,iteration,visit,item_id_list,visitor_id,reward,total_reward,fraction_relevant,percentage_overlap_rating,percentage_overlap_like
0,0,0,[132 183 318 211   7],308,4,4,4.0,20.0,0.0
1,0,1,[182 175  96  56 174],788,0,4,2.0,0.0,20.0
2,0,2,[  7 211 183 318 678],13,2,6,2.0,20.0,0.0
3,0,3,[ 56   8 655  82 238],85,2,8,2.0,0.0,0.0
4,0,4,[211   8 183  56   7],328,4,12,2.4,0.0,0.0
5,0,5,[211 183  56   7   8],6,4,16,2.6666666666666665,0.0,0.0
6,0,6,[211 183  56   8   7],379,5,21,3.0,0.0,0.0
7,0,7,[211 183  56   8   7],474,5,26,3.25,0.0,0.0
8,0,8,[211 183  56   8   7],379,5,31,3.4444444444444446,0.0,0.0
9,0,9,[211 183  56   8   7],406,5,36,3.6,0.0,0.0
10,0,10,[211 183  56   8   7],406,5,41,3.727272727272727,0.0,0.0
11,0,11,[211 183  56   8   7],406,5,46,3.8333333333333335,0.0,0.0
12,0,12,[100 265 228 211  97],59,5,51,3.923076923076923,0.0,20.0
13,0,13,[265  97 100 183 211],7,5,56,4.0,0.0,20.0
14,0,14,[265  97 100 183 211],474,5,61,4.066666666666666,0.0,20.0
15,0,15,[655 405  64 194 186],328,4,65,4.0625,0.0,0.0
16,0,16,[405 265 211 186  97],379,3,68,4.0,0.0,0.0
17,0,17,[265 211 186 183 228],843,2,70,3.888888888888889,0.0,0.0
18,0,18,[183 228 100  64 211],380,2,72,3.789473684210526,0.0,20.0
19,0,19,[183 100  56   8 211],315,3,75,3.75,0.0,20.0
20,0,20,[100 183  56 211 265],883,4,79,3.761904761904762,0.0,20.0
21,0,21,[100 183  56 211   7],883,5,84,3.8181818181818183,0.0,20.0
22,0,22,[100 183  56 211   7],774,1,85,3.6956521739130435,0.0,20.0
23,0,23,[183 100  56 211   8],308,5,90,3.75,0.0,20.0
24,0,24,[183 100  56 211   8],13,5,95,3.8,0.0,20.0
25,0,25,[183 100  56 211   8],6,5,100,3.8461538461538463,0.0,20.0
26,0,26,[183 100  56 211   8],234,3,103,3.814814814814815,0.0,20.0
27,0,27,[183 100   8  56 211],387,5,108,3.857142857142857,0.0,20.0
28,0,28,[183 100   8  56 211],6,5,113,3.896551724137931,0.0,20.0
29,0,29,[183 100   8  56 211],774,1,114,3.8,0.0,20.0
30,0,30,[183 100   8 211  56],474,5,119,3.838709677419355,0.0,20.0
31,0,31,[183 100   8 211  56],313,3,122,3.8125,0.0,20.0
32,0,32,[183 100 211   8  56],488,3,125,3.787878787878788,0.0,20.0
33,0,33,[183 211 100  56  97],346,4,129,3.7941176470588234,0.0,20.0
34,0,34,[183 211  56  97 100],406,5,134,3.8285714285714287,0.0,20.0
35,0,35,[183 211  97  56 100],311,3,137,3.8055555555555554,0.0,20.0
36,0,36,[183  97 211  56 100],313,4,141,3.810810810810811,0.0,20.0
37,0,37,[183  97 211  56 100],328,4,145,3.8157894736842106,0.0,20.0
38,0,38,[183 211  56 100  97],234,2,147,3.769230769230769,0.0,20.0
39,0,39,[183 211 100  56   7],328,5,152,3.8,0.0,20.0
40,0,40,[183 211 100  56   7],579,2,154,3.7560975609756095,0.0,20.0
41,0,41,[183 100 211  56   8],474,5,159,3.7857142857142856,0.0,20.0
42,0,42,[183 100 211   8  56],311,3,162,3.7674418604651163,0.0,20.0
43,0,43,[183 100 211   8  56],234,3,165,3.75,0.0,20.0
44,0,44,[183 100   8 211  56],207,2,167,3.7111111111111112,0.0,20.0
45,0,45,[183 100 211  56   8],234,3,170,3.6956521739130435,0.0,20.0
46,0,46,[183 100   8 211  56],234,3,173,3.6808510638297873,0.0,20.0
47,0,47,[183 100   8 211   7],328,4,177,3.6875,0.0,20.0
48,0,48,[655 175 135 182 200],213,5,182,3.7142857142857144,0.0,0.0
49,0,49,[135 200 183 100   8],881,4,186,3.72,0.0,20.0
50,0,50,[427 202 423 186  15],271,4,190,3.7254901960784315,0.0,0.0
51,0,51,[135 423 427 202 183],815,4,194,3.730769230769231,0.0,0.0
52,0,52,[423 427 202 183 100],313,5,199,3.7547169811320753,0.0,20.0
53,0,53,[588  98 405 597 179],378,2,201,3.7222222222222223,0.0,20.0
54,0,54,[423 588 427 202  98],326,3,204,3.709090909090909,0.0,20.0
55,0,55,[427 202  98 183 100],374,3,207,3.6964285714285716,0.0,40.0
56,0,56,[ 98 183 100 427 202],830,5,212,3.719298245614035,0.0,40.0
57,0,57,[ 98 183 427 202 100],694,5,217,3.7413793103448274,0.0,40.0
58,0,58,[ 98 183 427 202 100],452,4,221,3.7457627118644066,0.0,40.0
59,0,59,[ 98 183 427 100 423],339,4,225,3.75,0.0,40.0
60,0,60,[318 515 258   1 282],200,5,230,3.7704918032786887,20.0,0.0
61,0,61,[515   1 258 282  98],899,3,233,3.7580645161290325,0.0,20.0
62,0,62,[258  98 282 183 427],334,5,238,3.7777777777777777,0.0,20.0
63,0,63,[258  98 282 183 427],334,5,243,3.796875,0.0,20.0
64,0,64,[258  98 282 183 427],474,5,248,3.8153846153846156,0.0,20.0
65,0,65,[258  98 282 183 427],788,4,252,3.8181818181818183,0.0,20.0
66,0,66,[ 79 228 269  50 300],13,2,254,3.791044776119403,0.0,20.0
67,0,67,[258  98  50 282 183],144,5,259,3.8088235294117645,0.0,40.0
68,0,68,[258  98  50 282 183],328,4,263,3.8115942028985508,0.0,40.0
69,0,69,[258  98  50 183 282],311,5,268,3.8285714285714287,0.0,40.0
70,0,70,[258  98  50 183 282],328,4,272,3.8309859154929575,0.0,40.0
71,0,71,[258  98  50 183 427],350,3,275,3.8194444444444446,0.0,40.0
72,0,72,[ 98  50 183 258 427],6,4,279,3.8219178082191783,0.0,40.0
73,0,73,[ 98  50 183 427 258],650,4,283,3.824324324324324,0.0,40.0
74,0,74,[ 98  50 183 427 100],694,5,288,3.84,0.0,60.0
75,0,75,[ 98  50 183 427 100],406,5,293,3.8552631578947367,0.0,60.0
76,0,76,[328  69 655  71 597],378,2,295,3.831168831168831,0.0,0.0
77,0,77,[ 71  50  98 183 427],194,3,298,3.8205128205128207,0.0,40.0
78,0,78,[ 71  98 183  50 427],830,5,303,3.8354430379746836,0.0,40.0
79,0,79,[ 71  98 183  50 427],882,5,308,3.85,0.0,40.0
80,0,80,[ 71  98 183  50 427],815,5,313,3.8641975308641974,0.0,40.0
81,0,81,[ 71  98 183  50 427],6,5,318,3.8780487804878048,0.0,40.0
82,0,82,[ 71  98 183  50 427],313,5,323,3.891566265060241,0.0,40.0
83,0,83,[ 71  98 183  50 427],6,5,328,3.9047619047619047,0.0,40.0
84,0,84,[ 71  98 183  50 427],664,4,332,3.9058823529411764,0.0,40.0
85,0,85,[ 71  98  50 183 427],328,4,336,3.9069767441860463,0.0,40.0
86,0,86,[ 71  98  50 183 427],753,4,340,3.9080459770114944,0.0,40.0
87,0,87,[257 117 742 546  97],271,2,342,3.8863636363636362,0.0,0.0
88,0,88,[ 71  98 257  50 183],815,4,346,3.8876404494382024,0.0,40.0
89,0,89,[271 175 222 508 483],669,1,347,3.8555555555555556,20.0,0.0
90,0,90,[ 98  71  50 183 427],753,4,351,3.857142857142857,0.0,40.0
91,0,91,[ 98  71  50 183 427],650,4,355,3.858695652173913,0.0,40.0
92,0,92,[182 127 185 496 289],234,3,358,3.849462365591398,0.0,20.0
93,0,93,[ 98 289 127 496  50],10,5,363,3.8617021276595747,0.0,60.0
94,0,94,[ 98 289 127 496  50],387,3,366,3.8526315789473684,0.0,60.0
95,0,95,[ 98 127  50  71 183],313,5,371,3.8645833333333335,0.0,60.0
96,0,96,[ 98 127  50  71 183],840,4,375,3.865979381443299,0.0,60.0
97,0,97,[ 98 127  50 183 427],830,5,380,3.877551020408163,0.0,60.0
98,0,98,[ 98 127  50 183 427],194,3,383,3.8686868686868685,0.0,60.0
99,0,99,[ 98 127  50 427 183],326,4,387,3.87,0.0,60.0
100,0,100,[ 98  50 427 183 127],815,4,391,3.871287128712871,0.0,60.0
101,0,101,[ 98  50 427 183  71],536,4,395,3.872549019607843,0.0,40.0
102,0,102,[ 98  50 427 183  71],374,3,398,3.8640776699029127,0.0,40.0
103,0,103,[427  56 168 135 385],474,4,402,3.8653846153846154,0.0,0.0
104,0,104,[385  98  50 183 427],379,4,406,3.8666666666666667,0.0,40.0
105,0,105,[ 98  50 183 427  71],59,4,410,3.8679245283018866,0.0,40.0
106,0,106,[ 98  50 427 183  71],194,3,413,3.8598130841121496,0.0,40.0
107,0,107,[ 98 427  50 183  71],664,4,417,3.861111111111111,0.0,40.0
108,0,108,[ 98 427  50 183  71],42,5,422,3.871559633027523,0.0,40.0
109,0,109,[ 98 427  50 183  71],380,5,427,3.881818181818182,0.0,40.0
110,0,110,[ 98 427  50 183  71],664,4,431,3.8828828828828827,0.0,40.0
111,0,111,[ 98 427  50  71 183],380,5,436,3.892857142857143,0.0,40.0
112,0,112,[ 98 427  50  71 183],48,4,440,3.893805309734513,0.0,40.0
113,0,113,[ 98 427  50 183  71],830,5,445,3.9035087719298245,0.0,40.0
114,0,114,[172  97  69 435 191],840,3,448,3.8956521739130436,0.0,0.0
115,0,115,[191  98 435 427  50],650,5,453,3.9051724137931036,0.0,40.0
116,0,116,[191  98 435 427  50],843,0,453,3.871794871794872,0.0,40.0
117,0,117,[ 98 427  50 183  71],334,4,457,3.8728813559322033,0.0,40.0
118,0,118,[ 98 427  50 183 100],312,5,462,3.8823529411764706,0.0,60.0
119,0,119,[132   8 427 176 302],334,3,465,3.875,0.0,0.0
120,0,120,[302  98 427  50 183],745,3,468,3.8677685950413223,0.0,40.0
121,0,121,[302  98 427  50 183],940,4,472,3.8688524590163933,0.0,40.0
122,0,122,[173 196 588 302 235],13,3,475,3.861788617886179,0.0,0.0
123,0,123,[196 302  98 427  50],271,5,480,3.870967741935484,0.0,40.0
124,0,124,[196 302  98 427  50],664,5,485,3.88,0.0,40.0
125,0,125,[196 302  98 427  50],380,5,490,3.888888888888889,0.0,40.0
126,0,126,[196 302  98 427  50],380,5,495,3.8976377952755907,0.0,40.0
127,0,127,[100 655 204 222 405],881,5,500,3.90625,0.0,20.0
128,0,128,[181  50 182 197 176],64,4,504,3.9069767441860463,0.0,20.0
129,0,129,[302 196 181 204  98],271,5,509,3.9153846153846152,0.0,20.0
130,0,130,[183 143 483  64 161],60,4,513,3.9160305343511452,20.0,0.0
131,0,131,[ 71   1 191   8  11],64,4,517,3.9166666666666665,0.0,0.0
132,0,132,[181 302 161  11 204],454,3,520,3.9097744360902253,0.0,0.0
133,0,133,[196 302 204 161  98],271,4,524,3.91044776119403,0.0,20.0
134,0,134,[196 302 204  98 427],13,5,529,3.9185185185185185,0.0,20.0
135,0,135,[196 302 204  98 427],334,5,534,3.926470588235294,0.0,20.0
136,0,136,[196 302 204  98 427],537,2,536,3.9124087591240877,0.0,20.0
137,0,137,[302  98 427 196  50],13,5,541,3.920289855072464,0.0,40.0
138,0,138,[302  98 427 196  50],537,3,544,3.9136690647482015,0.0,40.0
139,0,139,[  7 475 268 301  28],537,3,547,3.907142857142857,0.0,0.0
140,0,140,[ 64 322  98 132 180],13,4,551,3.9078014184397163,0.0,20.0
141,0,141,[174 265 195  96  71],312,4,555,3.908450704225352,0.0,20.0
142,0,142,[185 144 183 435 357],406,4,559,3.909090909090909,20.0,0.0
143,0,143,[195 357 302 475 180],144,3,562,3.9027777777777777,20.0,0.0
144,0,144,[180 357 268 195  98],13,3,565,3.896551724137931,20.0,20.0
145,0,145,[195 328 427 286  98],328,3,568,3.8904109589041096,0.0,20.0
146,0,146,[180 286 268  98 302],29,5,573,3.8979591836734695,0.0,20.0
147,0,147,[273 237  82  25 313],13,2,575,3.885135135135135,0.0,0.0
148,0,148,[268 313 286 180 237],85,4,579,3.8859060402684564,0.0,0.0
149,0,149,[161 118 427 228 153],374,4,583,3.8866666666666667,0.0,0.0
150,0,150,[197  28   9 182 435],59,5,588,3.8940397350993377,0.0,0.0
151,0,151,[127 357 257  79 168],210,5,593,3.901315789473684,20.0,20.0
152,0,152,[215 181 289  71 333],85,3,596,3.895424836601307,0.0,0.0
153,0,153,[185 328 180  96 300],13,2,598,3.883116883116883,0.0,0.0
154,0,154,[180 153 118 313   9],308,3,601,3.8774193548387097,0.0,0.0
155,0,155,[180 286 268   9 153],85,4,605,3.878205128205128,0.0,0.0
156,0,156,[228   8 265 186  28],766,2,607,3.8662420382165603,0.0,0.0
157,0,157,[ 98  11 211 111 385],474,5,612,3.8734177215189876,0.0,20.0
158,0,158,[286 180   9 111 268],13,3,615,3.8679245283018866,0.0,0.0
159,0,159,[111 180 268 215  98],537,2,617,3.85625,0.0,20.0
160,0,160,[180 268  98 302  50],537,4,621,3.857142857142857,0.0,40.0
161,0,161,[204 603 127 173  12],334,5,626,3.8641975308641974,40.0,20.0
162,0,162,[173  70 435 483 302],524,5,631,3.871165644171779,20.0,0.0
163,0,163,[603  12 268 180  70],664,3,634,3.8658536585365852,40.0,0.0
164,0,164,[603 180  12 302  98],339,5,639,3.8727272727272726,40.0,20.0
165,0,165,[603 180  12 302  98],474,5,644,3.8795180722891565,40.0,20.0
166,0,166,[ 25 196 176 121 197],533,4,648,3.8802395209580838,0.0,0.0
167,0,167,[603  12 180 121 302],458,4,652,3.880952380952381,40.0,0.0
168,0,168,[603 180  12 302  98],90,5,657,3.8875739644970415,40.0,20.0
169,0,169,[603 180  12 302  98],13,5,662,3.8941176470588235,40.0,20.0
170,0,170,[300 323 118 117 678],699,3,665,3.888888888888889,0.0,0.0
171,0,171,[323 180 603  12 302],90,4,669,3.88953488372093,40.0,0.0
172,0,172,[180 603  12 302  98],666,5,674,3.8959537572254335,40.0,20.0
173,0,173,[180 603  12 302  98],543,5,679,3.9022988505747125,40.0,20.0
174,0,174,[180 603  12 302  98],271,5,684,3.9085714285714284,40.0,20.0
175,0,175,[276 181 515 194 172],537,2,686,3.897727272727273,0.0,0.0
176,0,176,[276 603  12 180 302],664,5,691,3.903954802259887,40.0,0.0
177,0,177,[172 132 194 238 196],537,1,692,3.8876404494382024,0.0,0.0
178,0,178,[276 180 603  12 302],13,5,697,3.893854748603352,40.0,0.0
179,0,179,[276 180 603  12 302],474,5,702,3.9,40.0,0.0
180,0,180,[ 64  22 515 100  89],346,4,706,3.9005524861878453,0.0,20.0
181,0,181,[276 603  12  89 180],90,5,711,3.9065934065934065,40.0,0.0
182,0,182,[276 603  12  89 180],385,3,714,3.901639344262295,40.0,0.0
183,0,183,[ 22 603  89 180 302],664,4,718,3.902173913043478,20.0,0.0
184,0,184,[ 89 603 180 302  98],524,3,721,3.8972972972972975,20.0,20.0
185,0,185,[222 322 302  50  98],474,5,726,3.903225806451613,0.0,40.0
186,0,186,[ 89 180 302 603  12],537,4,730,3.9037433155080214,40.0,0.0
187,0,187,[ 98 153 179 135 271],379,4,734,3.904255319148936,0.0,20.0
188,0,188,[180  89 302 603  98],537,4,738,3.9047619047619047,20.0,20.0
189,0,189,[180  89 302 603  98],537,4,742,3.905263157894737,20.0,20.0
190,0,190,[180  89 302 603  98],664,5,747,3.910994764397906,20.0,20.0
191,0,191,[180  89 302 603  98],13,5,752,3.9166666666666665,20.0,20.0
192,0,192,[180  89 302 603  98],666,5,757,3.922279792746114,20.0,20.0
193,0,193,[180  89 302 603  98],271,4,761,3.922680412371134,20.0,20.0
194,0,194,[180 302 603  89  98],474,5,766,3.928205128205128,20.0,20.0
195,0,195,[180 302 603  89  98],339,5,771,3.933673469387755,20.0,20.0
196,0,196,[180 302 603  89  98],474,5,776,3.9390862944162435,20.0,20.0
197,0,197,[269 185  56 210 435],271,3,779,3.9343434343434343,0.0,0.0
198,0,198,[322 187 588 427  28],234,3,782,3.92964824120603,0.0,0.0
199,0,199,[210 180 187 302 603],543,4,786,3.93,20.0,0.0
200,0,200,[180 187 302 603  89],836,5,791,3.9353233830845773,20.0,0.0
201,0,201,[180 187 302 603  89],271,4,795,3.9356435643564356,20.0,0.0
202,0,202,[180 187 302 603  98],13,5,800,3.9408866995073892,20.0,20.0
203,0,203,[180 187 302 603  98],524,3,803,3.9362745098039214,20.0,20.0
204,0,204,[180 187 302 603  98],664,5,808,3.9414634146341463,20.0,20.0
205,0,205,[180 187 302 603  98],474,5,813,3.9466019417475726,20.0,20.0
206,0,206,[515 238 186   8  71],13,3,816,3.9420289855072466,0.0,0.0
207,0,207,[423  96 245 172  79],455,4,820,3.9423076923076925,0.0,0.0
208,0,208,[180 187 302 603  98],664,5,825,3.9473684210526314,20.0,20.0
209,0,209,[180 187 302 603  98],664,5,830,3.9523809523809526,20.0,20.0
210,0,210,[234  89 153  96 118],313,4,834,3.9526066350710902,0.0,0.0
211,0,211,[180 187 234 302 603],666,4,838,3.952830188679245,20.0,0.0
212,0,212,[180 187 302 603  98],339,5,843,3.9577464788732395,20.0,20.0
213,0,213,[180 187 302 603  98],537,4,847,3.957943925233645,20.0,20.0
214,0,214,[180 187 302 603  98],524,3,850,3.953488372093023,20.0,20.0
215,0,215,[180 187 302 603  50],458,4,854,3.9537037037037037,20.0,20.0
216,0,216,[180 187 302 603  98],666,5,859,3.9585253456221197,20.0,20.0
217,0,217,[180 187 302 603  98],666,5,864,3.963302752293578,20.0,20.0
218,0,218,[258  64 172 180 237],13,5,869,3.9680365296803655,0.0,0.0
219,0,219,[180 187 302 603  98],315,5,874,3.9727272727272727,20.0,20.0
220,0,220,[180 187 302 603  98],271,5,879,3.97737556561086,20.0,20.0
221,0,221,[ 28  98 258  95 210],387,4,883,3.9774774774774775,0.0,20.0
222,0,222,[496  69 322 215 144],263,4,887,3.977578475336323,0.0,0.0
223,0,223,[180 187 302 603  98],271,5,892,3.982142857142857,20.0,20.0
224,0,224,[180 187 302 603  98],13,5,897,3.986666666666667,20.0,20.0
225,0,225,[288  22 111 405 222],92,1,898,3.9734513274336285,0.0,0.0
226,0,226,[180 187 302 603  98],537,4,902,3.973568281938326,20.0,20.0
227,0,227,[180 187 302 603  98],339,5,907,3.9780701754385963,20.0,20.0
228,0,228,[195 269  22 318  50],738,3,910,3.9737991266375547,20.0,20.0
229,0,229,[180 187 302 603  98],537,4,914,3.973913043478261,20.0,20.0
230,0,230,[180 187 302 603 427],666,5,919,3.9783549783549783,20.0,0.0
231,0,231,[180 187 302 603 427],90,5,924,3.9827586206896552,20.0,0.0
232,0,232,[515  56 275 118  96],145,3,927,3.9785407725321886,0.0,0.0
233,0,233,[180 187 302 603 427],458,5,932,3.982905982905983,20.0,0.0
234,0,234,[  4  70 204 100 173],579,2,934,3.974468085106383,0.0,20.0
235,0,235,[180 187 302 603 427],664,5,939,3.9788135593220337,20.0,0.0
236,0,236,[180 187 302 603 427],339,5,944,3.9831223628691985,20.0,0.0
237,0,237,[180 187 302 603 427],666,5,949,3.9873949579831933,20.0,0.0
238,0,238,[180 187 302 603 427],90,5,954,3.99163179916318,20.0,0.0
239,0,239,[180 187 302 603 427],271,5,959,3.995833333333333,20.0,0.0
240,0,240,[180 187 302 603 427],666,5,964,4.0,20.0,0.0
241,0,241,[  9 176 568   8  56],200,5,969,4.0041322314049586,0.0,0.0
242,0,242,[187 568 180 302 603],339,4,973,4.004115226337449,20.0,0.0
243,0,243,[234   7 603  71  15],234,2,975,3.9959016393442623,20.0,0.0
244,0,244,[180 187 302 603 427],90,5,980,4.0,20.0,0.0
245,0,245,[180 187 302 603 427],537,5,985,4.004065040650406,20.0,0.0
246,0,246,[180 187 302 603 427],666,5,990,4.008097165991903,20.0,0.0
247,0,247,[180 187 302 603 427],664,5,995,4.012096774193548,20.0,0.0
248,0,248,[568 117 174 546   1],749,4,999,4.0120481927710845,0.0,20.0
249,0,249,[180 187 302 603 427],90,5,1004,4.016,20.0,0.0
250,0,250,[180 187 302 603 427],537,5,1009,4.0199203187251,20.0,0.0
251,0,251,[180 187 302 603 427],537,5,1014,4.023809523809524,20.0,0.0
252,0,252,[ 97   4  89 180  11],271,4,1018,4.023715415019763,0.0,0.0
253,0,253,[180 187 302 603 427],90,5,1023,4.02755905511811,20.0,0.0
254,0,254,[180 187 302 603 427],474,5,1028,4.031372549019608,20.0,0.0
255,0,255,[180 187 302 603 427],666,5,1033,4.03515625,20.0,0.0
256,0,256,[180 187 302 603 427],474,5,1038,4.038910505836576,20.0,0.0
257,0,257,[111 117 588 204 288],479,2,1040,4.0310077519379846,0.0,0.0
258,0,258,[180 187 302 603 427],339,5,1045,4.0347490347490345,20.0,0.0
259,0,259,[180 187 302 603 427],664,5,1050,4.038461538461538,20.0,0.0
260,0,260,[180 187 302 603 427],13,5,1055,4.042145593869732,20.0,0.0
261,0,261,[117 204 603 471  98],533,5,1060,4.0458015267175576,20.0,20.0
262,0,262,[187 471 180 302 603],666,5,1065,4.0494296577946765,20.0,0.0
263,0,263,[132   8 100 151 423],533,3,1068,4.045454545454546,0.0,20.0
264,0,264,[187 471 180 302 603],271,4,1072,4.0452830188679245,20.0,0.0
265,0,265,[ 50  64  12 196 289],318,2,1074,4.037593984962406,20.0,20.0
266,0,266,[180 187 302 603 427],664,5,1079,4.0411985018726595,20.0,0.0
267,0,267,[180 187 302 603 427],271,5,1084,4.044776119402985,20.0,0.0
268,0,268,[180 187 302 603 427],339,5,1089,4.048327137546468,20.0,0.0
269,0,269,[180 187 302 603 427],339,5,1094,4.051851851851852,20.0,0.0
270,0,270,[180 187 302 603 427],666,5,1099,4.055350553505535,20.0,0.0
271,0,271,[180 187 302 603 427],474,5,1104,4.0588235294117645,20.0,0.0
272,0,272,[180 187 302 603 427],666,5,1109,4.062271062271062,20.0,0.0
273,0,273,[180 187 302 603 427],458,5,1114,4.065693430656935,20.0,0.0
274,0,274,[180 187 302 603 427],271,5,1119,4.069090909090909,20.0,0.0
275,0,275,[180 187 302 603 427],339,5,1124,4.072463768115942,20.0,0.0
276,0,276,[ 15  79 168 180 127],537,3,1127,4.068592057761733,0.0,20.0
277,0,277,[273 318 313 182 127],144,4,1131,4.068345323741007,20.0,20.0
278,0,278,[187 180 302 603 427],664,5,1136,4.07168458781362,20.0,0.0
279,0,279,[187 180 302 603 427],666,5,1141,4.075,20.0,0.0
280,0,280,[204 313  56 235 183],328,3,1144,4.0711743772241995,0.0,0.0
281,0,281,[197 235 135 403 132],378,3,1147,4.067375886524823,0.0,0.0
282,0,282,[ 89  25 288 258 197],234,1,1148,4.056537102473499,0.0,0.0
283,0,283,[187 403 180 302 603],339,4,1152,4.056338028169014,20.0,0.0
284,0,284,[180 187 302 603 427],458,5,1157,4.059649122807017,20.0,0.0
285,0,285,[180 187 302 603 427],339,5,1162,4.062937062937063,20.0,0.0
286,0,286,[180 187 302 603 427],271,5,1167,4.066202090592334,20.0,0.0
287,0,287,[180 187 302 603 427],13,5,1172,4.069444444444445,20.0,0.0
288,0,288,[180 187 302 603 427],474,5,1177,4.072664359861592,20.0,0.0
289,0,289,[515  25  70 313 196],271,4,1181,4.072413793103448,0.0,0.0
290,0,290,[176 210  64 180 125],378,3,1184,4.0687285223367695,0.0,0.0
291,0,291,[187 302 180 603 427],90,5,1189,4.071917808219178,20.0,0.0
292,0,292,[187 302 180 603 427],666,5,1194,4.075085324232082,20.0,0.0
293,0,293,[238 117 294 385 742],207,1,1195,4.0646258503401365,0.0,0.0
294,0,294,[187 302 180 603 427],474,5,1200,4.067796610169491,20.0,0.0
295,0,295,[187 302 180 603 427],13,5,1205,4.070945945945946,20.0,0.0
296,0,296,[187 302 180 603 427],474,5,1210,4.074074074074074,20.0,0.0
297,0,297,[111 597 300 405 100],533,3,1213,4.070469798657718,0.0,20.0
298,0,298,[187 302 180 603 427],666,5,1218,4.073578595317726,20.0,0.0
299,0,299,[127 265 196   9  69],533,4,1222,4.073333333333333,0.0,20.0
300,0,300,[187 302 180 603 427],474,5,1227,4.076411960132891,20.0,0.0
301,0,301,[286 385 153 301 176],13,1,1228,4.066225165562914,0.0,0.0
302,0,302,[187 302 180 603 427],664,5,1233,4.069306930693069,20.0,0.0
303,0,303,[187 302 180 603 427],537,5,1238,4.072368421052632,20.0,0.0
304,0,304,[187 302 180 603 427],339,5,1243,4.075409836065574,20.0,0.0
305,0,305,[187 302 180 603 427],13,5,1248,4.078431372549019,20.0,0.0
306,0,306,[187 302 180 603 427],458,5,1253,4.0814332247557,20.0,0.0
307,0,307,[187 302 180 603 427],90,5,1258,4.084415584415584,20.0,0.0
308,0,308,[187 302 180 603 427],537,5,1263,4.087378640776699,20.0,0.0
309,0,309,[187 302 180 603 427],90,5,1268,4.090322580645161,20.0,0.0
310,0,310,[187 302 180 603 427],666,5,1273,4.093247588424437,20.0,0.0
311,0,311,[187 302 180 603 427],458,5,1278,4.096153846153846,20.0,0.0
312,0,312,[204 405 179 289 435],13,2,1280,4.0894568690095845,0.0,0.0
313,0,313,[423  96 210  11 144],374,4,1284,4.089171974522293,0.0,0.0
314,0,314,[187 302 180 603 427],537,5,1289,4.092063492063492,20.0,0.0
315,0,315,[200 496  28 483  12],308,2,1291,4.0854430379746836,40.0,0.0
316,0,316,[187 302 180 603 427],13,5,1296,4.0883280757097795,20.0,0.0
317,0,317,[ 98 385   4 173 568],749,4,1300,4.088050314465409,0.0,20.0
318,0,318,[ 22 271 185  56 100],537,3,1303,4.084639498432602,0.0,20.0
319,0,319,[187 302 180 603 427],666,5,1308,4.0875,20.0,0.0
320,0,320,[187 302 180 603 427],474,5,1313,4.090342679127726,20.0,0.0
321,0,321,[144 235  97 318 153],87,4,1317,4.090062111801243,20.0,0.0
322,0,322,[ 25 357 271  98 182],749,4,1321,4.089783281733746,20.0,20.0
323,0,323,[187 302 180 603 427],271,5,1326,4.092592592592593,20.0,0.0
324,0,324,[187 302 180 603 427],339,5,1331,4.095384615384615,20.0,0.0
325,0,325,[275 546  12 117 194],533,4,1335,4.095092024539877,20.0,0.0
326,0,326,[187 302 180 603 427],666,5,1340,4.097859327217125,20.0,0.0
327,0,327,[187 302 180 603 427],13,5,1345,4.100609756097561,20.0,0.0
328,0,328,[222 597  28 204 202],882,5,1350,4.103343465045593,0.0,0.0
329,0,329,[187 302 180 603 427],666,5,1355,4.106060606060606,20.0,0.0
330,0,330,[187 302 180 603 427],90,5,1360,4.108761329305136,20.0,0.0
331,0,331,[187 302 180 603 427],664,5,1365,4.11144578313253,20.0,0.0
332,0,332,[ 22 238 211 216  98],234,2,1367,4.105105105105105,0.0,20.0
333,0,333,[187 302 180 603 427],537,5,1372,4.107784431137724,20.0,0.0
334,0,334,[187 302 180 603 427],90,5,1377,4.11044776119403,20.0,0.0
335,0,335,[187 302 180 603 427],458,5,1382,4.113095238095238,20.0,0.0
336,0,336,[187 302 180 603 427],474,5,1387,4.115727002967359,20.0,0.0
337,0,337,[187 302 180 603 427],90,5,1392,4.118343195266272,20.0,0.0
338,0,338,[322  89 196 222 265],234,0,1392,4.106194690265487,0.0,0.0
339,0,339,[187 302 180 603 427],458,5,1397,4.108823529411764,20.0,0.0
340,0,340,[187 302 180 603 427],458,5,1402,4.1114369501466275,20.0,0.0
341,0,341,[187 302 180 603 427],664,5,1407,4.114035087719298,20.0,0.0
342,0,342,[187 302 180 603 427],664,5,1412,4.11661807580175,20.0,0.0
343,0,343,[ 15 328  56 423 180],378,3,1415,4.113372093023256,0.0,0.0
344,0,344,[294 153   9 127  70],406,2,1417,4.107246376811594,0.0,20.0
345,0,345,[187 302 180 603 427],271,5,1422,4.109826589595376,20.0,0.0
346,0,346,[187 302 180 603 427],271,5,1427,4.112391930835735,20.0,0.0
347,0,347,[187 302 180 603 427],474,5,1432,4.114942528735632,20.0,0.0
348,0,348,[187 302 180 603 427],474,5,1437,4.117478510028653,20.0,0.0
349,0,349,[187 302 180 603 427],271,5,1442,4.12,20.0,0.0
350,0,350,[187 302 180 603 427],458,5,1447,4.122507122507122,20.0,0.0
351,0,351,[187 302 180 603 427],474,5,1452,4.125,20.0,0.0
352,0,352,[ 89 135 215 385 173],92,4,1456,4.124645892351275,0.0,0.0
353,0,353,[195  28 135 603 282],899,5,1461,4.127118644067797,20.0,0.0
354,0,354,[187 302 180 603 427],339,5,1466,4.129577464788732,20.0,0.0
355,0,355,[ 28 742 215 195  11],387,2,1468,4.123595505617978,0.0,0.0
356,0,356,[ 70  96  69 143 318],207,3,1471,4.120448179271708,20.0,0.0
357,0,357,[111 403  11 300 216],334,2,1473,4.114525139664805,0.0,0.0
358,0,358,[183 125  96 100 127],374,5,1478,4.116991643454039,0.0,40.0
359,0,359,[187 302 180 603 427],666,5,1483,4.1194444444444445,20.0,0.0
360,0,360,[187 302 180 603 427],474,5,1488,4.121883656509695,20.0,0.0
361,0,361,[187 302 180 603 427],458,5,1493,4.124309392265193,20.0,0.0
362,0,362,[187 302 180 603 427],271,5,1498,4.126721763085399,20.0,0.0
363,0,363,[187 302 180 603 427],339,5,1503,4.1291208791208796,20.0,0.0
364,0,364,[187 302 180 603 427],666,5,1508,4.131506849315069,20.0,0.0
365,0,365,[187 302 180 603 427],458,5,1513,4.133879781420765,20.0,0.0
366,0,366,[186 183 161  28 111],833,1,1514,4.125340599455041,0.0,0.0
367,0,367,[173 125 172   9   7],406,3,1517,4.122282608695652,0.0,0.0
368,0,368,[181 182 200 748 333],488,3,1520,4.119241192411924,0.0,0.0
369,0,369,[597 204  25 269 161],455,3,1523,4.116216216216216,0.0,0.0
370,0,370,[603 153 195 181 238],804,5,1528,4.118598382749326,20.0,0.0
371,0,371,[151 132 187 202 405],804,4,1532,4.118279569892473,0.0,0.0
372,0,372,[748 187 302 180 603],524,3,1535,4.115281501340482,20.0,0.0
373,0,373,[385 289 301 276 181],13,2,1537,4.109625668449198,0.0,0.0
374,0,374,[318 117 181 403  69],144,4,1541,4.109333333333334,20.0,0.0
375,0,375,[187 302 180 603 427],13,5,1546,4.111702127659575,20.0,0.0
376,0,376,[187 302 180 603 427],664,5,1551,4.114058355437666,20.0,0.0
377,0,377,[187 302 180 603 427],666,5,1556,4.116402116402116,20.0,0.0
378,0,378,[ 15 204 228 257  82],455,4,1560,4.116094986807388,0.0,0.0
379,0,379,[ 12 471 276  64 185],90,5,1565,4.118421052631579,20.0,0.0
380,0,380,[187 302 180 603 427],537,5,1570,4.120734908136483,20.0,0.0
381,0,381,[187 302 180 603 427],339,5,1575,4.12303664921466,20.0,0.0
382,0,382,[187 302 180 603 427],13,5,1580,4.12532637075718,20.0,0.0
383,0,383,[187 302 180 603 427],13,5,1585,4.127604166666667,20.0,0.0
384,0,384,[187 302 180 603 427],90,5,1590,4.12987012987013,20.0,0.0
385,0,385,[187 302 180 603 427],664,5,1595,4.132124352331606,20.0,0.0
386,0,386,[187 302 180 603 427],458,5,1600,4.134366925064599,20.0,0.0
387,0,387,[187 302 180 603 427],13,5,1605,4.13659793814433,20.0,0.0
388,0,388,[187 302 180 603 427],458,5,1610,4.138817480719794,20.0,0.0
389,0,389,[143 313 183 144 568],308,3,1613,4.135897435897436,0.0,0.0
390,0,390,[237 228 286 568 117],328,3,1616,4.132992327365729,0.0,0.0
391,0,391,[187 302 180 603 427],474,5,1621,4.135204081632653,20.0,0.0
392,0,392,[187 302 180 603 427],339,5,1626,4.137404580152672,20.0,0.0
393,0,393,[187 168 202 194 435],64,5,1631,4.1395939086294415,0.0,0.0
394,0,394,[187 302 180 603 427],90,5,1636,4.141772151898734,20.0,0.0
395,0,395,[405  28  15 211 121],653,2,1638,4.136363636363637,0.0,0.0
396,0,396,[403 194   4 294   1],144,4,1642,4.1360201511335015,0.0,0.0
397,0,397,[191 403 286 181 323],650,2,1644,4.130653266331659,0.0,0.0
398,0,398,[127  56 176  82 100],334,4,1648,4.130325814536341,0.0,40.0
399,0,399,[187 302 180 603 427],666,5,1653,4.1325,20.0,0.0
400,0,400,[187 302 180 603 427],90,5,1658,4.134663341645886,20.0,0.0
401,0,401,[187 302 180 603 427],90,5,1663,4.13681592039801,20.0,0.0
402,0,402,[187 302 180 603 427],339,5,1668,4.138957816377172,20.0,0.0
403,0,403,[187 302 180 603 427],13,5,1673,4.141089108910891,20.0,0.0
404,0,404,[187 302 180 603 427],271,5,1678,4.14320987654321,20.0,0.0
405,0,405,[276 228  89   8 181],13,5,1683,4.145320197044335,0.0,0.0
406,0,406,[187 302 180 603 427],339,5,1688,4.1474201474201475,20.0,0.0
407,0,407,[186  15  98  50 191],488,4,1692,4.147058823529412,0.0,40.0
408,0,408,[187 302 180 603 427],13,5,1697,4.1491442542787285,20.0,0.0
409,0,409,[328  56  69 181 222],506,5,1702,4.151219512195122,0.0,0.0
410,0,410,[187 302 180 603 427],271,5,1707,4.153284671532846,20.0,0.0
411,0,411,[300 194 191 143 357],13,1,1708,4.145631067961165,20.0,0.0
412,0,412,[222 276  28 172  71],42,4,1712,4.145278450363196,0.0,0.0
413,0,413,[294 144 194 180  56],648,2,1714,4.140096618357488,0.0,0.0
414,0,414,[187 302 180 603 427],13,5,1719,4.142168674698795,20.0,0.0
415,0,415,[187 302 180 603 427],339,5,1724,4.144230769230769,20.0,0.0
416,0,416,[187 302 180 603 427],666,5,1729,4.146282973621103,20.0,0.0
417,0,417,[195 273 215 183 568],537,0,1729,4.136363636363637,0.0,0.0
418,0,418,[187 302 180 603 427],537,5,1734,4.138424821002387,20.0,0.0
419,0,419,[187 302 180 603 427],474,5,1739,4.140476190476191,20.0,0.0
420,0,420,[ 50 151 271 276 475],669,2,1741,4.135391923990499,0.0,20.0
421,0,421,[187 302 180 603 427],13,5,1746,4.137440758293839,20.0,0.0
422,0,422,[187 302 180 603 427],90,5,1751,4.139479905437352,20.0,0.0
423,0,423,[187 302 180 603 427],537,5,1756,4.1415094339622645,20.0,0.0
424,0,424,[187 302 180 603 427],271,5,1761,4.143529411764706,20.0,0.0
425,0,425,[187 302 180 603 427],271,5,1766,4.145539906103286,20.0,0.0
426,0,426,[222  64 180 265 202],311,5,1771,4.147540983606557,0.0,0.0
427,0,427,[265 185 300 385 269],64,4,1775,4.147196261682243,0.0,0.0
428,0,428,[187 302 180 603 427],271,5,1780,4.1491841491841495,20.0,0.0
429,0,429,[ 11  22 423 117  28],378,3,1783,4.1465116279069765,0.0,0.0
430,0,430,[276  96 678 288  98],92,3,1786,4.143851508120649,0.0,20.0
431,0,431,[  1 318 238 132 496],6,5,1791,4.145833333333333,20.0,0.0
432,0,432,[187 302 180 603 427],90,5,1796,4.147806004618937,20.0,0.0
433,0,433,[187 302 180 603 427],664,5,1801,4.149769585253456,20.0,0.0
434,0,434,[187 302 180 603 427],339,5,1806,4.151724137931034,20.0,0.0
435,0,435,[238 204  70  64  50],804,5,1811,4.1536697247706424,0.0,20.0
436,0,436,[187 302 180 603 427],90,5,1816,4.155606407322654,20.0,0.0
437,0,437,[187 302 180 603 427],666,5,1821,4.157534246575342,20.0,0.0
438,0,438,[187 302 180 603 427],271,5,1826,4.159453302961276,20.0,0.0
439,0,439,[187 302 180 603 427],664,5,1831,4.161363636363636,20.0,0.0
440,0,440,[282 183 132  56 483],334,4,1835,4.160997732426304,20.0,0.0
441,0,441,[117 118 405 423 234],749,3,1838,4.158371040723982,0.0,0.0
442,0,442,[ 28 176 186 215 318],892,4,1842,4.158013544018059,20.0,0.0
443,0,443,[187 302 180 603 427],666,5,1847,4.15990990990991,20.0,0.0
444,0,444,[187 302 180 603 427],13,5,1852,4.1617977528089884,20.0,0.0
445,0,445,[187 302 180 603 427],339,5,1857,4.163677130044843,20.0,0.0
446,0,446,[183 100 197 187 435],840,4,1861,4.16331096196868,0.0,20.0
447,0,447,[302 187 180 603 427],474,5,1866,4.165178571428571,20.0,0.0
448,0,448,[678  98 235 127 496],648,3,1869,4.1625835189309575,0.0,40.0
449,0,449,[175 294 185   7  71],95,3,1872,4.16,0.0,0.0
450,0,450,[121 187 385 117 211],308,3,1875,4.157427937915743,0.0,0.0
451,0,451,[302 187 180 603 427],271,5,1880,4.15929203539823,20.0,0.0
452,0,452,[204  56   4 475 588],387,1,1881,4.152317880794702,0.0,0.0
453,0,453,[ 89 228 318  98 118],804,5,1886,4.154185022026431,20.0,20.0
454,0,454,[302 187 180 603 427],458,5,1891,4.156043956043956,20.0,0.0
455,0,455,[ 89 195 183  82 302],102,3,1894,4.1535087719298245,0.0,0.0
456,0,456,[187 302 180 603 427],13,5,1899,4.155361050328228,20.0,0.0
457,0,457,[183 313   8 215 546],234,3,1902,4.152838427947598,0.0,0.0
458,0,458,[ 82 200 286 508  28],653,4,1906,4.152505446623094,0.0,0.0
459,0,459,[187 302 180 603 427],458,5,1911,4.154347826086957,20.0,0.0
460,0,460,[187 302 180 603 427],664,5,1916,4.156182212581345,20.0,0.0
461,0,461,[276 748 180 568 238],207,1,1917,4.14935064935065,0.0,0.0
462,0,462,[187 302 180 603 427],458,5,1922,4.151187904967602,20.0,0.0
463,0,463,[187 302 180 603 427],458,5,1927,4.1530172413793105,20.0,0.0
464,0,464,[187 302 180 603 427],537,5,1932,4.15483870967742,20.0,0.0
465,0,465,[  9  71 174  98 172],788,2,1934,4.150214592274678,0.0,40.0
466,0,466,[286 196 186  71 546],378,3,1937,4.147751605995717,0.0,0.0
467,0,467,[187 302 180 603 427],474,5,1942,4.14957264957265,20.0,0.0
468,0,468,[187 302 180 603 427],537,5,1947,4.151385927505331,20.0,0.0
469,0,469,[  8   1 173 118 234],455,5,1952,4.153191489361702,0.0,0.0
470,0,470,[187 302 180 603 427],664,5,1957,4.154989384288747,20.0,0.0
471,0,471,[187 302 180 603 427],666,5,1962,4.156779661016949,20.0,0.0
472,0,472,[210 546 435 195   9],207,2,1964,4.152219873150106,0.0,0.0
473,0,473,[ 69 191 427  12 175],379,5,1969,4.154008438818566,20.0,0.0
474,0,474,[187 302 180 603 427],537,5,1974,4.1557894736842105,20.0,0.0
475,0,475,[187 302 180 603 427],666,5,1979,4.157563025210084,20.0,0.0
476,0,476,[187 302 180 603 427],664,5,1984,4.159329140461216,20.0,0.0
477,0,477,[187 302 180 603 427],474,5,1989,4.161087866108787,20.0,0.0
478,0,478,[176 144  64   9  69],7,4,1993,4.160751565762004,0.0,0.0
479,0,479,[187 302 180 603 427],666,5,1998,4.1625,20.0,0.0
480,0,480,[187 302 180 603 427],13,5,2003,4.164241164241164,20.0,0.0
481,0,481,[187 302 180 603 427],271,5,2008,4.16597510373444,20.0,0.0
482,0,482,[187 302 180 603 427],664,5,2013,4.167701863354037,20.0,0.0
483,0,483,[187 302 180 603 427],474,5,2018,4.169421487603306,20.0,0.0
484,0,484,[187 302 180 603 427],474,5,2023,4.171134020618557,20.0,0.0
485,0,485,[187 302 180 603 427],664,5,2028,4.172839506172839,20.0,0.0
486,0,486,[187 302 180 603 427],666,5,2033,4.174537987679671,20.0,0.0
487,0,487,[187 302 180 603 427],271,5,2038,4.176229508196721,20.0,0.0
488,0,488,[187 302 180 603 427],13,5,2043,4.177914110429448,20.0,0.0
489,0,489,[187 302 180 603 427],666,5,2048,4.179591836734694,20.0,0.0
490,0,490,[187 302 180 603 427],90,5,2053,4.181262729124236,20.0,0.0
491,0,491,[187 302 180 603 427],13,5,2058,4.182926829268292,20.0,0.0
492,0,492,[187 302 180 603 427],458,5,2063,4.1845841784989855,20.0,0.0
493,0,493,[196 483 423 204 186],398,5,2068,4.186234817813765,20.0,0.0
494,0,494,[546 313 196 175 132],650,4,2072,4.185858585858586,0.0,0.0
495,0,495,[483 191  96 265  70],452,3,2075,4.183467741935484,20.0,0.0
496,0,496,[187 302 180 603 427],339,5,2080,4.185110663983903,20.0,0.0
497,0,497,[187 302 180 603 427],339,5,2085,4.186746987951807,20.0,0.0
498,0,498,[135 258  22  69 194],13,5,2090,4.188376753507014,0.0,0.0
499,0,499,[187 302 180 603 427],474,5,2095,4.19,20.0,0.0
500,0,500,[195 288 176 202  25],378,2,2097,4.18562874251497,0.0,0.0
501,0,501,[187 302 180 603 427],474,5,2102,4.187250996015936,20.0,0.0
502,0,502,[187 302 180 603 427],537,5,2107,4.188866799204772,20.0,0.0
503,0,503,[187 302 180 603 427],90,5,2112,4.190476190476191,20.0,0.0
504,0,504,[187 302 180 603 427],458,5,2117,4.192079207920792,20.0,0.0
505,0,505,[187 302 180 603 427],339,5,2122,4.1936758893280635,20.0,0.0
506,0,506,[174  64 173 265 294],804,5,2127,4.195266272189349,0.0,20.0
507,0,507,[187 302 180 603 427],90,5,2132,4.196850393700787,20.0,0.0
508,0,508,[187 302 180 603 427],458,5,2137,4.198428290766208,20.0,0.0
509,0,509,[187 302 180 603 427],664,5,2142,4.2,20.0,0.0
510,0,510,[187 302 180 603 427],271,5,2147,4.201565557729941,20.0,0.0
511,0,511,[172 508  22 186 318],387,3,2150,4.19921875,20.0,0.0
512,0,512,[187 302 180 603 427],666,5,2155,4.200779727095517,20.0,0.0
513,0,513,[ 97 276 176 117 357],537,2,2157,4.196498054474708,20.0,0.0
514,0,514,[187 302 180 603 427],664,5,2162,4.1980582524271846,20.0,0.0
515,0,515,[187 302 180 603 427],13,5,2167,4.199612403100775,20.0,0.0
516,0,516,[168  95 385 200 258],102,2,2169,4.195357833655706,0.0,0.0
517,0,517,[187 302 180 603 427],271,5,2174,4.196911196911197,20.0,0.0
518,0,518,[ 82  96 294 121 655],666,1,2175,4.190751445086705,0.0,0.0
519,0,519,[187 302 180 603 427],537,5,2180,4.1923076923076925,20.0,0.0
520,0,520,[186 204 318  56 515],474,5,2185,4.1938579654510555,20.0,0.0
521,0,521,[318  22 258 276 168],92,3,2188,4.1915708812260535,20.0,0.0
522,0,522,[187 302 180 603 427],537,5,2193,4.193116634799235,20.0,0.0
523,0,523,[  1 234 588 273 181],458,4,2197,4.192748091603053,0.0,0.0
524,0,524,[ 50 194 202  22  71],650,2,2199,4.188571428571429,0.0,20.0
525,0,525,[187 302 180 603 427],271,5,2204,4.190114068441065,20.0,0.0
526,0,526,[435 180 151 100 211],387,3,2207,4.1878557874762805,0.0,20.0
527,0,527,[187 302 180 603 427],458,5,2212,4.1893939393939394,20.0,0.0
528,0,528,[187 302 180 603 427],664,5,2217,4.190926275992439,20.0,0.0
529,0,529,[187 302 180 603 427],90,5,2222,4.192452830188679,20.0,0.0
530,0,530,[187 302 180 603 427],90,5,2227,4.1939736346516,20.0,0.0
531,0,531,[228 357 187  25 289],533,3,2230,4.19172932330827,20.0,0.0
532,0,532,[187 302 180 603 427],458,5,2235,4.193245778611632,20.0,0.0
533,0,533,[187 302 180 603 427],339,5,2240,4.194756554307116,20.0,0.0
534,0,534,[187 302 180 603 427],664,5,2245,4.196261682242991,20.0,0.0
535,0,535,[187 302 180 603 427],13,5,2250,4.197761194029851,20.0,0.0
536,0,536,[187 302 180 603 427],458,5,2255,4.199255121042831,20.0,0.0
537,0,537,[187 302 180 603 427],474,5,2260,4.200743494423792,20.0,0.0
538,0,538,[ 12  82  64   4 318],774,0,2260,4.192949907235621,40.0,0.0
539,0,539,[187 302 180 603 427],666,5,2265,4.194444444444445,20.0,0.0
540,0,540,[187 302 180 603 427],474,5,2270,4.195933456561923,20.0,0.0
541,0,541,[187 302 180 603 427],339,5,2275,4.197416974169742,20.0,0.0
542,0,542,[187 302 180 603 427],666,5,2280,4.198895027624309,20.0,0.0
543,0,543,[187 302 180 603 427],458,5,2285,4.200367647058823,20.0,0.0
544,0,544,[187 302 180 603 427],537,5,2290,4.201834862385321,20.0,0.0
545,0,545,[185 228 183 405 483],897,4,2294,4.201465201465202,20.0,0.0
546,0,546,[187 302 180 603 427],537,5,2299,4.202925045703839,20.0,0.0
547,0,547,[187 302 180 603 427],664,5,2304,4.204379562043796,20.0,0.0
548,0,548,[187 302 180 603 427],474,5,2309,4.205828779599272,20.0,0.0
549,0,549,[187 302 180 603 427],458,5,2314,4.207272727272727,20.0,0.0
550,0,550,[187 302 180 603 427],90,5,2319,4.208711433756806,20.0,0.0
551,0,551,[405 185 403 117 151],788,3,2322,4.206521739130435,0.0,0.0
552,0,552,[187 302 180 603 427],90,5,2327,4.207956600361664,20.0,0.0
553,0,553,[187 302 180 603 427],339,5,2332,4.209386281588448,20.0,0.0
554,0,554,[187 302 180 603 427],537,5,2337,4.210810810810811,20.0,0.0
555,0,555,[435 151 132 202 403],295,5,2342,4.212230215827338,0.0,0.0
556,0,556,[187 302 180 603 427],537,5,2347,4.213644524236984,20.0,0.0
557,0,557,[187 302 180 603 427],537,5,2352,4.21505376344086,20.0,0.0
558,0,558,[ 28 216  98 568 273],42,4,2356,4.214669051878354,0.0,20.0
559,0,559,[187 302 180 603 427],664,5,2361,4.2160714285714285,20.0,0.0
560,0,560,[187 302 180 603 427],271,5,2366,4.2174688057041,20.0,0.0
561,0,561,[187 302 180 603 427],664,5,2371,4.2188612099644125,20.0,0.0
562,0,562,[  1 194 168 143 181],125,5,2376,4.220248667850799,0.0,0.0
563,0,563,[216  89   9 191 186],474,5,2381,4.221631205673759,0.0,0.0
564,0,564,[187 302 180 603 427],666,5,2386,4.223008849557522,20.0,0.0
565,0,565,[216 168 237 294 288],533,3,2389,4.220848056537102,0.0,0.0
566,0,566,[187 302 180 603 427],664,5,2394,4.222222222222222,20.0,0.0
567,0,567,[187 302 180 603 427],13,5,2399,4.223591549295775,20.0,0.0
568,0,568,[100 151 195 357   1],533,3,2402,4.221441124780316,20.0,20.0
569,0,569,[187 302 180 603 427],537,5,2407,4.222807017543859,20.0,0.0
570,0,570,[265 127  70  64 204],207,2,2409,4.218914185639229,0.0,20.0
571,0,571,[187 302 180 603 427],13,5,2414,4.22027972027972,20.0,0.0
572,0,572,[ 69 265 182 568  12],92,4,2418,4.219895287958115,20.0,0.0
573,0,573,[172 496 151 275 357],537,3,2421,4.2177700348432055,20.0,0.0
574,0,574,[ 95   9 215  71 127],749,3,2424,4.2156521739130435,0.0,20.0
575,0,575,[271 275 328 135 181],145,4,2428,4.215277777777778,0.0,0.0
576,0,576,[187 302 180 603 427],474,5,2433,4.2166377816291165,20.0,0.0
577,0,577,[187 302 180 603 427],271,5,2438,4.217993079584775,20.0,0.0
578,0,578,[483 318  11 568   7],343,4,2442,4.217616580310881,40.0,0.0
579,0,579,[228 204 211 318  50],454,3,2445,4.2155172413793105,20.0,20.0
580,0,580,[  1 161  64 174 202],533,5,2450,4.216867469879518,0.0,20.0
581,0,581,[403  22   4 515 151],234,3,2453,4.214776632302406,0.0,0.0
582,0,582,[151 496 127 111 180],648,2,2455,4.210977701543739,0.0,20.0
583,0,583,[187 302 603 180 427],271,5,2460,4.212328767123288,20.0,0.0
584,0,584,[655  28 181 403 228],254,4,2464,4.211965811965812,0.0,0.0
585,0,585,[235  95 222   7  96],402,4,2468,4.21160409556314,0.0,0.0
586,0,586,[496 183 180 175 179],59,5,2473,4.212947189097104,0.0,0.0
587,0,587,[187 302 603 180 427],458,5,2478,4.214285714285714,20.0,0.0
588,0,588,[187 302 603 180 427],13,5,2483,4.215619694397284,20.0,0.0
589,0,589,[187 302 603 180 427],90,5,2488,4.216949152542373,20.0,0.0
590,0,590,[187 302 603 180 427],666,5,2493,4.218274111675127,20.0,0.0
591,0,591,[187 302 603 180 427],664,5,2498,4.219594594594595,20.0,0.0
592,0,592,[187 302 603 180 427],271,5,2503,4.220910623946037,20.0,0.0
593,0,593,[187 302 603 180 427],537,5,2508,4.222222222222222,20.0,0.0
594,0,594,[187 302 603 180 427],339,5,2513,4.223529411764706,20.0,0.0
595,0,595,[405 127 125 143  82],892,3,2516,4.221476510067114,0.0,20.0
596,0,596,[143 200  25 568 742],92,0,2516,4.214405360134004,0.0,0.0
597,0,597,[187 302 603 180 427],13,5,2521,4.2157190635451505,20.0,0.0
598,0,598,[187 302 603 180 427],474,5,2526,4.217028380634391,20.0,0.0
599,0,599,[475 174  96 357  69],90,3,2529,4.215,20.0,20.0
600,0,600,[187 302 603 180 427],458,5,2534,4.21630615640599,20.0,0.0
601,0,601,[186  89 195  56 496],59,5,2539,4.217607973421927,0.0,0.0
602,0,602,[151 234   1 282  15],42,5,2544,4.218905472636816,0.0,0.0
603,0,603,[187 302 603 180 427],666,5,2549,4.220198675496689,20.0,0.0
604,0,604,[ 89 125 294 588 135],897,3,2552,4.218181818181818,0.0,0.0
605,0,605,[187 302 603 180 427],664,5,2557,4.2194719471947195,20.0,0.0
606,0,606,[187 302 603 180 427],474,5,2562,4.220757825370676,20.0,0.0
607,0,607,[211 289 168  98 302],271,4,2566,4.220394736842105,0.0,20.0
608,0,608,[204  79 179 282 228],643,3,2569,4.218390804597701,0.0,0.0
609,0,609,[187 302 603 180 427],664,5,2574,4.219672131147541,20.0,0.0
610,0,610,[187 302 603 180 427],537,5,2579,4.220949263502455,20.0,0.0
611,0,611,[271 357 258  22 196],263,3,2582,4.218954248366013,20.0,0.0
612,0,612,[187 302 603 180 427],664,5,2587,4.220228384991843,20.0,0.0
613,0,613,[405 323  96 269 568],13,1,2588,4.214983713355049,0.0,0.0
614,0,614,[187 302 603 180 427],339,5,2593,4.216260162601626,20.0,0.0
615,0,615,[127 176 300 185 318],311,4,2597,4.215909090909091,20.0,20.0
616,0,616,[187 302 603 180 427],537,5,2602,4.217179902755268,20.0,0.0
617,0,617,[187 302 603 180 427],90,5,2607,4.218446601941747,20.0,0.0
618,0,618,[273 435 185  50 168],749,5,2612,4.219709208400646,0.0,20.0
619,0,619,[117  89 238 427 179],271,3,2615,4.217741935483871,0.0,0.0
620,0,620,[172 238 423 197  96],650,4,2619,4.217391304347826,0.0,0.0
621,0,621,[202 275 195 174 186],6,4,2623,4.217041800643087,0.0,20.0
622,0,622,[294 135 496 546 211],882,4,2627,4.21669341894061,0.0,0.0
623,0,623,[187 302 603 180 427],664,5,2632,4.217948717948718,20.0,0.0
624,0,624,[273 172 161  22  70],7,2,2634,4.2144,0.0,0.0
625,0,625,[100  71   1 748 216],749,3,2637,4.212460063897764,0.0,20.0
626,0,626,[ 69 175 135 435 357],85,5,2642,4.21371610845295,20.0,0.0
627,0,627,[187 302 603 180 427],537,5,2647,4.214968152866242,20.0,0.0
628,0,628,[216 471 174  79 245],313,4,2651,4.21462639109698,0.0,20.0
629,0,629,[187 302 603 180 427],13,5,2656,4.215873015873016,20.0,0.0
630,0,630,[187 302 603 180 427],271,5,2661,4.2171156893819335,20.0,0.0
631,0,631,[187 302 603 180 427],664,5,2666,4.218354430379747,20.0,0.0
632,0,632,[187 302 603 180 427],13,5,2671,4.21958925750395,20.0,0.0
633,0,633,[187 302 603 180 427],339,5,2676,4.220820189274448,20.0,0.0
634,0,634,[187 302 603 180 427],271,5,2681,4.2220472440944885,20.0,0.0
635,0,635,[187 302 603 180 427],474,5,2686,4.223270440251572,20.0,0.0
636,0,636,[  1 204 176  70 288],643,3,2689,4.221350078492936,0.0,0.0
637,0,637,[187 302 603 180 427],90,5,2694,4.222570532915361,20.0,0.0
638,0,638,[187 302 603 180 427],664,5,2699,4.22378716744914,20.0,0.0
639,0,639,[187 302 603 180 427],13,5,2704,4.225,20.0,0.0
640,0,640,[187 302 603 180 427],90,5,2709,4.226209048361935,20.0,0.0
641,0,641,[273 483  50 204 194],537,2,2711,4.222741433021807,20.0,20.0
642,0,642,[187 302 603 180 427],474,5,2716,4.223950233281493,20.0,0.0
643,0,643,[187 302 603 180 427],537,5,2721,4.225155279503106,20.0,0.0
644,0,644,[187 302 603 180 427],271,5,2726,4.2263565891472865,20.0,0.0
645,0,645,[191  15 282  98 168],653,1,2727,4.2213622291021675,0.0,20.0
646,0,646,[603 216 237 546 132],533,3,2730,4.219474497681607,20.0,0.0
647,0,647,[187 302 603 180 427],474,5,2735,4.220679012345679,20.0,0.0
648,0,648,[423 135 294 215 282],474,4,2739,4.220338983050848,0.0,0.0
649,0,649,[187 302 603 180 427],339,5,2744,4.2215384615384615,20.0,0.0
650,0,650,[187 302 603 180 427],537,5,2749,4.22273425499232,20.0,0.0
651,0,651,[187 302 603 180 427],90,5,2754,4.223926380368098,20.0,0.0
652,0,652,[187 302 603 180 427],90,5,2759,4.225114854517611,20.0,0.0
653,0,653,[187 302 603 180 427],537,5,2764,4.226299694189603,20.0,0.0
654,0,654,[187 302 603 180 427],271,5,2769,4.227480916030534,20.0,0.0
655,0,655,[187 302 603 180 427],90,5,2774,4.228658536585366,20.0,0.0
656,0,656,[ 71 100   9 603 127],234,3,2777,4.226788432267885,20.0,40.0
657,0,657,[435 111 357 301 174],537,1,2778,4.221884498480243,20.0,20.0
658,0,658,[187 302 603 180 427],90,5,2783,4.223065250379363,20.0,0.0
659,0,659,[ 82  56  70 111 195],125,2,2785,4.21969696969697,0.0,0.0
660,0,660,[ 12 161  71  89 423],378,5,2790,4.2208774583963695,20.0,0.0
661,0,661,[187 302 603 180 427],339,5,2795,4.222054380664653,20.0,0.0
662,0,662,[176 186  69 423   1],892,4,2799,4.221719457013575,0.0,0.0
663,0,663,[187 302 603 180 427],666,5,2804,4.22289156626506,20.0,0.0
664,0,664,[121 118 357   1 515],121,3,2807,4.221052631578948,20.0,0.0
665,0,665,[  1  70 265 742 191],378,5,2812,4.222222222222222,0.0,0.0
666,0,666,[161 603 127 143 180],452,4,2816,4.221889055472264,20.0,20.0
667,0,667,[187 302 603 180 427],339,5,2821,4.223053892215569,20.0,0.0
668,0,668,[187 302 603 180 427],474,5,2826,4.2242152466367715,20.0,0.0
669,0,669,[187 302 603 180 427],458,5,2831,4.2253731343283585,20.0,0.0
670,0,670,[125 161 186 196 195],64,3,2834,4.223546944858421,0.0,0.0
671,0,671,[185  95 288  50  69],234,2,2836,4.220238095238095,0.0,20.0
672,0,672,[191 275 357  28  12],13,2,2838,4.2169390787518575,40.0,0.0
673,0,673,[181 185   9 161 216],234,0,2838,4.210682492581602,0.0,0.0
674,0,674,[187 302 603 180 427],90,5,2843,4.2118518518518515,20.0,0.0
675,0,675,[603   8 228  69 186],506,5,2848,4.21301775147929,20.0,0.0
676,0,676,[515  22 216 508  89],6,3,2851,4.211225997045791,0.0,0.0
677,0,677,[187 302 603 180 427],458,5,2856,4.212389380530974,20.0,0.0
678,0,678,[187 302 603 180 427],474,5,2861,4.213549337260678,20.0,0.0
679,0,679,[ 22 313 385 435 238],474,5,2866,4.214705882352941,0.0,0.0
680,0,680,[187 302 603 180 427],664,5,2871,4.215859030837004,20.0,0.0
681,0,681,[187 302 603 180 427],458,5,2876,4.217008797653959,20.0,0.0
682,0,682,[187 302 603 180 427],666,5,2881,4.218155197657394,20.0,0.0
683,0,683,[179  89  88   7   1],339,5,2886,4.219298245614035,0.0,0.0
684,0,684,[182 302 197 258 196],380,3,2889,4.217518248175183,0.0,0.0
685,0,685,[ 88 187 302 603 180],271,5,2894,4.21865889212828,20.0,0.0
686,0,686,[ 88 187 302 603 180],13,5,2899,4.219796215429403,20.0,0.0
687,0,687,[ 97  89  69 475 323],474,4,2903,4.219476744186046,0.0,0.0
688,0,688,[ 88 187 302 603 180],543,5,2908,4.220609579100145,20.0,0.0
689,0,689,[194 100  11 300 483],666,3,2911,4.218840579710145,20.0,20.0
690,0,690,[ 88 187 302 603 180],474,5,2916,4.219971056439942,20.0,0.0
691,0,691,[ 88 187 302 603 180],474,5,2921,4.221098265895954,20.0,0.0
692,0,692,[ 88 187 302 603 180],543,5,2926,4.222222222222222,20.0,0.0
693,0,693,[403 202 204 180 161],59,4,2930,4.221902017291066,0.0,0.0
694,0,694,[ 88 187 302 603 180],543,5,2935,4.223021582733813,20.0,0.0
695,0,695,[ 88 187 302 603 180],474,5,2940,4.224137931034483,20.0,0.0
696,0,696,[168 333 313   9 286],533,5,2945,4.2252510760401725,0.0,0.0
697,0,697,[ 79  82 427 742 179],650,1,2946,4.2206303724928365,0.0,0.0
698,0,698,[ 88 187 302 603 180],543,5,2951,4.221745350500715,20.0,0.0
699,0,699,[ 88 187 302 603 180],13,5,2956,4.222857142857142,20.0,0.0
700,0,700,[135  11  64   7  96],387,3,2959,4.221112696148359,0.0,0.0
701,0,701,[ 88 187 302 603 180],537,4,2963,4.220797720797721,20.0,0.0
702,0,702,[748 471 111 118 181],454,2,2965,4.217638691322902,0.0,0.0
703,0,703,[187 302 603 180 427],90,5,2970,4.21875,20.0,0.0
704,0,704,[187 302 603 180 427],664,5,2975,4.219858156028369,20.0,0.0
705,0,705,[161 183 313 132 302],380,4,2979,4.219546742209632,0.0,0.0
706,0,706,[183 313   4 182  95],234,3,2982,4.217821782178218,0.0,0.0
707,0,707,[187 302 603 180 427],90,5,2987,4.218926553672317,20.0,0.0
708,0,708,[187 302 603 180 427],90,5,2992,4.2200282087447105,20.0,0.0
709,0,709,[194 276   1 180 143],378,4,2996,4.219718309859155,0.0,0.0
710,0,710,[187 302 603 180 427],339,5,3001,4.220815752461322,20.0,0.0
711,0,711,[294 288 161  69   7],474,3,3004,4.219101123595506,0.0,0.0
712,0,712,[187 302 603 180 427],271,5,3009,4.220196353436185,20.0,0.0
713,0,713,[273 483 222 300 328],479,4,3013,4.219887955182073,20.0,0.0
714,0,714,[  1 176 300 265  22],533,3,3016,4.218181818181818,0.0,0.0
715,0,715,[187 302 603 180 427],339,5,3021,4.2192737430167595,20.0,0.0
716,0,716,[187 302 603 180 427],271,5,3026,4.220362622036262,20.0,0.0
717,0,717,[187 302 603 180 427],664,5,3031,4.221448467966574,20.0,0.0
718,0,718,[ 97 176 195 483  71],897,4,3035,4.221140472878998,20.0,0.0
719,0,719,[187 302 603 180 427],458,5,3040,4.222222222222222,20.0,0.0
720,0,720,[515 191 323 196 100],537,3,3043,4.220527045769765,0.0,20.0
721,0,721,[423 235 121 183 100],328,4,3047,4.2202216066482,0.0,20.0
722,0,722,[ 28  12 143 496 197],378,3,3050,4.218533886583679,20.0,0.0
723,0,723,[187 302 603 180 427],90,5,3055,4.219613259668508,20.0,0.0
724,0,724,[187 302 603 180 427],13,5,3060,4.220689655172414,20.0,0.0
725,0,725,[117 183 318 258 271],328,4,3064,4.220385674931129,20.0,0.0
726,0,726,[187 302 603 180 427],458,5,3069,4.2214580467675376,20.0,0.0
727,0,727,[187 302 603 180 427],271,5,3074,4.222527472527473,20.0,0.0
728,0,728,[187 302 603 180 427],664,5,3079,4.223593964334705,20.0,0.0
729,0,729,[187 302 603 180 427],90,5,3084,4.2246575342465755,20.0,0.0
730,0,730,[187 302 603 180 427],13,5,3089,4.225718194254446,20.0,0.0
731,0,731,[187 302 603 180 427],339,5,3094,4.226775956284153,20.0,0.0
732,0,732,[187 302 603 180 427],458,5,3099,4.227830832196453,20.0,0.0
733,0,733,[204 125 568 185  82],207,3,3102,4.226158038147139,0.0,0.0
734,0,734,[187 302 603 180 427],666,5,3107,4.227210884353742,20.0,0.0
735,0,735,[187 302 603 180 427],271,5,3112,4.228260869565218,20.0,0.0
736,0,736,[187 302 603 180 427],90,5,3117,4.229308005427408,20.0,0.0
737,0,737,[187 302 603 180 427],537,5,3122,4.230352303523035,20.0,0.0
738,0,738,[187 302 603 180 427],458,5,3127,4.2313937753721245,20.0,0.0
739,0,739,[187 302 603 180 427],537,5,3132,4.232432432432432,20.0,0.0
740,0,740,[186 216 405   8 173],6,4,3136,4.232118758434548,0.0,0.0
741,0,741,[ 22 515 588 405  11],840,3,3139,4.230458221024259,0.0,0.0
742,0,742,[187 302 603 180 427],271,5,3144,4.231493943472409,20.0,0.0
743,0,743,[187 302 603 180 427],339,5,3149,4.23252688172043,20.0,0.0
744,0,744,[187 302 603 180 427],339,5,3154,4.233557046979866,20.0,0.0
745,0,745,[187 302 603 180 427],339,5,3159,4.234584450402145,20.0,0.0
746,0,746,[187 302 603 180 427],90,5,3164,4.235609103078983,20.0,0.0
747,0,747,[187 302 603 180 427],271,5,3169,4.2366310160427805,20.0,0.0
748,0,748,[385 118 216 210 357],804,5,3174,4.237650200267023,20.0,0.0
749,0,749,[187 302 603 180 427],339,5,3179,4.238666666666667,20.0,0.0
750,0,750,[187 302 603 180 427],474,5,3184,4.239680426098535,20.0,0.0
751,0,751,[187 302 603 180 427],666,5,3189,4.240691489361702,20.0,0.0
752,0,752,[187 302 603 180 427],474,5,3194,4.241699867197875,20.0,0.0
753,0,753,[ 71 132  98 228  12],234,2,3196,4.2387267904509285,20.0,20.0
754,0,754,[ 56 191  95 175 204],234,1,3197,4.234437086092715,0.0,0.0
755,0,755,[187 302 603 180 427],537,5,3202,4.235449735449736,20.0,0.0
756,0,756,[323 322  50 222 333],113,3,3205,4.233817701453105,0.0,20.0
757,0,757,[187 302 603 180 427],339,5,3210,4.2348284960422165,20.0,0.0
758,0,758,[187 302 603 180 427],90,5,3215,4.235836627140975,20.0,0.0
759,0,759,[153 117 357 183 191],653,3,3218,4.234210526315789,20.0,0.0
760,0,760,[195 118 238  95 403],749,2,3220,4.231274638633377,0.0,0.0
761,0,761,[187 302 603 180 427],339,5,3225,4.232283464566929,20.0,0.0
762,0,762,[187 302 603 180 427],664,5,3230,4.233289646133683,20.0,0.0
763,0,763,[546 151 202  82  97],374,3,3233,4.231675392670157,0.0,0.0
764,0,764,[135 111  25 275 235],145,2,3235,4.228758169934641,0.0,0.0
765,0,765,[187 302 603 180 427],90,5,3240,4.2297650130548305,20.0,0.0
766,0,766,[187 302 603 180 427],537,5,3245,4.230769230769231,20.0,0.0
767,0,767,[187 302 603 180 427],13,5,3250,4.231770833333333,20.0,0.0
768,0,768,[357  50 200  89  56],650,4,3254,4.2314694408322495,20.0,20.0
769,0,769,[187 302 603 180 427],271,5,3259,4.232467532467532,20.0,0.0
770,0,770,[187 302 603 180 427],537,5,3264,4.233463035019455,20.0,0.0
771,0,771,[187 302 603 180 427],458,5,3269,4.234455958549223,20.0,0.0
772,0,772,[655  89 182 271 183],788,2,3271,4.231565329883571,0.0,0.0
773,0,773,[286 194 186 318 197],161,1,3272,4.227390180878553,20.0,0.0
774,0,774,[ 56  28 143  64   7],234,2,3274,4.224516129032258,0.0,0.0
775,0,775,[187 302 603 180 427],90,5,3279,4.225515463917525,20.0,0.0
776,0,776,[515 228 568 403 186],87,4,3283,4.225225225225225,0.0,0.0
777,0,777,[ 88 183 496 197  97],659,4,3287,4.224935732647815,0.0,0.0
778,0,778,[ 28 127 222 265 191],537,2,3289,4.2220795892169445,0.0,20.0
779,0,779,[210 135   4 288 405],59,4,3293,4.221794871794872,0.0,0.0
780,0,780,[202 181  97  15 215],479,2,3295,4.218950064020486,0.0,0.0
781,0,781,[ 82 202   1 187 195],881,5,3300,4.219948849104859,0.0,0.0
782,0,782,[127 118  79 222 194],749,3,3303,4.218390804597701,0.0,20.0
783,0,783,[427 234 121 222 286],328,3,3306,4.216836734693878,0.0,0.0
784,0,784,[187 302 603 180 427],537,5,3311,4.217834394904458,20.0,0.0
785,0,785,[187 302 603 180 427],474,5,3316,4.21882951653944,20.0,0.0
786,0,786,[187 302 603 180 427],13,5,3321,4.21982210927573,20.0,0.0
787,0,787,[187 302 603 180 427],666,5,3326,4.220812182741117,20.0,0.0
788,0,788,[187 302 603 180 427],90,5,3331,4.221799746514575,20.0,0.0
789,0,789,[318 143 197 427 742],533,5,3336,4.222784810126583,20.0,0.0
790,0,790,[187 302 603 180 427],271,5,3341,4.2237673830594185,20.0,0.0
791,0,791,[187 302 603 180 427],537,5,3346,4.224747474747475,20.0,0.0
792,0,792,[357 333 216  89  95],815,2,3348,4.221941992433796,20.0,0.0
793,0,793,[187 302 603 180 427],474,5,3353,4.222921914357682,20.0,0.0
794,0,794,[187 302 603 180 427],474,5,3358,4.223899371069183,20.0,0.0
795,0,795,[187 302 603 180 427],90,5,3363,4.224874371859296,20.0,0.0
796,0,796,[187 302 603 180 427],13,5,3368,4.225846925972396,20.0,0.0
797,0,797,[187 302 603 180 427],90,5,3373,4.226817042606516,20.0,0.0
798,0,798,[187 302 603 180 427],339,5,3378,4.227784730913642,20.0,0.0
799,0,799,[187 302 603 180 427],458,5,3383,4.22875,20.0,0.0
800,0,800,[187 302 603 180 427],474,5,3388,4.229712858926342,20.0,0.0
801,0,801,[117 172  11 471  15],374,3,3391,4.228179551122195,0.0,0.0
802,0,802,[125   1 144  22 121],158,4,3395,4.2278953922789535,0.0,0.0
803,0,803,[216 210  89 118 180],804,5,3400,4.2288557213930345,0.0,0.0
804,0,804,[187 302 603 180 427],474,5,3405,4.229813664596273,20.0,0.0
805,0,805,[187 302 603 180 427],664,5,3410,4.230769230769231,20.0,0.0
806,0,806,[187 302 603 180 427],458,5,3415,4.231722428748451,20.0,0.0
807,0,807,[187 302 603 180 427],666,5,3420,4.232673267326732,20.0,0.0
808,0,808,[ 22 333 271 268 222],145,4,3424,4.23238566131026,0.0,0.0
809,0,809,[187 302 603 180 427],90,5,3429,4.233333333333333,20.0,0.0
810,0,810,[328 153 174 385 568],92,3,3432,4.231812577065352,0.0,20.0
811,0,811,[357  12 186  11 196],892,3,3435,4.230295566502463,40.0,0.0
812,0,812,[187 302 603 180 427],271,5,3440,4.231242312423125,20.0,0.0
813,0,813,[211  98 121 228  22],738,3,3443,4.22972972972973,0.0,20.0
814,0,814,[187 302 603 180 427],90,5,3448,4.230674846625766,20.0,0.0
815,0,815,[318 222 496 186 143],311,3,3451,4.229166666666667,20.0,0.0
816,0,816,[187 302 603 180 427],537,5,3456,4.230110159118727,20.0,0.0
817,0,817,[187 302 603 180 427],664,5,3461,4.2310513447432765,20.0,0.0
818,0,818,[135   4 172 235 200],59,4,3465,4.230769230769231,0.0,0.0
819,0,819,[187 302 603 180 427],13,5,3470,4.2317073170731705,20.0,0.0
820,0,820,[187 302 603 180 427],458,5,3475,4.232643118148599,20.0,0.0
821,0,821,[187 302 603 180 427],271,5,3480,4.233576642335766,20.0,0.0
822,0,822,[483  96   8 322 313],234,3,3483,4.232077764277035,20.0,0.0
823,0,823,[187 302 603 180 427],339,5,3488,4.233009708737864,20.0,0.0
824,0,824,[ 79 182 508 357   1],6,3,3491,4.2315151515151515,20.0,0.0
825,0,825,[187 302 603 180 427],474,5,3496,4.232445520581114,20.0,0.0
826,0,826,[187 302 603 180 427],666,5,3501,4.233373639661427,20.0,0.0
827,0,827,[ 79 289 191 276 202],378,4,3505,4.233091787439614,0.0,0.0
828,0,828,[ 89 318 423 258 161],479,3,3508,4.231604342581424,20.0,0.0
829,0,829,[187 302 603 180 427],664,5,3513,4.232530120481928,20.0,0.0
830,0,830,[187 302 603 180 427],666,5,3518,4.233453670276775,20.0,0.0
831,0,831,[357 172   9 222 100],380,2,3520,4.230769230769231,20.0,20.0
832,0,832,[ 22 195   4 323 471],474,3,3523,4.229291716686674,0.0,0.0
833,0,833,[187 302 603 180 427],537,5,3528,4.23021582733813,20.0,0.0
834,0,834,[187 302 603 180 427],664,5,3533,4.231137724550898,20.0,0.0
835,0,835,[187 302 603 180 427],271,5,3538,4.232057416267943,20.0,0.0
836,0,836,[187 302 603 180 427],458,5,3543,4.232974910394265,20.0,0.0
837,0,837,[187 302 603 180 427],271,5,3548,4.233890214797136,20.0,0.0
838,0,838,[187 302 603 180 427],474,5,3553,4.234803337306317,20.0,0.0
839,0,839,[187 302 603 180 427],271,5,3558,4.235714285714286,20.0,0.0
840,0,840,[187 302 603 180 427],271,5,3563,4.236623067776456,20.0,0.0
841,0,841,[ 50  89 282 483 100],85,3,3566,4.235154394299287,20.0,40.0
842,0,842,[546   7 132 475 183],64,4,3570,4.234875444839858,0.0,0.0
843,0,843,[187 302 603 180 427],474,5,3575,4.235781990521327,20.0,0.0
844,0,844,[187 302 603 180 427],90,5,3580,4.236686390532545,20.0,0.0
845,0,845,[427  97   4 215 111],533,3,3583,4.235224586288416,0.0,0.0
846,0,846,[187 302 603 180 427],474,5,3588,4.236127508854781,20.0,0.0
847,0,847,[187 302 603 180 427],537,5,3593,4.2370283018867925,20.0,0.0
848,0,848,[403 185 173 202   8],13,2,3595,4.234393404004711,0.0,0.0
849,0,849,[187 302 603 180 427],664,5,3600,4.235294117647059,20.0,0.0
850,0,850,[187 302 603 180 427],339,5,3605,4.236192714453584,20.0,0.0
851,0,851,[187 302 603 180 427],537,5,3610,4.237089201877934,20.0,0.0
852,0,852,[496 655 168 100 183],311,4,3614,4.236811254396248,0.0,20.0
853,0,853,[127  98 172 132  50],64,5,3619,4.237704918032787,0.0,60.0
854,0,854,[216 135  15 181 143],378,4,3623,4.237426900584795,0.0,0.0
855,0,855,[118  96 210 176 215],42,4,3627,4.23714953271028,0.0,0.0
856,0,856,[187 302 603 180 427],664,5,3632,4.238039673278879,20.0,0.0
857,0,857,[187 302 603 180 427],271,5,3637,4.238927738927739,20.0,0.0
858,0,858,[187 302 603 180 427],474,5,3642,4.239813736903376,20.0,0.0
859,0,859,[187 302 603 180 427],13,5,3647,4.2406976744186045,20.0,0.0
860,0,860,[187 302 603 180 427],339,5,3652,4.241579558652729,20.0,0.0
861,0,861,[187 302 603 180 427],666,5,3657,4.24245939675174,20.0,0.0
862,0,862,[187 302 603 180 427],339,5,3662,4.243337195828505,20.0,0.0
863,0,863,[187 302 603 180 427],666,5,3667,4.244212962962963,20.0,0.0
864,0,864,[187 302 603 180 427],271,5,3672,4.245086705202312,20.0,0.0
865,0,865,[187 302 603 180 427],271,5,3677,4.245958429561201,20.0,0.0
866,0,866,[187 302 603 180 427],458,5,3682,4.246828143021915,20.0,0.0
867,0,867,[187 302 603 180 427],339,5,3687,4.247695852534562,20.0,0.0
868,0,868,[121 435 588  15  12],194,4,3691,4.24741081703107,20.0,0.0
869,0,869,[237 588 269 210  15],537,0,3691,4.242528735632184,0.0,0.0
870,0,870,[187 302 603 180 427],458,5,3696,4.243398392652124,20.0,0.0
871,0,871,[210   8 508 173  56],334,3,3699,4.24197247706422,0.0,0.0
872,0,872,[ 96 211 202 483 195],313,5,3704,4.242840778923253,20.0,0.0
873,0,873,[187 302 603 180 427],537,5,3709,4.24370709382151,20.0,0.0
874,0,874,[187 302 603 180 427],13,5,3714,4.244571428571429,20.0,0.0
875,0,875,[475  69 143 135 405],374,3,3717,4.243150684931507,0.0,0.0
876,0,876,[385 268 187  12  98],234,2,3719,4.240592930444698,20.0,20.0
877,0,877,[187 302 603 180 427],664,5,3724,4.241457858769932,20.0,0.0
878,0,878,[187 302 603 180 427],666,5,3729,4.242320819112628,20.0,0.0
879,0,879,[187 302 603 180 427],666,5,3734,4.243181818181818,20.0,0.0
880,0,880,[187 302 603 180 427],458,5,3739,4.244040862656073,20.0,0.0
881,0,881,[187 302 603 180 427],339,5,3744,4.244897959183674,20.0,0.0
882,0,882,[238 100 276  89 180],239,4,3748,4.244620611551529,0.0,20.0
883,0,883,[187 302 603 180 427],474,5,3753,4.245475113122172,20.0,0.0
884,0,884,[197  12 423  56 301],537,2,3755,4.242937853107344,20.0,0.0
885,0,885,[187 302 603 180 427],339,5,3760,4.243792325056433,20.0,0.0
886,0,886,[187 302 603 180 427],664,5,3765,4.244644870349493,20.0,0.0
887,0,887,[187 302 603 180 427],666,5,3770,4.245495495495495,20.0,0.0
888,0,888,[187 302 603 180 427],474,5,3775,4.246344206974128,20.0,0.0
889,0,889,[153 135 127 257  50],374,3,3778,4.244943820224719,0.0,40.0
890,0,890,[187 302 603 180 427],339,5,3783,4.245791245791246,20.0,0.0
891,0,891,[187 302 603 180 427],458,5,3788,4.246636771300448,20.0,0.0
892,0,892,[187 302 603 180 427],537,5,3793,4.247480403135499,20.0,0.0
893,0,893,[187 302 603 180 427],13,5,3798,4.248322147651007,20.0,0.0
894,0,894,[187 302 603 180 427],666,5,3803,4.249162011173184,20.0,0.0
895,0,895,[228 302  28 496  96],883,3,3806,4.247767857142857,0.0,0.0
896,0,896,[ 97 258 403 238 427],339,3,3809,4.246376811594203,0.0,0.0
897,0,897,[187 302 603 180 427],90,5,3814,4.247216035634744,20.0,0.0
898,0,898,[187 302 603 180 427],474,5,3819,4.24805339265851,20.0,0.0
899,0,899,[269 508  79 135 257],378,4,3823,4.247777777777777,0.0,0.0
900,0,900,[187 302 603 180 427],537,5,3828,4.248612652608213,20.0,0.0
901,0,901,[187 302 603 180 427],666,5,3833,4.249445676274944,20.0,0.0
902,0,902,[187 302 603 180 427],90,5,3838,4.250276854928018,20.0,0.0
903,0,903,[ 64 186 187 143 323],881,3,3841,4.248893805309734,0.0,0.0
904,0,904,[187 302 603 180 427],271,5,3846,4.249723756906078,20.0,0.0
905,0,905,[187 302 603 180 427],458,5,3851,4.250551876379691,20.0,0.0
906,0,906,[187 302 603 180 427],339,5,3856,4.251378169790518,20.0,0.0
907,0,907,[655 269 211 179 195],537,2,3858,4.248898678414097,0.0,0.0
908,0,908,[187 302 603 180 427],271,5,3863,4.2497249724972495,20.0,0.0
909,0,909,[187 302 603 180 427],271,5,3868,4.2505494505494505,20.0,0.0
910,0,910,[187 302 603 180 427],666,5,3873,4.251372118551043,20.0,0.0
911,0,911,[187 302 603 180 427],666,5,3878,4.25219298245614,20.0,0.0
912,0,912,[195 515  11 185 117],339,3,3881,4.2508214676889375,0.0,0.0
913,0,913,[187 302 603 180 427],537,5,3886,4.25164113785558,20.0,0.0
914,0,914,[187 302 603 180 427],537,5,3891,4.252459016393443,20.0,0.0
915,0,915,[187 302 603 180 427],13,5,3896,4.253275109170306,20.0,0.0
916,0,916,[187 302 603 180 427],13,5,3901,4.254089422028353,20.0,0.0
917,0,917,[187 302 603 180 427],271,5,3906,4.254901960784314,20.0,0.0
918,0,918,[200 100 294   4 275],7,4,3910,4.25462459194777,0.0,20.0
919,0,919,[187 302 603 180 427],537,5,3915,4.255434782608695,20.0,0.0
920,0,920,[187 302 603 180 427],537,5,3920,4.256243213897937,20.0,0.0
921,0,921,[187 302 603 180 427],474,5,3925,4.25704989154013,20.0,0.0
922,0,922,[187 302 603 180 427],537,5,3930,4.257854821235103,20.0,0.0
923,0,923,[597 496 210 191 483],7,4,3934,4.257575757575758,20.0,0.0
924,0,924,[187 302 603 180 427],664,5,3939,4.258378378378378,20.0,0.0
925,0,925,[100  50  28  64 301],119,5,3944,4.259179265658747,0.0,40.0
926,0,926,[258  69 257 204 269],666,2,3946,4.256742179072276,0.0,0.0
927,0,927,[187 302 603 180 427],664,5,3951,4.257543103448276,20.0,0.0
928,0,928,[187 302 603 180 427],664,5,3956,4.258342303552206,20.0,0.0
929,0,929,[187 302 603 180 427],271,5,3961,4.259139784946236,20.0,0.0
930,0,930,[265 257 655 200 323],804,4,3965,4.258861439312567,0.0,0.0
931,0,931,[187 302 603 180 427],339,5,3970,4.259656652360515,20.0,0.0
932,0,932,[187 302 603 180 427],458,5,3975,4.260450160771704,20.0,0.0
933,0,933,[288 186 215 294   4],804,4,3979,4.26017130620985,0.0,0.0
934,0,934,[ 89 111 289 182 117],378,3,3982,4.258823529411765,0.0,0.0
935,0,935,[187 302 603 180 427],90,5,3987,4.259615384615385,20.0,0.0
936,0,936,[187 302 603 180 427],537,5,3992,4.2604055496264674,20.0,0.0
937,0,937,[483 187  82 288 173],59,5,3997,4.2611940298507465,20.0,0.0
938,0,938,[187 302 603 180 427],537,5,4002,4.261980830670926,20.0,0.0
939,0,939,[275  28 143 742 210],95,4,4006,4.261702127659574,0.0,0.0
940,0,940,[ 56 197 258 176 269],659,5,4011,4.262486716259299,0.0,0.0
941,0,941,[195 135 172  70 185],95,3,4014,4.261146496815287,0.0,0.0
942,0,942,[187 302 603 180 427],13,5,4019,4.261930010604454,20.0,0.0
943,0,943,[187 302 603 180 427],537,5,4024,4.262711864406779,20.0,0.0
944,0,944,[187 302 603 180 427],474,5,4029,4.2634920634920634,20.0,0.0
945,0,945,[173 300 328 546 200],378,2,4031,4.261099365750528,0.0,0.0
946,0,946,[187 302 603 180 427],458,5,4036,4.261879619852165,20.0,0.0
947,0,947,[187 302 603 180 427],13,5,4041,4.262658227848101,20.0,0.0
948,0,948,[187 302 603 180 427],339,5,4046,4.263435194942044,20.0,0.0
949,0,949,[187 302 603 180 427],271,5,4051,4.2642105263157895,20.0,0.0
950,0,950,[187 302 603 180 427],458,5,4056,4.264984227129338,20.0,0.0
951,0,951,[191 323 333 508 328],537,2,4058,4.262605042016807,0.0,0.0
952,0,952,[187 302 603 180 427],664,5,4063,4.263378803777544,20.0,0.0
953,0,953,[187 302 603 180 427],474,5,4068,4.264150943396227,20.0,0.0
954,0,954,[ 79  71 300 215 181],85,3,4071,4.26282722513089,0.0,0.0
955,0,955,[  1 288 161  97 211],64,3,4074,4.2615062761506275,0.0,0.0
956,0,956,[187 302 603 180 427],458,5,4079,4.262277951933124,20.0,0.0
957,0,957,[187 302 603 180 427],339,5,4084,4.263048016701461,20.0,0.0
958,0,958,[187 302 603 180 427],271,5,4089,4.263816475495307,20.0,0.0
959,0,959,[515 151 257 568 294],95,4,4093,4.263541666666667,0.0,0.0
960,0,960,[ 70  96 179 202 483],234,1,4094,4.260145681581686,20.0,0.0
961,0,961,[187 302 603 180 427],271,5,4099,4.260914760914761,20.0,0.0
962,0,962,[187 302 603 180 427],664,5,4104,4.261682242990654,20.0,0.0
963,0,963,[187 302 603 180 427],458,5,4109,4.262448132780083,20.0,0.0
964,0,964,[187 302 603 180 427],90,5,4114,4.263212435233161,20.0,0.0
965,0,965,[187 302 603 180 427],664,5,4119,4.263975155279503,20.0,0.0
966,0,966,[144 111 302 151  11],833,3,4122,4.2626680455015515,0.0,0.0
967,0,967,[187 302 603 180 427],664,5,4127,4.2634297520661155,20.0,0.0
968,0,968,[187 302 603 180 427],339,5,4132,4.264189886480908,20.0,0.0
969,0,969,[187 302 603 180 427],666,5,4137,4.264948453608247,20.0,0.0
970,0,970,[187 302 603 180 427],666,5,4142,4.265705458290422,20.0,0.0
971,0,971,[187 302 603 180 427],537,5,4147,4.266460905349795,20.0,0.0
972,0,972,[187 302 603 180 427],664,5,4152,4.2672147995889,20.0,0.0
973,0,973,[187 302 603 180 427],537,5,4157,4.267967145790554,20.0,0.0
974,0,974,[196 144  28 234 257],374,3,4160,4.266666666666667,0.0,0.0
975,0,975,[187 302 603 180 427],13,5,4165,4.267418032786885,20.0,0.0
976,0,976,[200 186 238  97  96],881,0,4165,4.263050153531218,0.0,0.0
977,0,977,[546 153 300  70 655],64,2,4167,4.2607361963190185,0.0,0.0
978,0,978,[187 302 603 180 427],666,5,4172,4.261491317671093,20.0,0.0
979,0,979,[204 323  88 322 125],881,3,4175,4.260204081632653,0.0,0.0
980,0,980,[187 302 603 180 427],90,5,4180,4.260958205912335,20.0,0.0
981,0,981,[187 302 603 180 427],339,5,4185,4.261710794297352,20.0,0.0
982,0,982,[187 302 603 180 427],537,5,4190,4.262461851475076,20.0,0.0
983,0,983,[187 302 603 180 427],458,5,4195,4.263211382113822,20.0,0.0
984,0,984,[187 302 603 180 427],474,5,4200,4.2639593908629445,20.0,0.0
985,0,985,[187 302 603 180 427],474,5,4205,4.264705882352941,20.0,0.0
986,0,986,[237 496 405 111 181],537,1,4206,4.261398176291793,0.0,0.0
987,0,987,[187 302 603 180 427],666,5,4211,4.262145748987854,20.0,0.0
988,0,988,[546 195  11   7 289],92,3,4214,4.260869565217392,0.0,0.0
989,0,989,[187 302 603 180 427],664,5,4219,4.261616161616161,20.0,0.0
990,0,990,[187 302 603 180 427],666,5,4224,4.2623612512613525,20.0,0.0
991,0,991,[235 275 597 185 268],699,2,4226,4.26008064516129,0.0,0.0
992,0,992,[176 121 172 168  15],77,2,4228,4.257804632426989,0.0,0.0
993,0,993,[187 302 603 180 427],458,5,4233,4.258551307847083,20.0,0.0
994,0,994,[211 181 234 318  22],454,2,4235,4.256281407035176,20.0,0.0
995,0,995,[496 173  79 483 197],406,3,4238,4.255020080321285,20.0,0.0
996,0,996,[  9 655 111 423 183],13,4,4242,4.254764292878636,0.0,0.0
997,0,997,[187 302 603 180 427],664,5,4247,4.255511022044089,20.0,0.0
998,0,998,[111  70 271 174 238],479,4,4251,4.255255255255255,0.0,20.0
999,0,999,[ 89 179 186 222 483],194,3,4254,4.254,20.0,0.0
1000,0,1000,[187 302 603 180 427],474,5,4259,4.254745254745255,20.0,0.0
1001,0,1001,[187 302 603 180 427],339,5,4264,4.2554890219560875,20.0,0.0
1002,0,1002,[187 302 603 180 427],13,5,4269,4.256231306081755,20.0,0.0
1003,0,1003,[187 302 603 180 427],474,5,4274,4.256972111553785,20.0,0.0
1004,0,1004,[187 302 603 180 427],339,5,4279,4.25771144278607,20.0,0.0
1005,0,1005,[187 302 603 180 427],474,5,4284,4.258449304174951,20.0,0.0
1006,0,1006,[187 302 603 180 427],13,5,4289,4.259185700099305,20.0,0.0
1007,0,1007,[357 179 423 515  28],899,3,4292,4.257936507936508,20.0,0.0
1008,0,1008,[ 12 174 385  56 302],10,5,4297,4.258671952428147,20.0,20.0
1009,0,1009,[289  50 435 135 222],881,2,4299,4.256435643564356,0.0,20.0
1010,0,1010,[286 588 182   8 191],458,5,4304,4.2571711177052425,0.0,0.0
1011,0,1011,[187 302 603 180 427],458,5,4309,4.257905138339921,20.0,0.0
1012,0,1012,[187 302 603 180 427],474,5,4314,4.258637709772952,20.0,0.0
1013,0,1013,[187 302 603 180 427],271,5,4319,4.259368836291913,20.0,0.0
1014,0,1014,[187 302 603 180 427],666,5,4324,4.260098522167488,20.0,0.0
1015,0,1015,[187 302 603 180 427],271,5,4329,4.2608267716535435,20.0,0.0
1016,0,1016,[187 302 603 180 427],271,5,4334,4.261553588987217,20.0,0.0
1017,0,1017,[187 302 603 180 427],271,5,4339,4.262278978388998,20.0,0.0
1018,0,1018,[187 302 603 180 427],271,5,4344,4.263002944062807,20.0,0.0
1019,0,1019,[187 302 603 180 427],458,5,4349,4.263725490196078,20.0,0.0
1020,0,1020,[187 302 603 180 427],537,5,4354,4.264446620959843,20.0,0.0
1021,0,1021,[187 302 603 180 427],339,5,4359,4.265166340508806,20.0,0.0
1022,0,1022,[228 471 603 322 180],537,2,4361,4.262952101661779,20.0,0.0
1023,0,1023,[ 79   9 234 185 210],13,1,4362,4.259765625,0.0,0.0
1024,0,1024,[174 191  88 289 318],537,2,4364,4.257560975609756,20.0,20.0
1025,0,1025,[187 302 603 180 427],13,5,4369,4.258284600389864,20.0,0.0
1026,0,1026,[187 302 603 180 427],271,5,4374,4.259006815968841,20.0,0.0
1027,0,1027,[187 302 603 180 427],90,5,4379,4.259727626459144,20.0,0.0
1028,0,1028,[742 173 294 172 210],378,4,4383,4.259475218658892,0.0,0.0
1029,0,1029,[187 302 603 180 427],13,5,4388,4.260194174757282,20.0,0.0
1030,0,1030,[ 28  95 181   7 175],279,2,4390,4.25800193986421,0.0,0.0
1031,0,1031,[187 302 603 180 427],537,5,4395,4.258720930232558,20.0,0.0
1032,0,1032,[187 302 603 180 427],339,5,4400,4.259438528557599,20.0,0.0
1033,0,1033,[187 302 603 180 427],339,5,4405,4.2601547388781436,20.0,0.0
1034,0,1034,[187 302 603 180 427],664,5,4410,4.260869565217392,20.0,0.0
1035,0,1035,[187 302 603 180 427],537,5,4415,4.261583011583012,20.0,0.0
1036,0,1036,[187 302 603 180 427],271,5,4420,4.262295081967213,20.0,0.0
1037,0,1037,[187 302 603 180 427],666,5,4425,4.263005780346821,20.0,0.0
1038,0,1038,[ 89  64 100 197 180],6,5,4430,4.263715110683349,0.0,20.0
1039,0,1039,[ 22 174 161 515 153],650,3,4433,4.2625,0.0,20.0
1040,0,1040,[187 302 603 180 427],664,5,4438,4.263208453410183,20.0,0.0
1041,0,1041,[187 302 603 180 427],13,5,4443,4.263915547024952,20.0,0.0
1042,0,1042,[275 204 276 181  95],334,4,4447,4.26366251198466,0.0,0.0
1043,0,1043,[471 186 546 655 168],7,5,4452,4.264367816091954,0.0,0.0
1044,0,1044,[187 302 603 180 427],537,5,4457,4.265071770334928,20.0,0.0
1045,0,1045,[568 286 238 173  98],488,2,4459,4.262906309751434,0.0,20.0
1046,0,1046,[187 302 603 180 427],666,5,4464,4.263610315186247,20.0,0.0
1047,0,1047,[187 302 603 180 427],666,5,4469,4.2643129770992365,20.0,0.0
1048,0,1048,[185 151 257 357 237],6,2,4471,4.262154432793136,20.0,0.0
1049,0,1049,[187 302 603 180 427],458,5,4476,4.2628571428571425,20.0,0.0
1050,0,1050,[187 302 603 180 427],474,5,4481,4.263558515699334,20.0,0.0
1051,0,1051,[187 302 603 180 427],458,5,4486,4.26425855513308,20.0,0.0
1052,0,1052,[187 302 603 180 427],458,5,4491,4.264957264957265,20.0,0.0
1053,0,1053,[187 302 603 180 427],458,5,4496,4.265654648956357,20.0,0.0
1054,0,1054,[187 302 603 180 427],537,5,4501,4.266350710900474,20.0,0.0
1055,0,1055,[  7 508 215 100 210],378,5,4506,4.267045454545454,0.0,20.0
1056,0,1056,[187 302 603 180 427],666,5,4511,4.267738883632924,20.0,0.0
1057,0,1057,[187 302 603 180 427],537,5,4516,4.2684310018903595,20.0,0.0
1058,0,1058,[143 151 211  79 742],313,2,4518,4.26628895184136,0.0,0.0
1059,0,1059,[187 302 603 180 427],271,5,4523,4.266981132075472,20.0,0.0
1060,0,1060,[111 204 143 117 357],234,1,4524,4.263901979264844,20.0,0.0
1061,0,1061,[187 302 603 180 427],474,5,4529,4.264595103578155,20.0,0.0
1062,0,1062,[ 22 202 168 515 127],804,4,4533,4.264346190028222,0.0,20.0
1063,0,1063,[187 302 603 180 427],664,5,4538,4.265037593984962,20.0,0.0
1064,0,1064,[187 302 603 180 427],474,5,4543,4.265727699530516,20.0,0.0
1065,0,1065,[187 302 603 180 427],339,5,4548,4.266416510318949,20.0,0.0
1066,0,1066,[187 302 603 180 427],666,5,4553,4.2671040299906275,20.0,0.0
1067,0,1067,[168  89 204 323 282],881,3,4556,4.265917602996255,0.0,0.0
1068,0,1068,[187 302 603 180 427],537,5,4561,4.266604303086997,20.0,0.0
1069,0,1069,[187 302 603 180 427],339,5,4566,4.267289719626168,20.0,0.0
1070,0,1070,[187 302 603 180 427],13,5,4571,4.26797385620915,20.0,0.0
1071,0,1071,[187 302 603 180 427],90,5,4576,4.268656716417911,20.0,0.0
1072,0,1072,[143 210  11 204  95],897,3,4579,4.267474370922646,0.0,0.0
1073,0,1073,[121 496 568 181 196],42,5,4584,4.268156424581005,0.0,0.0
1074,0,1074,[187 302 603 180 427],474,5,4589,4.268837209302325,20.0,0.0
1075,0,1075,[187 302 603 180 427],537,5,4594,4.269516728624535,20.0,0.0
1076,0,1076,[187 302 603 180 427],664,5,4599,4.270194986072424,20.0,0.0
1077,0,1077,[175 168 471 275 597],7,4,4603,4.269944341372913,0.0,0.0
1078,0,1078,[143 180 144 294 234],659,5,4608,4.270620945319741,0.0,0.0
1079,0,1079,[187 302 603 180 427],13,5,4613,4.271296296296296,20.0,0.0
1080,0,1080,[187 302 603 180 427],666,5,4618,4.271970397779834,20.0,0.0
1081,0,1081,[187 302 603 180 427],339,5,4623,4.27264325323475,20.0,0.0
1082,0,1082,[187 302 603 180 427],458,5,4628,4.27331486611265,20.0,0.0
1083,0,1083,[405 568 118 168 597],374,4,4632,4.273062730627307,0.0,0.0
1084,0,1084,[187 302 603 180 427],664,5,4637,4.273732718894009,20.0,0.0
1085,0,1085,[187 302 603 180 427],13,5,4642,4.274401473296501,20.0,0.0
1086,0,1086,[282  22 435 181 200],455,4,4646,4.274149034038638,0.0,0.0
1087,0,1087,[187 302 603 180 427],474,5,4651,4.274816176470588,20.0,0.0
1088,0,1088,[187 302 603 180 427],474,5,4656,4.2754820936639115,20.0,0.0
1089,0,1089,[187 302 603 180 427],458,5,4661,4.276146788990825,20.0,0.0
1090,0,1090,[187 302 603 180 427],90,5,4666,4.276810265811182,20.0,0.0
1091,0,1091,[187 302 603 180 427],474,5,4671,4.277472527472527,20.0,0.0
1092,0,1092,[187 302 603 180 427],271,5,4676,4.278133577310156,20.0,0.0
1093,0,1093,[187 302 603 180 427],537,5,4681,4.278793418647166,20.0,0.0
1094,0,1094,[187 302 603 180 427],458,5,4686,4.279452054794521,20.0,0.0
1095,0,1095,[187 302 603 180 427],271,5,4691,4.280109489051095,20.0,0.0
1096,0,1096,[187 302 603 180 427],458,5,4696,4.280765724703738,20.0,0.0
1097,0,1097,[273 151   1   7  56],59,3,4699,4.27959927140255,0.0,0.0
1098,0,1098,[187 302 603 180 427],458,5,4704,4.280254777070064,20.0,0.0
1099,0,1099,[187 302 603 180 427],474,5,4709,4.280909090909091,20.0,0.0
1100,0,1100,[187 302 603 180 427],666,5,4714,4.281562216167121,20.0,0.0
1101,0,1101,[187 302 603 180 427],666,5,4719,4.282214156079855,20.0,0.0
1102,0,1102,[187 302 603 180 427],13,5,4724,4.2828649138712604,20.0,0.0
1103,0,1103,[187 302 603 180 427],664,5,4729,4.283514492753623,20.0,0.0
1104,0,1104,[187 302 603 180 427],90,5,4734,4.284162895927602,20.0,0.0
1105,0,1105,[187 302 603 180 427],339,5,4739,4.284810126582278,20.0,0.0
1106,0,1106,[546   7 144  71 322],234,0,4739,4.280939476061428,0.0,0.0
1107,0,1107,[187 302 603 180 427],13,5,4744,4.281588447653429,20.0,0.0
1108,0,1108,[ 50  11 678  28 187],474,4,4748,4.281334535617674,0.0,20.0
1109,0,1109,[187 302 603 180 427],666,5,4753,4.281981981981982,20.0,0.0
1110,0,1110,[187 302 603 180 427],271,5,4758,4.282628262826282,20.0,0.0
1111,0,1111,[187 302 603 180 427],271,5,4763,4.283273381294964,20.0,0.0
1112,0,1112,[187 302 603 180 427],339,5,4768,4.283917340521114,20.0,0.0
1113,0,1113,[187 302 603 180 427],271,5,4773,4.284560143626571,20.0,0.0
1114,0,1114,[187 302 603 180 427],664,5,4778,4.285201793721973,20.0,0.0
1115,0,1115,[194  97  22   7 257],378,5,4783,4.28584229390681,0.0,0.0
1116,0,1116,[ 64 175  88 385   4],207,2,4785,4.283795881826321,0.0,0.0
1117,0,1117,[187 302 603 180 427],339,5,4790,4.284436493738819,20.0,0.0
1118,0,1118,[187 302 603 180 427],13,5,4795,4.285075960679178,20.0,0.0
1119,0,1119,[ 96 294 153 121   4],538,2,4797,4.283035714285714,0.0,0.0
1120,0,1120,[187 302 603 180 427],271,5,4802,4.283675289919715,20.0,0.0
1121,0,1121,[ 22  97  70  89 286],788,4,4806,4.283422459893048,0.0,0.0
1122,0,1122,[183  11 117 603 423],643,4,4810,4.283170080142476,20.0,0.0
1123,0,1123,[187 302 603 180 427],537,5,4815,4.2838078291814945,20.0,0.0
1124,0,1124,[597  88 588 215 173],378,4,4819,4.283555555555555,0.0,0.0
1125,0,1125,[187 302 603 180 427],537,5,4824,4.284191829484902,20.0,0.0
1126,0,1126,[742 161 121  79 276],378,5,4829,4.284826974267968,0.0,0.0
1127,0,1127,[187 302 603 180 427],474,5,4834,4.285460992907802,20.0,0.0
1128,0,1128,[187 302 603 180 427],666,5,4839,4.286093888396811,20.0,0.0
1129,0,1129,[ 12  11 175 237  22],207,1,4840,4.283185840707965,20.0,0.0
1130,0,1130,[187 302 603 180 427],664,5,4845,4.2838196286472146,20.0,0.0
1131,0,1131,[187 302 603 180 427],90,5,4850,4.284452296819788,20.0,0.0
1132,0,1132,[185 211   7  88 127],474,5,4855,4.285083848190644,0.0,20.0
1133,0,1133,[187 302 603 180 427],339,5,4860,4.285714285714286,20.0,0.0
1134,0,1134,[187 302 603 180 427],339,5,4865,4.286343612334802,20.0,0.0
1135,0,1135,[187 302 603 180 427],13,5,4870,4.286971830985915,20.0,0.0
1136,0,1136,[187 302 603 180 427],271,5,4875,4.287598944591029,20.0,0.0
1137,0,1137,[187 302 603 180 427],537,5,4880,4.288224956063269,20.0,0.0
1138,0,1138,[187 302 603 180 427],90,5,4885,4.288849868305531,20.0,0.0
1139,0,1139,[187 302 603 180 427],90,5,4890,4.2894736842105265,20.0,0.0
1140,0,1140,[742 144 257  96 588],454,3,4893,4.288343558282208,0.0,0.0
1141,0,1141,[187 302 603 180 427],537,5,4898,4.288966725043783,20.0,0.0
1142,0,1142,[187 302 603 180 427],90,5,4903,4.289588801399825,20.0,0.0
1143,0,1143,[187 302 603 180 427],474,5,4908,4.29020979020979,20.0,0.0
1144,0,1144,[187 302 603 180 427],13,5,4913,4.290829694323144,20.0,0.0
1145,0,1145,[187 302 603 180 427],474,5,4918,4.291448516579407,20.0,0.0
1146,0,1146,[174 215   1  79 475],648,3,4921,4.290322580645161,0.0,20.0
1147,0,1147,[  8  50 100  89 333],328,3,4924,4.289198606271777,0.0,40.0
1148,0,1148,[181 127 300 289  69],537,1,4925,4.286335944299391,0.0,20.0
1149,0,1149,[187 302 603 180 427],339,5,4930,4.28695652173913,20.0,0.0
1150,0,1150,[187 302 603 180 427],90,5,4935,4.287576020851434,20.0,0.0
1151,0,1151,[186   9 275 194 180],271,5,4940,4.288194444444445,0.0,0.0
1152,0,1152,[202 257  98  71 204],840,3,4943,4.287077189939289,0.0,20.0
1153,0,1153,[187 302 603 180 427],271,5,4948,4.287694974003466,20.0,0.0
1154,0,1154,[187 302 603 180 427],90,5,4953,4.288311688311689,20.0,0.0
1155,0,1155,[187 302 603 180 427],339,5,4958,4.288927335640138,20.0,0.0
1156,0,1156,[187 302 603 180 427],664,5,4963,4.289541918755402,20.0,0.0
1157,0,1157,[187 302 603 180 427],474,5,4968,4.290155440414508,20.0,0.0
1158,0,1158,[187 302 603 180 427],271,5,4973,4.29076790336497,20.0,0.0
1159,0,1159,[187 302 603 180 427],666,5,4978,4.291379310344827,20.0,0.0
1160,0,1160,[118 187 200 234   1],343,2,4980,4.289405684754522,0.0,0.0
1161,0,1161,[423 117  50 273 195],892,5,4985,4.290017211703959,0.0,20.0
1162,0,1162,[187 302 603 180 427],474,5,4990,4.290627687016337,20.0,0.0
1163,0,1163,[187 302 603 180 427],664,5,4995,4.291237113402062,20.0,0.0
1164,0,1164,[ 95 273  79 121 271],102,1,4996,4.288412017167382,0.0,0.0
1165,0,1165,[187 302 603 180 427],339,5,5001,4.289022298456261,20.0,0.0
1166,0,1166,[194  15 318  98 118],311,4,5005,4.288774635818338,20.0,20.0
1167,0,1167,[234 135 174  96 181],804,4,5009,4.288527397260274,0.0,20.0
1168,0,1168,[187 302 603 180 427],458,5,5014,4.289136013686912,20.0,0.0
1169,0,1169,[187 302 603 180 427],271,5,5019,4.28974358974359,20.0,0.0
1170,0,1170,[187 302 603 180 427],458,5,5024,4.290350128095644,20.0,0.0
1171,0,1171,[204 143 196 238 215],378,4,5028,4.290102389078498,0.0,0.0
1172,0,1172,[187 302 603 180 427],666,5,5033,4.290707587382779,20.0,0.0
1173,0,1173,[187 302 603 180 427],474,5,5038,4.2913117546848385,20.0,0.0
1174,0,1174,[185 183 135   7  89],406,5,5043,4.2919148936170215,0.0,0.0
1175,0,1175,[187 302 603 180 427],271,5,5048,4.292517006802721,20.0,0.0
1176,0,1176,[186  95  97 161 258],843,1,5049,4.289719626168225,0.0,0.0
1177,0,1177,[187 302 603 180 427],13,5,5054,4.290322580645161,20.0,0.0
1178,0,1178,[187 302 603 180 427],664,5,5059,4.290924512298558,20.0,0.0
1179,0,1179,[  8 357 282 222 237],85,2,5061,4.288983050847458,20.0,0.0
1180,0,1180,[269 282 211 289 187],85,2,5063,4.287044877222693,0.0,0.0
1181,0,1181,[132  70  82 318 187],308,4,5067,4.286802030456853,20.0,0.0
1182,0,1182,[195 302 603 161 748],524,2,5069,4.28486897717667,20.0,0.0
1183,0,1183,[172 168  22 135 125],234,2,5071,4.2829391891891895,0.0,0.0
1184,0,1184,[187 302 603 180 427],537,5,5076,4.283544303797468,20.0,0.0
1185,0,1185,[ 71 210 546 172 222],897,5,5081,4.2841483979763915,0.0,0.0
1186,0,1186,[187 302 603 180 427],271,5,5086,4.28475147430497,20.0,0.0
1187,0,1187,[ 64 234  11   9 237],234,2,5088,4.282828282828283,0.0,0.0
1188,0,1188,[187 302 603 180 427],90,5,5093,4.283431455004205,20.0,0.0
1189,0,1189,[135 168 258 172 546],666,4,5097,4.283193277310924,0.0,0.0
1190,0,1190,[187 302 603 180 427],666,5,5102,4.283795130142737,20.0,0.0
1191,0,1191,[275 151 153  98  28],536,4,5106,4.283557046979865,0.0,20.0
1192,0,1192,[187 302 603 180 427],339,5,5111,4.284157585917854,20.0,0.0
1193,0,1193,[ 79 235 238 172  50],158,4,5115,4.28391959798995,0.0,20.0
1194,0,1194,[187 302 603 180 427],13,5,5120,4.2845188284518825,20.0,0.0
1195,0,1195,[187 302 603 180 427],90,5,5125,4.285117056856187,20.0,0.0
1196,0,1196,[187 302 603 180 427],474,5,5130,4.285714285714286,20.0,0.0
1197,0,1197,[181 588 357 435 286],144,5,5135,4.286310517529215,20.0,0.0
1198,0,1198,[180   9  25 597 403],92,3,5138,4.285237698081735,0.0,0.0
1199,0,1199,[ 70 222 168 405 197],474,4,5142,4.285,0.0,0.0
1200,0,1200,[187 302 603 180 427],271,5,5147,4.285595337218984,20.0,0.0
1201,0,1201,[187 302 603 180 427],664,5,5152,4.286189683860233,20.0,0.0
1202,0,1202,[187 302 603 180 427],271,5,5157,4.286783042394015,20.0,0.0
1203,0,1203,[181 323  28 237 655],474,4,5161,4.2865448504983386,0.0,0.0
1204,0,1204,[ 97 385 175  25  96],537,1,5162,4.283817427385892,0.0,0.0
1205,0,1205,[187 302 603 180 427],537,5,5167,4.284411276948591,20.0,0.0
1206,0,1206,[187 302 603 180 427],339,5,5172,4.285004142502071,20.0,0.0
1207,0,1207,[211 385 204 403 186],653,3,5175,4.283940397350993,0.0,0.0
1208,0,1208,[191 508 276 357  79],669,1,5176,4.281224152191895,20.0,0.0
1209,0,1209,[187 302 603 180 427],90,5,5181,4.281818181818182,20.0,0.0
1210,0,1210,[187 302 603 180 427],537,5,5186,4.282411230388109,20.0,0.0
1211,0,1211,[ 15 121 588 238 118],59,4,5190,4.282178217821782,0.0,0.0
1212,0,1212,[187 302 603 180 427],90,5,5195,4.282769991755977,20.0,0.0
1213,0,1213,[187 302 603 180 427],13,5,5200,4.283360790774299,20.0,0.0
1214,0,1214,[427 265 289 183  79],334,3,5203,4.282304526748971,0.0,0.0
1215,0,1215,[187 302 603 180 427],339,5,5208,4.282894736842105,20.0,0.0
1216,0,1216,[179  28  89  79 144],7,5,5213,4.2834839769926045,0.0,0.0
1217,0,1217,[187 302 603 180 427],271,5,5218,4.284072249589491,20.0,0.0
1218,0,1218,[187 302 603 180 427],474,5,5223,4.284659557013946,20.0,0.0
1219,0,1219,[234 176 288 100 289],474,3,5226,4.283606557377049,0.0,20.0
1220,0,1220,[282 238 127 496  28],95,5,5231,4.284193284193284,0.0,20.0
1221,0,1221,[187 302 603 180 427],458,5,5236,4.284779050736497,20.0,0.0
1222,0,1222,[187 302 603 180 427],474,5,5241,4.285363859362224,20.0,0.0
1223,0,1223,[265 132 196 475 174],92,4,5245,4.285130718954249,0.0,20.0
1224,0,1224,[202 118 186 153 323],804,5,5250,4.285714285714286,0.0,0.0
1225,0,1225,[496 127 121  71 405],815,3,5253,4.284665579119086,0.0,20.0
1226,0,1226,[187 302 603 180 427],537,5,5258,4.285248573757131,20.0,0.0
1227,0,1227,[187 302 603 180 427],90,5,5263,4.285830618892508,20.0,0.0
1228,0,1228,[  7 210 515  11 127],474,5,5268,4.286411716842962,0.0,20.0
1229,0,1229,[187 302 603 180 427],271,5,5273,4.286991869918699,20.0,0.0
1230,0,1230,[200  12 197 435 238],537,2,5275,4.285134037367993,20.0,0.0
1231,0,1231,[187 302 603 180 427],90,5,5280,4.285714285714286,20.0,0.0
1232,0,1232,[187 302 603 180 427],474,5,5285,4.286293592862936,20.0,0.0
1233,0,1233,[515 117 180 176 161],387,2,5287,4.284440842787682,0.0,0.0
1234,0,1234,[597 405 222   1 117],279,2,5289,4.282591093117409,0.0,0.0
1235,0,1235,[187 302 603 180 427],339,5,5294,4.283171521035599,20.0,0.0
1236,0,1236,[187 302 603 180 427],664,5,5299,4.283751010509297,20.0,0.0
1237,0,1237,[187 302 603 180 427],13,5,5304,4.284329563812601,20.0,0.0
1238,0,1238,[187 302 603 180 427],458,5,5309,4.284907183212268,20.0,0.0
1239,0,1239,[237 546  89   8 216],7,5,5314,4.285483870967742,0.0,0.0
1240,0,1240,[118 234 127 179 215],643,3,5317,4.2844480257856565,0.0,20.0
1241,0,1241,[180 151 118 496  69],524,3,5320,4.28341384863124,0.0,0.0
1242,0,1242,[265 275 181 435 195],308,4,5324,4.283185840707965,0.0,0.0
1243,0,1243,[187 302 603 180 427],537,5,5329,4.283762057877814,20.0,0.0
1244,0,1244,[  4 168 568  82 546],533,3,5332,4.282730923694779,0.0,0.0
1245,0,1245,[187 302 603 180 427],666,5,5337,4.28330658105939,20.0,0.0
1246,0,1246,[187 302 603 180 427],339,5,5342,4.283881315156376,20.0,0.0
1247,0,1247,[187 302 603 180 427],90,5,5347,4.284455128205129,20.0,0.0
1248,0,1248,[ 89 257 318 508 235],378,5,5352,4.285028022417935,20.0,0.0
1249,0,1249,[187 302 603 180 427],90,5,5357,4.2856,20.0,0.0
1250,0,1250,[187 302 603 180 427],666,5,5362,4.286171063149481,20.0,0.0
1251,0,1251,[ 82 288 187 483 179],234,2,5364,4.284345047923322,20.0,0.0
1252,0,1252,[187 302 603 180 427],13,5,5369,4.284916201117318,20.0,0.0
1253,0,1253,[187 302 603 180 427],339,5,5374,4.28548644338118,20.0,0.0
1254,0,1254,[187 302 603 180 427],664,5,5379,4.286055776892431,20.0,0.0
1255,0,1255,[187 302 603 180 427],271,5,5384,4.286624203821656,20.0,0.0
1256,0,1256,[187 302 603 180 427],90,5,5389,4.287191726332538,20.0,0.0
1257,0,1257,[ 11  69  15 111  28],92,2,5391,4.28537360890302,0.0,0.0
1258,0,1258,[187 302 603 180 427],13,5,5396,4.28594122319301,20.0,0.0
1259,0,1259,[187 302 603 180 427],13,5,5401,4.286507936507936,20.0,0.0
1260,0,1260,[187 302 603 180 427],474,5,5406,4.287073750991277,20.0,0.0
1261,0,1261,[187 302 603 180 427],339,5,5411,4.287638668779715,20.0,0.0
1262,0,1262,[187 302 603 180 427],458,5,5416,4.288202692003167,20.0,0.0
1263,0,1263,[269 546 100   7 191],650,4,5420,4.287974683544304,0.0,20.0
1264,0,1264,[187 302 603 180 427],271,5,5425,4.288537549407114,20.0,0.0
1265,0,1265,[187 302 603 180 427],339,5,5430,4.289099526066351,20.0,0.0
1266,0,1266,[181 333 191   8 742],533,4,5434,4.288871349644831,0.0,0.0
1267,0,1267,[143 173 508 175  69],213,4,5438,4.288643533123029,0.0,0.0
1268,0,1268,[187 302 603 180 427],664,5,5443,4.289204097714736,20.0,0.0
1269,0,1269,[187 302 603 180 427],666,5,5448,4.289763779527559,20.0,0.0
1270,0,1270,[187 302 603 180 427],474,5,5453,4.290322580645161,20.0,0.0
1271,0,1271,[187 302 603 180 427],339,5,5458,4.290880503144654,20.0,0.0
1272,0,1272,[187 302 603 180 427],474,5,5463,4.291437549096623,20.0,0.0
1273,0,1273,[187 302 603 180 427],13,5,5468,4.2919937205651495,20.0,0.0
1274,0,1274,[211 191 118  28 302],343,4,5472,4.291764705882353,0.0,0.0
1275,0,1275,[187 302 603 180 427],339,5,5477,4.2923197492163006,20.0,0.0
1276,0,1276,[153 121 132 238 195],77,3,5480,4.291307752545028,0.0,0.0
1277,0,1277,[111  11 294 237 195],13,2,5482,4.289514866979656,0.0,0.0
1278,0,1278,[187 302 603 180 427],339,5,5487,4.2900703674745895,20.0,0.0
1279,0,1279,[222 318 496  82  71],454,3,5490,4.2890625,20.0,0.0
1280,0,1280,[288 195   7 187 273],64,4,5494,4.288836846213895,0.0,0.0
1281,0,1281,[182 168 328  89 405],271,0,5494,4.285491419656786,0.0,0.0
1282,0,1282,[187 302 603 180 427],474,5,5499,4.286048324240062,20.0,0.0
1283,0,1283,[187 302 603 180 427],458,5,5504,4.286604361370716,20.0,0.0
1284,0,1284,[187 302 603 180 427],13,5,5509,4.28715953307393,20.0,0.0
1285,0,1285,[187 302 603 180 427],271,5,5514,4.287713841368585,20.0,0.0
1286,0,1286,[187 302 603 180 427],339,5,5519,4.2882672882672885,20.0,0.0
1287,0,1287,[ 89   8 323 301 597],13,2,5521,4.286490683229814,0.0,0.0
1288,0,1288,[187 302 603 180 427],666,5,5526,4.287044220325834,20.0,0.0
1289,0,1289,[127 318   4 210 588],7,5,5531,4.287596899224806,20.0,20.0
1290,0,1290,[187 302 603 180 427],90,5,5536,4.288148721920991,20.0,0.0
1291,0,1291,[179 176 496 181 197],60,5,5541,4.288699690402477,0.0,0.0
1292,0,1292,[187 302 603 180 427],458,5,5546,4.289249806651199,20.0,0.0
1293,0,1293,[496 127 111 435 385],87,5,5551,4.289799072642968,0.0,20.0
1294,0,1294,[187 302 603 180 427],90,5,5556,4.29034749034749,20.0,0.0
1295,0,1295,[181 121 258  98 234],546,5,5561,4.290895061728395,0.0,20.0
1296,0,1296,[187 302 603 180 427],458,5,5566,4.291441788743254,20.0,0.0
1297,0,1297,[187 302 603 180 427],339,5,5571,4.2919876733436055,20.0,0.0
1298,0,1298,[161 174 118 328  71],479,2,5573,4.29022324865281,0.0,20.0
1299,0,1299,[187 302 603 180 427],664,5,5578,4.2907692307692304,20.0,0.0
1300,0,1300,[187 302 603 180 427],13,5,5583,4.291314373558801,20.0,0.0
1301,0,1301,[187 302 603 180 427],339,5,5588,4.291858678955453,20.0,0.0
1302,0,1302,[323 182 313  15 111],59,5,5593,4.2924021488871835,0.0,0.0
1303,0,1303,[187 302 603 180 427],664,5,5598,4.292944785276074,20.0,0.0
1304,0,1304,[ 25 273  95   7 237],308,3,5601,4.291954022988506,0.0,0.0
1305,0,1305,[187 302 603 180 427],537,5,5606,4.292496171516079,20.0,0.0
1306,0,1306,[258  89 180  12 282],474,5,5611,4.293037490436113,20.0,0.0
1307,0,1307,[187 302 603 180 427],90,5,5616,4.293577981651376,20.0,0.0
1308,0,1308,[187 302 603 180 427],90,5,5621,4.294117647058823,20.0,0.0
1309,0,1309,[187 302 603 180 427],474,5,5626,4.294656488549618,20.0,0.0
1310,0,1310,[187 302 603 180 427],537,5,5631,4.295194508009153,20.0,0.0
1311,0,1311,[187 302 603 180 427],458,5,5636,4.295731707317073,20.0,0.0
1312,0,1312,[187 302 603 180 427],666,5,5641,4.296268088347296,20.0,0.0
1313,0,1313,[187 302 603 180 427],664,5,5646,4.296803652968037,20.0,0.0
1314,0,1314,[294 125   4 265 215],271,3,5649,4.295817490494296,0.0,0.0
1315,0,1315,[187 302 603 180 427],90,5,5654,4.296352583586626,20.0,0.0
1316,0,1316,[187 302 603 180 427],474,5,5659,4.2968868640850415,20.0,0.0
1317,0,1317,[187 302 603 180 427],339,5,5664,4.29742033383915,20.0,0.0
1318,0,1318,[273 228 127 276 471],402,4,5668,4.297194844579226,0.0,20.0
1319,0,1319,[273  15 588 135 222],892,5,5673,4.297727272727273,0.0,0.0
1320,0,1320,[288  12 271 258  69],13,3,5676,4.29674489023467,20.0,0.0
1321,0,1321,[187 302 603 180 427],474,5,5681,4.297276853252647,20.0,0.0
1322,0,1322,[187 302 603 180 427],537,5,5686,4.297808012093727,20.0,0.0
1323,0,1323,[471 180   9 161 173],13,2,5688,4.2960725075528705,0.0,0.0
1324,0,1324,[187 302 603 180 427],664,5,5693,4.296603773584906,20.0,0.0
1325,0,1325,[187 302 603 180 427],90,5,5698,4.297134238310709,20.0,0.0
1326,0,1326,[357 202 427 603  69],527,4,5702,4.296910324039186,40.0,0.0
1327,0,1327,[187 302 603 180 427],13,5,5707,4.297439759036145,20.0,0.0
1328,0,1328,[187 302 603 180 427],271,5,5712,4.297968397291196,20.0,0.0
1329,0,1329,[187 302 603 180 427],90,5,5717,4.298496240601504,20.0,0.0
1330,0,1330,[187 302 603 180 427],664,5,5722,4.299023290758828,20.0,0.0
1331,0,1331,[187 302 603 180 427],666,5,5727,4.29954954954955,20.0,0.0
1332,0,1332,[187 302 603 180 427],537,5,5732,4.300075018754689,20.0,0.0
1333,0,1333,[187 302 603 180 427],458,5,5737,4.300599700149925,20.0,0.0
1334,0,1334,[187 302 603 180 427],271,5,5742,4.301123595505618,20.0,0.0
1335,0,1335,[508  89 143 318  22],184,3,5745,4.300149700598802,20.0,0.0
1336,0,1336,[ 88 435 471 180 168],271,3,5748,4.2991772625280475,0.0,0.0
1337,0,1337,[ 64  50 202 742 228],749,5,5753,4.299701046337818,0.0,20.0
1338,0,1338,[187 302 603 180 427],339,5,5758,4.300224047796863,20.0,0.0
1339,0,1339,[173 568 197 655 127],210,5,5763,4.300746268656717,0.0,20.0
1340,0,1340,[187 302 603 180 427],666,5,5768,4.301267710663684,20.0,0.0
1341,0,1341,[357 328 180  96 183],488,3,5771,4.300298062593145,20.0,0.0
1342,0,1342,[187 302 603 180 427],458,5,5776,4.300819061801936,20.0,0.0
1343,0,1343,[187 302 603 180 427],664,5,5781,4.301339285714286,20.0,0.0
1344,0,1344,[546 508 471  50  96],378,3,5784,4.300371747211896,0.0,20.0
1345,0,1345,[187 302 603 180 427],458,5,5789,4.300891530460624,20.0,0.0
1346,0,1346,[187 302 603 180 427],271,5,5794,4.301410541945063,20.0,0.0
1347,0,1347,[235 202 143 179 655],59,3,5797,4.300445103857567,0.0,0.0
1348,0,1348,[187 302 603 180 427],339,5,5802,4.300963676797628,20.0,0.0
1349,0,1349,[187 302 603 180 427],13,5,5807,4.301481481481481,20.0,0.0
1350,0,1350,[ 12 300 597 568   1],533,4,5811,4.301258327165063,20.0,0.0
1351,0,1351,[187 302 603 180 427],474,5,5816,4.3017751479289945,20.0,0.0
1352,0,1352,[234 235 328 204  56],788,1,5817,4.299334811529934,0.0,0.0
1353,0,1353,[187 302 603 180 427],666,5,5822,4.299852289512556,20.0,0.0
1354,0,1354,[185 135 333   9 265],13,2,5824,4.298154981549816,0.0,0.0
1355,0,1355,[187 302 603 180 427],271,5,5829,4.298672566371682,20.0,0.0
1356,0,1356,[187 302 603 180 427],458,5,5834,4.299189388356669,20.0,0.0
1357,0,1357,[187 302 603 180 427],474,5,5839,4.299705449189985,20.0,0.0
1358,0,1358,[153 301 211 168 546],279,4,5843,4.299484915378955,0.0,0.0
1359,0,1359,[187 302 603 180 427],664,5,5848,4.3,20.0,0.0
1360,0,1360,[318 174  69 182 678],213,4,5852,4.299779573842763,20.0,20.0
1361,0,1361,[187 302 603 180 427],13,5,5857,4.300293685756241,20.0,0.0
1362,0,1362,[187 302 603 180 427],271,5,5862,4.300807043286867,20.0,0.0
1363,0,1363,[187 302 603 180 427],458,5,5867,4.301319648093842,20.0,0.0
1364,0,1364,[235 385 125  89 228],897,3,5870,4.3003663003663,0.0,0.0
1365,0,1365,[187 302 603 180 427],13,5,5875,4.300878477306003,20.0,0.0
1366,0,1366,[  7 143 183 588  79],7,4,5879,4.3006583760058525,0.0,0.0
1367,0,1367,[187 302 603 180 427],458,5,5884,4.3011695906432745,20.0,0.0
1368,0,1368,[187 302 603 180 427],13,5,5889,4.301680058436816,20.0,0.0
1369,0,1369,[323  95 435 202 135],537,1,5890,4.299270072992701,0.0,0.0
1370,0,1370,[187 302 603 180 427],271,5,5895,4.299781181619256,20.0,0.0
1371,0,1371,[187 302 603 180 427],13,5,5900,4.300291545189505,20.0,0.0
1372,0,1372,[187 302 603 180 427],664,5,5905,4.300801165331391,20.0,0.0
1373,0,1373,[187 302 603 180 427],666,5,5910,4.301310043668122,20.0,0.0
1374,0,1374,[187 302 603 180 427],339,5,5915,4.301818181818182,20.0,0.0
1375,0,1375,[187 302 603 180 427],271,5,5920,4.3023255813953485,20.0,0.0
1376,0,1376,[187 302 603 180 427],537,5,5925,4.302832244008715,20.0,0.0
1377,0,1377,[187 302 603 180 427],458,5,5930,4.303338171262699,20.0,0.0
1378,0,1378,[187 302 603 180 427],458,5,5935,4.30384336475707,20.0,0.0
1379,0,1379,[187 302 603 180 427],339,5,5940,4.304347826086956,20.0,0.0
1380,0,1380,[187 302 603 180 427],271,5,5945,4.304851556842867,20.0,0.0
1381,0,1381,[187 302 603 180 427],537,5,5950,4.305354558610709,20.0,0.0
1382,0,1382,[423 191 215 144  50],387,2,5952,4.303687635574837,0.0,20.0
1383,0,1383,[187 302 603 180 427],664,5,5957,4.304190751445087,20.0,0.0
1384,0,1384,[187 302 603 180 427],458,5,5962,4.304693140794224,20.0,0.0
1385,0,1385,[187 302 603 180 427],90,5,5967,4.305194805194805,20.0,0.0
1386,0,1386,[187 302 603 180 427],271,5,5972,4.305695746214853,20.0,0.0
1387,0,1387,[288 597 265 127 125],82,1,5973,4.303314121037464,0.0,20.0
1388,0,1388,[655 276 238 202   7],59,5,5978,4.30381569474442,0.0,0.0
1389,0,1389,[187 302 603 180 427],537,5,5983,4.30431654676259,20.0,0.0
1390,0,1390,[100 172 125 151 655],64,3,5986,4.303378864126528,0.0,20.0
1391,0,1391,[187 302 603 180 427],13,5,5991,4.303879310344827,20.0,0.0
1392,0,1392,[187 302 603 180 427],537,5,5996,4.304379038047379,20.0,0.0
1393,0,1393,[173 204 318 237 357],13,2,5998,4.302725968436155,40.0,0.0
1394,0,1394,[187 302 603 180 427],666,5,6003,4.303225806451613,20.0,0.0
1395,0,1395,[546 175  25 174 153],95,3,6006,4.302292263610315,0.0,20.0
1396,0,1396,[568 301 173 182 238],650,2,6008,4.3006442376521115,0.0,0.0
1397,0,1397,[187 302 603 180 427],666,5,6013,4.301144492131616,20.0,0.0
1398,0,1398,[187 302 603 180 427],474,5,6018,4.301644031451036,20.0,0.0
1399,0,1399,[187 302 603 180 427],271,5,6023,4.302142857142857,20.0,0.0
1400,0,1400,[ 97  69 132 471  79],90,4,6027,4.301927194860814,0.0,0.0
1401,0,1401,[187 302 603 180 427],537,5,6032,4.302425106990015,20.0,0.0
1402,0,1402,[187 302 603 180 427],458,5,6037,4.302922309337135,20.0,0.0
1403,0,1403,[ 50 173 181  22 187],346,3,6040,4.301994301994302,0.0,20.0
1404,0,1404,[153 111 568  98 100],385,3,6043,4.301067615658363,0.0,40.0
1405,0,1405,[ 25 200  95 403 288],843,1,6044,4.298719772403983,0.0,0.0
1406,0,1406,[187 302 603 180 427],271,5,6049,4.2992181947405825,20.0,0.0
1407,0,1407,[ 70 172 187 286 117],13,2,6051,4.2975852272727275,0.0,0.0
1408,0,1408,[515 568 210  28 174],883,3,6054,4.29666430092264,0.0,20.0
1409,0,1409,[204 168   4 427 483],7,5,6059,4.297163120567376,20.0,0.0
1410,0,1410,[187 302 603 180 427],339,5,6064,4.2976612331679656,20.0,0.0
1411,0,1411,[187 302 603 180 427],339,5,6069,4.298158640226629,20.0,0.0
1412,0,1412,[187 302 603 180 427],474,5,6074,4.298655343241331,20.0,0.0
1413,0,1413,[187 302 603 180 427],271,5,6079,4.299151343705799,20.0,0.0
1414,0,1414,[187 302 603 180 427],666,5,6084,4.299646643109541,20.0,0.0
1415,0,1415,[191 215  97 603  11],387,2,6086,4.298022598870056,20.0,0.0
1416,0,1416,[187 302 603 180 427],13,5,6091,4.298517995765702,20.0,0.0
1417,0,1417,[194  95 597 234 286],650,2,6093,4.296897038081806,0.0,0.0
1418,0,1418,[187 302 603 180 427],474,5,6098,4.2973925299506694,20.0,0.0
1419,0,1419,[187 302 603 180 427],537,5,6103,4.297887323943662,20.0,0.0
1420,0,1420,[187 302 603 180 427],90,5,6108,4.298381421534131,20.0,0.0
1421,0,1421,[187 302 603 180 427],90,5,6113,4.29887482419128,20.0,0.0
1422,0,1422,[187 302 603 180 427],90,5,6118,4.299367533380183,20.0,0.0
1423,0,1423,[275 423 143 603 161],13,3,6121,4.298455056179775,20.0,0.0
1424,0,1424,[187 302 603 180 427],666,5,6126,4.298947368421053,20.0,0.0
1425,0,1425,[187 302 603 180 427],666,5,6131,4.2994389901823284,20.0,0.0
1426,0,1426,[187 302 603 180 427],666,5,6136,4.299929922915207,20.0,0.0
1427,0,1427,[174 276  88 132 302],339,5,6141,4.300420168067227,0.0,20.0
1428,0,1428,[187 302 603 180 427],271,5,6146,4.3009097270818755,20.0,0.0
1429,0,1429,[216 357 333 483  89],328,3,6149,4.3,40.0,0.0
1430,0,1430,[187 302 603 180 427],13,5,6154,4.300489168413697,20.0,0.0
1431,0,1431,[187 302 603 180 427],664,5,6159,4.300977653631285,20.0,0.0
1432,0,1432,[187 302 603 180 427],13,5,6164,4.301465457083043,20.0,0.0
1433,0,1433,[180 153 496 423 151],234,2,6166,4.299860529986053,0.0,0.0
1434,0,1434,[187 302 603 180 427],13,5,6171,4.300348432055749,20.0,0.0
1435,0,1435,[187 302 603 180 427],474,5,6176,4.3008356545961,20.0,0.0
1436,0,1436,[194 496 323 185 403],650,2,6178,4.299234516353514,0.0,0.0
1437,0,1437,[187 302 603 180 427],664,5,6183,4.2997218358831715,20.0,0.0
1438,0,1438,[210 183   8 276 194],883,4,6187,4.299513551077137,0.0,0.0
1439,0,1439,[187 302 603 180 427],664,5,6192,4.3,20.0,0.0
1440,0,1440,[257  96 289 172 215],378,5,6197,4.300485773768217,0.0,0.0
1441,0,1441,[187 302 603 180 427],474,5,6202,4.300970873786408,20.0,0.0
1442,0,1442,[187 302 603 180 427],271,5,6207,4.301455301455301,20.0,0.0
1443,0,1443,[ 96 257  15 197 211],210,5,6212,4.301939058171745,0.0,0.0
1444,0,1444,[187 302 603 180 427],13,5,6217,4.30242214532872,20.0,0.0
1445,0,1445,[187 302 603 180 427],664,5,6222,4.3029045643153525,20.0,0.0
1446,0,1446,[187 302 603 180 427],339,5,6227,4.3033863165169315,20.0,0.0
1447,0,1447,[228 135 174 117 294],882,5,6232,4.303867403314917,0.0,20.0
1448,0,1448,[275  28 427 403 328],334,3,6235,4.302967563837129,0.0,0.0
1449,0,1449,[187 302 603 180 427],537,5,6240,4.303448275862069,20.0,0.0
1450,0,1450,[187 302 603 180 427],90,5,6245,4.303928325292901,20.0,0.0
1451,0,1451,[187 302 603 180 427],537,5,6250,4.304407713498622,20.0,0.0
1452,0,1452,[187 302 603 180 427],666,5,6255,4.3048864418444595,20.0,0.0
1453,0,1453,[187 302 603 180 427],339,5,6260,4.305364511691884,20.0,0.0
1454,0,1454,[187 302 603 180 427],271,5,6265,4.305841924398625,20.0,0.0
1455,0,1455,[187 302 603 180 427],537,5,6270,4.306318681318682,20.0,0.0
1456,0,1456,[245 135 100 194 385],452,3,6273,4.305422100205902,0.0,20.0
1457,0,1457,[  1 191 471  82 276],537,2,6275,4.303840877914952,0.0,0.0
1458,0,1458,[187 302 603 180 427],458,5,6280,4.3043180260452365,20.0,0.0
1459,0,1459,[187 302 603 180 427],271,5,6285,4.304794520547945,20.0,0.0
1460,0,1460,[168 294  15 318 435],474,3,6288,4.303901437371663,20.0,0.0
1461,0,1461,[265 121 288 180 200],537,1,6289,4.301641586867305,0.0,0.0
1462,0,1462,[187 302 603 180 427],666,5,6294,4.302118933697881,20.0,0.0
1463,0,1463,[151 258 186 271  89],334,3,6297,4.301229508196721,0.0,0.0
1464,0,1464,[187 302 603 180 427],664,5,6302,4.301706484641638,20.0,0.0
1465,0,1465,[200   8 132 385  89],328,3,6305,4.300818553888131,0.0,0.0
1466,0,1466,[195 427  95 234  96],537,1,6306,4.298568507157464,0.0,0.0
1467,0,1467,[187 302 603 180 427],13,5,6311,4.299046321525886,20.0,0.0
1468,0,1468,[187 302 603 180 427],458,5,6316,4.299523485364193,20.0,0.0
1469,0,1469,[187 302 603 180 427],13,5,6321,4.3,20.0,0.0
1470,0,1470,[288  97  96 301 100],739,4,6325,4.299796057104011,0.0,20.0
1471,0,1471,[187 302 603 180 427],458,5,6330,4.300271739130435,20.0,0.0
1472,0,1472,[187 302 603 180 427],271,5,6335,4.300746775288527,20.0,0.0
1473,0,1473,[187 302 603 180 427],474,5,6340,4.301221166892809,20.0,0.0
1474,0,1474,[187 302 603 180 427],458,5,6345,4.301694915254237,20.0,0.0
1475,0,1475,[ 89 515  11  82 151],881,4,6349,4.301490514905149,0.0,0.0
1476,0,1476,[182 179 181 153  96],7,4,6353,4.301286391333785,0.0,0.0
1477,0,1477,[187 302 603 180 427],271,5,6358,4.301759133964818,20.0,0.0
1478,0,1478,[187 302 603 180 427],339,5,6363,4.302231237322515,20.0,0.0
1479,0,1479,[322 151 238 168 202],883,5,6368,4.302702702702702,0.0,0.0
1480,0,1480,[187 302 603 180 427],339,5,6373,4.303173531397705,20.0,0.0
1481,0,1481,[187 302 603 180 427],339,5,6378,4.303643724696356,20.0,0.0
1482,0,1482,[187 302 603 180 427],90,5,6383,4.304113283884019,20.0,0.0
1483,0,1483,[187 302 603 180 427],664,5,6388,4.304582210242588,20.0,0.0
1484,0,1484,[187 302 603 180 427],339,5,6393,4.305050505050505,20.0,0.0
1485,0,1485,[187 302 603 180 427],458,5,6398,4.305518169582773,20.0,0.0
1486,0,1486,[ 56 313 357 318 168],308,4,6402,4.3053127101546735,40.0,0.0
1487,0,1487,[187 302 603 180 427],339,5,6407,4.305779569892473,20.0,0.0
1488,0,1488,[187 302 603 180 427],13,5,6412,4.3062458025520485,20.0,0.0
1489,0,1489,[187 302 603 180 427],474,5,6417,4.306711409395973,20.0,0.0
1490,0,1490,[187 302 603 180 427],13,5,6422,4.307176391683434,20.0,0.0
1491,0,1491,[678 222 742 211 322],488,3,6425,4.306300268096515,0.0,0.0
1492,0,1492,[187 302 603 180 427],537,5,6430,4.306764902880107,20.0,0.0
1493,0,1493,[187 302 603 180 427],666,5,6435,4.307228915662651,20.0,0.0
1494,0,1494,[187 302 603 180 427],474,5,6440,4.3076923076923075,20.0,0.0
1495,0,1495,[187 302 603 180 427],339,5,6445,4.308155080213904,20.0,0.0
1496,0,1496,[187 302 603 180 427],90,5,6450,4.3086172344689375,20.0,0.0
1497,0,1497,[ 69 286  64 183 132],95,4,6454,4.308411214953271,0.0,0.0
1498,0,1498,[187 302 603 180 427],339,5,6459,4.308872581721148,20.0,0.0
1499,0,1499,[187 302 603 180 427],271,5,6464,4.309333333333333,20.0,0.0
1500,0,1500,[187 302 603 180 427],458,5,6469,4.30979347101932,20.0,0.0
1501,0,1501,[222 200  98  64 194],804,4,6473,4.3095872170439415,0.0,20.0
1502,0,1502,[187 302 603 180 427],666,5,6478,4.310046573519627,20.0,0.0
1503,0,1503,[153 216 196 121 678],804,5,6483,4.310505319148936,0.0,0.0
1504,0,1504,[ 79 216 423 194  89],899,5,6488,4.310963455149501,0.0,0.0
1505,0,1505,[ 25  79 174 180 323],881,3,6491,4.310092961487384,0.0,20.0
1506,0,1506,[385 176  11 216 269],666,3,6494,4.309223623092236,0.0,0.0
1507,0,1507,[187 302 603 180 427],664,5,6499,4.309681697612732,20.0,0.0
1508,0,1508,[423 475 121 200 118],92,2,6501,4.308151093439363,0.0,0.0
1509,0,1509,[200 179 257 143 313],334,4,6505,4.30794701986755,0.0,0.0
1510,0,1510,[ 28 286 313 435 265],234,2,6507,4.306419589675712,0.0,0.0
1511,0,1511,[288 135  15 515 191],452,3,6510,4.305555555555555,0.0,0.0
1512,0,1512,[187 302 603 180 427],339,5,6515,4.30601454064772,20.0,0.0
1513,0,1513,[187 302 603 180 427],474,5,6520,4.306472919418758,20.0,0.0
1514,0,1514,[187 302 603 180 427],271,5,6525,4.306930693069307,20.0,0.0
1515,0,1515,[187 302 603 180 427],537,5,6530,4.307387862796833,20.0,0.0
1516,0,1516,[187 302 603 180 427],339,5,6535,4.307844429795649,20.0,0.0
1517,0,1517,[197 151 168   7 204],881,2,6537,4.3063241106719365,0.0,0.0
1518,0,1518,[187 302 603 180 427],474,5,6542,4.30678077682686,20.0,0.0
1519,0,1519,[187 302 603 180 427],339,5,6547,4.307236842105263,20.0,0.0
1520,0,1520,[288  22 132 318 228],533,4,6551,4.307034845496384,20.0,0.0
1521,0,1521,[117 257  88 269 191],650,3,6554,4.306176084099868,0.0,0.0
1522,0,1522,[385 216 423  89  50],738,4,6558,4.305975049244911,0.0,20.0
1523,0,1523,[187 302 603 180 427],458,5,6563,4.306430446194225,20.0,0.0
1524,0,1524,[187 302 603 180 427],474,5,6568,4.306885245901639,20.0,0.0
1525,0,1525,[187 302 603 180 427],13,5,6573,4.307339449541284,20.0,0.0
1526,0,1526,[187 302 603 180 427],458,5,6578,4.307793058284218,20.0,0.0
1527,0,1527,[187 302 603 180 427],458,5,6583,4.308246073298429,20.0,0.0
1528,0,1528,[172 748  96 245 153],749,4,6587,4.3080444735120995,0.0,0.0
1529,0,1529,[187 302 603 180 427],339,5,6592,4.308496732026144,20.0,0.0
1530,0,1530,[187 302 603 180 427],339,5,6597,4.308948399738733,20.0,0.0
1531,0,1531,[121  89 265 603 288],804,4,6601,4.308746736292428,20.0,0.0
1532,0,1532,[196 318 181 546 328],92,2,6603,4.307240704500979,20.0,0.0
1533,0,1533,[187 302 603 180 427],90,5,6608,4.3076923076923075,20.0,0.0
1534,0,1534,[187 302 603 180 427],666,5,6613,4.30814332247557,20.0,0.0
1535,0,1535,[ 95 515 276  96 423],59,4,6617,4.307942708333333,0.0,0.0
1536,0,1536,[187 302 603 180 427],664,5,6622,4.308392973324659,20.0,0.0
1537,0,1537,[187 302 603 180 427],13,5,6627,4.308842652795839,20.0,0.0
1538,0,1538,[187 302 603 180 427],664,5,6632,4.309291747888239,20.0,0.0
1539,0,1539,[187 302 603 180 427],271,5,6637,4.30974025974026,20.0,0.0
1540,0,1540,[187 302 603 180 427],458,5,6642,4.310188189487346,20.0,0.0
1541,0,1541,[187 302 603 180 427],474,5,6647,4.310635538261997,20.0,0.0
1542,0,1542,[144 294  89 100 197],406,3,6650,4.309786130913804,0.0,20.0
1543,0,1543,[318   9 176 237 215],184,5,6655,4.310233160621761,20.0,0.0
1544,0,1544,[187 302 603 180 427],271,5,6660,4.310679611650485,20.0,0.0
1545,0,1545,[ 82 515  95 237 496],234,2,6662,4.309184993531694,0.0,0.0
1546,0,1546,[187 302 603 180 427],13,5,6667,4.309631544925662,20.0,0.0
1547,0,1547,[187 302 603 180 427],474,5,6672,4.310077519379845,20.0,0.0
1548,0,1548,[196 204  56 496 403],892,4,6676,4.309877340219496,0.0,0.0
1549,0,1549,[222 435  22 471  97],454,2,6678,4.308387096774194,0.0,0.0
1550,0,1550,[187 302 603 180 427],474,5,6683,4.3088330109606705,20.0,0.0
1551,0,1551,[187 302 603 180 427],339,5,6688,4.309278350515464,20.0,0.0
1552,0,1552,[187 302 603 180 427],458,5,6693,4.309723116548615,20.0,0.0
1553,0,1553,[176 204 127  95 143],892,4,6697,4.309523809523809,0.0,20.0
1554,0,1554,[187 302 603 180 427],666,5,6702,4.309967845659164,20.0,0.0
1555,0,1555,[187 302 603 180 427],13,5,6707,4.310411311053985,20.0,0.0
1556,0,1556,[187 302 603 180 427],666,5,6712,4.310854206807964,20.0,0.0
1557,0,1557,[187 302 603 180 427],666,5,6717,4.311296534017972,20.0,0.0
1558,0,1558,[187 302 603 180 427],458,5,6722,4.311738293778063,20.0,0.0
1559,0,1559,[187 302 603 180 427],13,5,6727,4.312179487179487,20.0,0.0
1560,0,1560,[187 302 603 180 427],537,5,6732,4.312620115310699,20.0,0.0
1561,0,1561,[187 302 603 180 427],90,5,6737,4.313060179257362,20.0,0.0
1562,0,1562,[187 302 603 180 427],339,5,6742,4.3134996801023675,20.0,0.0
1563,0,1563,[318  82 202   1 234],313,4,6746,4.313299232736573,20.0,0.0
1564,0,1564,[187 302 603 180 427],13,5,6751,4.313738019169329,20.0,0.0
1565,0,1565,[294 423 235 286 427],328,2,6753,4.312260536398467,0.0,0.0
1566,0,1566,[161 546 174 187 322],524,5,6758,4.312699425654116,0.0,20.0
1567,0,1567,[ 70 174  22 215 153],479,4,6762,4.3125,0.0,20.0
1568,0,1568,[187 302 603 180 427],474,5,6767,4.312938177182919,20.0,0.0
1569,0,1569,[187 302 603 180 427],271,5,6772,4.313375796178344,20.0,0.0
1570,0,1570,[ 88 176 202  28 294],42,4,6776,4.313176320814768,0.0,0.0
1571,0,1571,[ 70 168  50 228 357],194,2,6778,4.311704834605598,20.0,20.0
1572,0,1572,[187 302 603 180 427],474,5,6783,4.312142403051494,20.0,0.0
1573,0,1573,[187 302 603 180 427],271,5,6788,4.312579415501906,20.0,0.0
1574,0,1574,[187 302 603 180 427],271,5,6793,4.313015873015873,20.0,0.0
1575,0,1575,[228 403 385 125 655],881,3,6796,4.312182741116751,0.0,0.0
1576,0,1576,[187 302 603 180 427],13,5,6801,4.312618896639188,20.0,0.0
1577,0,1577,[403 273  98 300 194],378,5,6806,4.313054499366286,0.0,20.0
1578,0,1578,[187 302 603 180 427],458,5,6811,4.313489550348322,20.0,0.0
1579,0,1579,[ 50 117  97  96 153],328,3,6814,4.312658227848101,0.0,20.0
1580,0,1580,[187 302 603 180 427],271,5,6819,4.313092979127135,20.0,0.0
1581,0,1581,[187 302 603 180 427],474,5,6824,4.313527180783818,20.0,0.0
1582,0,1582,[187 302 603 180 427],664,5,6829,4.31396083385976,20.0,0.0
1583,0,1583,[187 302 603 180 427],458,5,6834,4.3143939393939394,20.0,0.0
1584,0,1584,[318 471 186 168 121],7,5,6839,4.314826498422713,20.0,0.0
1585,0,1585,[289  50 508 118  70],533,4,6843,4.314627994955864,0.0,20.0
1586,0,1586,[187 302 603 180 427],537,5,6848,4.315059861373661,20.0,0.0
1587,0,1587,[161 300 258 435 405],102,1,6849,4.312972292191436,0.0,0.0
1588,0,1588,[187 302 603 180 427],458,5,6854,4.313404657016992,20.0,0.0
1589,0,1589,[187 302 603 180 427],474,5,6859,4.313836477987421,20.0,0.0
1590,0,1590,[ 71 333 405 121 143],13,2,6861,4.312382149591452,0.0,0.0
1591,0,1591,[187 302 603 180 427],13,5,6866,4.312814070351759,20.0,0.0
1592,0,1592,[301  82 238 258  70],537,3,6869,4.311989956057753,0.0,0.0
1593,0,1593,[210  28 161   1 185],843,0,6869,4.309284818067754,0.0,0.0
1594,0,1594,[187 302 603 180 427],474,5,6874,4.309717868338558,20.0,0.0
1595,0,1595,[187 302 603 180 427],458,5,6879,4.31015037593985,20.0,0.0
1596,0,1596,[191  98 237 265 403],524,3,6882,4.30932999373826,0.0,20.0
1597,0,1597,[483 185 294 127 144],213,4,6886,4.3091364205256575,20.0,20.0
1598,0,1598,[187 302 603 180 427],458,5,6891,4.309568480300188,20.0,0.0
1599,0,1599,[187 302 603 180 427],90,5,6896,4.31,20.0,0.0
1600,0,1600,[187 302 603 180 427],13,5,6901,4.3104309806371015,20.0,0.0
1601,0,1601,[ 89 216 210 237 202],234,0,6901,4.307740324594257,0.0,0.0
1602,0,1602,[ 98 132 515 180   1],339,5,6906,4.30817217716781,0.0,20.0
1603,0,1603,[187 302 603 180 427],537,5,6911,4.30860349127182,20.0,0.0
1604,0,1604,[187 302 603 180 427],537,5,6916,4.309034267912772,20.0,0.0
1605,0,1605,[187 302 603 180 427],13,5,6921,4.309464508094645,20.0,0.0
1606,0,1606,[187 302 603 180 427],664,5,6926,4.309894212818917,20.0,0.0
1607,0,1607,[187 302 603 180 427],271,5,6931,4.310323383084577,20.0,0.0
1608,0,1608,[ 82  50 197 271   1],263,4,6935,4.310130515848353,0.0,20.0
1609,0,1609,[187 302 603 180 427],13,5,6940,4.3105590062111805,20.0,0.0
1610,0,1610,[257 234  71  22  28],95,4,6944,4.3103662321539415,0.0,0.0
1611,0,1611,[179 655 357   7  12],406,4,6948,4.310173697270471,40.0,0.0
1612,0,1612,[187 302 603 180 427],666,5,6953,4.310601363918165,20.0,0.0
1613,0,1613,[187 302 603 180 427],13,5,6958,4.311028500619579,20.0,0.0
1614,0,1614,[187 302 603 180 427],271,5,6963,4.311455108359133,20.0,0.0
1615,0,1615,[187 302 603 180 427],339,5,6968,4.311881188118812,20.0,0.0
1616,0,1616,[187 302 603 180 427],537,5,6973,4.312306740878169,20.0,0.0
1617,0,1617,[187 302 603 180 427],271,5,6978,4.312731767614339,20.0,0.0
1618,0,1618,[187 302 603 180 427],13,5,6983,4.313156269302039,20.0,0.0
1619,0,1619,[597  56 483 258 210],200,5,6988,4.31358024691358,20.0,0.0
1620,0,1620,[187 302 603 180 427],537,5,6993,4.314003701418877,20.0,0.0
1621,0,1621,[187 302 603 180 427],339,5,6998,4.31442663378545,20.0,0.0
1622,0,1622,[187 302 603 180 427],664,5,7003,4.314849044978435,20.0,0.0
1623,0,1623,[187 302 603 180 427],664,5,7008,4.315270935960591,20.0,0.0
1624,0,1624,[187 302 603 180 427],474,5,7013,4.3156923076923075,20.0,0.0
1625,0,1625,[187 302 603 180 427],537,5,7018,4.316113161131612,20.0,0.0
1626,0,1626,[187 302 603 180 427],474,5,7023,4.316533497234174,20.0,0.0
1627,0,1627,[187 302 603 180 427],537,5,7028,4.316953316953317,20.0,0.0
1628,0,1628,[187 302 603 180 427],339,5,7033,4.3173726212400245,20.0,0.0
1629,0,1629,[187 302 603 180 427],271,5,7038,4.317791411042945,20.0,0.0
1630,0,1630,[186 234   7 187 135],406,3,7041,4.316983445738811,0.0,0.0
1631,0,1631,[385  12 275 323  82],883,3,7044,4.3161764705882355,20.0,0.0
1632,0,1632,[302 187 603 180 427],271,5,7049,4.316595223515003,20.0,0.0
1633,0,1633,[  1 185 173 125 200],213,4,7053,4.31640146878825,0.0,0.0
1634,0,1634,[302 187 603 180 427],537,5,7058,4.316819571865444,20.0,0.0
1635,0,1635,[302 187 603 180 427],458,5,7063,4.317237163814181,20.0,0.0
1636,0,1636,[302 187 603 180 427],474,5,7068,4.317654245571167,20.0,0.0
1637,0,1637,[ 15 515 118  71  79],455,3,7071,4.316849816849817,0.0,0.0
1638,0,1638,[302 187 603 180 427],458,5,7076,4.317266625991458,20.0,0.0
1639,0,1639,[302 187 603 180 427],664,5,7081,4.317682926829268,20.0,0.0
1640,0,1640,[ 50 265  88   1 168],479,5,7086,4.318098720292505,0.0,20.0
1641,0,1641,[194 423 196 289 175],41,1,7087,4.316077953714982,0.0,0.0
1642,0,1642,[302 187 603 180 427],13,5,7092,4.316494217894096,20.0,0.0
1643,0,1643,[302 187 603 180 427],537,5,7097,4.3169099756691,20.0,0.0
1644,0,1644,[302 187 603 180 427],537,5,7102,4.317325227963526,20.0,0.0
1645,0,1645,[302 187 603 180 427],271,5,7107,4.317739975698664,20.0,0.0
1646,0,1646,[195 100  28 471 210],653,4,7111,4.317547055251973,0.0,20.0
1647,0,1647,[276 275 176 318 183],308,5,7116,4.317961165048544,20.0,0.0
1648,0,1648,[302 187 603 180 427],664,5,7121,4.318374772589448,20.0,0.0
1649,0,1649,[237 183 121 286 403],890,1,7122,4.316363636363636,0.0,0.0
1650,0,1650,[302 187 603 180 427],90,5,7127,4.3167777104784975,20.0,0.0
1651,0,1651,[302 187 603 180 427],90,5,7132,4.317191283292979,20.0,0.0
1652,0,1652,[302 187 603 180 427],339,5,7137,4.317604355716878,20.0,0.0
1653,0,1653,[302 187 603 180 427],664,5,7142,4.3180169286578,20.0,0.0
1654,0,1654,[302 187 603 180 427],458,5,7147,4.318429003021148,20.0,0.0
1655,0,1655,[302 187 603 180 427],458,5,7152,4.318840579710145,20.0,0.0
1656,0,1656,[302 187 603 180 427],664,5,7157,4.31925165962583,20.0,0.0
1657,0,1657,[ 69 405 238 132  64],666,3,7160,4.318455971049457,0.0,0.0
1658,0,1658,[302 187 603 180 427],271,5,7165,4.318866787221218,20.0,0.0
1659,0,1659,[302 187 603 180 427],271,5,7170,4.319277108433735,20.0,0.0
1660,0,1660,[302 187 603 180 427],339,5,7175,4.319686935580975,20.0,0.0
1661,0,1661,[195 603 144 215  69],13,4,7179,4.319494584837545,20.0,0.0
1662,0,1662,[ 50 121 202  88 508],13,4,7183,4.319302465423933,0.0,20.0
1663,0,1663,[302 187 603 180 427],537,5,7188,4.319711538461538,20.0,0.0
1664,0,1664,[302 187 603 180 427],13,5,7193,4.32012012012012,20.0,0.0
1665,0,1665,[302 187 603 180 427],271,5,7198,4.320528211284514,20.0,0.0
1666,0,1666,[302 187 603 180 427],90,5,7203,4.320935812837432,20.0,0.0
1667,0,1667,[302 187 603 180 427],664,5,7208,4.321342925659472,20.0,0.0
1668,0,1668,[ 89 127 515 568 655],13,3,7211,4.320551228280407,0.0,20.0
1669,0,1669,[302 187 603 180 427],474,5,7216,4.320958083832335,20.0,0.0
1670,0,1670,[187 678 294 182 216],474,3,7219,4.320167564332735,0.0,0.0
1671,0,1671,[302 187 603 180 427],664,5,7224,4.320574162679426,20.0,0.0
1672,0,1672,[228 237 183 144 222],313,2,7226,4.3191870890615665,0.0,0.0
1673,0,1673,[302 187 603 180 427],339,5,7231,4.319593787335723,20.0,0.0
1674,0,1674,[302 187 603 180 427],90,5,7236,4.32,20.0,0.0
1675,0,1675,[302 187 603 180 427],13,5,7241,4.320405727923628,20.0,0.0
1676,0,1676,[ 70 483   7 186 294],158,3,7244,4.319618366129994,20.0,0.0
1677,0,1677,[302 187 603 180 427],474,5,7249,4.320023837902265,20.0,0.0
1678,0,1678,[302 187 603 180 427],474,5,7254,4.320428826682549,20.0,0.0
1679,0,1679,[302 187 603 180 427],90,5,7259,4.320833333333334,20.0,0.0
1680,0,1680,[175 435 196   4 185],339,5,7264,4.3212373587150505,0.0,0.0
1681,0,1681,[302 187 603 180 427],537,5,7269,4.321640903686088,20.0,0.0
1682,0,1682,[423  98  95  22 197],308,3,7272,4.320855614973262,0.0,20.0
1683,0,1683,[302 187 603 180 427],90,5,7277,4.32125890736342,20.0,0.0
1684,0,1684,[302 187 603 180 427],339,5,7282,4.321661721068249,20.0,0.0
1685,0,1685,[483 100 191 175 289],90,3,7285,4.320877817319098,20.0,20.0
1686,0,1686,[161  25 748 191 234],200,4,7289,4.320687611144042,0.0,0.0
1687,0,1687,[302 187 603 180 427],90,5,7294,4.321090047393365,20.0,0.0
1688,0,1688,[302 187 603 180 427],474,5,7299,4.321492007104796,20.0,0.0
1689,0,1689,[302 187 603 180 427],537,5,7304,4.321893491124261,20.0,0.0
1690,0,1690,[302 187 603 180 427],339,5,7309,4.322294500295683,20.0,0.0
1691,0,1691,[302 187 603 180 427],666,5,7314,4.322695035460993,20.0,0.0
1692,0,1692,[427 403 235 196  82],398,4,7318,4.322504430005907,0.0,0.0
1693,0,1693,[302 187 603 180 427],474,5,7323,4.3229043683589135,20.0,0.0
1694,0,1694,[302 187 603 180 427],13,5,7328,4.32330383480826,20.0,0.0
1695,0,1695,[302 187 603 180 427],664,5,7333,4.3237028301886795,20.0,0.0
1696,0,1696,[748 318 153 135 211],64,3,7336,4.322922804949911,20.0,0.0
1697,0,1697,[302 187 603 180 427],90,5,7341,4.323321554770318,20.0,0.0
1698,0,1698,[302 187 603 180 427],474,5,7346,4.323719835197175,20.0,0.0
1699,0,1699,[215  71 427 234 228],533,4,7350,4.323529411764706,0.0,0.0
1700,0,1700,[302 187 603 180 427],666,5,7355,4.3239271017048795,20.0,0.0
1701,0,1701,[302 187 603 180 427],537,5,7360,4.324324324324325,20.0,0.0
1702,0,1702,[302 187 603 180 427],339,5,7365,4.324721080446271,20.0,0.0
1703,0,1703,[302 187 603 180 427],537,5,7370,4.325117370892019,20.0,0.0
1704,0,1704,[302 187 603 180 427],339,5,7375,4.325513196480938,20.0,0.0
1705,0,1705,[302 187 603 180 427],271,5,7380,4.325908558030481,20.0,0.0
1706,0,1706,[471 405  50 144 515],7,3,7383,4.325131810193322,0.0,20.0
1707,0,1707,[302 187 603 180 427],90,5,7388,4.325526932084309,20.0,0.0
1708,0,1708,[302 187 603 180 427],271,5,7393,4.32592159157402,20.0,0.0
1709,0,1709,[302 187 603 180 427],13,5,7398,4.326315789473684,20.0,0.0
1710,0,1710,[302 187 603 180 427],664,5,7403,4.326709526592636,20.0,0.0
1711,0,1711,[302 187 603 180 427],271,5,7408,4.327102803738318,20.0,0.0
1712,0,1712,[302 187 603 180 427],13,5,7413,4.327495621716287,20.0,0.0
1713,0,1713,[302 187 603 180 427],271,5,7418,4.327887981330222,20.0,0.0
1714,0,1714,[302 187 603 180 427],271,5,7423,4.328279883381924,20.0,0.0
1715,0,1715,[302 187 603 180 427],664,5,7428,4.328671328671328,20.0,0.0
1716,0,1716,[265  56 172 187 515],881,4,7432,4.328479906814211,0.0,0.0
1717,0,1717,[302 187 603 180 427],339,5,7437,4.328870779976717,20.0,0.0
1718,0,1718,[302 187 603 180 427],537,5,7442,4.329261198371146,20.0,0.0
1719,0,1719,[168 471 313 238 257],271,3,7445,4.328488372093023,0.0,0.0
1720,0,1720,[127 111 496  89 257],271,4,7449,4.328297501452644,0.0,20.0
1721,0,1721,[135 423  50 179 435],524,4,7453,4.328106852497096,0.0,20.0
1722,0,1722,[302 187 603 180 427],458,5,7458,4.32849680789321,20.0,0.0
1723,0,1723,[302 187 603 180 427],271,5,7463,4.328886310904872,20.0,0.0
1724,0,1724,[302 187 603 180 427],664,5,7468,4.329275362318841,20.0,0.0
1725,0,1725,[588  22 483 282 238],95,3,7471,4.328505214368482,20.0,0.0
1726,0,1726,[302 187 603 180 427],90,5,7476,4.328894035900405,20.0,0.0
1727,0,1727,[405 179 168 235 202],833,4,7480,4.328703703703703,0.0,0.0
1728,0,1728,[302 187 603 180 427],458,5,7485,4.329091960670908,20.0,0.0
1729,0,1729,[302 187 603 180 427],458,5,7490,4.329479768786127,20.0,0.0
1730,0,1730,[302 187 603 180 427],13,5,7495,4.329867128827267,20.0,0.0
1731,0,1731,[302 187 603 180 427],90,5,7500,4.330254041570439,20.0,0.0
1732,0,1732,[302 187 603 180 427],271,5,7505,4.330640507789959,20.0,0.0
1733,0,1733,[172 234   7 215 597],59,4,7509,4.33044982698962,0.0,0.0
1734,0,1734,[496 151 265 300 211],234,1,7510,4.328530259365994,0.0,0.0
1735,0,1735,[302 187 603 180 427],474,5,7515,4.328917050691245,20.0,0.0
1736,0,1736,[302 187 603 180 427],90,5,7520,4.32930339666091,20.0,0.0
1737,0,1737,[143 238  64 125  97],213,5,7525,4.3296892980437285,0.0,0.0
1738,0,1738,[302 187 603 180 427],664,5,7530,4.33007475560667,20.0,0.0
1739,0,1739,[174 268 237   8 180],13,5,7535,4.330459770114943,0.0,20.0
1740,0,1740,[302 187 603 180 427],13,5,7540,4.330844342331993,20.0,0.0
1741,0,1741,[302 187 603 180 427],339,5,7545,4.331228473019518,20.0,0.0
1742,0,1742,[228 172 235 257 174],279,3,7548,4.330464716006885,0.0,20.0
1743,0,1743,[302 187 603 180 427],339,5,7553,4.330848623853211,20.0,0.0
1744,0,1744,[161 215 515 186 238],804,5,7558,4.331232091690544,0.0,0.0
1745,0,1745,[302 187 603 180 427],458,5,7563,4.331615120274914,20.0,0.0
1746,0,1746,[204  88 183 234 176],749,5,7568,4.331997710360618,0.0,0.0
1747,0,1747,[302 187 603 180 427],537,5,7573,4.332379862700229,20.0,0.0
1748,0,1748,[302 187 603 180 427],458,5,7578,4.332761578044597,20.0,0.0
1749,0,1749,[302 187 603 180 427],13,5,7583,4.333142857142857,20.0,0.0
1750,0,1750,[ 64  11 117  96 258],749,5,7588,4.3335237007424325,0.0,0.0
1751,0,1751,[385  56  11 483 435],454,0,7588,4.331050228310502,20.0,0.0
1752,0,1752,[302 187 603 180 427],474,5,7593,4.331431831146606,20.0,0.0
1753,0,1753,[302 187 603 180 427],458,5,7598,4.331812998859749,20.0,0.0
1754,0,1754,[302 187 603 180 427],13,5,7603,4.3321937321937325,20.0,0.0
1755,0,1755,[302 187 603 180 427],474,5,7608,4.332574031890661,20.0,0.0
1756,0,1756,[302 187 603 180 427],664,5,7613,4.332953898690951,20.0,0.0
1757,0,1757,[302 187 603 180 427],664,5,7618,4.333333333333333,20.0,0.0
1758,0,1758,[655  56   8 238   9],881,2,7620,4.332006822057988,0.0,0.0
1759,0,1759,[174 742 333   7  50],334,4,7624,4.331818181818182,0.0,40.0
1760,0,1760,[172  89 269 323 125],378,3,7627,4.331061896649631,0.0,0.0
1761,0,1761,[323 204 318 151 237],59,4,7631,4.3308740068104425,20.0,0.0
1762,0,1762,[302 187 603 180 427],664,5,7636,4.33125354509359,20.0,0.0
1763,0,1763,[ 50 204 302  79 483],666,2,7638,4.329931972789115,20.0,20.0
1764,0,1764,[302 187 603 180 427],664,5,7643,4.330311614730878,20.0,0.0
1765,0,1765,[301 183   9 180 181],458,3,7646,4.329558323895809,0.0,0.0
1766,0,1766,[302 187 603 180 427],666,5,7651,4.329937747594793,20.0,0.0
1767,0,1767,[ 97 323 403 172 385],881,2,7653,4.328619909502263,0.0,0.0
1768,0,1768,[302 187 603 180 427],339,5,7658,4.328999434708875,20.0,0.0
1769,0,1769,[302 187 603 180 427],666,5,7663,4.329378531073447,20.0,0.0
1770,0,1770,[215 237  25 197 174],378,4,7667,4.329192546583851,0.0,20.0
1771,0,1771,[117 333   7 183 237],144,3,7670,4.3284424379232505,0.0,0.0
1772,0,1772,[302 187 603 180 427],537,5,7675,4.328821206993796,20.0,0.0
1773,0,1773,[302 187 603 180 427],90,5,7680,4.3291995490417134,20.0,0.0
1774,0,1774,[168 286 222 186 568],881,2,7682,4.327887323943662,0.0,0.0
1775,0,1775,[302 187 603 180 427],90,5,7687,4.3282657657657655,20.0,0.0
1776,0,1776,[302 187 603 180 427],90,5,7692,4.328643781654474,20.0,0.0
1777,0,1777,[302 187 603 180 427],339,5,7697,4.329021372328459,20.0,0.0
1778,0,1778,[275 286  69 132  89],184,4,7701,4.328836424957841,0.0,0.0
1779,0,1779,[385 568 168 200 135],543,2,7703,4.3275280898876405,0.0,0.0
1780,0,1780,[302 187 603 180 427],666,5,7708,4.327905670971364,20.0,0.0
1781,0,1781,[111 286  97 168 135],452,3,7711,4.327160493827161,0.0,0.0
1782,0,1782,[302 187 603 180 427],474,5,7716,4.327537857543466,20.0,0.0
1783,0,1783,[302 187 603 180 427],90,5,7721,4.327914798206278,20.0,0.0
1784,0,1784,[302 187 603 180 427],339,5,7726,4.32829131652661,20.0,0.0
1785,0,1785,[302 187 603 180 427],271,5,7731,4.328667413213886,20.0,0.0
1786,0,1786,[302 187 603 180 427],458,5,7736,4.329043088975937,20.0,0.0
1787,0,1787,[302 187 603 180 427],90,5,7741,4.3294183445190155,20.0,0.0
1788,0,1788,[117 301 143 127 265],334,1,7742,4.327557294577977,0.0,20.0
1789,0,1789,[302 187 603 180 427],664,5,7747,4.327932960893855,20.0,0.0
1790,0,1790,[210 475   9 135 496],64,4,7751,4.327749860413177,0.0,0.0
1791,0,1791,[302 187 603 180 427],474,5,7756,4.328125,20.0,0.0
1792,0,1792,[302 187 603 180 427],664,5,7761,4.328499721137758,20.0,0.0
1793,0,1793,[186 515 204 234  79],666,1,7762,4.326644370122631,0.0,0.0
1794,0,1794,[302 187 603 180 427],474,5,7767,4.3270194986072426,20.0,0.0
1795,0,1795,[302 187 603 180 427],666,5,7772,4.327394209354121,20.0,0.0
1796,0,1796,[302 187 603 180 427],474,5,7777,4.327768503060657,20.0,0.0
1797,0,1797,[210 385 265 318 568],59,5,7782,4.328142380422692,20.0,0.0
1798,0,1798,[302 187 603 180 427],13,5,7787,4.328515842134519,20.0,0.0
1799,0,1799,[302 187 603 180 427],664,5,7792,4.328888888888889,20.0,0.0
1800,0,1800,[302 187 603 180 427],13,5,7797,4.3292615213770125,20.0,0.0
1801,0,1801,[496  79 273 403  88],479,3,7800,4.328523862375139,0.0,0.0
1802,0,1802,[302 187 603 180 427],13,5,7805,4.328896283971159,20.0,0.0
1803,0,1803,[302 187 603 180 427],537,5,7810,4.329268292682927,20.0,0.0
1804,0,1804,[194 385 132 183 144],194,2,7812,4.32797783933518,0.0,0.0
1805,0,1805,[258   1  89 186 546],64,2,7814,4.326688815060908,0.0,0.0
1806,0,1806,[202 258 210 172  56],184,2,7816,4.325401217487548,0.0,0.0
1807,0,1807,[302 187 603 180 427],666,5,7821,4.325774336283186,20.0,0.0
1808,0,1808,[302 187 603 180 427],666,5,7826,4.326147042564953,20.0,0.0
1809,0,1809,[302 187 603 180 427],537,5,7831,4.326519337016575,20.0,0.0
1810,0,1810,[655  64 237  98 276],13,5,7836,4.326891220320265,0.0,20.0
1811,0,1811,[302 187 603 180 427],458,5,7841,4.327262693156733,20.0,0.0
1812,0,1812,[ 89 265 197 135 132],474,5,7846,4.327633756205185,0.0,0.0
1813,0,1813,[302 187 603 180 427],474,5,7851,4.32800441014333,20.0,0.0
1814,0,1814,[302 187 603 180 427],537,5,7856,4.328374655647383,20.0,0.0
1815,0,1815,[302 187 603 180 427],664,5,7861,4.328744493392071,20.0,0.0
1816,0,1816,[302 187 603 180 427],271,5,7866,4.329113924050633,20.0,0.0
1817,0,1817,[302 187 603 180 427],666,5,7871,4.32948294829483,20.0,0.0
1818,0,1818,[333  25 187 258 127],313,3,7874,4.328752061572293,0.0,20.0
1819,0,1819,[245 288 597 194 286],458,1,7875,4.326923076923077,0.0,0.0
1820,0,1820,[302 187 603 180 427],537,5,7880,4.327292696320703,20.0,0.0
1821,0,1821,[234 151 222 210 235],932,2,7882,4.326015367727772,0.0,0.0
1822,0,1822,[216 195 289  82   4],883,4,7886,4.325836533187054,0.0,0.0
1823,0,1823,[655 515  97 269 204],339,4,7890,4.3256578947368425,0.0,0.0
1824,0,1824,[385  98  15 179  50],378,4,7894,4.325479452054794,0.0,40.0
1825,0,1825,[302 187 603 180 427],666,5,7899,4.325848849945236,20.0,0.0
1826,0,1826,[185  88 275 289  70],454,2,7901,4.324575807334428,0.0,0.0
1827,0,1827,[302 187 603 180 427],474,5,7906,4.324945295404814,20.0,0.0
1828,0,1828,[302 187 603 180 427],13,5,7911,4.325314379442318,20.0,0.0
1829,0,1829,[302 187 603 180 427],458,5,7916,4.32568306010929,20.0,0.0
1830,0,1830,[302 187 603 180 427],271,5,7921,4.32605133806663,20.0,0.0
1831,0,1831,[294  50 483  69  79],538,4,7925,4.325873362445415,20.0,20.0
1832,0,1832,[302 187 603 180 427],339,5,7930,4.326241134751773,20.0,0.0
1833,0,1833,[302 187 603 180 427],537,5,7935,4.326608505997819,20.0,0.0
1834,0,1834,[302 187 603 180 427],90,5,7940,4.3269754768392374,20.0,0.0
1835,0,1835,[742 185  82 186  98],543,3,7943,4.326252723311547,0.0,20.0
1836,0,1836,[182 222   9 238 273],145,4,7947,4.326075122482308,0.0,0.0
1837,0,1837,[302 187 603 180 427],13,5,7952,4.326441784548422,20.0,0.0
1838,0,1838,[302 187 603 180 427],664,5,7957,4.326808047852094,20.0,0.0
1839,0,1839,[302 187 603 180 427],537,5,7962,4.327173913043478,20.0,0.0
1840,0,1840,[302 187 603 180 427],458,5,7967,4.32753938077132,20.0,0.0
1841,0,1841,[302 187 603 180 427],474,5,7972,4.3279044516829535,20.0,0.0
1842,0,1842,[302 187 603 180 427],271,5,7977,4.328269126424308,20.0,0.0
1843,0,1843,[302 187 603 180 427],90,5,7982,4.328633405639914,20.0,0.0
1844,0,1844,[302 187 603 180 427],458,5,7987,4.3289972899729,20.0,0.0
1845,0,1845,[302 187 603 180 427],90,5,7992,4.329360780065006,20.0,0.0
1846,0,1846,[302 187 603 180 427],666,5,7997,4.329723876556578,20.0,0.0
1847,0,1847,[216 186  50 174  11],882,5,8002,4.33008658008658,0.0,40.0
1848,0,1848,[186 237 127  79  25],194,2,8004,4.328826392644673,0.0,20.0
1849,0,1849,[302 187 603 180 427],90,5,8009,4.329189189189189,20.0,0.0
1850,0,1850,[174 318 143  56 172],536,4,8013,4.329011345218801,20.0,20.0
1851,0,1851,[302 187 603 180 427],271,5,8018,4.329373650107992,20.0,0.0
1852,0,1852,[302 187 603 180 427],666,5,8023,4.329735563950351,20.0,0.0
1853,0,1853,[302 187 603 180 427],666,5,8028,4.330097087378641,20.0,0.0
1854,0,1854,[302 187 603 180 427],271,5,8033,4.330458221024259,20.0,0.0
1855,0,1855,[302 187 603 180 427],474,5,8038,4.330818965517241,20.0,0.0
1856,0,1856,[ 88 111 202 211 132],95,3,8041,4.330102315562735,0.0,0.0
1857,0,1857,[405   1 276 423 742],458,4,8045,4.329924650161464,0.0,0.0
1858,0,1858,[302 187 603 180 427],664,5,8050,4.330285099515868,20.0,0.0
1859,0,1859,[302 187 603 180 427],271,5,8055,4.330645161290323,20.0,0.0
1860,0,1860,[153 175 568 180  89],194,0,8055,4.328318108543794,0.0,0.0
1861,0,1861,[302 187 603 180 427],13,5,8060,4.3286788399570355,20.0,0.0
1862,0,1862,[ 12 196 111  89 435],271,4,8064,4.328502415458937,20.0,0.0
1863,0,1863,[234 161 173  82 475],452,2,8066,4.32725321888412,0.0,0.0
1864,0,1864,[ 98 215   1 515 151],804,4,8070,4.327077747989276,0.0,20.0
1865,0,1865,[302 187 603 180 427],474,5,8075,4.327438370846731,20.0,0.0
1866,0,1866,[302 187 603 180 427],458,5,8080,4.3277986073915375,20.0,0.0
1867,0,1867,[235  97 187  88 323],13,3,8083,4.327087794432548,0.0,0.0
1868,0,1868,[302 187 603 180 427],537,5,8088,4.32744783306581,20.0,0.0
1869,0,1869,[302 187 603 180 427],339,5,8093,4.327807486631016,20.0,0.0
1870,0,1870,[195 275 286 385 742],533,5,8098,4.328166755745591,0.0,0.0
1871,0,1871,[603 238 211 515 471],543,3,8101,4.327457264957265,20.0,0.0
1872,0,1872,[302 187 603 180 427],666,5,8106,4.327816337426588,20.0,0.0
1873,0,1873,[173 265 238 111  79],479,5,8111,4.3281750266808965,0.0,0.0
1874,0,1874,[302 187 603 180 427],458,5,8116,4.328533333333334,20.0,0.0
1875,0,1875,[301 597 546 257 302],378,2,8118,4.3272921108742,0.0,0.0
1876,0,1876,[302 187 603 180 427],537,5,8123,4.3276505061267985,20.0,0.0
1877,0,1877,[302 187 603 180 427],458,5,8128,4.32800851970181,20.0,0.0
1878,0,1878,[216  25 275 181 405],882,4,8132,4.327833954230974,0.0,0.0
1879,0,1879,[302 187 603 180 427],537,5,8137,4.328191489361702,20.0,0.0
1880,0,1880,[302 187 603 180 427],90,5,8142,4.328548644338118,20.0,0.0
1881,0,1881,[  4 678 483 174 655],664,3,8145,4.3278427205100956,20.0,20.0
1882,0,1882,[302 187 603 180 427],537,5,8150,4.328199681359533,20.0,0.0
1883,0,1883,[302 187 603 180 427],537,5,8155,4.328556263269639,20.0,0.0
1884,0,1884,[302 187 603 180 427],339,5,8160,4.3289124668435015,20.0,0.0
1885,0,1885,[302 187 603 180 427],339,5,8165,4.329268292682927,20.0,0.0
1886,0,1886,[483 151 174 180  25],804,4,8169,4.329093799682035,20.0,20.0
1887,0,1887,[302 187 603 180 427],271,5,8174,4.329449152542373,20.0,0.0
1888,0,1888,[302 187 603 180 427],339,5,8179,4.329804129168872,20.0,0.0
1889,0,1889,[302 187 603 180 427],90,5,8184,4.33015873015873,20.0,0.0
1890,0,1890,[268 196 175 174 269],288,4,8188,4.329984135378107,0.0,20.0
1891,0,1891,[302 187 603 180 427],339,5,8193,4.330338266384778,20.0,0.0
1892,0,1892,[ 12  97  56 357 135],774,0,8193,4.328050713153724,40.0,0.0
1893,0,1893,[288  71 435 135   4],64,3,8196,4.327349524815206,0.0,0.0
1894,0,1894,[302 187 603 180 427],13,5,8201,4.327704485488127,20.0,0.0
1895,0,1895,[302 187 603 180 427],474,5,8206,4.328059071729958,20.0,0.0
1896,0,1896,[302 187 603 180 427],90,5,8211,4.328413284132841,20.0,0.0
1897,0,1897,[282 172 197  95 215],804,4,8215,4.328240252897787,0.0,0.0
1898,0,1898,[471 238 100 182 313],537,4,8219,4.328067403896788,0.0,20.0
1899,0,1899,[182 204  50 144 302],328,3,8222,4.327368421052632,0.0,20.0
1900,0,1900,[216 357 258 237 172],271,4,8226,4.327196212519726,20.0,0.0
1901,0,1901,[179 475 597 234 182],308,3,8229,4.326498422712934,0.0,0.0
1902,0,1902,[302 187 603 180 427],90,5,8234,4.326852338413032,20.0,0.0
1903,0,1903,[302 187 603 180 427],537,5,8239,4.327205882352941,20.0,0.0
1904,0,1904,[302 187 603 180 427],474,5,8244,4.32755905511811,20.0,0.0
1905,0,1905,[302 187 603 180 427],666,5,8249,4.32791185729276,20.0,0.0
1906,0,1906,[385 286 235 546 204],788,1,8250,4.3261667540639746,0.0,0.0
1907,0,1907,[302 187 603 180 427],474,5,8255,4.326519916142558,20.0,0.0
1908,0,1908,[302 187 603 180 427],339,5,8260,4.326872708224201,20.0,0.0
1909,0,1909,[302 187 603 180 427],271,5,8265,4.327225130890052,20.0,0.0
1910,0,1910,[322 161 222 118 286],524,4,8269,4.32705389848247,0.0,0.0
1911,0,1911,[302 187 603 180 427],666,5,8274,4.327405857740586,20.0,0.0
1912,0,1912,[275 118  11  56  89],378,4,8278,4.32723470987977,0.0,0.0
1913,0,1913,[302 187 603 180 427],666,5,8283,4.327586206896552,20.0,0.0
1914,0,1914,[300 273 276 301 143],90,3,8286,4.326892950391645,0.0,0.0
1915,0,1915,[302 187 603 180 427],339,5,8291,4.327244258872652,20.0,0.0
1916,0,1916,[302 187 603 180 427],664,5,8296,4.3275952008346374,20.0,0.0
1917,0,1917,[302 187 603 180 427],537,5,8301,4.327945776850886,20.0,0.0
1918,0,1918,[302 187 603 180 427],90,5,8306,4.328295987493486,20.0,0.0
1919,0,1919,[302 187 603 180 427],537,5,8311,4.328645833333334,20.0,0.0
1920,0,1920,[302 187 603 180 427],90,5,8316,4.328995314940135,20.0,0.0
1921,0,1921,[588 187  22 515  50],311,5,8321,4.329344432882414,0.0,20.0
1922,0,1922,[302 187 603 180 427],474,5,8326,4.329693187727509,20.0,0.0
1923,0,1923,[302 187 603 180 427],664,5,8331,4.33004158004158,20.0,0.0
1924,0,1924,[234 173 172 100  79],804,5,8336,4.33038961038961,0.0,20.0
1925,0,1925,[302 187 603 180 427],271,5,8341,4.33073727933541,20.0,0.0
1926,0,1926,[302 187 603 180 427],458,5,8346,4.3310845874416195,20.0,0.0
1927,0,1927,[275  97 194 127  69],458,2,8348,4.329875518672199,0.0,20.0
1928,0,1928,[172 187 385 294 168],488,3,8351,4.3291861067910835,0.0,0.0
1929,0,1929,[237  70 132 179 181],194,1,8352,4.327461139896373,0.0,0.0
1930,0,1930,[302 187 603 180 427],458,5,8357,4.327809425168306,20.0,0.0
1931,0,1931,[153 318 475 269 268],334,4,8361,4.327639751552795,20.0,0.0
1932,0,1932,[302 187 603 180 427],666,5,8366,4.327987584066219,20.0,0.0
1933,0,1933,[302 187 603 180 427],664,5,8371,4.328335056876939,20.0,0.0
1934,0,1934,[302 187 603 180 427],13,5,8376,4.328682170542636,20.0,0.0
1935,0,1935,[302 187 603 180 427],90,5,8381,4.329028925619835,20.0,0.0
1936,0,1936,[302 187 603 180 427],13,5,8386,4.329375322663913,20.0,0.0
1937,0,1937,[302 187 603 180 427],664,5,8391,4.329721362229102,20.0,0.0
1938,0,1938,[302 187 603 180 427],474,5,8396,4.330067044868489,20.0,0.0
1939,0,1939,[302 187 603 180 427],664,5,8401,4.33041237113402,20.0,0.0
1940,0,1940,[302 187 603 180 427],474,5,8406,4.330757341576507,20.0,0.0
1941,0,1941,[302 187 603 180 427],474,5,8411,4.3311019567456235,20.0,0.0
1942,0,1942,[302 187 603 180 427],90,5,8416,4.331446217189913,20.0,0.0
1943,0,1943,[302 187 603 180 427],458,5,8421,4.33179012345679,20.0,0.0
1944,0,1944,[302 187 603 180 427],666,5,8426,4.332133676092545,20.0,0.0
1945,0,1945,[302 187 603 180 427],537,5,8431,4.332476875642343,20.0,0.0
1946,0,1946,[405 182  11  71  82],64,2,8433,4.331278890600925,0.0,0.0
1947,0,1947,[161 276 271 222 333],334,3,8436,4.330595482546201,0.0,0.0
1948,0,1948,[302 187 603 180 427],13,5,8441,4.330938943047717,20.0,0.0
1949,0,1949,[265  69 216  15 435],650,3,8444,4.3302564102564105,0.0,0.0
1950,0,1950,[143  50 173 185 202],234,1,8445,4.328549461814454,0.0,20.0
1951,0,1951,[191 143  89 176 215],200,5,8450,4.328893442622951,0.0,0.0
1952,0,1952,[385   7 216 588 127],804,4,8454,4.328725038402458,0.0,20.0
1953,0,1953,[302 187 603 180 427],339,5,8459,4.32906857727738,20.0,0.0
1954,0,1954,[302 187 603 180 427],537,5,8464,4.329411764705882,20.0,0.0
1955,0,1955,[302 187 603 180 427],474,5,8469,4.329754601226994,20.0,0.0
1956,0,1956,[302 187 603 180 427],666,5,8474,4.330097087378641,20.0,0.0
1957,0,1957,[302 187 603 180 427],13,5,8479,4.330439223697651,20.0,0.0
1958,0,1958,[  7 118 183 182 300],13,3,8482,4.329760081674324,0.0,0.0
1959,0,1959,[302 187 603 180 427],271,5,8487,4.330102040816326,20.0,0.0
1960,0,1960,[302 187 603 180 427],271,5,8492,4.330443651198368,20.0,0.0
1961,0,1961,[258 238 318  96  12],311,5,8497,4.330784913353721,40.0,0.0
1962,0,1962,[322 187 405 403   1],804,4,8501,4.330616403464085,0.0,0.0
1963,0,1963,[302 187 603 180 427],666,5,8506,4.330957230142566,20.0,0.0
1964,0,1964,[302 187 603 180 427],537,5,8511,4.331297709923664,20.0,0.0
1965,0,1965,[302 187 603 180 427],664,5,8516,4.331637843336725,20.0,0.0
1966,0,1966,[168   9 117 435  96],881,1,8517,4.329944077275038,0.0,0.0
1967,0,1967,[302 187 603 180 427],666,5,8522,4.330284552845528,20.0,0.0
1968,0,1968,[302 187 603 180 427],271,5,8527,4.33062468257999,20.0,0.0
1969,0,1969,[302 187 603 180 427],474,5,8532,4.330964467005076,20.0,0.0
1970,0,1970,[302 187 603 180 427],90,5,8537,4.331303906646372,20.0,0.0
1971,0,1971,[302 187 603 180 427],666,5,8542,4.331643002028398,20.0,0.0
1972,0,1972,[302 187 603 180 427],90,5,8547,4.331981753674607,20.0,0.0
1973,0,1973,[ 28 313 603 403   7],64,4,8551,4.331813576494428,20.0,0.0
1974,0,1974,[302 187 603 180 427],664,5,8556,4.332151898734177,20.0,0.0
1975,0,1975,[302 187 603 180 427],666,5,8561,4.3324898785425106,20.0,0.0
1976,0,1976,[302 187 603 180 427],90,5,8566,4.332827516439049,20.0,0.0
1977,0,1977,[302 187 603 180 427],458,5,8571,4.333164812942366,20.0,0.0
1978,0,1978,[302 187 603 180 427],90,5,8576,4.333501768569985,20.0,0.0
1979,0,1979,[302 187 603 180 427],458,5,8581,4.333838383838384,20.0,0.0
1980,0,1980,[302 187 603 180 427],13,5,8586,4.334174659262999,20.0,0.0
1981,0,1981,[202 288  12 194  28],643,4,8590,4.3340060544904135,20.0,0.0
1982,0,1982,[302 187 603 180 427],458,5,8595,4.334341906202723,20.0,0.0
1983,0,1983,[ 64 234 117   9 151],378,3,8598,4.33366935483871,0.0,0.0
1984,0,1984,[173 258  71  69 289],85,3,8601,4.332997481108312,0.0,0.0
1985,0,1985,[302 187 603 180 427],664,5,8606,4.333333333333333,20.0,0.0
1986,0,1986,[302 187 603 180 427],339,5,8611,4.333668847508807,20.0,0.0
1987,0,1987,[302 187 603 180 427],537,5,8616,4.334004024144869,20.0,0.0
1988,0,1988,[302 187 603 180 427],474,5,8621,4.334338863750628,20.0,0.0
1989,0,1989,[100 322 328  64 357],804,5,8626,4.334673366834171,20.0,20.0
1990,0,1990,[132 265 111 173  64],59,5,8631,4.335007533902561,0.0,0.0
1991,0,1991,[655 168 258 173 515],815,3,8634,4.3343373493975905,0.0,0.0
1992,0,1992,[302 187 603 180 427],666,5,8639,4.334671349724034,20.0,0.0
1993,0,1993,[302 187 603 180 427],458,5,8644,4.335005015045136,20.0,0.0
1994,0,1994,[302 187 603 180 427],474,5,8649,4.3353383458646615,20.0,0.0
1995,0,1995,[237 117 174 210   8],313,3,8652,4.3346693386773545,0.0,20.0
1996,0,1996,[302 187 603 180 427],339,5,8657,4.335002503755633,20.0,0.0
1997,0,1997,[302 187 603 180 427],458,5,8662,4.335335335335335,20.0,0.0
1998,0,1998,[302 187 603 180 427],13,5,8667,4.3356678339169585,20.0,0.0
1999,0,1999,[302 187 603 180 427],474,5,8672,4.336,20.0,0.0
2000,0,2000,[286   4  97 423 168],343,5,8677,4.336331834082959,0.0,0.0
2001,0,2001,[302 187 603 180 427],474,5,8682,4.336663336663337,20.0,0.0
2002,0,2002,[302 187 603 180 427],664,5,8687,4.336994508237644,20.0,0.0
2003,0,2003,[302 187 603 180 427],458,5,8692,4.3373253493013975,20.0,0.0
2004,0,2004,[288  69 111  82  70],643,2,8694,4.336159600997506,0.0,0.0
2005,0,2005,[302 187 603 180 427],458,5,8699,4.336490528414756,20.0,0.0
2006,0,2006,[ 79 234 423 127 211],749,5,8704,4.336821126058794,0.0,20.0
2007,0,2007,[302 187 603 180 427],666,5,8709,4.33715139442231,20.0,0.0
2008,0,2008,[172 186 135 300 508],533,3,8712,4.33648581383773,0.0,0.0
2009,0,2009,[302 187 603 180 427],474,5,8717,4.33681592039801,20.0,0.0
2010,0,2010,[302 187 603 180 427],458,5,8722,4.337145698657384,20.0,0.0
2011,0,2011,[200 153 405 258 183],447,3,8725,4.33648111332008,0.0,0.0
2012,0,2012,[302 187 603 180 427],666,5,8730,4.336810730253354,20.0,0.0
2013,0,2013,[302 187 603 180 427],666,5,8735,4.337140019860973,20.0,0.0
2014,0,2014,[302 187 603 180 427],664,5,8740,4.337468982630273,20.0,0.0
2015,0,2015,[289 196 318 546 742],374,2,8742,4.336309523809524,20.0,0.0
2016,0,2016,[273 100 357 245 202],749,4,8746,4.336142786316311,20.0,20.0
2017,0,2017,[302 187 603 180 427],666,5,8751,4.336471754212091,20.0,0.0
2018,0,2018,[302 187 603 180 427],474,5,8756,4.33680039623576,20.0,0.0
2019,0,2019,[302 187 603 180 427],664,5,8761,4.337128712871287,20.0,0.0
2020,0,2020,[302 187 603 180 427],13,5,8766,4.337456704601682,20.0,0.0
2021,0,2021,[302 187 603 180 427],537,5,8771,4.337784371909001,20.0,0.0
2022,0,2022,[588  12 222   4 215],194,3,8774,4.337123084527929,20.0,0.0
2023,0,2023,[403 191  82 179 195],848,4,8778,4.336956521739131,0.0,0.0
2024,0,2024,[302 187 603 180 427],339,5,8783,4.337283950617284,20.0,0.0
2025,0,2025,[302 187 603 180 427],474,5,8788,4.33761105626851,20.0,0.0
2026,0,2026,[ 97  50  79 135 403],308,4,8792,4.33744449925999,0.0,20.0
2027,0,2027,[302 187 603 180 427],666,5,8797,4.337771203155818,20.0,0.0
2028,0,2028,[302 187 603 180 427],13,5,8802,4.33809758501725,20.0,0.0
2029,0,2029,[302 187 603 180 427],271,5,8807,4.338423645320197,20.0,0.0
2030,0,2030,[471 323 216 496 100],311,3,8810,4.337764647956671,0.0,20.0
2031,0,2031,[302 187 603 180 427],458,5,8815,4.338090551181103,20.0,0.0
2032,0,2032,[173 196 265 179 405],92,3,8818,4.337432365961633,0.0,0.0
2033,0,2033,[174  22  28 211 118],648,5,8823,4.337758112094395,0.0,20.0
2034,0,2034,[302 187 603 180 427],474,5,8828,4.338083538083538,20.0,0.0
2035,0,2035,[302 187 603 180 427],458,5,8833,4.338408644400785,20.0,0.0
2036,0,2036,[302 187 603 180 427],90,5,8838,4.338733431516936,20.0,0.0
2037,0,2037,[302 187 603 180 427],339,5,8843,4.3390578999018645,20.0,0.0
2038,0,2038,[302 187 603 180 427],664,5,8848,4.339382050024522,20.0,0.0
2039,0,2039,[302 187 603 180 427],458,5,8853,4.339705882352941,20.0,0.0
2040,0,2040,[  8 483 286 405 151],334,4,8857,4.3395394414502695,20.0,0.0
2041,0,2041,[302 187 603 180 427],271,5,8862,4.339862879529873,20.0,0.0
2042,0,2042,[302 187 603 180 427],537,5,8867,4.340186000978952,20.0,0.0
2043,0,2043,[302 187 603 180 427],474,5,8872,4.340508806262231,20.0,0.0
2044,0,2044,[322 471  56 183 655],788,2,8874,4.339364303178484,0.0,0.0
2045,0,2045,[302 187 603 180 427],537,5,8879,4.339687194525904,20.0,0.0
2046,0,2046,[302 187 603 180 427],90,5,8884,4.340009770395701,20.0,0.0
2047,0,2047,[423 301 294  97 748],328,1,8885,4.33837890625,0.0,0.0
2048,0,2048,[357 597 471  89 742],328,3,8888,4.337725719863348,20.0,0.0
2049,0,2049,[302 187 603 180 427],90,5,8893,4.338048780487805,20.0,0.0
2050,0,2050,[111  82  96 403 427],42,3,8896,4.3373963920039005,0.0,0.0
2051,0,2051,[237 197 385 121 748],313,3,8899,4.336744639376218,0.0,0.0
2052,0,2052,[294  64 187 234 183],144,5,8904,4.337067705796396,0.0,0.0
2053,0,2053,[179 385 403 161  64],64,4,8908,4.336903602726387,0.0,0.0
2054,0,2054,[269 194   1 197 200],650,4,8912,4.336739659367397,0.0,0.0
2055,0,2055,[302 187 603 180 427],339,5,8917,4.337062256809339,20.0,0.0
2056,0,2056,[496 176 194  88 175],749,4,8921,4.336898395721925,0.0,0.0
2057,0,2057,[302 187 603 180 427],474,5,8926,4.337220602526725,20.0,0.0
2058,0,2058,[175 173 235 742 322],524,2,8928,4.336085478387567,0.0,0.0
2059,0,2059,[302 187 603 180 427],13,5,8933,4.336407766990291,20.0,0.0
2060,0,2060,[302 187 603 180 427],664,5,8938,4.33672974284328,20.0,0.0
2061,0,2061,[302 187 603 180 427],13,5,8943,4.337051406401552,20.0,0.0
2062,0,2062,[302 187 603 180 427],339,5,8948,4.337372758119244,20.0,0.0
2063,0,2063,[302 187 603 180 427],339,5,8953,4.337693798449612,20.0,0.0
2064,0,2064,[111  56 215   4 144],749,3,8956,4.337046004842615,0.0,0.0
2065,0,2065,[302 187 603 180 427],537,5,8961,4.337366892545982,20.0,0.0
2066,0,2066,[302 187 603 180 427],271,5,8966,4.337687469762941,20.0,0.0
2067,0,2067,[302 187 603 180 427],664,5,8971,4.338007736943907,20.0,0.0
2068,0,2068,[187 323  64  11 143],59,4,8975,4.337844369260512,0.0,0.0
2069,0,2069,[302 187 603 180 427],271,5,8980,4.338164251207729,20.0,0.0
2070,0,2070,[238 328 313 118 289],13,2,8982,4.337035248672139,0.0,0.0
2071,0,2071,[302 187 603 180 427],458,5,8987,4.337355212355212,20.0,0.0
2072,0,2072,[302 187 603 180 427],339,5,8992,4.337674867342017,20.0,0.0
2073,0,2073,[302 187 603 180 427],339,5,8997,4.337994214079075,20.0,0.0
2074,0,2074,[302 187 603 180 427],474,5,9002,4.338313253012048,20.0,0.0
2075,0,2075,[302 187 603 180 427],339,5,9007,4.338631984585742,20.0,0.0
2076,0,2076,[302 187 603 180 427],537,5,9012,4.338950409244102,20.0,0.0
2077,0,2077,[302 187 603 180 427],666,5,9017,4.339268527430221,20.0,0.0
2078,0,2078,[302 187 603 180 427],537,5,9022,4.339586339586339,20.0,0.0
2079,0,2079,[302 187 603 180 427],271,5,9027,4.339903846153846,20.0,0.0
2080,0,2080,[ 79  50  89 197 210],774,1,9028,4.338298894762134,0.0,20.0
2081,0,2081,[211 111 132 405  28],447,3,9031,4.337656099903938,0.0,0.0
2082,0,2082,[313 180 182 118 175],378,4,9035,4.337493999039847,0.0,0.0
2083,0,2083,[302 187 603 427 180],458,5,9040,4.337811900191938,20.0,0.0
2084,0,2084,[302 187 603 427 180],474,5,9045,4.338129496402877,20.0,0.0
2085,0,2085,[302 187 603 427 180],339,5,9050,4.338446788111217,20.0,0.0
2086,0,2086,[273  25 276 323 678],168,2,9052,4.337326305701964,0.0,0.0
2087,0,2087,[271   1  79 603 483],13,2,9054,4.336206896551724,40.0,0.0
2088,0,2088,[  7 194 196 121 403],881,2,9056,4.335088559119196,0.0,0.0
2089,0,2089,[302 187 603 427 180],664,5,9061,4.335406698564594,20.0,0.0
2090,0,2090,[403 168 172 200 603],334,4,9065,4.335246293639407,20.0,0.0
2091,0,2091,[ 64 179 237 265 168],474,4,9069,4.33508604206501,0.0,0.0
2092,0,2092,[302 187 603 427 180],339,5,9074,4.3354037267080745,20.0,0.0
2093,0,2093,[302 187 603 427 180],474,5,9079,4.335721107927411,20.0,0.0
2094,0,2094,[ 71 181 294 173 172],7,3,9082,4.335083532219571,0.0,0.0
2095,0,2095,[302 187 603 427 180],666,5,9087,4.335400763358779,20.0,0.0
2096,0,2096,[204  28  82 151 496],537,1,9088,4.33381020505484,0.0,0.0
2097,0,2097,[174  89 475  88 132],343,4,9092,4.333651096282174,0.0,20.0
2098,0,2098,[302 187 603 427 180],13,5,9097,4.333968556455455,20.0,0.0
2099,0,2099,[302 187 603 427 180],474,5,9102,4.3342857142857145,20.0,0.0
2100,0,2100,[302 187 603 427 180],664,5,9107,4.334602570204664,20.0,0.0
2101,0,2101,[ 25  64 258 215 588],387,1,9108,4.333016175071361,0.0,0.0
2102,0,2102,[ 96  71  56 100 289],387,3,9111,4.3323823109843085,0.0,20.0
2103,0,2103,[302 187 603 427 180],474,5,9116,4.332699619771863,20.0,0.0
2104,0,2104,[302 187 603 427 180],271,5,9121,4.3330166270783845,20.0,0.0
2105,0,2105,[302 187 603 427 180],664,5,9126,4.333333333333333,20.0,0.0
2106,0,2106,[655 257 172 286  88],454,2,9128,4.332225913621262,0.0,0.0
2107,0,2107,[ 50 168 237 183 300],215,4,9132,4.332068311195446,0.0,20.0
2108,0,2108,[302 187 603 427 180],666,5,9137,4.332385016595543,20.0,0.0
2109,0,2109,[302 187 603 427 180],339,5,9142,4.332701421800948,20.0,0.0
2110,0,2110,[302 187 603 427 180],271,5,9147,4.333017527238276,20.0,0.0
2111,0,2111,[302 187 603 427 180],474,5,9152,4.333333333333333,20.0,0.0
2112,0,2112,[302 187 603 427 180],666,5,9157,4.333648840511121,20.0,0.0
2113,0,2113,[301 186 176 475 508],537,3,9160,4.333017975402082,0.0,0.0
2114,0,2114,[100  25  64  11 258],213,5,9165,4.333333333333333,0.0,20.0
2115,0,2115,[302 187 603 427 180],458,5,9170,4.333648393194707,20.0,0.0
2116,0,2116,[302 187 603 427 180],339,5,9175,4.333963155408597,20.0,0.0
2117,0,2117,[568   1 153 143  22],125,4,9179,4.333805476864967,0.0,0.0
2118,0,2118,[302 187 603 427 180],474,5,9184,4.334119867862199,20.0,0.0
2119,0,2119,[302 187 603 427 180],90,5,9189,4.334433962264151,20.0,0.0
2120,0,2120,[302 187 603 427 180],458,5,9194,4.334747760490335,20.0,0.0
2121,0,2121,[302 187 603 427 180],666,5,9199,4.3350612629594725,20.0,0.0
2122,0,2122,[ 71  22  95 257 475],308,5,9204,4.335374470089496,0.0,0.0
2123,0,2123,[302 187 603 427 180],339,5,9209,4.335687382297552,20.0,0.0
2124,0,2124,[117 282 427 289  28],271,3,9212,4.335058823529412,0.0,0.0
2125,0,2125,[302 187 603 427 180],537,5,9217,4.335371589840075,20.0,0.0
2126,0,2126,[302 187 603 427 180],271,5,9222,4.335684062059238,20.0,0.0
2127,0,2127,[273 603 168 423 181],643,3,9225,4.335056390977444,20.0,0.0
2128,0,2128,[302 187 603 427 180],664,5,9230,4.335368717707844,20.0,0.0
2129,0,2129,[302 187 603 427 180],271,5,9235,4.335680751173709,20.0,0.0
2130,0,2130,[222 228 100 546 405],279,2,9237,4.334584702017832,0.0,20.0
2131,0,2131,[302 187 603 427 180],458,5,9242,4.334896810506566,20.0,0.0
2132,0,2132,[302 187 603 427 180],13,5,9247,4.335208626347867,20.0,0.0
2133,0,2133,[302 187 603 427 180],271,5,9252,4.3355201499531395,20.0,0.0
2134,0,2134,[302 187 603 427 180],13,5,9257,4.335831381733021,20.0,0.0
2135,0,2135,[302 187 603 427 180],339,5,9262,4.336142322097379,20.0,0.0
2136,0,2136,[211 257 323 216 172],804,5,9267,4.336452971455311,0.0,0.0
2137,0,2137,[302 187 603 427 180],271,5,9272,4.336763330215154,20.0,0.0
2138,0,2138,[302 187 603 427 180],271,5,9277,4.3370733987844785,20.0,0.0
2139,0,2139,[302 187 603 427 180],458,5,9282,4.337383177570094,20.0,0.0
2140,0,2140,[302 187 603 427 180],666,5,9287,4.337692666978048,20.0,0.0
2141,0,2141,[121 196 211 322 183],207,2,9289,4.336601307189542,0.0,0.0
2142,0,2142,[302 187 603 427 180],664,5,9294,4.336910872608493,20.0,0.0
2143,0,2143,[302 187 603 427 180],666,5,9299,4.3372201492537314,20.0,0.0
2144,0,2144,[153 385  64 181 168],194,2,9301,4.336130536130536,0.0,0.0
2145,0,2145,[302 187 603 427 180],13,5,9306,4.336439888164026,20.0,0.0
2146,0,2146,[302 187 603 427 180],339,5,9311,4.336748952026083,20.0,0.0
2147,0,2147,[302 187 603 427 180],13,5,9316,4.337057728119181,20.0,0.0
2148,0,2148,[302 187 603 427 180],458,5,9321,4.337366216845044,20.0,0.0
2149,0,2149,[302 187 603 427 180],664,5,9326,4.337674418604651,20.0,0.0
2150,0,2150,[302 187 603 427 180],458,5,9331,4.337982333798234,20.0,0.0
2151,0,2151,[302 187 603 427 180],90,5,9336,4.338289962825279,20.0,0.0
2152,0,2152,[302 187 603 427 180],664,5,9341,4.338597306084533,20.0,0.0
2153,0,2153,[302 187 603 427 180],666,5,9346,4.3389043639740015,20.0,0.0
2154,0,2154,[302 187 603 427 180],90,5,9351,4.339211136890952,20.0,0.0
2155,0,2155,[302 187 603 427 180],664,5,9356,4.3395176252319105,20.0,0.0
2156,0,2156,[302 187 603 427 180],664,5,9361,4.339823829392675,20.0,0.0
2157,0,2157,[302 187 603 427 180],271,5,9366,4.340129749768304,20.0,0.0
2158,0,2158,[302 187 603 427 180],90,5,9371,4.340435386753127,20.0,0.0
2159,0,2159,[302 187 603 427 180],90,5,9376,4.340740740740741,20.0,0.0
2160,0,2160,[302 187 603 427 180],664,5,9381,4.341045812124016,20.0,0.0
2161,0,2161,[302 187 603 427 180],271,5,9386,4.3413506012950975,20.0,0.0
2162,0,2162,[300 196 181 357  88],840,3,9389,4.340730466944059,20.0,0.0
2163,0,2163,[302 187 603 427 180],458,5,9394,4.3410351201478745,20.0,0.0
2164,0,2164,[200 181 318 588 483],479,4,9398,4.340877598152425,40.0,0.0
2165,0,2165,[  1 742 655 403 216],95,4,9402,4.340720221606648,0.0,0.0
2166,0,2166,[ 82 235 180 195 186],59,4,9406,4.340562990309183,0.0,0.0
2167,0,2167,[268 546 186 180 196],92,4,9410,4.340405904059041,0.0,0.0
2168,0,2168,[196 228 186  50 322],334,3,9413,4.3397879207007835,0.0,20.0
2169,0,2169,[ 98  25 179 153  69],899,2,9415,4.338709677419355,0.0,20.0
2170,0,2170,[302 187 603 427 180],537,5,9420,4.33901427913404,20.0,0.0
2171,0,2171,[302 187 603 427 180],537,5,9425,4.339318600368324,20.0,0.0
2172,0,2172,[302 187 603 427 180],664,5,9430,4.339622641509434,20.0,0.0
2173,0,2173,[302 187 603 427 180],474,5,9435,4.339926402943882,20.0,0.0
2174,0,2174,[302 187 603 427 180],13,5,9440,4.340229885057472,20.0,0.0
2175,0,2175,[302 187 603 427 180],666,5,9445,4.340533088235294,20.0,0.0
2176,0,2176,[302 187 603 427 180],666,5,9450,4.340836012861736,20.0,0.0
2177,0,2177,[357 294  98 135 185],406,4,9454,4.340679522497704,20.0,20.0
2178,0,2178,[302 187 603 427 180],90,5,9459,4.340982101881597,20.0,0.0
2179,0,2179,[302 187 603 427 180],474,5,9464,4.341284403669725,20.0,0.0
2180,0,2180,[216  69 471 313 323],90,3,9467,4.340669417698304,0.0,0.0
2181,0,2181,[302 187 603 427 180],537,5,9472,4.340971585701191,20.0,0.0
2182,0,2182,[302 187 603 427 180],666,5,9477,4.341273476866697,20.0,0.0
2183,0,2183,[ 88 282 100 182 435],318,5,9482,4.341575091575091,0.0,20.0
2184,0,2184,[302 187 603 427 180],537,5,9487,4.34187643020595,20.0,0.0
2185,0,2185,[302 187 603 427 180],339,5,9492,4.342177493138152,20.0,0.0
2186,0,2186,[200  12 202 161 121],7,3,9495,4.341563786008231,20.0,0.0
2187,0,2187,[302 187 603 427 180],271,5,9500,4.341864716636198,20.0,0.0
2188,0,2188,[302 187 603 427 180],537,5,9505,4.342165372316126,20.0,0.0
2189,0,2189,[588 269  79  70 423],13,2,9507,4.341095890410959,0.0,0.0
2190,0,2190,[302 187 603 427 180],271,5,9512,4.341396622546783,20.0,0.0
2191,0,2191,[135  95   4  22 127],524,2,9514,4.3403284671532845,0.0,20.0
2192,0,2192,[187 143 215 196  69],59,4,9518,4.340173278613771,0.0,0.0
2193,0,2193,[302 187 603 427 180],271,5,9523,4.340474020054694,20.0,0.0
2194,0,2194,[172 179  28  22 322],13,3,9526,4.3398633257403185,0.0,0.0
2195,0,2195,[302 187 603 427 180],537,5,9531,4.340163934426229,20.0,0.0
2196,0,2196,[302 187 603 427 180],474,5,9536,4.340464269458352,20.0,0.0
2197,0,2197,[ 7 79 56 50 11],882,5,9541,4.340764331210191,0.0,20.0
2198,0,2198,[302 187 603 427 180],271,5,9546,4.34106412005457,20.0,0.0
2199,0,2199,[302 187 603 427 180],664,5,9551,4.341363636363637,20.0,0.0
2200,0,2200,[  1 588 197  50 742],313,4,9555,4.341208541572013,0.0,20.0
2201,0,2201,[210  70 216 144 118],87,5,9560,4.341507720254314,0.0,0.0
2202,0,2202,[302 187 603 427 180],474,5,9565,4.341806627326373,20.0,0.0
2203,0,2203,[302 187 603 427 180],458,5,9570,4.342105263157895,20.0,0.0
2204,0,2204,[302 187 603 427 180],90,5,9575,4.342403628117914,20.0,0.0
2205,0,2205,[302 187 603 427 180],537,5,9580,4.342701722574796,20.0,0.0
2206,0,2206,[302 187 603 427 180],458,5,9585,4.342999546896239,20.0,0.0
2207,0,2207,[302 187 603 427 180],339,5,9590,4.343297101449275,20.0,0.0
2208,0,2208,[302 187 603 427 180],537,5,9595,4.343594386600271,20.0,0.0
2209,0,2209,[302 187 603 427 180],537,5,9600,4.343891402714932,20.0,0.0
2210,0,2210,[235 423 435 403   4],648,4,9604,4.343735866123926,0.0,0.0
2211,0,2211,[302 187 603 427 180],13,5,9609,4.344032549728753,20.0,0.0
2212,0,2212,[302 187 603 427 180],666,5,9614,4.344328965205603,20.0,0.0
2213,0,2213,[  7 496   9 275 210],184,4,9618,4.3441734417344176,0.0,0.0
2214,0,2214,[302 187 603 427 180],90,5,9623,4.344469525959368,20.0,0.0
2215,0,2215,[471  64  95 234  56],378,4,9627,4.344314079422382,0.0,0.0
2216,0,2216,[288 603 196 215   8],308,3,9630,4.343707713125846,20.0,0.0
2217,0,2217,[302 187 603 427 180],474,5,9635,4.344003606853021,20.0,0.0
2218,0,2218,[302 187 603 427 180],666,5,9640,4.3442992338891395,20.0,0.0
2219,0,2219,[143 435 185 282 175],406,3,9643,4.343693693693694,0.0,0.0
2220,0,2220,[302 187 603 427 180],664,5,9648,4.343989194056731,20.0,0.0
2221,0,2221,[153  98 228 588 175],843,2,9650,4.342934293429343,0.0,20.0
2222,0,2222,[302 187 603 427 180],474,5,9655,4.343229869545659,20.0,0.0
2223,0,2223,[302 187 603 427 180],474,5,9660,4.343525179856115,20.0,0.0
2224,0,2224,[257   7  69  50 515],343,4,9664,4.343370786516854,0.0,20.0
2225,0,2225,[  7 143 323 257 183],650,3,9667,4.3427672955974845,0.0,0.0
2226,0,2226,[302 187 603 427 180],474,5,9672,4.343062415806017,20.0,0.0
2227,0,2227,[302 187 603 427 180],90,5,9677,4.343357271095153,20.0,0.0
2228,0,2228,[ 11 197   7   8 655],406,4,9681,4.343203230148048,0.0,0.0
2229,0,2229,[302 187 603 427 180],13,5,9686,4.343497757847533,20.0,0.0
2230,0,2230,[302 187 603 427 180],666,5,9691,4.343792021515016,20.0,0.0
2231,0,2231,[302 187 603 427 180],458,5,9696,4.344086021505376,20.0,0.0
2232,0,2232,[ 71 182   1 273 597],374,4,9700,4.343931930138827,0.0,0.0
2233,0,2233,[302 187 603 427 180],474,5,9705,4.3442256042972245,20.0,0.0
2234,0,2234,[302 187 603 427 180],664,5,9710,4.344519015659955,20.0,0.0
2235,0,2235,[302 187 603 427 180],271,5,9715,4.344812164579606,20.0,0.0
2236,0,2236,[302 187 603 427 180],474,5,9720,4.345105051408136,20.0,0.0
2237,0,2237,[302 187 603 427 180],90,5,9725,4.345397676496872,20.0,0.0
2238,0,2238,[135 204  79 174 228],804,4,9729,4.345243412237606,0.0,20.0
2239,0,2239,[302 187 603 427 180],666,5,9734,4.345535714285714,20.0,0.0
2240,0,2240,[302 187 603 427 180],339,5,9739,4.34582775546631,20.0,0.0
2241,0,2241,[302 187 603 427 180],666,5,9744,4.346119536128457,20.0,0.0
2242,0,2242,[302 187 603 427 180],664,5,9749,4.346411056620598,20.0,0.0
2243,0,2243,[ 15 172  88 195 235],537,0,9749,4.344474153297683,0.0,0.0
2244,0,2244,[405 111 275 187 258],537,3,9752,4.343875278396436,0.0,0.0
2245,0,2245,[161 195   4 216 200],374,3,9755,4.343276936776491,0.0,0.0
2246,0,2246,[ 95 271  69 210 176],290,4,9759,4.343124165554072,0.0,0.0
2247,0,2247,[302 187 603 427 180],458,5,9764,4.343416370106762,20.0,0.0
2248,0,2248,[302 187 603 427 180],90,5,9769,4.34370831480658,20.0,0.0
2249,0,2249,[302 187 603 427 180],666,5,9774,4.344,20.0,0.0
2250,0,2250,[302 187 603 427 180],537,5,9779,4.344291426032874,20.0,0.0
2251,0,2251,[302 187 603 427 180],664,5,9784,4.344582593250444,20.0,0.0
2252,0,2252,[302 187 603 427 180],13,5,9789,4.344873501997337,20.0,0.0
2253,0,2253,[302 187 603 427 180],13,5,9794,4.345164152617569,20.0,0.0
2254,0,2254,[302 187 603 427 180],474,5,9799,4.345454545454546,20.0,0.0
2255,0,2255,[302 187 603 427 180],666,5,9804,4.345744680851064,20.0,0.0
2256,0,2256,[282 222 228   9 655],788,2,9806,4.344705361098804,0.0,0.0
2257,0,2257,[302 187 603 427 180],90,5,9811,4.344995571302038,20.0,0.0
2258,0,2258,[ 95 423 286 127 180],650,0,9811,4.34307215582116,0.0,20.0
2259,0,2259,[302 187 603 427 180],271,5,9816,4.343362831858407,20.0,0.0
2260,0,2260,[100   8  56 181  95],398,3,9819,4.3427686864219375,0.0,20.0
2261,0,2261,[385 423 176 196 132],326,2,9821,4.341732979664014,0.0,0.0
2262,0,2262,[302 187 603 427 180],474,5,9826,4.342023862129916,20.0,0.0
2263,0,2263,[302 187 603 427 180],271,5,9831,4.342314487632509,20.0,0.0
2264,0,2264,[ 71 216 183 655 403],398,5,9836,4.342604856512141,0.0,0.0
2265,0,2265,[215   7 161 200 172],653,2,9838,4.341571050308914,0.0,0.0
2266,0,2266,[173 235 168 269 185],13,1,9839,4.340097044552271,0.0,0.0
2267,0,2267,[302 187 603 427 180],666,5,9844,4.340388007054674,20.0,0.0
2268,0,2268,[302 187 603 427 180],458,5,9849,4.340678713089467,20.0,0.0
2269,0,2269,[302 187 603 427 180],474,5,9854,4.340969162995595,20.0,0.0
2270,0,2270,[302 187 603 427 180],664,5,9859,4.341259357111404,20.0,0.0
2271,0,2271,[302 187 603 427 180],537,5,9864,4.341549295774648,20.0,0.0
2272,0,2272,[302 187 603 427 180],339,5,9869,4.341838979322481,20.0,0.0
2273,0,2273,[302 187 603 427 180],664,5,9874,4.342128408091469,20.0,0.0
2274,0,2274,[289 135 483 275 186],13,3,9877,4.341538461538462,20.0,0.0
2275,0,2275,[117  79 202 100  11],538,4,9881,4.3413884007029875,0.0,20.0
2276,0,2276,[302 187 603 427 180],271,5,9886,4.341677646025472,20.0,0.0
2277,0,2277,[302 187 603 427 180],339,5,9891,4.341966637401229,20.0,0.0
2278,0,2278,[302 187 603 427 180],537,5,9896,4.342255375164546,20.0,0.0
2279,0,2279,[ 98 215 546 588 286],194,2,9898,4.341228070175439,0.0,20.0
2280,0,2280,[  1 151 125 403 202],648,3,9901,4.340640070144674,0.0,0.0
2281,0,2281,[302 187 603 427 180],664,5,9906,4.340929009640666,20.0,0.0
2282,0,2282,[323 127 121 187 153],648,3,9909,4.340341655716163,0.0,20.0
2283,0,2283,[302 187 603 427 180],666,5,9914,4.340630472854641,20.0,0.0
2284,0,2284,[ 69 210 200   7  64],308,4,9918,4.340481400437636,0.0,0.0
2285,0,2285,[302 187 603 427 180],537,5,9923,4.3407699037620295,20.0,0.0
2286,0,2286,[302 187 603 427 180],458,5,9928,4.341058154787932,20.0,0.0
2287,0,2287,[302 187 603 427 180],537,5,9933,4.341346153846154,20.0,0.0
2288,0,2288,[302 187 603 427 180],664,5,9938,4.3416339012669285,20.0,0.0
2289,0,2289,[168 121 191 153  25],85,2,9940,4.3406113537117905,0.0,0.0
2290,0,2290,[302 187 603 427 180],537,5,9945,4.34089917066783,20.0,0.0
2291,0,2291,[302 187 603 427 180],90,5,9950,4.341186736474695,20.0,0.0
2292,0,2292,[302 187 603 427 180],271,5,9955,4.341474051460968,20.0,0.0
2293,0,2293,[302 187 603 427 180],664,5,9960,4.3417611159546645,20.0,0.0
2294,0,2294,[302 187 603 427 180],90,5,9965,4.342047930283225,20.0,0.0
2295,0,2295,[302 187 603 427 180],474,5,9970,4.342334494773519,20.0,0.0
2296,0,2296,[ 71 385 748  96  88],479,2,9972,4.341314758380497,0.0,0.0
2297,0,2297,[302 187 603 427 180],339,5,9977,4.341601392515231,20.0,0.0
2298,0,2298,[302 187 603 427 180],90,5,9982,4.341887777294476,20.0,0.0
2299,0,2299,[302 187 603 427 180],271,5,9987,4.342173913043478,20.0,0.0
2300,0,2300,[302 187 603 427 180],666,5,9992,4.342459800086918,20.0,0.0
2301,0,2301,[302 187 603 427 180],271,5,9997,4.342745438748914,20.0,0.0
2302,0,2302,[302 187 603 427 180],474,5,10002,4.343030829353018,20.0,0.0
2303,0,2303,[302 187 603 427 180],90,5,10007,4.343315972222222,20.0,0.0
2304,0,2304,[275 143 100  98  71],533,5,10012,4.343600867678958,0.0,40.0
2305,0,2305,[204 435 483 195  96],934,4,10016,4.34345186470078,20.0,0.0
2306,0,2306,[483 191 176 200 237],7,4,10020,4.34330299089727,20.0,0.0
2307,0,2307,[302 187 603 427 180],271,5,10025,4.343587521663778,20.0,0.0
2308,0,2308,[302 187 603 427 180],666,5,10030,4.3438718059766135,20.0,0.0
2309,0,2309,[302 187 603 427 180],666,5,10035,4.3441558441558445,20.0,0.0
2310,0,2310,[ 56  12 483 151 191],385,2,10037,4.343141497187365,40.0,0.0
2311,0,2311,[302 187 603 427 180],666,5,10042,4.343425605536332,20.0,0.0
2312,0,2312,[302 187 603 427 180],339,5,10047,4.343709468223087,20.0,0.0
2313,0,2313,[678 333 187 132 269],605,4,10051,4.343560933448574,0.0,0.0
2314,0,2314,[173 180 215  50 179],311,4,10055,4.34341252699784,0.0,20.0
2315,0,2315,[302 187 603 427 180],13,5,10060,4.343696027633851,20.0,0.0
2316,0,2316,[483 135 118 237 117],533,3,10063,4.343116098403107,20.0,0.0
2317,0,2317,[  4 288 427 603 234],650,3,10066,4.342536669542709,20.0,0.0
2318,0,2318,[302 187 603 427 180],666,5,10071,4.342820181112549,20.0,0.0
2319,0,2319,[237 176 234 132 269],378,5,10076,4.343103448275862,0.0,0.0
2320,0,2320,[302 187 603 427 180],90,5,10081,4.343386471348556,20.0,0.0
2321,0,2321,[302 187 603 427 180],664,5,10086,4.343669250645995,20.0,0.0
2322,0,2322,[302 187 603 427 180],339,5,10091,4.343951786482996,20.0,0.0
2323,0,2323,[302 187 603 427 180],537,5,10096,4.344234079173838,20.0,0.0
2324,0,2324,[ 71 318 117  56  15],554,5,10101,4.344516129032258,20.0,0.0
2325,0,2325,[302 187 603 427 180],666,5,10106,4.344797936371453,20.0,0.0
2326,0,2326,[302 187 603 427 180],474,5,10111,4.345079501504083,20.0,0.0
2327,0,2327,[ 50   7  11  89 323],28,4,10115,4.344931271477663,0.0,20.0
2328,0,2328,[197 483 288  11 161],59,4,10119,4.344783168741949,20.0,0.0
2329,0,2329,[302 187 603 427 180],13,5,10124,4.345064377682403,20.0,0.0
2330,0,2330,[302 187 603 427 180],666,5,10129,4.345345345345345,20.0,0.0
2331,0,2331,[302 135 228 257  89],883,5,10134,4.345626072041166,0.0,0.0
2332,0,2332,[302 187 603 427 180],537,5,10139,4.345906558079726,20.0,0.0
2333,0,2333,[302 187 603 427 180],90,5,10144,4.346186803770351,20.0,0.0
2334,0,2334,[302 187 603 427 180],458,5,10149,4.346466809421842,20.0,0.0
2335,0,2335,[302 187 603 427 180],474,5,10154,4.346746575342466,20.0,0.0
2336,0,2336,[173 176  89  64 144],144,4,10158,4.346598202824134,0.0,0.0
2337,0,2337,[302 187 603 427 180],271,5,10163,4.346877673224979,20.0,0.0
2338,0,2338,[302 187 603 427 180],458,5,10168,4.347156904660111,20.0,0.0
2339,0,2339,[405  88   4  82 269],13,2,10170,4.346153846153846,0.0,0.0
2340,0,2340,[302 187 603 427 180],666,5,10175,4.346433148227253,20.0,0.0
2341,0,2341,[302 187 603 427 180],666,5,10180,4.3467122117848,20.0,0.0
2342,0,2342,[302 187 603 427 180],537,5,10185,4.3469910371318825,20.0,0.0
2343,0,2343,[302 187 603 427 180],664,5,10190,4.347269624573379,20.0,0.0
2344,0,2344,[302 187 603 427 180],664,5,10195,4.347547974413646,20.0,0.0
2345,0,2345,[302 187 603 427 180],664,5,10200,4.3478260869565215,20.0,0.0
2346,0,2346,[302 187 603 427 180],90,5,10205,4.348103962505326,20.0,0.0
2347,0,2347,[302 187 603 427 180],13,5,10210,4.3483816013628624,20.0,0.0
2348,0,2348,[302 187 603 427 180],664,5,10215,4.3486590038314175,20.0,0.0
2349,0,2349,[302 187 603 427 180],664,5,10220,4.348936170212766,20.0,0.0
2350,0,2350,[302 187 603 427 180],474,5,10225,4.349213100808167,20.0,0.0
2351,0,2351,[302 187 603 427 180],474,5,10230,4.349489795918367,20.0,0.0
2352,0,2352,[302 187 603 427 180],339,5,10235,4.349766255843604,20.0,0.0
2353,0,2353,[302 187 603 427 180],666,5,10240,4.3500424808836025,20.0,0.0
2354,0,2354,[302 187 603 427 180],339,5,10245,4.350318471337579,20.0,0.0
2355,0,2355,[302 187 603 427 180],664,5,10250,4.350594227504245,20.0,0.0
2356,0,2356,[302 187 603 427 180],90,5,10255,4.350869749681799,20.0,0.0
2357,0,2357,[302 187 603 427 180],458,5,10260,4.351145038167939,20.0,0.0
2358,0,2358,[302 187 603 427 180],664,5,10265,4.351420093259856,20.0,0.0
2359,0,2359,[302 187 603 427 180],271,5,10270,4.351694915254237,20.0,0.0
2360,0,2360,[302 187 603 427 180],666,5,10275,4.351969504447268,20.0,0.0
2361,0,2361,[302 187 603 427 180],537,5,10280,4.352243861134632,20.0,0.0
2362,0,2362,[ 98 202 588 180 174],899,3,10283,4.351671603893356,0.0,40.0
2363,0,2363,[302 187 603 427 180],271,5,10288,4.351945854483925,20.0,0.0
2364,0,2364,[228  64 216 235 195],406,3,10291,4.351374207188161,0.0,0.0
2365,0,2365,[302 187 603 427 180],90,5,10296,4.351648351648351,20.0,0.0
2366,0,2366,[302 187 603 427 180],537,5,10301,4.351922264469793,20.0,0.0
2367,0,2367,[302 187 603 427 180],537,5,10306,4.352195945945946,20.0,0.0
2368,0,2368,[302 187 603 427 180],664,5,10311,4.352469396369776,20.0,0.0
2369,0,2369,[496 111 135 175 168],537,4,10315,4.352320675105485,0.0,0.0
2370,0,2370,[302 187 603 427 180],474,5,10320,4.352593842260649,20.0,0.0
2371,0,2371,[302 187 603 427 180],271,5,10325,4.352866779089376,20.0,0.0
2372,0,2372,[302 187 603 427 180],458,5,10330,4.353139485882849,20.0,0.0
2373,0,2373,[302 187 603 427 180],474,5,10335,4.3534119629317605,20.0,0.0
2374,0,2374,[175 238 568 265 161],738,4,10339,4.3532631578947365,0.0,0.0
2375,0,2375,[302 187 603 427 180],339,5,10344,4.353535353535354,20.0,0.0
2376,0,2376,[333 286  25 427 508],533,5,10349,4.353807320151452,0.0,0.0
2377,0,2377,[172  96 237 216 234],326,1,10350,4.352396972245584,0.0,0.0
2378,0,2378,[302 187 603 427 180],666,5,10355,4.352669188734763,20.0,0.0
2379,0,2379,[302 187 603 427 180],474,5,10360,4.352941176470588,20.0,0.0
2380,0,2380,[ 64 186   4 194 328],13,4,10364,4.352792944141117,0.0,0.0
2381,0,2381,[483  70 234  56   7],59,4,10368,4.352644836272041,20.0,0.0
2382,0,2382,[302 187 603 427 180],339,5,10373,4.352916491817037,20.0,0.0
2383,0,2383,[117 385 216 172 100],650,5,10378,4.353187919463087,0.0,20.0
2384,0,2384,[302 187 603 427 180],666,5,10383,4.353459119496855,20.0,0.0
2385,0,2385,[302 187 603 427 180],537,5,10388,4.353730092204526,20.0,0.0
2386,0,2386,[ 97 323 276  69 235],378,3,10391,4.353162966066192,0.0,0.0
2387,0,2387,[302 187 603 427 180],13,5,10396,4.353433835845896,20.0,0.0
2388,0,2388,[302 187 603 427 180],458,5,10401,4.353704478861449,20.0,0.0
2389,0,2389,[302 187 603 427 180],666,5,10406,4.3539748953974895,20.0,0.0
2390,0,2390,[302 187 603 427 180],458,5,10411,4.354245085738185,20.0,0.0
2391,0,2391,[302 187 603 427 180],90,5,10416,4.354515050167224,20.0,0.0
2392,0,2392,[172  70 132 222 175],64,5,10421,4.354784788967823,0.0,0.0
2393,0,2393,[153 179   7 202 161],95,3,10424,4.35421888053467,0.0,0.0
2394,0,2394,[174 742 187   8 200],298,3,10427,4.353653444676409,0.0,20.0
2395,0,2395,[302 187 603 427 180],664,5,10432,4.353923205342237,20.0,0.0
2396,0,2396,[276 475 471 215 258],90,2,10434,4.352941176470588,0.0,0.0
2397,0,2397,[276 234 196 202 182],90,3,10437,4.352376980817348,0.0,0.0
2398,0,2398,[  4  89 197 100   1],339,5,10442,4.352646936223427,0.0,20.0
2399,0,2399,[302 187 603 427 180],474,5,10447,4.352916666666666,20.0,0.0
2400,0,2400,[302 187 603 427 180],666,5,10452,4.353186172428155,20.0,0.0
2401,0,2401,[302 187 603 427 180],90,5,10457,4.353455453788509,20.0,0.0
2402,0,2402,[302 187 603 427 180],90,5,10462,4.353724511027882,20.0,0.0
2403,0,2403,[302 187 603 427 180],13,5,10467,4.353993344425957,20.0,0.0
2404,0,2404,[211 301 655 318  56],85,4,10471,4.3538461538461535,20.0,0.0
2405,0,2405,[235  70  64 678 289],82,2,10473,4.35286783042394,0.0,0.0
2406,0,2406,[302 187 603 427 180],339,5,10478,4.353136684669713,20.0,0.0
2407,0,2407,[302 187 603 427 180],458,5,10483,4.3534053156146175,20.0,0.0
2408,0,2408,[302 187 603 427 180],90,5,10488,4.353673723536737,20.0,0.0
2409,0,2409,[302 187 603 427 180],339,5,10493,4.353941908713693,20.0,0.0
2410,0,2410,[302 187 603 427 180],339,5,10498,4.354209871422646,20.0,0.0
2411,0,2411,[183 427 268 195 286],7,4,10502,4.3540630182421225,0.0,0.0
2412,0,2412,[176  64 588  82 258],313,3,10505,4.353501864898466,0.0,0.0
2413,0,2413,[ 12 210  22 268 748],92,3,10508,4.352941176470588,20.0,0.0
2414,0,2414,[302 187 603 427 180],13,5,10513,4.353209109730849,20.0,0.0
2415,0,2415,[302 187 603 427 180],339,5,10518,4.353476821192053,20.0,0.0
2416,0,2416,[172  79 215 153 211],804,5,10523,4.3537443111295,0.0,0.0
2417,0,2417,[302 187 603 427 180],271,5,10528,4.354011579818032,20.0,0.0
2418,0,2418,[174 202 186 127 200],848,3,10531,4.353451839603141,0.0,40.0
2419,0,2419,[121 237 191 269 742],334,2,10533,4.352479338842975,0.0,0.0
2420,0,2420,[302 187 603 427 180],13,5,10538,4.352746798843453,20.0,0.0
2421,0,2421,[161 181 125 318 423],311,5,10543,4.353014037985136,20.0,0.0
2422,0,2422,[302 187 603 427 180],90,5,10548,4.353281056541477,20.0,0.0
2423,0,2423,[302 187 603 427 180],13,5,10553,4.353547854785479,20.0,0.0
2424,0,2424,[302 187 603 427 180],339,5,10558,4.353814432989691,20.0,0.0
2425,0,2425,[ 56 588 288 318 202],892,5,10563,4.354080791426216,20.0,0.0
2426,0,2426,[ 88 286 117 186  25],271,3,10566,4.353522867737948,0.0,0.0
2427,0,2427,[273  89 403 215 423],64,3,10569,4.352965403624382,0.0,0.0
2428,0,2428,[228  50 333  28 196],881,2,10571,4.351996706463566,0.0,20.0
2429,0,2429,[302 187 603 427 180],666,5,10576,4.352263374485597,20.0,0.0
2430,0,2430,[302 187 603 427 180],13,5,10581,4.352529823118059,20.0,0.0
2431,0,2431,[302 187 603 427 180],13,5,10586,4.352796052631579,20.0,0.0
2432,0,2432,[302 187 603 427 180],666,5,10591,4.353062063296342,20.0,0.0
2433,0,2433,[333  96 179 603 405],815,2,10593,4.352095316351685,20.0,0.0
2434,0,2434,[302 187 603 427 180],666,5,10598,4.352361396303902,20.0,0.0
2435,0,2435,[302 187 603 427 180],271,5,10603,4.352627257799671,20.0,0.0
2436,0,2436,[302 187 603 427 180],271,5,10608,4.35289290110792,20.0,0.0
2437,0,2437,[286 405   8 194 100],379,4,10612,4.352748154224774,0.0,20.0
2438,0,2438,[302 187 603 427 180],474,5,10617,4.353013530135302,20.0,0.0
2439,0,2439,[302 187 603 427 180],13,5,10622,4.35327868852459,20.0,0.0
2440,0,2440,[302 187 603 427 180],339,5,10627,4.353543629659975,20.0,0.0
2441,0,2441,[302 187 603 427 180],666,5,10632,4.353808353808354,20.0,0.0
2442,0,2442,[ 89   7  98 151 286],650,3,10635,4.353254195661073,0.0,20.0
2443,0,2443,[182 153  56 191  79],840,4,10639,4.353109656301146,0.0,0.0
2444,0,2444,[333  70  50 294  82],537,2,10641,4.352147239263804,0.0,20.0
2445,0,2445,[302 187 603 427 180],90,5,10646,4.3524121013900245,20.0,0.0
2446,0,2446,[302 187 603 427 180],664,5,10651,4.352676747037188,20.0,0.0
2447,0,2447,[302 187 603 427 180],90,5,10656,4.352941176470588,20.0,0.0
2448,0,2448,[302 187 603 427 180],666,5,10661,4.353205389955083,20.0,0.0
2449,0,2449,[ 64 423 215 323 275],454,3,10664,4.35265306122449,0.0,0.0
2450,0,2450,[294 194 179 211 202],194,4,10668,4.35250917992656,0.0,0.0
2451,0,2451,[302 187 603 427 180],90,5,10673,4.352773246329527,20.0,0.0
2452,0,2452,[172 197 288 318 125],533,4,10677,4.352629433346922,20.0,0.0
2453,0,2453,[302 187 603 427 180],666,5,10682,4.352893235533823,20.0,0.0
2454,0,2454,[ 50 186 357 427 322],533,3,10685,4.352342158859471,20.0,20.0
2455,0,2455,[302 187 603 427 180],271,5,10690,4.352605863192182,20.0,0.0
2456,0,2456,[ 96 111 228 202 515],537,1,10691,4.3512413512413515,0.0,0.0
2457,0,2457,[302 187 603 427 180],666,5,10696,4.351505288852726,20.0,0.0
2458,0,2458,[302 187 603 427 180],13,5,10701,4.351769011793412,20.0,0.0
2459,0,2459,[302 187 603 427 180],13,5,10706,4.352032520325203,20.0,0.0
2460,0,2460,[302 187 603 427 180],458,5,10711,4.352295814709468,20.0,0.0
2461,0,2461,[302 187 603 427 180],666,5,10716,4.352558895207149,20.0,0.0
2462,0,2462,[302 187 603 427 180],13,5,10721,4.352821762078766,20.0,0.0
2463,0,2463,[302 187 603 427 180],664,5,10726,4.353084415584416,20.0,0.0
2464,0,2464,[302 187 603 427 180],537,5,10731,4.353346855983773,20.0,0.0
2465,0,2465,[302 187 603 427 180],271,5,10736,4.3536090835360906,20.0,0.0
2466,0,2466,[294 471 405  82 172],13,1,10737,4.3522496959870285,0.0,0.0
2467,0,2467,[302 187 603 427 180],271,5,10742,4.3525121555915725,20.0,0.0
2468,0,2468,[ 12 210 300 275 121],119,4,10746,4.352369380315918,20.0,0.0
2469,0,2469,[302 187 603 427 180],90,5,10751,4.352631578947369,20.0,0.0
2470,0,2470,[588 275 187 286 196],406,1,10752,4.351274787535411,0.0,0.0
2471,0,2471,[294 200 385 496  11],308,3,10755,4.350728155339806,0.0,0.0
2472,0,2472,[302 187 603 427 180],474,5,10760,4.350990699555196,20.0,0.0
2473,0,2473,[222  71   4 276 483],334,3,10763,4.3504446240905414,20.0,0.0
2474,0,2474,[302 187 603 427 180],339,5,10768,4.35070707070707,20.0,0.0
2475,0,2475,[300  64 121 215   1],533,5,10773,4.350969305331179,0.0,0.0
2476,0,2476,[302 187 603 427 180],664,5,10778,4.351231328219621,20.0,0.0
2477,0,2477,[302 187 603 427 180],474,5,10783,4.351493139628733,20.0,0.0
2478,0,2478,[427 318 235 273 423],374,0,10783,4.3497377974989915,20.0,0.0
2479,0,2479,[302 187 603 427 180],271,5,10788,4.35,20.0,0.0
2480,0,2480,[302 187 603 427 180],458,5,10793,4.350261991132608,20.0,0.0
2481,0,2481,[302 187 603 427 180],666,5,10798,4.350523771152297,20.0,0.0
2482,0,2482,[302 187 603 427 180],339,5,10803,4.350785340314136,20.0,0.0
2483,0,2483,[237  69  50  98 215],882,5,10808,4.351046698872786,0.0,40.0
2484,0,2484,[302 187 603 427 180],664,5,10813,4.351307847082495,20.0,0.0
2485,0,2485,[302 187 603 427 180],271,5,10818,4.351568785197104,20.0,0.0
2486,0,2486,[302 187 603 427 180],339,5,10823,4.351829513470045,20.0,0.0
2487,0,2487,[302 187 603 427 180],458,5,10828,4.352090032154341,20.0,0.0
2488,0,2488,[301 117  56 161 172],334,1,10829,4.350743270389715,0.0,0.0
2489,0,2489,[275 748 546 117 197],899,4,10833,4.3506024096385545,0.0,0.0
2490,0,2490,[302 187 603 427 180],664,5,10838,4.350863107185869,20.0,0.0
2491,0,2491,[191 318  82   9 215],59,5,10843,4.351123595505618,20.0,0.0
2492,0,2492,[111 121   7 228  79],447,3,10846,4.350581628559968,0.0,0.0
2493,0,2493,[302 187 603 427 180],339,5,10851,4.35084202085004,20.0,0.0
2494,0,2494,[302 187 603 427 180],666,5,10856,4.351102204408818,20.0,0.0
2495,0,2495,[180 202 288 405 508],378,1,10857,4.349759615384615,0.0,0.0
2496,0,2496,[302 187 603 427 180],537,5,10862,4.350020024028835,20.0,0.0
2497,0,2497,[302 187 603 427 180],90,5,10867,4.350280224179343,20.0,0.0
2498,0,2498,[222 294 423 127  95],194,2,10869,4.3493397358943575,0.0,20.0
2499,0,2499,[302 187 603 427 180],271,5,10874,4.3496,20.0,0.0
2500,0,2500,[302 187 603 427 180],664,5,10879,4.349860055977609,20.0,0.0
2501,0,2501,[483 275 286 216 191],13,1,10880,4.348521183053557,20.0,0.0
2502,0,2502,[302 187 603 427 180],90,5,10885,4.348781462245306,20.0,0.0
2503,0,2503,[ 96  22 323 318 423],378,4,10889,4.348642172523961,20.0,0.0
2504,0,2504,[496  71 215 222 405],194,2,10891,4.347704590818363,0.0,0.0
2505,0,2505,[121 174 135 385 515],59,5,10896,4.347964884277734,0.0,20.0
2506,0,2506,[302 187 603 427 180],13,5,10901,4.348224970083765,20.0,0.0
2507,0,2507,[302 187 603 427 180],13,5,10906,4.348484848484849,20.0,0.0
2508,0,2508,[302 187 603 427 180],13,5,10911,4.348744519728975,20.0,0.0
2509,0,2509,[302 187 603 427 180],339,5,10916,4.349003984063745,20.0,0.0
2510,0,2510,[302 187 603 427 180],339,5,10921,4.34926324173636,20.0,0.0
2511,0,2511,[302 187 603 427 180],339,5,10926,4.349522292993631,20.0,0.0
2512,0,2512,[302 187 603 427 180],90,5,10931,4.3497811380819735,20.0,0.0
2513,0,2513,[302 187 603 427 180],458,5,10936,4.350039777247415,20.0,0.0
2514,0,2514,[302 187 603 427 180],13,5,10941,4.350298210735587,20.0,0.0
2515,0,2515,[288  97 182 483 200],374,4,10945,4.350158982511924,20.0,0.0
2516,0,2516,[302 187 603 427 180],13,5,10950,4.350417163289631,20.0,0.0
2517,0,2517,[117 568 176  56 202],543,3,10953,4.34988085782367,0.0,0.0
2518,0,2518,[302 187 603 427 180],474,5,10958,4.350138944025407,20.0,0.0
2519,0,2519,[302 187 603 427 180],474,5,10963,4.3503968253968255,20.0,0.0
2520,0,2520,[175 135 168 153  98],10,4,10967,4.350257834192781,0.0,20.0
2521,0,2521,[215  98 275  95 322],13,3,10970,4.349722442505947,0.0,20.0
2522,0,2522,[ 98 121 748 180   7],882,5,10975,4.349980182322632,0.0,20.0
2523,0,2523,[302 187 603 427 180],474,5,10980,4.350237717908082,20.0,0.0
2524,0,2524,[ 96 194  69 300 313],940,4,10984,4.35009900990099,0.0,0.0
2525,0,2525,[678 357 194 286 181],213,4,10988,4.349960411718132,20.0,0.0
2526,0,2526,[302 187 603 427 180],271,5,10993,4.350217649386624,20.0,0.0
2527,0,2527,[302 187 603 427 180],666,5,10998,4.350474683544304,20.0,0.0
2528,0,2528,[215  22  98 100 197],13,5,11003,4.350731514432582,0.0,40.0
2529,0,2529,[302 187 603 427 180],13,5,11008,4.35098814229249,20.0,0.0
2530,0,2530,[185  15 176 179 742],749,5,11013,4.351244567364678,0.0,0.0
2531,0,2531,[302 187 603 427 180],271,5,11018,4.351500789889416,20.0,0.0
2532,0,2532,[302 187 603 427 180],537,5,11023,4.351756810106593,20.0,0.0
2533,0,2533,[302 187 603 427 180],537,5,11028,4.352012628255722,20.0,0.0
2534,0,2534,[302 187 603 427 180],339,5,11033,4.352268244575937,20.0,0.0
2535,0,2535,[302 187 603 427 180],458,5,11038,4.3525236593059935,20.0,0.0
2536,0,2536,[302 187 603 427 180],666,5,11043,4.352778872684273,20.0,0.0
2537,0,2537,[302 187 603 427 180],664,5,11048,4.353033884948778,20.0,0.0
2538,0,2538,[302 187 603 427 180],666,5,11053,4.353288696337141,20.0,0.0
2539,0,2539,[328 181 173 678 187],804,5,11058,4.353543307086614,0.0,0.0
2540,0,2540,[302 187 603 427 180],537,5,11063,4.353797717434081,20.0,0.0
2541,0,2541,[302 187 603 427 180],474,5,11068,4.354051927616051,20.0,0.0
2542,0,2542,[ 12  11 222  89 275],455,1,11069,4.35273299252851,20.0,0.0
2543,0,2543,[302 187 603 427 180],90,5,11074,4.352987421383648,20.0,0.0
2544,0,2544,[655 202 143 483 179],815,3,11077,4.352455795677799,20.0,0.0
2545,0,2545,[ 89 121 168 357   7],474,4,11081,4.352317360565593,20.0,0.0
2546,0,2546,[302 187 603 427 180],458,5,11086,4.35257165292501,20.0,0.0
2547,0,2547,[ 25 288  95 515 121],892,5,11091,4.352825745682889,0.0,0.0
2548,0,2548,[302 187 603 427 180],458,5,11096,4.353079639074147,20.0,0.0
2549,0,2549,[216 588  70 174 182],398,5,11101,4.3533333333333335,0.0,20.0
2550,0,2550,[302 187 603 427 180],90,5,11106,4.353586828694629,20.0,0.0
2551,0,2551,[302 187 603 427 180],90,5,11111,4.35384012539185,20.0,0.0
2552,0,2552,[385  89 302 265 174],524,4,11115,4.353701527614571,0.0,20.0
2553,0,2553,[302 187 603 427 180],458,5,11120,4.353954581049335,20.0,0.0
2554,0,2554,[235   7 194 196 603],932,4,11124,4.353816046966732,20.0,0.0
2555,0,2555,[302 187 603 427 180],90,5,11129,4.354068857589985,20.0,0.0
2556,0,2556,[302 187 603 427 180],664,5,11134,4.354321470473211,20.0,0.0
2557,0,2557,[ 56 568 515  71 194],7,4,11138,4.354182955433933,0.0,0.0
2558,0,2558,[302 187 603 427 180],339,5,11143,4.354435326299336,20.0,0.0
2559,0,2559,[302 187 603 427 180],13,5,11148,4.3546875,20.0,0.0
2560,0,2560,[302 187 603 427 180],90,5,11153,4.354939476766888,20.0,0.0
2561,0,2561,[ 15 210 216 288  71],308,3,11156,4.354410616705699,0.0,0.0
2562,0,2562,[302 187 603 427 180],458,5,11161,4.354662504877097,20.0,0.0
2563,0,2563,[333 153 496 405  82],334,3,11164,4.354134165366615,0.0,0.0
2564,0,2564,[302 187 603 427 180],666,5,11169,4.3543859649122805,20.0,0.0
2565,0,2565,[357  11 118 483 427],328,2,11171,4.353468433359314,40.0,0.0
2566,0,2566,[228 483  97 132 216],398,5,11176,4.353720296065446,20.0,0.0
2567,0,2567,[302 187 603 427 180],666,5,11181,4.353971962616822,20.0,0.0
2568,0,2568,[302 187 603 427 180],458,5,11186,4.354223433242507,20.0,0.0
2569,0,2569,[289 144 191 333   7],387,2,11188,4.353307392996109,0.0,0.0
2570,0,2570,[ 28 168  71   7  95],95,4,11192,4.35316997277324,0.0,0.0
2571,0,2571,[302 187 603 427 180],474,5,11197,4.353421461897356,20.0,0.0
2572,0,2572,[302 187 603 427 180],458,5,11202,4.353672755538282,20.0,0.0
2573,0,2573,[111 275 211 496 234],533,4,11206,4.353535353535354,0.0,0.0
2574,0,2574,[234 127 655 216 271],843,2,11208,4.352621359223301,0.0,20.0
2575,0,2575,[302 187 603 427 180],458,5,11213,4.352872670807454,20.0,0.0
2576,0,2576,[ 79 265 215 185 300],234,0,11213,4.351183546759798,0.0,0.0
2577,0,2577,[302 187 603 427 180],13,5,11218,4.351435221101629,20.0,0.0
2578,0,2578,[302 187 603 427 180],271,5,11223,4.351686700271423,20.0,0.0
2579,0,2579,[302 187 603 427 180],339,5,11228,4.351937984496124,20.0,0.0
2580,0,2580,[ 97 273 183 568 300],87,3,11231,4.351414180550174,0.0,0.0
2581,0,2581,[302 187 603 427 180],537,5,11236,4.3516653756777695,20.0,0.0
2582,0,2582,[179  89 471 196 405],374,2,11238,4.35075493612079,0.0,0.0
2583,0,2583,[ 22 302  96 183 194],543,3,11241,4.350232198142415,0.0,0.0
2584,0,2584,[302 187 603 427 180],537,5,11246,4.350483558994197,20.0,0.0
2585,0,2585,[228 153 179 235  22],339,4,11250,4.3503480278422275,0.0,0.0
2586,0,2586,[302 187 603 427 180],339,5,11255,4.3505991495941245,20.0,0.0
2587,0,2587,[302 187 603 427 180],664,5,11260,4.350850077279753,20.0,0.0
2588,0,2588,[546 117 235   1 127],102,0,11260,4.349169563538045,0.0,20.0
2589,0,2589,[302 187 603 427 180],90,5,11265,4.3494208494208495,20.0,0.0
2590,0,2590,[ 22 216 300 288   7],537,1,11266,4.348128135854882,0.0,0.0
2591,0,2591,[302 187 603 427 180],90,5,11271,4.34837962962963,20.0,0.0
2592,0,2592,[302 187 603 427 180],666,5,11276,4.348630929425376,20.0,0.0
2593,0,2593,[302 187 603 427 180],458,5,11281,4.3488820354664615,20.0,0.0
2594,0,2594,[302 187 603 427 180],90,5,11286,4.349132947976878,20.0,0.0
2595,0,2595,[302 187 603 427 180],339,5,11291,4.349383667180278,20.0,0.0
2596,0,2596,[302 187 603 427 180],271,5,11296,4.349634193299962,20.0,0.0
2597,0,2597,[302 187 603 427 180],666,5,11301,4.349884526558891,20.0,0.0
2598,0,2598,[302 187 603 427 180],537,5,11306,4.3501346671796846,20.0,0.0
2599,0,2599,[302 187 603 427 180],666,5,11311,4.350384615384615,20.0,0.0
2600,0,2600,[302 187 603 427 180],666,5,11316,4.350634371395617,20.0,0.0
2601,0,2601,[302 187 603 427 180],474,5,11321,4.350883935434282,20.0,0.0
2602,0,2602,[435  88 174 172 153],102,1,11322,4.34959661928544,0.0,20.0
2603,0,2603,[302 187 603 427 180],90,5,11327,4.349846390168971,20.0,0.0
2604,0,2604,[427 238 196 204  82],308,4,11331,4.349712092130519,0.0,0.0
2605,0,2605,[302 187 603 427 180],13,5,11336,4.349961627014582,20.0,0.0
2606,0,2606,[238 333 748  89 151],881,2,11338,4.349060222477944,0.0,0.0
2607,0,2607,[302 187 603 427 180],339,5,11343,4.34930981595092,20.0,0.0
2608,0,2608,[215 568 328  82   7],92,2,11345,4.348409352242238,0.0,0.0
2609,0,2609,[302 187 603 427 180],90,5,11350,4.3486590038314175,20.0,0.0
2610,0,2610,[196 257  28 216  56],901,4,11354,4.348525469168901,0.0,0.0
2611,0,2611,[435 265 181 588 271],13,4,11358,4.348392036753445,0.0,0.0
2612,0,2612,[302 187 603 427 180],90,5,11363,4.348641408342901,20.0,0.0
2613,0,2613,[  4  70 211 196 143],64,4,11367,4.348508033664881,0.0,0.0
2614,0,2614,[302 187 603 427 180],339,5,11372,4.348757170172084,20.0,0.0
2615,0,2615,[ 50 282 275 471 265],455,4,11376,4.348623853211009,0.0,20.0
2616,0,2616,[655 238 405   4 435],295,5,11381,4.3488727550630495,0.0,0.0
2617,0,2617,[302 187 603 427 180],13,5,11386,4.349121466768525,20.0,0.0
2618,0,2618,[302 187 603 427 180],537,5,11391,4.349369988545246,20.0,0.0
2619,0,2619,[302 187 603 427 180],458,5,11396,4.349618320610687,20.0,0.0
2620,0,2620,[182   1 427  89 435],650,3,11399,4.349103395650515,0.0,0.0
2621,0,2621,[117 182  95 186 301],13,3,11402,4.348588863463005,0.0,0.0
2622,0,2622,[118 174 294 186   7],882,5,11407,4.348837209302325,0.0,20.0
2623,0,2623,[302 187 603 427 180],13,5,11412,4.349085365853658,20.0,0.0
2624,0,2624,[286 186 197  69  95],234,2,11414,4.348190476190476,0.0,0.0
2625,0,2625,[508 748 204 245 313],653,4,11418,4.348057882711348,0.0,0.0
2626,0,2626,[302 187 603 427 180],537,5,11423,4.348306052531405,20.0,0.0
2627,0,2627,[235 222  89 597 211],13,2,11425,4.347412480974125,0.0,0.0
2628,0,2628,[  7 294 289 100 173],537,3,11428,4.346899961962723,0.0,20.0
2629,0,2629,[302 187 603 427 180],271,5,11433,4.347148288973384,20.0,0.0
2630,0,2630,[302 187 603 427 180],13,5,11438,4.347396427213987,20.0,0.0
2631,0,2631,[302 187 603 427 180],271,5,11443,4.347644376899696,20.0,0.0
2632,0,2632,[  1  15 496 228 273],749,5,11448,4.3478921382453475,0.0,0.0
2633,0,2633,[302 153  22  89  50],6,4,11452,4.347760060744116,0.0,20.0
2634,0,2634,[302 187 603 427 180],13,5,11457,4.348007590132827,20.0,0.0
2635,0,2635,[302 187 603 427 180],664,5,11462,4.348254931714719,20.0,0.0
2636,0,2636,[276 588 405 496 173],378,3,11465,4.347743648084945,0.0,0.0
2637,0,2637,[ 28 294 385 257 215],378,4,11469,4.347611827141774,0.0,0.0
2638,0,2638,[302 187 603 427 180],474,5,11474,4.34785903751421,20.0,0.0
2639,0,2639,[302 187 603 427 180],339,5,11479,4.34810606060606,20.0,0.0
2640,0,2640,[302 187 603 427 180],537,5,11484,4.348352896630065,20.0,0.0
2641,0,2641,[302 187 603 427 180],458,5,11489,4.3485995457986375,20.0,0.0
2642,0,2642,[175 210 179  89 100],653,4,11493,4.348467650397276,0.0,20.0
2643,0,2643,[276 191 127 211  25],406,4,11497,4.348335854765507,0.0,20.0
2644,0,2644,[302 187 603 427 180],13,5,11502,4.348582230623818,20.0,0.0
2645,0,2645,[ 79 111 357 202 132],749,4,11506,4.348450491307634,20.0,0.0
2646,0,2646,[302 187 603 427 180],271,5,11511,4.3486966377030605,20.0,0.0
2647,0,2647,[302 187 603 427 180],537,5,11516,4.348942598187311,20.0,0.0
2648,0,2648,[161 125 195 100 179],378,2,11518,4.348055870139675,0.0,20.0
2649,0,2649,[125 200 403 742  98],899,3,11521,4.347547169811321,0.0,20.0
2650,0,2650,[405  28 187 265 125],892,5,11526,4.347793285552622,0.0,0.0
2651,0,2651,[302 187 603 427 180],458,5,11531,4.348039215686274,20.0,0.0
2652,0,2652,[302 187 603 427 180],666,5,11536,4.348284960422164,20.0,0.0
2653,0,2653,[302 187 603 427 180],666,5,11541,4.348530519969857,20.0,0.0
2654,0,2654,[302 187 603 427 180],339,5,11546,4.348775894538607,20.0,0.0
2655,0,2655,[302 187 603 427 180],474,5,11551,4.349021084337349,20.0,0.0
2656,0,2656,[302 187 603 427 180],339,5,11556,4.349266089574709,20.0,0.0
2657,0,2657,[302 187 603 427 180],339,5,11561,4.349510910458991,20.0,0.0
2658,0,2658,[302 187 603 427 180],90,5,11566,4.349755547198195,20.0,0.0
2659,0,2659,[ 70 235 403 174 186],524,3,11569,4.349248120300752,0.0,20.0
2660,0,2660,[302 187 603 427 180],271,5,11574,4.349492671927846,20.0,0.0
2661,0,2661,[302 187 603 427 180],458,5,11579,4.349737039819685,20.0,0.0
2662,0,2662,[302 187 603 427 180],90,5,11584,4.349981224183252,20.0,0.0
2663,0,2663,[302 187 603 427 180],13,5,11589,4.350225225225225,20.0,0.0
2664,0,2664,[403 483 216 175  22],184,2,11591,4.349343339587242,20.0,0.0
2665,0,2665,[655 289 234  82 204],538,1,11592,4.348087021755439,0.0,0.0
2666,0,2666,[302 187 603 427 180],666,5,11597,4.348331458567679,20.0,0.0
2667,0,2667,[ 79 180 182  64   7],59,5,11602,4.348575712143928,0.0,0.0
2668,0,2668,[302 187 603 427 180],90,5,11607,4.348819782690146,20.0,0.0
2669,0,2669,[302 187 603 427 180],90,5,11612,4.349063670411985,20.0,0.0
2670,0,2670,[302 187 603 427 180],90,5,11617,4.349307375514789,20.0,0.0
2671,0,2671,[210 174 403   4  56],804,3,11620,4.348802395209581,0.0,20.0
2672,0,2672,[302 187 603 427 180],458,5,11625,4.349046015712682,20.0,0.0
2673,0,2673,[302 187 603 427 180],458,5,11630,4.349289454001496,20.0,0.0
2674,0,2674,[302 187 603 427 180],664,5,11635,4.349532710280374,20.0,0.0
2675,0,2675,[302 187 603 427 180],339,5,11640,4.349775784753363,20.0,0.0
2676,0,2676,[302 187 603 427 180],474,5,11645,4.350018677624206,20.0,0.0
2677,0,2677,[302 187 603 427 180],458,5,11650,4.350261389096341,20.0,0.0
2678,0,2678,[323 435 289 322   9],474,3,11653,4.349757372153789,0.0,0.0
2679,0,2679,[286 294 180 127 176],328,4,11657,4.349626865671642,0.0,20.0
2680,0,2680,[302 187 603 427 180],271,5,11662,4.349869451697128,20.0,0.0
2681,0,2681,[302 187 603 427 180],474,5,11667,4.350111856823267,20.0,0.0
2682,0,2682,[302 187 603 427 180],458,5,11672,4.35035408125233,20.0,0.0
2683,0,2683,[302 187 603 427 180],13,5,11677,4.350596125186289,20.0,0.0
2684,0,2684,[234 153 183 186  64],664,3,11680,4.350093109869646,0.0,0.0
2685,0,2685,[288 176 269  28 216],13,1,11681,4.348845867460908,0.0,0.0
2686,0,2686,[302 187 603 427 180],666,5,11686,4.349088202456271,20.0,0.0
2687,0,2687,[302 187 603 427 180],474,5,11691,4.349330357142857,20.0,0.0
2688,0,2688,[302 187 603 427 180],474,5,11696,4.34957233172183,20.0,0.0
2689,0,2689,[302 187 603 427 180],474,5,11701,4.349814126394052,20.0,0.0
2690,0,2690,[302 187 603 427 180],664,5,11706,4.350055741360089,20.0,0.0
2691,0,2691,[546 245 182 204 202],653,2,11708,4.349182763744428,0.0,0.0
2692,0,2692,[302 187 603 427 180],90,5,11713,4.3494244337170445,20.0,0.0
2693,0,2693,[175 176 118 195 135],653,2,11715,4.348552338530067,0.0,0.0
2694,0,2694,[302 187 603 427 180],664,5,11720,4.348794063079778,20.0,0.0
2695,0,2695,[302 187 603 427 180],537,5,11725,4.349035608308605,20.0,0.0
2696,0,2696,[302 187 603 427 180],458,5,11730,4.349276974416018,20.0,0.0
2697,0,2697,[302 187 603 427 180],13,5,11735,4.349518161601186,20.0,0.0
2698,0,2698,[186 275   1 174  79],64,5,11740,4.3497591700629865,0.0,20.0
2699,0,2699,[302 187 603 427 180],458,5,11745,4.35,20.0,0.0
2700,0,2700,[ 89 161 289 405 748],13,3,11748,4.349500185116623,0.0,0.0
2701,0,2701,[257 143 235  64 194],308,4,11752,4.349370836417468,0.0,0.0
2702,0,2702,[302 187 603 427 180],474,5,11757,4.349611542730299,20.0,0.0
2703,0,2703,[302 187 603 427 180],339,5,11762,4.349852071005917,20.0,0.0
2704,0,2704,[302 187 603 427 180],90,5,11767,4.350092421441775,20.0,0.0
2705,0,2705,[ 97 385   4 222 357],194,2,11769,4.349223946784923,20.0,0.0
2706,0,2706,[ 79 333 161 172 121],346,4,11773,4.349094939046916,0.0,0.0
2707,0,2707,[ 56  96 289 475 515],474,4,11777,4.348966026587887,0.0,0.0
2708,0,2708,[302 187 603 427 180],458,5,11782,4.349206349206349,20.0,0.0
2709,0,2709,[302 187 603 427 180],458,5,11787,4.349446494464945,20.0,0.0
2710,0,2710,[302 187 603 427 180],13,5,11792,4.349686462559941,20.0,0.0
2711,0,2711,[302 187 603 427 180],537,5,11797,4.349926253687316,20.0,0.0
2712,0,2712,[302 187 603 427 180],13,5,11802,4.350165868042757,20.0,0.0
2713,0,2713,[302 187 603 427 180],339,5,11807,4.350405305821665,20.0,0.0
2714,0,2714,[302 187 603 427 180],474,5,11812,4.3506445672191525,20.0,0.0
2715,0,2715,[ 70  96  50 483 333],537,3,11815,4.350147275405007,20.0,20.0
2716,0,2716,[302 187 603 427 180],13,5,11820,4.3503864556496135,20.0,0.0
2717,0,2717,[302 187 603 427 180],13,5,11825,4.350625459896983,20.0,0.0
2718,0,2718,[ 71 121 185 100 168],749,3,11828,4.350128723795513,0.0,20.0
2719,0,2719,[302 187 603 427 180],666,5,11833,4.350367647058824,20.0,0.0
2720,0,2720,[127 121 655 186 185],666,3,11836,4.349871370819551,0.0,20.0
2721,0,2721,[302 187 603 427 180],664,5,11841,4.350110213078619,20.0,0.0
2722,0,2722,[100 185  96  64 210],488,3,11844,4.349614395886889,0.0,20.0
2723,0,2723,[302 187 603 427 180],664,5,11849,4.3498531571218795,20.0,0.0
2724,0,2724,[302 187 603 427 180],13,5,11854,4.3500917431192665,20.0,0.0
2725,0,2725,[111 568 127 176 118],643,4,11858,4.349963316214233,0.0,20.0
2726,0,2726,[302 187 603 427 180],458,5,11863,4.350201686835351,20.0,0.0
2727,0,2727,[302 187 603 427 180],339,5,11868,4.350439882697947,20.0,0.0
2728,0,2728,[302 187 603 427 180],271,5,11873,4.3506779039941375,20.0,0.0
2729,0,2729,[471 568 328 427 322],788,2,11875,4.3498168498168495,0.0,0.0
2730,0,2730,[302 187 603 427 180],339,5,11880,4.350054924935921,20.0,0.0
2731,0,2731,[ 88 222   1 121 215],650,1,11881,4.348828696925329,0.0,0.0
2732,0,2732,[302 187 603 427 180],90,5,11886,4.349066959385291,20.0,0.0
2733,0,2733,[302 187 603 427 180],666,5,11891,4.349305047549378,20.0,0.0
2734,0,2734,[302 187 603 427 180],13,5,11896,4.349542961608775,20.0,0.0
2735,0,2735,[302 187 603 427 180],13,5,11901,4.349780701754386,20.0,0.0
2736,0,2736,[302 187 603 427 180],13,5,11906,4.350018268176836,20.0,0.0
2737,0,2737,[302 187 603 427 180],664,5,11911,4.3502556610664715,20.0,0.0
2738,0,2738,[475 185 234 117 180],479,3,11914,4.349762687112085,0.0,0.0
2739,0,2739,[ 88 403 238 222   8],883,4,11918,4.34963503649635,0.0,0.0
2740,0,2740,[302 187 603 427 180],13,5,11923,4.34987230937614,20.0,0.0
2741,0,2741,[302 187 603 427 180],90,5,11928,4.350109409190372,20.0,0.0
2742,0,2742,[302 187 603 427 180],458,5,11933,4.350346336128327,20.0,0.0
2743,0,2743,[302 187 603 427 180],13,5,11938,4.350583090379009,20.0,0.0
2744,0,2744,[302 187 603 427 180],339,5,11943,4.350819672131148,20.0,0.0
2745,0,2745,[302 187 603 427 180],664,5,11948,4.351056081573198,20.0,0.0
2746,0,2746,[515 603 197  70  89],452,5,11953,4.351292318893338,20.0,0.0
2747,0,2747,[302 187 603 427 180],339,5,11958,4.351528384279476,20.0,0.0
2748,0,2748,[302 187 603 427 180],666,5,11963,4.351764277919243,20.0,0.0
2749,0,2749,[302 187 603 427 180],666,5,11968,4.352,20.0,0.0
2750,0,2750,[  7 153 197 168 195],374,2,11970,4.351145038167939,0.0,0.0
2751,0,2751,[423 257  15 357  50],653,2,11972,4.350290697674419,20.0,20.0
2752,0,2752,[302 187 603 427 180],339,5,11977,4.350526698147475,20.0,0.0
2753,0,2753,[302 187 603 427 180],271,5,11982,4.350762527233115,20.0,0.0
2754,0,2754,[302 187 603 427 180],339,5,11987,4.350998185117968,20.0,0.0
2755,0,2755,[187 357 204 228 180],85,4,11991,4.350870827285922,20.0,0.0
2756,0,2756,[302 187 603 427 180],458,5,11996,4.351106274936525,20.0,0.0
2757,0,2757,[302 187 603 427 180],339,5,12001,4.351341551849166,20.0,0.0
2758,0,2758,[302 187 603 427 180],339,5,12006,4.351576658209496,20.0,0.0
2759,0,2759,[302 187 603 427 180],90,5,12011,4.351811594202899,20.0,0.0
2760,0,2760,[475   1  28 172  89],648,4,12015,4.351684172401304,0.0,0.0
2761,0,2761,[302 187 603 427 180],537,5,12020,4.3519188993482985,20.0,0.0
2762,0,2762,[302 187 603 427 180],664,5,12025,4.352153456387984,20.0,0.0
2763,0,2763,[405 135   8 282 235],334,3,12028,4.351664254703328,0.0,0.0
2764,0,2764,[ 11  70  56 118 288],892,4,12032,4.3515370705244125,0.0,0.0
2765,0,2765,[302 187 603 427 180],537,5,12037,4.35177151120752,20.0,0.0
2766,0,2766,[302 187 603 427 180],666,5,12042,4.352005782435851,20.0,0.0
2767,0,2767,[302 187 603 427 180],666,5,12047,4.352239884393064,20.0,0.0
2768,0,2768,[302 187 603 427 180],271,5,12052,4.35247381726255,20.0,0.0
2769,0,2769,[302 187 603 427 180],458,5,12057,4.3527075812274365,20.0,0.0
2770,0,2770,[302 187 603 427 180],537,5,12062,4.352941176470588,20.0,0.0
2771,0,2771,[302 187 603 427 180],474,5,12067,4.353174603174603,20.0,0.0
2772,0,2772,[302 187 603 427 180],458,5,12072,4.353407861521817,20.0,0.0
2773,0,2773,[302 187 603 427 180],537,5,12077,4.353640951694304,20.0,0.0
2774,0,2774,[302 187 603 427 180],271,5,12082,4.353873873873874,20.0,0.0
2775,0,2775,[153 423 228  89  88],694,5,12087,4.354106628242075,0.0,0.0
2776,0,2776,[302 187 603 427 180],474,5,12092,4.354339214980194,20.0,0.0
2777,0,2777,[302 187 603 427 180],271,5,12097,4.354571634269258,20.0,0.0
2778,0,2778,[302 187 603 427 180],458,5,12102,4.354803886290032,20.0,0.0
2779,0,2779,[302 187 603 427 180],537,5,12107,4.355035971223022,20.0,0.0
2780,0,2780,[302 187 603 427 180],458,5,12112,4.355267889248472,20.0,0.0
2781,0,2781,[  4   1 258 301  70],788,2,12114,4.354421279654924,0.0,0.0
2782,0,2782,[143  12 275 475 678],13,1,12115,4.353215954006468,20.0,0.0
2783,0,2783,[ 56 176 597 655 211],7,3,12118,4.352729885057471,0.0,0.0
2784,0,2784,[302 187 603 427 180],13,5,12123,4.352962298025135,20.0,0.0
2785,0,2785,[168 237 191 282 258],334,5,12128,4.353194544149318,0.0,0.0
2786,0,2786,[302 187 603 427 180],90,5,12133,4.353426623609616,20.0,0.0
2787,0,2787,[173 273 200 257 176],378,4,12137,4.353299856527977,0.0,0.0
2788,0,2788,[302 187 603 427 180],664,5,12142,4.353531731803514,20.0,0.0
2789,0,2789,[302 187 603 427 180],339,5,12147,4.353763440860215,20.0,0.0
2790,0,2790,[302 187 603 427 180],537,5,12152,4.353994983876746,20.0,0.0
2791,0,2791,[403 121 483 132 238],881,2,12154,4.353151862464183,20.0,0.0
2792,0,2792,[275 121 289 111 546],271,3,12157,4.35266738274257,0.0,0.0
2793,0,2793,[302 187 603 427 180],339,5,12162,4.352899069434502,20.0,0.0
2794,0,2794,[302 187 603 427 180],90,5,12167,4.353130590339893,20.0,0.0
2795,0,2795,[ 70 195 183 117  79],881,4,12171,4.353004291845494,0.0,0.0
2796,0,2796,[302 187 603 427 180],90,5,12176,4.353235609581695,20.0,0.0
2797,0,2797,[302 187 603 427 180],13,5,12181,4.353466761972838,20.0,0.0
2798,0,2798,[328 179 143 125 176],92,3,12184,4.352983208288674,0.0,0.0
2799,0,2799,[302 187 603 427 180],664,5,12189,4.3532142857142855,20.0,0.0
2800,0,2800,[111   7  82 258 172],13,3,12192,4.3527311674402,0.0,0.0
2801,0,2801,[302 187 603 427 180],458,5,12197,4.3529621698786585,20.0,0.0
2802,0,2802,[302 187 603 427 180],339,5,12202,4.3531930074919725,20.0,0.0
2803,0,2803,[302 187 603 427 180],90,5,12207,4.3534236804564905,20.0,0.0
2804,0,2804,[302 187 603 427 180],458,5,12212,4.3536541889483065,20.0,0.0
2805,0,2805,[302 187 603 427 180],90,5,12217,4.3538845331432645,20.0,0.0
2806,0,2806,[302 187 603 427 180],666,5,12222,4.3541147132169575,20.0,0.0
2807,0,2807,[302 187 603 427 180],458,5,12227,4.35434472934473,20.0,0.0
2808,0,2808,[ 79  88 161 172 385],200,5,12232,4.354574581701673,0.0,0.0
2809,0,2809,[161 127  79 181  89],158,3,12235,4.354092526690391,0.0,20.0
2810,0,2810,[546   4 117 172  56],788,1,12236,4.352899324083956,0.0,0.0
2811,0,2811,[302 187 603 427 180],666,5,12241,4.353129445234709,20.0,0.0
2812,0,2812,[597  22 333 121 289],13,2,12243,4.3522929257020975,0.0,0.0
2813,0,2813,[302 187 603 427 180],666,5,12248,4.352523098791756,20.0,0.0
2814,0,2814,[176 496  15 258  98],749,5,12253,4.352753108348135,0.0,20.0
2815,0,2815,[302 187 603 427 180],664,5,12258,4.352982954545454,20.0,0.0
2816,0,2816,[655 235  12 121 204],13,4,12262,4.35285764998225,20.0,0.0
2817,0,2817,[302 187 603 427 180],664,5,12267,4.353087295954578,20.0,0.0
2818,0,2818,[302 187 603 427 180],271,5,12272,4.353316778999646,20.0,0.0
2819,0,2819,[ 96   1 216  89 173],883,4,12276,4.353191489361702,0.0,0.0
2820,0,2820,[302 187 603 427 180],474,5,12281,4.353420772775611,20.0,0.0
2821,0,2821,[132 186 597  89 385],788,2,12283,4.352586817859674,0.0,0.0
2822,0,2822,[302 187 603 427 180],666,5,12288,4.352816153028693,20.0,0.0
2823,0,2823,[ 71 144 294  88 176],13,3,12291,4.352337110481586,0.0,0.0
2824,0,2824,[302 187 603 427 180],664,5,12296,4.352566371681416,20.0,0.0
2825,0,2825,[172  97 173 118 423],194,1,12297,4.351380042462845,0.0,0.0
2826,0,2826,[302 187 603 427 180],458,5,12302,4.351609480014149,20.0,0.0
2827,0,2827,[405  89 271 276 238],334,3,12305,4.351131541725601,0.0,0.0
2828,0,2828,[302 187 603 427 180],90,5,12310,4.351360904913397,20.0,0.0
2829,0,2829,[302 187 603 427 180],537,5,12315,4.351590106007067,20.0,0.0
2830,0,2830,[302 187 603 427 180],664,5,12320,4.351819145178382,20.0,0.0
2831,0,2831,[ 98 405  50  79 423],59,4,12324,4.351694915254237,0.0,40.0
2832,0,2832,[302 187 603 427 180],90,5,12329,4.351923755735969,20.0,0.0
2833,0,2833,[302 187 603 427 180],271,5,12334,4.352152434721242,20.0,0.0
2834,0,2834,[302 187 603 427 180],90,5,12339,4.352380952380952,20.0,0.0
2835,0,2835,[302 187 603 427 180],664,5,12344,4.3526093088857545,20.0,0.0
2836,0,2836,[302 187 603 427 180],13,5,12349,4.352837504406063,20.0,0.0
2837,0,2837,[302 187 603 427 180],537,5,12354,4.353065539112051,20.0,0.0
2838,0,2838,[423   9 168  82 318],334,5,12359,4.3532934131736525,20.0,0.0
2839,0,2839,[302 187 603 427 180],271,5,12364,4.353521126760564,20.0,0.0
2840,0,2840,[302 187 603 427 180],90,5,12369,4.353748680042239,20.0,0.0
2841,0,2841,[265 174 211 742 471],271,3,12372,4.353272343420127,0.0,20.0
2842,0,2842,[302 187 603 427 180],458,5,12377,4.3534998241294405,20.0,0.0
2843,0,2843,[302 187 603 427 180],90,5,12382,4.353727144866386,20.0,0.0
2844,0,2844,[302 187 603 427 180],537,5,12387,4.353954305799649,20.0,0.0
2845,0,2845,[302 187 603 427 180],537,5,12392,4.354181307097681,20.0,0.0
2846,0,2846,[302 187 603 427 180],271,5,12397,4.354408148928697,20.0,0.0
2847,0,2847,[ 79 175 111 151 288],474,3,12400,4.353932584269663,0.0,0.0
2848,0,2848,[302 187 603 427 180],666,5,12405,4.354159354159354,20.0,0.0
2849,0,2849,[302 187 603 427 180],271,5,12410,4.3543859649122805,20.0,0.0
2850,0,2850,[302 187 603 427 180],664,5,12415,4.354612416695896,20.0,0.0
2851,0,2851,[318 172 222 275 216],328,3,12418,4.354137447405329,20.0,0.0
2852,0,2852,[204 176 135   7 597],378,3,12421,4.3536628110760605,0.0,0.0
2853,0,2853,[302 187 603 427 180],13,5,12426,4.353889278206027,20.0,0.0
2854,0,2854,[302 187 603 427 180],664,5,12431,4.354115586690018,20.0,0.0
2855,0,2855,[302 187 603 427 180],664,5,12436,4.3543417366946775,20.0,0.0
2856,0,2856,[302 187 603 427 180],664,5,12441,4.354567728386419,20.0,0.0
2857,0,2857,[302 187 603 427 180],664,5,12446,4.35479356193142,20.0,0.0
2858,0,2858,[302 187 603 427 180],13,5,12451,4.355019237495628,20.0,0.0
2859,0,2859,[302 187 603 427 180],90,5,12456,4.3552447552447555,20.0,0.0
2860,0,2860,[ 82  79 182 276 197],339,5,12461,4.355470115344286,0.0,0.0
2861,0,2861,[302 187 603 427 180],474,5,12466,4.355695317959469,20.0,0.0
2862,0,2862,[288 151 194 210  25],7,4,12470,4.3555710792874605,0.0,0.0
2863,0,2863,[121  69  25  96 197],474,5,12475,4.355796089385475,0.0,0.0
2864,0,2864,[302 187 603 427 180],664,5,12480,4.356020942408377,20.0,0.0
2865,0,2865,[ 89 294 678 194 196],474,3,12483,4.355547801814375,0.0,0.0
2866,0,2866,[161 151 265 427  79],650,2,12485,4.354726194628531,0.0,0.0
2867,0,2867,[302 187 603 427 180],13,5,12490,4.354951185495119,20.0,0.0
2868,0,2868,[153 118 318 423 222],788,2,12492,4.354130359010108,20.0,0.0
2869,0,2869,[302 187 603 427 180],664,5,12497,4.354355400696864,20.0,0.0
2870,0,2870,[302 187 603 427 180],458,5,12502,4.354580285614769,20.0,0.0
2871,0,2871,[748 475 238 603 185],474,4,12506,4.354456824512535,20.0,0.0
2872,0,2872,[302 187 603 427 180],339,5,12511,4.354681517577445,20.0,0.0
2873,0,2873,[302 187 603 427 180],474,5,12516,4.354906054279749,20.0,0.0
2874,0,2874,[302 187 603 427 180],271,5,12521,4.355130434782609,20.0,0.0
2875,0,2875,[144 228  96 132  22],92,3,12524,4.354659248956884,0.0,0.0
2876,0,2876,[302 187 603 427 180],271,5,12529,4.354883559263121,20.0,0.0
2877,0,2877,[302 187 603 427 180],666,5,12534,4.355107713690063,20.0,0.0
2878,0,2878,[302 187 603 427 180],664,5,12539,4.3553317124001385,20.0,0.0
2879,0,2879,[228   1 179 515 168],380,3,12542,4.354861111111111,0.0,0.0
2880,0,2880,[655 194  69 204 127],213,4,12546,4.354737938215897,0.0,20.0
2881,0,2881,[302 187 603 427 180],664,5,12551,4.354961832061068,20.0,0.0
2882,0,2882,[302 187 603 427 180],664,5,12556,4.355185570586195,20.0,0.0
2883,0,2883,[302 187 603 427 180],13,5,12561,4.355409153952843,20.0,0.0
2884,0,2884,[302 183 427 132  15],6,4,12565,4.3552859618717505,0.0,0.0
2885,0,2885,[302 187 603 427 180],458,5,12570,4.355509355509356,20.0,0.0
2886,0,2886,[302 187 603 427 180],13,5,12575,4.3557325943886385,20.0,0.0
2887,0,2887,[302 187 603 427 180],13,5,12580,4.35595567867036,20.0,0.0
2888,0,2888,[302 187 603 427 180],474,5,12585,4.356178608515057,20.0,0.0
2889,0,2889,[286 182  98 210 588],59,3,12588,4.355709342560553,0.0,20.0
2890,0,2890,[302 187 603 427 180],271,5,12593,4.3559322033898304,20.0,0.0
2891,0,2891,[175 748  22 258  70],653,2,12595,4.355117565698478,0.0,0.0
2892,0,2892,[302 187 603 427 180],664,5,12600,4.355340477013481,20.0,0.0
2893,0,2893,[127 183 403  50 111],234,3,12603,4.354872149274361,0.0,40.0
2894,0,2894,[302 187 603 427 180],666,5,12608,4.355094991364421,20.0,0.0
2895,0,2895,[302 187 603 427 180],339,5,12613,4.355317679558011,20.0,0.0
2896,0,2896,[302 187 603 427 180],13,5,12618,4.355540214014498,20.0,0.0
2897,0,2897,[ 28 144 385  15 257],378,5,12623,4.355762594893029,0.0,0.0
2898,0,2898,[302 187 603 427 180],474,5,12628,4.355984822352536,20.0,0.0
2899,0,2899,[302 187 603 427 180],90,5,12633,4.356206896551724,20.0,0.0
2900,0,2900,[302 187 603 427 180],13,5,12638,4.356428817649086,20.0,0.0
2901,0,2901,[302 187 603 427 180],90,5,12643,4.356650585802894,20.0,0.0
2902,0,2902,[302 187 603 427 180],537,5,12648,4.356872201171202,20.0,0.0
2903,0,2903,[302 187 603 427 180],458,5,12653,4.357093663911845,20.0,0.0
2904,0,2904,[302 187 603 427 180],339,5,12658,4.357314974182444,20.0,0.0
2905,0,2905,[302 187 603 427 180],339,5,12663,4.3575361321404,20.0,0.0
2906,0,2906,[302 187 603 427 180],458,5,12668,4.3577571379428965,20.0,0.0
2907,0,2907,[202 300  56  11 200],666,4,12672,4.357634112792297,0.0,0.0
2908,0,2908,[302 187 603 427 180],666,5,12677,4.357854932966656,20.0,0.0
2909,0,2909,[302 187 603 427 180],271,5,12682,4.35807560137457,20.0,0.0
2910,0,2910,[302 187 603 427 180],458,5,12687,4.35829611817245,20.0,0.0
2911,0,2911,[302 187 603 427 180],339,5,12692,4.358516483516484,20.0,0.0
2912,0,2912,[302 187 603 427 180],90,5,12697,4.35873669756265,20.0,0.0
2913,0,2913,[271 313 216 127 273],144,4,12701,4.358613589567605,0.0,20.0
2914,0,2914,[302 187 603 427 180],458,5,12706,4.358833619210977,20.0,0.0
2915,0,2915,[302 187 603 427 180],664,5,12711,4.359053497942387,20.0,0.0
2916,0,2916,[302 187 603 427 180],13,5,12716,4.359273225917038,20.0,0.0
2917,0,2917,[302 187 603 427 180],458,5,12721,4.359492803289925,20.0,0.0
2918,0,2918,[ 22 191 181 215 748],648,3,12724,4.359027064063035,0.0,0.0
2919,0,2919,[202 496   7 196  15],653,0,12724,4.357534246575343,0.0,0.0
2920,0,2920,[302 187 603 427 180],90,5,12729,4.357754193769257,20.0,0.0
2921,0,2921,[302 187 603 427 180],13,5,12734,4.3579739904175225,20.0,0.0
2922,0,2922,[302 187 603 427 180],664,5,12739,4.358193636674649,20.0,0.0
2923,0,2923,[302 187 603 427 180],474,5,12744,4.358413132694938,20.0,0.0
2924,0,2924,[302 187 603 427 180],90,5,12749,4.358632478632479,20.0,0.0
2925,0,2925,[  1 271  71 568  56],64,3,12752,4.358168147641832,0.0,0.0
2926,0,2926,[302 187 603 427 180],90,5,12757,4.358387427400069,20.0,0.0
2927,0,2927,[302 187 603 427 180],339,5,12762,4.358606557377049,20.0,0.0
2928,0,2928,[ 95 276  25 187 172],59,4,12766,4.358484124274496,0.0,0.0
2929,0,2929,[302 187 603 427 180],13,5,12771,4.358703071672355,20.0,0.0
2930,0,2930,[302 187 603 427 180],13,5,12776,4.358921869669055,20.0,0.0
2931,0,2931,[204 288 173  11  71],554,3,12779,4.358458390177353,0.0,0.0
2932,0,2932,[357 238 276  79 125],406,2,12781,4.357654278895329,20.0,0.0
2933,0,2933,[302 187 603 427 180],458,5,12786,4.357873210633946,20.0,0.0
2934,0,2934,[427 176 194 111  56],474,5,12791,4.35809199318569,0.0,0.0
2935,0,2935,[302 187 603 427 180],666,5,12796,4.358310626702997,20.0,0.0
2936,0,2936,[211 318  22 427  71],474,5,12801,4.3585291113381,20.0,0.0
2937,0,2937,[302 187 603 427 180],13,5,12806,4.358747447243022,20.0,0.0
2938,0,2938,[302 187 603 427 180],664,5,12811,4.358965634569581,20.0,0.0
2939,0,2939,[302 187 603 427 180],90,5,12816,4.359183673469388,20.0,0.0
2940,0,2940,[181 127 228 179 748],653,5,12821,4.3594015640938455,0.0,20.0
2941,0,2941,[302 187 603 427 180],666,5,12826,4.359619306594154,20.0,0.0
2942,0,2942,[302 187 603 427 180],339,5,12831,4.359836901121305,20.0,0.0
2943,0,2943,[302 187 603 427 180],666,5,12836,4.360054347826087,20.0,0.0
2944,0,2944,[302 187 603 427 180],474,5,12841,4.360271646859083,20.0,0.0
2945,0,2945,[302 187 603 427 180],13,5,12846,4.360488798370672,20.0,0.0
2946,0,2946,[302 187 603 427 180],458,5,12851,4.360705802511029,20.0,0.0
2947,0,2947,[475 176 496   4 183],387,1,12852,4.359565807327002,0.0,0.0
2948,0,2948,[302 187 603 427 180],339,5,12857,4.359782977280434,20.0,0.0
2949,0,2949,[302 187 603 427 180],90,5,12862,4.36,20.0,0.0
2950,0,2950,[302 187 603 427 180],13,5,12867,4.360216875635378,20.0,0.0
2951,0,2951,[302 187 603 427 180],271,5,12872,4.360433604336043,20.0,0.0
2952,0,2952,[302 187 603 427 180],458,5,12877,4.36065018625127,20.0,0.0
2953,0,2953,[216 176 496 403  15],892,4,12881,4.360528097494922,0.0,0.0
2954,0,2954,[302 187 603 427 180],339,5,12886,4.360744500846024,20.0,0.0
2955,0,2955,[204 175 135  82 515],804,4,12890,4.360622462787551,0.0,0.0
2956,0,2956,[173 175  79  97 568],189,4,12894,4.360500507270882,0.0,0.0
2957,0,2957,[302 187 603 427 180],666,5,12899,4.360716700473293,20.0,0.0
2958,0,2958,[302 187 603 427 180],271,5,12904,4.360932747549848,20.0,0.0
2959,0,2959,[302 187 603 427 180],474,5,12909,4.361148648648649,20.0,0.0
2960,0,2960,[357   8 172 183 515],774,1,12910,4.360013508949679,20.0,0.0
2961,0,2961,[302 187 603 427 180],664,5,12915,4.360229574611749,20.0,0.0
2962,0,2962,[302 187 603 427 180],458,5,12920,4.360445494431319,20.0,0.0
2963,0,2963,[302 187 603 427 180],666,5,12925,4.360661268556005,20.0,0.0
2964,0,2964,[302 187 603 427 180],458,5,12930,4.360876897133221,20.0,0.0
2965,0,2965,[328 175  82 196 333],85,2,12932,4.360080917060014,0.0,0.0
2966,0,2966,[  8 471  98  82 357],13,2,12934,4.359285473542299,20.0,20.0
2967,0,2967,[302 187 603 427 180],90,5,12939,4.359501347708895,20.0,0.0
2968,0,2968,[302 187 603 427 180],90,5,12944,4.359717076456719,20.0,0.0
2969,0,2969,[237   7  64 222   8],474,5,12949,4.35993265993266,0.0,0.0
2970,0,2970,[302 187 603 427 180],90,5,12954,4.360148098283406,20.0,0.0
2971,0,2971,[302 187 603 427 180],339,5,12959,4.360363391655451,20.0,0.0
2972,0,2972,[302 187 603 427 180],537,5,12964,4.360578540195089,20.0,0.0
2973,0,2973,[302 187 603 427 180],13,5,12969,4.36079354404842,20.0,0.0
2974,0,2974,[179  11 222 289 174],881,4,12973,4.360672268907563,0.0,20.0
2975,0,2975,[302 187 603 427 180],339,5,12978,4.360887096774194,20.0,0.0
2976,0,2976,[302 187 603 427 180],664,5,12983,4.361101780315754,20.0,0.0
2977,0,2977,[302 187 603 427 180],537,5,12988,4.361316319677636,20.0,0.0
2978,0,2978,[151 357 181 276 288],234,1,12989,4.360187982544478,20.0,0.0
2979,0,2979,[302 187 603 427 180],339,5,12994,4.360402684563758,20.0,0.0
2980,0,2980,[151 568 238 121 144],313,4,12998,4.360281784636028,0.0,0.0
2981,0,2981,[302 187 603 427 180],90,5,13003,4.360496311200537,20.0,0.0
2982,0,2982,[  9 748 515 180 313],328,4,13007,4.360375460945357,0.0,0.0
2983,0,2983,[302 187 603 427 180],13,5,13012,4.36058981233244,20.0,0.0
2984,0,2984,[302 187 603 427 180],666,5,13017,4.3608040201005025,20.0,0.0
2985,0,2985,[302 187 603 427 180],13,5,13022,4.361018084393838,20.0,0.0
2986,0,2986,[302 187 603 427 180],666,5,13027,4.361232005356545,20.0,0.0
2987,0,2987,[302 187 603 427 180],339,5,13032,4.36144578313253,20.0,0.0
2988,0,2988,[302 187 603 427 180],664,5,13037,4.361659417865507,20.0,0.0
2989,0,2989,[202 144 132 168 234],749,5,13042,4.361872909698997,0.0,0.0
2990,0,2990,[302 187 603 427 180],537,5,13047,4.362086258776329,20.0,0.0
2991,0,2991,[302 187 603 427 180],666,5,13052,4.362299465240642,20.0,0.0
2992,0,2992,[302 187 603 427 180],458,5,13057,4.362512529234881,20.0,0.0
2993,0,2993,[475 385  98  79 515],387,3,13060,4.362057448229793,0.0,20.0
2994,0,2994,[302 187 603 427 180],339,5,13065,4.362270450751252,20.0,0.0
2995,0,2995,[302 187 603 427 180],339,5,13070,4.362483311081442,20.0,0.0
2996,0,2996,[  4  89 302 191 276],378,4,13074,4.362362362362362,0.0,0.0
2997,0,2997,[117  98 186  22 269],334,2,13076,4.3615743829219475,0.0,20.0
2998,0,2998,[268 237 174 197 161],234,1,13077,4.3604534844948315,0.0,20.0
2999,0,2999,[588 202 483 204 183],881,4,13081,4.360333333333333,20.0,0.0
3000,0,3000,[302 187 603 427 180],664,5,13086,4.360546484505165,20.0,0.0
3001,0,3001,[ 64  89 546 153 121],374,4,13090,4.360426382411726,0.0,0.0
3002,0,3002,[302 187 603 427 180],666,5,13095,4.360639360639361,20.0,0.0
3003,0,3003,[302 187 603 427 180],90,5,13100,4.360852197070573,20.0,0.0
3004,0,3004,[302 187 603 427 180],458,5,13105,4.3610648918469215,20.0,0.0
3005,0,3005,[302 187 603 427 180],339,5,13110,4.36127744510978,20.0,0.0
3006,0,3006,[302 187 603 427 180],458,5,13115,4.361489857000333,20.0,0.0
3007,0,3007,[302 187 603 427 180],271,5,13120,4.361702127659575,20.0,0.0
3008,0,3008,[302 187 603 427 180],13,5,13125,4.361914257228315,20.0,0.0
3009,0,3009,[302 187 603 427 180],90,5,13130,4.362126245847176,20.0,0.0
3010,0,3010,[302 187 603 427 180],271,5,13135,4.362338093656592,20.0,0.0
3011,0,3011,[302 187 603 427 180],90,5,13140,4.362549800796812,20.0,0.0
3012,0,3012,[302 187 603 427 180],271,5,13145,4.362761367407899,20.0,0.0
3013,0,3013,[313 121 546 265 515],650,3,13148,4.362309223623092,0.0,0.0
3014,0,3014,[302 187 603 427 180],271,5,13153,4.362520729684909,20.0,0.0
3015,0,3015,[302 187 603 427 180],474,5,13158,4.362732095490716,20.0,0.0
3016,0,3016,[302 187 603 427 180],666,5,13163,4.36294332117998,20.0,0.0
3017,0,3017,[176 210  15 435 385],650,3,13166,4.362491716368456,0.0,0.0
3018,0,3018,[302 187 603 427 180],13,5,13171,4.362702881748923,20.0,0.0
3019,0,3019,[183   4 127 515 313],334,4,13175,4.362582781456954,0.0,20.0
3020,0,3020,[302 187 603 427 180],271,5,13180,4.362793776895068,20.0,0.0
3021,0,3021,[302 187 603 427 180],13,5,13185,4.36300463269358,20.0,0.0
3022,0,3022,[194  15 196   4 187],650,2,13187,4.362222957327158,0.0,0.0
3023,0,3023,[603 187 508 176  98],213,5,13192,4.362433862433862,20.0,20.0
3024,0,3024,[302 603 187 427 180],90,5,13197,4.362644628099174,20.0,0.0
3025,0,3025,[302 603 187 427 180],664,5,13202,4.362855254461335,20.0,0.0
3026,0,3026,[235 173 161 222   7],378,4,13206,4.362735381565907,0.0,0.0
3027,0,3027,[302 603 187 427 180],537,5,13211,4.362945838837517,20.0,0.0
3028,0,3028,[302 603 187 427 180],13,5,13216,4.363156157147573,20.0,0.0
3029,0,3029,[302 603 187 427 180],90,5,13221,4.363366336633663,20.0,0.0
3030,0,3030,[302 603 187 427 180],271,5,13226,4.363576377433191,20.0,0.0
3031,0,3031,[258 100 268 269 475],199,4,13230,4.363456464379947,0.0,20.0
3032,0,3032,[294  71 318 172  89],308,4,13234,4.363336630398945,20.0,0.0
3033,0,3033,[302 603 187 427 180],664,5,13239,4.363546473302571,20.0,0.0
3034,0,3034,[483 191 127 403 275],311,5,13244,4.363756177924217,20.0,20.0
3035,0,3035,[194 132 483 144 276],234,3,13247,4.3633069828722,20.0,0.0
3036,0,3036,[302 603 187 427 180],271,5,13252,4.363516628251564,20.0,0.0
3037,0,3037,[302 603 187 427 180],458,5,13257,4.363726135615536,20.0,0.0
3038,0,3038,[302 603 187 427 180],664,5,13262,4.363935505100362,20.0,0.0
3039,0,3039,[302 603 187 427 180],537,5,13267,4.364144736842105,20.0,0.0
3040,0,3040,[  4 403 265   7 179],234,1,13268,4.363038474186123,0.0,0.0
3041,0,3041,[302 603 187 427 180],458,5,13273,4.363247863247863,20.0,0.0
3042,0,3042,[302 603 187 427 180],474,5,13278,4.363457114689451,20.0,0.0
3043,0,3043,[302 603 187 427 180],339,5,13283,4.363666228646518,20.0,0.0
3044,0,3044,[302 603 187 427 180],537,5,13288,4.363875205254516,20.0,0.0
3045,0,3045,[302 603 187 427 180],458,5,13293,4.3640840446487195,20.0,0.0
3046,0,3046,[302 603 187 427 180],664,5,13298,4.364292746964227,20.0,0.0
3047,0,3047,[302 603 187 427 180],666,5,13303,4.364501312335958,20.0,0.0
3048,0,3048,[302 603 187 427 180],271,5,13308,4.364709740898656,20.0,0.0
3049,0,3049,[302 603 187 427 180],458,5,13313,4.3649180327868855,20.0,0.0
3050,0,3050,[257   4 144 153 265],374,3,13316,4.364470665355621,0.0,0.0
3051,0,3051,[302 603 187 427 180],458,5,13321,4.364678899082569,20.0,0.0
3052,0,3052,[302 603 187 427 180],458,5,13326,4.3648869963969865,20.0,0.0
3053,0,3053,[435 508  22 161 228],524,3,13329,4.364440078585462,0.0,0.0
3054,0,3054,[302 603 187 427 180],13,5,13334,4.364648117839607,20.0,0.0
3055,0,3055,[302 603 187 427 180],271,5,13339,4.364856020942408,20.0,0.0
3056,0,3056,[185 200 210 143 385],537,1,13340,4.363755315668956,0.0,0.0
3057,0,3057,[276 273 197 204 275],537,3,13343,4.363309352517986,0.0,0.0
3058,0,3058,[496   1 257 168 328],804,5,13348,4.363517489375613,0.0,0.0
3059,0,3059,[302 603 187 427 180],666,5,13353,4.363725490196078,20.0,0.0
3060,0,3060,[302 603 187 427 180],664,5,13358,4.363933355112708,20.0,0.0
3061,0,3061,[302 603 187 427 180],271,5,13363,4.364141084258654,20.0,0.0
3062,0,3062,[471  56 269  96 265],7,4,13367,4.364022200457068,0.0,0.0
3063,0,3063,[302 603 187 427 180],474,5,13372,4.364229765013055,20.0,0.0
3064,0,3064,[302 603 187 427 180],458,5,13377,4.364437194127243,20.0,0.0
3065,0,3065,[302 603 187 427 180],664,5,13382,4.364644487932159,20.0,0.0
3066,0,3066,[302 603 187 427 180],474,5,13387,4.364851646560156,20.0,0.0
3067,0,3067,[302 603 187 427 180],271,5,13392,4.365058670143416,20.0,0.0
3068,0,3068,[302 603 187 427 180],666,5,13397,4.365265558813946,20.0,0.0
3069,0,3069,[302 603 187 427 180],90,5,13402,4.3654723127035835,20.0,0.0
3070,0,3070,[302 603 187 427 180],666,5,13407,4.365678931943992,20.0,0.0
3071,0,3071,[302 603 187 427 180],666,5,13412,4.365885416666667,20.0,0.0
3072,0,3072,[181 282 179 144  64],207,3,13415,4.365440937194924,0.0,0.0
3073,0,3073,[302 603 187 427 180],474,5,13420,4.365647364996747,20.0,0.0
3074,0,3074,[302 603 187 427 180],664,5,13425,4.365853658536586,20.0,0.0
3075,0,3075,[ 64 748 245 328 385],488,4,13429,4.365734720416125,0.0,0.0
3076,0,3076,[302 603 187 427 180],474,5,13434,4.3659408514787135,20.0,0.0
3077,0,3077,[302 603 187 427 180],90,5,13439,4.366146848602989,20.0,0.0
3078,0,3078,[302 603 187 427 180],537,5,13444,4.366352711919454,20.0,0.0
3079,0,3079,[302 603 187 427 180],339,5,13449,4.366558441558442,20.0,0.0
3080,0,3080,[302 603 187 427 180],666,5,13454,4.366764037650114,20.0,0.0
3081,0,3081,[302 603 187 427 180],13,5,13459,4.366969500324465,20.0,0.0
3082,0,3082,[302 603 187 427 180],339,5,13464,4.36717482971132,20.0,0.0
3083,0,3083,[302 603 187 427 180],271,5,13469,4.367380025940337,20.0,0.0
3084,0,3084,[302 603 187 427 180],474,5,13474,4.367585089141005,20.0,0.0
3085,0,3085,[302 603 187 427 180],271,5,13479,4.367790019442644,20.0,0.0
3086,0,3086,[300 186 191 180 135],313,4,13483,4.36767087787496,0.0,0.0
3087,0,3087,[302 603 187 427 180],90,5,13488,4.367875647668394,20.0,0.0
3088,0,3088,[302 603 187 427 180],458,5,13493,4.368080284881839,20.0,0.0
3089,0,3089,[132  79 186 143 318],194,2,13495,4.367313915857605,20.0,0.0
3090,0,3090,[302 603 187 427 180],537,5,13500,4.367518602394047,20.0,0.0
3091,0,3091,[302 603 187 427 180],537,5,13505,4.367723156532988,20.0,0.0
3092,0,3092,[302 603 187 427 180],474,5,13510,4.3679275784028455,20.0,0.0
3093,0,3093,[ 95   1  25 181 228],374,4,13514,4.367808661926309,0.0,0.0
3094,0,3094,[302 603 187 427 180],474,5,13519,4.368012924071082,20.0,0.0
3095,0,3095,[385  96 174 125 678],648,3,13522,4.3675710594315245,0.0,20.0
3096,0,3096,[302 603 187 427 180],664,5,13527,4.367775266386826,20.0,0.0
3097,0,3097,[302 603 187 427 180],339,5,13532,4.367979341510652,20.0,0.0
3098,0,3098,[ 50 655  96 210 603],537,2,13534,4.367215230719587,20.0,20.0
3099,0,3099,[179 143 269 238 496],537,3,13537,4.3667741935483875,0.0,0.0
3100,0,3100,[302 603 187 427 180],90,5,13542,4.366978394066431,20.0,0.0
3101,0,3101,[302 603 187 427 180],13,5,13547,4.367182462927143,20.0,0.0
3102,0,3102,[302 603 187 427 180],458,5,13552,4.367386400257815,20.0,0.0
3103,0,3103,[302 603 187 427 180],458,5,13557,4.367590206185567,20.0,0.0
3104,0,3104,[302 603 187 427 180],271,5,13562,4.367793880837359,20.0,0.0
3105,0,3105,[302 603 187 427 180],664,5,13567,4.367997424339987,20.0,0.0
3106,0,3106,[302 603 187 427 180],13,5,13572,4.368200836820083,20.0,0.0
3107,0,3107,[302 603 187 427 180],339,5,13577,4.3684041184041185,20.0,0.0
3108,0,3108,[302 603 187 427 180],13,5,13582,4.368607269218399,20.0,0.0
3109,0,3109,[302 603 187 427 180],666,5,13587,4.368810289389067,20.0,0.0
3110,0,3110,[302 603 187 427 180],458,5,13592,4.369013179042109,20.0,0.0
3111,0,3111,[302 603 187 427 180],666,5,13597,4.369215938303342,20.0,0.0
3112,0,3112,[ 89 742 187 313  15],59,4,13601,4.369097333761645,0.0,0.0
3113,0,3113,[302 603 187 427 180],271,5,13606,4.369299935773924,20.0,0.0
3114,0,3114,[302 603 187 427 180],339,5,13611,4.369502407704655,20.0,0.0
3115,0,3115,[144 515 273 288 176],234,1,13612,4.368421052631579,0.0,0.0
3116,0,3116,[302 603 187 427 180],474,5,13617,4.368623676612127,20.0,0.0
3117,0,3117,[302 603 187 427 180],90,5,13622,4.368826170622194,20.0,0.0
3118,0,3118,[302 603 187 427 180],664,5,13627,4.369028534786791,20.0,0.0
3119,0,3119,[302 603 187 427 180],474,5,13632,4.369230769230769,20.0,0.0
3120,0,3120,[ 95  82 187  22 185],749,3,13635,4.368792053828901,0.0,0.0
3121,0,3121,[176 185 423  97 210],234,1,13636,4.367713004484305,0.0,0.0
3122,0,3122,[302 603 187 427 180],474,5,13641,4.367915465898175,20.0,0.0
3123,0,3123,[302 603 187 427 180],666,5,13646,4.3681177976952625,20.0,0.0
3124,0,3124,[302 603 187 427 180],13,5,13651,4.36832,20.0,0.0
3125,0,3125,[302 603 187 427 180],458,5,13656,4.36852207293666,20.0,0.0
3126,0,3126,[302 603 187 427 180],664,5,13661,4.368724016629357,20.0,0.0
3127,0,3127,[302 603 187 427 180],271,5,13666,4.368925831202046,20.0,0.0
3128,0,3128,[186 180  96 181 328],234,0,13666,4.367529562160435,0.0,0.0
3129,0,3129,[302 603 187 427 180],664,5,13671,4.3677316293929715,20.0,0.0
3130,0,3130,[496 385 678   4  25],474,4,13675,4.367614180772916,0.0,0.0
3131,0,3131,[302 603 187 427 180],271,5,13680,4.367816091954023,20.0,0.0
3132,0,3132,[302 603 187 427 180],339,5,13685,4.36801787424194,20.0,0.0
3133,0,3133,[302 603 187 427 180],458,5,13690,4.368219527760051,20.0,0.0
3134,0,3134,[174  15  96 546 210],308,3,13693,4.3677830940988835,0.0,20.0
3135,0,3135,[302 603 187 427 180],271,5,13698,4.367984693877551,20.0,0.0
3136,0,3136,[302 603 187 427 180],664,5,13703,4.368186165125916,20.0,0.0
3137,0,3137,[144 153 265 483 121],892,5,13708,4.368387507966858,20.0,0.0
3138,0,3138,[302 603 187 427 180],666,5,13713,4.368588722523096,20.0,0.0
3139,0,3139,[183  70 172  97 496],537,2,13715,4.367834394904459,0.0,0.0
3140,0,3140,[ 89 655 271 546  64],119,5,13720,4.368035657433938,0.0,0.0
3141,0,3141,[302 603 187 427 180],13,5,13725,4.368236791852324,20.0,0.0
3142,0,3142,[302 603 187 427 180],271,5,13730,4.368437798281897,20.0,0.0
3143,0,3143,[ 25 175  69 197 100],474,5,13735,4.368638676844784,0.0,20.0
3144,0,3144,[302 603 187 427 180],271,5,13740,4.368839427662957,20.0,0.0
3145,0,3145,[151  69 237 200  28],788,4,13744,4.368722186904005,0.0,0.0
3146,0,3146,[176 294   7   1 546],13,0,13744,4.367333968859231,0.0,0.0
3147,0,3147,[127 176 228 180 403],738,4,13748,4.367217280813215,0.0,20.0
3148,0,3148,[245  97 186 318 300],666,2,13750,4.366465544617339,20.0,0.0
3149,0,3149,[302 603 187 427 180],90,5,13755,4.366666666666666,20.0,0.0
3150,0,3150,[161  97 318 385 183],543,2,13757,4.365915582354808,20.0,0.0
3151,0,3151,[302 603 187 427 180],339,5,13762,4.366116751269035,20.0,0.0
3152,0,3152,[222 238  70 186 202],892,4,13766,4.366000634316524,0.0,0.0
3153,0,3153,[302 603 187 427 180],474,5,13771,4.366201648700064,20.0,0.0
3154,0,3154,[ 50  28 742  70 173],488,4,13775,4.36608557844691,0.0,20.0
3155,0,3155,[302 603 187 427 180],13,5,13780,4.366286438529785,20.0,0.0
3156,0,3156,[302 603 187 427 180],664,5,13785,4.36648717136522,20.0,0.0
3157,0,3157,[302 603 187 427 180],537,5,13790,4.366687777074097,20.0,0.0
3158,0,3158,[302 603 187 427 180],458,5,13795,4.366888255777145,20.0,0.0
3159,0,3159,[302 603 187 427 180],474,5,13800,4.367088607594937,20.0,0.0
3160,0,3160,[302 603 187 427 180],90,5,13805,4.367288832647896,20.0,0.0
3161,0,3161,[302 603 187 427 180],666,5,13810,4.367488931056293,20.0,0.0
3162,0,3162,[176 183 403  56 313],883,4,13814,4.367372747391717,0.0,0.0
3163,0,3163,[235 405 357   8 121],13,2,13816,4.366624525916562,20.0,0.0
3164,0,3164,[302 603 187 427 180],339,5,13821,4.366824644549763,20.0,0.0
3165,0,3165,[302 603 187 427 180],339,5,13826,4.367024636765635,20.0,0.0
3166,0,3166,[100  82 288   1 172],650,2,13828,4.366277233975371,0.0,20.0
3167,0,3167,[302 603 187 427 180],666,5,13833,4.3664772727272725,20.0,0.0
3168,0,3168,[302 603 187 427 180],339,5,13838,4.366677185231934,20.0,0.0
3169,0,3169,[ 56 179 172 496 322],334,2,13840,4.365930599369086,0.0,0.0
3170,0,3170,[302 603 187 427 180],666,5,13845,4.366130558183539,20.0,0.0
3171,0,3171,[302 603 187 427 180],537,5,13850,4.366330390920555,20.0,0.0
3172,0,3172,[302 603 187 427 180],666,5,13855,4.366530097699338,20.0,0.0
3173,0,3173,[302 603 187 427 180],271,5,13860,4.366729678638942,20.0,0.0
3174,0,3174,[ 96  70 172  88 588],892,5,13865,4.366929133858267,0.0,0.0
3175,0,3175,[302 603 187 427 180],537,5,13870,4.36712846347607,20.0,0.0
3176,0,3176,[302 603 187 427 180],339,5,13875,4.367327667610954,20.0,0.0
3177,0,3177,[172  98 496 174 161],59,4,13879,4.367212083071114,0.0,40.0
3178,0,3178,[302 603 187 427 180],339,5,13884,4.367411135577226,20.0,0.0
3179,0,3179,[302 603 187 427 180],537,5,13889,4.367610062893082,20.0,0.0
3180,0,3180,[302 603 187 427 180],664,5,13894,4.367808865136749,20.0,0.0
3181,0,3181,[ 82   9  64 546 265],533,3,13897,4.3673790069138905,0.0,0.0
3182,0,3182,[302 603 187 427 180],666,5,13902,4.367577756833176,20.0,0.0
3183,0,3183,[302 603 187 427 180],666,5,13907,4.367776381909548,20.0,0.0
3184,0,3184,[302 603 187 427 180],666,5,13912,4.367974882260596,20.0,0.0
3185,0,3185,[302 603 187 427 180],271,5,13917,4.368173258003766,20.0,0.0
3186,0,3186,[302 603 187 427 180],339,5,13922,4.368371509256354,20.0,0.0
3187,0,3187,[302 603 187 427 180],664,5,13927,4.368569636135508,20.0,0.0
3188,0,3188,[302 603 187 427 180],537,5,13932,4.368767638758231,20.0,0.0
3189,0,3189,[302 603 187 427 180],13,5,13937,4.36896551724138,20.0,0.0
3190,0,3190,[302 603 187 427 180],271,5,13942,4.369163271701661,20.0,0.0
3191,0,3191,[302 603 187 427 180],13,5,13947,4.3693609022556394,20.0,0.0
3192,0,3192,[546 143   7  11 322],92,2,13949,4.368618853742562,0.0,0.0
3193,0,3193,[204 118 313  82  79],653,4,13953,4.36850344395742,0.0,0.0
3194,0,3194,[302 603 187 427 180],666,5,13958,4.368701095461659,20.0,0.0
3195,0,3195,[403 234 282 118 180],92,4,13962,4.368585732165206,0.0,0.0
3196,0,3196,[  1 237 180   7 183],234,1,13963,4.367532061307476,0.0,0.0
3197,0,3197,[302 603 187 427 180],664,5,13968,4.367729831144465,20.0,0.0
3198,0,3198,[211 742 187 385 176],313,4,13972,4.36761487964989,0.0,0.0
3199,0,3199,[302 603 187 427 180],664,5,13977,4.3678125,20.0,0.0
3200,0,3200,[302 603 187 427 180],90,5,13982,4.368009996875976,20.0,0.0
3201,0,3201,[302 603 187 427 180],271,5,13987,4.368207370393504,20.0,0.0
3202,0,3202,[302 603 187 427 180],271,5,13992,4.368404620668124,20.0,0.0
3203,0,3203,[302 603 187 427 180],13,5,13997,4.368601747815231,20.0,0.0
3204,0,3204,[118 175 318 546 222],648,3,14000,4.368174726989079,20.0,0.0
3205,0,3205,[302 603 187 427 180],13,5,14005,4.3683718028696195,20.0,0.0
3206,0,3206,[302 603 187 427 180],339,5,14010,4.368568755846586,20.0,0.0
3207,0,3207,[302 603 187 427 180],474,5,14015,4.368765586034913,20.0,0.0
3208,0,3208,[423 183 127 318 175],479,4,14019,4.368650669990651,20.0,20.0
3209,0,3209,[182   1 222 118 117],194,1,14020,4.367601246105919,0.0,0.0
3210,0,3210,[ 56 245 197 151 174],653,3,14023,4.367175334786671,0.0,20.0
3211,0,3211,[302 603 187 427 180],664,5,14028,4.367372353673724,20.0,0.0
3212,0,3212,[302 603 187 427 180],13,5,14033,4.367569249922191,20.0,0.0
3213,0,3213,[302 603 187 427 180],664,5,14038,4.3677660236465465,20.0,0.0
3214,0,3214,[222 423 328 215 238],85,2,14040,4.367029548989113,0.0,0.0
3215,0,3215,[282 121  79 168 194],899,5,14045,4.367226368159204,0.0,0.0
3216,0,3216,[302 603 187 427 180],537,5,14050,4.367423064967361,20.0,0.0
3217,0,3217,[302 603 187 427 180],458,5,14055,4.367619639527657,20.0,0.0
3218,0,3218,[302 603 187 427 180],90,5,14060,4.367816091954023,20.0,0.0
3219,0,3219,[302 603 187 427 180],664,5,14065,4.368012422360248,20.0,0.0
3220,0,3220,[215 294 222  98 176],804,5,14070,4.368208630859981,0.0,20.0
3221,0,3221,[185 111 435  25 183],666,3,14073,4.367783985102421,0.0,0.0
3222,0,3222,[302 603 187 427 180],339,5,14078,4.3679801427241705,20.0,0.0
3223,0,3223,[302 603 187 427 180],664,5,14083,4.3681761786600495,20.0,0.0
3224,0,3224,[301  96 568 185 216],328,2,14085,4.367441860465116,0.0,0.0
3225,0,3225,[302 603 187 427 180],13,5,14090,4.367637941723497,20.0,0.0
3226,0,3226,[ 15 228 222  71 211],749,4,14094,4.367524016114038,0.0,0.0
3227,0,3227,[302 603 187 427 180],537,5,14099,4.367719950433705,20.0,0.0
3228,0,3228,[161 257 174   7 313],92,3,14102,4.367296376587179,0.0,20.0
3229,0,3229,[302 603 187 427 180],339,5,14107,4.36749226006192,20.0,0.0
3230,0,3230,[ 50 174 405 435 496],313,4,14111,4.367378520581863,0.0,40.0
3231,0,3231,[302 603 187 427 180],458,5,14116,4.367574257425742,20.0,0.0
3232,0,3232,[302 603 187 427 180],474,5,14121,4.3677698731828025,20.0,0.0
3233,0,3233,[302 603 187 427 180],666,5,14126,4.367965367965368,20.0,0.0
3234,0,3234,[302 603 187 427 180],271,5,14131,4.368160741885626,20.0,0.0
3235,0,3235,[302 603 187 427 180],90,5,14136,4.368355995055624,20.0,0.0
3236,0,3236,[302 603 187 427 180],271,5,14141,4.368551127587272,20.0,0.0
3237,0,3237,[302 603 187 427 180],474,5,14146,4.368746139592341,20.0,0.0
3238,0,3238,[302 603 187 427 180],664,5,14151,4.368941031182464,20.0,0.0
3239,0,3239,[187 318 191 258 216],59,4,14155,4.368827160493828,20.0,0.0
3240,0,3240,[302 603 187 427 180],90,5,14160,4.369021906818883,20.0,0.0
3241,0,3241,[333 143  89 144 269],64,2,14162,4.368291178285009,0.0,0.0
3242,0,3242,[268 423 318  64 181],13,4,14166,4.368177613320999,20.0,0.0
3243,0,3243,[302 603 187 427 180],537,5,14171,4.368372379778052,20.0,0.0
3244,0,3244,[302 603 187 427 180],271,5,14176,4.368567026194145,20.0,0.0
3245,0,3245,[118 173  22 151   4],650,2,14178,4.367837338262477,0.0,0.0
3246,0,3246,[302 603 187 427 180],537,5,14183,4.368032029565753,20.0,0.0
3247,0,3247,[180  11  96 121 238],59,5,14188,4.3682266009852215,0.0,0.0
3248,0,3248,[302 603 187 427 180],664,5,14193,4.368421052631579,20.0,0.0
3249,0,3249,[302 603 187 427 180],271,5,14198,4.368615384615385,20.0,0.0
3250,0,3250,[302 603 187 427 180],458,5,14203,4.368809597047062,20.0,0.0
3251,0,3251,[302 603 187 427 180],13,5,14208,4.369003690036901,20.0,0.0
3252,0,3252,[302 603 187 427 180],90,5,14213,4.369197663695051,20.0,0.0
3253,0,3253,[302 603 187 427 180],537,5,14218,4.369391518131531,20.0,0.0
3254,0,3254,[276 385 180 655 127],474,5,14223,4.369585253456221,0.0,20.0
3255,0,3255,[175 328 182 143 257],334,2,14225,4.368857493857494,0.0,0.0
3256,0,3256,[302 603 187 427 180],474,5,14230,4.369051274178692,20.0,0.0
3257,0,3257,[302 603 187 427 180],13,5,14235,4.369244935543278,20.0,0.0
3258,0,3258,[302 603 187 427 180],339,5,14240,4.369438478060755,20.0,0.0
3259,0,3259,[ 22 144  96 173 174],840,2,14242,4.368711656441718,0.0,20.0
3260,0,3260,[302 196 215 127 197],90,4,14246,4.368598589389758,0.0,20.0
3261,0,3261,[435  88 181 276 144],378,5,14251,4.368792152053954,0.0,0.0
3262,0,3262,[ 79 427 185 135 175],379,5,14256,4.36898559607723,0.0,0.0
3263,0,3263,[174 234 181 195 269],64,5,14261,4.369178921568627,0.0,20.0
3264,0,3264,[302 603 187 427 180],537,5,14266,4.3693721286370595,20.0,0.0
3265,0,3265,[302 603 187 427 180],13,5,14271,4.369565217391305,20.0,0.0
3266,0,3266,[ 97  22 333 151 174],313,3,14274,4.369146005509642,0.0,20.0
3267,0,3267,[302 603 187 427 180],537,5,14279,4.369339045287638,20.0,0.0
3268,0,3268,[302 603 187 427 180],474,5,14284,4.369531966962374,20.0,0.0
3269,0,3269,[174 187 300 210 195],379,3,14287,4.369113149847095,0.0,20.0
3270,0,3270,[302 603 187 427 180],537,5,14292,4.369306022623051,20.0,0.0
3271,0,3271,[302 603 187 427 180],90,5,14297,4.369498777506112,20.0,0.0
3272,0,3272,[302 603 187 427 180],458,5,14302,4.369691414604339,20.0,0.0
3273,0,3273,[302 603 187 427 180],537,5,14307,4.369883934025657,20.0,0.0
3274,0,3274,[302 603 187 427 180],271,5,14312,4.3700763358778625,20.0,0.0
3275,0,3275,[302 603 187 427 180],666,5,14317,4.37026862026862,20.0,0.0
3276,0,3276,[302 603 187 427 180],537,5,14322,4.370460787305462,20.0,0.0
3277,0,3277,[302 603 187 427 180],666,5,14327,4.37065283709579,20.0,0.0
3278,0,3278,[302 603 187 427 180],474,5,14332,4.370844769746874,20.0,0.0
3279,0,3279,[302 603 187 427 180],90,5,14337,4.371036585365854,20.0,0.0
3280,0,3280,[427 294 181  56 275],821,5,14342,4.371228284059738,0.0,0.0
3281,0,3281,[302 603 187 427 180],271,5,14347,4.3714198659354055,20.0,0.0
3282,0,3282,[273 238 143 318 288],537,2,14349,4.370697532744441,20.0,0.0
3283,0,3283,[288 176 211  28 294],897,4,14353,4.370584652862363,0.0,0.0
3284,0,3284,[475 385 118 318  88],343,3,14356,4.370167427701674,20.0,0.0
3285,0,3285,[302 603 187 427 180],271,5,14361,4.370359099208764,20.0,0.0
3286,0,3286,[323 183 216  82 181],881,4,14365,4.3702464253118345,0.0,0.0
3287,0,3287,[302 603 187 427 180],664,5,14370,4.37043795620438,20.0,0.0
3288,0,3288,[302 603 187 427 180],664,5,14375,4.370629370629371,20.0,0.0
3289,0,3289,[  1 228 121 197 191],738,5,14380,4.37082066869301,0.0,0.0
3290,0,3290,[ 28 748 268 179 161],92,2,14382,4.370100273473109,0.0,0.0
3291,0,3291,[302 603 187 427 180],90,5,14387,4.370291616038882,20.0,0.0
3292,0,3292,[118 180  82 603 234],313,4,14391,4.370179167931977,20.0,0.0
3293,0,3293,[181 222   1 183 471],648,5,14396,4.37037037037037,0.0,0.0
3294,0,3294,[302 603 187 427 180],458,5,14401,4.370561456752656,20.0,0.0
3295,0,3295,[302 603 187 427 180],458,5,14406,4.370752427184466,20.0,0.0
3296,0,3296,[302 603 187 427 180],474,5,14411,4.370943281771307,20.0,0.0
3297,0,3297,[302 603 187 427 180],339,5,14416,4.371134020618556,20.0,0.0
3298,0,3298,[302 603 187 427 180],458,5,14421,4.371324643831464,20.0,0.0
3299,0,3299,[200 237 300 176 111],653,2,14423,4.370606060606061,0.0,0.0
3300,0,3300,[302 603 187 427 180],339,5,14428,4.370796728264162,20.0,0.0
3301,0,3301,[ 69 125 568 151 323],200,3,14431,4.37038158691702,0.0,0.0
3302,0,3302,[302 603 187 427 180],666,5,14436,4.370572207084469,20.0,0.0
3303,0,3303,[302 603 187 427 180],13,5,14441,4.370762711864407,20.0,0.0
3304,0,3304,[302 603 187 427 180],666,5,14446,4.3709531013615734,20.0,0.0
3305,0,3305,[302 603 187 427 180],537,5,14451,4.371143375680581,20.0,0.0
3306,0,3306,[174 185 423 597 546],804,2,14453,4.370426368309646,0.0,20.0
3307,0,3307,[ 97 195 265 182 294],666,2,14455,4.369709794437727,0.0,0.0
3308,0,3308,[302 603 187 427 180],537,5,14460,4.369900271985494,20.0,0.0
3309,0,3309,[234   9 181 161 471],378,4,14464,4.369788519637463,0.0,0.0
3310,0,3310,[186 143 202 135 237],749,4,14468,4.369676834793114,0.0,0.0
3311,0,3311,[302 603 187 427 180],664,5,14473,4.369867149758454,20.0,0.0
3312,0,3312,[302 603 187 427 180],664,5,14478,4.370057349833988,20.0,0.0
3313,0,3313,[302 603 187 427 180],537,5,14483,4.3702474351237175,20.0,0.0
3314,0,3314,[302 603 187 427 180],664,5,14488,4.370437405731523,20.0,0.0
3315,0,3315,[ 50 294 588  82 288],804,4,14492,4.370325693606755,0.0,20.0
3316,0,3316,[197 427  56 125 127],234,3,14495,4.369912571600844,0.0,20.0
3317,0,3317,[ 64 202 385 245  70],666,3,14498,4.369499698613622,0.0,0.0
3318,0,3318,[302 603 187 427 180],271,5,14503,4.369689665561916,20.0,0.0
3319,0,3319,[302 603 187 427 180],13,5,14508,4.369879518072289,20.0,0.0
3320,0,3320,[ 88 603 151 742  56],650,1,14509,4.368864799759109,20.0,0.0
3321,0,3321,[237  28 174 273 427],308,2,14511,4.368151715833835,0.0,20.0
3322,0,3322,[151  22  12  15 179],537,1,14512,4.3671381281974115,20.0,0.0
3323,0,3323,[302 603 187 427 180],458,5,14517,4.367328519855596,20.0,0.0
3324,0,3324,[302 603 187 427 180],339,5,14522,4.367518796992481,20.0,0.0
3325,0,3325,[322 211 294  82 202],311,4,14526,4.367408298256164,0.0,0.0
3326,0,3326,[168 187 748 195 508],524,2,14528,4.366696723775173,0.0,0.0
3327,0,3327,[204 215 194 588 179],13,4,14532,4.366586538461538,0.0,0.0
3328,0,3328,[302 603 187 427 180],664,5,14537,4.366776809852809,20.0,0.0
3329,0,3329,[302 603 187 427 180],271,5,14542,4.366966966966967,20.0,0.0
3330,0,3330,[302 603 187 427 180],90,5,14547,4.367157009906935,20.0,0.0
3331,0,3331,[ 71 172  97  98 200],13,4,14551,4.367046818727491,0.0,20.0
3332,0,3332,[302 603 187 427 180],474,5,14556,4.3672367236723675,20.0,0.0
3333,0,3333,[302 603 187 427 180],666,5,14561,4.367426514697061,20.0,0.0
3334,0,3334,[302 603 187 427 180],537,5,14566,4.367616191904048,20.0,0.0
3335,0,3335,[ 95 144 546  25  50],13,3,14569,4.367206235011991,0.0,20.0
3336,0,3336,[302 603 187 427 180],339,5,14574,4.367395864548996,20.0,0.0
3337,0,3337,[302 603 187 427 180],339,5,14579,4.367585380467346,20.0,0.0
3338,0,3338,[ 97 234 172 127 144],194,2,14581,4.366876310272537,0.0,20.0
3339,0,3339,[302 603 187 427 180],666,5,14586,4.367065868263473,20.0,0.0
3340,0,3340,[385 234 132  71 161],7,4,14590,4.366956001197246,0.0,0.0
3341,0,3341,[302 603 187 427 180],339,5,14595,4.367145421903052,20.0,0.0
3342,0,3342,[ 70 175 173 265   1],194,3,14598,4.366736464253664,0.0,0.0
3343,0,3343,[302 603 187 427 180],339,5,14603,4.366925837320574,20.0,0.0
3344,0,3344,[302 603 187 427 180],474,5,14608,4.367115097159941,20.0,0.0
3345,0,3345,[302 603 187 427 180],271,5,14613,4.367304243873281,20.0,0.0
3346,0,3346,[265 174 405   9 182],374,4,14617,4.367194502539587,0.0,20.0
3347,0,3347,[195   1  82 215  96],882,5,14622,4.367383512544803,0.0,0.0
3348,0,3348,[302 603 187 427 180],13,5,14627,4.36757240967453,20.0,0.0
3349,0,3349,[302 603 187 427 180],339,5,14632,4.367761194029851,20.0,0.0
3350,0,3350,[302 603 187 427 180],90,5,14637,4.3679498657117275,20.0,0.0
3351,0,3351,[111 471 194  79  15],454,1,14638,4.366945107398568,0.0,0.0
3352,0,3352,[302 603 187 427 180],13,5,14643,4.367133909931405,20.0,0.0
3353,0,3353,[127 191  50 423 179],840,5,14648,4.3673225998807395,0.0,40.0
3354,0,3354,[300 273 202 151 121],699,0,14648,4.36602086438152,0.0,0.0
3355,0,3355,[313 265  97 508 117],474,4,14652,4.365911799761621,0.0,0.0
3356,0,3356,[258 127   1 179  64],387,4,14656,4.3658028001191544,0.0,20.0
3357,0,3357,[302 603 187 427 180],666,5,14661,4.3659916617033945,20.0,0.0
3358,0,3358,[546 222  56 742 286],119,5,14666,4.3661804108365585,0.0,0.0
3359,0,3359,[302 603 187 427 180],458,5,14671,4.366369047619048,20.0,0.0
3360,0,3360,[302 603 187 427 180],474,5,14676,4.366557572151145,20.0,0.0
3361,0,3361,[302 603 187 427 180],271,5,14681,4.366745984533016,20.0,0.0
3362,0,3362,[302 603 187 427 180],13,5,14686,4.366934284864704,20.0,0.0
3363,0,3363,[186 322 234 237 235],92,3,14689,4.36652794292509,0.0,0.0
3364,0,3364,[302 603 187 427 180],271,5,14694,4.366716196136701,20.0,0.0
3365,0,3365,[302 603 187 427 180],664,5,14699,4.3669043374925725,20.0,0.0
3366,0,3366,[302 603 187 427 180],339,5,14704,4.367092367092367,20.0,0.0
3367,0,3367,[302 603 187 427 180],339,5,14709,4.36728028503563,20.0,0.0
3368,0,3368,[302 603 187 427 180],666,5,14714,4.367468091421787,20.0,0.0
3369,0,3369,[ 50 215 191 328 153],488,3,14717,4.3670623145400596,0.0,20.0
3370,0,3370,[302 603 187 427 180],339,5,14722,4.367250074161969,20.0,0.0
3371,0,3371,[235 655 603 294   8],308,3,14725,4.366844602609727,20.0,0.0
3372,0,3372,[302 603 187 427 180],271,5,14730,4.36703231544619,20.0,0.0
3373,0,3373,[258 294 172 222 597],145,5,14735,4.367219917012448,0.0,0.0
3374,0,3374,[302 603 187 427 180],666,5,14740,4.367407407407407,20.0,0.0
3375,0,3375,[302 603 187 427 180],537,5,14745,4.367594786729858,20.0,0.0
3376,0,3376,[302 603 187 427 180],664,5,14750,4.367782055078472,20.0,0.0
3377,0,3377,[302 603 187 427 180],90,5,14755,4.367969212551806,20.0,0.0
3378,0,3378,[302 603 187 427 180],666,5,14760,4.368156259248298,20.0,0.0
3379,0,3379,[302 603 187 427 180],271,5,14765,4.368343195266272,20.0,0.0
3380,0,3380,[302 603 187 427 180],474,5,14770,4.3685300207039335,20.0,0.0
3381,0,3381,[237  82 185 173 483],13,2,14772,4.36782968657599,20.0,0.0
3382,0,3382,[302 603 187 427 180],90,5,14777,4.368016553355011,20.0,0.0
3383,0,3383,[302 603 187 427 180],537,5,14782,4.368203309692672,20.0,0.0
3384,0,3384,[302 603 187 427 180],13,5,14787,4.368389955686854,20.0,0.0
3385,0,3385,[302 603 187 427 180],90,5,14792,4.368576491435322,20.0,0.0
3386,0,3386,[222 496 135 196 172],42,5,14797,4.368762917035725,0.0,0.0
3387,0,3387,[100 204 275 269 357],6,4,14801,4.368654073199528,20.0,20.0
3388,0,3388,[  4  50 275 265 161],524,4,14805,4.368545293596931,0.0,20.0
3389,0,3389,[196 174   4  79 161],7,4,14809,4.368436578171091,0.0,20.0
3390,0,3390,[302 603 187 427 180],458,5,14814,4.368622825125332,20.0,0.0
3391,0,3391,[302 603 187 427 180],90,5,14819,4.368808962264151,20.0,0.0
3392,0,3392,[302 603 187 427 180],474,5,14824,4.368994989684645,20.0,0.0
3393,0,3393,[187 333 508 288 228],13,2,14826,4.368296994696523,0.0,0.0
3394,0,3394,[302 603 187 427 180],458,5,14831,4.368483063328424,20.0,0.0
3395,0,3395,[302 603 187 427 180],664,5,14836,4.36866902237927,20.0,0.0
3396,0,3396,[302 603 187 427 180],339,5,14841,4.368854871945834,20.0,0.0
3397,0,3397,[302 603 187 427 180],666,5,14846,4.369040612124779,20.0,0.0
3398,0,3398,[302 603 187 427 180],458,5,14851,4.369226243012651,20.0,0.0
3399,0,3399,[483 185 174 127 215],897,4,14855,4.3691176470588236,20.0,40.0
3400,0,3400,[318 197 515  56 117],524,4,14859,4.369009114966186,20.0,0.0
3401,0,3401,[168 176 195 197 423],64,4,14863,4.368900646678425,0.0,0.0
3402,0,3402,[302 603 187 427 180],474,5,14868,4.369086100499559,20.0,0.0
3403,0,3403,[302 603 187 427 180],271,5,14873,4.369271445358402,20.0,0.0
3404,0,3404,[204 328  96  28 496],479,4,14877,4.3691629955947135,0.0,0.0
3405,0,3405,[302 603 187 427 180],271,5,14882,4.369348209042865,20.0,0.0
3406,0,3406,[ 71 748 183 132 151],200,3,14885,4.368946287056061,0.0,0.0
3407,0,3407,[302 603 187 427 180],664,5,14890,4.369131455399061,20.0,0.0
3408,0,3408,[302 603 187 427 180],90,5,14895,4.369316515107069,20.0,0.0
3409,0,3409,[302 603 187 427 180],664,5,14900,4.3695014662756595,20.0,0.0
3410,0,3410,[302 603 187 427 180],664,5,14905,4.3696863090002935,20.0,0.0
3411,0,3411,[302 603 187 427 180],474,5,14910,4.369871043376319,20.0,0.0
3412,0,3412,[127 515 385 211 435],666,4,14914,4.369762672135951,0.0,20.0
3413,0,3413,[302 603 187 427 180],339,5,14919,4.369947275922671,20.0,0.0
3414,0,3414,[  9 301 273 202 403],378,3,14922,4.3695461200585655,0.0,0.0
3415,0,3415,[183  22 143 237 546],95,3,14925,4.369145199063232,0.0,0.0
3416,0,3416,[302 603 187 427 180],339,5,14930,4.369329821480831,20.0,0.0
3417,0,3417,[302 603 187 427 180],90,5,14935,4.369514335868929,20.0,0.0
3418,0,3418,[202 357 588 273   4],7,3,14938,4.369113775957882,20.0,0.0
3419,0,3419,[211 302 385 181 173],666,3,14941,4.368713450292398,0.0,0.0
3420,0,3420,[302 603 187 427 180],271,5,14946,4.368897983045893,20.0,0.0
3421,0,3421,[302 603 187 427 180],271,5,14951,4.369082407948568,20.0,0.0
3422,0,3422,[302 603 187 427 180],458,5,14956,4.3692667250949455,20.0,0.0
3423,0,3423,[385 403 216 172 568],95,4,14960,4.369158878504673,0.0,0.0
3424,0,3424,[302 603 187 427 180],474,5,14965,4.369343065693431,20.0,0.0
3425,0,3425,[302 603 187 427 180],339,5,14970,4.36952714535902,20.0,0.0
3426,0,3426,[ 28 111 568  82 191],543,4,14974,4.369419317187044,0.0,0.0
3427,0,3427,[302 603 187 427 180],271,5,14979,4.369603267211202,20.0,0.0
3428,0,3428,[194 357 118 191 187],694,5,14984,4.36978710994459,20.0,0.0
3429,0,3429,[302 603 187 427 180],458,5,14989,4.36997084548105,20.0,0.0
3430,0,3430,[153  79 125 385 195],313,3,14992,4.36957155348295,0.0,0.0
3431,0,3431,[302 603 187 427 180],90,5,14997,4.369755244755245,20.0,0.0
3432,0,3432,[302 603 187 427 180],664,5,15002,4.369938829012526,20.0,0.0
3433,0,3433,[302 603 187 427 180],474,5,15007,4.370122306348282,20.0,0.0
3434,0,3434,[302 603 187 427 180],13,5,15012,4.370305676855895,20.0,0.0
3435,0,3435,[302 603 187 427 180],13,5,15017,4.370488940628638,20.0,0.0
3436,0,3436,[385 183 655 237 403],95,3,15020,4.370090194937445,0.0,0.0
3437,0,3437,[302 603 187 427 180],90,5,15025,4.370273414776032,20.0,0.0
3438,0,3438,[181  50 748 546 100],64,3,15028,4.369874963652224,0.0,40.0
3439,0,3439,[100 151 168 385  64],279,4,15032,4.369767441860465,0.0,20.0
3440,0,3440,[302 603 187 427 180],271,5,15037,4.3699505957570475,20.0,0.0
3441,0,3441,[302 603 187 427 180],458,5,15042,4.370133643230679,20.0,0.0
3442,0,3442,[302 603 187 427 180],666,5,15047,4.370316584374092,20.0,0.0
3443,0,3443,[172 175 197  56 195],406,5,15052,4.370499419279907,0.0,0.0
3444,0,3444,[302 603 187 427 180],458,5,15057,4.370682148040639,20.0,0.0
3445,0,3445,[302 603 187 427 180],339,5,15062,4.370864770748694,20.0,0.0
3446,0,3446,[117 187 111 186   1],643,4,15066,4.370757180156658,0.0,0.0
3447,0,3447,[176 269 200 174 237],288,5,15071,4.3709396751740135,0.0,20.0
3448,0,3448,[302 603 187 427 180],664,5,15076,4.371122064366483,20.0,0.0
3449,0,3449,[302 603 187 427 180],666,5,15081,4.371304347826087,20.0,0.0
3450,0,3450,[568  25 179 144 215],378,4,15085,4.371196754563894,0.0,0.0
3451,0,3451,[302 603 187 427 180],13,5,15090,4.371378910776362,20.0,0.0
3452,0,3452,[302 603 187 427 180],474,5,15095,4.371560961482769,20.0,0.0
3453,0,3453,[153 100 313 289  64],234,4,15099,4.371453387376954,0.0,20.0
3454,0,3454,[302 603 187 427 180],537,5,15104,4.371635311143271,20.0,0.0
3455,0,3455,[302 603 187 427 180],13,5,15109,4.37181712962963,20.0,0.0
3456,0,3456,[302 603 187 427 180],666,5,15114,4.371998842927393,20.0,0.0
3457,0,3457,[302 603 187 427 180],271,5,15119,4.37218045112782,20.0,0.0
3458,0,3458,[302 603 187 427 180],666,5,15124,4.372361954322058,20.0,0.0
3459,0,3459,[302 603 187 427 180],271,5,15129,4.372543352601156,20.0,0.0
3460,0,3460,[168  69 151 204 427],334,4,15133,4.372435712221901,0.0,0.0
3461,0,3461,[302 603 187 427 180],664,5,15138,4.37261698440208,20.0,0.0
3462,0,3462,[302 603 187 427 180],13,5,15143,4.372798151891423,20.0,0.0
3463,0,3463,[174  95 153   7 173],650,4,15147,4.372690531177829,0.0,20.0
3464,0,3464,[210 515 273 301 222],13,0,15147,4.371428571428571,0.0,0.0
3465,0,3465,[173 318 135 742  96],387,3,15150,4.371032890940565,20.0,0.0
3466,0,3466,[302 603 187 427 180],458,5,15155,4.3712143063167,20.0,0.0
3467,0,3467,[302 603 187 427 180],474,5,15160,4.371395617070357,20.0,0.0
3468,0,3468,[289 313  95 234 238],85,3,15163,4.3710002882675125,0.0,0.0
3469,0,3469,[237 135  95 182 204],6,2,15165,4.370317002881844,0.0,0.0
3470,0,3470,[111 196 186 237 185],334,3,15168,4.3699222126188415,0.0,0.0
3471,0,3471,[302 603 187 427 180],458,5,15173,4.370103686635945,20.0,0.0
3472,0,3472,[276 185  12  64 200],271,3,15176,4.369709185142528,20.0,0.0
3473,0,3473,[210 200 181  56 228],326,2,15178,4.369027058146229,0.0,0.0
3474,0,3474,[302 603 187 427 180],13,5,15183,4.369208633093526,20.0,0.0
3475,0,3475,[ 56  22 121 275   1],158,5,15188,4.369390103567318,0.0,0.0
3476,0,3476,[302 603 187 427 180],339,5,15193,4.369571469657751,20.0,0.0
3477,0,3477,[302 603 187 427 180],13,5,15198,4.369752731454859,20.0,0.0
3478,0,3478,[302 603 187 427 180],664,5,15203,4.3699338890485775,20.0,0.0
3479,0,3479,[588 195 144 173 151],406,2,15205,4.369252873563219,0.0,0.0
3480,0,3480,[302 603 187 427 180],90,5,15210,4.369434070669348,20.0,0.0
3481,0,3481,[588 286 195 268 191],234,1,15211,4.368466398621482,0.0,0.0
3482,0,3482,[ 25 405 237   1 196],374,4,15215,4.368360608670686,0.0,0.0
3483,0,3483,[302 603 187 427 180],474,5,15220,4.368541905855339,20.0,0.0
3484,0,3484,[302 603 187 427 180],537,5,15225,4.368723098995696,20.0,0.0
3485,0,3485,[302 603 187 427 180],666,5,15230,4.368904188181297,20.0,0.0
3486,0,3486,[302 603 187 427 180],90,5,15235,4.369085173501578,20.0,0.0
3487,0,3487,[117 127  97 100 300],455,4,15239,4.368979357798165,0.0,40.0
3488,0,3488,[168 238  71 185 144],308,4,15243,4.3688736027515045,0.0,0.0
3489,0,3489,[302 603 187 427 180],90,5,15248,4.369054441260745,20.0,0.0
3490,0,3490,[168 161 318 588  22],479,3,15251,4.368662274419937,20.0,0.0
3491,0,3491,[302 603 187 427 180],474,5,15256,4.368843069873997,20.0,0.0
3492,0,3492,[302 603 187 427 180],13,5,15261,4.369023761809333,20.0,0.0
3493,0,3493,[282 180  70 175  25],85,3,15264,4.368631940469376,0.0,0.0
3494,0,3494,[ 98 276 151 288 357],200,4,15268,4.368526466380543,20.0,20.0
3495,0,3495,[302 603 187 427 180],339,5,15273,4.36870709382151,20.0,0.0
3496,0,3496,[302 603 187 427 180],13,5,15278,4.36888761795825,20.0,0.0
3497,0,3497,[302 603 187 427 180],13,5,15283,4.36906803887936,20.0,0.0
3498,0,3498,[302 603 187 427 180],664,5,15288,4.369248356673335,20.0,0.0
3499,0,3499,[302 603 187 427 180],666,5,15293,4.369428571428571,20.0,0.0
3500,0,3500,[302 603 187 427 180],13,5,15298,4.369608683233362,20.0,0.0
3501,0,3501,[302 603 187 427 180],666,5,15303,4.3697886921758995,20.0,0.0
3502,0,3502,[302 603 187 427 180],537,5,15308,4.369968598344276,20.0,0.0
3503,0,3503,[302 603 187 427 180],13,5,15313,4.3701484018264845,20.0,0.0
3504,0,3504,[258  88  89 435  96],313,3,15316,4.369757489300999,0.0,0.0
3505,0,3505,[302 603 187 427 180],537,5,15321,4.369937250427838,20.0,0.0
3506,0,3506,[302 603 187 427 180],664,5,15326,4.370116909039065,20.0,0.0
3507,0,3507,[204 275 144 173   1],279,2,15328,4.369441277080957,0.0,0.0
3508,0,3508,[302 603 187 427 180],90,5,15333,4.369620974636649,20.0,0.0
3509,0,3509,[302 603 187 427 180],474,5,15338,4.36980056980057,20.0,0.0
3510,0,3510,[210  50 435 385  82],536,4,15342,4.369695243520365,0.0,20.0
3511,0,3511,[ 11  69 183 294   7],666,3,15345,4.369305239179955,0.0,0.0
3512,0,3512,[302 603 187 427 180],458,5,15350,4.369484770851124,20.0,0.0
3513,0,3513,[302 603 187 427 180],664,5,15355,4.369664200341491,20.0,0.0
3514,0,3514,[302 603 187 427 180],666,5,15360,4.369843527738265,20.0,0.0
3515,0,3515,[302 603 187 427 180],664,5,15365,4.370022753128556,20.0,0.0
3516,0,3516,[302 603 187 427 180],537,5,15370,4.370201876599374,20.0,0.0
3517,0,3517,[302 603 187 427 180],537,5,15375,4.370380898237635,20.0,0.0
3518,0,3518,[302 603 187 427 180],458,5,15380,4.37055981813015,20.0,0.0
3519,0,3519,[276 222 187 483  50],537,4,15384,4.370454545454545,20.0,20.0
3520,0,3520,[302 603 187 427 180],13,5,15389,4.370633342800341,20.0,0.0
3521,0,3521,[211 111 357 403 202],749,4,15393,4.370528109028961,20.0,0.0
3522,0,3522,[302 603 187 427 180],339,5,15398,4.370706783990917,20.0,0.0
3523,0,3523,[132 483  97  12 117],406,5,15403,4.37088535754824,40.0,0.0
3524,0,3524,[302 603 187 427 180],339,5,15408,4.371063829787234,20.0,0.0
3525,0,3525,[ 15  88 471 153 151],313,1,15409,4.37010777084515,0.0,0.0
3526,0,3526,[302 603 187 427 180],90,5,15414,4.3702863623476045,20.0,0.0
3527,0,3527,[302 603 187 427 180],13,5,15419,4.37046485260771,20.0,0.0
3528,0,3528,[302 603 187 427 180],664,5,15424,4.370643241711533,20.0,0.0
3529,0,3529,[515  98  97 173 174],406,3,15427,4.370254957507083,0.0,40.0
3530,0,3530,[302 603 187 427 180],666,5,15432,4.370433305012744,20.0,0.0
3531,0,3531,[ 88 546 265 135 423],92,2,15434,4.369762174405436,0.0,0.0
3532,0,3532,[235 194 121 289 132],328,3,15437,4.369374469289555,0.0,0.0
3533,0,3533,[211 496 174 588 357],194,5,15442,4.369552914544426,20.0,20.0
3534,0,3534,[302 603 187 427 180],458,5,15447,4.3697312588401696,20.0,0.0
3535,0,3535,[302 603 187 427 180],271,5,15452,4.369909502262443,20.0,0.0
3536,0,3536,[302 603 187 427 180],458,5,15457,4.370087644896805,20.0,0.0
3537,0,3537,[ 12 132 313 475  82],119,3,15460,4.369700395703788,20.0,0.0
3538,0,3538,[269 678  97 257   7],455,4,15464,4.36959593105397,0.0,0.0
3539,0,3539,[302 603 187 427 180],458,5,15469,4.369774011299435,20.0,0.0
3540,0,3540,[302 603 187 427 180],339,5,15474,4.3699519909630045,20.0,0.0
3541,0,3541,[302 603 187 427 180],271,5,15479,4.37012987012987,20.0,0.0
3542,0,3542,[ 11   1  50 121 257],145,3,15482,4.369743155517923,0.0,20.0
3543,0,3543,[302 603 187 427 180],90,5,15487,4.369920993227991,20.0,0.0
3544,0,3544,[257 168  71 435 403],290,2,15489,4.369252468265162,0.0,0.0
3545,0,3545,[ 97 143   1 475 111],64,4,15493,4.369148336153413,0.0,0.0
3546,0,3546,[742 515 276   9 245],458,4,15497,4.36904426275726,0.0,0.0
3547,0,3547,[ 97 204 173 215 174],85,3,15500,4.368658399098083,0.0,20.0
3548,0,3548,[ 12 258 235 323 187],537,2,15502,4.3679909833755985,20.0,0.0
3549,0,3549,[302 603 187 427 180],13,5,15507,4.368169014084507,20.0,0.0
3550,0,3550,[302 603 187 427 180],537,5,15512,4.36834694452267,20.0,0.0
3551,0,3551,[302 603 187 427 180],537,5,15517,4.368524774774775,20.0,0.0
3552,0,3552,[302 603 187 427 180],90,5,15522,4.368702504925415,20.0,0.0
3553,0,3553,[228 194 180 135 151],7,5,15527,4.368880135059088,0.0,0.0
3554,0,3554,[302 603 187 427 180],537,5,15532,4.369057665260197,20.0,0.0
3555,0,3555,[302 603 187 427 180],339,5,15537,4.369235095613049,20.0,0.0
3556,0,3556,[191  56 483 568 210],125,4,15541,4.36913129041327,20.0,0.0
3557,0,3557,[302 603 187 427 180],458,5,15546,4.369308600337268,20.0,0.0
3558,0,3558,[ 50 403 176 185 748],749,4,15550,4.369204832818207,0.0,20.0
3559,0,3559,[204 546 181 185 403],374,3,15553,4.3688202247191015,0.0,0.0
3560,0,3560,[302 603 187 427 180],664,5,15558,4.368997472620051,20.0,0.0
3561,0,3561,[302 603 187 427 180],271,5,15563,4.369174620999439,20.0,0.0
3562,0,3562,[302 603 187 427 180],537,5,15568,4.369351669941061,20.0,0.0
3563,0,3563,[302 603 187 427 180],474,5,15573,4.369528619528619,20.0,0.0
3564,0,3564,[100  15 655 405 508],92,3,15576,4.369144460028051,0.0,20.0
3565,0,3565,[ 15 183 282 117  12],548,4,15580,4.369040942232193,20.0,0.0
3566,0,3566,[302 603 187 427 180],474,5,15585,4.369217830109336,20.0,0.0
3567,0,3567,[  8  50 143 182 385],892,3,15588,4.368834080717488,0.0,20.0
3568,0,3568,[ 22 185 182 187 173],64,5,15593,4.369010927430653,0.0,0.0
3569,0,3569,[182  82 185 111 357],13,2,15595,4.368347338935574,20.0,0.0
3570,0,3570,[ 71  97  96 216   7],13,3,15598,4.367964155698684,0.0,0.0
3571,0,3571,[302 603 187 427 180],339,5,15603,4.368141097424412,20.0,0.0
3572,0,3572,[202 271 475 238 175],479,3,15606,4.367758186397985,0.0,0.0
3573,0,3573,[302 603 187 427 180],537,5,15611,4.367935086737549,20.0,0.0
3574,0,3574,[187 588 655  56 127],311,5,15616,4.368111888111888,0.0,20.0
3575,0,3575,[302 603 187 427 180],271,5,15621,4.368288590604027,20.0,0.0
3576,0,3576,[302 603 187 427 180],90,5,15626,4.368465194296897,20.0,0.0
3577,0,3577,[ 11 357  89 197 483],7,4,15630,4.36836221352711,40.0,0.0
3578,0,3578,[302 603 187 427 180],664,5,15635,4.368538697960324,20.0,0.0
3579,0,3579,[302 603 187 427 180],458,5,15640,4.368715083798882,20.0,0.0
3580,0,3580,[302 603 187 427 180],666,5,15645,4.368891371125384,20.0,0.0
3581,0,3581,[ 89  25 143 174  22],194,2,15647,4.3682300390843105,0.0,20.0
3582,0,3582,[302 603 187 427 180],666,5,15652,4.368406363382641,20.0,0.0
3583,0,3583,[234 237 202 245 288],804,4,15656,4.368303571428571,0.0,0.0
3584,0,3584,[210 204  69  28 568],13,3,15659,4.36792189679219,0.0,0.0
3585,0,3585,[135 191  56 403 655],398,4,15663,4.36781929726715,0.0,0.0
3586,0,3586,[302 603 187 427 180],664,5,15668,4.367995539448007,20.0,0.0
3587,0,3587,[496 268 174 127 234],234,3,15671,4.367614269788183,0.0,40.0
3588,0,3588,[302 603 187 427 180],458,5,15676,4.3677904708832545,20.0,0.0
3589,0,3589,[302 603 187 427 180],90,5,15681,4.367966573816156,20.0,0.0
3590,0,3590,[302 603 187 427 180],474,5,15686,4.368142578668895,20.0,0.0
3591,0,3591,[302 603 187 427 180],458,5,15691,4.368318485523385,20.0,0.0
3592,0,3592,[302 603 187 427 180],666,5,15696,4.368494294461453,20.0,0.0
3593,0,3593,[238 179 183 323 435],537,2,15698,4.367835281023929,0.0,0.0
3594,0,3594,[ 89 328 238 215  70],537,3,15701,4.367454798331015,0.0,0.0
3595,0,3595,[302 603 187 427 180],13,5,15706,4.367630700778643,20.0,0.0
3596,0,3596,[132 179 175 191 186],339,5,15711,4.367806505421185,0.0,0.0
3597,0,3597,[302 603 187 427 180],13,5,15716,4.367982212340189,20.0,0.0
3598,0,3598,[100 603 268 328 151],334,4,15720,4.367879966657405,20.0,20.0
3599,0,3599,[204 333 127 302  97],458,3,15723,4.3675,0.0,20.0
3600,0,3600,[302 603 187 427 180],271,5,15728,4.367675645653985,20.0,0.0
3601,0,3601,[302 603 187 427 180],90,5,15733,4.367851193781233,20.0,0.0
3602,0,3602,[302 603 187 427 180],458,5,15738,4.368026644462947,20.0,0.0
3603,0,3603,[302 603 187 427 180],339,5,15743,4.368201997780244,20.0,0.0
3604,0,3604,[302 603 187 427 180],474,5,15748,4.368377253814147,20.0,0.0
3605,0,3605,[405 323 202 204 121],374,3,15751,4.367997781475319,0.0,0.0
3606,0,3606,[302 603 187 427 180],13,5,15756,4.368172996950374,20.0,0.0
3607,0,3607,[151   1  96 135 655],749,5,15761,4.368348115299335,0.0,0.0
3608,0,3608,[302 603 187 427 180],664,5,15766,4.368523136602937,20.0,0.0
3609,0,3609,[302 603 187 427 180],13,5,15771,4.368698060941829,20.0,0.0
3610,0,3610,[302 603 187 427 180],474,5,15776,4.368872888396566,20.0,0.0
3611,0,3611,[181  50 496 215 183],479,3,15779,4.368493909191583,0.0,20.0
3612,0,3612,[ 56  50 222 117 655],339,4,15783,4.368391918073623,0.0,20.0
3613,0,3613,[302 603 187 427 180],458,5,15788,4.368566685113448,20.0,0.0
3614,0,3614,[302 603 187 427 180],664,5,15793,4.368741355463347,20.0,0.0
3615,0,3615,[302 603 187 427 180],90,5,15798,4.36891592920354,20.0,0.0
3616,0,3616,[302 603 187 427 180],664,5,15803,4.369090406414156,20.0,0.0
3617,0,3617,[302 603 187 427 180],90,5,15808,4.369264787175235,20.0,0.0
3618,0,3618,[302 603 187 427 180],664,5,15813,4.369439071566731,20.0,0.0
3619,0,3619,[302 603 187 427 180],537,5,15818,4.369613259668508,20.0,0.0
3620,0,3620,[302 603 187 427 180],13,5,15823,4.369787351560342,20.0,0.0
3621,0,3621,[302 603 187 427 180],537,5,15828,4.369961347321921,20.0,0.0
3622,0,3622,[ 97 180 111 300  25],533,3,15831,4.369583218327353,0.0,0.0
3623,0,3623,[234 216 161 282 323],374,4,15835,4.36948123620309,0.0,0.0
3624,0,3624,[302 603 187 427 180],271,5,15840,4.369655172413793,20.0,0.0
3625,0,3625,[496 183 427 271  98],650,4,15844,4.369553226696084,0.0,20.0
3626,0,3626,[302 603 187 427 180],339,5,15849,4.369727047146402,20.0,0.0
3627,0,3627,[216 173 276   8 181],892,5,15854,4.369900771775082,0.0,0.0
3628,0,3628,[216 202 187 175 173],666,4,15858,4.369798842656379,0.0,0.0
3629,0,3629,[302 603 187 427 180],664,5,15863,4.369972451790634,20.0,0.0
3630,0,3630,[302 603 187 427 180],474,5,15868,4.370145965298816,20.0,0.0
3631,0,3631,[302 603 187 427 180],474,5,15873,4.370319383259912,20.0,0.0
3632,0,3632,[302 603 187 427 180],271,5,15878,4.370492705752821,20.0,0.0
3633,0,3633,[302 603 187 427 180],271,5,15883,4.370665932856356,20.0,0.0
3634,0,3634,[496 173   1 132 245],488,2,15885,4.370013755158184,0.0,0.0
3635,0,3635,[302 603 187 427 180],474,5,15890,4.37018701870187,20.0,0.0
3636,0,3636,[302 603 187 427 180],666,5,15895,4.370360186967281,20.0,0.0
3637,0,3637,[302 603 187 427 180],90,5,15900,4.370533260032985,20.0,0.0
3638,0,3638,[ 64  95 174 183  98],263,5,15905,4.370706237977466,0.0,40.0
3639,0,3639,[302 603 187 427 180],474,5,15910,4.3708791208791204,20.0,0.0
3640,0,3640,[ 70 195 288 168 322],13,1,15911,4.369953309530349,0.0,0.0
3641,0,3641,[302 603 187 427 180],13,5,15916,4.370126304228446,20.0,0.0
3642,0,3642,[546  70  64  97 300],328,3,15919,4.369750205874279,0.0,0.0
3643,0,3643,[183 202 282 200 294],881,3,15922,4.369374313940725,0.0,0.0
3644,0,3644,[ 88 173  64 174 385],42,5,15927,4.3695473251028805,0.0,20.0
3645,0,3645,[182 175  28 151  25],666,2,15929,4.368897421832145,0.0,0.0
3646,0,3646,[302 603 187 427 180],271,5,15934,4.3690704688785305,20.0,0.0
3647,0,3647,[302 603 187 427 180],271,5,15939,4.369243421052632,20.0,0.0
3648,0,3648,[302 603 187 427 180],13,5,15944,4.369416278432447,20.0,0.0
3649,0,3649,[302 603 187 427 180],664,5,15949,4.369589041095891,20.0,0.0
3650,0,3650,[302 603 187 427 180],537,5,15954,4.369761709120789,20.0,0.0
3651,0,3651,[302 603 187 427 180],458,5,15959,4.369934282584885,20.0,0.0
3652,0,3652,[302 603 187 427 180],666,5,15964,4.370106761565836,20.0,0.0
3653,0,3653,[302 603 187 427 180],458,5,15969,4.370279146141215,20.0,0.0
3654,0,3654,[302 603 187 427 180],664,5,15974,4.3704514363885085,20.0,0.0
3655,0,3655,[302 603 187 427 180],90,5,15979,4.37062363238512,20.0,0.0
3656,0,3656,[423 121  88 173 322],454,3,15982,4.370248837845228,0.0,0.0
3657,0,3657,[302 603 187 427 180],339,5,15987,4.370420995079279,20.0,0.0
3658,0,3658,[302 603 187 427 180],271,5,15992,4.370593058212626,20.0,0.0
3659,0,3659,[302 603 187 427 180],339,5,15997,4.370765027322404,20.0,0.0
3660,0,3660,[ 89  50 546 235  28],328,3,16000,4.370390603660202,0.0,20.0
3661,0,3661,[302 603 187 427 180],271,5,16005,4.370562534134353,20.0,0.0
3662,0,3662,[302 603 187 427 180],13,5,16010,4.370734370734371,20.0,0.0
3663,0,3663,[302 603 187 427 180],339,5,16015,4.370906113537118,20.0,0.0
3664,0,3664,[143   7 173 168 186],666,3,16018,4.370532060027285,0.0,0.0
3665,0,3665,[302 603 187 427 180],271,5,16023,4.370703764320786,20.0,0.0
3666,0,3666,[302 603 187 427 180],458,5,16028,4.370875374965912,20.0,0.0
3667,0,3667,[302 603 187 427 180],13,5,16033,4.371046892039258,20.0,0.0
3668,0,3668,[302 603 187 427 180],537,5,16038,4.371218315617335,20.0,0.0
3669,0,3669,[144 173 210 313 196],378,5,16043,4.371389645776567,0.0,0.0
3670,0,3670,[302 603 187 427 180],666,5,16048,4.371560882593299,20.0,0.0
3671,0,3671,[135 301 508   7 175],13,2,16050,4.370915032679738,0.0,0.0
3672,0,3672,[211 135  12  70 475],533,3,16053,4.37054179145113,20.0,0.0
3673,0,3673,[302 603 187 427 180],339,5,16058,4.370713119216113,20.0,0.0
3674,0,3674,[302 603 187 427 180],537,5,16063,4.370884353741497,20.0,0.0
3675,0,3675,[144  22 228 179 385],234,1,16064,4.3699673558215455,0.0,0.0
3676,0,3676,[302 603 187 427 180],474,5,16069,4.370138700027196,20.0,0.0
3677,0,3677,[302 603 187 427 180],13,5,16074,4.370309951060359,20.0,0.0
3678,0,3678,[302 603 187 427 180],474,5,16079,4.37048110899701,20.0,0.0
3679,0,3679,[302 603 187 427 180],271,5,16084,4.370652173913044,20.0,0.0
3680,0,3680,[302 603 187 427 180],90,5,16089,4.370823145884271,20.0,0.0
3681,0,3681,[302 603 187 427 180],537,5,16094,4.3709940249864205,20.0,0.0
3682,0,3682,[234 215   9 121 357],59,5,16099,4.37116481129514,20.0,0.0
3683,0,3683,[302 603 187 427 180],90,5,16104,4.371335504885994,20.0,0.0
3684,0,3684,[302 603 187 427 180],664,5,16109,4.371506105834464,20.0,0.0
3685,0,3685,[302 603 187 427 180],666,5,16114,4.371676614215953,20.0,0.0
3686,0,3686,[196  56 427 127 222],194,3,16117,4.371304583672362,0.0,20.0
3687,0,3687,[302 603 187 427 180],458,5,16122,4.3714750542299345,20.0,0.0
3688,0,3688,[302 603 187 427 180],664,5,16127,4.371645432366495,20.0,0.0
3689,0,3689,[302 603 187 427 180],474,5,16132,4.3718157181571815,20.0,0.0
3690,0,3690,[302 603 187 427 180],90,5,16137,4.3719859116770525,20.0,0.0
3691,0,3691,[475 100  96 211 180],90,4,16141,4.371885157096425,0.0,20.0
3692,0,3692,[302 603 187 427 180],271,5,16146,4.372055239642567,20.0,0.0
3693,0,3693,[  4 427 269 173 200],940,3,16149,4.371683811586356,0.0,0.0
3694,0,3694,[300 191   9 183 194],234,3,16152,4.371312584573748,0.0,0.0
3695,0,3695,[302 603 187 427 180],666,5,16157,4.371482683982684,20.0,0.0
3696,0,3696,[302 603 187 427 180],474,5,16162,4.3716526913713825,20.0,0.0
3697,0,3697,[302 603 187 427 180],90,5,16167,4.3718226068144945,20.0,0.0
3698,0,3698,[302 603 187 427 180],458,5,16172,4.371992430386591,20.0,0.0
3699,0,3699,[302 603 187 427 180],271,5,16177,4.372162162162162,20.0,0.0
3700,0,3700,[234 235 546 385 215],378,4,16181,4.37206160497163,0.0,0.0
3701,0,3701,[ 89  82 237  56 200],455,3,16184,4.371690977849811,0.0,0.0
3702,0,3702,[161 172  12 121 234],455,4,16188,4.371590602214421,20.0,0.0
3703,0,3703,[302 603 187 427 180],666,5,16193,4.371760259179266,20.0,0.0
3704,0,3704,[302 603 187 427 180],271,5,16198,4.371929824561404,20.0,0.0
3705,0,3705,[ 97  64 568 135 197],543,3,16201,4.371559633027523,0.0,0.0
3706,0,3706,[302 603 187 427 180],537,5,16206,4.371729161046669,20.0,0.0
3707,0,3707,[302 603 187 427 180],537,5,16211,4.371898597626753,20.0,0.0
3708,0,3708,[302 603 187 427 180],458,5,16216,4.372067942841737,20.0,0.0
3709,0,3709,[182 127  71 508 210],533,4,16220,4.3719676549865225,0.0,20.0
3710,0,3710,[427  69 423  88 135],398,4,16224,4.371867421180275,0.0,0.0
3711,0,3711,[302 603 187 427 180],13,5,16229,4.372036637931035,20.0,0.0
3712,0,3712,[302 603 187 427 180],664,5,16234,4.372205763533531,20.0,0.0
3713,0,3713,[302 603 187 427 180],666,5,16239,4.372374798061389,20.0,0.0
3714,0,3714,[302 603 187 427 180],13,5,16244,4.3725437415881565,20.0,0.0
3715,0,3715,[302 603 187 427 180],458,5,16249,4.372712594187298,20.0,0.0
3716,0,3716,[197 228 179  97 603],64,2,16251,4.372074253430186,20.0,0.0
3717,0,3717,[302 603 187 427 180],666,5,16256,4.372243141473911,20.0,0.0
3718,0,3718,[161  79   4 211 132],308,3,16259,4.371874159720355,0.0,0.0
3719,0,3719,[405 403 234  89 228],901,3,16262,4.371505376344086,0.0,0.0
3720,0,3720,[302 603 187 427 180],339,5,16267,4.3716742811072296,20.0,0.0
3721,0,3721,[302 603 187 427 180],474,5,16272,4.3718430951101555,20.0,0.0
3722,0,3722,[161 194 228 186 179],648,4,16276,4.371743217835079,0.0,0.0
3723,0,3723,[ 15 318 235  64  97],374,2,16278,4.371106337271751,20.0,0.0
3724,0,3724,[118  22 191  56 403],543,3,16281,4.370738255033557,0.0,0.0
3725,0,3725,[302 603 187 427 180],664,5,16286,4.370907139023081,20.0,0.0
3726,0,3726,[302 603 187 427 180],664,5,16291,4.371075932385296,20.0,0.0
3727,0,3727,[302 603 187 427 180],271,5,16296,4.371244635193133,20.0,0.0
3728,0,3728,[222  98 294 117 172],328,3,16299,4.37087691069992,0.0,20.0
3729,0,3729,[302 603 187 427 180],13,5,16304,4.371045576407507,20.0,0.0
3730,0,3730,[302 603 187 427 180],474,5,16309,4.371214151701957,20.0,0.0
3731,0,3731,[302 603 187 427 180],458,5,16314,4.371382636655949,20.0,0.0
3732,0,3732,[302 603 187 427 180],339,5,16319,4.371551031342084,20.0,0.0
3733,0,3733,[302 603 187 427 180],664,5,16324,4.371719335832887,20.0,0.0
3734,0,3734,[182 385 515 405 187],537,3,16327,4.371352074966532,0.0,0.0
3735,0,3735,[302 603 187 427 180],537,5,16332,4.37152034261242,20.0,0.0
3736,0,3736,[302 603 187 427 180],664,5,16337,4.371688520203372,20.0,0.0
3737,0,3737,[302 603 187 427 180],339,5,16342,4.371856607811664,20.0,0.0
3738,0,3738,[125  25  96 161 276],200,5,16347,4.372024605509495,0.0,0.0
3739,0,3739,[302 603 187 427 180],537,5,16352,4.372192513368984,20.0,0.0
3740,0,3740,[302 603 187 427 180],339,5,16357,4.3723603314621755,20.0,0.0
3741,0,3741,[302 603 187 427 180],458,5,16362,4.372528059861037,20.0,0.0
3742,0,3742,[302 603 187 427 180],339,5,16367,4.3726956986374566,20.0,0.0
3743,0,3743,[302 603 187 427 180],90,5,16372,4.372863247863248,20.0,0.0
3744,0,3744,[125 483  64 216 597],7,4,16376,4.372763684913218,20.0,0.0
3745,0,3745,[ 64 174 181   4   8],881,4,16380,4.3726641751201285,0.0,20.0
3746,0,3746,[302 603 187 427 180],271,5,16385,4.3728315986122235,20.0,0.0
3747,0,3747,[588 423  50 183 143],295,4,16389,4.372732123799359,0.0,20.0
3748,0,3748,[302 603 187 427 180],339,5,16394,4.3728994398506265,20.0,0.0
3749,0,3749,[173 200   9 180 222],92,3,16397,4.372533333333333,0.0,0.0
3750,0,3750,[302 603 187 427 180],90,5,16402,4.372700613169822,20.0,0.0
3751,0,3751,[302 603 187 427 180],666,5,16407,4.372867803837953,20.0,0.0
3752,0,3752,[228   1  88  25 196],892,4,16411,4.372768451905142,0.0,0.0
3753,0,3753,[435 216 405 100 403],59,4,16415,4.37266915290357,0.0,20.0
3754,0,3754,[302 603 187 427 180],474,5,16420,4.372836218375499,20.0,0.0
3755,0,3755,[423  64 179 385 196],343,4,16424,4.372736954206602,0.0,0.0
3756,0,3756,[302 603 187 427 180],537,5,16429,4.3729039126963,20.0,0.0
3757,0,3757,[302 603 187 427 180],90,5,16434,4.373070782331027,20.0,0.0
3758,0,3758,[302 603 187 427 180],537,5,16439,4.373237563181697,20.0,0.0
3759,0,3759,[302 603 187 427 180],666,5,16444,4.373404255319149,20.0,0.0
3760,0,3760,[204  98 168  88  97],406,3,16447,4.3730390853496415,0.0,20.0
3761,0,3761,[275 121 423  97 318],233,5,16452,4.373205741626794,20.0,0.0
3762,0,3762,[174 222 211 179 151],380,2,16454,4.3725750730799895,0.0,20.0
3763,0,3763,[302 603 187 427 180],13,5,16459,4.372741764080765,20.0,0.0
3764,0,3764,[508 471 276 245 301],455,3,16462,4.372377158034529,0.0,0.0
3765,0,3765,[302 603 187 427 180],537,5,16467,4.372543813064259,20.0,0.0
3766,0,3766,[197 286 121 515 180],271,4,16471,4.372444916379082,0.0,0.0
3767,0,3767,[302 603 187 427 180],666,5,16476,4.372611464968153,20.0,0.0
3768,0,3768,[302 603 187 427 180],271,5,16481,4.372777925179093,20.0,0.0
3769,0,3769,[ 50 172 180  64 191],488,2,16483,4.372148541114059,0.0,20.0
3770,0,3770,[302 603 187 427 180],537,5,16488,4.372315035799523,20.0,0.0
3771,0,3771,[302 603 187 427 180],458,5,16493,4.372481442205727,20.0,0.0
3772,0,3772,[143 118 423 144  88],295,4,16497,4.372382719321495,0.0,0.0
3773,0,3773,[202 125  69 742 195],749,5,16502,4.372549019607843,0.0,0.0
3774,0,3774,[302 603 187 427 180],271,5,16507,4.37271523178808,20.0,0.0
3775,0,3775,[302 603 187 427 180],458,5,16512,4.372881355932203,20.0,0.0
3776,0,3776,[302 603 187 427 180],474,5,16517,4.3730473921101405,20.0,0.0
3777,0,3777,[302 603 187 427 180],271,5,16522,4.373213340391741,20.0,0.0
3778,0,3778,[403 234 175 181  88],339,4,16526,4.373114580576872,0.0,0.0
3779,0,3779,[302 603 187 427 180],271,5,16531,4.373280423280423,20.0,0.0
3780,0,3780,[302 603 187 427 180],666,5,16536,4.373446178259719,20.0,0.0
3781,0,3781,[302 603 187 427 180],339,5,16541,4.373611845584347,20.0,0.0
3782,0,3782,[144 173  89 435 427],454,2,16543,4.3729844039122385,0.0,0.0
3783,0,3783,[302 603 187 427 180],271,5,16548,4.373150105708246,20.0,0.0
3784,0,3784,[302 603 187 427 180],664,5,16553,4.3733157199471595,20.0,0.0
3785,0,3785,[302 603 187 427 180],90,5,16558,4.373481246698362,20.0,0.0
3786,0,3786,[175 405   8 282 385],95,4,16562,4.373382624768946,0.0,0.0
3787,0,3787,[302 603 187 427 180],458,5,16567,4.373548046462513,20.0,0.0
3788,0,3788,[302 603 187 427 180],458,5,16572,4.373713380839272,20.0,0.0
3789,0,3789,[235 144 403 313 286],144,3,16575,4.37335092348285,0.0,0.0
3790,0,3790,[302 603 187 427 180],666,5,16580,4.373516222632551,20.0,0.0
3791,0,3791,[385 168 655 175 202],881,3,16583,4.373154008438819,0.0,0.0
3792,0,3792,[302 603 187 427 180],664,5,16588,4.3733192723437915,20.0,0.0
3793,0,3793,[222 403 135 195  98],533,3,16591,4.372957301001581,0.0,20.0
3794,0,3794,[302 603 187 427 180],537,5,16596,4.373122529644268,20.0,0.0
3795,0,3795,[302 603 187 427 180],537,5,16601,4.373287671232877,20.0,0.0
3796,0,3796,[302 603 187 427 180],271,5,16606,4.373452725836186,20.0,0.0
3797,0,3797,[302 603 187 427 180],90,5,16611,4.373617693522907,20.0,0.0
3798,0,3798,[302 603 187 427 180],339,5,16616,4.373782574361674,20.0,0.0
3799,0,3799,[302 603 187 427 180],537,5,16621,4.373947368421053,20.0,0.0
3800,0,3800,[655  79 222 357 300],454,2,16623,4.373322809786898,20.0,0.0
3801,0,3801,[471 174  98 187 185],271,3,16626,4.372961599158338,0.0,40.0
3802,0,3802,[302 603 187 427 180],271,5,16631,4.373126479095451,20.0,0.0
3803,0,3803,[127 210  82 194 483],524,4,16635,4.3730283911671926,20.0,20.0
3804,0,3804,[175 204 546  79 118],653,2,16637,4.372404730617609,0.0,0.0
3805,0,3805,[302 603 187 427 180],13,5,16642,4.372569626904887,20.0,0.0
3806,0,3806,[302 603 187 427 180],458,5,16647,4.372734436564224,20.0,0.0
3807,0,3807,[302 603 187 427 180],271,5,16652,4.3728991596638656,20.0,0.0
3808,0,3808,[  1 588 245 496 273],458,3,16655,4.37253872407456,0.0,0.0
3809,0,3809,[211  97  70 176 181],398,5,16660,4.3727034120734904,0.0,0.0
3810,0,3810,[302 603 187 427 180],271,5,16665,4.3728680136447124,20.0,0.0
3811,0,3811,[302 603 187 427 180],537,5,16670,4.3730325288562435,20.0,0.0
3812,0,3812,[302 603 187 427 180],666,5,16675,4.373196957776029,20.0,0.0
3813,0,3813,[302 603 187 427 180],90,5,16680,4.373361300471945,20.0,0.0
3814,0,3814,[302 603 187 427 180],458,5,16685,4.373525557011796,20.0,0.0
3815,0,3815,[302 603 187 427 180],664,5,16690,4.373689727463312,20.0,0.0
3816,0,3816,[302 603 187 427 180],458,5,16695,4.373853811894158,20.0,0.0
3817,0,3817,[302 603 187 427 180],666,5,16700,4.374017810371923,20.0,0.0
3818,0,3818,[302 603 187 427 180],664,5,16705,4.374181722964127,20.0,0.0
3819,0,3819,[245 471  96 182 237],454,2,16707,4.373560209424084,0.0,0.0
3820,0,3820,[302 603 187 427 180],664,5,16712,4.37372415598011,20.0,0.0
3821,0,3821,[ 69   7 276 144 568],883,3,16715,4.373364730507587,0.0,0.0
3822,0,3822,[127 172 423 508  56],85,4,16719,4.373267067747842,0.0,20.0
3823,0,3823,[302 603 187 427 180],339,5,16724,4.373430962343096,20.0,0.0
3824,0,3824,[302 603 187 427 180],339,5,16729,4.37359477124183,20.0,0.0
3825,0,3825,[302 603 187 427 180],664,5,16734,4.373758494511239,20.0,0.0
3826,0,3826,[302 603 187 427 180],666,5,16739,4.373922132218448,20.0,0.0
3827,0,3827,[302 603 187 427 180],13,5,16744,4.374085684430512,20.0,0.0
3828,0,3828,[222 125  15  56  88],92,3,16747,4.373726821624445,0.0,0.0
3829,0,3829,[121 125  69 132 174],533,5,16752,4.3738903394255875,0.0,20.0
3830,0,3830,[302 603 187 427 180],537,5,16757,4.374053771861133,20.0,0.0
3831,0,3831,[ 96 275  89 182 385],7,5,16762,4.374217118997913,0.0,0.0
3832,0,3832,[ 28 265 568 179  22],537,1,16763,4.373336811896687,0.0,0.0
3833,0,3833,[302 603 187 427 180],474,5,16768,4.373500260824205,20.0,0.0
3834,0,3834,[204 181 186  88 222],234,0,16768,4.372359843546284,0.0,0.0
3835,0,3835,[302 603 187 427 180],271,5,16773,4.372523461939521,20.0,0.0
3836,0,3836,[143   7 385 496 515],666,3,16776,4.3721657544956996,0.0,0.0
3837,0,3837,[302 603 187 427 180],666,5,16781,4.372329338196978,20.0,0.0
3838,0,3838,[276 197 194 111   9],82,5,16786,4.3724928366762175,0.0,0.0
3839,0,3839,[302 603 187 427 180],666,5,16791,4.37265625,20.0,0.0
3840,0,3840,[302 603 187 427 180],271,5,16796,4.372819578234835,20.0,0.0
3841,0,3841,[302 603 187 427 180],537,5,16801,4.372982821447163,20.0,0.0
3842,0,3842,[302 603 187 427 180],339,5,16806,4.373145979703357,20.0,0.0
3843,0,3843,[302 603 187 427 180],474,5,16811,4.373309053069719,20.0,0.0
3844,0,3844,[302 603 187 427 180],90,5,16816,4.373472041612484,20.0,0.0
3845,0,3845,[302 603 187 427 180],664,5,16821,4.373634945397816,20.0,0.0
3846,0,3846,[302 603 187 427 180],339,5,16826,4.373797764491812,20.0,0.0
3847,0,3847,[302 603 187 427 180],666,5,16831,4.373960498960499,20.0,0.0
3848,0,3848,[216 135 127 196 423],848,4,16835,4.373863341127565,0.0,20.0
3849,0,3849,[302 603 187 427 180],339,5,16840,4.374025974025974,20.0,0.0
3850,0,3850,[302 603 187 427 180],458,5,16845,4.374188522461698,20.0,0.0
3851,0,3851,[302 603 187 427 180],458,5,16850,4.374350986500519,20.0,0.0
3852,0,3852,[302 603 187 427 180],271,5,16855,4.3745133662081495,20.0,0.0
3853,0,3853,[302 603 187 427 180],474,5,16860,4.374675661650233,20.0,0.0
3854,0,3854,[302 603 187 427 180],474,5,16865,4.374837872892347,20.0,0.0
3855,0,3855,[496 357 185 195 176],474,5,16870,4.375,20.0,0.0
3856,0,3856,[191 195 568 357 515],311,5,16875,4.375162043038631,20.0,0.0
3857,0,3857,[302 603 187 427 180],474,5,16880,4.375324002073613,20.0,0.0
3858,0,3858,[302 603 187 427 180],90,5,16885,4.375485877170251,20.0,0.0
3859,0,3859,[ 88  89 276  98 144],346,3,16888,4.375129533678757,0.0,20.0
3860,0,3860,[100 127   4 175 181],194,3,16891,4.374773374773374,0.0,40.0
3861,0,3861,[196 228 135 515 186],537,3,16894,4.37441740031072,0.0,0.0
3862,0,3862,[302 603 187 427 180],339,5,16899,4.3745793424799375,20.0,0.0
3863,0,3863,[302 603 187 427 180],664,5,16904,4.374741200828157,20.0,0.0
3864,0,3864,[302 603 187 427 180],339,5,16909,4.37490297542044,20.0,0.0
3865,0,3865,[180 211  96 210 121],666,2,16911,4.374288670460424,0.0,0.0
3866,0,3866,[302 603 187 427 180],664,5,16916,4.3744504784070335,20.0,0.0
3867,0,3867,[302 603 187 427 180],537,5,16921,4.374612202688728,20.0,0.0
3868,0,3868,[132 508 196   7  82],59,5,16926,4.37477384337038,0.0,0.0
3869,0,3869,[302 603 187 427 180],90,5,16931,4.3749354005167955,20.0,0.0
3870,0,3870,[302 603 187 427 180],666,5,16936,4.375096874192715,20.0,0.0
3871,0,3871,[302 603 187 427 180],271,5,16941,4.3752582644628095,20.0,0.0
3872,0,3872,[302 603 187 427 180],664,5,16946,4.375419571391686,20.0,0.0
3873,0,3873,[546  96 328 181  28],804,4,16950,4.375322663913268,0.0,0.0
3874,0,3874,[302 603 187 427 180],90,5,16955,4.3754838709677415,20.0,0.0
3875,0,3875,[204 275   4  97  96],7,5,16960,4.375644994840041,0.0,0.0
3876,0,3876,[ 69 483  98   9 161],328,5,16965,4.375806035594532,20.0,20.0
3877,0,3877,[302 603 187 427 180],339,5,16970,4.375966993295513,20.0,0.0
3878,0,3878,[196  64 588 191 603],398,5,16975,4.376127868007218,20.0,0.0
3879,0,3879,[302 603 187 427 180],339,5,16980,4.376288659793815,20.0,0.0
3880,0,3880,[ 96 678 185 197  79],537,2,16982,4.375676372069054,0.0,0.0
3881,0,3881,[302 603 187 427 180],339,5,16987,4.375837197320968,20.0,0.0
3882,0,3882,[302 603 187 427 180],13,5,16992,4.375997939737316,20.0,0.0
3883,0,3883,[302 603 187 427 180],13,5,16997,4.37615859938208,20.0,0.0
3884,0,3884,[302 603 187 427 180],339,5,17002,4.376319176319177,20.0,0.0
3885,0,3885,[302 603 187 427 180],90,5,17007,4.376479670612455,20.0,0.0
3886,0,3886,[176 197  82 204 151],830,1,17008,4.375611011062516,0.0,0.0
3887,0,3887,[ 50 222 403 186 215],881,1,17009,4.37474279835391,0.0,20.0
3888,0,3888,[185 435 121 289  15],474,4,17013,4.374646438673181,0.0,0.0
3889,0,3889,[302 603 187 427 180],339,5,17018,4.374807197943444,20.0,0.0
3890,0,3890,[302 603 187 427 180],664,5,17023,4.37496787458237,20.0,0.0
3891,0,3891,[ 95 222 195 496 655],815,3,17026,4.374614594039055,0.0,0.0
3892,0,3892,[302 603 187 427 180],13,5,17031,4.374775237605959,20.0,0.0
3893,0,3893,[125 257 282 655  56],119,5,17036,4.3749357986646125,0.0,0.0
3894,0,3894,[302 603 187 427 180],474,5,17041,4.375096277278562,20.0,0.0
3895,0,3895,[288 282 195 546 483],374,3,17044,4.374743326488707,20.0,0.0
3896,0,3896,[435 202  71  69 357],233,5,17049,4.374903772132409,20.0,0.0
3897,0,3897,[435   1 357 186 176],881,3,17052,4.374551051821447,20.0,0.0
3898,0,3898,[302 603 187 427 180],474,5,17057,4.374711464478072,20.0,0.0
3899,0,3899,[302 603 187 427 180],90,5,17062,4.374871794871795,20.0,0.0
3900,0,3900,[302 603 187 427 180],666,5,17067,4.375032043065881,20.0,0.0
3901,0,3901,[302 603 187 427 180],474,5,17072,4.375192209123527,20.0,0.0
3902,0,3902,[ 28  95   7  69 318],738,5,17077,4.375352293107865,20.0,0.0
3903,0,3903,[302 603 187 427 180],13,5,17082,4.375512295081967,20.0,0.0
3904,0,3904,[302 603 187 427 180],666,5,17087,4.3756722151088345,20.0,0.0
3905,0,3905,[ 98 168 483 238 125],648,3,17090,4.375320020481311,20.0,20.0
3906,0,3906,[302 603 187 427 180],474,5,17095,4.375479907857692,20.0,0.0
3907,0,3907,[  9  56  69 172 471],308,3,17098,4.3751279426816785,0.0,0.0
3908,0,3908,[302 603 187 427 180],664,5,17103,4.375287797390637,20.0,0.0
3909,0,3909,[302 603 187 427 180],271,5,17108,4.375447570332481,20.0,0.0
3910,0,3910,[302 603 187 427 180],13,5,17113,4.375607261569931,20.0,0.0
3911,0,3911,[302 603 187 427 180],13,5,17118,4.375766871165644,20.0,0.0
3912,0,3912,[302 603 187 427 180],474,5,17123,4.375926399182213,20.0,0.0
3913,0,3913,[302 603 187 427 180],666,5,17128,4.376085845682167,20.0,0.0
3914,0,3914,[302 603 187 427 180],13,5,17133,4.376245210727969,20.0,0.0
3915,0,3915,[385 273  22 234 185],234,2,17135,4.375638406537283,0.0,0.0
3916,0,3916,[ 25 471 265 183 117],145,4,17139,4.375542507020679,0.0,0.0
3917,0,3917,[302 603 187 427 180],474,5,17144,4.3757018887187344,20.0,0.0
3918,0,3918,[546 257 210 294  69],374,3,17147,4.3753508548099,0.0,0.0
3919,0,3919,[  1  96 210  95 496],200,5,17152,4.375510204081633,0.0,0.0
3920,0,3920,[302 603 187 427 180],13,5,17157,4.375669472073451,20.0,0.0
3921,0,3921,[ 88 191 234 135 313],308,3,17160,4.375318714941357,0.0,0.0
3922,0,3922,[302 603 187 427 180],664,5,17165,4.37547795054805,20.0,0.0
3923,0,3923,[302 603 187 427 180],666,5,17170,4.375637104994903,20.0,0.0
3924,0,3924,[302 603 187 427 180],90,5,17175,4.375796178343949,20.0,0.0
3925,0,3925,[286  95  69 496 294],537,1,17176,4.37493632195619,0.0,0.0
3926,0,3926,[302 603 187 427 180],458,5,17181,4.375095492742552,20.0,0.0
3927,0,3927,[302 603 187 427 180],537,5,17186,4.375254582484725,20.0,0.0
3928,0,3928,[ 97 265 228   1  56],339,4,17190,4.375159073555612,0.0,0.0
3929,0,3929,[302 603 187 427 180],271,5,17195,4.375318066157761,20.0,0.0
3930,0,3930,[302 603 187 427 180],474,5,17200,4.375476977868227,20.0,0.0
3931,0,3931,[302 603 187 427 180],664,5,17205,4.375635808748728,20.0,0.0
3932,0,3932,[302 603 187 427 180],458,5,17210,4.37579455886092,20.0,0.0
3933,0,3933,[328 202 318 173 132],554,4,17214,4.375699034062023,20.0,0.0
3934,0,3934,[302 603 187 427 180],271,5,17219,4.375857687420584,20.0,0.0
3935,0,3935,[302 603 187 427 180],458,5,17224,4.376016260162602,20.0,0.0
3936,0,3936,[302 603 187 427 180],666,5,17229,4.376174752349504,20.0,0.0
3937,0,3937,[276 175 515  28 423],537,3,17232,4.375825292026409,0.0,0.0
3938,0,3938,[302 603 187 427 180],474,5,17237,4.375983752221376,20.0,0.0
3939,0,3939,[302 603 187 427 180],664,5,17242,4.376142131979695,20.0,0.0
3940,0,3940,[180  56   9  25 132],343,4,17246,4.376046688657701,0.0,0.0
3941,0,3941,[ 96 423 215  69 294],92,3,17249,4.375697615423642,0.0,0.0
3942,0,3942,[302 603 187 427 180],90,5,17254,4.375855947248288,20.0,0.0
3943,0,3943,[302 603 187 427 180],666,5,17259,4.376014198782961,20.0,0.0
3944,0,3944,[302 603 187 427 180],474,5,17264,4.37617237008872,20.0,0.0
3945,0,3945,[302 603 187 427 180],458,5,17269,4.3763304612265586,20.0,0.0
3946,0,3946,[302 603 187 427 180],271,5,17274,4.376488472257411,20.0,0.0
3947,0,3947,[302 603 187 427 180],339,5,17279,4.376646403242148,20.0,0.0
3948,0,3948,[302 603 187 427 180],537,5,17284,4.37680425424158,20.0,0.0
3949,0,3949,[302 603 187 427 180],537,5,17289,4.376962025316455,20.0,0.0
3950,0,3950,[483 121 173 210 588],848,4,17293,4.376866616046571,20.0,0.0
3951,0,3951,[302 603 187 427 180],458,5,17298,4.377024291497976,20.0,0.0
3952,0,3952,[302 603 187 427 180],339,5,17303,4.377181887174298,20.0,0.0
3953,0,3953,[302 603 187 427 180],474,5,17308,4.377339403136065,20.0,0.0
3954,0,3954,[265  12 258 286 318],378,5,17313,4.377496839443742,40.0,0.0
3955,0,3955,[176 135 323 194 161],328,2,17315,4.3768958543983825,0.0,0.0
3956,0,3956,[302 603 187 427 180],474,5,17320,4.377053323224665,20.0,0.0
3957,0,3957,[483 435   9 174  95],233,5,17325,4.377210712481051,20.0,20.0
3958,0,3958,[302 603 187 427 180],666,5,17330,4.377368022227835,20.0,0.0
3959,0,3959,[302 603 187 427 180],90,5,17335,4.377525252525253,20.0,0.0
3960,0,3960,[237 515  28 423 144],328,5,17340,4.377682403433476,0.0,0.0
3961,0,3961,[597 197  71  97 127],82,3,17343,4.377334679454821,0.0,20.0
3962,0,3962,[210 603 216  89  12],379,5,17348,4.377491799142064,40.0,0.0
3963,0,3963,[403  96  69 294 215],648,2,17350,4.3768920282542885,0.0,0.0
3964,0,3964,[302 603 187 427 180],537,5,17355,4.377049180327869,20.0,0.0
3965,0,3965,[302 603 187 427 180],666,5,17360,4.37720625315179,20.0,0.0
3966,0,3966,[302 603 187 427 180],339,5,17365,4.377363246785984,20.0,0.0
3967,0,3967,[215 111 132 286  22],488,3,17368,4.377016129032258,0.0,0.0
3968,0,3968,[302 603 187 427 180],666,5,17373,4.377173091458806,20.0,0.0
3969,0,3969,[302 603 187 427 180],666,5,17378,4.377329974811083,20.0,0.0
3970,0,3970,[302 603 187 427 180],474,5,17383,4.377486779148829,20.0,0.0
3971,0,3971,[302 603 187 427 180],458,5,17388,4.377643504531722,20.0,0.0
3972,0,3972,[302 603 187 427 180],458,5,17393,4.377800151019381,20.0,0.0
3973,0,3973,[302 603 187 427 180],271,5,17398,4.3779567186713635,20.0,0.0
3974,0,3974,[302 603 187 427 180],458,5,17403,4.37811320754717,20.0,0.0
3975,0,3975,[302 603 187 427 180],458,5,17408,4.378269617706238,20.0,0.0
3976,0,3976,[235 180  15 172 435],271,3,17411,4.377923057581091,0.0,0.0
3977,0,3977,[302 603 187 427 180],90,5,17416,4.378079436902967,20.0,0.0
3978,0,3978,[302 603 187 427 180],271,5,17421,4.378235737622518,20.0,0.0
3979,0,3979,[302 603 187 427 180],458,5,17426,4.378391959798995,20.0,0.0
3980,0,3980,[302 603 187 427 180],664,5,17431,4.378548103491585,20.0,0.0
3981,0,3981,[302 603 187 427 180],537,5,17436,4.378704168759417,20.0,0.0
3982,0,3982,[ 12 191 238  95 121],454,2,17438,4.378106954556866,20.0,0.0
3983,0,3983,[302 603 187 427 180],90,5,17443,4.378263052208835,20.0,0.0
3984,0,3984,[302 603 187 427 180],90,5,17448,4.378419071518193,20.0,0.0
3985,0,3985,[302 603 187 427 180],537,5,17453,4.378575012543903,20.0,0.0
3986,0,3986,[211  89 742  82 151],387,3,17456,4.378229245046401,0.0,0.0
3987,0,3987,[471 403  82  15 195],374,2,17458,4.377632898696088,0.0,0.0
3988,0,3988,[302 603 187 427 180],13,5,17463,4.377788919528704,20.0,0.0
3989,0,3989,[302 603 187 427 180],339,5,17468,4.377944862155388,20.0,0.0
3990,0,3990,[172 265 238 174 173],378,4,17472,4.37785016286645,0.0,20.0
3991,0,3991,[302 603 187 427 180],537,5,17477,4.3780060120240485,20.0,0.0
3992,0,3992,[302 603 187 427 180],458,5,17482,4.3781617831204604,20.0,0.0
3993,0,3993,[302 603 187 427 180],666,5,17487,4.378317476214321,20.0,0.0
3994,0,3994,[302 603 187 427 180],537,5,17492,4.378473091364206,20.0,0.0
3995,0,3995,[302 603 187 427 180],474,5,17497,4.378628628628628,20.0,0.0
3996,0,3996,[357 174 471 200 175],13,2,17499,4.378033525143858,20.0,20.0
3997,0,3997,[302 603 187 427 180],664,5,17504,4.378189094547274,20.0,0.0
3998,0,3998,[302 603 187 427 180],537,5,17509,4.378344586146537,20.0,0.0
3999,0,3999,[302 603 187 427 180],664,5,17514,4.3785,20.0,0.0
4000,0,4000,[ 79 276  89  15 245],455,2,17516,4.377905523619095,0.0,0.0
4001,0,4001,[302 603 187 427 180],537,5,17521,4.378060969515243,20.0,0.0
4002,0,4002,[302 603 187 427 180],90,5,17526,4.37821633774669,20.0,0.0
4003,0,4003,[302 603 187 427 180],458,5,17531,4.378371628371628,20.0,0.0
4004,0,4004,[302 603 187 427 180],474,5,17536,4.37852684144819,20.0,0.0
4005,0,4005,[302 603 187 427 180],537,5,17541,4.378681977034448,20.0,0.0
4006,0,4006,[546 228 132  22 125],194,1,17542,4.3778387821312705,0.0,0.0
4007,0,4007,[302 603 187 427 180],339,5,17547,4.377994011976048,20.0,0.0
4008,0,4008,[302 603 187 427 180],13,5,17552,4.378149164380145,20.0,0.0
4009,0,4009,[282 117  82 195   8],200,5,17557,4.378304239401496,0.0,0.0
4010,0,4010,[302 603 187 427 180],474,5,17562,4.378459237097981,20.0,0.0
4011,0,4011,[302 603 187 427 180],664,5,17567,4.378614157527418,20.0,0.0
4012,0,4012,[ 89  69 100 357 435],454,2,17569,4.3780214303513585,20.0,20.0
4013,0,4013,[302 603 187 427 180],537,5,17574,4.378176382660688,20.0,0.0
4014,0,4014,[210  89 135 483 282],479,5,17579,4.378331257783312,20.0,0.0
4015,0,4015,[302 603 187 427 180],664,5,17584,4.378486055776892,20.0,0.0
4016,0,4016,[216 186  69 196 235],378,3,17587,4.378142892705999,0.0,0.0
4017,0,4017,[302 603 187 427 180],13,5,17592,4.378297660527625,20.0,0.0
4018,0,4018,[302 603 187 427 180],13,5,17597,4.378452351331177,20.0,0.0
4019,0,4019,[302 603 187 427 180],339,5,17602,4.3786069651741295,20.0,0.0
4020,0,4020,[302 603 187 427 180],90,5,17607,4.378761502113902,20.0,0.0
4021,0,4021,[568 202   9 748 121],207,2,17609,4.378170064644456,0.0,0.0
4022,0,4022,[302 603 187 427 180],271,5,17614,4.37832463335819,20.0,0.0
4023,0,4023,[302 603 187 427 180],537,5,17619,4.378479125248509,20.0,0.0
4024,0,4024,[118   7 197 181 597],82,2,17621,4.377888198757764,0.0,0.0
4025,0,4025,[302 603 187 427 180],271,5,17626,4.378042722305017,20.0,0.0
4026,0,4026,[302 603 187 427 180],90,5,17631,4.3781971691085175,20.0,0.0
4027,0,4027,[302 603 187 427 180],664,5,17636,4.378351539225422,20.0,0.0
4028,0,4028,[483 234 161 357 196],650,4,17640,4.3782576321667905,40.0,0.0
4029,0,4029,[302 603 187 427 180],90,5,17645,4.378411910669975,20.0,0.0
4030,0,4030,[302 603 187 427 180],664,5,17650,4.37856611262714,20.0,0.0
4031,0,4031,[132  70 151 179  82],653,2,17652,4.377976190476191,0.0,0.0
4032,0,4032,[302 603 187 427 180],13,5,17657,4.378130424001983,20.0,0.0
4033,0,4033,[ 89  79 237 403 496],7,5,17662,4.378284581060981,0.0,0.0
4034,0,4034,[151 135 288 204 294],479,3,17665,4.377942998760843,0.0,0.0
4035,0,4035,[302 603 187 427 180],271,5,17670,4.378097125867195,20.0,0.0
4036,0,4036,[132 237 174 318 357],6,4,17674,4.378003467921724,40.0,20.0
4037,0,4037,[302 603 187 427 180],537,5,17679,4.378157503714711,20.0,0.0
4038,0,4038,[302 603 187 427 180],664,5,17684,4.378311463233474,20.0,0.0
4039,0,4039,[185  64  88 237  69],537,1,17685,4.377475247524752,0.0,0.0
4040,0,4040,[121 161  97 183 204],650,2,17687,4.376886909180896,0.0,0.0
4041,0,4041,[302 603 187 427 180],537,5,17692,4.3770410687778325,20.0,0.0
4042,0,4042,[302 603 187 427 180],458,5,17697,4.3771951521147665,20.0,0.0
4043,0,4043,[302 603 187 427 180],664,5,17702,4.377349159248269,20.0,0.0
4044,0,4044,[302 603 187 427 180],90,5,17707,4.377503090234858,20.0,0.0
4045,0,4045,[302 603 187 427 180],666,5,17712,4.377656945130994,20.0,0.0
4046,0,4046,[302 603 187 427 180],271,5,17717,4.377810723993082,20.0,0.0
4047,0,4047,[318 186 195 172 144],385,0,17717,4.3767292490118574,20.0,0.0
4048,0,4048,[ 12  97 132 318 153],664,4,17721,4.376636206470733,40.0,0.0
4049,0,4049,[302 603 187 427 180],13,5,17726,4.37679012345679,20.0,0.0
4050,0,4050,[302 603 187 427 180],474,5,17731,4.376943964453221,20.0,0.0
4051,0,4051,[302 603 187 427 180],666,5,17736,4.377097729516288,20.0,0.0
4052,0,4052,[302 603 187 427 180],664,5,17741,4.377251418702196,20.0,0.0
4053,0,4053,[423 196 186   1 117],650,3,17744,4.376911692155895,0.0,0.0
4054,0,4054,[302 603 187 427 180],90,5,17749,4.377065351418002,20.0,0.0
4055,0,4055,[215 151 237 121 143],7,4,17753,4.376972386587771,0.0,0.0
4056,0,4056,[302 603 187 427 180],666,5,17758,4.377125955139266,20.0,0.0
4057,0,4057,[302 603 187 427 180],339,5,17763,4.377279448003943,20.0,0.0
4058,0,4058,[216 161  97  82  69],533,4,17767,4.377186499137719,0.0,0.0
4059,0,4059,[302 603 187 427 180],664,5,17772,4.377339901477833,20.0,0.0
4060,0,4060,[302 603 187 427 180],13,5,17777,4.377493228268899,20.0,0.0
4061,0,4061,[302 603 187 427 180],458,5,17782,4.377646479566716,20.0,0.0
4062,0,4062,[302 603 187 427 180],458,5,17787,4.377799655427024,20.0,0.0
4063,0,4063,[568 111  79 191 357],749,4,17791,4.377706692913386,20.0,0.0
4064,0,4064,[302 603 187 427 180],90,5,17796,4.377859778597786,20.0,0.0
4065,0,4065,[435 273 496 204 238],234,1,17797,4.377029021151008,0.0,0.0
4066,0,4066,[302 603 187 427 180],537,5,17802,4.377182198180477,20.0,0.0
4067,0,4067,[302 603 187 427 180],13,5,17807,4.377335299901672,20.0,0.0
4068,0,4068,[302 603 187 427 180],664,5,17812,4.377488326370115,20.0,0.0
4069,0,4069,[302 603 187 427 180],90,5,17817,4.377641277641278,20.0,0.0
4070,0,4070,[302 603 187 427 180],474,5,17822,4.377794153770572,20.0,0.0
4071,0,4071,[302 603 187 427 180],90,5,17827,4.37794695481336,20.0,0.0
4072,0,4072,[135  28 174 117 186],897,3,17830,4.377608642278419,0.0,20.0
4073,0,4073,[302 603 187 427 180],666,5,17835,4.3777614138438885,20.0,0.0
4074,0,4074,[302 603 187 427 180],90,5,17840,4.3779141104294474,20.0,0.0
4075,0,4075,[302 603 187 427 180],664,5,17845,4.378066732090285,20.0,0.0
4076,0,4076,[302 603 187 427 180],13,5,17850,4.378219278881531,20.0,0.0
4077,0,4077,[302 603 187 427 180],271,5,17855,4.378371750858264,20.0,0.0
4078,0,4078,[302 603 187 427 180],537,5,17860,4.378524148075509,20.0,0.0
4079,0,4079,[302 603 187 427 180],664,5,17865,4.3786764705882355,20.0,0.0
4080,0,4080,[302 603 187 427 180],339,5,17870,4.37882871845136,20.0,0.0
4081,0,4081,[302 603 187 427 180],666,5,17875,4.3789808917197455,20.0,0.0
4082,0,4082,[302 603 187 427 180],537,5,17880,4.3791329904482,20.0,0.0
4083,0,4083,[302 603 187 427 180],90,5,17885,4.379285014691479,20.0,0.0
4084,0,4084,[302 603 187 427 180],666,5,17890,4.379436964504284,20.0,0.0
4085,0,4085,[302 603 187 427 180],458,5,17895,4.379588839941263,20.0,0.0
4086,0,4086,[302 603 187 427 180],666,5,17900,4.37974064105701,20.0,0.0
4087,0,4087,[302 603 187 427 180],666,5,17905,4.379892367906066,20.0,0.0
4088,0,4088,[302 603 187 427 180],90,5,17910,4.38004402054292,20.0,0.0
4089,0,4089,[302 603 187 427 180],13,5,17915,4.380195599022005,20.0,0.0
4090,0,4090,[181 211 132 385 475],64,5,17920,4.380347103397702,0.0,0.0
4091,0,4091,[302 603 187 427 180],474,5,17925,4.3804985337243405,20.0,0.0
4092,0,4092,[302 603 187 427 180],271,5,17930,4.380649890056193,20.0,0.0
4093,0,4093,[302 603 187 427 180],664,5,17935,4.380801172447484,20.0,0.0
4094,0,4094,[302 603 187 427 180],90,5,17940,4.380952380952381,20.0,0.0
4095,0,4095,[194 182 238 183 174],378,4,17944,4.380859375,0.0,20.0
4096,0,4096,[302 603 187 427 180],13,5,17949,4.381010495484501,20.0,0.0
4097,0,4097,[302 603 187 427 180],13,5,17954,4.381161542215715,20.0,0.0
4098,0,4098,[302 603 187 427 180],664,5,17959,4.381312515247622,20.0,0.0
4099,0,4099,[302 603 187 427 180],666,5,17964,4.381463414634147,20.0,0.0
4100,0,4100,[302 603 187 427 180],666,5,17969,4.381614240429164,20.0,0.0
4101,0,4101,[  1 238 423 546 127],13,2,17971,4.381033642125792,0.0,20.0
4102,0,4102,[  7   1 403 288 204],339,2,17973,4.380453326834024,0.0,0.0
4103,0,4103,[302 603 187 427 180],90,5,17978,4.3806042884990255,20.0,0.0
4104,0,4104,[302 603 187 427 180],13,5,17983,4.380755176613886,20.0,0.0
4105,0,4105,[302 603 187 427 180],474,5,17988,4.380905991232343,20.0,0.0
4106,0,4106,[302 603 187 427 180],339,5,17993,4.381056732408084,20.0,0.0
4107,0,4107,[302 603 187 427 180],664,5,17998,4.381207400194742,20.0,0.0
4108,0,4108,[322 181 289  56  97],234,1,17999,4.380384521781456,0.0,0.0
4109,0,4109,[302 603 187 427 180],664,5,18004,4.380535279805353,20.0,0.0
4110,0,4110,[301  64 100 151  22],90,4,18008,4.380442714667964,0.0,20.0
4111,0,4111,[302 603 187 427 180],458,5,18013,4.3805933852140075,20.0,0.0
4112,0,4112,[302 603 187 427 180],537,5,18018,4.380743982494529,20.0,0.0
4113,0,4113,[603 216 168 173 127],749,5,18023,4.380894506562956,20.0,20.0
4114,0,4114,[302 603 187 427 180],90,5,18028,4.381044957472661,20.0,0.0
4115,0,4115,[185 111 385 302 182],13,3,18031,4.380709426627794,0.0,0.0
4116,0,4116,[385 195 238 143 176],881,4,18035,4.380616954092786,0.0,0.0
4117,0,4117,[302 603 187 427 180],458,5,18040,4.380767362797474,20.0,0.0
4118,0,4118,[302 603 187 427 180],474,5,18045,4.380917698470503,20.0,0.0
4119,0,4119,[302 603 187 427 180],474,5,18050,4.381067961165049,20.0,0.0
4120,0,4120,[302 603 187 427 180],13,5,18055,4.381218150934239,20.0,0.0
4121,0,4121,[302 603 187 427 180],664,5,18060,4.38136826783115,20.0,0.0
4122,0,4122,[496 405 234 210  88],200,4,18064,4.381275770070337,0.0,0.0
4123,0,4123,[174 144 222 357 143],312,3,18067,4.38094083414161,20.0,20.0
4124,0,4124,[302 603 187 427 180],271,5,18072,4.381090909090909,20.0,0.0
4125,0,4125,[302 603 187 427 180],474,5,18077,4.381240911294232,20.0,0.0
4126,0,4126,[215 143 153  98 211],234,1,18078,4.380421613763024,0.0,20.0
4127,0,4127,[ 25 186 175 202 100],194,2,18080,4.37984496124031,0.0,20.0
4128,0,4128,[302 603 187 427 180],339,5,18085,4.379995156212158,20.0,0.0
4129,0,4129,[302 603 187 427 180],664,5,18090,4.380145278450363,20.0,0.0
4130,0,4130,[302 603 187 427 180],90,5,18095,4.380295328007747,20.0,0.0
4131,0,4131,[302 603 187 427 180],666,5,18100,4.380445304937076,20.0,0.0
4132,0,4132,[111  25 357 294 174],13,2,18102,4.37986934430196,20.0,20.0
4133,0,4133,[302 603 187 427 180],474,5,18107,4.380019351717465,20.0,0.0
4134,0,4134,[ 28  50  98 222 196],387,4,18111,4.379927448609432,0.0,40.0
4135,0,4135,[302 603 187 427 180],339,5,18116,4.380077369439071,20.0,0.0
4136,0,4136,[302 603 187 427 180],90,5,18121,4.38022721779067,20.0,0.0
4137,0,4137,[302 603 187 427 180],339,5,18126,4.380376993716771,20.0,0.0
4138,0,4138,[302 603 187 427 180],13,5,18131,4.380526697269872,20.0,0.0
4139,0,4139,[302 603 187 427 180],13,5,18136,4.380676328502416,20.0,0.0
4140,0,4140,[ 70 179 333 435 678],13,1,18137,4.379859937213234,0.0,0.0
4141,0,4141,[194 435  25 222 180],194,2,18139,4.3792853693867695,0.0,0.0
4142,0,4142,[302 603 187 427 180],339,5,18144,4.379435191889935,20.0,0.0
4143,0,4143,[302 603 187 427 180],474,5,18149,4.379584942084942,20.0,0.0
4144,0,4144,[302 603 187 427 180],13,5,18154,4.379734620024125,20.0,0.0
4145,0,4145,[302 603 187 427 180],664,5,18159,4.379884225759769,20.0,0.0
4146,0,4146,[302 603 187 427 180],537,5,18164,4.380033759344104,20.0,0.0
4147,0,4147,[ 71 191 187  79 265],650,2,18166,4.379459980713597,0.0,0.0
4148,0,4148,[  9  79 174 427 132],7,5,18171,4.379609544468547,0.0,20.0
4149,0,4149,[302 603 187 427 180],666,5,18176,4.379759036144578,20.0,0.0
4150,0,4150,[302 603 187 427 180],664,5,18181,4.379908455793784,20.0,0.0
4151,0,4151,[302 603 187 427 180],271,5,18186,4.380057803468208,20.0,0.0
4152,0,4152,[302 603 187 427 180],458,5,18191,4.380207079219841,20.0,0.0
4153,0,4153,[302 603 187 427 180],13,5,18196,4.3803562831006255,20.0,0.0
4154,0,4154,[ 79  98 127 121 117],207,3,18199,4.380024067388688,0.0,40.0
4155,0,4155,[302 603 187 427 180],664,5,18204,4.380173243503369,20.0,0.0
4156,0,4156,[191 496 196 143 187],659,5,18209,4.380322347847005,0.0,0.0
4157,0,4157,[302 603 187 427 180],458,5,18214,4.380471380471381,20.0,0.0
4158,0,4158,[ 98  96 471 546 286],653,2,18216,4.379899014186102,0.0,20.0
4159,0,4159,[275  22 286 151 195],883,3,18219,4.379567307692308,0.0,0.0
4160,0,4160,[483  88   8 191 215],13,4,18223,4.379476087478971,20.0,0.0
4161,0,4161,[302 603 187 427 180],271,5,18228,4.379625180201826,20.0,0.0
4162,0,4162,[302 603 187 427 180],271,5,18233,4.379774201297142,20.0,0.0
4163,0,4163,[302 603 187 427 180],90,5,18238,4.379923150816523,20.0,0.0
4164,0,4164,[302 603 187 427 180],666,5,18243,4.380072028811525,20.0,0.0
4165,0,4165,[302 603 187 427 180],458,5,18248,4.380220835333653,20.0,0.0
4166,0,4166,[302 603 187 427 180],666,5,18253,4.3803695704343655,20.0,0.0
4167,0,4167,[302 603 187 427 180],458,5,18258,4.380518234165067,20.0,0.0
4168,0,4168,[302 603 187 427 180],666,5,18263,4.380666826577117,20.0,0.0
4169,0,4169,[302 603 187 427 180],90,5,18268,4.380815347721822,20.0,0.0
4170,0,4170,[121  97 135 286 300],653,4,18272,4.380724046991129,0.0,0.0
4171,0,4171,[302 603 187 427 180],458,5,18277,4.380872483221476,20.0,0.0
4172,0,4172,[ 28  82 742 323 185],488,4,18281,4.380781212556913,0.0,0.0
4173,0,4173,[174 655  28 200  15],308,3,18284,4.380450407283182,0.0,20.0
4174,0,4174,[302 603 187 427 180],90,5,18289,4.38059880239521,20.0,0.0
4175,0,4175,[302 603 187 427 180],458,5,18294,4.380747126436781,20.0,0.0
4176,0,4176,[302 603 187 427 180],666,5,18299,4.380895379458942,20.0,0.0
4177,0,4177,[302 603 187 427 180],474,5,18304,4.381043561512685,20.0,0.0
4178,0,4178,[302 603 187 427 180],339,5,18309,4.381191672648959,20.0,0.0
4179,0,4179,[748 180  71  25 191],533,3,18312,4.380861244019139,0.0,0.0
4180,0,4180,[ 69 515 302 151   9],334,4,18316,4.380770150681655,0.0,0.0
4181,0,4181,[302 603 187 427 180],90,5,18321,4.380918220946915,20.0,0.0
4182,0,4182,[302 603 187 427 180],474,5,18326,4.38106622041597,20.0,0.0
4183,0,4183,[302 603 187 427 180],271,5,18331,4.38121414913958,20.0,0.0
4184,0,4184,[302 603 187 427 180],537,5,18336,4.381362007168459,20.0,0.0
4185,0,4185,[302 603 187 427 180],90,5,18341,4.381509794553272,20.0,0.0
4186,0,4186,[302 603 187 427 180],664,5,18346,4.381657511344638,20.0,0.0
4187,0,4187,[323   7 237 194 234],328,3,18349,4.3813276026743075,0.0,0.0
4188,0,4188,[302 603 187 427 180],13,5,18354,4.381475292432562,20.0,0.0
4189,0,4189,[ 56 183  95  96 328],313,3,18357,4.381145584725537,0.0,0.0
4190,0,4190,[302 603 187 427 180],474,5,18362,4.3812932474349795,20.0,0.0
4191,0,4191,[302 603 187 427 180],271,5,18367,4.3814408396946565,20.0,0.0
4192,0,4192,[302 603 187 427 180],271,5,18372,4.381588361554972,20.0,0.0
4193,0,4193,[302 603 187 427 180],339,5,18377,4.381735813066285,20.0,0.0
4194,0,4194,[191 496 238 183 144],64,4,18381,4.381644815256258,0.0,0.0
4195,0,4195,[302 603 187 427 180],474,5,18386,4.381792183031458,20.0,0.0
4196,0,4196,[288 197  88 588  22],479,3,18389,4.381462949725995,0.0,0.0
4197,0,4197,[210 216 318  97 423],378,5,18394,4.381610290614578,20.0,0.0
4198,0,4198,[483 197 132 127 175],10,4,18398,4.381519409383187,20.0,20.0
4199,0,4199,[302 603 187 427 180],458,5,18403,4.381666666666667,20.0,0.0
4200,0,4200,[302 603 187 427 180],666,5,18408,4.3818138538443225,20.0,0.0
4201,0,4201,[ 22 187  95 385 111],479,4,18412,4.381722989052832,0.0,0.0
4202,0,4202,[302 603 187 427 180],474,5,18417,4.381870092790864,20.0,0.0
4203,0,4203,[302 603 187 427 180],13,5,18422,4.382017126546146,20.0,0.0
4204,0,4204,[121 515  71 174 127],455,4,18426,4.38192627824019,0.0,40.0
4205,0,4205,[302 603 187 427 180],13,5,18431,4.382073228720875,20.0,0.0
4206,0,4206,[268 215 173 174 515],387,3,18434,4.381744711195626,0.0,20.0
4207,0,4207,[183 228 515  56  96],804,4,18438,4.381653992395437,0.0,0.0
4208,0,4208,[289 211 403 271 186],328,3,18441,4.381325730577334,0.0,0.0
4209,0,4209,[405 172 111 269 174],271,4,18445,4.381235154394299,0.0,20.0
4210,0,4210,[302 603 187 427 180],666,5,18450,4.381382094514367,20.0,0.0
4211,0,4211,[144 161 125 168  97],194,3,18453,4.381054131054131,0.0,0.0
4212,0,4212,[302 603 187 427 180],666,5,18458,4.381201044386423,20.0,0.0
4213,0,4213,[ 95 175 191 313 483],650,4,18462,4.3811105837683915,20.0,0.0
4214,0,4214,[405  98 496 302 216],6,4,18466,4.381020166073547,0.0,20.0
4215,0,4215,[302 603 187 427 180],474,5,18471,4.381166982922201,20.0,0.0
4216,0,4216,[302 603 187 427 180],13,5,18476,4.38131373013991,20.0,0.0
4217,0,4217,[483 174 276 423 127],881,5,18481,4.381460407776197,20.0,40.0
4218,0,4218,[302 603 187 427 180],537,5,18486,4.38160701588054,20.0,0.0
4219,0,4219,[302 603 187 427 180],664,5,18491,4.38175355450237,20.0,0.0
4220,0,4220,[435 678 216 186  70],13,2,18493,4.381189291637053,0.0,0.0
4221,0,4221,[302 603 187 427 180],537,5,18498,4.3813358597820935,20.0,0.0
4222,0,4222,[302 603 187 427 180],666,5,18503,4.381482358512906,20.0,0.0
4223,0,4223,[275  56 435  98 187],6,5,18508,4.381628787878788,0.0,20.0
4224,0,4224,[435 216 185  25  79],843,0,18508,4.3805917159763315,0.0,0.0
4225,0,4225,[302 603 187 427 180],666,5,18513,4.380738286796024,20.0,0.0
4226,0,4226,[258 313 286 318 117],676,4,18517,4.38064821386326,20.0,0.0
4227,0,4227,[  4 125 186 423 228],295,5,18522,4.380794701986755,0.0,0.0
4228,0,4228,[302 603 187 427 180],339,5,18527,4.380941120832348,20.0,0.0
4229,0,4229,[176 328  64 196  50],263,5,18532,4.381087470449173,0.0,20.0
4230,0,4230,[182 435  69 228   8],85,4,18536,4.38099740014181,0.0,0.0
4231,0,4231,[302 603 187 427 180],13,5,18541,4.3811436672967865,20.0,0.0
4232,0,4232,[302 603 187 427 180],13,5,18546,4.381289865343728,20.0,0.0
4233,0,4233,[302 603 187 427 180],339,5,18551,4.381435994331602,20.0,0.0
4234,0,4234,[678 195 515 603  79],13,1,18552,4.380637544273908,20.0,0.0
4235,0,4235,[302 603 187 427 180],666,5,18557,4.3807837582625115,20.0,0.0
4236,0,4236,[302 603 187 427 180],666,5,18562,4.38092990323342,20.0,0.0
4237,0,4237,[222 357 204  28 265],804,5,18567,4.381075979235488,20.0,0.0
4238,0,4238,[ 70  64 508 127 181],144,5,18572,4.381221986317528,0.0,20.0
4239,0,4239,[435 191 333 132 172],85,4,18576,4.381132075471698,0.0,0.0
4240,0,4240,[302 603 187 427 180],664,5,18581,4.381278000471587,20.0,0.0
4241,0,4241,[234 546  98  89   4],271,3,18584,4.380952380952381,0.0,20.0
4242,0,4242,[ 12  64 117  70 423],533,5,18589,4.381098279519208,20.0,0.0
4243,0,4243,[302 603 187 427 180],458,5,18594,4.38124410933082,20.0,0.0
4244,0,4244,[302 603 187 427 180],339,5,18599,4.3813898704358065,20.0,0.0
4245,0,4245,[302 603 187 427 180],666,5,18604,4.381535562882713,20.0,0.0
4246,0,4246,[302 603 187 427 180],664,5,18609,4.381681186720038,20.0,0.0
4247,0,4247,[302 603 187 427 180],474,5,18614,4.381826741996234,20.0,0.0
4248,0,4248,[  7  70 496 235 385],194,1,18615,4.381030830783714,0.0,0.0
4249,0,4249,[302 603 187 427 180],90,5,18620,4.381176470588235,20.0,0.0
4250,0,4250,[302 603 187 427 180],537,5,18625,4.381322041872501,20.0,0.0
4251,0,4251,[302 603 187 427 180],458,5,18630,4.381467544684854,20.0,0.0
4252,0,4252,[ 82  70 204 357   8],454,4,18634,4.381377850928756,20.0,0.0
4253,0,4253,[302 603 187 427 180],474,5,18639,4.381523272214387,20.0,0.0
4254,0,4254,[245 100 173 187 175],346,2,18641,4.38096357226792,0.0,20.0
4255,0,4255,[405  70 175 328 603],537,3,18644,4.3806390977443606,20.0,0.0
4256,0,4256,[302 603 187 427 180],474,5,18649,4.380784590086916,20.0,0.0
4257,0,4257,[302 603 187 427 180],13,5,18654,4.380930014091122,20.0,0.0
4258,0,4258,[302 603 187 427 180],339,5,18659,4.381075369805118,20.0,0.0
4259,0,4259,[ 22   7 427 191 216],7,5,18664,4.381220657276995,0.0,0.0
4260,0,4260,[302 603 187 427 180],458,5,18669,4.381365876554799,20.0,0.0
4261,0,4261,[289 174  97 180  70],194,1,18670,4.380572501173158,0.0,20.0
4262,0,4262,[ 25 151  50 258 100],339,4,18674,4.380483227773868,0.0,40.0
4263,0,4263,[385  98 435 300 161],234,1,18675,4.3796904315197,0.0,20.0
4264,0,4264,[302 603 187 427 180],339,5,18680,4.379835873388042,20.0,0.0
4265,0,4265,[403 176 100  96  64],398,4,18684,4.379746835443038,0.0,20.0
4266,0,4266,[302 603 187 427 180],666,5,18689,4.379892195922194,20.0,0.0
4267,0,4267,[302 603 187 427 180],537,5,18694,4.380037488284911,20.0,0.0
4268,0,4268,[302 603 187 427 180],664,5,18699,4.3801827125790584,20.0,0.0
4269,0,4269,[302 603 187 427 180],90,5,18704,4.380327868852459,20.0,0.0
4270,0,4270,[ 56   8 276   7 515],474,5,18709,4.380472957152891,0.0,0.0
4271,0,4271,[302 603 187 427 180],666,5,18714,4.38061797752809,20.0,0.0
4272,0,4272,[302 603 187 427 180],90,5,18719,4.380762930025743,20.0,0.0
4273,0,4273,[  4 515  71 153  28],194,4,18723,4.380673841834347,0.0,0.0
4274,0,4274,[302 603 187 427 180],537,5,18728,4.380818713450292,20.0,0.0
4275,0,4275,[302 603 187 427 180],458,5,18733,4.380963517305894,20.0,0.0
4276,0,4276,[302 603 187 427 180],271,5,18738,4.381108253448679,20.0,0.0
4277,0,4277,[302 603 187 427 180],664,5,18743,4.381252921926134,20.0,0.0
4278,0,4278,[302 603 187 427 180],339,5,18748,4.381397522785697,20.0,0.0
4279,0,4279,[302 603 187 427 180],474,5,18753,4.381542056074767,20.0,0.0
4280,0,4280,[302 603 187 427 180],458,5,18758,4.381686521840692,20.0,0.0
4281,0,4281,[302 603 187 427 180],339,5,18763,4.38183092013078,20.0,0.0
4282,0,4282,[302 603 187 427 180],474,5,18768,4.381975250992295,20.0,0.0
4283,0,4283,[302 603 187 427 180],271,5,18773,4.382119514472456,20.0,0.0
4284,0,4284,[185 655 423 357 427],59,5,18778,4.382263710618436,20.0,0.0
4285,0,4285,[  1 186  89 118  50],59,4,18782,4.382174521698554,0.0,20.0
4286,0,4286,[313 318 168  25  95],537,3,18785,4.381852111033357,20.0,0.0
4287,0,4287,[302 603 187 427 180],458,5,18790,4.381996268656716,20.0,0.0
4288,0,4288,[302 603 187 427 180],13,5,18795,4.382140359058056,20.0,0.0
4289,0,4289,[302 603 187 427 180],664,5,18800,4.382284382284382,20.0,0.0
4290,0,4290,[228 258  69 318 211],774,2,18802,4.381729200652528,20.0,0.0
4291,0,4291,[403 200 179 210 588],843,1,18803,4.3809412861137,0.0,0.0
4292,0,4292,[288 496 322 515 174],804,4,18807,4.380852550663872,0.0,20.0
4293,0,4293,[302 603 187 427 180],537,5,18812,4.380996739636703,20.0,0.0
4294,0,4294,[302 603 187 427 180],13,5,18817,4.381140861466822,20.0,0.0
4295,0,4295,[435 161 174 117  64],899,4,18821,4.381052141527002,0.0,20.0
4296,0,4296,[302 603 187 427 180],666,5,18826,4.381196183383756,20.0,0.0
4297,0,4297,[302 603 187 427 180],339,5,18831,4.381340158213122,20.0,0.0
4298,0,4298,[302 603 187 427 180],458,5,18836,4.381484066061875,20.0,0.0
4299,0,4299,[100 678 187 202 427],664,4,18840,4.381395348837209,0.0,20.0
4300,0,4300,[302 603 187 427 180],666,5,18845,4.381539176935596,20.0,0.0
4301,0,4301,[302 603 187 427 180],474,5,18850,4.381682938168294,20.0,0.0
4302,0,4302,[ 28 174 471 546  25],378,3,18853,4.381361840576342,0.0,20.0
4303,0,4303,[302 603 187 427 180],339,5,18858,4.381505576208179,20.0,0.0
4304,0,4304,[269 265 603  82   7],339,4,18862,4.381416957026713,20.0,0.0
4305,0,4305,[265 176 186 174  96],308,4,18866,4.381328379006038,0.0,20.0
4306,0,4306,[302 603 187 427 180],90,5,18871,4.381472022289296,20.0,0.0
4307,0,4307,[302 603 187 427 180],90,5,18876,4.381615598885793,20.0,0.0
4308,0,4308,[302 603 187 427 180],13,5,18881,4.381759108841958,20.0,0.0
4309,0,4309,[302 603 187 427 180],90,5,18886,4.381902552204176,20.0,0.0
4310,0,4310,[302 603 187 427 180],339,5,18891,4.382045929018789,20.0,0.0
4311,0,4311,[200 185  70 183   9],7,4,18895,4.3819573283859,0.0,0.0
4312,0,4312,[302 603 187 427 180],474,5,18900,4.382100626014375,20.0,0.0
4313,0,4313,[302 603 187 427 180],474,5,18905,4.382243857209087,20.0,0.0
4314,0,4314,[302 603 187 427 180],664,5,18910,4.382387022016222,20.0,0.0
4315,0,4315,[ 56 257 357 144 127],650,1,18911,4.3816033364226135,20.0,20.0
4316,0,4316,[302 603 187 427 180],271,5,18916,4.381746583275422,20.0,0.0
4317,0,4317,[271 143 174 191 258],499,1,18917,4.380963408985641,0.0,20.0
4318,0,4318,[302 603 187 427 180],13,5,18922,4.381106737670757,20.0,0.0
4319,0,4319,[302 603 187 427 180],271,5,18927,4.38125,20.0,0.0
4320,0,4320,[302 603 187 427 180],90,5,18932,4.38139319601944,20.0,0.0
4321,0,4321,[302 603 187 427 180],458,5,18937,4.381536325775104,20.0,0.0
4322,0,4322,[323 275 546 121 174],119,5,18942,4.3816793893129775,0.0,20.0
4323,0,4323,[302 603 187 427 180],458,5,18947,4.381822386679001,20.0,0.0
4324,0,4324,[302 603 187 427 180],664,5,18952,4.381965317919075,20.0,0.0
4325,0,4325,[183 265 655  64 185],881,5,18957,4.3821081830790565,0.0,0.0
4326,0,4326,[ 82 211  79 191 294],125,4,18961,4.382019875202219,0.0,0.0
4327,0,4327,[302 603 187 427 180],271,5,18966,4.382162661737523,20.0,0.0
4328,0,4328,[211 328 144 186 546],788,3,18969,4.381843381843382,0.0,0.0
4329,0,4329,[302 603 187 427 180],339,5,18974,4.381986143187067,20.0,0.0
4330,0,4330,[161  98  28 125 183],648,3,18977,4.381667051489264,0.0,20.0
4331,0,4331,[302 603 187 427 180],271,5,18982,4.381809787626962,20.0,0.0
4332,0,4332,[302 603 187 427 180],537,5,18987,4.3819524578813756,20.0,0.0
4333,0,4333,[302 603 187 427 180],90,5,18992,4.382095062298108,20.0,0.0
4334,0,4334,[302 603 187 427 180],666,5,18997,4.382237600922722,20.0,0.0
4335,0,4335,[302 603 187 427 180],458,5,19002,4.382380073800738,20.0,0.0
4336,0,4336,[302 603 187 427 180],664,5,19007,4.382522480977634,20.0,0.0
4337,0,4337,[678 204 294 127  96],188,3,19010,4.38220378054403,0.0,20.0
4338,0,4338,[302 603 187 427 180],666,5,19015,4.382346162710302,20.0,0.0
4339,0,4339,[302 603 187 427 180],90,5,19020,4.382488479262673,20.0,0.0
4340,0,4340,[427 282 471  28 222],194,2,19022,4.3819396452430315,0.0,0.0
4341,0,4341,[174 271 302 258 210],871,5,19027,4.382081989866421,0.0,20.0
4342,0,4342,[ 79  11 172 179 216],537,1,19028,4.38130324660373,0.0,0.0
4343,0,4343,[302 603 187 427 180],13,5,19033,4.3814456721915285,20.0,0.0
4344,0,4344,[302 603 187 427 180],666,5,19038,4.381588032220944,20.0,0.0
4345,0,4345,[180  64 423 471 125],144,5,19043,4.381730326737229,0.0,0.0
4346,0,4346,[568 328 748 175 228],804,5,19048,4.381872555785599,0.0,0.0
4347,0,4347,[435 237  88 222 282],194,1,19049,4.381094756209752,0.0,0.0
4348,0,4348,[302 603 187 427 180],458,5,19054,4.381237065992182,20.0,0.0
4349,0,4349,[515  88 328 289 215],537,1,19055,4.380459770114943,0.0,0.0
4350,0,4350,[302 603 187 427 180],90,5,19060,4.3806021604228915,20.0,0.0
4351,0,4351,[302 603 187 427 180],474,5,19065,4.380744485294118,20.0,0.0
4352,0,4352,[211  88 183  69 435],694,5,19070,4.380886744773719,0.0,0.0
4353,0,4353,[302 603 187 427 180],90,5,19075,4.381028938906752,20.0,0.0
4354,0,4354,[302 603 187 427 180],339,5,19080,4.381171067738232,20.0,0.0
4355,0,4355,[144 183 211 161 265],234,1,19081,4.380394857667585,0.0,0.0
4356,0,4356,[ 22 144  69 127 568],263,5,19086,4.380537066789075,0.0,20.0
4357,0,4357,[302 603 187 427 180],666,5,19091,4.380679210647086,20.0,0.0
4358,0,4358,[196 143  88 471 117],207,2,19093,4.380133058040835,0.0,0.0
4359,0,4359,[302 603 187 427 180],339,5,19098,4.380275229357798,20.0,0.0
4360,0,4360,[ 12 100 496 196 237],892,5,19103,4.380417335473515,20.0,20.0
4361,0,4361,[302 603 187 427 180],664,5,19108,4.380559376432829,20.0,0.0
4362,0,4362,[302 603 187 427 180],271,5,19113,4.380701352280541,20.0,0.0
4363,0,4363,[588 210  28  15 385],479,2,19115,4.380155820348304,0.0,0.0
4364,0,4364,[302 603 187 427 180],458,5,19120,4.380297823596793,20.0,0.0
4365,0,4365,[302 603 187 427 180],271,5,19125,4.380439761795694,20.0,0.0
4366,0,4366,[302 603 187 427 180],458,5,19130,4.380581634989696,20.0,0.0
4367,0,4367,[  1 403  71  12 301],234,0,19130,4.379578754578755,20.0,0.0
4368,0,4368,[302 603 187 427 180],537,5,19135,4.379720759899291,20.0,0.0
4369,0,4369,[302 603 187 427 180],474,5,19140,4.379862700228833,20.0,0.0
4370,0,4370,[161  15  82 318  56],184,1,19141,4.379089453214368,20.0,0.0
4371,0,4371,[423 121  69 471  50],653,3,19144,4.3787740164684354,0.0,20.0
4372,0,4372,[302 603 187 427 180],664,5,19149,4.37891607592042,20.0,0.0
4373,0,4373,[215 655  71 238 196],804,5,19154,4.379058070416095,0.0,0.0
4374,0,4374,[302 603 187 427 180],474,5,19159,4.3792,20.0,0.0
4375,0,4375,[302 603 187 427 180],339,5,19164,4.379341864716636,20.0,0.0
4376,0,4376,[194 174 196 228 235],59,3,19167,4.379026730637423,0.0,20.0
4377,0,4377,[302 603 187 427 180],13,5,19172,4.379168570123344,20.0,0.0
4378,0,4378,[302 603 187 427 180],474,5,19177,4.379310344827586,20.0,0.0
4379,0,4379,[143  25  11 742 132],881,3,19180,4.378995433789954,0.0,0.0
4380,0,4380,[302 603 187 427 180],666,5,19185,4.379137183291486,20.0,0.0
4381,0,4381,[403 405 183  89 515],774,1,19186,4.378366042902784,0.0,0.0
4382,0,4382,[302 603 187 427 180],474,5,19191,4.378507871321013,20.0,0.0
4383,0,4383,[174 200 183 435 118],308,4,19195,4.3784215328467155,0.0,20.0
4384,0,4384,[302 603 187 427 180],13,5,19200,4.378563283922463,20.0,0.0
4385,0,4385,[ 28 275 300 471 483],7,5,19205,4.378704970360237,20.0,0.0
4386,0,4386,[302 603 187 427 180],90,5,19210,4.37884659220424,20.0,0.0
4387,0,4387,[302 603 187 427 180],458,5,19215,4.378988149498633,20.0,0.0
4388,0,4388,[302 603 187 427 180],664,5,19220,4.379129642287537,20.0,0.0
4389,0,4389,[302 603 187 427 180],474,5,19225,4.379271070615034,20.0,0.0
4390,0,4390,[172  71  97 471 275],7,5,19230,4.3794124345251655,0.0,0.0
4391,0,4391,[302 603 187 427 180],13,5,19235,4.379553734061931,20.0,0.0
4392,0,4392,[302 603 187 427 180],666,5,19240,4.379694969269292,20.0,0.0
4393,0,4393,[300 195 294  79 172],125,5,19245,4.37983614019117,0.0,0.0
4394,0,4394,[302 603 187 427 180],339,5,19250,4.379977246871444,20.0,0.0
4395,0,4395,[302 603 187 427 180],474,5,19255,4.380118289353958,20.0,0.0
4396,0,4396,[313  97 204 483  82],13,4,19259,4.380031839890835,20.0,0.0
4397,0,4397,[302 603 187 427 180],90,5,19264,4.380172805820828,20.0,0.0
4398,0,4398,[302 603 187 427 180],90,5,19269,4.380313707660832,20.0,0.0
4399,0,4399,[302 603 187 427 180],90,5,19274,4.380454545454546,20.0,0.0
4400,0,4400,[  1   8 405 194 238],458,4,19278,4.380368098159509,0.0,0.0
4401,0,4401,[302 603 187 427 180],664,5,19283,4.380508859609269,20.0,0.0
4402,0,4402,[302 603 187 427 180],666,5,19288,4.380649557120146,20.0,0.0
4403,0,4403,[302 603 187 427 180],90,5,19293,4.380790190735695,20.0,0.0
4404,0,4404,[196  71  97   8 143],13,4,19297,4.380703745743474,0.0,0.0
4405,0,4405,[302 603 187 427 180],666,5,19302,4.380844303222878,20.0,0.0
4406,0,4406,[302 603 187 427 180],537,5,19307,4.380984796914,20.0,0.0
4407,0,4407,[  7 182 235  82 258],378,5,19312,4.381125226860254,0.0,0.0
4408,0,4408,[302 603 187 427 180],13,5,19317,4.381265593105012,20.0,0.0
4409,0,4409,[302 603 187 427 180],664,5,19322,4.38140589569161,20.0,0.0
4410,0,4410,[302 603 187 427 180],666,5,19327,4.381546134663342,20.0,0.0
4411,0,4411,[302 603 187 427 180],90,5,19332,4.381686310063463,20.0,0.0
4412,0,4412,[271 215 144 546 179],479,1,19333,4.380920009064129,0.0,0.0
4413,0,4413,[302 603 187 427 180],474,5,19338,4.381060262800181,20.0,0.0
4414,0,4414,[210  96  11 143  98],346,3,19341,4.38074745186863,0.0,20.0
4415,0,4415,[568 265 202 186 191],804,5,19346,4.38088768115942,0.0,0.0
4416,0,4416,[302 603 187 427 180],13,5,19351,4.381027846954947,20.0,0.0
4417,0,4417,[471 568 276  98 161],378,4,19355,4.380941602535084,0.0,20.0
4418,0,4418,[302 603 187 427 180],90,5,19360,4.381081692690654,20.0,0.0
4419,0,4419,[302 603 187 427 180],458,5,19365,4.381221719457014,20.0,0.0
4420,0,4420,[302 603 187 427 180],13,5,19370,4.381361682877177,20.0,0.0
4421,0,4421,[ 12 135 258 186 508],774,0,19370,4.380370872908187,20.0,0.0
4422,0,4422,[302 603 187 427 180],90,5,19375,4.380510965408094,20.0,0.0
4423,0,4423,[302 603 187 427 180],537,5,19380,4.380650994575046,20.0,0.0
4424,0,4424,[228 238 180  71 268],85,3,19383,4.380338983050848,0.0,0.0
4425,0,4425,[302 603 187 427 180],271,5,19388,4.380478987799368,20.0,0.0
4426,0,4426,[302 603 187 427 180],271,5,19393,4.380618929297492,20.0,0.0
4427,0,4427,[173 515 357 318  22],892,5,19398,4.380758807588076,40.0,0.0
4428,0,4428,[302 143  98  11  89],474,5,19403,4.380898622713931,0.0,20.0
4429,0,4429,[423 328  22 100 271],788,4,19407,4.380812641083521,0.0,20.0
4430,0,4430,[302 603 187 427 180],271,5,19412,4.380952380952381,20.0,0.0
4431,0,4431,[302 603 187 427 180],339,5,19417,4.381092057761733,20.0,0.0
4432,0,4432,[385 276 127   4 186],308,5,19422,4.381231671554252,0.0,20.0
4433,0,4433,[179 271 258 183 318],537,3,19425,4.380920162381597,20.0,0.0
4434,0,4434,[302 603 187 427 180],666,5,19430,4.381059751972942,20.0,0.0
4435,0,4435,[323  22 265 235 286],59,3,19433,4.380748422001804,0.0,0.0
4436,0,4436,[195 546  56   4 187],833,3,19436,4.38043723236421,0.0,0.0
4437,0,4437,[ 56 215 403 172 132],311,5,19441,4.380576836412798,0.0,0.0
4438,0,4438,[302 603 187 427 180],666,5,19446,4.380716377562514,20.0,0.0
4439,0,4439,[302 603 187 427 180],271,5,19451,4.380855855855856,20.0,0.0
4440,0,4440,[302 603 187 427 180],458,5,19456,4.380995271335284,20.0,0.0
4441,0,4441,[302 603 187 427 180],474,5,19461,4.381134624043224,20.0,0.0
4442,0,4442,[ 70 238 471 125 237],653,0,19461,4.38014854827819,0.0,0.0
4443,0,4443,[302 603 187 427 180],664,5,19466,4.38028802880288,20.0,0.0
4444,0,4444,[302 603 187 427 180],90,5,19471,4.380427446569179,20.0,0.0
4445,0,4445,[302 603 187 427 180],666,5,19476,4.380566801619433,20.0,0.0
4446,0,4446,[302 603 187 427 180],458,5,19481,4.380706093995952,20.0,0.0
4447,0,4447,[302 603 187 427 180],664,5,19486,4.380845323741007,20.0,0.0
4448,0,4448,[ 70 588 568  97 238],7,4,19490,4.380759721285682,0.0,0.0
4449,0,4449,[302 603 187 427 180],90,5,19495,4.380898876404494,20.0,0.0
4450,0,4450,[302 603 187 427 180],271,5,19500,4.381037968995732,20.0,0.0
4451,0,4451,[302 603 187 427 180],537,5,19505,4.381176999101528,20.0,0.0
4452,0,4452,[127 204 180 318 423],653,4,19509,4.381091399056816,20.0,20.0
4453,0,4453,[423 127 275 202 235],343,5,19514,4.381230354737315,0.0,20.0
4454,0,4454,[202 197  89 176 265],653,2,19516,4.380695847362514,0.0,0.0
4455,0,4455,[302 603 187 427 180],458,5,19521,4.380834829443447,20.0,0.0
4456,0,4456,[302 603 187 427 180],537,5,19526,4.380973749158627,20.0,0.0
4457,0,4457,[302 603 187 427 180],271,5,19531,4.3811126065500225,20.0,0.0
4458,0,4458,[302 603 187 427 180],271,5,19536,4.381251401659565,20.0,0.0
4459,0,4459,[302 603 187 427 180],666,5,19541,4.381390134529148,20.0,0.0
4460,0,4460,[302 603 187 427 180],458,5,19546,4.381528805200627,20.0,0.0
4461,0,4461,[302 603 187 427 180],664,5,19551,4.381667413715823,20.0,0.0
4462,0,4462,[302 603 187 427 180],458,5,19556,4.381805960116513,20.0,0.0
4463,0,4463,[302 603 187 427 180],474,5,19561,4.381944444444445,20.0,0.0
4464,0,4464,[302 603 187 427 180],13,5,19566,4.382082866741321,20.0,0.0
4465,0,4465,[302 603 187 427 180],13,5,19571,4.382221227048813,20.0,0.0
4466,0,4466,[302 603 187 427 180],13,5,19576,4.3823595254085514,20.0,0.0
4467,0,4467,[282 294 403 385 186],788,1,19577,4.3816025067144135,0.0,0.0
4468,0,4468,[302 603 187 427 180],13,5,19582,4.381740881629,20.0,0.0
4469,0,4469,[302 603 187 427 180],13,5,19587,4.381879194630873,20.0,0.0
4470,0,4470,[302 603 187 427 180],90,5,19592,4.382017445761575,20.0,0.0
4471,0,4471,[302 603 187 427 180],474,5,19597,4.382155635062611,20.0,0.0
4472,0,4472,[302 603 187 427 180],474,5,19602,4.382293762575452,20.0,0.0
4473,0,4473,[168 222  25 603 515],650,4,19606,4.3822083147071975,20.0,0.0
4474,0,4474,[302 603 187 427 180],271,5,19611,4.382346368715083,20.0,0.0
4475,0,4475,[302 603 187 427 180],537,5,19616,4.3824843610366395,20.0,0.0
4476,0,4476,[302 603 187 427 180],458,5,19621,4.382622291713201,20.0,0.0
4477,0,4477,[302 603 187 427 180],90,5,19626,4.382760160786066,20.0,0.0
4478,0,4478,[302 603 187 427 180],271,5,19631,4.382897968296494,20.0,0.0
4479,0,4479,[302 603 187 427 180],474,5,19636,4.383035714285715,20.0,0.0
4480,0,4480,[302 603 187 427 180],339,5,19641,4.383173398794912,20.0,0.0
4481,0,4481,[302 603 187 427 180],271,5,19646,4.3833110218652385,20.0,0.0
4482,0,4482,[302 603 187 427 180],271,5,19651,4.38344858353781,20.0,0.0
4483,0,4483,[161 435 117   7 153],234,0,19651,4.382471008028546,0.0,0.0
4484,0,4484,[302 603 187 427 180],90,5,19656,4.3826086956521735,20.0,0.0
4485,0,4485,[423  64 216 275 515],95,4,19660,4.382523406152474,0.0,0.0
4486,0,4486,[302 603 187 427 180],666,5,19665,4.382661020726544,20.0,0.0
4487,0,4487,[ 50 568 161 496 515],643,4,19669,4.382575757575758,0.0,20.0
4488,0,4488,[302 603 187 427 180],339,5,19674,4.382713299175763,20.0,0.0
4489,0,4489,[302 603 187 427 180],666,5,19679,4.382850779510022,20.0,0.0
4490,0,4490,[302 603 187 427 180],458,5,19684,4.382988198619461,20.0,0.0
4491,0,4491,[302 603 187 427 180],271,5,19689,4.383125556544969,20.0,0.0
4492,0,4492,[302 603 187 427 180],664,5,19694,4.383262853327398,20.0,0.0
4493,0,4493,[302 603 187 427 180],339,5,19699,4.383400089007566,20.0,0.0
4494,0,4494,[302 603 187 427 180],13,5,19704,4.383537263626251,20.0,0.0
4495,0,4495,[302 603 187 427 180],13,5,19709,4.3836743772241995,20.0,0.0
4496,0,4496,[288 655 181  64 183],378,4,19713,4.383589059372915,0.0,0.0
4497,0,4497,[302 603 187 427 180],474,5,19718,4.383726100489106,20.0,0.0
4498,0,4498,[302 603 187 427 180],339,5,19723,4.383863080684597,20.0,0.0
4499,0,4499,[302 603 187 427 180],271,5,19728,4.384,20.0,0.0
4500,0,4500,[302 603 187 427 180],664,5,19733,4.384136858475895,20.0,0.0
4501,0,4501,[302 603 187 427 180],666,5,19738,4.384273656152821,20.0,0.0
4502,0,4502,[302 603 187 427 180],90,5,19743,4.384410393071286,20.0,0.0
4503,0,4503,[194 423 180  22 186],774,1,19744,4.383658969804618,0.0,0.0
4504,0,4504,[185 216 222 182 143],650,3,19747,4.383351831298557,0.0,0.0
4505,0,4505,[302 603 187 427 180],474,5,19752,4.383488681757656,20.0,0.0
4506,0,4506,[143 427 228 515 300],13,2,19754,4.382959840248502,0.0,0.0
4507,0,4507,[144 302 135 483 237],454,3,19757,4.38265306122449,20.0,0.0
4508,0,4508,[302 603 187 427 180],90,5,19762,4.3827899756043465,20.0,0.0
4509,0,4509,[318 153 195  56 185],194,3,19765,4.382483370288249,20.0,0.0
4510,0,4510,[475 174 191 183  64],207,3,19768,4.382176900908889,0.0,20.0
4511,0,4511,[302 603 187 427 180],537,5,19773,4.382313829787234,20.0,0.0
4512,0,4512,[302 603 187 427 180],664,5,19778,4.382450697983603,20.0,0.0
4513,0,4513,[302 603 187 427 180],474,5,19783,4.382587505538325,20.0,0.0
4514,0,4514,[302 603 187 427 180],666,5,19788,4.382724252491695,20.0,0.0
4515,0,4515,[302 603 187 427 180],474,5,19793,4.382860938883968,20.0,0.0
4516,0,4516,[ 56 323 496 175   4],804,4,19797,4.382776178879787,0.0,0.0
4517,0,4517,[180 288 202  28 427],59,5,19802,4.382912793271359,0.0,0.0
4518,0,4518,[302 603 187 427 180],474,5,19807,4.383049347200708,20.0,0.0
4519,0,4519,[302 603 187 427 180],664,5,19812,4.383185840707965,20.0,0.0
4520,0,4520,[483  79 322 180 546],234,1,19813,4.382437513824375,20.0,0.0
4521,0,4521,[302 603 187 427 180],271,5,19818,4.382574082264485,20.0,0.0
4522,0,4522,[302 603 187 427 180],13,5,19823,4.382710590316162,20.0,0.0
4523,0,4523,[333 215 153  69 194],144,4,19827,4.38262599469496,0.0,0.0
4524,0,4524,[ 98 200   7 405 143],92,2,19829,4.382099447513812,0.0,20.0
4525,0,4525,[515 313  12 234   1],883,3,19832,4.38179407865665,20.0,0.0
4526,0,4526,[302 603 187 427 180],666,5,19837,4.381930638391871,20.0,0.0
4527,0,4527,[302 603 187 427 180],271,5,19842,4.382067137809187,20.0,0.0
4528,0,4528,[302 603 187 427 180],13,5,19847,4.3822035769485534,20.0,0.0
4529,0,4529,[302 603 187 427 180],664,5,19852,4.38233995584989,20.0,0.0
4530,0,4530,[302 603 187 427 180],90,5,19857,4.3824762745530785,20.0,0.0
4531,0,4531,[302 603 187 427 180],537,5,19862,4.38261253309797,20.0,0.0
4532,0,4532,[175 200 588 496 194],378,3,19865,4.382307522611956,0.0,0.0
4533,0,4533,[302 603 187 427 180],664,5,19870,4.382443758270843,20.0,0.0
4534,0,4534,[302 603 187 427 180],13,5,19875,4.38257993384785,20.0,0.0
4535,0,4535,[302 603 187 427 180],664,5,19880,4.382716049382716,20.0,0.0
4536,0,4536,[234 496 186 273 182],64,4,19884,4.382631694952612,0.0,0.0
4537,0,4537,[302 603 187 427 180],13,5,19889,4.382767739092111,20.0,0.0
4538,0,4538,[302 603 187 427 180],664,5,19894,4.382903723287067,20.0,0.0
4539,0,4539,[302 603 187 427 180],13,5,19899,4.3830396475770925,20.0,0.0
4540,0,4540,[302 603 187 427 180],537,5,19904,4.3831755120017615,20.0,0.0
4541,0,4541,[211 496 234  56 204],538,3,19907,4.382870981946279,0.0,0.0
4542,0,4542,[144  88  12 153 357],398,4,19911,4.382786704820603,40.0,0.0
4543,0,4543,[237   1  11 515 357],121,4,19915,4.382702464788732,20.0,0.0
4544,0,4544,[200 210 322 234  82],308,3,19918,4.382398239823982,0.0,0.0
4545,0,4545,[301   9 313 121 275],145,2,19920,4.3818741750989885,0.0,0.0
4546,0,4546,[173 215 172 183 132],346,3,19923,4.381570266109523,0.0,0.0
4547,0,4547,[216 135 215 228 318],479,3,19926,4.381266490765172,20.0,0.0
4548,0,4548,[302 603 187 427 180],537,5,19931,4.381402506045284,20.0,0.0
4549,0,4549,[302 603 187 427 180],458,5,19936,4.381538461538462,20.0,0.0
4550,0,4550,[302 603 187 427 180],664,5,19941,4.381674357284114,20.0,0.0
4551,0,4551,[313 496 200 655 276],308,3,19944,4.381370826010545,0.0,0.0
4552,0,4552,[302 603 187 427 180],664,5,19949,4.38150669887986,20.0,0.0
4553,0,4553,[302 603 187 427 180],664,5,19954,4.381642512077295,20.0,0.0
4554,0,4554,[302 603 187 427 180],474,5,19959,4.381778265642152,20.0,0.0
4555,0,4555,[302 603 187 427 180],458,5,19964,4.381913959613696,20.0,0.0
4556,0,4556,[302 603 187 427 180],339,5,19969,4.382049594031161,20.0,0.0
4557,0,4557,[302 603 187 427 180],458,5,19974,4.382185168933743,20.0,0.0
4558,0,4558,[302 603 187 427 180],537,5,19979,4.3823206843606055,20.0,0.0
4559,0,4559,[546 181 234 174 483],60,5,19984,4.382456140350877,20.0,20.0
4560,0,4560,[427 195 186 258 568],85,1,19985,4.3817145362859025,0.0,0.0
4561,0,4561,[168 282 423 111 127],533,5,19990,4.381850065760632,0.0,20.0
4562,0,4562,[302 603 187 427 180],90,5,19995,4.3819855358316895,20.0,0.0
4563,0,4563,[302 603 187 427 180],537,5,20000,4.382120946538125,20.0,0.0
4564,0,4564,[302 603 187 427 180],666,5,20005,4.382256297918948,20.0,0.0
4565,0,4565,[302 603 187 427 180],474,5,20010,4.382391590013141,20.0,0.0
4566,0,4566,[302 603 187 427 180],474,5,20015,4.382526822859646,20.0,0.0
4567,0,4567,[302 603 187 427 180],474,5,20020,4.382661996497373,20.0,0.0
4568,0,4568,[302 603 187 427 180],537,5,20025,4.382797110965201,20.0,0.0
4569,0,4569,[100 161 515   9 197],932,4,20029,4.382713347921225,0.0,20.0
4570,0,4570,[302 603 187 427 180],458,5,20034,4.382848392036753,20.0,0.0
4571,0,4571,[302 603 187 427 180],664,5,20039,4.382983377077865,20.0,0.0
4572,0,4572,[302 603 187 427 180],666,5,20044,4.383118303083315,20.0,0.0
4573,0,4573,[302 603 187 427 180],339,5,20049,4.383253170091823,20.0,0.0
4574,0,4574,[302 603 187 427 180],13,5,20054,4.383387978142077,20.0,0.0
4575,0,4575,[  1 405 385 237 135],42,5,20059,4.3835227272727275,0.0,0.0
4576,0,4576,[302 603 187 427 180],339,5,20064,4.383657417522395,20.0,0.0
4577,0,4577,[210 195 186 403 273],346,3,20067,4.383355176933159,0.0,0.0
4578,0,4578,[302 603 187 427 180],339,5,20072,4.383489844944311,20.0,0.0
4579,0,4579,[294   7 135 143  95],200,5,20077,4.383624454148472,0.0,0.0
4580,0,4580,[ 79 237 423 568 357],194,1,20078,4.382885832787601,20.0,0.0
4581,0,4581,[302 603 187 427 180],458,5,20083,4.383020515058926,20.0,0.0
4582,0,4582,[181 313   7 168 265],92,5,20088,4.383155138555531,0.0,0.0
4583,0,4583,[302 603 187 427 180],666,5,20093,4.3832897033158815,20.0,0.0
4584,0,4584,[302 603 187 427 180],537,5,20098,4.383424209378408,20.0,0.0
4585,0,4585,[302 603 187 427 180],90,5,20103,4.383558656781509,20.0,0.0
4586,0,4586,[302 603 187 427 180],458,5,20108,4.383693045563549,20.0,0.0
4587,0,4587,[302 603 187 427 180],474,5,20113,4.383827375762859,20.0,0.0
4588,0,4588,[302 603 187 427 180],537,5,20118,4.383961647417738,20.0,0.0
4589,0,4589,[313 222 318 597 273],13,1,20119,4.38322440087146,20.0,0.0
4590,0,4590,[302 603 187 427 180],537,5,20124,4.383358745371379,20.0,0.0
4591,0,4591,[302 603 187 427 180],666,5,20129,4.383493031358885,20.0,0.0
4592,0,4592,[302 603 187 427 180],458,5,20134,4.383627258872197,20.0,0.0
4593,0,4593,[302 603 187 427 180],271,5,20139,4.3837614279495,20.0,0.0
4594,0,4594,[ 25  82 125  15 215],749,5,20144,4.383895538628945,0.0,0.0
4595,0,4595,[302 603 187 427 180],666,5,20149,4.384029590948651,20.0,0.0
4596,0,4596,[597 228 222 174 153],102,2,20151,4.383510985425278,0.0,20.0
4597,0,4597,[302 603 187 427 180],90,5,20156,4.3836450630709,20.0,0.0
4598,0,4598,[302 603 187 427 180],458,5,20161,4.3837790824092195,20.0,0.0
4599,0,4599,[302 603 187 427 180],13,5,20166,4.383913043478261,20.0,0.0
4600,0,4600,[568  88 194 216 100],881,3,20169,4.383612258204738,0.0,20.0
4601,0,4601,[302 603 187 427 180],664,5,20174,4.383746197305519,20.0,0.0
4602,0,4602,[302 603 187 427 180],271,5,20179,4.383880078209863,20.0,0.0
4603,0,4603,[302 603 187 427 180],13,5,20184,4.384013900955691,20.0,0.0
4604,0,4604,[183 328 405 475 215],92,3,20187,4.38371335504886,0.0,0.0
4605,0,4605,[302 603 187 427 180],666,5,20192,4.38384715588363,20.0,0.0
4606,0,4606,[302 603 187 427 180],664,5,20197,4.383980898632516,20.0,0.0
4607,0,4607,[257 181 597 323 546],548,5,20202,4.384114583333333,0.0,0.0
4608,0,4608,[302 603 187 427 180],458,5,20207,4.384248210023866,20.0,0.0
4609,0,4609,[302 603 187 427 180],458,5,20212,4.384381778741865,20.0,0.0
4610,0,4610,[302 603 187 427 180],537,5,20217,4.384515289525049,20.0,0.0
4611,0,4611,[173  25  96 168 181],42,3,20220,4.384215091066782,0.0,0.0
4612,0,4612,[238   4 318 515 183],666,5,20225,4.384348580099719,20.0,0.0
4613,0,4613,[302 603 187 427 180],474,5,20230,4.384482011270047,20.0,0.0
4614,0,4614,[302 603 187 427 180],271,5,20235,4.384615384615385,20.0,0.0
4615,0,4615,[ 89  56 191 265 176],686,4,20239,4.384532062391681,0.0,0.0
4616,0,4616,[118 117 496 173   7],892,5,20244,4.3846653671215075,0.0,0.0
4617,0,4617,[175 597 202 313  28],653,3,20247,4.384365526201819,0.0,0.0
4618,0,4618,[302 603 187 427 180],474,5,20252,4.384498809266075,20.0,0.0
4619,0,4619,[748 185  96 144 403],749,4,20256,4.384415584415584,0.0,0.0
4620,0,4620,[ 64   1 125  98 258],378,4,20260,4.384332395585371,0.0,20.0
4621,0,4621,[302 603 187 427 180],90,5,20265,4.384465599307659,20.0,0.0
4622,0,4622,[603  98 135 318 127],233,5,20270,4.384598745403418,40.0,40.0
4623,0,4623,[  9 144 135   4   1],308,4,20274,4.384515570934256,0.0,0.0
4624,0,4624,[302 603 187 427 180],666,5,20279,4.384648648648649,20.0,0.0
4625,0,4625,[258 333  71 237 423],64,2,20281,4.384133160397752,0.0,0.0
4626,0,4626,[172  69 196 125 234],378,3,20284,4.383834017722066,0.0,0.0
4627,0,4627,[302 603 187 427 180],537,5,20289,4.383967156439066,20.0,0.0
4628,0,4628,[302 603 187 427 180],339,5,20294,4.384100237632318,20.0,0.0
4629,0,4629,[302 603 187 427 180],537,5,20299,4.384233261339093,20.0,0.0
4630,0,4630,[302 603 187 427 180],90,5,20304,4.384366227596631,20.0,0.0
4631,0,4631,[302 603 187 427 180],90,5,20309,4.384499136442142,20.0,0.0
4632,0,4632,[302 603 187 427 180],537,5,20314,4.384631987912799,20.0,0.0
4633,0,4633,[257  69  96 183 181],815,4,20318,4.384548985757445,0.0,0.0
4634,0,4634,[302 603 187 427 180],271,5,20323,4.384681769147789,20.0,0.0
4635,0,4635,[161 237 202 183 238],184,3,20326,4.384383088869715,0.0,0.0
4636,0,4636,[302 603 187 427 180],666,5,20331,4.384515850765581,20.0,0.0
4637,0,4637,[302 603 187 427 180],271,5,20336,4.3846485554118155,20.0,0.0
4638,0,4638,[302 603 187 427 180],90,5,20341,4.384781202845441,20.0,0.0
4639,0,4639,[302 603 187 427 180],666,5,20346,4.384913793103448,20.0,0.0
4640,0,4640,[275  22 183 216  89],378,5,20351,4.385046326222797,0.0,0.0
4641,0,4641,[302 603 187 427 180],90,5,20356,4.3851788022404135,20.0,0.0
4642,0,4642,[135  71 210 288 234],374,5,20361,4.385311221193194,0.0,0.0
4643,0,4643,[302 603 187 427 180],664,5,20366,4.385443583118001,20.0,0.0
4644,0,4644,[302 603 187 427 180],666,5,20371,4.385575888051669,20.0,0.0
4645,0,4645,[235 322 211 117 289],328,3,20374,4.385277658200603,0.0,0.0
4646,0,4646,[302 603 187 427 180],271,5,20379,4.385409941897999,20.0,0.0
4647,0,4647,[302 603 187 427 180],664,5,20384,4.385542168674699,20.0,0.0
4648,0,4648,[302 603 187 427 180],664,5,20389,4.3856743385674335,20.0,0.0
4649,0,4649,[276 200 228 271   4],92,3,20392,4.385376344086022,0.0,0.0
4650,0,4650,[302 603 187 427 180],458,5,20397,4.385508492797248,20.0,0.0
4651,0,4651,[302 603 187 427 180],537,5,20402,4.385640584694755,20.0,0.0
4652,0,4652,[302 603 187 427 180],666,5,20407,4.385772619815173,20.0,0.0
4653,0,4653,[302 603 187 427 180],13,5,20412,4.385904598195101,20.0,0.0
4654,0,4654,[588  96 132   8   7],881,2,20414,4.385392051557465,0.0,0.0
4655,0,4655,[302 603 187 427 180],271,5,20419,4.385524054982818,20.0,0.0
4656,0,4656,[302 603 187 427 180],666,5,20424,4.3856560017178445,20.0,0.0
4657,0,4657,[151 200 202 100 301],234,2,20426,4.385143838557321,0.0,20.0
4658,0,4658,[302 603 187 427 180],458,5,20431,4.385275810259713,20.0,0.0
4659,0,4659,[302 603 187 427 180],666,5,20436,4.385407725321889,20.0,0.0
4660,0,4660,[191 195 186 403 182],7,5,20441,4.385539583780305,0.0,0.0
4661,0,4661,[302 603 187 427 180],458,5,20446,4.385671385671386,20.0,0.0
4662,0,4662,[282 597  12 271  22],144,4,20450,4.385588676817499,20.0,0.0
4663,0,4663,[302 603 187 427 180],90,5,20455,4.385720411663808,20.0,0.0
4664,0,4664,[302 603 187 427 180],474,5,20460,4.385852090032154,20.0,0.0
4665,0,4665,[204 238  22 197 678],454,3,20463,4.385555079297043,0.0,0.0
4666,0,4666,[121 197 357 655  98],311,5,20468,4.385686736661667,20.0,20.0
4667,0,4667,[302 603 187 427 180],664,5,20473,4.385818337617824,20.0,0.0
4668,0,4668,[ 56 161 194 423 216],60,5,20478,4.385949882201756,0.0,0.0
4669,0,4669,[568 191 269 121  95],738,3,20481,4.385653104925053,0.0,0.0
4670,0,4670,[302 603 187 427 180],339,5,20486,4.385784628559195,20.0,0.0
4671,0,4671,[  8 313 183 234   1],234,4,20490,4.38570205479452,0.0,0.0
4672,0,4672,[302 603 187 427 180],474,5,20495,4.385833511662743,20.0,0.0
4673,0,4673,[568 210  50  89  79],378,5,20500,4.385964912280702,0.0,20.0
4674,0,4674,[302 603 187 427 180],537,5,20505,4.386096256684492,20.0,0.0
4675,0,4675,[197 237 179 288  88],215,3,20508,4.385799828913601,0.0,0.0
4676,0,4676,[302 603 187 427 180],666,5,20513,4.38593115244815,20.0,0.0
4677,0,4677,[302 603 187 427 180],537,5,20518,4.386062419837537,20.0,0.0
4678,0,4678,[302 603 187 427 180],458,5,20523,4.38619363111776,20.0,0.0
4679,0,4679,[302 603 187 427 180],339,5,20528,4.386324786324787,20.0,0.0
4680,0,4680,[435 742   4  79  95],271,4,20532,4.38624225592822,0.0,0.0
4681,0,4681,[100  69 143  88 265],650,3,20535,4.385946176847501,0.0,20.0
4682,0,4682,[302 603 187 427 180],474,5,20540,4.386077300875507,20.0,0.0
4683,0,4683,[302 603 187 427 180],90,5,20545,4.386208368915457,20.0,0.0
4684,0,4684,[385 211  64 183 181],387,3,20548,4.385912486659552,0.0,0.0
4685,0,4685,[ 97 185 568 288 197],308,3,20551,4.385616730687153,0.0,0.0
4686,0,4686,[302 603 187 427 180],90,5,20556,4.385747813100064,20.0,0.0
4687,0,4687,[302 603 187 427 180],666,5,20561,4.385878839590443,20.0,0.0
4688,0,4688,[135 403 323 210 183],87,3,20564,4.3855832800170615,0.0,0.0
4689,0,4689,[302 603 187 427 180],474,5,20569,4.385714285714286,20.0,0.0
4690,0,4690,[302 603 187 427 180],474,5,20574,4.385845235557451,20.0,0.0
4691,0,4691,[302 603 187 427 180],271,5,20579,4.385976129582268,20.0,0.0
4692,0,4692,[185 323 121 174 210],13,2,20581,4.38546771787769,0.0,20.0
4693,0,4693,[302 603 187 427 180],474,5,20586,4.385598636557307,20.0,0.0
4694,0,4694,[302 603 187 427 180],458,5,20591,4.385729499467518,20.0,0.0
4695,0,4695,[151 183   1 121 515],95,5,20596,4.385860306643952,0.0,0.0
4696,0,4696,[185 483 678 234 168],881,2,20598,4.385352352565468,20.0,0.0
4697,0,4697,[302 603 187 427 180],537,5,20603,4.385483184333759,20.0,0.0
4698,0,4698,[508 288  25 174  82],387,3,20606,4.385188337944244,0.0,20.0
4699,0,4699,[302 603 187 427 180],13,5,20611,4.38531914893617,20.0,0.0
4700,0,4700,[302 603 187 427 180],474,5,20616,4.385449904275686,20.0,0.0
4701,0,4701,[302 603 187 427 180],458,5,20621,4.3855806039982985,20.0,0.0
4702,0,4702,[302 603 187 427 180],90,5,20626,4.3857112481394855,20.0,0.0
4703,0,4703,[302 603 187 427 180],458,5,20631,4.385841836734694,20.0,0.0
4704,0,4704,[ 88 546  82 655 483],643,2,20633,4.385334750265675,20.0,0.0
4705,0,4705,[222 228 125   1 234],64,4,20637,4.3852528686782835,0.0,0.0
4706,0,4706,[302 603 187 427 180],90,5,20642,4.385383471425537,20.0,0.0
4707,0,4707,[302 603 187 427 180],90,5,20647,4.385514018691588,20.0,0.0
4708,0,4708,[471 210 328 194 403],653,2,20649,4.385007432575918,0.0,0.0
4709,0,4709,[302 603 187 427 180],13,5,20654,4.385138004246285,20.0,0.0
4710,0,4710,[222 211 127  95 257],479,5,20659,4.385268520483974,0.0,20.0
4711,0,4711,[258 132 151 508 180],474,3,20662,4.384974533106961,0.0,0.0
4712,0,4712,[238 655 742 183 179],749,4,20666,4.384892849565033,0.0,0.0
4713,0,4713,[302 603 187 427 180],474,5,20671,4.385023334747561,20.0,0.0
4714,0,4714,[302 603 187 427 180],13,5,20676,4.3851537645811245,20.0,0.0
4715,0,4715,[302 603 187 427 180],90,5,20681,4.385284139100933,20.0,0.0
4716,0,4716,[302 603 187 427 180],537,5,20686,4.385414458342167,20.0,0.0
4717,0,4717,[302 603 187 427 180],13,5,20691,4.385544722339975,20.0,0.0
4718,0,4718,[302 603 187 427 180],271,5,20696,4.3856749311294765,20.0,0.0
4719,0,4719,[302 603 187 427 180],90,5,20701,4.385805084745763,20.0,0.0
4720,0,4720,[202 568 423 357 228],648,4,20705,4.385723363694132,20.0,0.0
4721,0,4721,[302 603 187 427 180],474,5,20710,4.38585345192715,20.0,0.0
4722,0,4722,[181 222 143 265  70],234,0,20710,4.38492483590938,0.0,0.0
4723,0,4723,[182 273 175 603 210],64,2,20712,4.384419983065199,20.0,0.0
4724,0,4724,[302 603 187 427 180],90,5,20717,4.384550264550264,20.0,0.0
4725,0,4725,[302 603 187 427 180],458,5,20722,4.384680490901396,20.0,0.0
4726,0,4726,[302 603 187 427 180],474,5,20727,4.384810662153586,20.0,0.0
4727,0,4727,[302 603 187 427 180],90,5,20732,4.384940778341794,20.0,0.0
4728,0,4728,[302 603 187 427 180],537,5,20737,4.385070839500951,20.0,0.0
4729,0,4729,[302 603 187 427 180],666,5,20742,4.385200845665962,20.0,0.0
4730,0,4730,[302 603 187 427 180],271,5,20747,4.385330796871697,20.0,0.0
4731,0,4731,[173 427 210 313  50],499,3,20750,4.3850380388841925,0.0,20.0
4732,0,4732,[127 237 385 151 185],749,3,20753,4.384745404605958,0.0,20.0
4733,0,4733,[183 202  69 271 275],64,4,20757,4.38466413181242,0.0,0.0
4734,0,4734,[186 258  98 144 515],343,5,20762,4.384794086589229,0.0,20.0
4735,0,4735,[405 191 496 161 483],334,2,20764,4.38429054054054,20.0,0.0
4736,0,4736,[655 483 204 216 588],311,5,20769,4.384420519316023,20.0,0.0
4737,0,4737,[215 403  97 118 228],311,4,20773,4.384339383706205,0.0,0.0
4738,0,4738,[302 603 187 427 180],13,5,20778,4.38446929732011,20.0,0.0
4739,0,4739,[302 603 187 427 180],13,5,20783,4.384599156118144,20.0,0.0
4740,0,4740,[302 603 187 427 180],474,5,20788,4.384728960134993,20.0,0.0
4741,0,4741,[302 603 187 427 180],474,5,20793,4.384858709405314,20.0,0.0
4742,0,4742,[172 237 423 435  95],749,3,20796,4.384566729917774,0.0,0.0
4743,0,4743,[302 603 187 427 180],664,5,20801,4.384696458684655,20.0,0.0
4744,0,4744,[302 603 187 427 180],666,5,20806,4.384826132771338,20.0,0.0
4745,0,4745,[302 603 187 427 180],13,5,20811,4.384955752212389,20.0,0.0
4746,0,4746,[302 603 187 427 180],474,5,20816,4.385085317042343,20.0,0.0
4747,0,4747,[302 603 187 427 180],13,5,20821,4.385214827295703,20.0,0.0
4748,0,4748,[302 603 187 427 180],666,5,20826,4.3853442830069485,20.0,0.0
4749,0,4749,[302 603 187 427 180],458,5,20831,4.385473684210527,20.0,0.0
4750,0,4750,[302 603 187 427 180],13,5,20836,4.385603030940855,20.0,0.0
4751,0,4751,[302 603 187 427 180],271,5,20841,4.3857323232323235,20.0,0.0
4752,0,4752,[302 603 187 427 180],271,5,20846,4.3858615611192935,20.0,0.0
4753,0,4753,[176 216 181 173 385],379,4,20850,4.385780395456457,0.0,0.0
4754,0,4754,[302 603 187 427 180],664,5,20855,4.385909568874869,20.0,0.0
4755,0,4755,[258  50 318   7  28],537,4,20859,4.385828427249789,20.0,20.0
4756,0,4756,[302 603 187 427 180],458,5,20864,4.38595753626235,20.0,0.0
4757,0,4757,[288 176 215 117 187],537,1,20865,4.385245901639344,0.0,0.0
4758,0,4758,[546 195 655 185   1],194,3,20868,4.384954822441689,0.0,0.0
4759,0,4759,[215   7 132  22 357],7,5,20873,4.385084033613445,20.0,0.0
4760,0,4760,[302 603 187 427 180],537,5,20878,4.385213190506196,20.0,0.0
4761,0,4761,[302 603 187 427 180],474,5,20883,4.385342293154137,20.0,0.0
4762,0,4762,[302 603 187 427 180],13,5,20888,4.385471341591434,20.0,0.0
4763,0,4763,[286 111  79 222 300],234,0,20888,4.384550797649035,0.0,0.0
4764,0,4764,[204 257  50 200 121],795,0,20888,4.383630640083945,0.0,20.0
4765,0,4765,[427 423 742 403 568],59,4,20892,4.383550146873689,0.0,0.0
4766,0,4766,[302 603 187 427 180],666,5,20897,4.383679462974617,20.0,0.0
4767,0,4767,[385 678 179  25 100],749,2,20899,4.3831795302013425,0.0,20.0
4768,0,4768,[302 603 187 427 180],13,5,20904,4.383308869784022,20.0,0.0
4769,0,4769,[ 22 210 111 143 182],454,3,20907,4.3830188679245285,0.0,0.0
4770,0,4770,[275 135  70  15 210],537,3,20910,4.3827289876336195,0.0,0.0
4771,0,4771,[181  69 202 118  28],188,1,20911,4.382020117351216,0.0,0.0
4772,0,4772,[302 603 187 427 180],458,5,20916,4.382149591451917,20.0,0.0
4773,0,4773,[302 603 187 427 180],13,5,20921,4.38227901131127,20.0,0.0
4774,0,4774,[302 603 187 427 180],664,5,20926,4.382408376963351,20.0,0.0
4775,0,4775,[546 742  15 204 172],554,3,20929,4.382118927973199,0.0,0.0
4776,0,4776,[483 228 161 235 471],13,3,20932,4.381829600167469,20.0,0.0
4777,0,4777,[ 70 237 742 174 655],454,3,20935,4.381540393470071,0.0,20.0
4778,0,4778,[302 603 187 427 180],537,5,20940,4.381669805398619,20.0,0.0
4779,0,4779,[302 603 187 427 180],339,5,20945,4.381799163179917,20.0,0.0
4780,0,4780,[302 603 187 427 180],458,5,20950,4.38192846684794,20.0,0.0
4781,0,4781,[302 603 187 427 180],474,5,20955,4.382057716436638,20.0,0.0
4782,0,4782,[302 603 187 427 180],537,5,20960,4.382186911979929,20.0,0.0
4783,0,4783,[302 603 187 427 180],474,5,20965,4.382316053511706,20.0,0.0
4784,0,4784,[174 186  88 228  25],343,4,20969,4.382236154649948,0.0,20.0
4785,0,4785,[  9 300 323 237  25],90,3,20972,4.381947346427079,0.0,0.0
4786,0,4786,[302 603 187 427 180],90,5,20977,4.382076457071235,20.0,0.0
4787,0,4787,[302 603 187 427 180],339,5,20982,4.382205513784461,20.0,0.0
4788,0,4788,[194 151 183 435 187],59,4,20986,4.382125704740029,0.0,0.0
4789,0,4789,[302 603 187 427 180],13,5,20991,4.382254697286013,20.0,0.0
4790,0,4790,[302 603 187 427 180],664,5,20996,4.382383635984137,20.0,0.0
4791,0,4791,[302 603 187 427 180],90,5,21001,4.382512520868113,20.0,0.0
4792,0,4792,[ 95 276   7 357 286],537,3,21004,4.382224076778636,20.0,0.0
4793,0,4793,[276 172 238 153 176],234,0,21004,4.3813099707968295,0.0,0.0
4794,0,4794,[302 603 187 427 180],339,5,21009,4.381438998957247,20.0,0.0
4795,0,4795,[302 603 187 427 180],271,5,21014,4.381567973311093,20.0,0.0
4796,0,4796,[302 603 187 427 180],666,5,21019,4.381696893892016,20.0,0.0
4797,0,4797,[153 237   4 318 568],92,3,21022,4.381408920383493,20.0,0.0
4798,0,4798,[302 603 187 427 180],90,5,21027,4.381537820379246,20.0,0.0
4799,0,4799,[302 603 187 427 180],537,5,21032,4.381666666666667,20.0,0.0
4800,0,4800,[302 603 187 427 180],339,5,21037,4.381795459279317,20.0,0.0
4801,0,4801,[302 603 187 427 180],664,5,21042,4.381924198250728,20.0,0.0
4802,0,4802,[302 603 187 427 180],13,5,21047,4.382052883614407,20.0,0.0
4803,0,4803,[302 603 187 427 180],339,5,21052,4.38218151540383,20.0,0.0
4804,0,4804,[302 603 187 427 180],13,5,21057,4.382310093652445,20.0,0.0
4805,0,4805,[302 603 187 427 180],537,5,21062,4.3824386183936745,20.0,0.0
4806,0,4806,[302 603 187 427 180],666,5,21067,4.3825670896609115,20.0,0.0
4807,0,4807,[121 181 161 153   4],210,5,21072,4.3826955074875205,0.0,0.0
4808,0,4808,[132 118 180 211 210],882,5,21077,4.382823871906841,0.0,0.0
4809,0,4809,[302 603 187 427 180],458,5,21082,4.382952182952183,20.0,0.0
4810,0,4810,[568 222 216 180 181],882,5,21087,4.383080440656828,0.0,0.0
4811,0,4811,[302 603 187 427 180],90,5,21092,4.383208645054031,20.0,0.0
4812,0,4812,[302 603 187 427 180],664,5,21097,4.38333679617702,20.0,0.0
4813,0,4813,[302 603 187 427 180],339,5,21102,4.383464894058995,20.0,0.0
4814,0,4814,[265 245 275 180 403],378,3,21105,4.383177570093458,0.0,0.0
4815,0,4815,[302 603 187 427 180],458,5,21110,4.3833056478405314,20.0,0.0
4816,0,4816,[302 603 187 427 180],664,5,21115,4.383433672410214,20.0,0.0
4817,0,4817,[302 603 187 427 180],13,5,21120,4.383561643835616,20.0,0.0
4818,0,4818,[568 300  89 427 202],13,3,21123,4.383274538285951,0.0,0.0
4819,0,4819,[100 216  15 195 678],308,2,21125,4.382780082987552,0.0,20.0
4820,0,4820,[302 603 187 427 180],458,5,21130,4.38290811035055,20.0,0.0
4821,0,4821,[302 603 187 427 180],458,5,21135,4.383036084612194,20.0,0.0
4822,0,4822,[302 603 187 427 180],13,5,21140,4.383164005805515,20.0,0.0
4823,0,4823,[546 568 216 176  71],804,4,21144,4.383084577114428,0.0,0.0
4824,0,4824,[302 603 187 427 180],458,5,21149,4.383212435233161,20.0,0.0
4825,0,4825,[302 603 187 427 180],537,5,21154,4.383340240364691,20.0,0.0
4826,0,4826,[302 603 187 427 180],271,5,21159,4.383467992541951,20.0,0.0
4827,0,4827,[204 435  25   7  11],666,3,21162,4.383181441590721,0.0,0.0
4828,0,4828,[302 603 187 427 180],13,5,21167,4.383309173741975,20.0,0.0
4829,0,4829,[302 603 187 427 180],271,5,21172,4.38343685300207,20.0,0.0
4830,0,4830,[302 603 187 427 180],90,5,21177,4.38356447940385,20.0,0.0
4831,0,4831,[302 603 187 427 180],271,5,21182,4.383692052980132,20.0,0.0
4832,0,4832,[302 603 187 427 180],537,5,21187,4.383819573763708,20.0,0.0
4833,0,4833,[302 603 187 427 180],664,5,21192,4.38394704178734,20.0,0.0
4834,0,4834,[282 121 748 180 185],479,4,21196,4.383867631851086,0.0,0.0
4835,0,4835,[179  69 111 483 238],334,3,21199,4.38358147229115,20.0,0.0
4836,0,4836,[302 603 187 427 180],537,5,21204,4.383708910481704,20.0,0.0
4837,0,4837,[302 603 187 427 180],664,5,21209,4.383836295990078,20.0,0.0
4838,0,4838,[ 70 197  56 322 385],524,4,21213,4.383756974581525,0.0,0.0
4839,0,4839,[302 603 187 427 180],666,5,21218,4.3838842975206616,20.0,0.0
4840,0,4840,[127 180 294 173 318],537,4,21222,4.383804998967156,20.0,20.0
4841,0,4841,[210 143 276 179 125],59,3,21225,4.383519206939281,0.0,0.0
4842,0,4842,[302 603 187 427 180],271,5,21230,4.383646500103242,20.0,0.0
4843,0,4843,[302 603 187 427 180],537,5,21235,4.383773740710157,20.0,0.0
4844,0,4844,[302 603 187 427 180],339,5,21240,4.38390092879257,20.0,0.0
4845,0,4845,[ 69 294 228 322 655],13,3,21243,4.383615352868345,0.0,0.0
4846,0,4846,[302 603 187 427 180],458,5,21248,4.383742521147101,20.0,0.0
4847,0,4847,[302 603 187 427 180],90,5,21253,4.383869636963697,20.0,0.0
4848,0,4848,[174 655   8 742 678],488,2,21255,4.383378016085791,0.0,20.0
4849,0,4849,[302 603 187 427 180],458,5,21260,4.383505154639176,20.0,0.0
4850,0,4850,[144 546 117 475  11],339,3,21263,4.383219954648526,0.0,0.0
4851,0,4851,[302 603 187 427 180],537,5,21268,4.383347073371805,20.0,0.0
4852,0,4852,[302 603 187 427 180],664,5,21273,4.383474139707397,20.0,0.0
4853,0,4853,[302 603 187 427 180],666,5,21278,4.38360115368768,20.0,0.0
4854,0,4854,[302 603 187 427 180],90,5,21283,4.383728115345005,20.0,0.0
4855,0,4855,[302 603 187 427 180],664,5,21288,4.383855024711697,20.0,0.0
4856,0,4856,[302 603 187 427 180],339,5,21293,4.383981881820054,20.0,0.0
4857,0,4857,[ 11 282  82 597  70],374,5,21298,4.384108686702347,0.0,0.0
4858,0,4858,[187 215 132 100  82],343,5,21303,4.384235439390821,0.0,20.0
4859,0,4859,[302 603 187 427 180],271,5,21308,4.3843621399176955,20.0,0.0
4860,0,4860,[385  69 117  95  96],537,0,21308,4.383460193375849,0.0,0.0
4861,0,4861,[302 603 187 427 180],474,5,21313,4.38358700123406,20.0,0.0
4862,0,4862,[257  96 238 200 222],210,4,21317,4.383508122558092,0.0,0.0
4863,0,4863,[  7 258 222 176 276],234,0,21317,4.382606907894737,0.0,0.0
4864,0,4864,[181 237  28 186   9],59,4,21321,4.3825282631038025,0.0,0.0
4865,0,4865,[302 603 187 427 180],664,5,21326,4.382655158240855,20.0,0.0
4866,0,4866,[302 603 187 427 180],458,5,21331,4.382782001232792,20.0,0.0
4867,0,4867,[  1 357 174  64 471],343,5,21336,4.38290879211175,20.0,20.0
4868,0,4868,[302 603 187 427 180],666,5,21341,4.383035530909837,20.0,0.0
4869,0,4869,[302 603 187 427 180],339,5,21346,4.383162217659137,20.0,0.0
4870,0,4870,[302 603 187 427 180],13,5,21351,4.383288852391706,20.0,0.0
4871,0,4871,[302 603 187 427 180],271,5,21356,4.383415435139573,20.0,0.0
4872,0,4872,[ 69 471 210 302 357],360,4,21360,4.383336753539914,20.0,0.0
4873,0,4873,[302 603 187 427 180],537,5,21365,4.38346327451785,20.0,0.0
4874,0,4874,[ 22  50 181  70 202],479,5,21370,4.383589743589743,0.0,20.0
4875,0,4875,[302 603 187 427 180],90,5,21375,4.383716160787531,20.0,0.0
4876,0,4876,[211 168  88 300 405],379,3,21378,4.3834324379741645,0.0,0.0
4877,0,4877,[302 603 187 427 180],271,5,21383,4.383558835588356,20.0,0.0
4878,0,4878,[302 603 187 427 180],339,5,21388,4.383685181389629,20.0,0.0
4879,0,4879,[196 121 216   9 294],474,4,21392,4.383606557377049,0.0,0.0
4880,0,4880,[196  56  95  64 118],892,5,21397,4.383732841630813,0.0,0.0
4881,0,4881,[328 127  11 172 174],334,3,21400,4.383449405981155,0.0,40.0
4882,0,4882,[258  25  97 237 265],7,4,21404,4.383370878558264,0.0,0.0
4883,0,4883,[204  50 196 245 211],666,1,21405,4.382678132678133,0.0,20.0
4884,0,4884,[180  70 210 215 289],488,2,21407,4.382190378710337,0.0,0.0
4885,0,4885,[302 603 187 427 180],474,5,21412,4.382316823577568,20.0,0.0
4886,0,4886,[302 603 187 427 180],537,5,21417,4.38244321669736,20.0,0.0
4887,0,4887,[302 603 187 427 180],90,5,21422,4.382569558101473,20.0,0.0
4888,0,4888,[302 603 187 427 180],13,5,21427,4.3826958478216405,20.0,0.0
4889,0,4889,[257 288 151 135 202],447,2,21429,4.382208588957055,0.0,0.0
4890,0,4890,[302 603 187 427 180],666,5,21434,4.382334900838274,20.0,0.0
4891,0,4891,[125 286 515  71 210],234,1,21435,4.381643499591169,0.0,0.0
4892,0,4892,[269 187  88 196 144],650,2,21437,4.3811567545473125,0.0,0.0
4893,0,4893,[302 603 187 427 180],537,5,21442,4.3812832039231715,20.0,0.0
4894,0,4894,[302 603 187 427 180],13,5,21447,4.381409601634321,20.0,0.0
4895,0,4895,[302 603 187 427 180],664,5,21452,4.381535947712418,20.0,0.0
4896,0,4896,[302 603 187 427 180],666,5,21457,4.381662242189095,20.0,0.0
4897,0,4897,[100   7 143 271 153],13,2,21459,4.381175990200082,0.0,20.0
4898,0,4898,[302 603 187 427 180],537,5,21464,4.381302306593183,20.0,0.0
4899,0,4899,[302 603 187 427 180],13,5,21469,4.381428571428572,20.0,0.0
4900,0,4900,[175  89 196 302 181],474,5,21474,4.3815547847378085,0.0,0.0
4901,0,4901,[302 603 187 427 180],666,5,21479,4.381680946552428,20.0,0.0
4902,0,4902,[302 603 187 427 180],666,5,21484,4.381807056903936,20.0,0.0
4903,0,4903,[302 603 187 427 180],13,5,21489,4.381933115823817,20.0,0.0
4904,0,4904,[546  28  79 322  12],374,5,21494,4.382059123343527,20.0,0.0
4905,0,4905,[121 405 597 496 273],643,2,21496,4.381573583367305,0.0,0.0
4906,0,4906,[302 603 187 427 180],90,5,21501,4.381699612798044,20.0,0.0
4907,0,4907,[302 603 187 427 180],13,5,21506,4.381825590872046,20.0,0.0
4908,0,4908,[143 603 216  89  82],59,4,21510,4.381747810144632,20.0,0.0
4909,0,4909,[313 742 132  98   7],650,4,21514,4.381670061099796,0.0,20.0
4910,0,4910,[302 603 187 427 180],537,5,21519,4.3817959682345755,20.0,0.0
4911,0,4911,[568  71 215 271  79],536,4,21523,4.381718241042345,0.0,0.0
4912,0,4912,[302 603 187 427 180],537,5,21528,4.381844087115815,20.0,0.0
4913,0,4913,[302 603 187 427 180],474,5,21533,4.381969881969882,20.0,0.0
4914,0,4914,[302 603 187 427 180],90,5,21538,4.382095625635809,20.0,0.0
4915,0,4915,[302 603 187 427 180],458,5,21543,4.3822213181448335,20.0,0.0
4916,0,4916,[302 603 187 427 180],271,5,21548,4.382346959528167,20.0,0.0
4917,0,4917,[302 603 187 427 180],537,5,21553,4.382472549816999,20.0,0.0
4918,0,4918,[235 176 172 748 435],313,3,21556,4.382191502337873,0.0,0.0
4919,0,4919,[ 69  22 180 111 258],6,1,21557,4.381504065040651,0.0,0.0
4920,0,4920,[302 603 187 427 180],90,5,21562,4.381629750050803,20.0,0.0
4921,0,4921,[ 98  50   8 132  70],64,5,21567,4.381755383990248,0.0,40.0
4922,0,4922,[302 603 187 427 180],13,5,21572,4.381880966890107,20.0,0.0
4923,0,4923,[144 191 357 234 127],234,4,21576,4.381803411860276,20.0,20.0
4924,0,4924,[ 69 483  89 328 179],85,4,21580,4.3817258883248735,20.0,0.0
4925,0,4925,[180 202 265 286 228],653,4,21584,4.381648396264718,0.0,0.0
4926,0,4926,[ 28   7 144  25 265],7,4,21588,4.381570935660646,0.0,0.0
4927,0,4927,[ 22  82 678 182 191],92,2,21590,4.381087662337662,0.0,0.0
4928,0,4928,[302 603 187 427 180],474,5,21595,4.381213227835261,20.0,0.0
4929,0,4929,[302 603 187 427 180],474,5,21600,4.381338742393509,20.0,0.0
4930,0,4930,[302 603 187 427 180],474,5,21605,4.381464206043399,20.0,0.0
4931,0,4931,[302 603 187 427 180],90,5,21610,4.381589618815896,20.0,0.0
4932,0,4932,[257 161 182 423 121],749,1,21611,4.380904115142915,0.0,0.0
4933,0,4933,[302 603 187 427 180],271,5,21616,4.381029590595865,20.0,0.0
4934,0,4934,[302 603 187 427 180],339,5,21621,4.381155015197568,20.0,0.0
4935,0,4935,[302 603 187 427 180],271,5,21626,4.38128038897893,20.0,0.0
4936,0,4936,[302 603 187 427 180],537,5,21631,4.3814057119708325,20.0,0.0
4937,0,4937,[302 603 187 427 180],339,5,21636,4.381530984204131,20.0,0.0
4938,0,4938,[302 603 187 427 180],90,5,21641,4.381656205709658,20.0,0.0
4939,0,4939,[302 603 187 427 180],664,5,21646,4.3817813765182185,20.0,0.0
4940,0,4940,[302 603 187 427 180],474,5,21651,4.381906496660595,20.0,0.0
4941,0,4941,[302 603 187 427 180],271,5,21656,4.3820315661675435,20.0,0.0
4942,0,4942,[302 603 187 427 180],458,5,21661,4.382156585069795,20.0,0.0
4943,0,4943,[302 603 187 427 180],537,5,21666,4.382281553398058,20.0,0.0
4944,0,4944,[302 603 187 427 180],537,5,21671,4.382406471183013,20.0,0.0
4945,0,4945,[302 603 187 427 180],339,5,21676,4.382531338455317,20.0,0.0
4946,0,4946,[302 603 187 427 180],666,5,21681,4.382656155245604,20.0,0.0
4947,0,4947,[302 603 187 427 180],271,5,21686,4.382780921584478,20.0,0.0
4948,0,4948,[302 603 187 427 180],90,5,21691,4.3829056375025255,20.0,0.0
4949,0,4949,[333 210 143  71 175],85,3,21694,4.382626262626262,0.0,0.0
4950,0,4950,[318 211 216 435 196],87,5,21699,4.3827509594021405,20.0,0.0
4951,0,4951,[302 603 187 427 180],271,5,21704,4.382875605815832,20.0,0.0
4952,0,4952,[302 603 187 427 180],664,5,21709,4.38300020189784,20.0,0.0
4953,0,4953,[302 603 187 427 180],666,5,21714,4.383124747678644,20.0,0.0
4954,0,4954,[302 603 187 427 180],339,5,21719,4.383249243188699,20.0,0.0
4955,0,4955,[302 603 187 427 180],664,5,21724,4.383373688458434,20.0,0.0
4956,0,4956,[ 79 172  69 294 508],387,3,21727,4.383094613677628,0.0,0.0
4957,0,4957,[ 97 748 202 195 228],653,3,21730,4.3828156514723675,0.0,0.0
4958,0,4958,[302 603 187 427 180],664,5,21735,4.382940108892922,20.0,0.0
4959,0,4959,[302 603 187 427 180],474,5,21740,4.383064516129032,20.0,0.0
4960,0,4960,[302 603 187 427 180],664,5,21745,4.383188873211046,20.0,0.0
4961,0,4961,[302 603 187 427 180],13,5,21750,4.383313180169287,20.0,0.0
4962,0,4962,[200 435 121   7 100],59,5,21755,4.383437437034052,0.0,20.0
4963,0,4963,[302 603 187 427 180],537,5,21760,4.383561643835616,20.0,0.0
4964,0,4964,[302 603 187 427 180],537,5,21765,4.38368580060423,20.0,0.0
4965,0,4965,[302 603 187 427 180],339,5,21770,4.383809907370117,20.0,0.0
4966,0,4966,[302 603 187 427 180],13,5,21775,4.383933964163479,20.0,0.0
4967,0,4967,[357 200  98 235 222],213,3,21778,4.3836553945249594,20.0,20.0
4968,0,4968,[302 603 187 427 180],271,5,21783,4.383779432481385,20.0,0.0
4969,0,4969,[ 56 265 195 168 423],650,3,21786,4.383501006036218,0.0,0.0
4970,0,4970,[302 603 187 427 180],537,5,21791,4.383625025145846,20.0,0.0
4971,0,4971,[302 603 187 427 180],13,5,21796,4.383748994368464,20.0,0.0
4972,0,4972,[302 603 187 427 180],474,5,21801,4.383872913734164,20.0,0.0
4973,0,4973,[294  79   9 546 196],234,0,21801,4.382991556091676,0.0,0.0
4974,0,4974,[ 22   4 144 121   1],343,4,21805,4.382914572864322,0.0,0.0
4975,0,4975,[302 603 187 427 180],537,5,21810,4.383038585209003,20.0,0.0
4976,0,4976,[ 69 318 143 180 265],234,2,21812,4.382559774964839,20.0,0.0
4977,0,4977,[302 603 187 427 180],474,5,21817,4.382683808758538,20.0,0.0
4978,0,4978,[302 603 187 427 180],90,5,21822,4.382807792729464,20.0,0.0
4979,0,4979,[678 183 161 269  98],13,3,21825,4.382530120481928,0.0,20.0
4980,0,4980,[125   7  28 483 301],6,1,21826,4.38185103392893,20.0,0.0
4981,0,4981,[302 603 187 427 180],666,5,21831,4.3819751103974305,20.0,0.0
4982,0,4982,[302 603 187 427 180],664,5,21836,4.3820991370660245,20.0,0.0
4983,0,4983,[174  97 185 496 186],650,3,21839,4.381821829855538,0.0,20.0
4984,0,4984,[302 603 187 427 180],537,5,21844,4.3819458375125375,20.0,0.0
4985,0,4985,[ 56 234 405 191 216],378,4,21848,4.381869233854793,0.0,0.0
4986,0,4986,[302 603 187 427 180],458,5,21853,4.381993182273912,20.0,0.0
4987,0,4987,[302 603 187 427 180],664,5,21858,4.382117080994386,20.0,0.0
4988,0,4988,[302 603 187 427 180],339,5,21863,4.382240930046102,20.0,0.0
4989,0,4989,[678   4 176  89   8],92,4,21867,4.382164328657314,0.0,0.0
4990,0,4990,[302 603 187 427 180],458,5,21872,4.382288118613504,20.0,0.0
4991,0,4991,[286 300 265 655 185],379,4,21876,4.382211538461538,0.0,0.0
4992,0,4992,[211 187 423  64 183],339,4,21880,4.382134988984578,0.0,0.0
4993,0,4993,[302 603 187 427 180],537,5,21885,4.382258710452543,20.0,0.0
4994,0,4994,[173 289 273 222 210],234,1,21886,4.381581581581582,0.0,0.0
4995,0,4995,[302 603 187 427 180],339,5,21891,4.381705364291433,20.0,0.0
4996,0,4996,[302 603 187 427 180],90,5,21896,4.381829097458475,20.0,0.0
4997,0,4997,[302 235 222 237 318],343,5,21901,4.381952781112445,20.0,0.0
4998,0,4998,[183  88 153 257 302],378,5,21906,4.3820764152830565,0.0,0.0
4999,0,4999,[245  56  89 117 300],328,5,21911,4.3822,0.0,0.0
5000,0,5000,[302 603 187 427 180],474,5,21916,4.382323535292941,20.0,0.0
5001,0,5001,[302 603 187 427 180],13,5,21921,4.382447021191523,20.0,0.0
5002,0,5002,[302 603 187 427 180],339,5,21926,4.382570457725365,20.0,0.0
5003,0,5003,[215 191  98  88 273],378,5,21931,4.382693844924061,0.0,20.0
5004,0,5004,[302 603 187 427 180],339,5,21936,4.382817182817183,20.0,0.0
5005,0,5005,[302 603 187 427 180],664,5,21941,4.382940471434279,20.0,0.0
5006,0,5006,[302 603 187 427 180],13,5,21946,4.383063710804874,20.0,0.0
5007,0,5007,[197 257 471  22 127],308,3,21949,4.3827875399361025,0.0,20.0
5008,0,5008,[302 603 187 427 180],90,5,21954,4.382910760630865,20.0,0.0
5009,0,5009,[ 28 427 179 127 333],537,3,21957,4.382634730538922,0.0,20.0
5010,0,5010,[302 603 187 427 180],537,5,21962,4.382757932548394,20.0,0.0
5011,0,5011,[302 603 187 427 180],271,5,21967,4.382881085395052,20.0,0.0
5012,0,5012,[302 603 187 427 180],474,5,21972,4.383004189108318,20.0,0.0
5013,0,5013,[302 603 187 427 180],339,5,21977,4.383127243717591,20.0,0.0
5014,0,5014,[185 186 515 234 546],328,4,21981,4.3830508474576275,0.0,0.0
5015,0,5015,[302 603 187 427 180],664,5,21986,4.38317384370016,20.0,0.0
5016,0,5016,[302 603 187 427 180],90,5,21991,4.383296790910903,20.0,0.0
5017,0,5017,[302 603 187 427 180],271,5,21996,4.383419689119171,20.0,0.0
5018,0,5018,[302 603 187 427 180],666,5,22001,4.383542538354254,20.0,0.0
5019,0,5019,[302 603 187 427 180],90,5,22006,4.383665338645418,20.0,0.0
5020,0,5020,[302 603 187 427 180],458,5,22011,4.383788090021908,20.0,0.0
5021,0,5021,[ 98 405 118  56 483],328,4,22015,4.383711668657905,20.0,20.0
5022,0,5022,[302 603 187 427 180],666,5,22020,4.383834361935098,20.0,0.0
5023,0,5023,[ 56 289 151 238 568],881,1,22021,4.383160828025478,0.0,0.0
5024,0,5024,[197 546 135 191   8],313,4,22025,4.383084577114428,0.0,0.0
5025,0,5025,[185  70 300 222 173],479,4,22029,4.383008356545961,0.0,0.0
5026,0,5026,[435 515 174 117  70],102,1,22030,4.38233538889994,0.0,20.0
5027,0,5027,[302 603 187 427 180],271,5,22035,4.3824582338902145,20.0,0.0
5028,0,5028,[302 603 187 427 180],339,5,22040,4.38258103002585,20.0,0.0
5029,0,5029,[302 603 187 427 180],537,5,22045,4.382703777335984,20.0,0.0
5030,0,5030,[257  98  88 655 200],815,3,22048,4.3824289405684755,0.0,20.0
5031,0,5031,[302 603 187 427 180],271,5,22053,4.382551669316375,20.0,0.0
5032,0,5032,[302 603 187 427 180],666,5,22058,4.382674349294655,20.0,0.0
5033,0,5033,[ 70  71 508 125 323],59,2,22060,4.382201032975765,0.0,0.0
5034,0,5034,[302 603 187 427 180],666,5,22065,4.382323733862959,20.0,0.0
5035,0,5035,[302 603 187 427 180],339,5,22070,4.382446386020652,20.0,0.0
5036,0,5036,[302 603 187 427 180],458,5,22075,4.382568989477864,20.0,0.0
5037,0,5037,[191 471 195 100 175],207,1,22076,4.3818975784041285,0.0,20.0
5038,0,5038,[125 161 215 588 288],234,0,22076,4.38102798174241,0.0,0.0
5039,0,5039,[258  56 121   1 216],92,4,22080,4.380952380952381,0.0,0.0
5040,0,5040,[143 483 144 191 153],804,4,22084,4.380876810156715,20.0,0.0
5041,0,5041,[302 603 187 427 180],474,5,22089,4.380999603332011,20.0,0.0
5042,0,5042,[302 603 187 427 180],664,5,22094,4.381122347808844,20.0,0.0
5043,0,5043,[302 603 187 427 180],458,5,22099,4.381245043616178,20.0,0.0
5044,0,5044,[302 603 187 427 180],90,5,22104,4.3813676907829535,20.0,0.0
5045,0,5045,[302 603 187 427 180],90,5,22109,4.38149028933809,20.0,0.0
5046,0,5046,[168 257 403 742 200],308,5,22114,4.381612839310481,0.0,0.0
5047,0,5047,[302 603 187 427 180],666,5,22119,4.381735340729001,20.0,0.0
5048,0,5048,[302 603 187 427 180],537,5,22124,4.381857793622499,20.0,0.0
5049,0,5049,[302 603 187 427 180],271,5,22129,4.381980198019802,20.0,0.0
5050,0,5050,[187 185  11 265 202],207,2,22131,4.381508612156009,0.0,0.0
5051,0,5051,[302 603 187 427 180],458,5,22136,4.381631037212985,20.0,0.0
5052,0,5052,[515 286 132 265 180],474,5,22141,4.381753413813576,0.0,0.0
5053,0,5053,[302 603 187 427 180],474,5,22146,4.381875741986545,20.0,0.0
5054,0,5054,[216  70 405 496 328],533,4,22150,4.381800197823937,0.0,0.0
5055,0,5055,[302 603 187 427 180],90,5,22155,4.38192246835443,20.0,0.0
5056,0,5056,[302 603 187 427 180],537,5,22160,4.382044690527981,20.0,0.0
5057,0,5057,[302 603 187 427 180],666,5,22165,4.38216686437327,20.0,0.0
5058,0,5058,[302 603 187 427 180],13,5,22170,4.3822889899189565,20.0,0.0
5059,0,5059,[302 603 187 427 180],90,5,22175,4.382411067193676,20.0,0.0
5060,0,5060,[302 603 187 427 180],664,5,22180,4.382533096226043,20.0,0.0
5061,0,5061,[302 603 187 427 180],13,5,22185,4.382655077044646,20.0,0.0
5062,0,5062,[302 603 187 427 180],474,5,22190,4.3827770096780565,20.0,0.0
5063,0,5063,[302 603 187 427 180],664,5,22195,4.382898894154819,20.0,0.0
5064,0,5064,[427 118 483 288 282],533,4,22199,4.382823297137216,20.0,0.0
5065,0,5065,[302 603 187 427 180],537,5,22204,4.382945124358468,20.0,0.0
5066,0,5066,[302 603 187 427 180],90,5,22209,4.383066903493191,20.0,0.0
5067,0,5067,[271 186 423  50 678],13,3,22212,4.382794001578532,0.0,20.0
5068,0,5068,[302 603 187 427 180],664,5,22217,4.382915762477806,20.0,0.0
5069,0,5069,[  4 175  70 515 174],207,3,22220,4.382642998027613,0.0,20.0
5070,0,5070,[302 603 187 427 180],664,5,22225,4.382764740682311,20.0,0.0
5071,0,5071,[302 603 187 427 180],271,5,22230,4.382886435331231,20.0,0.0
5072,0,5072,[215 294 742 282 100],92,3,22233,4.3826138379657005,0.0,20.0
5073,0,5073,[135 357 282 286  97],881,3,22236,4.382341348048876,20.0,0.0
5074,0,5074,[302 603 187 427 180],90,5,22241,4.382463054187192,20.0,0.0
5075,0,5075,[302 603 187 427 180],458,5,22246,4.382584712371947,20.0,0.0
5076,0,5076,[302 603 187 427 180],339,5,22251,4.382706322631475,20.0,0.0
5077,0,5077,[302 603 187 427 180],13,5,22256,4.382827884994092,20.0,0.0
5078,0,5078,[302 603 187 427 180],458,5,22261,4.382949399488088,20.0,0.0
5079,0,5079,[302 603 187 427 180],271,5,22266,4.383070866141733,20.0,0.0
5080,0,5080,[302 603 187 427 180],90,5,22271,4.383192284983271,20.0,0.0
5081,0,5081,[238 742 483 191 118],308,3,22274,4.3829201101928374,20.0,0.0
5082,0,5082,[302 423 323 200 132],328,4,22278,4.382844776706669,0.0,0.0
5083,0,5083,[302 603 187 427 180],458,5,22283,4.382966168371361,20.0,0.0
5084,0,5084,[302 603 187 427 180],13,5,22288,4.383087512291052,20.0,0.0
5085,0,5085,[302 603 187 427 180],537,5,22293,4.3832088084939045,20.0,0.0
5086,0,5086,[234 186 202 655 181],774,1,22294,4.3825437389424025,0.0,0.0
5087,0,5087,[ 28  98 144   7   8],60,4,22298,4.38246855345912,0.0,20.0
5088,0,5088,[302 603 187 427 180],458,5,22303,4.382589899783848,20.0,0.0
5089,0,5089,[302 603 187 427 180],271,5,22308,4.382711198428291,20.0,0.0
5090,0,5090,[302 603 187 427 180],458,5,22313,4.382832449420546,20.0,0.0
5091,0,5091,[302 603 187 427 180],458,5,22318,4.3829536527886885,20.0,0.0
5092,0,5092,[302 603 187 427 180],90,5,22323,4.38307480856077,20.0,0.0
5093,0,5093,[302 603 187 427 180],13,5,22328,4.383195916764821,20.0,0.0
5094,0,5094,[302 603 187 427 180],458,5,22333,4.383316977428851,20.0,0.0
5095,0,5095,[302 603 187 427 180],474,5,22338,4.383437990580847,20.0,0.0
5096,0,5096,[302 603 187 427 180],664,5,22343,4.383558956248774,20.0,0.0
5097,0,5097,[302 603 187 427 180],474,5,22348,4.383679874460573,20.0,0.0
5098,0,5098,[302 603 187 427 180],537,5,22353,4.383800745244166,20.0,0.0
5099,0,5099,[302 603 187 427 180],458,5,22358,4.383921568627451,20.0,0.0
5100,0,5100,[302 603 187 427 180],458,5,22363,4.384042344638306,20.0,0.0
5101,0,5101,[302 603 187 427 180],666,5,22368,4.384163073304586,20.0,0.0
5102,0,5102,[258  79 125 515  95],200,5,22373,4.384283754654125,0.0,0.0
5103,0,5103,[302 603 187 427 180],339,5,22378,4.384404388714733,20.0,0.0
5104,0,5104,[265 100 588 271 269],537,1,22379,4.383741429970617,0.0,20.0
5105,0,5105,[302 603 187 427 180],666,5,22384,4.383862122992558,20.0,0.0
5106,0,5106,[302 603 187 427 180],339,5,22389,4.383982768748776,20.0,0.0
5107,0,5107,[302 603 187 427 180],339,5,22394,4.384103367267032,20.0,0.0
5108,0,5108,[180 168 276 258 191],13,4,22398,4.384028185554903,0.0,0.0
5109,0,5109,[302 603 187 427 180],339,5,22403,4.3841487279843445,20.0,0.0
5110,0,5110,[302 603 187 427 180],666,5,22408,4.384269223243984,20.0,0.0
5111,0,5111,[302 603 187 427 180],339,5,22413,4.384389671361502,20.0,0.0
5112,0,5112,[302 603 187 427 180],474,5,22418,4.384510072364561,20.0,0.0
5113,0,5113,[302 603 187 427 180],90,5,22423,4.384630426280798,20.0,0.0
5114,0,5114,[161 182 143 237 118],533,3,22426,4.3843597262952105,0.0,0.0
5115,0,5115,[172 175 742 300 323],378,4,22430,4.384284597341673,0.0,0.0
5116,0,5116,[302 603 187 427 180],90,5,22435,4.384404924760602,20.0,0.0
5117,0,5117,[302 603 187 427 180],271,5,22440,4.384525205158265,20.0,0.0
5118,0,5118,[302 603 187 427 180],537,5,22445,4.384645438562219,20.0,0.0
5119,0,5119,[302 603 187 427 180],537,5,22450,4.384765625,20.0,0.0
5120,0,5120,[302 603 187 427 180],666,5,22455,4.3848857644991215,20.0,0.0
5121,0,5121,[302 603 187 427 180],339,5,22460,4.385005857087076,20.0,0.0
5122,0,5122,[144 475 301 471 655],119,5,22465,4.385125902791334,0.0,0.0
5123,0,5123,[302 603 187 427 180],474,5,22470,4.385245901639344,20.0,0.0
5124,0,5124,[302 603 187 427 180],13,5,22475,4.385365853658537,20.0,0.0
5125,0,5125,[302 603 187 427 180],90,5,22480,4.3854857588763165,20.0,0.0
5126,0,5126,[302 603 187 427 180],666,5,22485,4.385605617320071,20.0,0.0
5127,0,5127,[153  56 176 318 276],13,3,22488,4.385335413416537,20.0,0.0
5128,0,5128,[302 603 187 427 180],666,5,22493,4.385455254435563,20.0,0.0
5129,0,5129,[302 603 187 427 180],339,5,22498,4.385575048732943,20.0,0.0
5130,0,5130,[289 127 197 238  96],234,3,22501,4.38530500877022,0.0,20.0
5131,0,5131,[302 603 187 427 180],666,5,22506,4.385424785658612,20.0,0.0
5132,0,5132,[  4 333 125  50 143],533,4,22510,4.38534969803234,0.0,20.0
5133,0,5133,[302 603 187 427 180],537,5,22515,4.385469419555902,20.0,0.0
5134,0,5134,[186  88 191  96 508],92,4,22519,4.38539435248296,0.0,0.0
5135,0,5135,[302 603 187 427 180],474,5,22524,4.385514018691588,20.0,0.0
5136,0,5136,[132   1 286  25  28],406,2,22526,4.385049639867627,0.0,0.0
5137,0,5137,[302 603 187 427 180],90,5,22531,4.385169326586221,20.0,0.0
5138,0,5138,[197  70 151  69 144],308,2,22533,4.384705195563339,0.0,0.0
5139,0,5139,[216  12 175  56 269],7,4,22537,4.384630350194553,20.0,0.0
5140,0,5140,[302 603 187 427 180],271,5,22542,4.384750048628671,20.0,0.0
5141,0,5141,[153  25 183  64 180],92,4,22546,4.384675223648386,0.0,0.0
5142,0,5142,[215 194 603 197 200],308,3,22549,4.384405988722535,20.0,0.0
5143,0,5143,[302 603 187 427 180],666,5,22554,4.38452566096423,20.0,0.0
5144,0,5144,[302 603 187 427 180],664,5,22559,4.384645286686103,20.0,0.0
5145,0,5145,[121 302 100 127 182],458,4,22563,4.384570540225417,0.0,40.0
5146,0,5146,[302 603 187 427 180],666,5,22568,4.384690110744123,20.0,0.0
5147,0,5147,[257   9 121  89   1],378,5,22573,4.384809634809635,0.0,0.0
5148,0,5148,[302 603 187 427 180],666,5,22578,4.3849291124490195,20.0,0.0
5149,0,5149,[175 194  15 174 182],234,1,22579,4.384271844660194,0.0,20.0
5150,0,5150,[302 603 187 427 180],537,5,22584,4.384391380314502,20.0,0.0
5151,0,5151,[265 333 405 210 215],13,2,22586,4.383928571428571,0.0,0.0
5152,0,5152,[127 222  50 273 300],328,3,22589,4.383660003881234,0.0,40.0
5153,0,5153,[302 603 187 427 180],90,5,22594,4.383779588668995,20.0,0.0
5154,0,5154,[302 603 187 427 180],664,5,22599,4.383899127061106,20.0,0.0
5155,0,5155,[435 196 289 135 191],85,4,22603,4.383824670287044,0.0,0.0
5156,0,5156,[302 603 187 427 180],13,5,22608,4.383944153577661,20.0,0.0
5157,0,5157,[196 222 100 111 185],334,4,22612,4.383869716944552,0.0,20.0
5158,0,5158,[125  28 294 180 286],788,3,22615,4.383601473153712,0.0,0.0
5159,0,5159,[302 603 187 427 180],537,5,22620,4.383720930232558,20.0,0.0
5160,0,5160,[333 179   9   1 546],13,0,22620,4.38287153652393,0.0,0.0
5161,0,5161,[302 603 187 427 180],537,5,22625,4.3829910887253005,20.0,0.0
5162,0,5162,[302 603 187 427 180],474,5,22630,4.383110594615534,20.0,0.0
5163,0,5163,[ 56  25 385   4 121],87,5,22635,4.383230054221534,0.0,0.0
5164,0,5164,[302 603 187 427 180],13,5,22640,4.383349467570184,20.0,0.0
5165,0,5165,[302 603 187 427 180],458,5,22645,4.383468834688347,20.0,0.0
5166,0,5166,[328 185 172 245 385],653,3,22648,4.383201083801045,0.0,0.0
5167,0,5167,[100 161 121 423 245],378,4,22652,4.38312693498452,0.0,20.0
5168,0,5168,[302 603 187 427 180],666,5,22657,4.383246275875411,20.0,0.0
5169,0,5169,[302 603 187 427 180],474,5,22662,4.383365570599613,20.0,0.0
5170,0,5170,[302 603 187 427 180],90,5,22667,4.38348481918391,20.0,0.0
5171,0,5171,[ 12 265   7 135  50],13,4,22671,4.383410672853828,20.0,20.0
5172,0,5172,[215  28 161 200 182],506,5,22676,4.383529866615117,0.0,0.0
5173,0,5173,[302 603 187 427 180],458,5,22681,4.38364901430228,20.0,0.0
5174,0,5174,[302 603 187 427 180],271,5,22686,4.383768115942029,20.0,0.0
5175,0,5175,[302 603 187 427 180],474,5,22691,4.383887171561051,20.0,0.0
5176,0,5176,[187  96 508 655 183],527,3,22694,4.383619857060073,0.0,0.0
5177,0,5177,[302 603 187 427 180],13,5,22699,4.383738895326381,20.0,0.0
5178,0,5178,[302 603 187 427 180],474,5,22704,4.383857887623093,20.0,0.0
5179,0,5179,[302 603 187 427 180],666,5,22709,4.383976833976834,20.0,0.0
5180,0,5180,[302 603 187 427 180],271,5,22714,4.384095734414206,20.0,0.0
5181,0,5181,[302 603 187 427 180],666,5,22719,4.3842145889617905,20.0,0.0
5182,0,5182,[302 603 187 427 180],474,5,22724,4.3843333976461505,20.0,0.0
5183,0,5183,[282 222  56 275 144],455,2,22726,4.383873456790123,0.0,0.0
5184,0,5184,[302 603 187 427 180],90,5,22731,4.383992285438766,20.0,0.0
5185,0,5185,[302 603 187 427 180],458,5,22736,4.384111068260702,20.0,0.0
5186,0,5186,[117 118  69 135  89],275,0,22736,4.383265856950067,0.0,0.0
5187,0,5187,[302 603 187 427 180],458,5,22741,4.383384734001542,20.0,0.0
5188,0,5188,[127 271 286 269 216],650,2,22743,4.382925419155907,0.0,20.0
5189,0,5189,[186   1  98 597  69],92,4,22747,4.382851637764933,0.0,20.0
5190,0,5190,[302 603 187 427 180],339,5,22752,4.382970525910229,20.0,0.0
5191,0,5191,[302 603 187 427 180],458,5,22757,4.38308936825886,20.0,0.0
5192,0,5192,[302 603 187 427 180],13,5,22762,4.383208164837281,20.0,0.0
5193,0,5193,[302 603 187 427 180],458,5,22767,4.383326915671929,20.0,0.0
5194,0,5194,[302 603 187 427 180],666,5,22772,4.38344562078922,20.0,0.0
5195,0,5195,[196 202  70 183 172],506,5,22777,4.38356428021555,0.0,0.0
5196,0,5196,[302 603 187 427 180],474,5,22782,4.383682893977294,20.0,0.0
5197,0,5197,[271  25 175 168 258],537,3,22785,4.383416698730281,0.0,0.0
5198,0,5198,[121 168  98  28 742],95,5,22790,4.383535295249087,0.0,20.0
5199,0,5199,[302 603 187 427 180],474,5,22795,4.383653846153846,20.0,0.0
5200,0,5200,[302 603 187 427 180],458,5,22800,4.383772351470871,20.0,0.0
5201,0,5201,[302 603 187 427 180],271,5,22805,4.383890811226451,20.0,0.0
5202,0,5202,[302 603 187 427 180],13,5,22810,4.3840092254468574,20.0,0.0
5203,0,5203,[216 181 172 100 215],85,3,22813,4.383743274404305,0.0,20.0
5204,0,5204,[121 195 222  64 238],774,1,22814,4.383093179634966,0.0,0.0
5205,0,5205,[294 161  70  69 496],653,2,22816,4.38263542066846,0.0,0.0
5206,0,5206,[  1 423 182 496 357],387,3,22819,4.382369886690993,20.0,0.0
5207,0,5207,[187 153 228  82 603],64,2,22821,4.381912442396313,20.0,0.0
5208,0,5208,[302 603 187 427 180],664,5,22826,4.382031100019198,20.0,0.0
5209,0,5209,[403 180 200 289 265],378,3,22829,4.381765834932821,0.0,0.0
5210,0,5210,[302 603 187 427 180],271,5,22834,4.381884475148724,20.0,0.0
5211,0,5211,[302 603 187 427 180],474,5,22839,4.3820030698388335,20.0,0.0
5212,0,5212,[135 196 288  50 403],892,4,22843,4.381929790907347,0.0,20.0
5213,0,5213,[185  98 328  70 202],699,3,22846,4.381664748753356,0.0,20.0
5214,0,5214,[302 603 187 427 180],339,5,22851,4.381783317353787,20.0,0.0
5215,0,5215,[302 603 187 427 180],666,5,22856,4.381901840490798,20.0,0.0
5216,0,5216,[323 238   4 182  82],537,2,22858,4.381445275062297,0.0,0.0
5217,0,5217,[302 603 187 427 180],458,5,22863,4.3815638175546185,20.0,0.0
5218,0,5218,[302 603 187 427 180],13,5,22868,4.381682314619659,20.0,0.0
5219,0,5219,[273  22  88 127 118],774,1,22869,4.38103448275862,0.0,20.0
5220,0,5220,[302 603 187 427 180],664,5,22874,4.381153035816894,20.0,0.0
5221,0,5221,[196  28 588 144  82],95,3,22877,4.38088854844887,0.0,0.0
5222,0,5222,[202  69 132 100 318],161,3,22880,4.380624162358798,20.0,20.0
5223,0,5223,[302 603 187 427 180],458,5,22885,4.380742725880551,20.0,0.0
5224,0,5224,[302 603 187 427 180],664,5,22890,4.380861244019139,20.0,0.0
5225,0,5225,[302 603 187 427 180],474,5,22895,4.380979716800613,20.0,0.0
5226,0,5226,[302 603 187 427 180],90,5,22900,4.381098144251005,20.0,0.0
5227,0,5227,[302 603 187 427 180],474,5,22905,4.381216526396328,20.0,0.0
5228,0,5228,[302 603 187 427 180],339,5,22910,4.381334863262574,20.0,0.0
5229,0,5229,[302 603 187 427 180],13,5,22915,4.381453154875717,20.0,0.0
5230,0,5230,[302 603 187 427 180],271,5,22920,4.381571401261709,20.0,0.0
5231,0,5231,[302 603 187 427 180],458,5,22925,4.3816896024464835,20.0,0.0
5232,0,5232,[471 313 179  50 286],474,4,22929,4.381616663481751,0.0,20.0
5233,0,5233,[ 98 496  22 286  12],409,4,22933,4.381543752388231,20.0,20.0
5234,0,5234,[302 603 187 427 180],90,5,22938,4.381661891117479,20.0,0.0
5235,0,5235,[ 12 238 228 118 275],524,2,22940,4.381207028265852,20.0,0.0
5236,0,5236,[302 603 187 427 180],474,5,22945,4.3813251861752915,20.0,0.0
5237,0,5237,[302 603 187 427 180],537,5,22950,4.381443298969073,20.0,0.0
5238,0,5238,[302 603 187 427 180],13,5,22955,4.381561366673029,20.0,0.0
5239,0,5239,[302 603 187 427 180],537,5,22960,4.3816793893129775,20.0,0.0
5240,0,5240,[302 603 187 427 180],664,5,22965,4.381797366914711,20.0,0.0
5241,0,5241,[435  11 215 302 471],788,1,22966,4.381152231972529,0.0,0.0
5242,0,5242,[302 603 187 427 180],90,5,22971,4.381270265115392,20.0,0.0
5243,0,5243,[302 603 187 427 180],458,5,22976,4.3813882532418,20.0,0.0
5244,0,5244,[302 603 187 427 180],339,5,22981,4.381506196377503,20.0,0.0
5245,0,5245,[302 603 187 427 180],666,5,22986,4.381624094548227,20.0,0.0
5246,0,5246,[302 603 187 427 180],90,5,22991,4.381741947779684,20.0,0.0
5247,0,5247,[302 603 187 427 180],13,5,22996,4.381859756097561,20.0,0.0
5248,0,5248,[127 748 118 196 237],533,3,22999,4.3815964945703945,0.0,20.0
5249,0,5249,[275 597 181 323 132],13,2,23001,4.381142857142857,0.0,0.0
5250,0,5250,[302 603 187 427 180],271,5,23006,4.381260712245287,20.0,0.0
5251,0,5251,[173 323 180 161 187],897,4,23010,4.381188118811881,0.0,0.0
5252,0,5252,[ 22 118  95 471 135],194,1,23011,4.380544450790024,0.0,0.0
5253,0,5253,[187 655 546 186 168],339,5,23016,4.380662352493339,0.0,0.0
5254,0,5254,[302 603 187 427 180],537,5,23021,4.380780209324453,20.0,0.0
5255,0,5255,[294 143 153  89 173],648,4,23025,4.380707762557078,0.0,0.0
5256,0,5256,[302 603 187 427 180],458,5,23030,4.380825565912117,20.0,0.0
5257,0,5257,[ 25  15 117 168 237],398,3,23033,4.380562951692659,0.0,0.0
5258,0,5258,[  7 210 174 427  88],295,5,23038,4.380680737782848,0.0,20.0
5259,0,5259,[302 603 187 427 180],271,5,23043,4.380798479087453,20.0,0.0
5260,0,5260,[302 603 187 427 180],271,5,23048,4.380916175632009,20.0,0.0
5261,0,5261,[302 603 187 427 180],13,5,23053,4.381033827442037,20.0,0.0
5262,0,5262,[302 603 187 427 180],271,5,23058,4.381151434543036,20.0,0.0
5263,0,5263,[ 11 265 211  22 191],488,3,23061,4.3808890577507595,0.0,0.0
5264,0,5264,[302 603 187 427 180],13,5,23066,4.381006647673314,20.0,0.0
5265,0,5265,[302 603 187 427 180],666,5,23071,4.381124192935815,20.0,0.0
5266,0,5266,[153 748 258  28 597],788,2,23073,4.380672109360167,0.0,0.0
5267,0,5267,[144 588 302 748  71],454,3,23076,4.380410022779043,0.0,0.0
5268,0,5268,[302 603 187 427 180],90,5,23081,4.380527614348074,20.0,0.0
5269,0,5269,[ 79 211  12  64 173],59,5,23086,4.380645161290323,20.0,0.0
5270,0,5270,[302 603 187 427 180],666,5,23091,4.38076266363119,20.0,0.0
5271,0,5271,[302 603 187 427 180],90,5,23096,4.380880121396054,20.0,0.0
5272,0,5272,[302 603 187 427 180],537,5,23101,4.3809975346102785,20.0,0.0
5273,0,5273,[118 135 286  11 211],788,2,23103,4.3805460750853245,0.0,0.0
5274,0,5274,[302 603 187 427 180],339,5,23108,4.380663507109005,20.0,0.0
5275,0,5275,[302 603 187 427 180],13,5,23113,4.380780894617134,20.0,0.0
5276,0,5276,[302 603 187 427 180],339,5,23118,4.38089823763502,20.0,0.0
5277,0,5277,[302 603 187 427 180],474,5,23123,4.38101553618795,20.0,0.0
5278,0,5278,[302 603 187 427 180],664,5,23128,4.381132790301193,20.0,0.0
5279,0,5279,[302 603 187 427 180],339,5,23133,4.38125,20.0,0.0
5280,0,5280,[302 603 187 427 180],458,5,23138,4.381367165309601,20.0,0.0
5281,0,5281,[302 603 187 427 180],474,5,23143,4.381484286255207,20.0,0.0
5282,0,5282,[196 204 403  88 210],901,4,23147,4.381412076471702,0.0,0.0
5283,0,5283,[144   1 228 204 132],643,4,23151,4.381339894019682,0.0,0.0
5284,0,5284,[179   1 328  50 111],749,4,23155,4.381267738883633,0.0,20.0
5285,0,5285,[ 89 153 435  22 121],650,3,23158,4.381006432084752,0.0,0.0
5286,0,5286,[302 603 187 427 180],90,5,23163,4.381123510497447,20.0,0.0
5287,0,5287,[302 603 187 427 180],458,5,23168,4.38124054462935,20.0,0.0
5288,0,5288,[302 603 187 427 180],664,5,23173,4.381357534505578,20.0,0.0
5289,0,5289,[302 603 187 427 180],474,5,23178,4.381474480151229,20.0,0.0
5290,0,5290,[302 603 187 427 180],339,5,23183,4.381591381591382,20.0,0.0
5291,0,5291,[302 603 187 427 180],664,5,23188,4.381708238851096,20.0,0.0
5292,0,5292,[118 423 265 357  69],666,1,23189,4.381069336860004,20.0,0.0
5293,0,5293,[302 603 187 427 180],537,5,23194,4.381186248583302,20.0,0.0
5294,0,5294,[302 603 187 427 180],537,5,23199,4.381303116147309,20.0,0.0
5295,0,5295,[191 144  22 204  79],749,5,23204,4.3814199395770395,0.0,0.0
5296,0,5296,[302 603 187 427 180],90,5,23209,4.381536718897489,20.0,0.0
5297,0,5297,[405 301 282 265 204],328,2,23211,4.381087202718007,0.0,0.0
5298,0,5298,[302 603 187 427 180],13,5,23216,4.38120400075486,20.0,0.0
5299,0,5299,[173 288 423  98 181],643,3,23219,4.3809433962264155,0.0,20.0
5300,0,5300,[302 603 187 427 180],339,5,23224,4.381060177325033,20.0,0.0
5301,0,5301,[302 603 187 427 180],474,5,23229,4.3811769143719355,20.0,0.0
5302,0,5302,[302 603 187 427 180],339,5,23234,4.381293607392042,20.0,0.0
5303,0,5303,[302 603 187 427 180],666,5,23239,4.381410256410256,20.0,0.0
5304,0,5304,[302 603 187 427 180],271,5,23244,4.381526861451461,20.0,0.0
5305,0,5305,[302 603 187 427 180],537,5,23249,4.38164342254052,20.0,0.0
5306,0,5306,[302 603 187 427 180],339,5,23254,4.38175993970228,20.0,0.0
5307,0,5307,[302 603 187 427 180],271,5,23259,4.381876412961567,20.0,0.0
5308,0,5308,[302 603 187 427 180],664,5,23264,4.381992842343191,20.0,0.0
5309,0,5309,[  1 405  82  96 153],379,4,23268,4.381920903954803,0.0,0.0
5310,0,5310,[ 82 183  50  96 204],506,5,23273,4.382037281114668,0.0,20.0
5311,0,5311,[302 603 187 427 180],664,5,23278,4.382153614457831,20.0,0.0
5312,0,5312,[302 603 187 427 180],537,5,23283,4.382269904009035,20.0,0.0
5313,0,5313,[302 603 187 427 180],537,5,23288,4.382386149793,20.0,0.0
5314,0,5314,[302 603 187 427 180],339,5,23293,4.382502351834431,20.0,0.0
5315,0,5315,[302 603 187 427 180],13,5,23298,4.3826185101580135,20.0,0.0
5316,0,5316,[302 603 187 427 180],90,5,23303,4.382734624788415,20.0,0.0
5317,0,5317,[568 127 742 678 132],749,4,23307,4.382662655133509,0.0,20.0
5318,0,5318,[302 603 187 427 180],474,5,23312,4.382778717804099,20.0,0.0
5319,0,5319,[302 603 187 427 180],339,5,23317,4.382894736842105,20.0,0.0
5320,0,5320,[302 603 187 427 180],13,5,23322,4.383010712272129,20.0,0.0
5321,0,5321,[100  25  69 385 322],537,1,23323,4.382375046974821,0.0,20.0
5322,0,5322,[302 603 187 427 180],13,5,23328,4.382491076460642,20.0,0.0
5323,0,5323,[222  95  15 234 405],479,4,23332,4.382419233658903,0.0,0.0
5324,0,5324,[111  97   7  28 117],474,5,23337,4.382535211267606,0.0,0.0
5325,0,5325,[302 603 187 427 180],339,5,23342,4.382651145324822,20.0,0.0
5326,0,5326,[237 151 186 496 655],308,3,23345,4.382391590013141,0.0,0.0
5327,0,5327,[302 603 187 427 180],664,5,23350,4.3825075075075075,20.0,0.0
5328,0,5328,[302 603 187 427 180],458,5,23355,4.382623381497467,20.0,0.0
5329,0,5329,[302 603 187 427 180],271,5,23360,4.382739212007505,20.0,0.0
5330,0,5330,[302 603 187 427 180],474,5,23365,4.38285499906209,20.0,0.0
5331,0,5331,[302 603 187 427 180],474,5,23370,4.382970742685671,20.0,0.0
5332,0,5332,[302 603 187 427 180],458,5,23375,4.383086442902681,20.0,0.0
5333,0,5333,[302 603 187 427 180],666,5,23380,4.383202099737533,20.0,0.0
5334,0,5334,[302 603 187 427 180],666,5,23385,4.383317713214621,20.0,0.0
5335,0,5335,[302 603 187 427 180],271,5,23390,4.383433283358321,20.0,0.0
5336,0,5336,[ 15  79 385 403  64],881,3,23393,4.383174067828368,0.0,0.0
5337,0,5337,[302 603 187 427 180],271,5,23398,4.383289621581117,20.0,0.0
5338,0,5338,[ 50 515 235  79 173],537,3,23401,4.383030530061809,0.0,20.0
5339,0,5339,[302 603 187 427 180],271,5,23406,4.383146067415731,20.0,0.0
5340,0,5340,[111 271 216 222  98],877,3,23409,4.382887099794046,0.0,20.0
5341,0,5341,[258 385 333 237  79],653,3,23412,4.3826282291276675,0.0,0.0
5342,0,5342,[302 603 187 427 180],537,5,23417,4.382743776904361,20.0,0.0
5343,0,5343,[ 71 127 403  82 235],479,2,23419,4.382297904191617,0.0,20.0
5344,0,5344,[302 603 187 427 180],271,5,23424,4.3824134705332085,20.0,0.0
5345,0,5345,[302 603 187 427 180],271,5,23429,4.382528993640105,20.0,0.0
5346,0,5346,[302 603 187 427 180],664,5,23434,4.382644473536563,20.0,0.0
5347,0,5347,[153   8  70 546 100],308,4,23438,4.382572924457741,0.0,20.0
5348,0,5348,[302 603 187 427 180],666,5,23443,4.382688352963171,20.0,0.0
5349,0,5349,[302 603 187 427 180],458,5,23448,4.382803738317757,20.0,0.0
5350,0,5350,[302 603 187 427 180],271,5,23453,4.382919080545692,20.0,0.0
5351,0,5351,[302 603 187 427 180],537,5,23458,4.383034379671151,20.0,0.0
5352,0,5352,[302 603 187 427 180],537,5,23463,4.383149635718289,20.0,0.0
5353,0,5353,[302 603 187 427 180],474,5,23468,4.383264848711244,20.0,0.0
5354,0,5354,[238 127 234 176  56],10,5,23473,4.383380018674137,0.0,20.0
5355,0,5355,[302 603 187 427 180],458,5,23478,4.383495145631068,20.0,0.0
5356,0,5356,[302 603 187 427 180],271,5,23483,4.383610229606123,20.0,0.0
5357,0,5357,[195 111  88 200  98],145,4,23487,4.383538633818589,0.0,20.0
5358,0,5358,[302 603 187 427 180],537,5,23492,4.3836536667288675,20.0,0.0
5359,0,5359,[302 603 187 427 180],90,5,23497,4.383768656716418,20.0,0.0
5360,0,5360,[302 603 187 427 180],13,5,23502,4.38388360380526,20.0,0.0
5361,0,5361,[302 603 187 427 180],537,5,23507,4.3839985080193955,20.0,0.0
5362,0,5362,[302 603 187 427 180],458,5,23512,4.384113369382808,20.0,0.0
5363,0,5363,[179 111 186 216 288],474,4,23516,4.384041759880686,0.0,0.0
5364,0,5364,[748   9  69 276 151],533,2,23518,4.383597390493942,0.0,0.0
5365,0,5365,[302 603 187 427 180],339,5,23523,4.3837122623928435,20.0,0.0
5366,0,5366,[302 603 187 427 180],537,5,23528,4.383827091485001,20.0,0.0
5367,0,5367,[196 118 318 181  11],653,2,23530,4.3833830104321905,20.0,0.0
5368,0,5368,[196 180 403 222 173],387,3,23533,4.383125349227044,0.0,0.0
5369,0,5369,[302 603 187 427 180],90,5,23538,4.383240223463687,20.0,0.0
5370,0,5370,[333  50  22  89  15],144,3,23541,4.38298268478868,0.0,20.0
5371,0,5371,[302 603 187 427 180],339,5,23546,4.383097542814594,20.0,0.0
5372,0,5372,[282 186 197 427  96],326,2,23548,4.382654010794714,0.0,0.0
5373,0,5373,[302 603 187 427 180],90,5,23553,4.3827688872348345,20.0,0.0
5374,0,5374,[302 603 187 427 180],666,5,23558,4.3828837209302325,20.0,0.0
5375,0,5375,[302 603 187 427 180],664,5,23563,4.382998511904762,20.0,0.0
5376,0,5376,[127 179 546 302  64],458,4,23567,4.382927282871489,0.0,20.0
5377,0,5377,[175  82   8  98 210],892,4,23571,4.382856080327259,0.0,20.0
5378,0,5378,[302 603 187 427 180],474,5,23576,4.382970812418665,20.0,0.0
5379,0,5379,[302 603 187 427 180],13,5,23581,4.383085501858736,20.0,0.0
5380,0,5380,[302 603 187 427 180],339,5,23586,4.383200148671251,20.0,0.0
5381,0,5381,[302 603 187 427 180],458,5,23591,4.38331475287997,20.0,0.0
5382,0,5382,[302 603 187 427 180],666,5,23596,4.383429314508638,20.0,0.0
5383,0,5383,[302 603 187 427 180],458,5,23601,4.383543833580981,20.0,0.0
5384,0,5384,[228   9 357  71  64],13,3,23604,4.383286908077994,20.0,0.0
5385,0,5385,[302 603 187 427 180],666,5,23609,4.383401411065726,20.0,0.0
5386,0,5386,[302 603 187 427 180],271,5,23614,4.383515871542603,20.0,0.0
5387,0,5387,[181  56 174 235 117],882,4,23618,4.383444691907943,0.0,20.0
5388,0,5388,[302 603 187 427 180],271,5,23623,4.383559101874188,20.0,0.0
5389,0,5389,[302 603 187 427 180],664,5,23628,4.383673469387755,20.0,0.0
5390,0,5390,[302 603 187 427 180],666,5,23633,4.383787794472268,20.0,0.0
5391,0,5391,[302 603 187 427 180],664,5,23638,4.383902077151335,20.0,0.0
5392,0,5392,[471 196 202  11 174],653,1,23639,4.38327461524198,0.0,20.0
5393,0,5393,[302 603 187 427 180],474,5,23644,4.383388950685947,20.0,0.0
5394,0,5394,[588 100 222 195 181],454,2,23646,4.382947173308619,0.0,20.0
5395,0,5395,[302 603 187 427 180],339,5,23651,4.383061527057079,20.0,0.0
5396,0,5396,[302 603 187 427 180],90,5,23656,4.383175838428757,20.0,0.0
5397,0,5397,[302 603 187 427 180],458,5,23661,4.383290107447203,20.0,0.0
5398,0,5398,[322 200 187 143 161],308,3,23664,4.383033895165771,0.0,0.0
5399,0,5399,[302 603 187 427 180],666,5,23669,4.383148148148148,20.0,0.0
5400,0,5400,[302 603 187 427 180],90,5,23674,4.38326235882244,20.0,0.0
5401,0,5401,[302 603 187 427 180],458,5,23679,4.383376527212143,20.0,0.0
5402,0,5402,[302 603 187 427 180],13,5,23684,4.383490653340736,20.0,0.0
5403,0,5403,[302 603 187 427 180],537,5,23689,4.38360473723168,20.0,0.0
5404,0,5404,[202 265 475 515 191],92,4,23693,4.383533765032378,0.0,0.0
5405,0,5405,[302 603 187 427 180],474,5,23698,4.383647798742138,20.0,0.0
5406,0,5406,[ 69  97 204 172 357],454,3,23701,4.38339189938968,20.0,0.0
5407,0,5407,[302 603 187 427 180],90,5,23706,4.383505917159764,20.0,0.0
5408,0,5408,[302 603 187 427 180],458,5,23711,4.383619892771307,20.0,0.0
5409,0,5409,[302 603 187 427 180],458,5,23716,4.383733826247689,20.0,0.0
5410,0,5410,[234 183  88  50 196],537,1,23717,4.383108482720385,0.0,20.0
5411,0,5411,[302 603 187 427 180],664,5,23722,4.383222468588322,20.0,0.0
5412,0,5412,[302 603 187 427 180],666,5,23727,4.383336412340661,20.0,0.0
5413,0,5413,[302 603 187 427 180],90,5,23732,4.383450314000739,20.0,0.0
5414,0,5414,[302 603 187 427 180],666,5,23737,4.383564173591874,20.0,0.0
5415,0,5415,[ 11 471  79 100 172],308,4,23741,4.383493353028065,0.0,20.0
5416,0,5416,[302 603 187 427 180],13,5,23746,4.383607162636145,20.0,0.0
5417,0,5417,[302 603 187 427 180],339,5,23751,4.383720930232558,20.0,0.0
5418,0,5418,[302 603 187 427 180],474,5,23756,4.383834655840561,20.0,0.0
5419,0,5419,[302 603 187 427 180],664,5,23761,4.3839483394833945,20.0,0.0
5420,0,5420,[302 603 187 427 180],13,5,23766,4.384061981184283,20.0,0.0
5421,0,5421,[302 603 187 427 180],664,5,23771,4.384175580966433,20.0,0.0
5422,0,5422,[302 603 187 427 180],13,5,23776,4.384289138853033,20.0,0.0
5423,0,5423,[302 603 187 427 180],13,5,23781,4.384402654867257,20.0,0.0
5424,0,5424,[471 191 180 175 483],524,4,23785,4.384331797235023,20.0,0.0
5425,0,5425,[302 603 187 427 180],339,5,23790,4.38444526354589,20.0,0.0
5426,0,5426,[302 603 187 427 180],474,5,23795,4.384558688041275,20.0,0.0
5427,0,5427,[302 603 187 427 180],13,5,23800,4.384672070744289,20.0,0.0
5428,0,5428,[  1 313  98 318 172],454,2,23802,4.384232823724443,20.0,20.0
5429,0,5429,[302 603 187 427 180],90,5,23807,4.384346224677716,20.0,0.0
5430,0,5430,[302 603 187 427 180],474,5,23812,4.384459583870374,20.0,0.0
5431,0,5431,[302 603 187 427 180],271,5,23817,4.384572901325479,20.0,0.0
5432,0,5432,[302 603 187 427 180],458,5,23822,4.384686177066078,20.0,0.0
5433,0,5433,[302 603 187 427 180],458,5,23827,4.384799411115201,20.0,0.0
5434,0,5434,[302 603 187 427 180],474,5,23832,4.38491260349586,20.0,0.0
5435,0,5435,[ 95 135 172 179 118],271,4,23836,4.384841795437822,0.0,0.0
5436,0,5436,[195  70  98 111 194],207,2,23838,4.384403163509289,0.0,20.0
5437,0,5437,[273 211  28 289 742],387,3,23841,4.3841485840382495,0.0,0.0
5438,0,5438,[302 603 187 427 180],271,5,23846,4.384261812833241,20.0,0.0
5439,0,5439,[302 603 187 427 180],537,5,23851,4.384375,20.0,0.0
5440,0,5440,[302 603 187 427 180],339,5,23856,4.384488145561478,20.0,0.0
5441,0,5441,[302 603 187 427 180],458,5,23861,4.38460124954061,20.0,0.0
5442,0,5442,[302 603 187 427 180],90,5,23866,4.384714311960316,20.0,0.0
5443,0,5443,[302 603 187 427 180],271,5,23871,4.384827332843497,20.0,0.0
5444,0,5444,[302 603 187 427 180],271,5,23876,4.38494031221304,20.0,0.0
5445,0,5445,[ 50 508 151 228 127],59,5,23881,4.3850532500918105,0.0,40.0
5446,0,5446,[655 191 423 678 333],334,4,23885,4.384982559206903,0.0,0.0
5447,0,5447,[302 603 187 427 180],474,5,23890,4.385095447870778,20.0,0.0
5448,0,5448,[302 603 187 427 180],664,5,23895,4.385208295100019,20.0,0.0
5449,0,5449,[302 603 187 427 180],13,5,23900,4.385321100917431,20.0,0.0
5450,0,5450,[302 603 187 427 180],339,5,23905,4.385433865345808,20.0,0.0
5451,0,5451,[302 603 187 427 180],537,5,23910,4.385546588407924,20.0,0.0
5452,0,5452,[302 603 187 427 180],664,5,23915,4.385659270126536,20.0,0.0
5453,0,5453,[302 603 187 427 180],13,5,23920,4.385771910524386,20.0,0.0
5454,0,5454,[302 603 187 427 180],474,5,23925,4.385884509624198,20.0,0.0
5455,0,5455,[302 603 187 427 180],666,5,23930,4.38599706744868,20.0,0.0
5456,0,5456,[302 603 187 427 180],339,5,23935,4.386109584020524,20.0,0.0
5457,0,5457,[302 603 187 427 180],666,5,23940,4.386222059362404,20.0,0.0
5458,0,5458,[302 603 187 427 180],271,5,23945,4.386334493496977,20.0,0.0
5459,0,5459,[302 603 187 427 180],13,5,23950,4.386446886446887,20.0,0.0
5460,0,5460,[597 144 435 161 328],804,3,23953,4.3861930049441495,0.0,0.0
5461,0,5461,[302 603 187 427 180],90,5,23958,4.38630538264372,20.0,0.0
5462,0,5462,[302 603 187 427 180],537,5,23963,4.386417719201904,20.0,0.0
5463,0,5463,[302 603 187 427 180],474,5,23968,4.386530014641289,20.0,0.0
5464,0,5464,[302 603 187 427 180],666,5,23973,4.386642268984446,20.0,0.0
5465,0,5465,[385 183 161 174 222],234,1,23974,4.386022685693377,0.0,20.0
5466,0,5466,[302 603 187 427 180],537,5,23979,4.386134991768794,20.0,0.0
5467,0,5467,[302 603 187 427 180],90,5,23984,4.386247256766643,20.0,0.0
5468,0,5468,[302 603 187 427 180],13,5,23989,4.386359480709453,20.0,0.0
5469,0,5469,[302 603 187 427 180],339,5,23994,4.386471663619744,20.0,0.0
5470,0,5470,[302 603 187 427 180],664,5,23999,4.386583805520015,20.0,0.0
5471,0,5471,[302 603 187 427 180],666,5,24004,4.386695906432749,20.0,0.0
5472,0,5472,[302 603 187 427 180],339,5,24009,4.386807966380413,20.0,0.0
5473,0,5473,[273 322 357 197 194],308,2,24011,4.38637194008038,20.0,0.0
5474,0,5474,[678   7 194 328 300],537,1,24012,4.385753424657534,0.0,0.0
5475,0,5475,[302 603 187 427 180],537,5,24017,4.385865595325055,20.0,0.0
5476,0,5476,[302 603 187 427 180],271,5,24022,4.385977725031951,20.0,0.0
5477,0,5477,[302 603 187 427 180],666,5,24027,4.386089813800657,20.0,0.0
5478,0,5478,[161   1 200 195 678],881,2,24029,4.3856543164811095,0.0,0.0
5479,0,5479,[302 603 187 427 180],664,5,24034,4.385766423357664,20.0,0.0
5480,0,5480,[302 603 187 427 180],90,5,24039,4.385878489326765,20.0,0.0
5481,0,5481,[ 95   8 100   7 597],554,3,24042,4.385625684056913,0.0,20.0
5482,0,5482,[302 603 187 427 180],13,5,24047,4.385737734816706,20.0,0.0
5483,0,5483,[302 603 187 427 180],13,5,24052,4.385849744711889,20.0,0.0
5484,0,5484,[302 603 187 427 180],664,5,24057,4.3859617137648135,20.0,0.0
5485,0,5485,[ 98 100 237   1   9],184,5,24062,4.386073641997813,0.0,40.0
5486,0,5486,[302 603 187 427 180],474,5,24067,4.386185529433206,20.0,0.0
5487,0,5487,[302 603 187 427 180],458,5,24072,4.386297376093294,20.0,0.0
5488,0,5488,[  7 161  69 194 475],452,4,24076,4.386226999453452,0.0,0.0
5489,0,5489,[302 603 187 427 180],13,5,24081,4.386338797814208,20.0,0.0
5490,0,5490,[302 603 187 427 180],90,5,24086,4.38645055545438,20.0,0.0
5491,0,5491,[197 183  50 357 195],643,5,24091,4.386562272396213,20.0,20.0
5492,0,5492,[302 603 187 427 180],666,5,24096,4.386673948661933,20.0,0.0
5493,0,5493,[603 183 471 655 597],7,4,24100,4.386603567528213,20.0,0.0
5494,0,5494,[302 603 187 427 180],666,5,24105,4.386715195632393,20.0,0.0
5495,0,5495,[302 603 187 427 180],474,5,24110,4.3868267831149925,20.0,0.0
5496,0,5496,[302 603 187 427 180],90,5,24115,4.386938329998181,20.0,0.0
5497,0,5497,[302 603 187 427 180],13,5,24120,4.387049836304111,20.0,0.0
5498,0,5498,[175 427 172 423  69],537,2,24122,4.386615748317876,0.0,0.0
5499,0,5499,[302 603 187 427 180],271,5,24127,4.386727272727272,20.0,0.0
5500,0,5500,[275   9  64 172 496],533,5,24132,4.386838756589711,0.0,0.0
5501,0,5501,[302 603 187 427 180],537,5,24137,4.386950199927299,20.0,0.0
5502,0,5502,[302 603 187 427 180],271,5,24142,4.38706160276213,20.0,0.0
5503,0,5503,[302 603 187 427 180],339,5,24147,4.387172965116279,20.0,0.0
5504,0,5504,[302 603 187 427 180],271,5,24152,4.387284287011807,20.0,0.0
5505,0,5505,[ 15 174  98 197 183],452,5,24157,4.387395568470759,0.0,40.0
5506,0,5506,[302 603 187 427 180],664,5,24162,4.387506809515163,20.0,0.0
5507,0,5507,[435 742 238 174 183],650,4,24166,4.387436456063907,0.0,20.0
5508,0,5508,[302 603 187 427 180],537,5,24171,4.387547649301143,20.0,0.0
5509,0,5509,[ 89 175 127 588 185],13,4,24175,4.387477313974592,0.0,20.0
5510,0,5510,[435 211 204 276 271],883,4,24179,4.387407004173471,0.0,0.0
5511,0,5511,[475  71 135 597 515],92,4,24183,4.38733671988389,0.0,0.0
5512,0,5512,[302 603 187 427 180],271,5,24188,4.387447850535099,20.0,0.0
5513,0,5513,[302 603 187 427 180],474,5,24193,4.387558940877765,20.0,0.0
5514,0,5514,[237 471 186 121 546],92,4,24197,4.387488667271079,0.0,0.0
5515,0,5515,[302 603 187 427 180],458,5,24202,4.387599709934736,20.0,0.0
5516,0,5516,[302 603 187 427 180],13,5,24207,4.387710712343665,20.0,0.0
5517,0,5517,[302 603 187 427 180],664,5,24212,4.387821674519754,20.0,0.0
5518,0,5518,[302 603 187 427 180],13,5,24217,4.3879325964848706,20.0,0.0
5519,0,5519,[302 603 187 427 180],13,5,24222,4.38804347826087,20.0,0.0
5520,0,5520,[302 603 187 427 180],13,5,24227,4.388154319869589,20.0,0.0
5521,0,5521,[496 196 222 471 423],815,4,24231,4.388084027526259,0.0,0.0
5522,0,5522,[546 238 423 294 185],308,3,24234,4.387832699619772,0.0,0.0
5523,0,5523,[302 603 187 427 180],474,5,24239,4.387943519188993,20.0,0.0
5524,0,5524,[302 603 187 427 180],666,5,24244,4.388054298642534,20.0,0.0
5525,0,5525,[302 603 187 427 180],13,5,24249,4.388165038002172,20.0,0.0
5526,0,5526,[143 186 174 269 318],318,5,24254,4.388275737289669,20.0,20.0
5527,0,5527,[302 603 187 427 180],458,5,24259,4.388386396526773,20.0,0.0
5528,0,5528,[172 357  71 153 144],387,3,24262,4.388135286670284,20.0,0.0
5529,0,5529,[302 603 187 427 180],537,5,24267,4.388245931283906,20.0,0.0
5530,0,5530,[302 603 187 427 180],90,5,24272,4.388356535888628,20.0,0.0
5531,0,5531,[302 603 187 427 180],271,5,24277,4.388467100506146,20.0,0.0
5532,0,5532,[302 603 187 427 180],664,5,24282,4.388577625158142,20.0,0.0
5533,0,5533,[302 603 187 427 180],90,5,24287,4.3886881098662816,20.0,0.0
5534,0,5534,[302 603 187 427 180],13,5,24292,4.3887985546522135,20.0,0.0
5535,0,5535,[302 603 187 427 180],339,5,24297,4.388908959537572,20.0,0.0
5536,0,5536,[302 603 187 427 180],90,5,24302,4.389019324543977,20.0,0.0
5537,0,5537,[302 603 187 427 180],339,5,24307,4.38912964969303,20.0,0.0
5538,0,5538,[173 276 286 183 385],537,2,24309,4.3886983209965695,0.0,0.0
5539,0,5539,[302 603 187 427 180],271,5,24314,4.388808664259928,20.0,0.0
5540,0,5540,[302 603 187 427 180],666,5,24319,4.3889189676953615,20.0,0.0
5541,0,5541,[302 603 187 427 180],13,5,24324,4.3890292313244315,20.0,0.0
5542,0,5542,[302 603 187 427 180],271,5,24329,4.3891394551686815,20.0,0.0
5543,0,5543,[176 257   4 222 181],650,3,24332,4.388888888888889,0.0,0.0
5544,0,5544,[302 603 187 427 180],666,5,24337,4.388999098286745,20.0,0.0
5545,0,5545,[302 603 187 427 180],666,5,24342,4.389109267940858,20.0,0.0
5546,0,5546,[302 603 187 427 180],13,5,24347,4.389219397872724,20.0,0.0
5547,0,5547,[ 82 168 183 127 194],64,4,24351,4.38914924297044,0.0,20.0
5548,0,5548,[546 100 322   4 215],804,4,24355,4.389079113353757,0.0,20.0
5549,0,5549,[144 515 182 655 216],313,5,24360,4.389189189189189,0.0,0.0
5550,0,5550,[302 603 187 427 180],13,5,24365,4.389299225364799,20.0,0.0
5551,0,5551,[302 603 187 427 180],339,5,24370,4.389409221902017,20.0,0.0
5552,0,5552,[302 603 187 427 180],666,5,24375,4.389519178822258,20.0,0.0
5553,0,5553,[234  64 179 257 202],738,3,24378,4.389268995318689,0.0,0.0
5554,0,5554,[302 603 187 427 180],90,5,24383,4.389378937893789,20.0,0.0
5555,0,5555,[181 194  50 111 496],59,4,24387,4.389308855291577,0.0,20.0
5556,0,5556,[302 603 187 427 180],13,5,24392,4.389418751124707,20.0,0.0
5557,0,5557,[302 603 187 427 180],271,5,24397,4.389528607412738,20.0,0.0
5558,0,5558,[257 302 181 423 215],144,4,24401,4.3894585357078615,0.0,0.0
5559,0,5559,[302 603 187 427 180],537,5,24406,4.389568345323741,20.0,0.0
5560,0,5560,[302 603 187 427 180],666,5,24411,4.389678115446862,20.0,0.0
5561,0,5561,[302 603 187 427 180],458,5,24416,4.389787846098526,20.0,0.0
5562,0,5562,[302 603 187 427 180],458,5,24421,4.389897537300018,20.0,0.0
5563,0,5563,[302 603 187 427 180],664,5,24426,4.39000718907261,20.0,0.0
5564,0,5564,[ 95 210  11  97  64],454,3,24429,4.389757412398922,0.0,0.0
5565,0,5565,[  1 289 385 202 168],95,4,24433,4.389687387711104,0.0,0.0
5566,0,5566,[302 603 187 427 180],458,5,24438,4.389797018142626,20.0,0.0
5567,0,5567,[302 603 187 427 180],13,5,24443,4.389906609195402,20.0,0.0
5568,0,5568,[302 603 187 427 180],666,5,24448,4.390016160890645,20.0,0.0
5569,0,5569,[ 69 275  11  56  82],455,4,24452,4.3899461400359066,0.0,0.0
5570,0,5570,[302 603 187 427 180],537,5,24457,4.390055645306049,20.0,0.0
5571,0,5571,[302 603 187 427 180],666,5,24462,4.390165111270639,20.0,0.0
5572,0,5572,[302 603 187 427 180],666,5,24467,4.390274537950835,20.0,0.0
5573,0,5573,[357  64 403 546 515],13,1,24468,4.389666307857912,20.0,0.0
5574,0,5574,[302 603 187 427 180],666,5,24473,4.389775784753363,20.0,0.0
5575,0,5575,[427  70 286  97 118],194,1,24474,4.389167862266858,0.0,0.0
5576,0,5576,[302 603 187 427 180],339,5,24479,4.389277389277389,20.0,0.0
5577,0,5577,[196 187 427 181  25],234,2,24481,4.388849049838652,0.0,0.0
5578,0,5578,[302 603 187 427 180],664,5,24486,4.388958594730238,20.0,0.0
5579,0,5579,[302 603 187 427 180],90,5,24491,4.389068100358423,20.0,0.0
5580,0,5580,[302 603 187 427 180],458,5,24496,4.389177566744311,20.0,0.0
5581,0,5581,[302 603 187 427 180],13,5,24501,4.389286993908994,20.0,0.0
5582,0,5582,[211  71 597 423 187],328,4,24505,4.38921726670249,0.0,0.0
5583,0,5583,[302 603 187 427 180],664,5,24510,4.38932664756447,20.0,0.0
5584,0,5584,[655 318   9 153 328],85,2,24512,4.388898836168308,20.0,0.0
5585,0,5585,[118 568 200 179 173],378,3,24515,4.3886501969208735,0.0,0.0
5586,0,5586,[302 603 187 427 180],271,5,24520,4.3887596205477,20.0,0.0
5587,0,5587,[302 603 187 427 180],537,5,24525,4.388869005010737,20.0,0.0
5588,0,5588,[ 96  82 197  28 168],666,2,24527,4.388441581678297,0.0,0.0
5589,0,5589,[302 603 187 427 180],458,5,24532,4.388550983899821,20.0,0.0
5590,0,5590,[302 603 187 427 180],90,5,24537,4.388660346986228,20.0,0.0
5591,0,5591,[269  69 216 196 143],666,1,24538,4.388054363376252,0.0,0.0
5592,0,5592,[ 95 357   7   4  64],234,3,24541,4.387806186304309,20.0,0.0
5593,0,5593,[302 603 187 427 180],666,5,24546,4.387915623882732,20.0,0.0
5594,0,5594,[302 603 187 427 180],13,5,24551,4.388025022341377,20.0,0.0
5595,0,5595,[302 603 187 427 180],664,5,24556,4.3881343817012155,20.0,0.0
5596,0,5596,[302 603 187 427 180],664,5,24561,4.388243701983205,20.0,0.0
5597,0,5597,[496 161 423 117 182],339,2,24563,4.387817077527688,0.0,0.0
5598,0,5598,[200 183 210 294  70],378,3,24566,4.3875692087872835,0.0,0.0
5599,0,5599,[546  96  50 216 132],13,3,24569,4.387321428571428,0.0,20.0
5600,0,5600,[302 603 187 427 180],271,5,24574,4.387430815925727,20.0,0.0
5601,0,5601,[185  89 273 191 143],59,3,24577,4.387183148875402,0.0,0.0
5602,0,5602,[302 603 187 427 180],271,5,24582,4.387292521863287,20.0,0.0
5603,0,5603,[302 603 187 427 180],664,5,24587,4.387401855817274,20.0,0.0
5604,0,5604,[302 603 187 427 180],537,5,24592,4.387511150758251,20.0,0.0
5605,0,5605,[ 98 282 515 180 194],326,3,24595,4.387263646093471,0.0,20.0
5606,0,5606,[302 603 187 427 180],537,5,24600,4.387372926698769,20.0,0.0
5607,0,5607,[228  96 568 435  71],648,4,24604,4.387303851640514,0.0,0.0
5608,0,5608,[187 200 135 435  15],6,3,24607,4.387056516313068,0.0,0.0
5609,0,5609,[588 168 603  95 127],398,4,24611,4.38698752228164,20.0,20.0
5610,0,5610,[294 183  11 515  98],7,2,24613,4.386562110140795,0.0,20.0
5611,0,5611,[302 603 187 427 180],537,5,24618,4.386671418389166,20.0,0.0
5612,0,5612,[302 603 187 427 180],664,5,24623,4.386780687689293,20.0,0.0
5613,0,5613,[302 603 187 427 180],474,5,24628,4.386889918061988,20.0,0.0
5614,0,5614,[546 176 117  96 403],158,3,24631,4.386642920747996,0.0,0.0
5615,0,5615,[302 603 187 427 180],666,5,24636,4.386752136752137,20.0,0.0
5616,0,5616,[302 603 187 427 180],537,5,24641,4.386861313868613,20.0,0.0
5617,0,5617,[179 195 269 211  98],452,4,24645,4.386792452830188,0.0,20.0
5618,0,5618,[357 546 186 435 234],308,3,24648,4.386545648691938,20.0,0.0
5619,0,5619,[302 603 187 427 180],537,5,24653,4.386654804270463,20.0,0.0
5620,0,5620,[302 603 187 427 180],339,5,24658,4.3867639210104965,20.0,0.0
5621,0,5621,[302 603 187 427 180],271,5,24663,4.386872998932764,20.0,0.0
5622,0,5622,[302 603 187 427 180],13,5,24668,4.386982038057976,20.0,0.0
5623,0,5623,[302 603 187 427 180],666,5,24673,4.387091038406828,20.0,0.0
5624,0,5624,[ 64 216 265 496 475],64,5,24678,4.3872,0.0,0.0
5625,0,5625,[302 603 187 427 180],537,5,24683,4.387308922858159,20.0,0.0
5626,0,5626,[302 603 187 427 180],458,5,24688,4.387417807001955,20.0,0.0
5627,0,5627,[302 603 187 427 180],458,5,24693,4.387526652452026,20.0,0.0
5628,0,5628,[302 603 187 427 180],666,5,24698,4.387635459228993,20.0,0.0
5629,0,5629,[286 125  50  70 151],59,2,24700,4.38721136767318,0.0,20.0
5630,0,5630,[202 135 496  64 357],406,4,24704,4.387142603445214,20.0,0.0
5631,0,5631,[302 603 187 427 180],13,5,24709,4.387251420454546,20.0,0.0
5632,0,5632,[302 603 187 427 180],666,5,24714,4.387360198828333,20.0,0.0
5633,0,5633,[302 603 187 427 180],13,5,24719,4.3874689385871495,20.0,0.0
5634,0,5634,[302 603 187 427 180],474,5,24724,4.3875776397515525,20.0,0.0
5635,0,5635,[302 603 187 427 180],339,5,24729,4.387686302342087,20.0,0.0
5636,0,5636,[302 603 187 427 180],271,5,24734,4.3877949263792795,20.0,0.0
5637,0,5637,[302 603 187 427 180],90,5,24739,4.387903511883646,20.0,0.0
5638,0,5638,[302 603 187 427 180],90,5,24744,4.388012058875687,20.0,0.0
5639,0,5639,[302 603 187 427 180],537,5,24749,4.3881205673758865,20.0,0.0
5640,0,5640,[748  12 302 153 289],788,3,24752,4.387874490338593,20.0,0.0
5641,0,5641,[302 603 187 427 180],271,5,24757,4.387982984757178,20.0,0.0
5642,0,5642,[302 603 187 427 180],458,5,24762,4.38809144072302,20.0,0.0
5643,0,5643,[153 135 318 182 603],90,4,24766,4.388022678951098,40.0,0.0
5644,0,5644,[191 423 222 286 568],13,1,24767,4.387422497785651,0.0,0.0
5645,0,5645,[302 603 187 427 180],537,5,24772,4.38753099539497,20.0,0.0
5646,0,5646,[302 603 187 427 180],666,5,24777,4.387639454577652,20.0,0.0
5647,0,5647,[ 82 118   7  79 405],774,0,24777,4.386862606232294,0.0,0.0
5648,0,5648,[302 603 187 427 180],339,5,24782,4.386971145335457,20.0,0.0
5649,0,5649,[302 603 187 427 180],537,5,24787,4.387079646017699,20.0,0.0
5650,0,5650,[302 603 187 427 180],458,5,24792,4.387188108299416,20.0,0.0
5651,0,5651,[302 603 187 427 180],666,5,24797,4.387296532200991,20.0,0.0
5652,0,5652,[ 82 568 275 322 385],308,4,24801,4.3872280205200775,0.0,0.0
5653,0,5653,[144 196 234 204 216],144,4,24805,4.38715953307393,0.0,0.0
5654,0,5654,[302 603 187 427 180],537,5,24810,4.387267904509284,20.0,0.0
5655,0,5655,[ 79 183 322 144 173],346,3,24813,4.387022630834512,0.0,0.0
5656,0,5656,[ 64 748 475 258   8],13,4,24817,4.386954216015556,0.0,0.0
5657,0,5657,[302 603 187 427 180],90,5,24822,4.387062566277836,20.0,0.0
5658,0,5658,[302 603 187 427 180],271,5,24827,4.38717087824704,20.0,0.0
5659,0,5659,[200 185 186 151 288],897,5,24832,4.387279151943463,0.0,0.0
5660,0,5660,[302 603 187 427 180],664,5,24837,4.387387387387387,20.0,0.0
5661,0,5661,[302 603 187 427 180],271,5,24842,4.3874955845990815,20.0,0.0
5662,0,5662,[302 603 187 427 180],13,5,24847,4.387603743598799,20.0,0.0
5663,0,5663,[302 603 187 427 180],339,5,24852,4.387711864406779,20.0,0.0
5664,0,5664,[202 181 185 238  25],271,3,24855,4.387466902030009,0.0,0.0
5665,0,5665,[273 182 588 210 191],378,5,24860,4.387575008824568,0.0,0.0
5666,0,5666,[302 603 187 427 180],90,5,24865,4.387683077466032,20.0,0.0
5667,0,5667,[202  50 435 603 286],271,5,24870,4.387791107974595,20.0,20.0
5668,0,5668,[197 174 179 313  64],85,5,24875,4.3878991003704355,0.0,20.0
5669,0,5669,[302 603 187 427 180],537,5,24880,4.3880070546737215,20.0,0.0
5670,0,5670,[302 603 187 427 180],13,5,24885,4.388114970904603,20.0,0.0
5671,0,5671,[143 175  79 435  12],474,5,24890,4.388222849083216,20.0,0.0
5672,0,5672,[302 603 187 427 180],271,5,24895,4.388330689229685,20.0,0.0
5673,0,5673,[ 69 127  97 121 301],85,3,24898,4.3880860063447304,0.0,20.0
5674,0,5674,[302 603 187 427 180],666,5,24903,4.388193832599119,20.0,0.0
5675,0,5675,[302 603 187 427 180],664,5,24908,4.38830162085976,20.0,0.0
5676,0,5676,[302 603 187 427 180],666,5,24913,4.388409371146732,20.0,0.0
5677,0,5677,[748  28  98 191 200],313,2,24915,4.387988728425502,0.0,20.0
5678,0,5678,[182   8  28 403 197],774,1,24916,4.387392146504666,0.0,0.0
5679,0,5679,[176  28  95 185 180],897,4,24920,4.387323943661972,0.0,0.0
5680,0,5680,[302 603 187 427 180],339,5,24925,4.387431790177786,20.0,0.0
5681,0,5681,[302 603 187 427 180],664,5,24930,4.3875395987328405,20.0,0.0
5682,0,5682,[161 333 238 100 228],13,3,24933,4.38729544254795,0.0,20.0
5683,0,5683,[302 603 187 427 180],271,5,24938,4.387403237156931,20.0,0.0
5684,0,5684,[333 483 301 238 100],13,2,24940,4.38698328935796,20.0,20.0
5685,0,5685,[245 200 288 546 183],804,2,24942,4.386563489271896,0.0,0.0
5686,0,5686,[302 603 187 427 180],537,5,24947,4.38667135572358,20.0,0.0
5687,0,5687,[302 603 187 427 180],537,5,24952,4.386779184247539,20.0,0.0
5688,0,5688,[302 603 187 427 180],90,5,24957,4.386886974863772,20.0,0.0
5689,0,5689,[302 603 187 427 180],13,5,24962,4.386994727592267,20.0,0.0
5690,0,5690,[302 603 187 427 180],664,5,24967,4.387102442452996,20.0,0.0
5691,0,5691,[  7 111 185 475 121],13,2,24969,4.386683063949403,0.0,0.0
5692,0,5692,[302 603 187 427 180],474,5,24974,4.386790795714035,20.0,0.0
5693,0,5693,[302 603 187 427 180],271,5,24979,4.386898489638216,20.0,0.0
5694,0,5694,[175  28 153 288  82],308,4,24983,4.386830553116769,0.0,0.0
5695,0,5695,[302 603 187 427 180],271,5,24988,4.386938202247191,20.0,0.0
5696,0,5696,[302 603 187 427 180],474,5,24993,4.387045813586098,20.0,0.0
5697,0,5697,[302 603 187 427 180],271,5,24998,4.387153387153387,20.0,0.0
5698,0,5698,[302 603 187 427 180],458,5,25003,4.387260922968942,20.0,0.0
5699,0,5699,[302 603 187 427 180],664,5,25008,4.387368421052631,20.0,0.0
5700,0,5700,[302 603 187 427 180],458,5,25013,4.3874758814243116,20.0,0.0
5701,0,5701,[117 423  89 405 153],815,4,25017,4.387407927043143,0.0,0.0
5702,0,5702,[405 121  50  64 202],92,3,25020,4.387164650184114,0.0,20.0
5703,0,5703,[ 50 603 748 179 597],13,3,25023,4.386921458625526,20.0,20.0
5704,0,5704,[302 603 187 427 180],271,5,25028,4.3870289219982475,20.0,0.0
5705,0,5705,[568 328 125  11 132],749,5,25033,4.387136347704171,0.0,0.0
5706,0,5706,[302 603 187 427 180],664,5,25038,4.387243735763098,20.0,0.0
5707,0,5707,[475 328 300 200   4],537,1,25039,4.386650315346881,0.0,0.0
5708,0,5708,[302 603 187 427 180],271,5,25044,4.3867577509196005,20.0,0.0
5709,0,5709,[228 294  88 200 588],897,4,25048,4.386690017513135,0.0,0.0
5710,0,5710,[302 603 187 427 180],271,5,25053,4.386797408509893,20.0,0.0
5711,0,5711,[302 603 187 427 180],271,5,25058,4.386904761904762,20.0,0.0
5712,0,5712,[211 385 405 210 195],638,4,25062,4.386837038333625,0.0,0.0
5713,0,5713,[302 603 187 427 180],90,5,25067,4.386944347217361,20.0,0.0
5714,0,5714,[302 603 187 427 180],13,5,25072,4.387051618547681,20.0,0.0
5715,0,5715,[302 603 187 427 180],271,5,25077,4.387158852344297,20.0,0.0
5716,0,5716,[300  79 185 216 385],479,2,25079,4.386741297883505,0.0,0.0
5717,0,5717,[302 603 187 427 180],666,5,25084,4.386848548443512,20.0,0.0
5718,0,5718,[302 603 187 427 180],474,5,25089,4.386955761496766,20.0,0.0
5719,0,5719,[588  95 322  69 174],263,3,25092,4.386713286713286,0.0,20.0
5720,0,5720,[ 22 168 275  64 175],6,4,25096,4.386645691312707,0.0,0.0
5721,0,5721,[302 603 187 427 180],339,5,25101,4.38675288360713,20.0,0.0
5722,0,5722,[172  95 211 210  89],194,1,25102,4.386161104315918,0.0,0.0
5723,0,5723,[204 423 181 144 302],207,2,25104,4.385744234800838,0.0,0.0
5724,0,5724,[385  25 265  89 181],13,3,25107,4.385502183406113,0.0,0.0
5725,0,5725,[302 603 187 427 180],271,5,25112,4.385609500523926,20.0,0.0
5726,0,5726,[302 603 187 427 180],458,5,25117,4.385716780164135,20.0,0.0
5727,0,5727,[302 603 187 427 180],664,5,25122,4.385824022346369,20.0,0.0
5728,0,5728,[197 385 187  12 265],308,3,25125,4.385582126025485,20.0,0.0
5729,0,5729,[144 210  82 211  95],454,3,25128,4.385340314136125,0.0,0.0
5730,0,5730,[302 603 187 427 180],13,5,25133,4.385447565869831,20.0,0.0
5731,0,5731,[269 111 568 215  89],64,4,25137,4.3853803210048845,0.0,0.0
5732,0,5732,[302 603 187 427 180],13,5,25142,4.3854875283446715,20.0,0.0
5733,0,5733,[302 603 187 427 180],271,5,25147,4.385594698290896,20.0,0.0
5734,0,5734,[302 603 187 427 180],271,5,25152,4.3857018308631215,20.0,0.0
5735,0,5735,[313  97  70  95 234],378,5,25157,4.385808926080893,0.0,0.0
5736,0,5736,[111 313 210 174 151],64,3,25160,4.385567369705421,0.0,20.0
5737,0,5737,[302 603 187 427 180],271,5,25165,4.385674451028232,20.0,0.0
5738,0,5738,[302 603 187 427 180],474,5,25170,4.385781495033978,20.0,0.0
5739,0,5739,[197 215  28  71 238],13,4,25174,4.385714285714286,0.0,0.0
5740,0,5740,[302 603 187 427 180],474,5,25179,4.385821285490333,20.0,0.0
5741,0,5741,[302 603 187 427 180],271,5,25184,4.385928247997214,20.0,0.0
5742,0,5742,[302 603 187 427 180],537,5,25189,4.386035173254396,20.0,0.0
5743,0,5743,[197  89  69  50 210],537,3,25192,4.385793871866295,0.0,20.0
5744,0,5744,[302 603 187 427 180],537,5,25197,4.385900783289817,20.0,0.0
5745,0,5745,[302 603 187 427 180],474,5,25202,4.38600765750087,20.0,0.0
5746,0,5746,[302 603 187 427 180],664,5,25207,4.386114494518879,20.0,0.0
5747,0,5747,[302 603 187 427 180],458,5,25212,4.386221294363256,20.0,0.0
5748,0,5748,[302 603 187 427 180],90,5,25217,4.386328057053401,20.0,0.0
5749,0,5749,[302 603 187 427 180],339,5,25222,4.386434782608696,20.0,0.0
5750,0,5750,[302 603 187 427 180],666,5,25227,4.386541471048513,20.0,0.0
5751,0,5751,[302 603 187 427 180],458,5,25232,4.386648122392211,20.0,0.0
5752,0,5752,[294 173 357 175 435],406,3,25235,4.386407091952025,20.0,0.0
5753,0,5753,[302 603 187 427 180],474,5,25240,4.386513729579423,20.0,0.0
5754,0,5754,[302 603 187 427 180],339,5,25245,4.386620330147697,20.0,0.0
5755,0,5755,[302 603 187 427 180],664,5,25250,4.386726893676164,20.0,0.0
5756,0,5756,[273 235 182   7 135],145,5,25255,4.386833420184123,0.0,0.0
5757,0,5757,[302 603 187 427 180],664,5,25260,4.386939909690865,20.0,0.0
5758,0,5758,[127 144  70 515  12],13,3,25263,4.386699079701337,20.0,20.0
5759,0,5759,[ 79 179   4   7  28],189,3,25266,4.386458333333334,0.0,0.0
5760,0,5760,[302 603 187 427 180],339,5,25271,4.386564832494359,20.0,0.0
5761,0,5761,[302 603 187 427 180],271,5,25276,4.386671294689344,20.0,0.0
5762,0,5762,[568 186 179 403 144],343,4,25280,4.3866041992018046,0.0,0.0
5763,0,5763,[302 603 187 427 180],664,5,25285,4.386710617626648,20.0,0.0
5764,0,5764,[ 79 196  89 483 405],537,2,25287,4.386296617519514,20.0,0.0
5765,0,5765,[302 603 187 427 180],537,5,25292,4.386403052375997,20.0,0.0
5766,0,5766,[302 603 187 427 180],666,5,25297,4.386509450320791,20.0,0.0
5767,0,5767,[302 603 187 427 180],474,5,25302,4.386615811373093,20.0,0.0
5768,0,5768,[302 603 187 427 180],13,5,25307,4.3867221355520885,20.0,0.0
5769,0,5769,[302 603 187 427 180],458,5,25312,4.38682842287695,20.0,0.0
5770,0,5770,[ 96 125 151  97 403],788,0,25312,4.386068272396465,0.0,0.0
5771,0,5771,[302 603 187 427 180],664,5,25317,4.386174636174636,20.0,0.0
5772,0,5772,[302 603 187 427 180],90,5,25322,4.386280963104105,20.0,0.0
5773,0,5773,[183 100  88 423 405],749,3,25325,4.386040872878421,0.0,20.0
5774,0,5774,[302 603 187 427 180],339,5,25330,4.386147186147186,20.0,0.0
5775,0,5775,[471   8   4 508  22],92,4,25334,4.386080332409972,0.0,0.0
5776,0,5776,[ 82 546 265 135 186],882,4,25338,4.386013501817552,0.0,0.0
5777,0,5777,[302 603 187 427 180],90,5,25343,4.386119764624437,20.0,0.0
5778,0,5778,[302 603 187 427 180],666,5,25348,4.386225990655823,20.0,0.0
5779,0,5779,[153 179 185 175 132],843,2,25350,4.385813148788928,0.0,0.0
5780,0,5780,[302 603 187 427 180],458,5,25355,4.385919391108804,20.0,0.0
5781,0,5781,[302 603 187 427 180],90,5,25360,4.3860255966793495,20.0,0.0
5782,0,5782,[568 496 228  50  56],533,4,25364,4.385958844890196,0.0,20.0
5783,0,5783,[302 603 187 427 180],537,5,25369,4.386065006915629,20.0,0.0
5784,0,5784,[302 603 187 427 180],13,5,25374,4.386171132238548,20.0,0.0
5785,0,5785,[276 187  95 135 143],234,2,25376,4.385758727964051,0.0,0.0
5786,0,5786,[302 603 187 427 180],90,5,25381,4.385864869535165,20.0,0.0
5787,0,5787,[202 403 313  82 100],830,4,25385,4.385798203178991,0.0,20.0
5788,0,5788,[302 603 187 427 180],271,5,25390,4.385904301261013,20.0,0.0
5789,0,5789,[172 121 100   4 143],7,4,25394,4.385837651122626,0.0,20.0
5790,0,5790,[204 172 132 173 483],749,5,25399,4.385943705750302,20.0,0.0
5791,0,5791,[294 210  71 216 121],279,2,25401,4.3855317679558015,0.0,0.0
5792,0,5792,[302 603 187 427 180],537,5,25406,4.38563783877093,20.0,0.0
5793,0,5793,[302 603 187 427 180],271,5,25411,4.38574387297204,20.0,0.0
5794,0,5794,[234 202  70   4 322],234,2,25413,4.385332182916307,0.0,0.0
5795,0,5795,[ 95 117 204 313 515],234,2,25415,4.384920634920635,0.0,0.0
5796,0,5796,[302 603 187 427 180],664,5,25420,4.385026737967914,20.0,0.0
5797,0,5797,[302 603 187 427 180],474,5,25425,4.385132804415315,20.0,0.0
5798,0,5798,[  7 318  11 228 185],537,3,25428,4.384893947232281,20.0,0.0
5799,0,5799,[302 603 187 427 180],13,5,25433,4.385,20.0,0.0
5800,0,5800,[496 678 185  95 655],334,2,25435,4.384588863988967,0.0,0.0
5801,0,5801,[ 97 435 172 151 132],312,4,25439,4.384522578421234,0.0,0.0
5802,0,5802,[302 603 187 427 180],339,5,25444,4.384628640358435,20.0,0.0
5803,0,5803,[302 603 187 427 180],458,5,25449,4.38473466574776,20.0,0.0
5804,0,5804,[302 603 187 427 180],13,5,25454,4.384840654608096,20.0,0.0
5805,0,5805,[302 603 187 427 180],339,5,25459,4.384946606958319,20.0,0.0
5806,0,5806,[ 97 265 222 200 181],13,3,25462,4.384708110900637,0.0,0.0
5807,0,5807,[302 603 187 427 180],13,5,25467,4.384814049586777,20.0,0.0
5808,0,5808,[302 603 187 427 180],474,5,25472,4.384919951798933,20.0,0.0
5809,0,5809,[302 603 187 427 180],666,5,25477,4.385025817555938,20.0,0.0
5810,0,5810,[302 603 187 427 180],666,5,25482,4.385131646876613,20.0,0.0
5811,0,5811,[302 603 187 427 180],664,5,25487,4.385237439779766,20.0,0.0
5812,0,5812,[302 603 187 427 180],339,5,25492,4.3853431962841904,20.0,0.0
5813,0,5813,[180  69 151 127 173],339,5,25497,4.385448916408668,0.0,20.0
5814,0,5814,[302 603 187 427 180],664,5,25502,4.385554600171969,20.0,0.0
5815,0,5815,[302 603 187 427 180],271,5,25507,4.385660247592847,20.0,0.0
5816,0,5816,[ 50 471 187 186 357],666,3,25510,4.385422038851642,20.0,20.0
5817,0,5817,[748 475  15  50 257],486,2,25512,4.385012031625989,0.0,20.0
5818,0,5818,[302 603 187 427 180],90,5,25517,4.385117717820932,20.0,0.0
5819,0,5819,[  1 202 211 294 173],830,4,25521,4.385051546391753,0.0,0.0
5820,0,5820,[302 603 187 427 180],271,5,25526,4.385157189486343,20.0,0.0
5821,0,5821,[ 50 294 234 333 588],144,4,25530,4.385091034008932,0.0,20.0
5822,0,5822,[302 603 187 427 180],339,5,25535,4.385196634037437,20.0,0.0
5823,0,5823,[ 70  96 357 100 271],940,2,25537,4.384787087912088,20.0,20.0
5824,0,5824,[237  56 187 300 117],892,5,25542,4.384892703862661,0.0,0.0
5825,0,5825,[427  70 143 195  88],125,4,25546,4.38482663920357,0.0,0.0
5826,0,5826,[302 603 187 427 180],664,5,25551,4.384932212116012,20.0,0.0
5827,0,5827,[200  71 318  25  56],313,2,25553,4.38452299245024,20.0,0.0
5828,0,5828,[ 64 568 222  97  96],537,0,25553,4.383770801166581,0.0,0.0
5829,0,5829,[ 50 216   7 186 238],804,5,25558,4.383876500857633,0.0,20.0
5830,0,5830,[302 603 187 427 180],271,5,25563,4.383982164294289,20.0,0.0
5831,0,5831,[302 603 187 427 180],664,5,25568,4.384087791495199,20.0,0.0
5832,0,5832,[302 603 187 427 180],339,5,25573,4.3841933824789985,20.0,0.0
5833,0,5833,[302 603 187 427 180],339,5,25578,4.384298937264313,20.0,0.0
5834,0,5834,[302 603 187 427 180],90,5,25583,4.384404455869752,20.0,0.0
5835,0,5835,[ 22 403   1  50 318],653,4,25587,4.384338588074023,20.0,20.0
5836,0,5836,[302 603 187 427 180],666,5,25592,4.384444063731369,20.0,0.0
5837,0,5837,[302 603 187 427 180],458,5,25597,4.384549503254539,20.0,0.0
5838,0,5838,[ 11 172 143 322 286],234,0,25597,4.38379859564994,0.0,0.0
5839,0,5839,[  7  79 172  71 135],194,1,25598,4.383219178082192,0.0,0.0
5840,0,5840,[ 97  82 515 483 135],59,5,25603,4.383324773155282,20.0,0.0
5841,0,5841,[302 603 187 427 180],666,5,25608,4.383430332078055,20.0,0.0
5842,0,5842,[175 288 268 197 228],334,4,25612,4.383364709909293,0.0,0.0
5843,0,5843,[302 603 187 427 180],458,5,25617,4.38347022587269,20.0,0.0
5844,0,5844,[ 15 161 144 153 132],290,2,25619,4.383062446535501,0.0,0.0
5845,0,5845,[ 82 496   8 182 588],194,2,25621,4.38265480670544,0.0,0.0
5846,0,5846,[302 603 187 427 180],271,5,25626,4.382760389943561,20.0,0.0
5847,0,5847,[302 603 187 427 180],537,5,25631,4.382865937072504,20.0,0.0
5848,0,5848,[ 89 427  28 405  71],882,5,25636,4.382971448110788,0.0,0.0
5849,0,5849,[ 89 300 176  98  79],378,5,25641,4.383076923076923,0.0,20.0
5850,0,5850,[423  89 182 200 196],666,3,25644,4.382840540078619,0.0,0.0
5851,0,5851,[135 289 197  98 294],95,2,25646,4.382433356117566,0.0,20.0
5852,0,5852,[302 603 187 427 180],474,5,25651,4.3825388689560905,20.0,0.0
5853,0,5853,[118 483  97 100 143],194,2,25653,4.382131875640588,20.0,20.0
5854,0,5854,[ 98  95 271 196  88],290,4,25657,4.382066609735269,0.0,20.0
5855,0,5855,[302 603 187 427 180],271,5,25662,4.382172131147541,20.0,0.0
5856,0,5856,[125 328 186 245 435],313,2,25664,4.381765408912412,0.0,0.0
5857,0,5857,[ 97 127 423 197 185],95,4,25668,4.381700238989416,0.0,20.0
5858,0,5858,[117 655 385  88 301],234,0,25668,4.380952380952381,0.0,0.0
5859,0,5859,[302 603 187 427 180],664,5,25673,4.381058020477815,20.0,0.0
5860,0,5860,[200 182 423  71  69],95,3,25676,4.380822385258488,0.0,0.0
5861,0,5861,[302 603 187 427 180],339,5,25681,4.380928010917775,20.0,0.0
5862,0,5862,[302 603 187 427 180],537,5,25686,4.381033600545796,20.0,0.0
5863,0,5863,[302 603 187 427 180],664,5,25691,4.381139154160982,20.0,0.0
5864,0,5864,[174  56  71  98 515],524,3,25694,4.380903665814151,0.0,40.0
5865,0,5865,[286 172 300 483 271],13,2,25696,4.380497783839073,20.0,0.0
5866,0,5866,[ 95 194 200 257   9],308,5,25701,4.380603374808249,0.0,0.0
5867,0,5867,[302 603 187 427 180],271,5,25706,4.3807089297886845,20.0,0.0
5868,0,5868,[182 357 211 234 204],749,4,25710,4.380644062020787,20.0,0.0
5869,0,5869,[302 603 187 427 180],664,5,25715,4.3807495741056215,20.0,0.0
5870,0,5870,[302 603 187 427 180],13,5,25720,4.380855050246977,20.0,0.0
5871,0,5871,[168  97 228   7 172],804,5,25725,4.380960490463215,0.0,0.0
5872,0,5872,[302 603 187 427 180],474,5,25730,4.381065894772688,20.0,0.0
5873,0,5873,[185 111  56 483 508],474,4,25734,4.3810010214504596,20.0,0.0
5874,0,5874,[282 328 186 300 275],271,2,25736,4.380595744680851,0.0,0.0
5875,0,5875,[302 603 187 427 180],90,5,25741,4.38070115724983,20.0,0.0
5876,0,5876,[302 603 187 427 180],271,5,25746,4.380806533945891,20.0,0.0
5877,0,5877,[302 603 187 427 180],13,5,25751,4.380911874787342,20.0,0.0
5878,0,5878,[302 603 187 427 180],458,5,25756,4.381017179792481,20.0,0.0
5879,0,5879,[302 603 187 427 180],13,5,25761,4.381122448979592,20.0,0.0
5880,0,5880,[742 183 318  56 143],313,2,25763,4.3807175650399595,20.0,0.0
5881,0,5881,[237 496 194  56 302],271,4,25767,4.3806528391703505,0.0,0.0
5882,0,5882,[ 98  97 222  25 496],537,1,25768,4.380078191398946,0.0,20.0
5883,0,5883,[302 603 187 427 180],90,5,25773,4.38018354860639,20.0,0.0
5884,0,5884,[302 603 187 427 180],13,5,25778,4.3802888700084965,20.0,0.0
5885,0,5885,[302 603 187 427 180],474,5,25783,4.380394155623513,20.0,0.0
5886,0,5886,[302 603 187 427 180],271,5,25788,4.380499405469679,20.0,0.0
5887,0,5887,[191 496  56 216 176],882,5,25793,4.380604619565218,0.0,0.0
5888,0,5888,[302 603 187 427 180],339,5,25798,4.380709797928341,20.0,0.0
5889,0,5889,[182 423 127 172 273],7,4,25802,4.380645161290323,0.0,20.0
5890,0,5890,[302 603 187 427 180],474,5,25807,4.380750297063317,20.0,0.0
5891,0,5891,[302 603 187 427 180],458,5,25812,4.380855397148676,20.0,0.0
5892,0,5892,[302 603 187 427 180],666,5,25817,4.380960461564568,20.0,0.0
5893,0,5893,[238 257 118 655 294],479,3,25820,4.3807261621988465,0.0,0.0
5894,0,5894,[302 603 187 427 180],664,5,25825,4.380831212892281,20.0,0.0
5895,0,5895,[ 71 118 678 117  28],13,3,25828,4.380597014925373,0.0,0.0
5896,0,5896,[302 603 187 427 180],537,5,25833,4.3807020518907915,20.0,0.0
5897,0,5897,[302 603 187 427 180],271,5,25838,4.380807053238386,20.0,0.0
5898,0,5898,[603 194 215 294 234],7,4,25842,4.380742498728598,20.0,0.0
5899,0,5899,[322 100 180 403 174],92,4,25846,4.380677966101695,0.0,40.0
5900,0,5900,[302 603 187 427 180],13,5,25851,4.380782918149467,20.0,0.0
5901,0,5901,[742 588 237 200  88],378,4,25855,4.3807184005421895,0.0,0.0
5902,0,5902,[302 603 187 427 180],90,5,25860,4.380823310181264,20.0,0.0
5903,0,5903,[302 603 187 427 180],664,5,25865,4.380928184281843,20.0,0.0
5904,0,5904,[302 603 187 427 180],666,5,25870,4.381033022861981,20.0,0.0
5905,0,5905,[302 603 187 427 180],458,5,25875,4.381137825939723,20.0,0.0
5906,0,5906,[302 603 187 427 180],666,5,25880,4.381242593533097,20.0,0.0
5907,0,5907,[302 603 187 427 180],339,5,25885,4.381347325660122,20.0,0.0
5908,0,5908,[302 603 187 427 180],474,5,25890,4.381452022338805,20.0,0.0
5909,0,5909,[546 515   7  98 385],524,2,25892,4.381049069373942,0.0,20.0
5910,0,5910,[302 603 187 427 180],13,5,25897,4.381153781086111,20.0,0.0
5911,0,5911,[181  71  98 202 597],533,4,25901,4.381089309878214,0.0,20.0
5912,0,5912,[117  71 405 211 200],474,4,25905,4.3810248604769155,0.0,0.0
5913,0,5913,[302 603 187 427 180],666,5,25910,4.38112952316537,20.0,0.0
5914,0,5914,[302 603 187 427 180],458,5,25915,4.38123415046492,20.0,0.0
5915,0,5915,[302 603 187 427 180],339,5,25920,4.381338742393509,20.0,0.0
5916,0,5916,[ 50 403 168 603 427],13,4,25924,4.381274294405949,20.0,20.0
5917,0,5917,[194 235   1 143 197],648,4,25928,4.381209868198716,0.0,0.0
5918,0,5918,[302 603 187 427 180],271,5,25933,4.381314411218111,20.0,0.0
5919,0,5919,[302 603 187 427 180],458,5,25938,4.381418918918919,20.0,0.0
5920,0,5920,[302 603 187 427 180],13,5,25943,4.381523391319034,20.0,0.0
5921,0,5921,[302 603 187 427 180],339,5,25948,4.381627828436339,20.0,0.0
5922,0,5922,[302 603 187 427 180],537,5,25953,4.381732230288705,20.0,0.0
5923,0,5923,[153 182 121 427 237],13,5,25958,4.381836596893991,0.0,0.0
5924,0,5924,[748 237 333 210 286],13,2,25960,4.381434599156118,0.0,0.0
5925,0,5925,[302 603 187 427 180],271,5,25965,4.38153898076274,20.0,0.0
5926,0,5926,[302 603 187 427 180],458,5,25970,4.381643327146954,20.0,0.0
5927,0,5927,[  4   9 180   8  82],543,5,25975,4.381747638326586,0.0,0.0
5928,0,5928,[302 603 187 427 180],13,5,25980,4.381851914319447,20.0,0.0
5929,0,5929,[302 603 187 427 180],90,5,25985,4.381956155143339,20.0,0.0
5930,0,5930,[302 603 187 427 180],458,5,25990,4.382060360816051,20.0,0.0
5931,0,5931,[302 603 187 427 180],666,5,25995,4.382164531355361,20.0,0.0
5932,0,5932,[191 273 427 127 238],537,4,25999,4.382100117984156,0.0,20.0
5933,0,5933,[302 603 187 427 180],474,5,26004,4.382204246713853,20.0,0.0
5934,0,5934,[302 603 187 427 180],13,5,26009,4.382308340353833,20.0,0.0
5935,0,5935,[302 603 187 427 180],339,5,26014,4.382412398921833,20.0,0.0
5936,0,5936,[508 197   7   9 185],13,1,26015,4.381842681488967,0.0,0.0
5937,0,5937,[273 215 257  50   1],308,3,26018,4.381609969686763,0.0,20.0
5938,0,5938,[302 603 187 427 180],90,5,26023,4.381714093281698,20.0,0.0
5939,0,5939,[302 603 187 427 180],90,5,26028,4.381818181818182,20.0,0.0
5940,0,5940,[302 603 187 427 180],339,5,26033,4.38192223531392,20.0,0.0
5941,0,5941,[302 603 187 427 180],13,5,26038,4.382026253786604,20.0,0.0
5942,0,5942,[302 603 187 427 180],13,5,26043,4.382130237253913,20.0,0.0
5943,0,5943,[302 603 187 427 180],474,5,26048,4.3822341857335125,20.0,0.0
5944,0,5944,[302 603 187 427 180],474,5,26053,4.382338099243062,20.0,0.0
5945,0,5945,[302 603 187 427 180],537,5,26058,4.382441977800202,20.0,0.0
5946,0,5946,[302 603 187 427 180],537,5,26063,4.382545821422566,20.0,0.0
5947,0,5947,[302 603 187 427 180],474,5,26068,4.382649630127774,20.0,0.0
5948,0,5948,[302 603 187 427 180],13,5,26073,4.382753403933434,20.0,0.0
5949,0,5949,[ 79  88 216 234 174],648,5,26078,4.382857142857143,0.0,20.0
5950,0,5950,[258 300 215 235 175],13,3,26081,4.382624768946395,0.0,0.0
5951,0,5951,[302 603 187 427 180],271,5,26086,4.382728494623656,20.0,0.0
5952,0,5952,[ 97  79 288 301 515],537,1,26087,4.382160255333445,0.0,0.0
5953,0,5953,[302 603 187 427 180],339,5,26092,4.382264024185422,20.0,0.0
5954,0,5954,[143 132 427 121 194],882,4,26096,4.382199832073887,0.0,0.0
5955,0,5955,[302 603 187 427 180],664,5,26101,4.382303559435863,20.0,0.0
5956,0,5956,[302 603 187 427 180],458,5,26106,4.382407251972469,20.0,0.0
5957,0,5957,[302 603 187 427 180],90,5,26111,4.382510909701242,20.0,0.0
5958,0,5958,[302 603 187 427 180],458,5,26116,4.382614532639705,20.0,0.0
5959,0,5959,[302 603 187 427 180],13,5,26121,4.382718120805369,20.0,0.0
5960,0,5960,[302 603 187 427 180],537,5,26126,4.3828216742157355,20.0,0.0
5961,0,5961,[204 195  28 257 427],474,4,26130,4.382757463938276,0.0,0.0
5962,0,5962,[302 603 187 427 180],537,5,26135,4.382860976018782,20.0,0.0
5963,0,5963,[191 357  71 197 423],387,2,26137,4.382461435278337,20.0,0.0
5964,0,5964,[302 603 187 427 180],339,5,26142,4.382564962279966,20.0,0.0
5965,0,5965,[302 603 187 427 180],664,5,26147,4.3826684545759305,20.0,0.0
5966,0,5966,[302 603 187 427 180],13,5,26152,4.382771912183677,20.0,0.0
5967,0,5967,[546 568  71 161 403],313,4,26156,4.382707774798928,0.0,0.0
5968,0,5968,[210 187 257 118 273],479,4,26160,4.382643658904339,0.0,0.0
5969,0,5969,[302 603 187 427 180],666,5,26165,4.382747068676717,20.0,0.0
5970,0,5970,[302 603 187 427 180],537,5,26170,4.382850443811757,20.0,0.0
5971,0,5971,[302 603 187 427 180],271,5,26175,4.382953784326859,20.0,0.0
5972,0,5972,[302 603 187 427 180],13,5,26180,4.383057090239411,20.0,0.0
5973,0,5973,[302 603 187 427 180],271,5,26185,4.383160361566789,20.0,0.0
5974,0,5974,[302 603 187 427 180],474,5,26190,4.3832635983263595,20.0,0.0
5975,0,5975,[302 603 187 427 180],666,5,26195,4.383366800535475,20.0,0.0
5976,0,5976,[302 603 187 427 180],664,5,26200,4.383469968211477,20.0,0.0
5977,0,5977,[176 168 357 318 143],263,5,26205,4.383573101371696,40.0,0.0
5978,0,5978,[302 603 187 427 180],664,5,26210,4.383676200033451,20.0,0.0
5979,0,5979,[111  22 237 568  88],454,4,26214,4.383612040133779,0.0,0.0
5980,0,5980,[302 603 187 427 180],458,5,26219,4.383715097809731,20.0,0.0
5981,0,5981,[302 603 187 427 180],458,5,26224,4.383818121029756,20.0,0.0
5982,0,5982,[302 603 187 427 180],90,5,26229,4.383921109811132,20.0,0.0
5983,0,5983,[302 603 187 427 180],13,5,26234,4.384024064171123,20.0,0.0
5984,0,5984,[195  70 117 385 269],102,1,26235,4.383458646616542,0.0,0.0
5985,0,5985,[265 191 268 318  82],92,3,26238,4.3832275309054465,20.0,0.0
5986,0,5986,[271  56 186 568 185],379,4,26242,4.383163520962085,0.0,0.0
5987,0,5987,[302 603 187 427 180],458,5,26247,4.3832665330661325,20.0,0.0
5988,0,5988,[322 300  50 333 423],633,3,26250,4.383035565202872,0.0,20.0
5989,0,5989,[302 603 187 427 180],90,5,26255,4.383138564273789,20.0,0.0
5990,0,5990,[302 603 187 427 180],13,5,26260,4.383241528960107,20.0,0.0
5991,0,5991,[302 603 187 427 180],666,5,26265,4.383344459279039,20.0,0.0
5992,0,5992,[302 603 187 427 180],13,5,26270,4.383447355247789,20.0,0.0
5993,0,5993,[302 603 187 427 180],474,5,26275,4.38355021688355,20.0,0.0
5994,0,5994,[302 603 187 427 180],666,5,26280,4.383653044203503,20.0,0.0
5995,0,5995,[302 603 187 427 180],537,5,26285,4.383755837224816,20.0,0.0
5996,0,5996,[302 603 187 427 180],90,5,26290,4.383858595964649,20.0,0.0
5997,0,5997,[ 82 183  56 435 275],883,4,26294,4.3837945981994,0.0,0.0
5998,0,5998,[302 603 187 427 180],90,5,26299,4.38389731621937,20.0,0.0
5999,0,5999,[302 603 187 427 180],13,5,26304,4.384,20.0,0.0
6000,0,6000,[ 89 180 186  56 275],189,4,26308,4.383936010664889,0.0,0.0
6001,0,6001,[  7 202 111 143 234],95,4,26312,4.383872042652449,0.0,0.0
6002,0,6002,[234 144 597 273 237],13,3,26315,4.383641512577045,0.0,0.0
6003,0,6003,[135  82 588 111 300],13,3,26318,4.383411059293804,0.0,0.0
6004,0,6004,[ 88 194 238 215 237],474,5,26323,4.3835137385512075,0.0,0.0
6005,0,6005,[302 603 187 427 180],271,5,26328,4.383616383616384,20.0,0.0
6006,0,6006,[302 603 187 427 180],458,5,26333,4.383718994506409,20.0,0.0
6007,0,6007,[174 475 603 172 546],64,3,26336,4.383488681757656,20.0,20.0
6008,0,6008,[302 187 603 427 180],537,5,26341,4.383591279747046,20.0,0.0
6009,0,6009,[302 187 603 427 180],474,5,26346,4.38369384359401,20.0,0.0
6010,0,6010,[302 187 603 427 180],664,5,26351,4.3837963733155885,20.0,0.0
6011,0,6011,[197 181 496  82 127],215,4,26355,4.3837325349301395,0.0,20.0
6012,0,6012,[302 187 603 427 180],458,5,26360,4.383835024114418,20.0,0.0
6013,0,6013,[302 187 603 427 180],474,5,26365,4.383937479215165,20.0,0.0
6014,0,6014,[237 132 597  11 235],13,2,26367,4.38354114713217,0.0,0.0
6015,0,6015,[210 153 172 275 678],308,4,26371,4.383477393617022,0.0,0.0
6016,0,6016,[302 187 603 427 180],13,5,26376,4.383579857071631,20.0,0.0
6017,0,6017,[179 135   4 100 210],271,5,26381,4.383682286473912,0.0,20.0
6018,0,6018,[302 187 603 427 180],271,5,26386,4.3837846818408375,20.0,0.0
6019,0,6019,[302 187 603 427 180],458,5,26391,4.383887043189369,20.0,0.0
6020,0,6020,[195 204 216 186 183],378,3,26394,4.383657199800697,0.0,0.0
6021,0,6021,[423  25 471 289 276],455,3,26397,4.383427432746596,0.0,0.0
6022,0,6022,[302 187 603 427 180],271,5,26402,4.383529802424041,20.0,0.0
6023,0,6023,[302 187 603 427 180],271,5,26407,4.38363213811421,20.0,0.0
6024,0,6024,[ 25  98  70 515 151],308,3,26410,4.383402489626556,0.0,20.0
6025,0,6025,[302 187 603 427 180],271,5,26415,4.383504812479257,20.0,0.0
6026,0,6026,[258 300 182 228 515],488,4,26419,4.383441181350589,0.0,0.0
6027,0,6027,[322  71 508 286 143],533,5,26424,4.3835434638354345,0.0,0.0
6028,0,6028,[302 187 603 427 180],271,5,26429,4.3836457123901145,20.0,0.0
6029,0,6029,[302 187 603 427 180],339,5,26434,4.383747927031509,20.0,0.0
6030,0,6030,[302 187 603 427 180],537,5,26439,4.383850107776488,20.0,0.0
6031,0,6031,[302 187 603 427 180],13,5,26444,4.38395225464191,20.0,0.0
6032,0,6032,[302 187 603 427 180],13,5,26449,4.384054367644621,20.0,0.0
6033,0,6033,[237 186 318 301 161],334,2,26451,4.383659264169705,20.0,0.0
6034,0,6034,[302 187 603 427 180],537,5,26456,4.383761391880696,20.0,0.0
6035,0,6035,[181 151 568 211 471],313,4,26460,4.383697813121272,0.0,0.0
6036,0,6036,[302 187 603 427 180],664,5,26465,4.383799900612887,20.0,0.0
6037,0,6037,[496 385 172 403 435],398,4,26469,4.383736336535277,0.0,0.0
6038,0,6038,[265 318  12 191 423],387,3,26472,4.3835072031793345,40.0,0.0
6039,0,6039,[302 187 603 427 180],13,5,26477,4.383609271523179,20.0,0.0
6040,0,6040,[427 385 333 196  97],666,2,26479,4.383214699553054,0.0,0.0
6041,0,6041,[161  97 144 238 288],843,1,26480,4.382654750082754,0.0,0.0
6042,0,6042,[ 89 161  69   7 742],92,3,26483,4.382425947377131,0.0,0.0
6043,0,6043,[302 187 603 427 180],474,5,26488,4.382528127068166,20.0,0.0
6044,0,6044,[655 125 168 234   8],313,2,26490,4.382133995037221,0.0,0.0
6045,0,6045,[111 117 423 151 204],537,0,26490,4.381409196162752,0.0,0.0
6046,0,6046,[194  71 515 275 228],85,3,26493,4.381180750785513,0.0,0.0
6047,0,6047,[302 187 603 427 180],271,5,26498,4.381283068783069,20.0,0.0
6048,0,6048,[678 173 237 265  28],537,1,26499,4.3807240866258885,0.0,0.0
6049,0,6049,[302 187 603 427 180],458,5,26504,4.380826446280992,20.0,0.0
6050,0,6050,[302 187 603 427 180],90,5,26509,4.380928772103784,20.0,0.0
6051,0,6051,[302 187 603 427 180],474,5,26514,4.3810310641110375,20.0,0.0
6052,0,6052,[302 187 603 427 180],666,5,26519,4.381133322319511,20.0,0.0
6053,0,6053,[568 197 151 172 135],308,4,26523,4.381070366699703,0.0,0.0
6054,0,6054,[196   4 121 172 202],295,5,26528,4.381172584640793,0.0,0.0
6055,0,6055,[302 187 603 427 180],90,5,26533,4.381274768824307,20.0,0.0
6056,0,6056,[302 187 603 427 180],458,5,26538,4.381376919266964,20.0,0.0
6057,0,6057,[302 187 603 427 180],90,5,26543,4.381479035985474,20.0,0.0
6058,0,6058,[194 135 257 118 181],161,0,26543,4.380755900313583,0.0,0.0
6059,0,6059,[302 187 603 427 180],339,5,26548,4.380858085808581,20.0,0.0
6060,0,6060,[302 187 603 427 180],474,5,26553,4.380960237584557,20.0,0.0
6061,0,6061,[302 187 603 427 180],339,5,26558,4.381062355658199,20.0,0.0
6062,0,6062,[302 187 603 427 180],458,5,26563,4.381164440046182,20.0,0.0
6063,0,6063,[302 187 603 427 180],458,5,26568,4.381266490765172,20.0,0.0
6064,0,6064,[302 187 603 427 180],458,5,26573,4.381368507831822,20.0,0.0
6065,0,6065,[302 187 603 427 180],458,5,26578,4.381470491262776,20.0,0.0
6066,0,6066,[ 50 202 302 191 173],14,4,26582,4.381407614966211,0.0,20.0
6067,0,6067,[302 187 603 427 180],664,5,26587,4.381509558338827,20.0,0.0
6068,0,6068,[172 357 132 191 748],13,3,26590,4.38128192453452,20.0,0.0
6069,0,6069,[302 187 603 427 180],537,5,26595,4.381383855024712,20.0,0.0
6070,0,6070,[302 187 603 427 180],474,5,26600,4.381485751935431,20.0,0.0
6071,0,6071,[302 187 603 427 180],537,5,26605,4.381587615283268,20.0,0.0
6072,0,6072,[302 187 603 427 180],13,5,26610,4.381689445084802,20.0,0.0
6073,0,6073,[302 187 603 427 180],664,5,26615,4.381791241356602,20.0,0.0
6074,0,6074,[302 187 603 427 180],13,5,26620,4.381893004115226,20.0,0.0
6075,0,6075,[302 187 603 427 180],537,5,26625,4.381994733377222,20.0,0.0
6076,0,6076,[180 183 496 127 603],648,3,26628,4.38176731940102,20.0,20.0
6077,0,6077,[302 603 187 427 180],13,5,26633,4.381869035867061,20.0,0.0
6078,0,6078,[302 603 187 427 180],271,5,26638,4.381970718868235,20.0,0.0
6079,0,6079,[302 603 187 427 180],474,5,26643,4.382072368421053,20.0,0.0
6080,0,6080,[302 603 187 427 180],90,5,26648,4.382173984542016,20.0,0.0
6081,0,6081,[302 603 187 427 180],664,5,26653,4.382275567247616,20.0,0.0
6082,0,6082,[144 210 161 282 603],804,5,26658,4.3823771165543315,20.0,0.0
6083,0,6083,[175 143  96 216  28],881,3,26661,4.382149901380671,0.0,0.0
6084,0,6084,[302 603 187 427 180],664,5,26666,4.382251437962202,20.0,0.0
6085,0,6085,[ 69 678 475  96 357],648,1,26667,4.381695695037791,20.0,0.0
6086,0,6086,[302 603 187 427 180],339,5,26672,4.381797272876622,20.0,0.0
6087,0,6087,[302 603 187 427 180],339,5,26677,4.381898817345598,20.0,0.0
6088,0,6088,[405 215 508 238 185],653,0,26677,4.381179175562489,0.0,0.0
6089,0,6089,[ 15 405 118 742 282],548,4,26681,4.38111658456486,0.0,0.0
6090,0,6090,[302 603 187 427 180],664,5,26686,4.381218190773272,20.0,0.0
6091,0,6091,[180 568 204  97  50],189,5,26691,4.381319763624425,0.0,20.0
6092,0,6092,[194 222 151  69 273],749,4,26695,4.381257180370917,0.0,0.0
6093,0,6093,[196   1 117 288 153],308,3,26698,4.381030521824746,0.0,0.0
6094,0,6094,[302 603 187 427 180],339,5,26703,4.381132075471698,20.0,0.0
6095,0,6095,[302 603 187 427 180],339,5,26708,4.381233595800525,20.0,0.0
6096,0,6096,[302 603 187 427 180],537,5,26713,4.38133508282762,20.0,0.0
6097,0,6097,[302 603 187 427 180],537,5,26718,4.381436536569367,20.0,0.0
6098,0,6098,[302 603 187 427 180],664,5,26723,4.381537957042138,20.0,0.0
6099,0,6099,[302 603 187 427 180],666,5,26728,4.381639344262295,20.0,0.0
6100,0,6100,[302 603 187 427 180],13,5,26733,4.3817406982461895,20.0,0.0
6101,0,6101,[302 603 187 427 180],339,5,26738,4.38184201901016,20.0,0.0
6102,0,6102,[302 603 187 427 180],537,5,26743,4.381943306570539,20.0,0.0
6103,0,6103,[302 603 187 427 180],537,5,26748,4.382044560943643,20.0,0.0
6104,0,6104,[302 603 187 427 180],339,5,26753,4.382145782145782,20.0,0.0
6105,0,6105,[302 603 187 427 180],458,5,26758,4.382246970193252,20.0,0.0
6106,0,6106,[286 427 234 258 276],90,4,26762,4.382184378581955,0.0,0.0
6107,0,6107,[194 269  89 117  28],271,3,26765,4.381958087753765,0.0,0.0
6108,0,6108,[302 603 187 427 180],458,5,26770,4.382059256834179,20.0,0.0
6109,0,6109,[302 603 187 427 180],90,5,26775,4.38216039279869,20.0,0.0
6110,0,6110,[302 603 187 427 180],271,5,26780,4.382261495663558,20.0,0.0
6111,0,6111,[161 194  64  28 191],188,1,26781,4.381708115183246,0.0,0.0
6112,0,6112,[302 603 187 427 180],664,5,26786,4.381809258956323,20.0,0.0
6113,0,6113,[302 603 187 427 180],474,5,26791,4.381910369643442,20.0,0.0
6114,0,6114,[282 200 238 144 195],643,2,26793,4.381520850367948,0.0,0.0
6115,0,6115,[302 603 187 427 180],666,5,26798,4.381621975147155,20.0,0.0
6116,0,6116,[302 603 187 427 180],271,5,26803,4.3817230668628415,20.0,0.0
6117,0,6117,[179 228 182 216 237],7,5,26808,4.381824125531219,0.0,0.0
6118,0,6118,[302 603 187 427 180],271,5,26813,4.381925151168492,20.0,0.0
6119,0,6119,[385 357 191 294   7],13,0,26813,4.381209150326797,20.0,0.0
6120,0,6120,[302 603 187 427 180],537,5,26818,4.381310243424277,20.0,0.0
6121,0,6121,[302 603 187 427 180],90,5,26823,4.3814113034955895,20.0,0.0
6122,0,6122,[161 174 286 302 515],524,5,26828,4.381512330556917,0.0,20.0
6123,0,6123,[302 603 187 427 180],666,5,26833,4.381613324624428,20.0,0.0
6124,0,6124,[302 603 187 427 180],339,5,26838,4.381714285714286,20.0,0.0
6125,0,6125,[302 603 187 427 180],664,5,26843,4.381815213842638,20.0,0.0
6126,0,6126,[302 603 187 427 180],666,5,26848,4.3819161090256245,20.0,0.0
6127,0,6127,[ 98 186 423  12  22],308,4,26852,4.381853785900783,20.0,20.0
6128,0,6128,[302 603 187 427 180],90,5,26857,4.381954641866536,20.0,0.0
6129,0,6129,[ 15 204   9  28  98],881,3,26860,4.381729200652528,0.0,20.0
6130,0,6130,[302 603 187 427 180],537,5,26865,4.381830044038493,20.0,0.0
6131,0,6131,[265  11 403 435  12],308,4,26869,4.381767775603392,20.0,0.0
6132,0,6132,[302 603 187 427 180],666,5,26874,4.38186857981412,20.0,0.0
6133,0,6133,[302 603 187 427 180],458,5,26879,4.381969351157483,20.0,0.0
6134,0,6134,[302 603 187 427 180],537,5,26884,4.3820700896495515,20.0,0.0
6135,0,6135,[ 95 235 588  64 144],804,4,26888,4.382007822685789,0.0,0.0
6136,0,6136,[302 603 187 427 180],474,5,26893,4.382108522079192,20.0,0.0
6137,0,6137,[302 603 187 427 180],666,5,26898,4.382209188660801,20.0,0.0
6138,0,6138,[302 603 187 427 180],13,5,26903,4.382309822446652,20.0,0.0
6139,0,6139,[202 210  95 187 161],387,2,26905,4.381921824104235,0.0,0.0
6140,0,6140,[302 603 187 427 180],666,5,26910,4.382022471910112,20.0,0.0
6141,0,6141,[603 100 172 168 216],334,3,26913,4.381797460110713,20.0,20.0
6142,0,6142,[302 603 187 427 180],13,5,26918,4.38189809539313,20.0,0.0
6143,0,6143,[302 603 187 427 180],90,5,26923,4.381998697916667,20.0,0.0
6144,0,6144,[302 603 187 427 180],458,5,26928,4.382099267697315,20.0,0.0
6145,0,6145,[302 603 187 427 180],13,5,26933,4.382199804751058,20.0,0.0
6146,0,6146,[302 603 187 427 180],474,5,26938,4.382300309093867,20.0,0.0
6147,0,6147,[302 603 187 427 180],664,5,26943,4.382400780741705,20.0,0.0
6148,0,6148,[302 603 187 427 180],664,5,26948,4.382501219710522,20.0,0.0
6149,0,6149,[302 603 187 427 180],666,5,26953,4.38260162601626,20.0,0.0
6150,0,6150,[ 97 238 282 172 127],194,2,26955,4.382214274101772,0.0,20.0
6151,0,6151,[100 403 273 228 186],328,2,26957,4.381827048114435,0.0,20.0
6152,0,6152,[302 603 187 427 180],13,5,26962,4.3819275150333175,20.0,0.0
6153,0,6153,[302 603 187 427 180],664,5,26967,4.382027949301268,20.0,0.0
6154,0,6154,[302 603 187 427 180],474,5,26972,4.3821283509342,20.0,0.0
6155,0,6155,[302 603 187 427 180],664,5,26977,4.382228719948018,20.0,0.0
6156,0,6156,[302 603 187 427 180],339,5,26982,4.382329056358616,20.0,0.0
6157,0,6157,[302 603 187 427 180],537,5,26987,4.382429360181877,20.0,0.0
6158,0,6158,[302 603 187 427 180],90,5,26992,4.382529631433674,20.0,0.0
6159,0,6159,[302 603 187 427 180],537,5,26997,4.38262987012987,20.0,0.0
6160,0,6160,[153 385  11 182 100],454,1,26998,4.382080831033923,0.0,20.0
6161,0,6161,[655 238   7  56 204],643,3,27001,4.381856540084388,0.0,0.0
6162,0,6162,[302 603 187 427 180],339,5,27006,4.381956839201687,20.0,0.0
6163,0,6163,[302 603 187 427 180],339,5,27011,4.382057105775471,20.0,0.0
6164,0,6164,[302 603 187 427 180],474,5,27016,4.382157339821573,20.0,0.0
6165,0,6165,[302 603 187 427 180],13,5,27021,4.3822575413558225,20.0,0.0
6166,0,6166,[302 603 187 427 180],458,5,27026,4.382357710394032,20.0,0.0
6167,0,6167,[118 300 245 742 515],637,2,27028,4.381971465629054,0.0,0.0
6168,0,6168,[302 603 187 427 180],666,5,27033,4.382071648565407,20.0,0.0
6169,0,6169,[302 603 187 427 180],339,5,27038,4.382171799027553,20.0,0.0
6170,0,6170,[302 603 187 427 180],90,5,27043,4.382271917031275,20.0,0.0
6171,0,6171,[302 603 187 427 180],339,5,27048,4.382372002592352,20.0,0.0
6172,0,6172,[ 95 234   1 546 515],102,1,27049,4.381824072574113,0.0,0.0
6173,0,6173,[302 603 187 427 180],458,5,27054,4.381924198250728,20.0,0.0
6174,0,6174,[180 183 423 179 187],648,3,27057,4.381700404858299,0.0,0.0
6175,0,6175,[302 603 187 427 180],666,5,27062,4.381800518134715,20.0,0.0
6176,0,6176,[ 12 238  25 427 183],308,5,27067,4.3819005989962765,20.0,0.0
6177,0,6177,[ 97 161  95 228 180],194,1,27068,4.381353188734218,0.0,0.0
6178,0,6178,[302 603 187 427 180],666,5,27073,4.381453309597022,20.0,0.0
6179,0,6179,[302 603 187 427 180],13,5,27078,4.381553398058252,20.0,0.0
6180,0,6180,[127 125 174 194 301],6,3,27081,4.381329881896133,0.0,40.0
6181,0,6181,[302 603 187 427 180],474,5,27086,4.381429957942413,20.0,0.0
6182,0,6182,[302 603 187 427 180],537,5,27091,4.381530001617338,20.0,0.0
6183,0,6183,[302 603 187 427 180],666,5,27096,4.38163001293661,20.0,0.0
6184,0,6184,[302 603 187 427 180],339,5,27101,4.381729991915925,20.0,0.0
6185,0,6185,[ 82 228   8 121 197],334,4,27105,4.381668283220175,0.0,0.0
6186,0,6186,[302 603 187 427 180],666,5,27110,4.381768223694844,20.0,0.0
6187,0,6187,[302 603 187 427 180],13,5,27115,4.381868131868132,20.0,0.0
6188,0,6188,[302 603 187 427 180],339,5,27120,4.381968007755695,20.0,0.0
6189,0,6189,[173 132 182 200 655],506,5,27125,4.382067851373183,0.0,0.0
6190,0,6190,[302 603 187 427 180],537,5,27130,4.38216766273623,20.0,0.0
6191,0,6191,[238 118  96 216  98],313,5,27135,4.382267441860465,0.0,20.0
6192,0,6192,[302 603 187 427 180],666,5,27140,4.3823671887615046,20.0,0.0
6193,0,6193,[302 603 187 427 180],271,5,27145,4.382466903454956,20.0,0.0
6194,0,6194,[ 69  28 153 471  12],543,3,27148,4.382243744955609,20.0,0.0
6195,0,6195,[302 603 187 427 180],271,5,27153,4.38234344738541,20.0,0.0
6196,0,6196,[302 603 187 427 180],458,5,27158,4.382443117637567,20.0,0.0
6197,0,6197,[302 603 187 427 180],90,5,27163,4.382542755727654,20.0,0.0
6198,0,6198,[237  15  95 216 180],892,5,27168,4.3826423616712376,0.0,0.0
6199,0,6199,[302 603 187 427 180],458,5,27173,4.382741935483871,20.0,0.0
6200,0,6200,[302 603 187 427 180],537,5,27178,4.3828414771811,20.0,0.0
6201,0,6201,[302 603 187 427 180],271,5,27183,4.382940986778459,20.0,0.0
6202,0,6202,[302 603 187 427 180],339,5,27188,4.383040464291472,20.0,0.0
6203,0,6203,[302 603 187 427 180],271,5,27193,4.383139909735655,20.0,0.0
6204,0,6204,[302 603 187 427 180],537,5,27198,4.383239323126511,20.0,0.0
6205,0,6205,[302 603 187 427 180],537,5,27203,4.383338704479536,20.0,0.0
6206,0,6206,[302 603 187 427 180],537,5,27208,4.383438053810214,20.0,0.0
6207,0,6207,[ 11 286 181  82  79],488,3,27211,4.383215206185567,0.0,0.0
6208,0,6208,[302 603 187 427 180],13,5,27216,4.383314543404735,20.0,0.0
6209,0,6209,[302 603 187 427 180],90,5,27221,4.38341384863124,20.0,0.0
6210,0,6210,[302 603 187 427 180],13,5,27226,4.383513121880535,20.0,0.0
6211,0,6211,[179  89 515 143 318],13,1,27227,4.382968448164842,20.0,0.0
6212,0,6212,[196 121 202 258 204],666,2,27229,4.382584902623531,0.0,0.0
6213,0,6213,[302 603 187 427 180],271,5,27234,4.382684261345349,20.0,0.0
6214,0,6214,[194  50 181 238 200],95,4,27238,4.382622687047466,0.0,20.0
6215,0,6215,[302 603 187 427 180],474,5,27243,4.382722007722008,20.0,0.0
6216,0,6216,[302 603 187 427 180],271,5,27248,4.382821296445231,20.0,0.0
6217,0,6217,[302 603 187 427 180],13,5,27253,4.382920553232551,20.0,0.0
6218,0,6218,[273 748 186 118 195],102,2,27255,4.382537385431742,0.0,0.0
6219,0,6219,[ 28 187 125 216 211],313,3,27258,4.382315112540193,0.0,0.0
6220,0,6220,[302 603 187 427 180],474,5,27263,4.382414402829127,20.0,0.0
6221,0,6221,[302 603 187 427 180],537,5,27268,4.382513661202186,20.0,0.0
6222,0,6222,[302 603 187 427 180],339,5,27273,4.382612887674755,20.0,0.0
6223,0,6223,[302 603 187 427 180],664,5,27278,4.382712082262211,20.0,0.0
6224,0,6224,[302 603 187 427 180],271,5,27283,4.382811244979919,20.0,0.0
6225,0,6225,[302 603 187 427 180],537,5,27288,4.382910375843238,20.0,0.0
6226,0,6226,[181 168 273 186 222],666,1,27289,4.382367110968364,0.0,0.0
6227,0,6227,[237 144 172 151 211],64,3,27292,4.382145150931278,0.0,0.0
6228,0,6228,[ 71 117  89 282  22],378,4,27296,4.382083801573287,0.0,0.0
6229,0,6229,[302 603 187 427 180],666,5,27301,4.382182985553772,20.0,0.0
6230,0,6230,[ 98 186 182 423 176],537,2,27303,4.381800674049109,0.0,20.0
6231,0,6231,[210 182 318 216 194],666,2,27305,4.381418485237484,20.0,0.0
6232,0,6232,[302 603 187 427 180],474,5,27310,4.381517728220761,20.0,0.0
6233,0,6233,[ 96 179 603 357 427],527,4,27314,4.381456528713507,40.0,0.0
6234,0,6234,[302 603 187 427 180],339,5,27319,4.381555733761027,20.0,0.0
6235,0,6235,[294 403   7 238  64],13,1,27320,4.381013470173188,0.0,0.0
6236,0,6236,[302 603 187 427 180],339,5,27325,4.381112714446048,20.0,0.0
6237,0,6237,[302 603 187 427 180],271,5,27330,4.381211926899647,20.0,0.0
6238,0,6238,[302 603 187 427 180],271,5,27335,4.381311107549287,20.0,0.0
6239,0,6239,[302 603 187 427 180],271,5,27340,4.381410256410256,20.0,0.0
6240,0,6240,[302 603 187 427 180],537,5,27345,4.3815093734978365,20.0,0.0
6241,0,6241,[302 603 187 427 180],666,5,27350,4.381608458827299,20.0,0.0
6242,0,6242,[302 603 187 427 180],664,5,27355,4.381707512413904,20.0,0.0
6243,0,6243,[302 603 187 427 180],13,5,27360,4.381806534272902,20.0,0.0
6244,0,6244,[302 603 187 427 180],90,5,27365,4.381905524419536,20.0,0.0
6245,0,6245,[313  28 318 237 210],334,3,27368,4.381684277937881,20.0,0.0
6246,0,6246,[302 603 187 427 180],13,5,27373,4.381783255962862,20.0,0.0
6247,0,6247,[302 603 187 427 180],271,5,27378,4.3818822023047375,20.0,0.0
6248,0,6248,[302 603 187 427 180],474,5,27383,4.381981116978716,20.0,0.0
6249,0,6249,[302 603 187 427 180],474,5,27388,4.38208,20.0,0.0
6250,0,6250,[300 118 135 288 172],533,3,27391,4.381858902575588,0.0,0.0
6251,0,6251,[302 603 187 427 180],474,5,27396,4.381957773512476,20.0,0.0
6252,0,6252,[302 603 187 427 180],339,5,27401,4.382056612825844,20.0,0.0
6253,0,6253,[302 603 187 427 180],271,5,27406,4.38215542053086,20.0,0.0
6254,0,6254,[302 603 187 427 180],13,5,27411,4.382254196642686,20.0,0.0
6255,0,6255,[748 322 132 435 289],328,3,27414,4.382033248081841,0.0,0.0
6256,0,6256,[515  11  25   9   1],234,1,27415,4.381492728144478,0.0,0.0
6257,0,6257,[302 603 187 427 180],664,5,27420,4.381591562799617,20.0,0.0
6258,0,6258,[186  69 100 185  82],650,2,27422,4.381211056079246,0.0,20.0
6259,0,6259,[302 603 187 427 180],271,5,27427,4.381309904153355,20.0,0.0
6260,0,6260,[ 79  56 127 173 286],59,4,27431,4.381249001756908,0.0,20.0
6261,0,6261,[302 603 187 427 180],474,5,27436,4.381347812200575,20.0,0.0
6262,0,6262,[302 603 187 427 180],537,5,27441,4.381446591090532,20.0,0.0
6263,0,6263,[197 328  12 427 546],13,3,27444,4.381226053639847,20.0,0.0
6264,0,6264,[302 603 187 427 180],271,5,27449,4.381324820430966,20.0,0.0
6265,0,6265,[173 742 144 273   9],92,3,27452,4.381104372805618,0.0,0.0
6266,0,6266,[302 603 187 427 180],339,5,27457,4.381203127493219,20.0,0.0
6267,0,6267,[ 15 127 282  98 257],95,5,27462,4.38130185067007,0.0,40.0
6268,0,6268,[173 153 176  95 186],804,4,27466,4.381241027277078,0.0,0.0
6269,0,6269,[302 603 187 427 180],13,5,27471,4.381339712918661,20.0,0.0
6270,0,6270,[191  70 423 222  95],882,4,27475,4.381278902886302,0.0,0.0
6271,0,6271,[742 172 288 185 144],488,2,27477,4.380899234693878,0.0,0.0
6272,0,6272,[302 603 187 427 180],474,5,27482,4.380997927626335,20.0,0.0
6273,0,6273,[168  56 435 276 748],883,5,27487,4.381096589097864,0.0,0.0
6274,0,6274,[302 603 187 427 180],271,5,27492,4.381195219123506,20.0,0.0
6275,0,6275,[302 603 187 427 180],458,5,27497,4.381293817718292,20.0,0.0
6276,0,6276,[302 603 187 427 180],537,5,27502,4.381392384897244,20.0,0.0
6277,0,6277,[302 603 187 427 180],271,5,27507,4.3814909206753745,20.0,0.0
6278,0,6278,[322 210 161 182 742],454,2,27509,4.3811116419812075,0.0,0.0
6279,0,6279,[132 268 197 173 222],85,3,27512,4.380891719745223,0.0,0.0
6280,0,6280,[302 603 187 427 180],339,5,27517,4.380990288170674,20.0,0.0
6281,0,6281,[302 603 187 427 180],474,5,27522,4.3810888252149,20.0,0.0
6282,0,6282,[302 603 187 427 180],664,5,27527,4.381187330892885,20.0,0.0
6283,0,6283,[302 603 187 427 180],537,5,27532,4.381285805219606,20.0,0.0
6284,0,6284,[302 603 187 427 180],664,5,27537,4.381384248210024,20.0,0.0
6285,0,6285,[302 603 187 427 180],537,5,27542,4.381482659879096,20.0,0.0
6286,0,6286,[302 603 187 427 180],271,5,27547,4.381581040241769,20.0,0.0
6287,0,6287,[302 603 187 427 180],474,5,27552,4.3816793893129775,20.0,0.0
6288,0,6288,[302 603 187 427 180],474,5,27557,4.3817777071076485,20.0,0.0
6289,0,6289,[302 603 187 427 180],664,5,27562,4.3818759936406995,20.0,0.0
6290,0,6290,[302 603 187 427 180],664,5,27567,4.381974248927039,20.0,0.0
6291,0,6291,[183  82 191  22 435],840,3,27570,4.381754609027336,0.0,0.0
6292,0,6292,[435 269 200 153 161],102,0,27570,4.3810583187668835,0.0,0.0
6293,0,6293,[ 11 294 196  22 568],13,2,27572,4.380680012710518,0.0,0.0
6294,0,6294,[302 603 187 427 180],666,5,27577,4.380778395552025,20.0,0.0
6295,0,6295,[655 276 546  12 228],339,5,27582,4.380876747141042,20.0,0.0
6296,0,6296,[302 603 187 427 180],474,5,27587,4.380975067492456,20.0,0.0
6297,0,6297,[302 603 187 427 180],458,5,27592,4.381073356621149,20.0,0.0
6298,0,6298,[302 603 187 427 180],537,5,27597,4.381171614541991,20.0,0.0
6299,0,6299,[302 603 187 427 180],458,5,27602,4.381269841269841,20.0,0.0
6300,0,6300,[302 603 187 427 180],90,5,27607,4.381368036819553,20.0,0.0
6301,0,6301,[302 603 187 427 180],339,5,27612,4.381466201205966,20.0,0.0
6302,0,6302,[302 603 187 427 180],666,5,27617,4.381564334443915,20.0,0.0
6303,0,6303,[191 435  64 237 385],234,2,27619,4.38118654822335,0.0,0.0
6304,0,6304,[302 603 187 427 180],458,5,27624,4.381284694686757,20.0,0.0
6305,0,6305,[302 603 187 427 180],271,5,27629,4.381382810022201,20.0,0.0
6306,0,6306,[302 603 187 427 180],664,5,27634,4.38148089424449,20.0,0.0
6307,0,6307,[302 603 187 427 180],664,5,27639,4.381578947368421,20.0,0.0
6308,0,6308,[302 603 187 427 180],474,5,27644,4.381676969408781,20.0,0.0
6309,0,6309,[302 603 187 427 180],537,5,27649,4.381774960380349,20.0,0.0
6310,0,6310,[302 603 187 427 180],271,5,27654,4.3818729202978925,20.0,0.0
6311,0,6311,[302 603 187 427 180],664,5,27659,4.381970849176172,20.0,0.0
6312,0,6312,[302 603 187 427 180],13,5,27664,4.382068747029939,20.0,0.0
6313,0,6313,[748 603 222 182 471],454,2,27666,4.381691479252455,20.0,0.0
6314,0,6314,[302 603 187 427 180],458,5,27671,4.381789390340459,20.0,0.0
6315,0,6315,[302 603 187 427 180],474,5,27676,4.381887270424319,20.0,0.0
6316,0,6316,[302 603 187 427 180],666,5,27681,4.381985119518759,20.0,0.0
6317,0,6317,[302 603 187 427 180],271,5,27686,4.3820829376384935,20.0,0.0
6318,0,6318,[302 603 187 427 180],13,5,27691,4.382180724798228,20.0,0.0
6319,0,6319,[235  96 161 100 357],738,3,27694,4.381962025316455,20.0,20.0
6320,0,6320,[ 79 196 228 405  28],537,0,27694,4.3812687865844016,0.0,0.0
6321,0,6321,[ 88 185 471 228 143],374,3,27697,4.3810503005378045,0.0,0.0
6322,0,6322,[302 603 187 427 180],339,5,27702,4.38114818915072,20.0,0.0
6323,0,6323,[182 132 176 435  95],749,3,27705,4.380929791271347,0.0,0.0
6324,0,6324,[183  89  79  69 273],666,2,27707,4.380553359683795,0.0,0.0
6325,0,6325,[302 603 187 427 180],271,5,27712,4.380651280429972,20.0,0.0
6326,0,6326,[216  95   9 273 176],92,3,27715,4.380433064643591,0.0,0.0
6327,0,6327,[302 603 187 427 180],271,5,27720,4.380530973451328,20.0,0.0
6328,0,6328,[302 603 187 427 180],271,5,27725,4.380628851319324,20.0,0.0
6329,0,6329,[302 603 187 427 180],271,5,27730,4.380726698262244,20.0,0.0
6330,0,6330,[302 603 187 427 180],664,5,27735,4.38082451429474,20.0,0.0
6331,0,6331,[302 603 187 427 180],13,5,27740,4.380922299431459,20.0,0.0
6332,0,6332,[302 603 187 427 180],271,5,27745,4.3810200536870365,20.0,0.0
6333,0,6333,[333 121 216 174  79],64,3,27748,4.380802020839911,0.0,20.0
6334,0,6334,[238 176 655 121   7],213,5,27753,4.380899763220206,0.0,0.0
6335,0,6335,[302 603 187 427 180],666,5,27758,4.380997474747475,20.0,0.0
6336,0,6336,[302 603 187 427 180],271,5,27763,4.381095155436326,20.0,0.0
6337,0,6337,[ 96 181  82 471 143],537,0,27763,4.38040391290628,0.0,0.0
6338,0,6338,[ 82 195 186 100 168],64,4,27767,4.380343902823789,0.0,20.0
6339,0,6339,[ 11 289 182  15 257],374,2,27769,4.379968454258675,0.0,0.0
6340,0,6340,[302 603 187 427 180],666,5,27774,4.380066235609525,20.0,0.0
6341,0,6341,[568  97 125 135  89],290,1,27775,4.379533270261747,0.0,0.0
6342,0,6342,[238 194 135 435 385],694,4,27779,4.379473435282989,0.0,0.0
6343,0,6343,[302 603 187 427 180],537,5,27784,4.379571248423708,20.0,0.0
6344,0,6344,[187 588  25  88 196],650,1,27785,4.379038613081167,0.0,0.0
6345,0,6345,[302 603 427 187 180],537,5,27790,4.379136463914277,20.0,0.0
6346,0,6346,[302 603 427 187 180],458,5,27795,4.37923428391366,20.0,0.0
6347,0,6347,[302 603 427 187 180],474,5,27800,4.379332073093888,20.0,0.0
6348,0,6348,[302 603 427 187 180],458,5,27805,4.379429831469523,20.0,0.0
6349,0,6349,[183 118 210 175 496],184,3,27808,4.379212598425197,0.0,0.0
6350,0,6350,[302 603 427 187 180],339,5,27813,4.379310344827586,20.0,0.0
6351,0,6351,[180 328  50 127  56],804,3,27816,4.379093198992443,0.0,40.0
6352,0,6352,[302 603 427 187 180],666,5,27821,4.379190933417283,20.0,0.0
6353,0,6353,[302 603 427 187 180],13,5,27826,4.379288637079005,20.0,0.0
6354,0,6354,[302 603 427 187 180],90,5,27831,4.379386309992132,20.0,0.0
6355,0,6355,[237 125 508  98   7],144,4,27835,4.379326620516048,0.0,20.0
6356,0,6356,[ 22   4 100 117 197],650,3,27838,4.379109642913324,0.0,20.0
6357,0,6357,[302 603 427 187 180],666,5,27843,4.379207297892419,20.0,0.0
6358,0,6358,[302 603 427 187 180],13,5,27848,4.379304922157572,20.0,0.0
6359,0,6359,[302 603 427 187 180],666,5,27853,4.37940251572327,20.0,0.0
6360,0,6360,[302 603 427 187 180],664,5,27858,4.379500078603993,20.0,0.0
6361,0,6361,[302 603 427 187 180],90,5,27863,4.379597610814209,20.0,0.0
6362,0,6362,[289 496  88  79 121],95,4,27867,4.37953795379538,0.0,0.0
6363,0,6363,[ 11  95  15 568 405],537,0,27867,4.378849780012571,0.0,0.0
6364,0,6364,[302 603 427 187 180],666,5,27872,4.378947368421053,20.0,0.0
6365,0,6365,[100 423  71 268 742],334,3,27875,4.378730757147345,0.0,20.0
6366,0,6366,[216  82 385 318   4],738,4,27879,4.378671273755301,20.0,0.0
6367,0,6367,[302 603 427 187 180],664,5,27884,4.3787688442211055,20.0,0.0
6368,0,6368,[302 603 427 187 180],339,5,27889,4.378866384047731,20.0,0.0
6369,0,6369,[302 603 427 187 180],474,5,27894,4.378963893249607,20.0,0.0
6370,0,6370,[302 603 427 187 180],664,5,27899,4.379061371841155,20.0,0.0
6371,0,6371,[302 603 427 187 180],271,5,27904,4.379158819836786,20.0,0.0
6372,0,6372,[302 603 427 187 180],537,5,27909,4.379256237250902,20.0,0.0
6373,0,6373,[302 603 427 187 180],664,5,27914,4.379353624097898,20.0,0.0
6374,0,6374,[302 603 427 187 180],666,5,27919,4.379450980392157,20.0,0.0
6375,0,6375,[235 515  97 678   7],145,4,27923,4.379391468005019,0.0,0.0
6376,0,6376,[302 603 427 187 180],664,5,27928,4.379488787831269,20.0,0.0
6377,0,6377,[302 603 427 187 180],13,5,27933,4.37958607714017,20.0,0.0
6378,0,6378,[302 603 427 187 180],664,5,27938,4.379683335946073,20.0,0.0
6379,0,6379,[179 427 597 172 127],308,4,27942,4.379623824451411,0.0,20.0
6380,0,6380,[302 603 427 187 180],664,5,27947,4.379721046857859,20.0,0.0
6381,0,6381,[302 603 427 187 180],271,5,27952,4.379818238796616,20.0,0.0
6382,0,6382,[174 186 313 202 118],543,2,27954,4.379445401848661,0.0,20.0
6383,0,6383,[302 603 427 187 180],458,5,27959,4.37954260651629,20.0,0.0
6384,0,6384,[302 603 427 187 180],13,5,27964,4.3796397807361,20.0,0.0
6385,0,6385,[302 603 427 187 180],13,5,27969,4.379736924522393,20.0,0.0
6386,0,6386,[  9 222 179 235 173],92,3,27972,4.379520901831846,0.0,0.0
6387,0,6387,[ 50 655 194  12  25],59,4,27976,4.379461490294302,20.0,20.0
6388,0,6388,[302 603 427 187 180],474,5,27981,4.379558616371889,20.0,0.0
6389,0,6389,[302 603 427 187 180],339,5,27986,4.379655712050078,20.0,0.0
6390,0,6390,[ 11 216 258 237   9],145,4,27990,4.379596307307151,0.0,0.0
6391,0,6391,[302 603 427 187 180],339,5,27995,4.379693366708385,20.0,0.0
6392,0,6392,[302 603 427 187 180],666,5,28000,4.379790395745347,20.0,0.0
6393,0,6393,[ 71 211 181 143 210],454,2,28002,4.3794182045667815,0.0,0.0
6394,0,6394,[302 603 427 187 180],339,5,28007,4.379515246286161,20.0,0.0
6395,0,6395,[237 603 127 211 471],524,3,28010,4.379299562226391,20.0,20.0
6396,0,6396,[302 603 427 187 180],458,5,28015,4.379396592152571,20.0,0.0
6397,0,6397,[302 603 427 187 180],537,5,28020,4.379493591747421,20.0,0.0
6398,0,6398,[302 603 427 187 180],458,5,28025,4.37959056102516,20.0,0.0
6399,0,6399,[302 603 427 187 180],666,5,28030,4.3796875,20.0,0.0
6400,0,6400,[153 228 216 588 515],815,4,28034,4.379628183096391,0.0,0.0
6401,0,6401,[302 603 427 187 180],13,5,28039,4.379725085910653,20.0,0.0
6402,0,6402,[318 187 289 172 200],488,1,28040,4.379197251288459,20.0,0.0
6403,0,6403,[302 603 427 187 180],13,5,28045,4.379294191130543,20.0,0.0
6404,0,6404,[194  28 185 174 204],694,5,28050,4.379391100702576,0.0,20.0
6405,0,6405,[302 603 427 187 180],13,5,28055,4.379487980018732,20.0,0.0
6406,0,6406,[302 603 427 187 180],13,5,28060,4.379584829093179,20.0,0.0
6407,0,6407,[302 603 427 187 180],474,5,28065,4.379681647940075,20.0,0.0
6408,0,6408,[302 603 427 187 180],13,5,28070,4.379778436573568,20.0,0.0
6409,0,6409,[  4 318 483 234 286],537,2,28072,4.379407176287051,40.0,0.0
6410,0,6410,[302 603 427 187 180],666,5,28077,4.379503977538605,20.0,0.0
6411,0,6411,[185  11 427  56 144],666,4,28081,4.3794447910168435,0.0,0.0
6412,0,6412,[302 603 427 187 180],664,5,28086,4.37954155621394,20.0,0.0
6413,0,6413,[302 603 427 187 180],90,5,28091,4.379638291237917,20.0,0.0
6414,0,6414,[302 603 427 187 180],664,5,28096,4.379734996102884,20.0,0.0
6415,0,6415,[ 70 222 427 185 405],60,5,28101,4.379831670822942,0.0,0.0
6416,0,6416,[302 603 427 187 180],339,5,28106,4.379928315412187,20.0,0.0
6417,0,6417,[302 603 427 187 180],90,5,28111,4.3800249298847,20.0,0.0
6418,0,6418,[496 210 187 215 197],694,4,28115,4.379965726748715,0.0,0.0
6419,0,6419,[302 603 427 187 180],537,5,28120,4.38006230529595,20.0,0.0
6420,0,6420,[302 603 427 187 180],458,5,28125,4.380158853761096,20.0,0.0
6421,0,6421,[302 603 427 187 180],474,5,28130,4.3802553721582065,20.0,0.0
6422,0,6422,[ 70 265 176 603 588],804,5,28135,4.380351860501324,20.0,0.0
6423,0,6423,[302 603 427 187 180],90,5,28140,4.380448318804484,20.0,0.0
6424,0,6424,[302 603 427 187 180],664,5,28145,4.3805447470817125,20.0,0.0
6425,0,6425,[302 603 427 187 180],474,5,28150,4.3806411453470275,20.0,0.0
6426,0,6426,[302 603 427 187 180],339,5,28155,4.380737513614439,20.0,0.0
6427,0,6427,[302 603 427 187 180],537,5,28160,4.380833851897947,20.0,0.0
6428,0,6428,[238 161 385 471 202],7,3,28163,4.380619069839788,0.0,0.0
6429,0,6429,[181 265 180 228 111],648,4,28167,4.380559875583204,0.0,0.0
6430,0,6430,[302 603 427 187 180],13,5,28172,4.380656196547971,20.0,0.0
6431,0,6431,[302 603 427 187 180],13,5,28177,4.380752487562189,20.0,0.0
6432,0,6432,[302 603 427 187 180],474,5,28182,4.380848748639826,20.0,0.0
6433,0,6433,[302 603 427 187 180],664,5,28187,4.38094497979484,20.0,0.0
6434,0,6434,[302 603 427 187 180],537,5,28192,4.381041181041181,20.0,0.0
6435,0,6435,[302 603 427 187 180],666,5,28197,4.38113735239279,20.0,0.0
6436,0,6436,[215 515 357 200 405],7,3,28200,4.380922790119621,20.0,0.0
6437,0,6437,[ 11 173 153 742 588],378,4,28204,4.3808636222429325,0.0,0.0
6438,0,6438,[302 603 427 187 180],458,5,28209,4.380959776362789,20.0,0.0
6439,0,6439,[302 603 427 187 180],666,5,28214,4.381055900621118,20.0,0.0
6440,0,6440,[302 603 427 187 180],458,5,28219,4.381151995031828,20.0,0.0
6441,0,6441,[302 603 427 187 180],271,5,28224,4.381248059608817,20.0,0.0
6442,0,6442,[302 603 427 187 180],271,5,28229,4.3813440943659785,20.0,0.0
6443,0,6443,[302 603 427 187 180],90,5,28234,4.381440099317194,20.0,0.0
6444,0,6444,[302 603 427 187 180],13,5,28239,4.3815360744763385,20.0,0.0
6445,0,6445,[302 603 427 187 180],664,5,28244,4.381632019857276,20.0,0.0
6446,0,6446,[302 603 427 187 180],13,5,28249,4.381727935473863,20.0,0.0
6447,0,6447,[302 603 427 187 180],458,5,28254,4.3818238213399505,20.0,0.0
6448,0,6448,[302 603 427 187 180],339,5,28259,4.381919677469375,20.0,0.0
6449,0,6449,[471 568 275  98 211],95,3,28262,4.381705426356589,0.0,20.0
6450,0,6450,[302 603 427 187 180],664,5,28267,4.381801271120756,20.0,0.0
6451,0,6451,[ 56 288 182 135 235],213,4,28271,4.381742095474271,0.0,0.0
6452,0,6452,[302 603 427 187 180],666,5,28276,4.381837904850457,20.0,0.0
6453,0,6453,[302 603 427 187 180],90,5,28281,4.381933684536722,20.0,0.0
6454,0,6454,[ 50   9 276   4   8],343,5,28286,4.382029434546863,0.0,20.0
6455,0,6455,[302 603 427 187 180],537,5,28291,4.382125154894672,20.0,0.0
6456,0,6456,[302 603 427 187 180],339,5,28296,4.382220845593929,20.0,0.0
6457,0,6457,[302 603 427 187 180],458,5,28301,4.382316506658408,20.0,0.0
6458,0,6458,[302 603 427 187 180],13,5,28306,4.3824121381018735,20.0,0.0
6459,0,6459,[302 603 427 187 180],474,5,28311,4.38250773993808,20.0,0.0
6460,0,6460,[ 25 179 181  88 204],308,5,28316,4.382603312180777,0.0,0.0
6461,0,6461,[405  96 322 168 194],533,4,28320,4.382544103992572,0.0,0.0
6462,0,6462,[302 603 427 187 180],666,5,28325,4.382639641033576,20.0,0.0
6463,0,6463,[302 603 427 187 180],13,5,28330,4.382735148514851,20.0,0.0
6464,0,6464,[302 603 427 187 180],458,5,28335,4.382830626450116,20.0,0.0
6465,0,6465,[302 603 427 187 180],458,5,28340,4.382926074853078,20.0,0.0
6466,0,6466,[302 603 427 187 180],339,5,28345,4.383021493737436,20.0,0.0
6467,0,6467,[302 603 427 187 180],13,5,28350,4.383116883116883,20.0,0.0
6468,0,6468,[302 603 427 187 180],90,5,28355,4.383212243005101,20.0,0.0
6469,0,6469,[302 603 427 187 180],90,5,28360,4.383307573415765,20.0,0.0
6470,0,6470,[302 603 427 187 180],664,5,28365,4.383402874362541,20.0,0.0
6471,0,6471,[302 603 427 187 180],474,5,28370,4.383498145859085,20.0,0.0
6472,0,6472,[302 603 427 187 180],537,5,28375,4.383593387919048,20.0,0.0
6473,0,6473,[323 197 423  98 173],378,3,28378,4.383379672536299,0.0,20.0
6474,0,6474,[257  50 427 235 181],339,4,28382,4.383320463320463,0.0,20.0
6475,0,6475,[302 603 427 187 180],537,5,28387,4.383415688696727,20.0,0.0
6476,0,6476,[302 603 427 187 180],666,5,28392,4.383510884668828,20.0,0.0
6477,0,6477,[ 97 180 179 187 185],543,4,28396,4.383451682618092,0.0,0.0
6478,0,6478,[302 603 427 187 180],474,5,28401,4.383546843648711,20.0,0.0
6479,0,6479,[111 483 204 216  50],648,5,28406,4.383641975308642,20.0,20.0
6480,0,6480,[302 603 427 187 180],458,5,28411,4.38373707761148,20.0,0.0
6481,0,6481,[302 603 427 187 180],474,5,28416,4.383832150570812,20.0,0.0
6482,0,6482,[302 603 427 187 180],13,5,28421,4.383927194200216,20.0,0.0
6483,0,6483,[302 603 427 187 180],664,5,28426,4.384022208513263,20.0,0.0
6484,0,6484,[515 186  25   9 427],7,3,28429,4.383808789514264,0.0,0.0
6485,0,6485,[ 56 357 153 151 496],385,3,28432,4.383595436324391,20.0,0.0
6486,0,6486,[302 603 427 187 180],13,5,28437,4.383690457838754,20.0,0.0
6487,0,6487,[ 79  69 182   8   1],881,3,28440,4.383477188655981,0.0,0.0
6488,0,6488,[302 603 427 187 180],537,5,28445,4.38357219910618,20.0,0.0
6489,0,6489,[211 144 655 197 288],339,3,28448,4.383359013867488,0.0,0.0
6490,0,6490,[302 603 427 187 180],474,5,28453,4.383454013249114,20.0,0.0
6491,0,6491,[322 333 603  82 121],334,3,28456,4.3832409118915585,20.0,0.0
6492,0,6492,[302 603 427 187 180],458,5,28461,4.3833359002002155,20.0,0.0
6493,0,6493,[302 603 427 187 180],339,5,28466,4.383430859254696,20.0,0.0
6494,0,6494,[302 603 427 187 180],537,5,28471,4.383525789068514,20.0,0.0
6495,0,6495,[302 603 427 187 180],458,5,28476,4.383620689655173,20.0,0.0
6496,0,6496,[ 64 204 211 179 588],308,5,28481,4.383715561028167,0.0,0.0
6497,0,6497,[302 603 427 187 180],90,5,28486,4.383810403200985,20.0,0.0
6498,0,6498,[302 603 427 187 180],537,5,28491,4.383905216187106,20.0,0.0
6499,0,6499,[302 603 427 187 180],13,5,28496,4.384,20.0,0.0
6500,0,6500,[179  98 269 111  56],64,5,28501,4.38409475465313,0.0,20.0
6501,0,6501,[216 174 127  25 196],59,5,28506,4.384189480159951,0.0,40.0
6502,0,6502,[235 215 118 191 143],804,4,28510,4.384130401353222,0.0,0.0
6503,0,6503,[302 603 427 187 180],537,5,28515,4.384225092250922,20.0,0.0
6504,0,6504,[302 603 427 187 180],664,5,28520,4.384319754035357,20.0,0.0
6505,0,6505,[302 603 427 187 180],339,5,28525,4.384414386719951,20.0,0.0
6506,0,6506,[302 603 427 187 180],13,5,28530,4.384508990318119,20.0,0.0
6507,0,6507,[302 603 427 187 180],474,5,28535,4.38460356484327,20.0,0.0
6508,0,6508,[172 568 483 202 215],313,5,28540,4.384698110308803,20.0,0.0
6509,0,6509,[302 603 427 187 180],537,5,28545,4.38479262672811,20.0,0.0
6510,0,6510,[135 405   1 385 111],92,3,28548,4.384579941637229,0.0,0.0
6511,0,6511,[302 603 427 187 180],664,5,28553,4.384674447174447,20.0,0.0
6512,0,6512,[302 603 427 187 180],537,5,28558,4.384768923691079,20.0,0.0
6513,0,6513,[100 286 216 471 196],194,1,28559,4.384249309180227,0.0,20.0
6514,0,6514,[302 603 427 187 180],474,5,28564,4.384343821949348,20.0,0.0
6515,0,6515,[302 603 427 187 180],271,5,28569,4.384438305709024,20.0,0.0
6516,0,6516,[286   8 588 111 245],454,1,28570,4.3839189811262855,0.0,0.0
6517,0,6517,[302 603 427 187 180],664,5,28575,4.384013501073949,20.0,0.0
6518,0,6518,[403 275 588 172  95],184,4,28579,4.383954594262923,0.0,0.0
6519,0,6519,[302 603 427 187 180],666,5,28584,4.384049079754601,20.0,0.0
6520,0,6520,[302 603 427 187 180],458,5,28589,4.384143536267444,20.0,0.0
6521,0,6521,[302 603 427 187 180],271,5,28594,4.384237963814781,20.0,0.0
6522,0,6522,[302 603 427 187 180],537,5,28599,4.384332362409934,20.0,0.0
6523,0,6523,[302 603 427 187 180],474,5,28604,4.384426732066217,20.0,0.0
6524,0,6524,[143 322   7 405  11],537,1,28605,4.3839080459770114,0.0,0.0
6525,0,6525,[  4 357 268 173  70],13,2,28607,4.3835427520686485,20.0,0.0
6526,0,6526,[ 56 204  64 603   8],840,5,28612,4.383637199325877,20.0,0.0
6527,0,6527,[204 271 603 427 483],334,4,28616,4.383578431372549,40.0,0.0
6528,0,6528,[302 603 427 187 180],666,5,28621,4.38367284423342,20.0,0.0
6529,0,6529,[273 515 215 403 187],234,2,28623,4.383307810107198,0.0,0.0
6530,0,6530,[ 22 228 144  88  28],339,4,28627,4.383249119583525,0.0,0.0
6531,0,6531,[302 603 427 187 180],537,5,28632,4.383343539497857,20.0,0.0
6532,0,6532,[302 603 427 187 180],666,5,28637,4.383437930506658,20.0,0.0
6533,0,6533,[423  82 228 100 475],374,3,28640,4.38322620140802,0.0,20.0
6534,0,6534,[228 111  11  28 144],447,4,28644,4.383167559296098,0.0,0.0
6535,0,6535,[ 98 196 117   8   9],13,3,28647,4.382955936352509,0.0,20.0
6536,0,6536,[302 603 427 187 180],339,5,28652,4.383050328897047,20.0,0.0
6537,0,6537,[405  11 318  28 357],406,3,28655,4.382838788620373,40.0,0.0
6538,0,6538,[172 323 257  64 475],669,1,28656,4.382321455880104,0.0,0.0
6539,0,6539,[302 603 427 187 180],664,5,28661,4.382415902140673,20.0,0.0
6540,0,6540,[357 195 405 655 313],738,3,28664,4.382204555878306,20.0,0.0
6541,0,6541,[403 191 222 174 180],533,3,28667,4.381993274228065,0.0,20.0
6542,0,6542,[435 515  79 176 100],380,3,28670,4.381782057160324,0.0,20.0
6543,0,6543,[302 603 427 187 180],458,5,28675,4.38187652811736,20.0,0.0
6544,0,6544,[302 603 427 187 180],458,5,28680,4.381970970206265,20.0,0.0
6545,0,6545,[302 603 427 187 180],664,5,28685,4.382065383440269,20.0,0.0
6546,0,6546,[302 603 427 187 180],271,5,28690,4.382159767832595,20.0,0.0
6547,0,6547,[302 603 427 187 180],13,5,28695,4.382254123396457,20.0,0.0
6548,0,6548,[508 153 173 211 143],385,2,28697,4.381890364941213,0.0,0.0
6549,0,6549,[302 603 427 187 180],339,5,28702,4.381984732824428,20.0,0.0
6550,0,6550,[302 603 427 187 180],664,5,28707,4.3820790718974205,20.0,0.0
6551,0,6551,[258 183 127 161  22],653,3,28710,4.381868131868132,0.0,20.0
6552,0,6552,[302 603 427 187 180],13,5,28715,4.381962459942011,20.0,0.0
6553,0,6553,[302 603 427 187 180],664,5,28720,4.382056759231004,20.0,0.0
6554,0,6554,[  1 282 180 300 187],479,4,28724,4.381998474446987,0.0,0.0
6555,0,6555,[302 603 427 187 180],664,5,28729,4.38209273947529,20.0,0.0
6556,0,6556,[302 603 427 187 180],474,5,28734,4.382186975751106,20.0,0.0
6557,0,6557,[302 603 427 187 180],458,5,28739,4.382281183287588,20.0,0.0
6558,0,6558,[302 603 427 187 180],664,5,28744,4.382375362097881,20.0,0.0
6559,0,6559,[202 313 655 597 182],13,4,28748,4.382317073170731,0.0,0.0
6560,0,6560,[302 603 427 187 180],458,5,28753,4.382411217802164,20.0,0.0
6561,0,6561,[568 496 322 179 275],537,3,28756,4.382200548613228,0.0,0.0
6562,0,6562,[302 603 427 187 180],13,5,28761,4.38229468230992,20.0,0.0
6563,0,6563,[ 95 118 182 496  64],749,2,28763,4.381931748933577,0.0,0.0
6564,0,6564,[174 483 180  71 318],648,2,28765,4.381568926123381,40.0,20.0
6565,0,6565,[117 195 302 185 174],13,2,28767,4.381206213828815,0.0,20.0
6566,0,6566,[302 603 427 187 180],90,5,28772,4.381300441601949,20.0,0.0
6567,0,6567,[234 471  82 186 288],374,5,28777,4.381394640682095,0.0,0.0
6568,0,6568,[ 50 200 153  11 423],7,4,28781,4.381336580910337,0.0,20.0
6569,0,6569,[302 603 427 187 180],271,5,28786,4.381430745814307,20.0,0.0
6570,0,6570,[302 603 427 187 180],271,5,28791,4.381524882057525,20.0,0.0
6571,0,6571,[302 603 427 187 180],13,5,28796,4.381618989653074,20.0,0.0
6572,0,6572,[210 187   9 228 603],239,4,28800,4.381560931081697,20.0,0.0
6573,0,6573,[183 655  79  28   4],378,4,28804,4.381502890173411,0.0,0.0
6574,0,6574,[172 153  15 211 194],406,4,28808,4.381444866920152,0.0,0.0
6575,0,6575,[302 603 427 187 180],537,5,28813,4.3815389294403895,20.0,0.0
6576,0,6576,[568  69 237 176 294],42,4,28817,4.381480918351832,0.0,0.0
6577,0,6577,[302 603 427 187 180],339,5,28822,4.381574946792338,20.0,0.0
6578,0,6578,[143 742 228 197 678],334,2,28824,4.381212950296398,0.0,0.0
6579,0,6579,[302 603 427 187 180],13,5,28829,4.381306990881459,20.0,0.0
6580,0,6580,[215 183 194 187 237],406,2,28831,4.380945145114724,0.0,0.0
6581,0,6581,[302 603 427 187 180],90,5,28836,4.381039197812215,20.0,0.0
6582,0,6582,[302 603 427 187 180],537,5,28841,4.381133221935288,20.0,0.0
6583,0,6583,[ 96  95 125 405 271],749,3,28844,4.380923450789793,0.0,0.0
6584,0,6584,[238 204 216 200  22],339,3,28847,4.380713743356113,0.0,0.0
6585,0,6585,[222 322  95 403 172],334,2,28849,4.380352262374735,0.0,0.0
6586,0,6586,[302 603 427 187 180],13,5,28854,4.3804463336875665,20.0,0.0
6587,0,6587,[125 238  95 435 300],313,3,28857,4.38023679417122,0.0,0.0
6588,0,6588,[302 603 427 187 180],458,5,28862,4.380330854454393,20.0,0.0
6589,0,6589,[ 25 191  82 174 132],308,4,28866,4.380273141122913,0.0,20.0
6590,0,6590,[175  82 222   7 515],234,1,28867,4.379760279168563,0.0,0.0
6591,0,6591,[195 111  50  95 245],378,2,28869,4.37939927184466,0.0,20.0
6592,0,6592,[302 603 427 187 180],474,5,28874,4.379493402093129,20.0,0.0
6593,0,6593,[ 98  88 161  56 333],653,3,28877,4.379284197755536,0.0,20.0
6594,0,6594,[ 70  95 300 202 172],125,4,28881,4.379226686884003,0.0,0.0
6595,0,6595,[302 603 427 187 180],666,5,28886,4.379320800485143,20.0,0.0
6596,0,6596,[302 603 427 187 180],664,5,28891,4.37941488555404,20.0,0.0
6597,0,6597,[302 603 427 187 180],474,5,28896,4.3795089421036675,20.0,0.0
6598,0,6598,[302 603 427 187 180],666,5,28901,4.379602970146992,20.0,0.0
6599,0,6599,[302 603 427 187 180],339,5,28906,4.37969696969697,20.0,0.0
6600,0,6600,[302 603 427 187 180],271,5,28911,4.379790940766551,20.0,0.0
6601,0,6601,[211 276  79 186 185],271,3,28914,4.379581944865192,0.0,0.0
6602,0,6602,[161 153  97  70 210],13,3,28917,4.379373012267151,0.0,0.0
6603,0,6603,[302 603 427 187 180],13,5,28922,4.37946698970321,20.0,0.0
6604,0,6604,[302 603 427 187 180],666,5,28927,4.3795609386828165,20.0,0.0
6605,0,6605,[302 603 427 187 180],271,5,28932,4.379654859218892,20.0,0.0
6606,0,6606,[302 603 427 187 180],474,5,28937,4.379748751324353,20.0,0.0
6607,0,6607,[302 603 427 187 180],13,5,28942,4.379842615012106,20.0,0.0
6608,0,6608,[302 603 427 187 180],664,5,28947,4.379936450295053,20.0,0.0
6609,0,6609,[302 603 427 187 180],271,5,28952,4.380030257186082,20.0,0.0
6610,0,6610,[302 603 427 187 180],90,5,28957,4.380124035698079,20.0,0.0
6611,0,6611,[302 603 427 187 180],458,5,28962,4.38021778584392,20.0,0.0
6612,0,6612,[302 603 427 187 180],458,5,28967,4.380311507636474,20.0,0.0
6613,0,6613,[302 603 427 187 180],474,5,28972,4.3804052010886,20.0,0.0
6614,0,6614,[302 603 427 187 180],271,5,28977,4.380498866213152,20.0,0.0
6615,0,6615,[302 603 427 187 180],474,5,28982,4.380592503022974,20.0,0.0
6616,0,6616,[302 603 427 187 180],339,5,28987,4.380686111530905,20.0,0.0
6617,0,6617,[ 96 175  25  95 597],308,4,28991,4.380628588697491,0.0,0.0
6618,0,6618,[302 603 427 187 180],666,5,28996,4.380722163468802,20.0,0.0
6619,0,6619,[435 496  95   4 151],524,2,28998,4.38036253776435,0.0,0.0
6620,0,6620,[405 546 100 183  69],13,3,29001,4.380154055278659,0.0,20.0
6621,0,6621,[302 603 427 187 180],664,5,29006,4.380247659317427,20.0,0.0
6622,0,6622,[302 603 427 187 180],271,5,29011,4.380341235089839,20.0,0.0
6623,0,6623,[302 603 427 187 180],458,5,29016,4.380434782608695,20.0,0.0
6624,0,6624,[302 603 427 187 180],271,5,29021,4.380528301886793,20.0,0.0
6625,0,6625,[302 603 427 187 180],339,5,29026,4.380621792936915,20.0,0.0
6626,0,6626,[302 603 427 187 180],90,5,29031,4.380715255771842,20.0,0.0
6627,0,6627,[496 195  96 194 257],474,4,29035,4.380657815328908,0.0,0.0
6628,0,6628,[302 603 427 187 180],537,5,29040,4.380751244531604,20.0,0.0
6629,0,6629,[302 603 427 187 180],13,5,29045,4.380844645550528,20.0,0.0
6630,0,6630,[173 237  11 302 132],346,3,29048,4.380636404765496,0.0,0.0
6631,0,6631,[302 603 427 187 180],13,5,29053,4.380729794933655,20.0,0.0
6632,0,6632,[302 603 427 187 180],666,5,29058,4.38082315694256,20.0,0.0
6633,0,6633,[302 603 427 187 180],664,5,29063,4.380916490804944,20.0,0.0
6634,0,6634,[302 603 427 187 180],664,5,29068,4.381009796533534,20.0,0.0
6635,0,6635,[302 603 427 187 180],339,5,29073,4.381103074141048,20.0,0.0
6636,0,6636,[302 603 427 187 180],537,5,29078,4.381196323640199,20.0,0.0
6637,0,6637,[515 187 174 228 546],524,4,29082,4.38113889725821,0.0,20.0
6638,0,6638,[302 603 427 187 180],339,5,29087,4.3812321132700704,20.0,0.0
6639,0,6639,[ 12 288 179 289 173],334,3,29090,4.381024096385542,20.0,0.0
6640,0,6640,[ 69 483 546  97 515],290,2,29092,4.380665562415299,20.0,0.0
6641,0,6641,[302 603 427 187 180],271,5,29097,4.380758807588076,20.0,0.0
6642,0,6642,[302 603 427 187 180],13,5,29102,4.380852024687641,20.0,0.0
6643,0,6643,[302 603 427 187 180],537,5,29107,4.380945213726671,20.0,0.0
6644,0,6644,[211 200   4 132 655],328,4,29111,4.380887885628292,0.0,0.0
6645,0,6645,[302 603 427 187 180],13,5,29116,4.380981041227806,20.0,0.0
6646,0,6646,[302 603 427 187 180],13,5,29121,4.381074168797954,20.0,0.0
6647,0,6647,[302 603 427 187 180],537,5,29126,4.381167268351384,20.0,0.0
6648,0,6648,[222 588 127   7 286],650,2,29128,4.380809144232216,0.0,20.0
6649,0,6649,[357  89 183 186   1],738,5,29133,4.380902255639098,20.0,0.0
6650,0,6650,[302 603 427 187 180],537,5,29138,4.38099533904676,20.0,0.0
6651,0,6651,[ 56 313 483 423 153],207,5,29143,4.381088394467829,20.0,0.0
6652,0,6652,[302 603 427 187 180],339,5,29148,4.381181421914926,20.0,0.0
6653,0,6653,[302 603 427 187 180],458,5,29153,4.381274421400661,20.0,0.0
6654,0,6654,[302 603 427 187 180],664,5,29158,4.381367392937641,20.0,0.0
6655,0,6655,[302 603 427 187 180],474,5,29163,4.381460336538462,20.0,0.0
6656,0,6656,[302 603 427 187 180],537,5,29168,4.381553252215713,20.0,0.0
6657,0,6657,[302 603 427 187 180],90,5,29173,4.381646139981976,20.0,0.0
6658,0,6658,[302 603 427 187 180],537,5,29178,4.381738999849827,20.0,0.0
6659,0,6659,[302 603 427 187 180],537,5,29183,4.381831831831832,20.0,0.0
6660,0,6660,[313 151 143 191 257],334,4,29187,4.381774508332082,0.0,0.0
6661,0,6661,[302 603 427 187 180],474,5,29192,4.38186730711498,20.0,0.0
6662,0,6662,[302 603 427 187 180],271,5,29197,4.3819600780429235,20.0,0.0
6663,0,6663,[302 603 427 187 180],664,5,29202,4.382052821128451,20.0,0.0
6664,0,6664,[302 603 427 187 180],90,5,29207,4.382145536384096,20.0,0.0
6665,0,6665,[302 603 427 187 180],13,5,29212,4.382238223822382,20.0,0.0
6666,0,6666,[302 603 427 187 180],90,5,29217,4.382330883455827,20.0,0.0
6667,0,6667,[302 603 427 187 180],13,5,29222,4.38242351529694,20.0,0.0
6668,0,6668,[302 603 427 187 180],271,5,29227,4.3825161193582245,20.0,0.0
6669,0,6669,[302 603 427 187 180],13,5,29232,4.3826086956521735,20.0,0.0
6670,0,6670,[423 515 238  69 597],95,4,29236,4.382551341627942,0.0,0.0
6671,0,6671,[302 603 427 187 180],537,5,29241,4.382643884892087,20.0,0.0
6672,0,6672,[127 151  15  12  71],474,4,29245,4.382586542784355,20.0,20.0
6673,0,6673,[302 603 427 187 180],271,5,29250,4.382679053041654,20.0,0.0
6674,0,6674,[597  95 175 427 143],59,2,29252,4.382322097378277,0.0,0.0
6675,0,6675,[302 603 427 187 180],666,5,29257,4.382414619532654,20.0,0.0
6676,0,6676,[302 603 427 187 180],664,5,29262,4.382507113973341,20.0,0.0
6677,0,6677,[302 603 427 187 180],339,5,29267,4.382599580712788,20.0,0.0
6678,0,6678,[302 603 427 187 180],474,5,29272,4.382692019763438,20.0,0.0
6679,0,6679,[118 143 257 403  82],308,4,29276,4.382634730538922,0.0,0.0
6680,0,6680,[302 603 427 187 180],13,5,29281,4.3827271366561895,20.0,0.0
6681,0,6681,[302 603 427 187 180],90,5,29286,4.382819515115235,20.0,0.0
6682,0,6682,[302 603 427 187 180],474,5,29291,4.382911865928476,20.0,0.0
6683,0,6683,[302 603 427 187 180],90,5,29296,4.383004189108318,20.0,0.0
6684,0,6684,[302 603 427 187 180],666,5,29301,4.383096484667165,20.0,0.0
6685,0,6685,[ 69 175 238 275  97],378,3,29304,4.382889620101705,0.0,0.0
6686,0,6686,[ 28 195 132 121  98],7,5,29309,4.382981905189173,0.0,20.0
6687,0,6687,[302 603 427 187 180],339,5,29314,4.383074162679426,20.0,0.0
6688,0,6688,[302 603 427 187 180],271,5,29319,4.383166392584841,20.0,0.0
6689,0,6689,[288  15 121 603 195],537,1,29320,4.382660687593423,20.0,0.0
6690,0,6690,[302 603 427 187 180],90,5,29325,4.382752951726199,20.0,0.0
6691,0,6691,[215 118  56 211 286],343,4,29329,4.382695756126719,0.0,0.0
6692,0,6692,[302 603 427 187 180],13,5,29334,4.382787987449574,20.0,0.0
6693,0,6693,[302 603 427 187 180],339,5,29339,4.382880191216015,20.0,0.0
6694,0,6694,[302 603 427 187 180],90,5,29344,4.382972367438387,20.0,0.0
6695,0,6695,[302 603 427 187 180],537,5,29349,4.383064516129032,20.0,0.0
6696,0,6696,[302 603 427 187 180],537,5,29354,4.383156637300284,20.0,0.0
6697,0,6697,[181 187 185 161 210],897,4,29358,4.383099432666468,0.0,0.0
6698,0,6698,[228 235 655  79 176],92,4,29362,4.383042245111211,0.0,0.0
6699,0,6699,[302 603 427 187 180],458,5,29367,4.383134328358209,20.0,0.0
6700,0,6700,[302 603 427 187 180],458,5,29372,4.383226384121773,20.0,0.0
6701,0,6701,[237   4 215 403   7],295,5,29377,4.383318412414205,0.0,0.0
6702,0,6702,[302 603 427 187 180],339,5,29382,4.383410413247799,20.0,0.0
6703,0,6703,[546 235 222 276 269],378,3,29385,4.383204057279237,0.0,0.0
6704,0,6704,[ 70 403 187  28 275],7,4,29389,4.383146905294557,0.0,0.0
6705,0,6705,[302 603 427 187 180],90,5,29394,4.38323889054578,20.0,0.0
6706,0,6706,[302 603 427 187 180],90,5,29399,4.383330848367377,20.0,0.0
6707,0,6707,[302 603 427 187 180],664,5,29404,4.383422778771616,20.0,0.0
6708,0,6708,[301 161  89  82   8],234,1,29405,4.382918467729915,0.0,0.0
6709,0,6709,[302 603 427 187 180],271,5,29410,4.38301043219076,20.0,0.0
6710,0,6710,[265 132 175 168 191],77,2,29412,4.382655341975861,0.0,0.0
6711,0,6711,[ 22 187 603 182 180],897,5,29417,4.382747318235995,20.0,0.0
6712,0,6712,[ 22 282 195 405 135],95,3,29420,4.382541337702964,0.0,0.0
6713,0,6713,[496  28 176 153 194],804,5,29425,4.382633303544831,0.0,0.0
6714,0,6714,[302 603 427 187 180],537,5,29430,4.382725241995533,20.0,0.0
6715,0,6715,[181 286 546   4 597],653,3,29433,4.3825193567599765,0.0,0.0
6716,0,6716,[302 603 427 187 180],271,5,29438,4.382611284799761,20.0,0.0
6717,0,6717,[302 603 427 187 180],666,5,29443,4.3827031854718665,20.0,0.0
6718,0,6718,[302 603 427 187 180],13,5,29448,4.38279505878851,20.0,0.0
6719,0,6719,[302 603 427 187 180],271,5,29453,4.382886904761905,20.0,0.0
6720,0,6720,[302 603 427 187 180],13,5,29458,4.382978723404255,20.0,0.0
6721,0,6721,[191 197 742 183 269],207,4,29462,4.382921749479322,0.0,0.0
6722,0,6722,[302 603 427 187 180],537,5,29467,4.383013535623977,20.0,0.0
6723,0,6723,[180 135 238 742  96],653,3,29470,4.382807852468769,0.0,0.0
6724,0,6724,[302 603 427 187 180],664,5,29475,4.382899628252788,20.0,0.0
6725,0,6725,[276 121 357 173 204],200,5,29480,4.382991376746952,20.0,0.0
6726,0,6726,[173  88 195 144 127],749,5,29485,4.383083097963431,0.0,20.0
6727,0,6727,[275 471 132 237 603],454,2,29487,4.382728894173603,20.0,0.0
6728,0,6728,[151 143 125 195 655],213,5,29492,4.382820627136276,0.0,0.0
6729,0,6729,[318 125 202 132 117],290,2,29494,4.382466567607727,20.0,0.0
6730,0,6730,[302 603 427 187 180],271,5,29499,4.382558312286436,20.0,0.0
6731,0,6731,[300 216 276  82 678],537,1,29500,4.382055852644088,0.0,0.0
6732,0,6732,[302 603 427 187 180],474,5,29505,4.382147631070845,20.0,0.0
6733,0,6733,[302 603 427 187 180],664,5,29510,4.382239382239383,20.0,0.0
6734,0,6734,[302 603 427 187 180],90,5,29515,4.382331106161841,20.0,0.0
6735,0,6735,[275 143 187 161 135],7,3,29518,4.382125890736342,0.0,0.0
6736,0,6736,[302 603 427 187 180],458,5,29523,4.3822176042749,20.0,0.0
6737,0,6737,[200  89 289 328 322],92,1,29524,4.381715642623924,0.0,0.0
6738,0,6738,[302 603 427 187 180],537,5,29529,4.381807389820448,20.0,0.0
6739,0,6739,[302 603 427 187 180],664,5,29534,4.381899109792285,20.0,0.0
6740,0,6740,[302 603 427 187 180],474,5,29539,4.381990802551551,20.0,0.0
6741,0,6741,[471 568 603  69  98],899,4,29543,4.381934144170869,20.0,20.0
6742,0,6742,[ 96   8 215 121 228],92,5,29548,4.382025804538039,0.0,0.0
6743,0,6743,[161 405 168 172 258],313,2,29550,4.381672597864768,0.0,0.0
6744,0,6744,[302 603 427 187 180],271,5,29555,4.381764269829503,20.0,0.0
6745,0,6745,[302 603 427 187 180],339,5,29560,4.381855914616069,20.0,0.0
6746,0,6746,[132 186 323 568 748],311,3,29563,4.381651104194456,0.0,0.0
6747,0,6747,[302 603 427 187 180],458,5,29568,4.381742738589212,20.0,0.0
6748,0,6748,[742 258 288 385 194],533,4,29572,4.381686175729738,0.0,0.0
6749,0,6749,[302 603 427 187 180],474,5,29577,4.381777777777778,20.0,0.0
6750,0,6750,[302 603 427 187 180],458,5,29582,4.381869352688491,20.0,0.0
6751,0,6751,[302 603 427 187 180],458,5,29587,4.381960900473934,20.0,0.0
6752,0,6752,[302 603 427 187 180],666,5,29592,4.382052421146157,20.0,0.0
6753,0,6753,[302 603 427 187 180],271,5,29597,4.382143914717204,20.0,0.0
6754,0,6754,[ 82 173  79   1  15],554,3,29600,4.381939304219097,0.0,0.0
6755,0,6755,[271 237 294 117 182],537,1,29601,4.381438721136767,0.0,0.0
6756,0,6756,[302 603 427 187 180],537,5,29606,4.381530264910463,20.0,0.0
6757,0,6757,[174 135 132   4 111],385,1,29607,4.381029890500148,0.0,20.0
6758,0,6758,[302 603 427 187 180],537,5,29612,4.381121467672733,20.0,0.0
6759,0,6759,[235 475 313  82 273],13,1,29613,4.380621301775148,0.0,0.0
6760,0,6760,[176  56 173 515 151],7,3,29616,4.380417098062416,0.0,0.0
6761,0,6761,[302 603 427 187 180],537,5,29621,4.380508725229222,20.0,0.0
6762,0,6762,[117 403 276 197 322],533,3,29624,4.380304598550939,0.0,0.0
6763,0,6763,[302 603 427 187 180],537,5,29629,4.380396215257244,20.0,0.0
6764,0,6764,[ 25 144 153   1 222],92,4,29633,4.380339985218034,0.0,0.0
6765,0,6765,[294 300 211 234 328],271,2,29635,4.379988176174993,0.0,0.0
6766,0,6766,[302 603 427 187 180],339,5,29640,4.380079799024679,20.0,0.0
6767,0,6767,[ 28  22 216 211 144],339,3,29643,4.379875886524823,0.0,0.0
6768,0,6768,[302 603 427 187 180],458,5,29648,4.379967498892007,20.0,0.0
6769,0,6769,[302 603 427 187 180],458,5,29653,4.380059084194978,20.0,0.0
6770,0,6770,[302 603 427 187 180],474,5,29658,4.380150642445725,20.0,0.0
6771,0,6771,[302 603 427 187 180],474,5,29663,4.380242173656232,20.0,0.0
6772,0,6772,[302 603 427 187 180],339,5,29668,4.380333677838476,20.0,0.0
6773,0,6773,[302 603 427 187 180],13,5,29673,4.380425155004429,20.0,0.0
6774,0,6774,[405 191 323   4  70],804,5,29678,4.380516605166052,0.0,0.0
6775,0,6775,[423  56 483  82 183],537,2,29680,4.380165289256198,20.0,0.0
6776,0,6776,[302 603 427 187 180],666,5,29685,4.380256750774679,20.0,0.0
6777,0,6777,[238  25 210 222   1],406,2,29687,4.379905576866332,0.0,0.0
6778,0,6778,[182 282   7 515  79],95,4,29691,4.3798495353296945,0.0,0.0
6779,0,6779,[100 186  12 210 322],311,3,29694,4.379646017699115,20.0,20.0
6780,0,6780,[302 603 427 187 180],666,5,29699,4.379737501843386,20.0,0.0
6781,0,6781,[182 204 235 276 216],194,1,29700,4.3792391624889415,0.0,0.0
6782,0,6782,[302 603 427 187 180],474,5,29705,4.379330679640277,20.0,0.0
6783,0,6783,[302 603 427 187 180],13,5,29710,4.3794221698113205,20.0,0.0
6784,0,6784,[210 143 180 288  95],308,5,29715,4.379513633014001,0.0,0.0
6785,0,6785,[302 603 427 187 180],271,5,29720,4.379605069260242,20.0,0.0
6786,0,6786,[302 603 427 187 180],537,5,29725,4.379696478561956,20.0,0.0
6787,0,6787,[302 603 427 187 180],537,5,29730,4.379787860931055,20.0,0.0
6788,0,6788,[302 603 427 187 180],90,5,29735,4.379879216379437,20.0,0.0
6789,0,6789,[302 603 427 187 180],339,5,29740,4.379970544918999,20.0,0.0
6790,0,6790,[302 603 427 187 180],90,5,29745,4.380061846561626,20.0,0.0
6791,0,6791,[302 603 427 187 180],666,5,29750,4.380153121319199,20.0,0.0
6792,0,6792,[568 496 427  15  96],882,5,29755,4.3802443692035915,0.0,0.0
6793,0,6793,[302 603 427 187 180],13,5,29760,4.380335590226671,20.0,0.0
6794,0,6794,[302 603 427 187 180],474,5,29765,4.380426784400294,20.0,0.0
6795,0,6795,[302 603 427 187 180],666,5,29770,4.380517951736316,20.0,0.0
6796,0,6796,[678 175  11 179  96],387,3,29773,4.380314844784464,0.0,0.0
6797,0,6797,[302 603 427 187 180],664,5,29778,4.380406001765225,20.0,0.0
6798,0,6798,[302 603 427 187 180],339,5,29783,4.3804971319311665,20.0,0.0
6799,0,6799,[302 603 427 187 180],664,5,29788,4.380588235294118,20.0,0.0
6800,0,6800,[302 603 427 187 180],474,5,29793,4.380679311865902,20.0,0.0
6801,0,6801,[302 603 427 187 180],458,5,29798,4.380770361658336,20.0,0.0
6802,0,6802,[302 603 427 187 180],13,5,29803,4.380861384683228,20.0,0.0
6803,0,6803,[302 603 427 187 180],664,5,29808,4.380952380952381,20.0,0.0
6804,0,6804,[302 603 427 187 180],90,5,29813,4.38104335047759,20.0,0.0
6805,0,6805,[302 603 427 187 180],664,5,29818,4.381134293270644,20.0,0.0
6806,0,6806,[302 603 427 187 180],13,5,29823,4.381225209343323,20.0,0.0
6807,0,6807,[302 603 427 187 180],90,5,29828,4.381316098707403,20.0,0.0
6808,0,6808,[302 603 427 187 180],537,5,29833,4.381406961374651,20.0,0.0
6809,0,6809,[302 603 427 187 180],474,5,29838,4.381497797356828,20.0,0.0
6810,0,6810,[191 168  69  95  88],125,5,29843,4.381588606665688,0.0,0.0
6811,0,6811,[179 302  79 176 117],13,1,29844,4.381092190252495,0.0,0.0
6812,0,6812,[ 79  56  70 228 173],28,4,29848,4.3810362542198735,0.0,0.0
6813,0,6813,[302 603 427 187 180],666,5,29853,4.381127091282654,20.0,0.0
6814,0,6814,[197 161   1 143 195],479,3,29856,4.38092443140132,0.0,0.0
6815,0,6815,[143  50 483 195 194],749,5,29861,4.381015258215962,20.0,20.0
6816,0,6816,[286 204 191 186  89],378,4,29865,4.380959366290157,0.0,0.0
6817,0,6817,[ 25  50 168 182 222],406,2,29867,4.3806101496039895,0.0,20.0
6818,0,6818,[603 357  95  97 161],543,3,29870,4.380407684411204,40.0,0.0
6819,0,6819,[302 603 427 187 180],339,5,29875,4.3804985337243405,20.0,0.0
6820,0,6820,[302 603 427 187 180],458,5,29880,4.380589356399355,20.0,0.0
6821,0,6821,[302 603 427 187 180],474,5,29885,4.380680152447963,20.0,0.0
6822,0,6822,[302 603 427 187 180],90,5,29890,4.3807709218818704,20.0,0.0
6823,0,6823,[302 603 427 187 180],537,5,29895,4.3808616647127785,20.0,0.0
6824,0,6824,[302 603 427 187 180],271,5,29900,4.380952380952381,20.0,0.0
6825,0,6825,[302 603 427 187 180],271,5,29905,4.381043070612365,20.0,0.0
6826,0,6826,[423 125 546 237 161],295,5,29910,4.381133733704409,0.0,0.0
6827,0,6827,[302 603 427 187 180],339,5,29915,4.381224370240187,20.0,0.0
6828,0,6828,[302 603 427 187 180],664,5,29920,4.381314980231366,20.0,0.0
6829,0,6829,[151 111 269 286 200],378,2,29922,4.380966325036603,0.0,0.0
6830,0,6830,[302 603 427 187 180],474,5,29927,4.381056946274337,20.0,0.0
6831,0,6831,[302 603 427 187 180],666,5,29932,4.381147540983607,20.0,0.0
6832,0,6832,[196   8 322 216 471],207,2,29934,4.380799063368944,0.0,0.0
6833,0,6833,[302 603 427 187 180],664,5,29939,4.380889669300556,20.0,0.0
6834,0,6834,[302 603 427 187 180],90,5,29944,4.380980248719824,20.0,0.0
6835,0,6835,[302 603 427 187 180],664,5,29949,4.381070801638385,20.0,0.0
6836,0,6836,[302 603 427 187 180],458,5,29954,4.381161328067866,20.0,0.0
6837,0,6837,[302 603 427 187 180],13,5,29959,4.381251828019889,20.0,0.0
6838,0,6838,[302 603 427 187 180],339,5,29964,4.381342301506068,20.0,0.0
6839,0,6839,[302 603 427 187 180],537,5,29969,4.381432748538011,20.0,0.0
6840,0,6840,[185 257 151 742  28],653,1,29970,4.3809384592895775,0.0,0.0
6841,0,6841,[302 603 427 187 180],271,5,29975,4.381028938906752,20.0,0.0
6842,0,6842,[302 603 427 187 180],537,5,29980,4.381119392079497,20.0,0.0
6843,0,6843,[294   7 185 655 204],804,5,29985,4.3812098188194035,0.0,0.0
6844,0,6844,[302 603 427 187 180],664,5,29990,4.381300219138057,20.0,0.0
6845,0,6845,[302 603 427 187 180],339,5,29995,4.381390593047035,20.0,0.0
6846,0,6846,[302 603 427 187 180],474,5,30000,4.381480940557909,20.0,0.0
6847,0,6847,[318 405 168 216  96],374,3,30003,4.381279205607477,20.0,0.0
6848,0,6848,[302 603 427 187 180],458,5,30008,4.381369542998978,20.0,0.0
6849,0,6849,[435 323 187 194 235],788,2,30010,4.381021897810219,0.0,0.0
6850,0,6850,[234 195 273 235  64],213,4,30014,4.380966282294556,0.0,0.0
6851,0,6851,[265  15  69  25 403],308,2,30016,4.380618797431407,0.0,0.0
6852,0,6852,[302 603 427 187 180],537,5,30021,4.380709178461988,20.0,0.0
6853,0,6853,[302 603 427 187 180],666,5,30026,4.380799533119347,20.0,0.0
6854,0,6854,[302 603 427 187 180],339,5,30031,4.380889861415025,20.0,0.0
6855,0,6855,[302 603 427 187 180],458,5,30036,4.38098016336056,20.0,0.0
6856,0,6856,[302 603 427 187 180],537,5,30041,4.381070438967479,20.0,0.0
6857,0,6857,[302 603 427 187 180],458,5,30046,4.381160688247302,20.0,0.0
6858,0,6858,[302 603 427 187 180],271,5,30051,4.381250911211547,20.0,0.0
6859,0,6859,[302 603 427 187 180],474,5,30056,4.38134110787172,20.0,0.0
6860,0,6860,[181 174  22   7 180],234,1,30057,4.3808482728465235,0.0,20.0
6861,0,6861,[176 288 144 748 175],13,3,30060,4.380647041678811,0.0,0.0
6862,0,6862,[228  89  97 172 175],738,5,30065,4.380737286900772,0.0,0.0
6863,0,6863,[302 603 427 187 180],474,5,30070,4.380827505827506,20.0,0.0
6864,0,6864,[302 603 427 187 180],90,5,30075,4.380917698470503,20.0,0.0
6865,0,6865,[176 132   7 597 194],328,3,30078,4.380716574424701,0.0,0.0
6866,0,6866,[302 603 427 187 180],271,5,30083,4.380806756953546,20.0,0.0
6867,0,6867,[302 603 427 187 180],90,5,30088,4.380896913220734,20.0,0.0
6868,0,6868,[ 69 483 174  71 238],766,2,30090,4.380550298442277,20.0,20.0
6869,0,6869,[678 132 118 403 186],881,1,30091,4.380058224163028,0.0,0.0
6870,0,6870,[357  69 204 483   7],666,3,30094,4.379857371561636,40.0,0.0
6871,0,6871,[302 603 427 187 180],271,5,30099,4.379947613504075,20.0,0.0
6872,0,6872,[ 11 100 273 322 144],92,4,30103,4.3798923323148555,0.0,20.0
6873,0,6873,[194 405 318 121   4],804,5,30108,4.379982542915333,20.0,0.0
6874,0,6874,[508 195 238 174  69],833,2,30110,4.379636363636363,0.0,20.0
6875,0,6875,[302 603 427 187 180],271,5,30115,4.379726585223968,20.0,0.0
6876,0,6876,[302 603 427 187 180],339,5,30120,4.3798167805729245,20.0,0.0
6877,0,6877,[ 97 195  95  25 215],313,3,30123,4.37961616749055,0.0,0.0
6878,0,6878,[183 423 742 265 475],374,3,30126,4.379415612734409,0.0,0.0
6879,0,6879,[302 603 427 187 180],474,5,30131,4.379505813953489,20.0,0.0
6880,0,6880,[216 181 282 286 515],95,5,30136,4.379595988955094,0.0,0.0
6881,0,6881,[302 603 427 187 180],474,5,30141,4.379686137750654,20.0,0.0
6882,0,6882,[302 603 427 187 180],474,5,30146,4.379776260351591,20.0,0.0
6883,0,6883,[302 603 427 187 180],664,5,30151,4.379866356769321,20.0,0.0
6884,0,6884,[588 471  71 568 237],454,2,30153,4.379520697167756,0.0,0.0
6885,0,6885,[302 603 427 187 180],339,5,30158,4.379610804530932,20.0,0.0
6886,0,6886,[228 194 357  50  97],694,5,30163,4.379700885726732,20.0,20.0
6887,0,6887,[  9 204 174 265 427],533,4,30167,4.379645760743322,0.0,20.0
6888,0,6888,[302 603 427 187 180],339,5,30172,4.379735810712731,20.0,0.0
6889,0,6889,[302 603 427 187 180],666,5,30177,4.379825834542816,20.0,0.0
6890,0,6890,[588 185 174 135 597],13,3,30180,4.379625598606879,0.0,20.0
6891,0,6891,[258 288 655  89 603],13,4,30184,4.379570516540917,20.0,0.0
6892,0,6892,[302 603 427 187 180],664,5,30189,4.379660525170463,20.0,0.0
6893,0,6893,[302 603 427 187 180],537,5,30194,4.379750507687844,20.0,0.0
6894,0,6894,[302 603 427 187 180],666,5,30199,4.379840464104423,20.0,0.0
6895,0,6895,[302 603 427 187 180],664,5,30204,4.379930394431555,20.0,0.0
6896,0,6896,[ 95 423 180 258   8],387,3,30207,4.3797303175293605,0.0,0.0
6897,0,6897,[237 176 234 180 210],95,1,30208,4.3792403595245,0.0,0.0
6898,0,6898,[302 603 427 187 180],90,5,30213,4.379330337730106,20.0,0.0
6899,0,6899,[302 603 427 187 180],666,5,30218,4.379420289855072,20.0,0.0
6900,0,6900,[496  11 238 237 588],184,4,30222,4.379365309375453,0.0,0.0
6901,0,6901,[405 196  15  69  97],95,4,30226,4.379310344827586,0.0,0.0
6902,0,6902,[302 603 427 187 180],458,5,30231,4.379400260756193,20.0,0.0
6903,0,6903,[  4 483  79 196 195],308,3,30234,4.379200463499421,20.0,0.0
6904,0,6904,[302 603 427 187 180],537,5,30239,4.37929036929761,20.0,0.0
6905,0,6905,[132 568 289  56  11],537,1,30240,4.378801042571677,0.0,0.0
6906,0,6906,[228 211  71  98   8],7,5,30245,4.37889098016505,0.0,20.0
6907,0,6907,[  4 181  22   1  50],650,2,30247,4.378546612623046,0.0,20.0
6908,0,6908,[302 603 427 187 180],90,5,30252,4.378636561007382,20.0,0.0
6909,0,6909,[302 603 427 187 180],537,5,30257,4.378726483357453,20.0,0.0
6910,0,6910,[144 318 238 127   1],308,4,30261,4.378671682824483,20.0,20.0
6911,0,6911,[302 603 427 187 180],271,5,30266,4.378761574074074,20.0,0.0
6912,0,6912,[302 603 427 187 180],13,5,30271,4.378851439317228,20.0,0.0
6913,0,6913,[302 603 427 187 180],13,5,30276,4.37894127856523,20.0,0.0
6914,0,6914,[195  25 132 135 168],85,3,30279,4.378741865509761,0.0,0.0
6915,0,6915,[302 603 427 187 180],339,5,30284,4.3788316946211685,20.0,0.0
6916,0,6916,[302 603 427 187 180],474,5,30289,4.378921497759144,20.0,0.0
6917,0,6917,[179  98 180 603  89],452,5,30294,4.379011274934952,20.0,20.0
6918,0,6918,[176 210 475 180 318],605,3,30297,4.378811967047261,20.0,0.0
6919,0,6919,[  7 182  69  89 222],774,2,30299,4.378468208092485,0.0,0.0
6920,0,6920,[302 603 427 187 180],271,5,30304,4.378558011847999,20.0,0.0
6921,0,6921,[302 603 427 187 180],339,5,30309,4.378647789656169,20.0,0.0
6922,0,6922,[302 603 427 187 180],90,5,30314,4.378737541528239,20.0,0.0
6923,0,6923,[ 12 273 144 172 302],883,5,30319,4.378827267475447,20.0,0.0
6924,0,6924,[302 603 427 187 180],664,5,30324,4.378916967509025,20.0,0.0
6925,0,6925,[302 603 427 187 180],458,5,30329,4.3790066416401965,20.0,0.0
6926,0,6926,[282 237 333   4 180],653,2,30331,4.378663201963332,0.0,0.0
6927,0,6927,[302 603 427 187 180],271,5,30336,4.378752886836028,20.0,0.0
6928,0,6928,[302 603 427 187 180],474,5,30341,4.378842545821908,20.0,0.0
6929,0,6929,[302 603 427 187 180],339,5,30346,4.378932178932179,20.0,0.0
6930,0,6930,[265 546 483 318  96],308,2,30348,4.378588948203722,40.0,0.0
6931,0,6931,[302 603 427 187 180],664,5,30353,4.37867859203693,20.0,0.0
6932,0,6932,[603 271  22 168  97],738,2,30355,4.378335496898889,20.0,0.0
6933,0,6933,[191  98 174 238 168],537,3,30358,4.378136717623305,0.0,40.0
6934,0,6934,[168  70  69 435 191],536,3,30361,4.377937995674117,0.0,0.0
6935,0,6935,[302 603 427 187 180],474,5,30366,4.3780276816609,20.0,0.0
6936,0,6936,[302 603 427 187 180],90,5,30371,4.378117341790399,20.0,0.0
6937,0,6937,[ 64 118  70 186 183],374,5,30376,4.3782069760737965,0.0,0.0
6938,0,6938,[302 603 427 187 180],537,5,30381,4.378296584522266,20.0,0.0
6939,0,6939,[234 216 385 515 228],234,2,30383,4.377953890489914,0.0,0.0
6940,0,6940,[302 603 427 187 180],13,5,30388,4.378043509580752,20.0,0.0
6941,0,6941,[302 603 427 187 180],474,5,30393,4.378133102852204,20.0,0.0
6942,0,6942,[302 603 427 187 180],666,5,30398,4.3782226703154254,20.0,0.0
6943,0,6943,[302 603 427 187 180],339,5,30403,4.378312211981567,20.0,0.0
6944,0,6944,[302 603 427 187 180],458,5,30408,4.378401727861771,20.0,0.0
6945,0,6945,[302 603 427 187 180],537,5,30413,4.378491217967175,20.0,0.0
6946,0,6946,[300 357 172 183 100],313,5,30418,4.37858068230891,20.0,20.0
6947,0,6947,[302 603 427 187 180],664,5,30423,4.3786701208981,20.0,0.0
6948,0,6948,[300 603 117 385 273],90,2,30425,4.37832781695208,20.0,0.0
6949,0,6949,[191 471   7 151 258],6,1,30426,4.377841726618705,0.0,0.0
6950,0,6950,[275 245 132 289   8],334,2,30428,4.377499640339519,0.0,0.0
6951,0,6951,[568 118 195 117 471],194,0,30428,4.37686996547756,0.0,0.0
6952,0,6952,[265  28   1  88 228],537,0,30428,4.376240471738818,0.0,0.0
6953,0,6953,[302 603 427 187 180],666,5,30433,4.376330169686511,20.0,0.0
6954,0,6954,[302 603 427 187 180],537,5,30438,4.376419841840403,20.0,0.0
6955,0,6955,[302 603 427 187 180],13,5,30443,4.376509488211616,20.0,0.0
6956,0,6956,[302 603 427 187 180],90,5,30448,4.376599108811269,20.0,0.0
6957,0,6957,[172 173 216 318 655],899,4,30452,4.3765449841908595,20.0,0.0
6958,0,6958,[403 174 185 181 176],313,4,30456,4.376490875125737,0.0,20.0
6959,0,6959,[275 268  11  12 496],537,3,30459,4.376293103448276,20.0,0.0
6960,0,6960,[302 603 427 187 180],664,5,30464,4.376382703634535,20.0,0.0
6961,0,6961,[ 28 568  12 135 265],13,4,30468,4.376328641195059,20.0,0.0
6962,0,6962,[302 603 427 187 180],666,5,30473,4.376418210541433,20.0,0.0
6963,0,6963,[302 603 427 187 180],339,5,30478,4.376507754164273,20.0,0.0
6964,0,6964,[302 603 427 187 180],13,5,30483,4.376597272074659,20.0,0.0
6965,0,6965,[132 100 385 135 238],524,3,30486,4.376399655469423,0.0,20.0
6966,0,6966,[302 603 427 187 180],13,5,30491,4.376489163197933,20.0,0.0
6967,0,6967,[302 603 427 187 180],90,5,30496,4.376578645235361,20.0,0.0
6968,0,6968,[302 603 427 187 180],474,5,30501,4.3766681015927675,20.0,0.0
6969,0,6969,[210  12 427  22 475],334,4,30505,4.37661406025825,20.0,0.0
6970,0,6970,[302 603 427 187 180],90,5,30510,4.376703485870033,20.0,0.0
6971,0,6971,[204 181  50 313 186],13,5,30515,4.376792885829031,0.0,20.0
6972,0,6972,[302 603 427 187 180],339,5,30520,4.376882260146279,20.0,0.0
6973,0,6973,[302 603 427 187 180],13,5,30525,4.3769716088328074,20.0,0.0
6974,0,6974,[ 96 127  25 318   8],313,3,30528,4.376774193548387,20.0,20.0
6975,0,6975,[302 603 427 187 180],458,5,30533,4.376863532110092,20.0,0.0
6976,0,6976,[151 288 471  89 322],374,3,30536,4.376666188906407,0.0,0.0
6977,0,6977,[  7 194 568 196 322],537,1,30537,4.376182287188306,0.0,0.0
6978,0,6978,[125 300 118  25 275],7,3,30540,4.375985098151598,0.0,0.0
6979,0,6979,[302 603 427 187 180],13,5,30545,4.376074498567335,20.0,0.0
6980,0,6980,[302 603 427 187 180],90,5,30550,4.376163873370578,20.0,0.0
6981,0,6981,[302 603 427 187 180],13,5,30555,4.376253222572329,20.0,0.0
6982,0,6982,[302 603 427 187 180],537,5,30560,4.376342546183588,20.0,0.0
6983,0,6983,[237 172 117 187 423],271,4,30564,4.376288659793815,0.0,0.0
6984,0,6984,[301 318 181 265 117],537,1,30565,4.375805297065139,20.0,0.0
6985,0,6985,[302 603 427 187 180],13,5,30570,4.375894646435729,20.0,0.0
6986,0,6986,[302 603 427 187 180],664,5,30575,4.375983970230428,20.0,0.0
6987,0,6987,[423 471  70 496 435],234,2,30577,4.375643961076131,0.0,0.0
6988,0,6988,[302 603 427 187 180],537,5,30582,4.375733295178137,20.0,0.0
6989,0,6989,[302 603 427 187 180],13,5,30587,4.375822603719599,20.0,0.0
6990,0,6990,[302 603 427 187 180],458,5,30592,4.375911886711486,20.0,0.0
6991,0,6991,[ 96 475 328 182 176],13,2,30594,4.375572082379863,0.0,0.0
6992,0,6992,[302 603 427 187 180],474,5,30599,4.375661375661376,20.0,0.0
6993,0,6993,[302 603 427 187 180],666,5,30604,4.375750643408636,20.0,0.0
6994,0,6994,[181 196 471 215 234],95,4,30608,4.375696926375983,0.0,0.0
6995,0,6995,[302 603 427 187 180],271,5,30613,4.3757861635220126,20.0,0.0
6996,0,6996,[302 603 427 187 180],13,5,30618,4.375875375160783,20.0,0.0
6997,0,6997,[302 603 427 187 180],474,5,30623,4.375964561303229,20.0,0.0
6998,0,6998,[302 603 427 187 180],271,5,30628,4.37605372196028,20.0,0.0
6999,0,6999,[238 655 258  15 222],474,5,30633,4.376142857142857,0.0,0.0
7000,0,7000,[257  95  96  22 121],279,3,30636,4.375946293386659,0.0,0.0
7001,0,7001,[302 603 427 187 180],458,5,30641,4.376035418451871,20.0,0.0
7002,0,7002,[302 603 427 187 180],474,5,30646,4.376124518063687,20.0,0.0
7003,0,7003,[302 603 427 187 180],90,5,30651,4.37621359223301,20.0,0.0
7004,0,7004,[301 216 195  22 678],145,4,30655,4.37615988579586,0.0,0.0
7005,0,7005,[302 603 427 187 180],666,5,30660,4.37624892948901,20.0,0.0
7006,0,7006,[302 603 427 187 180],666,5,30665,4.376337947766519,20.0,0.0
7007,0,7007,[302 603 427 187 180],537,5,30670,4.376426940639269,20.0,0.0
7008,0,7008,[302 603 427 187 180],339,5,30675,4.376515908118134,20.0,0.0
7009,0,7009,[ 82 174 187 151  22],804,4,30679,4.376462196861627,0.0,20.0
7010,0,7010,[186 423 258 196 197],263,4,30683,4.3764085009271145,0.0,0.0
7011,0,7011,[144 655 197  25  88],234,1,30684,4.37592698231603,0.0,0.0
7012,0,7012,[302 603 427 187 180],537,5,30689,4.376015970340796,20.0,0.0
7013,0,7013,[302 603 427 187 180],458,5,30694,4.3761049329911605,20.0,0.0
7014,0,7014,[302 603 427 187 180],664,5,30699,4.376193870277976,20.0,0.0
7015,0,7015,[302 603 427 187 180],474,5,30704,4.376282782212087,20.0,0.0
7016,0,7016,[302 603 427 187 180],666,5,30709,4.376371668804333,20.0,0.0
7017,0,7017,[194 111  79 282  96],207,3,30712,4.376175548589342,0.0,0.0
7018,0,7018,[302 603 427 187 180],537,5,30717,4.376264425131785,20.0,0.0
7019,0,7019,[328  11  50  82 211],653,3,30720,4.3760683760683765,0.0,20.0
7020,0,7020,[302 603 427 187 180],664,5,30725,4.37615724255804,20.0,0.0
7021,0,7021,[ 89 125 655 196 100],64,3,30728,4.375961264596981,0.0,20.0
7022,0,7022,[302 603 427 187 180],474,5,30733,4.376050121030898,20.0,0.0
7023,0,7023,[300 144  82 172 183],488,3,30736,4.375854214123007,0.0,0.0
7024,0,7024,[302 603 427 187 180],458,5,30741,4.375943060498221,20.0,0.0
7025,0,7025,[168 185 546 655 403],313,3,30744,4.375747224594364,0.0,0.0
7026,0,7026,[182 302 117 228 427],339,4,30748,4.37569375266828,0.0,0.0
7027,0,7027,[ 69 117  11 125 186],897,3,30751,4.375498007968128,0.0,0.0
7028,0,7028,[302 603 427 187 180],13,5,30756,4.375586854460094,20.0,0.0
7029,0,7029,[302 603 427 187 180],664,5,30761,4.375675675675676,20.0,0.0
7030,0,7030,[168 276 546 215 195],298,3,30764,4.375480017067273,0.0,0.0
7031,0,7031,[302 603 427 187 180],666,5,30769,4.375568828213879,20.0,0.0
7032,0,7032,[302 603 427 187 180],666,5,30774,4.3756576141049335,20.0,0.0
7033,0,7033,[127 357 153 168  71],488,3,30777,4.375462041512653,20.0,20.0
7034,0,7034,[302 603 427 187 180],666,5,30782,4.375550817341862,20.0,0.0
7035,0,7035,[302 603 427 187 180],90,5,30787,4.375639567936328,20.0,0.0
7036,0,7036,[302 603 427 187 180],271,5,30792,4.375728293306807,20.0,0.0
7037,0,7037,[117  12 202  96 294],308,3,30795,4.375532821824382,20.0,0.0
7038,0,7038,[118 228 151 194  79],82,1,30796,4.375053274612871,0.0,0.0
7039,0,7039,[302 603 427 187 180],666,5,30801,4.375142045454545,20.0,0.0
7040,0,7040,[161 185 385 210 118],694,5,30806,4.375230791080813,0.0,0.0
7041,0,7041,[302 603 427 187 180],666,5,30811,4.375319511502414,20.0,0.0
7042,0,7042,[302 603 427 187 180],474,5,30816,4.375408206730087,20.0,0.0
7043,0,7043,[302 603 427 187 180],90,5,30821,4.37549687677456,20.0,0.0
7044,0,7044,[302 603 427 187 180],271,5,30826,4.375585521646558,20.0,0.0
7045,0,7045,[483 181 328 176  22],537,1,30827,4.375106443372126,20.0,0.0
7046,0,7046,[302 603 427 187 180],664,5,30832,4.375195118490137,20.0,0.0
7047,0,7047,[302 603 427 187 180],664,5,30837,4.375283768444949,20.0,0.0
7048,0,7048,[302 603 427 187 180],271,5,30842,4.375372393247269,20.0,0.0
7049,0,7049,[302 603 427 187 180],271,5,30847,4.375460992907802,20.0,0.0
7050,0,7050,[151 515 210 603  79],650,2,30849,4.375124095872926,20.0,0.0
7051,0,7051,[302 603 427 187 180],474,5,30854,4.375212705615429,20.0,0.0
7052,0,7052,[302 603 427 187 180],664,5,30859,4.375301290231107,20.0,0.0
7053,0,7053,[546   7 275 118  64],524,2,30861,4.374964559115395,0.0,0.0
7054,0,7054,[302 603 427 187 180],474,5,30866,4.3750531537916375,20.0,0.0
7055,0,7055,[302 603 427 187 180],474,5,30871,4.375141723356009,20.0,0.0
7056,0,7056,[302 603 427 187 180],537,5,30876,4.375230267819187,20.0,0.0
7057,0,7057,[185   1 196 282  98],311,4,30880,4.375177103995466,0.0,20.0
7058,0,7058,[302 603 427 187 180],13,5,30885,4.375265618359541,20.0,0.0
7059,0,7059,[302 603 427 187 180],537,5,30890,4.375354107648725,20.0,0.0
7060,0,7060,[ 56 427 222 357 216],474,5,30895,4.3754425718736725,20.0,0.0
7061,0,7061,[302 603 427 187 180],474,5,30900,4.375531011045029,20.0,0.0
7062,0,7062,[302 603 427 187 180],458,5,30905,4.375619425173439,20.0,0.0
7063,0,7063,[135 475 385 121 151],537,2,30907,4.375283125707814,0.0,0.0
7064,0,7064,[302 603 427 187 180],90,5,30912,4.375371549893843,20.0,0.0
7065,0,7065,[302 603 427 187 180],339,5,30917,4.375459949051797,20.0,0.0
7066,0,7066,[302 603 427 187 180],537,5,30922,4.3755483231923025,20.0,0.0
7067,0,7067,[121 238 385  70 483],311,5,30927,4.375636672325976,20.0,0.0
7068,0,7068,[496  28 423 180 143],60,4,30931,4.37558353373886,0.0,0.0
7069,0,7069,[258 144 204 191  82],13,3,30934,4.375388967468175,0.0,0.0
7070,0,7070,[302 603 427 187 180],664,5,30939,4.375477301654645,20.0,0.0
7071,0,7071,[204 427 187  11 121],537,2,30941,4.375141402714932,0.0,0.0
7072,0,7072,[302 603 427 187 180],339,5,30946,4.3752297469249255,20.0,0.0
7073,0,7073,[302 603 427 187 180],458,5,30951,4.375318066157761,20.0,0.0
7074,0,7074,[302 603 427 187 180],13,5,30956,4.375406360424028,20.0,0.0
7075,0,7075,[302 603 427 187 180],271,5,30961,4.375494629734313,20.0,0.0
7076,0,7076,[435  64 403 121 423],64,4,30965,4.3754415712872685,0.0,0.0
7077,0,7077,[175  69 237 100 228],653,3,30968,4.375247244984459,0.0,20.0
7078,0,7078,[153 176  50  88 196],374,2,30970,4.374911710693601,0.0,20.0
7079,0,7079,[286 121 100  89   1],406,4,30974,4.374858757062147,0.0,20.0
7080,0,7080,[  4 228 182 435 174],234,1,30975,4.374382149413925,0.0,20.0
7081,0,7081,[ 28 515   8 235 132],200,4,30979,4.374329285512567,0.0,0.0
7082,0,7082,[302 603 427 187 180],537,5,30984,4.374417619652689,20.0,0.0
7083,0,7083,[185 194 211 258 135],537,4,30988,4.374364765669114,0.0,0.0
7084,0,7084,[204 588 385   9   8],13,3,30991,4.374170783345095,0.0,0.0
7085,0,7085,[235  12 183 181 289],833,3,30994,4.373976855771945,20.0,0.0
7086,0,7086,[483 405 180 282 423],458,3,30997,4.373782982926485,20.0,0.0
7087,0,7087,[302 603 427 187 180],271,5,31002,4.373871331828442,20.0,0.0
7088,0,7088,[302 603 427 187 180],664,5,31007,4.373959655804768,20.0,0.0
7089,0,7089,[302 603 427 187 180],339,5,31012,4.3740479548660085,20.0,0.0
7090,0,7090,[302 603 427 187 180],13,5,31017,4.374136229022705,20.0,0.0
7091,0,7091,[ 96 258 288  89 475],479,3,31020,4.373942470389171,0.0,0.0
7092,0,7092,[302 603 427 187 180],458,5,31025,4.374030734526999,20.0,0.0
7093,0,7093,[ 12 172 197 216 282],334,3,31028,4.373837045390471,20.0,0.0
7094,0,7094,[302 603 427 187 180],664,5,31033,4.373925299506695,20.0,0.0
7095,0,7095,[ 96 175  12 200  11],308,5,31038,4.37401352874859,20.0,0.0
7096,0,7096,[678 357  82 271  69],263,3,31041,4.373819923911512,20.0,0.0
7097,0,7097,[302 603 427 187 180],13,5,31046,4.373908143138912,20.0,0.0
7098,0,7098,[302 603 427 187 180],339,5,31051,4.373996337512326,20.0,0.0
7099,0,7099,[302 603 427 187 180],474,5,31056,4.374084507042253,20.0,0.0
7100,0,7100,[302 603 427 187 180],537,5,31061,4.374172651739191,20.0,0.0
7101,0,7101,[302 603 427 187 180],13,5,31066,4.37426077161363,20.0,0.0
7102,0,7102,[302 603 427 187 180],90,5,31071,4.374348866676052,20.0,0.0
7103,0,7103,[405 174 678 143  12],474,4,31075,4.374296171171171,20.0,20.0
7104,0,7104,[302 603 427 187 180],13,5,31080,4.374384236453202,20.0,0.0
7105,0,7105,[302 603 427 187 180],458,5,31085,4.374472276949057,20.0,0.0
7106,0,7106,[ 15 144   7 385 161],648,2,31087,4.374138173631631,0.0,0.0
7107,0,7107,[211 268   4 172  64],537,2,31089,4.373804164321891,0.0,0.0
7108,0,7108,[302 603 427 187 180],271,5,31094,4.373892249261499,20.0,0.0
7109,0,7109,[302 603 427 187 180],474,5,31099,4.373980309423348,20.0,0.0
7110,0,7110,[302 603 427 187 180],13,5,31104,4.374068344817887,20.0,0.0
7111,0,7111,[ 69  71  12  50 235],334,2,31106,4.373734533183352,20.0,20.0
7112,0,7112,[302 603 427 187 180],13,5,31111,4.373822578377618,20.0,0.0
7113,0,7113,[191  98   8  82   1],311,5,31116,4.373910598819229,0.0,20.0
7114,0,7114,[191 196 180 333 328],144,3,31119,4.373717498243148,0.0,0.0
7115,0,7115,[302 603 427 187 180],664,5,31124,4.37380550871276,20.0,0.0
7116,0,7116,[302 603 427 187 180],666,5,31129,4.373893494449908,20.0,0.0
7117,0,7117,[144  97 135 100 121],13,5,31134,4.373981455465018,0.0,20.0
7118,0,7118,[302 603 427 187 180],474,5,31139,4.374069391768507,20.0,0.0
7119,0,7119,[302 603 427 187 180],664,5,31144,4.374157303370787,20.0,0.0
7120,0,7120,[302 603 427 187 180],13,5,31149,4.374245190282264,20.0,0.0
7121,0,7121,[302 603 427 187 180],664,5,31154,4.374333052513339,20.0,0.0
7122,0,7122,[302 603 427 187 180],90,5,31159,4.374420890074407,20.0,0.0
7123,0,7123,[ 56 328 568 302  70],102,0,31159,4.373806850084223,0.0,0.0
7124,0,7124,[  4   7 546 135 742],524,2,31161,4.373473684210526,0.0,0.0
7125,0,7125,[302 603 427 187 180],13,5,31166,4.373561605388717,20.0,0.0
7126,0,7126,[144  50 182 185 187],650,1,31167,4.3730882559281605,0.0,20.0
7127,0,7127,[215 194 238 313 153],308,3,31170,4.372895622895623,0.0,0.0
7128,0,7128,[302 603 427 187 180],13,5,31175,4.372983588161032,20.0,0.0
7129,0,7129,[302 603 427 187 180],666,5,31180,4.373071528751753,20.0,0.0
7130,0,7130,[183 269  96 435  71],7,4,31184,4.37301921189174,0.0,0.0
7131,0,7131,[302 603 427 187 180],664,5,31189,4.3731071228266964,20.0,0.0
7132,0,7132,[302 603 427 187 180],13,5,31194,4.3731950091125755,20.0,0.0
7133,0,7133,[302 603 427 187 180],339,5,31199,4.373282870759742,20.0,0.0
7134,0,7134,[302 603 427 187 180],458,5,31204,4.373370707778556,20.0,0.0
7135,0,7135,[302 603 427 187 180],271,5,31209,4.373458520179372,20.0,0.0
7136,0,7136,[302 603 427 187 180],664,5,31214,4.373546307972537,20.0,0.0
7137,0,7137,[302 603 427 187 180],666,5,31219,4.373634071168395,20.0,0.0
7138,0,7138,[215 405 180  70 210],882,4,31223,4.373581734136434,0.0,0.0
7139,0,7139,[742  25  11 179 603],271,3,31226,4.3733893557422965,20.0,0.0
7140,0,7140,[302 603 427 187 180],664,5,31231,4.373477104047052,20.0,0.0
7141,0,7141,[302 603 427 187 180],458,5,31236,4.373564827779333,20.0,0.0
7142,0,7142,[176 300 173 121   7],537,2,31238,4.373232535349293,0.0,0.0
7143,0,7143,[237 194 143 289  11],537,0,31238,4.3726203807390815,0.0,0.0
7144,0,7144,[302 603 427 187 180],458,5,31243,4.372708187543737,20.0,0.0
7145,0,7145,[302 603 427 187 180],666,5,31248,4.3727959697733,20.0,0.0
7146,0,7146,[ 64 111 300   4 172],378,3,31251,4.3726038897439485,0.0,0.0
7147,0,7147,[302 603 427 187 180],537,5,31256,4.372691662003358,20.0,0.0
7148,0,7148,[302 603 427 187 180],474,5,31261,4.372779409707651,20.0,0.0
7149,0,7149,[234 210 183 194 271],13,3,31264,4.3725874125874125,0.0,0.0
7150,0,7150,[302 603 427 187 180],474,5,31269,4.372675150328625,20.0,0.0
7151,0,7151,[181 151 568 357 111],95,5,31274,4.372762863534676,20.0,0.0
7152,0,7152,[302 603 427 187 180],666,5,31279,4.372850552215853,20.0,0.0
7153,0,7153,[302 603 427 187 180],271,5,31284,4.372938216382443,20.0,0.0
7154,0,7154,[302 603 427 187 180],474,5,31289,4.373025856044724,20.0,0.0
7155,0,7155,[302 603 427 187 180],339,5,31294,4.373113471212968,20.0,0.0
7156,0,7156,[302 603 427 187 180],666,5,31299,4.373201061897443,20.0,0.0
7157,0,7157,[302 603 427 187 180],13,5,31304,4.37328862810841,20.0,0.0
7158,0,7158,[302 603 427 187 180],271,5,31309,4.373376169856125,20.0,0.0
7159,0,7159,[302 603 427 187 180],458,5,31314,4.373463687150838,20.0,0.0
7160,0,7160,[302 603 427 187 180],666,5,31319,4.373551180002793,20.0,0.0
7161,0,7161,[302 603 427 187 180],666,5,31324,4.3736386484222285,20.0,0.0
7162,0,7162,[302 603 427 187 180],474,5,31329,4.3737260924193775,20.0,0.0
7163,0,7163,[302 603 427 187 180],664,5,31334,4.3738135120044666,20.0,0.0
7164,0,7164,[302 603 427 187 180],90,5,31339,4.373900907187718,20.0,0.0
7165,0,7165,[302 603 427 187 180],271,5,31344,4.373988277979347,20.0,0.0
7166,0,7166,[204 197 144 238  28],215,3,31347,4.373796567601507,0.0,0.0
7167,0,7167,[302 603 427 187 180],537,5,31352,4.373883928571429,20.0,0.0
7168,0,7168,[302 603 427 187 180],90,5,31357,4.373971265169479,20.0,0.0
7169,0,7169,[302 603 427 187 180],90,5,31362,4.374058577405858,20.0,0.0
7170,0,7170,[258 357 313 483 100],380,5,31367,4.374145865290754,40.0,20.0
7171,0,7171,[302 603 427 187 180],664,5,31372,4.374233128834356,20.0,0.0
7172,0,7172,[302 603 427 187 180],666,5,31377,4.374320368046843,20.0,0.0
7173,0,7173,[302 603 427 187 180],537,5,31382,4.374407582938389,20.0,0.0
7174,0,7174,[302 603 427 187 180],90,5,31387,4.374494773519164,20.0,0.0
7175,0,7175,[435 144  82 265  98],13,4,31391,4.374442586399108,0.0,20.0
7176,0,7176,[302 603 427 187 180],90,5,31396,4.374529747805489,20.0,0.0
7177,0,7177,[301   9 496 210 328],378,2,31398,4.374198941209251,0.0,0.0
7178,0,7178,[302 603 427 187 180],664,5,31403,4.374286112271904,20.0,0.0
7179,0,7179,[175 210 288 385 216],537,1,31404,4.373816155988858,0.0,0.0
7180,0,7180,[302 603 427 187 180],458,5,31409,4.37390335607854,20.0,0.0
7181,0,7181,[302 603 427 187 180],339,5,31414,4.373990531885268,20.0,0.0
7182,0,7182,[302 603 427 187 180],339,5,31419,4.374077683419184,20.0,0.0
7183,0,7183,[302 603 427 187 180],271,5,31424,4.374164810690423,20.0,0.0
7184,0,7184,[181 357 275  50 175],14,4,31428,4.3741127348643,20.0,20.0
7185,0,7185,[302 603 427 187 180],474,5,31433,4.374199833008628,20.0,0.0
7186,0,7186,[302 603 427 187 180],90,5,31438,4.3742869069152635,20.0,0.0
7187,0,7187,[302 603 427 187 180],271,5,31443,4.374373956594324,20.0,0.0
7188,0,7188,[302   8 655 144 235],343,5,31448,4.374460982055918,0.0,0.0
7189,0,7189,[302 603 427 187 180],90,5,31453,4.374547983310153,20.0,0.0
7190,0,7190,[302 603 427 187 180],537,5,31458,4.374634960367126,20.0,0.0
7191,0,7191,[143 288 265   1 204],479,3,31461,4.374443826473859,0.0,0.0
7192,0,7192,[302 603 427 187 180],339,5,31466,4.374530793827332,20.0,0.0
7193,0,7193,[143 483 237 179 197],7,4,31470,4.374478732276898,20.0,0.0
7194,0,7194,[302 603 427 187 180],339,5,31475,4.374565670604587,20.0,0.0
7195,0,7195,[302 603 427 187 180],271,5,31480,4.374652584769316,20.0,0.0
7196,0,7196,[ 70 322 655 195  89],474,5,31485,4.374739474781159,0.0,0.0
7197,0,7197,[302 603 427 187 180],458,5,31490,4.374826340650181,20.0,0.0
7198,0,7198,[302 603 427 187 180],271,5,31495,4.374913182386442,20.0,0.0
7199,0,7199,[302 603 427 187 180],537,5,31500,4.375,20.0,0.0
7200,0,7200,[302 603 427 187 180],537,5,31505,4.375086793500903,20.0,0.0
7201,0,7201,[302 603 427 187 180],13,5,31510,4.375173562899195,20.0,0.0
7202,0,7202,[302 603 427 187 180],271,5,31515,4.375260308204915,20.0,0.0
7203,0,7203,[748 183 568  50 322],313,3,31518,4.375069405885619,0.0,20.0
7204,0,7204,[302 603 427 187 180],339,5,31523,4.375156141568356,20.0,0.0
7205,0,7205,[302 603 427 187 180],458,5,31528,4.375242853177907,20.0,0.0
7206,0,7206,[302 603 427 187 180],474,5,31533,4.375329540724296,20.0,0.0
7207,0,7207,[302 603 427 187 180],474,5,31538,4.375416204217536,20.0,0.0
7208,0,7208,[302 603 427 187 180],537,5,31543,4.375502843667638,20.0,0.0
7209,0,7209,[302 603 427 187 180],458,5,31548,4.375589459084605,20.0,0.0
7210,0,7210,[  9 179 180 215 678],749,3,31551,4.375398696436001,0.0,0.0
7211,0,7211,[ 50 176 405 200 222],488,3,31554,4.375207986688852,0.0,20.0
7212,0,7212,[302 603 427 187 180],474,5,31559,4.375294606959656,20.0,0.0
7213,0,7213,[302 603 427 187 180],474,5,31564,4.375381203215969,20.0,0.0
7214,0,7214,[302 603 427 187 180],271,5,31569,4.375467775467776,20.0,0.0
7215,0,7215,[302 603 427 187 180],537,5,31574,4.375554323725056,20.0,0.0
7216,0,7216,[302 603 427 187 180],458,5,31579,4.375640847997783,20.0,0.0
7217,0,7217,[204  88 153  79 276],378,5,31584,4.375727348295927,0.0,0.0
7218,0,7218,[168 186  89 288 172],833,2,31586,4.375398254605901,0.0,0.0
7219,0,7219,[302 603 427 187 180],458,5,31591,4.375484764542937,20.0,0.0
7220,0,7220,[302 603 427 187 180],537,5,31596,4.375571250519319,20.0,0.0
7221,0,7221,[ 11 597 323 318 282],374,3,31599,4.375380780947106,20.0,0.0
7222,0,7222,[302 603 427 187 180],90,5,31604,4.375467257372283,20.0,0.0
7223,0,7223,[302 603 427 187 180],90,5,31609,4.375553709856035,20.0,0.0
7224,0,7224,[302 603 427 187 180],458,5,31614,4.375640138408304,20.0,0.0
7225,0,7225,[135 483 161 423  12],328,4,31618,4.375588153888735,40.0,0.0
7226,0,7226,[202 234  22 245 168],313,2,31620,4.3752594437525945,0.0,0.0
7227,0,7227,[302 603 427 187 180],458,5,31625,4.375345877144438,20.0,0.0
7228,0,7228,[302 603 427 187 180],90,5,31630,4.375432286623322,20.0,0.0
7229,0,7229,[302 603 427 187 180],339,5,31635,4.375518672199171,20.0,0.0
7230,0,7230,[302 603 427 187 180],90,5,31640,4.3756050338818975,20.0,0.0
7231,0,7231,[ 79 294  64 202 135],749,4,31644,4.375553097345133,0.0,0.0
7232,0,7232,[118   1 328 258 235],294,2,31646,4.3752246647310935,0.0,0.0
7233,0,7233,[302 603 427 187 180],537,5,31651,4.375311031241361,20.0,0.0
7234,0,7234,[302 603 427 187 180],458,5,31656,4.375397373876987,20.0,0.0
7235,0,7235,[302 603 427 187 180],271,5,31661,4.3754836926478715,20.0,0.0
7236,0,7236,[302 603 427 187 180],458,5,31666,4.375569987563908,20.0,0.0
7237,0,7237,[302 603 427 187 180],13,5,31671,4.375656258634982,20.0,0.0
7238,0,7238,[748 153  70  56 328],328,3,31674,4.37546622461666,0.0,0.0
7239,0,7239,[302 603 427 187 180],458,5,31679,4.375552486187845,20.0,0.0
7240,0,7240,[302 603 427 187 180],13,5,31684,4.375638723933158,20.0,0.0
7241,0,7241,[302 603 427 187 180],666,5,31689,4.3757249378624685,20.0,0.0
7242,0,7242,[ 82 204  28 183  98],334,4,31693,4.3756730636476595,0.0,20.0
7243,0,7243,[302 603 427 187 180],339,5,31698,4.375759249033683,20.0,0.0
7244,0,7244,[302 603 427 187 180],458,5,31703,4.37584541062802,20.0,0.0
7245,0,7245,[302 603 427 187 180],458,5,31708,4.375931548440519,20.0,0.0
7246,0,7246,[302 603 427 187 180],339,5,31713,4.3760176624810265,20.0,0.0
7247,0,7247,[302 603 427 187 180],13,5,31718,4.376103752759382,20.0,0.0
7248,0,7248,[302 603 427 187 180],458,5,31723,4.376189819285418,20.0,0.0
7249,0,7249,[151  56 515 195 238],650,3,31726,4.376,0.0,0.0
7250,0,7250,[302 603 427 187 180],90,5,31731,4.376086057095573,20.0,0.0
7251,0,7251,[423  96 174 210  70],13,3,31734,4.375896304467733,0.0,20.0
7252,0,7252,[302 603 427 187 180],458,5,31739,4.375982352130153,20.0,0.0
7253,0,7253,[216  79 191 282 200],378,4,31743,4.375930521091812,0.0,0.0
7254,0,7254,[302 603 427 187 180],666,5,31748,4.376016540317023,20.0,0.0
7255,0,7255,[302 603 427 187 180],458,5,31753,4.376102535832414,20.0,0.0
7256,0,7256,[302 603 427 187 180],13,5,31758,4.376188507647789,20.0,0.0
7257,0,7257,[302 603 427 187 180],474,5,31763,4.37627445577294,20.0,0.0
7258,0,7258,[302 603 427 187 180],474,5,31768,4.376360380217661,20.0,0.0
7259,0,7259,[302 603 427 187 180],537,5,31773,4.376446280991735,20.0,0.0
7260,0,7260,[117 210  97 211  15],313,4,31777,4.376394436028096,0.0,0.0
7261,0,7261,[222 195 127 403 196],653,2,31779,4.3760671991187,0.0,20.0
7262,0,7262,[302 603 427 187 180],339,5,31784,4.37615310477764,20.0,0.0
7263,0,7263,[302 603 427 187 180],474,5,31789,4.376238986784141,20.0,0.0
7264,0,7264,[655 323   4 176  69],59,5,31794,4.37632484514797,0.0,0.0
7265,0,7265,[ 96   7  64 216 515],892,5,31799,4.376410679878888,0.0,0.0
7266,0,7266,[302 603 427 187 180],458,5,31804,4.376496490986652,20.0,0.0
7267,0,7267,[302 603 427 187 180],90,5,31809,4.3765822784810124,20.0,0.0
7268,0,7268,[302 603 427 187 180],664,5,31814,4.3766680423717155,20.0,0.0
7269,0,7269,[302 603 427 187 180],271,5,31819,4.376753782668501,20.0,0.0
7270,0,7270,[302 603 427 187 180],13,5,31824,4.376839499381103,20.0,0.0
7271,0,7271,[174  79 187 288 127],804,3,31827,4.3766501650165015,0.0,40.0
7272,0,7272,[302 603 427 187 180],271,5,31832,4.376735872404785,20.0,0.0
7273,0,7273,[302 603 427 187 180],339,5,31837,4.37682155622766,20.0,0.0
7274,0,7274,[ 56 191 328 168 180],85,4,31841,4.3767697594501715,0.0,0.0
7275,0,7275,[302 603 427 187 180],339,5,31846,4.376855415063222,20.0,0.0
7276,0,7276,[ 28 172 265  82  50],42,4,31850,4.376803627868627,0.0,20.0
7277,0,7277,[161   1 318   8 286],194,3,31853,4.376614454520473,20.0,0.0
7278,0,7278,[301 318 174 742   7],458,3,31856,4.376425333150158,20.0,20.0
7279,0,7279,[174 546  70 151  15],447,1,31857,4.375961538461539,0.0,20.0
7280,0,7280,[302 603 427 187 180],458,5,31862,4.376047246257382,20.0,0.0
7281,0,7281,[302 603 427 187 180],474,5,31867,4.376132930513595,20.0,0.0
7282,0,7282,[302 603 427 187 180],664,5,31872,4.376218591239874,20.0,0.0
7283,0,7283,[302 603 427 187 180],13,5,31877,4.376304228445909,20.0,0.0
7284,0,7284,[302 603 427 187 180],537,5,31882,4.3763898421413865,20.0,0.0
7285,0,7285,[302 603 427 187 180],664,5,31887,4.376475432335987,20.0,0.0
7286,0,7286,[ 98 210 238 286 204],379,5,31892,4.376560999039385,0.0,20.0
7287,0,7287,[302 603 427 187 180],537,5,31897,4.376646542261251,20.0,0.0
7288,0,7288,[ 79 235 202   4  96],738,3,31900,4.3764576759500615,0.0,0.0
7289,0,7289,[302 603 427 187 180],537,5,31905,4.3765432098765435,20.0,0.0
7290,0,7290,[302 603 427 187 180],90,5,31910,4.376628720340145,20.0,0.0
7291,0,7291,[302 603 427 187 180],474,5,31915,4.376714207350521,20.0,0.0
7292,0,7292,[546 318 175  11 323],378,2,31917,4.376388317564788,20.0,0.0
7293,0,7293,[597 143 322 173 100],13,1,31918,4.375925418151906,0.0,20.0
7294,0,7294,[182 153 180 118 200],7,4,31922,4.375873886223441,0.0,0.0
7295,0,7295,[302 603 427 187 180],458,5,31927,4.375959429824562,20.0,0.0
7296,0,7296,[143  96 182   4 265],524,4,31931,4.375907907359188,0.0,0.0
7297,0,7297,[515 216  25 173 183],666,3,31934,4.37571937517128,0.0,0.0
7298,0,7298,[ 25 135  95 289 180],406,3,31937,4.375530894643102,0.0,0.0
7299,0,7299,[302 603 427 187 180],271,5,31942,4.375616438356165,20.0,0.0
7300,0,7300,[302 603 427 187 180],458,5,31947,4.375701958635803,20.0,0.0
7301,0,7301,[302 603 427 187 180],339,5,31952,4.375787455491646,20.0,0.0
7302,0,7302,[276 475 151  15  98],474,4,31956,4.37573599890456,0.0,20.0
7303,0,7303,[302 603 427 187 180],90,5,31961,4.3758214676889375,20.0,0.0
7304,0,7304,[302 603 427 187 180],13,5,31966,4.375906913073237,20.0,0.0
7305,0,7305,[302 603 427 187 180],13,5,31971,4.375992335067068,20.0,0.0
7306,0,7306,[ 28 144 748 678 568],488,2,31973,4.375667168468592,0.0,0.0
7307,0,7307,[302 603 427 187 180],474,5,31978,4.375752599890531,20.0,0.0
7308,0,7308,[161 471  89 508  70],455,3,31981,4.375564372691203,0.0,0.0
7309,0,7309,[302 603 427 187 180],13,5,31986,4.3756497948016415,20.0,0.0
7310,0,7310,[302 603 427 187 180],90,5,31991,4.375735193543975,20.0,0.0
7311,0,7311,[111 175 195  11 200],666,3,31994,4.37554704595186,0.0,0.0
7312,0,7312,[228  71 597 195 151],59,3,31997,4.375358949815397,0.0,0.0
7313,0,7313,[568  25  64 222 204],899,4,32001,4.375307629204266,0.0,0.0
7314,0,7314,[302 603 427 187 180],339,5,32006,4.375393028024607,20.0,0.0
7315,0,7315,[302 603 427 187 180],271,5,32011,4.37547840349918,20.0,0.0
7316,0,7316,[143 215 144 151 210],298,4,32015,4.375427087604209,0.0,0.0
7317,0,7317,[174  15 265  79  98],311,5,32020,4.375512435091555,0.0,40.0
7318,0,7318,[302 603 427 187 180],13,5,32025,4.3755977592567294,20.0,0.0
7319,0,7319,[302 603 427 187 180],339,5,32030,4.3756830601092895,20.0,0.0
7320,0,7320,[597 179  12 100 196],7,4,32034,4.375631744297227,20.0,20.0
7321,0,7321,[302 603 427 187 180],666,5,32039,4.375717017208413,20.0,0.0
7322,0,7322,[302 603 427 187 180],90,5,32044,4.375802266830534,20.0,0.0
7323,0,7323,[194 257 568  12 143],385,0,32044,4.3752048061168765,20.0,0.0
7324,0,7324,[302 603 427 187 180],339,5,32049,4.375290102389078,20.0,0.0
7325,0,7325,[471 182 483 118  22],328,2,32051,4.374965874965875,20.0,0.0
7326,0,7326,[ 56 183 237   8 176],215,4,32055,4.3749146990582775,0.0,0.0
7327,0,7327,[ 11 175 161 234  12],7,3,32058,4.374727074235808,20.0,0.0
7328,0,7328,[302 603 427 187 180],537,5,32063,4.374812389139037,20.0,0.0
7329,0,7329,[302 603 427 187 180],458,5,32068,4.374897680763984,20.0,0.0
7330,0,7330,[427 273  97 483 234],234,3,32071,4.374710135042968,20.0,0.0
7331,0,7331,[302 603 427 187 180],339,5,32076,4.374795417348609,20.0,0.0
7332,0,7332,[302 603 427 187 180],474,5,32081,4.3748806763943815,20.0,0.0
7333,0,7333,[302 603 427 187 180],474,5,32086,4.374965912189801,20.0,0.0
7334,0,7334,[302 603 427 187 180],339,5,32091,4.375051124744377,20.0,0.0
7335,0,7335,[302 603 427 187 180],474,5,32096,4.375136314067611,20.0,0.0
7336,0,7336,[483 202  64  95 180],263,5,32101,4.375221480169007,20.0,0.0
7337,0,7337,[302 603 427 187 180],666,5,32106,4.375306623058054,20.0,0.0
7338,0,7338,[176 215 294 194 175],406,3,32109,4.375119226052596,0.0,0.0
7339,0,7339,[302 603 427 187 180],339,5,32114,4.375204359673025,20.0,0.0
7340,0,7340,[302 603 427 187 180],474,5,32119,4.375289470099442,20.0,0.0
7341,0,7341,[302 603 427 187 180],271,5,32124,4.375374557341324,20.0,0.0
7342,0,7342,[ 96 597 191 405   1],95,3,32127,4.375187253166281,0.0,0.0
7343,0,7343,[302 603 427 187 180],90,5,32132,4.375272331154684,20.0,0.0
7344,0,7344,[302 603 427 187 180],666,5,32137,4.375357385976855,20.0,0.0
7345,0,7345,[302 603 427 187 180],666,5,32142,4.375442417642255,20.0,0.0
7346,0,7346,[302  79 328 222 269],877,2,32144,4.375119096229754,0.0,0.0
7347,0,7347,[276 181 228 121 286],339,4,32148,4.375068045726729,0.0,0.0
7348,0,7348,[302 603 427 187 180],271,5,32153,4.3751530820519795,20.0,0.0
7349,0,7349,[183  82  79 187 222],13,2,32155,4.374829931972789,0.0,0.0
7350,0,7350,[302 603 427 187 180],537,5,32160,4.3749149775540745,20.0,0.0
7351,0,7351,[302 603 427 187 180],90,5,32165,4.375,20.0,0.0
7352,0,7352,[302 603 427 187 180],664,5,32170,4.375084999320006,20.0,0.0
7353,0,7353,[211 181  97  89  69],59,5,32175,4.375169975523525,0.0,0.0
7354,0,7354,[302 603 427 187 180],271,5,32180,4.375254928619986,20.0,0.0
7355,0,7355,[302 603 427 187 180],271,5,32185,4.375339858618815,20.0,0.0
7356,0,7356,[276 515 180 269 143],339,5,32190,4.375424765529428,0.0,0.0
7357,0,7357,[302 603 427 187 180],458,5,32195,4.3755096493612395,20.0,0.0
7358,0,7358,[234 282 294 168 322],474,3,32198,4.375322734067129,0.0,0.0
7359,0,7359,[302 603 427 187 180],474,5,32203,4.375407608695652,20.0,0.0
7360,0,7360,[302 603 427 187 180],458,5,32208,4.375492460263551,20.0,0.0
7361,0,7361,[302 603 427 187 180],458,5,32213,4.375577288780223,20.0,0.0
7362,0,7362,[302 603 427 187 180],90,5,32218,4.375662094255059,20.0,0.0
7363,0,7363,[655  69  82  71 289],488,2,32220,4.3753394894079305,0.0,0.0
7364,0,7364,[302 603 427 187 180],339,5,32225,4.375424304141208,20.0,0.0
7365,0,7365,[302 603 427 187 180],271,5,32230,4.375509095845778,20.0,0.0
7366,0,7366,[282 143 215 313 603],474,5,32235,4.375593864531017,20.0,0.0
7367,0,7367,[302 603 427 187 180],271,5,32240,4.375678610206298,20.0,0.0
7368,0,7368,[302 603 427 187 180],271,5,32245,4.375763332880988,20.0,0.0
7369,0,7369,[597 234 286 216 111],59,3,32248,4.375576662143827,0.0,0.0
7370,0,7370,[179 117  82 385  95],479,2,32250,4.375254375254375,0.0,0.0
7371,0,7371,[302 603 427 187 180],666,5,32255,4.3753391209983725,20.0,0.0
7372,0,7372,[302 603 427 187 180],537,5,32260,4.3754238437542385,20.0,0.0
7373,0,7373,[302 603 427 187 180],666,5,32265,4.375508543531327,20.0,0.0
7374,0,7374,[302 603 427 187 180],664,5,32270,4.375593220338983,20.0,0.0
7375,0,7375,[302 603 427 187 180],474,5,32275,4.375677874186551,20.0,0.0
7376,0,7376,[302 603 427 187 180],537,5,32280,4.375762505083367,20.0,0.0
7377,0,7377,[302 603 427 187 180],537,5,32285,4.3758471130387635,20.0,0.0
7378,0,7378,[302 603 427 187 180],339,5,32290,4.375931698062068,20.0,0.0
7379,0,7379,[302 603 427 187 180],474,5,32295,4.376016260162602,20.0,0.0
7380,0,7380,[ 97   1  70 183   4],881,2,32297,4.37569435035903,0.0,0.0
7381,0,7381,[302 603 427 187 180],90,5,32302,4.375778921701436,20.0,0.0
7382,0,7382,[ 69 483 288 151  70],892,5,32307,4.3758634701340915,20.0,0.0
7383,0,7383,[302 603 427 187 180],13,5,32312,4.375947995666306,20.0,0.0
7384,0,7384,[302 603 427 187 180],666,5,32317,4.37603249830738,20.0,0.0
7385,0,7385,[302 603 427 187 180],13,5,32322,4.376116978066612,20.0,0.0
7386,0,7386,[286  71 427 197 194],7,5,32327,4.3762014349532965,0.0,0.0
7387,0,7387,[302 603 427 187 180],13,5,32332,4.376285868976719,20.0,0.0
7388,0,7388,[302 603 427 187 180],13,5,32337,4.376370280146163,20.0,0.0
7389,0,7389,[302 603 427 187 180],664,5,32342,4.376454668470907,20.0,0.0
7390,0,7390,[302 603 427 187 180],90,5,32347,4.3765390339602215,20.0,0.0
7391,0,7391,[302 603 427 187 180],271,5,32352,4.376623376623376,20.0,0.0
7392,0,7392,[302 603 427 187 180],271,5,32357,4.376707696469634,20.0,0.0
7393,0,7393,[302 603 427 187 180],458,5,32362,4.37679199350825,20.0,0.0
7394,0,7394,[302 603 427 187 180],90,5,32367,4.376876267748479,20.0,0.0
7395,0,7395,[211  69 435 385 153],883,3,32370,4.376690102758248,0.0,0.0
7396,0,7396,[  9 180 237 357 182],271,4,32374,4.376639178045154,20.0,0.0
7397,0,7397,[275  69 435  97 603],271,5,32379,4.376723438767234,20.0,0.0
7398,0,7398,[302 603 427 187 180],537,5,32384,4.376807676713069,20.0,0.0
7399,0,7399,[  8 144 435 222  71],378,4,32388,4.376756756756757,0.0,0.0
7400,0,7400,[302 603 427 187 180],458,5,32393,4.3768409674368325,20.0,0.0
7401,0,7401,[302 603 427 187 180],666,5,32398,4.376925155363415,20.0,0.0
7402,0,7402,[302 603 427 187 180],90,5,32403,4.377009320545724,20.0,0.0
7403,0,7403,[302 603 427 187 180],339,5,32408,4.377093462992977,20.0,0.0
7404,0,7404,[238 568 265  50   1],881,3,32411,4.376907494935854,0.0,20.0
7405,0,7405,[302 603 427 187 180],474,5,32416,4.376991628409398,20.0,0.0
7406,0,7406,[174 282  97   9 187],194,3,32419,4.3768057243148375,0.0,20.0
7407,0,7407,[302 603 427 187 180],537,5,32424,4.376889848812095,20.0,0.0
7408,0,7408,[302 603 427 187 180],474,5,32429,4.376973950600621,20.0,0.0
7409,0,7409,[302 603 427 187 180],90,5,32434,4.377058029689609,20.0,0.0
7410,0,7410,[273  12  64 176 268],234,1,32435,4.376602347861287,20.0,0.0
7411,0,7411,[302 603 427 187 180],90,5,32440,4.376686454398273,20.0,0.0
7412,0,7412,[302 603 427 187 180],664,5,32445,4.376770538243626,20.0,0.0
7413,0,7413,[496 151 282 183 405],479,4,32449,4.37671971944969,0.0,0.0
7414,0,7414,[ 12 323 117 222 235],13,1,32450,4.37626432906271,20.0,0.0
7415,0,7415,[302 603 427 187 180],339,5,32455,4.376348435814455,20.0,0.0
7416,0,7416,[302 603 427 187 180],666,5,32460,4.376432519886746,20.0,0.0
7417,0,7417,[273 176  15 121 300],378,5,32465,4.376516581288757,0.0,0.0
7418,0,7418,[655 194 143 403  71],7,4,32469,4.376465830974525,0.0,0.0
7419,0,7419,[302 603 427 187 180],458,5,32474,4.37654986522911,20.0,0.0
7420,0,7420,[302 603 427 187 180],90,5,32479,4.376633876836006,20.0,0.0
7421,0,7421,[302 603 427 187 180],271,5,32484,4.376717865804365,20.0,0.0
7422,0,7422,[678 191 405  15  79],455,2,32486,4.376397682877543,0.0,0.0
7423,0,7423,[302 603 427 187 180],664,5,32491,4.376481681034483,20.0,0.0
7424,0,7424,[204  89 282   7 300],334,4,32495,4.376430976430976,0.0,0.0
7425,0,7425,[302 603 427 187 180],13,5,32500,4.37651494748182,20.0,0.0
7426,0,7426,[302 603 427 187 180],474,5,32505,4.37659889592029,20.0,0.0
7427,0,7427,[275 185 496 210 328],271,3,32508,4.376413570274637,0.0,0.0
7428,0,7428,[187 655 471 117 318],144,5,32513,4.376497509759052,20.0,0.0
7429,0,7429,[302 603 427 187 180],474,5,32518,4.3765814266487215,20.0,0.0
7430,0,7430,[302 603 427 187 180],458,5,32523,4.376665320952766,20.0,0.0
7431,0,7431,[302 603 427 187 180],537,5,32528,4.376749192680301,20.0,0.0
7432,0,7432,[210  97 151 483 568],313,4,32532,4.3766985066594914,20.0,0.0
7433,0,7433,[603 151 265 427 300],666,2,32534,4.376378800107614,20.0,0.0
7434,0,7434,[302 603 427 187 180],339,5,32539,4.376462676529926,20.0,0.0
7435,0,7435,[302 603 427 187 180],339,5,32544,4.376546530392684,20.0,0.0
7436,0,7436,[302 603 427 187 180],458,5,32549,4.376630361704988,20.0,0.0
7437,0,7437,[302 603 427 187 180],458,5,32554,4.3767141704759345,20.0,0.0
7438,0,7438,[204  64 228  69 176],374,5,32559,4.376797956714612,0.0,0.0
7439,0,7439,[302 603 427 187 180],537,5,32564,4.376881720430108,20.0,0.0
7440,0,7440,[302 603 427 187 180],13,5,32569,4.376965461631501,20.0,0.0
7441,0,7441,[302 603 427 187 180],271,5,32574,4.377049180327869,20.0,0.0
7442,0,7442,[302 603 427 187 180],474,5,32579,4.3771328765282815,20.0,0.0
7443,0,7443,[302 603 427 187 180],458,5,32584,4.377216550241806,20.0,0.0
7444,0,7444,[302 603 427 187 180],666,5,32589,4.377300201477501,20.0,0.0
7445,0,7445,[302 603 427 187 180],13,5,32594,4.377383830244426,20.0,0.0
7446,0,7446,[302 603 427 187 180],271,5,32599,4.3774674365516315,20.0,0.0
7447,0,7447,[302 603 427 187 180],339,5,32604,4.377551020408164,20.0,0.0
7448,0,7448,[302 603 427 187 180],664,5,32609,4.377634581823063,20.0,0.0
7449,0,7449,[ 71 265 286 496 211],82,5,32614,4.377718120805369,0.0,0.0
7450,0,7450,[302 603 427 187 180],13,5,32619,4.377801637364112,20.0,0.0
7451,0,7451,[302 603 427 187 180],90,5,32624,4.37788513150832,20.0,0.0
7452,0,7452,[302 603 427 187 180],13,5,32629,4.377968603247014,20.0,0.0
7453,0,7453,[302 603 427 187 180],271,5,32634,4.378052052589214,20.0,0.0
7454,0,7454,[302 603 427 187 180],458,5,32639,4.37813547954393,20.0,0.0
7455,0,7455,[302 603 427 187 180],664,5,32644,4.378218884120171,20.0,0.0
7456,0,7456,[191   1 186 179 328],378,2,32646,4.377899959769344,0.0,0.0
7457,0,7457,[302 603 427 187 180],90,5,32651,4.377983373558595,20.0,0.0
7458,0,7458,[302 603 427 187 180],537,5,32656,4.378066764981901,20.0,0.0
7459,0,7459,[302 603 427 187 180],458,5,32661,4.378150134048258,20.0,0.0
7460,0,7460,[678 588 185 237 194],7,4,32665,4.3780994504758075,0.0,0.0
7461,0,7461,[302 603 427 187 180],474,5,32670,4.378182792816939,20.0,0.0
7462,0,7462,[302 603 427 187 180],474,5,32675,4.378266112823262,20.0,0.0
7463,0,7463,[183  12  69  28 204],59,5,32680,4.378349410503751,20.0,0.0
7464,0,7464,[302 603 427 187 180],458,5,32685,4.378432685867381,20.0,0.0
7465,0,7465,[ 88 127 210 234 195],774,1,32686,4.3779801768015005,0.0,20.0
7466,0,7466,[302 603 427 187 180],664,5,32691,4.37806347930896,20.0,0.0
7467,0,7467,[302 603 427 187 180],271,5,32696,4.3781467595072305,20.0,0.0
7468,0,7468,[302 603 427 187 180],13,5,32701,4.378230017405275,20.0,0.0
7469,0,7469,[302 603 427 187 180],271,5,32706,4.378313253012048,20.0,0.0
7470,0,7470,[ 69 183 483  79 176],200,5,32711,4.378396466336501,20.0,0.0
7471,0,7471,[302 603 427 187 180],90,5,32716,4.37847965738758,20.0,0.0
7472,0,7472,[183 405 194 748 237],64,3,32719,4.378295196039074,0.0,0.0
7473,0,7473,[302 603 427 187 180],474,5,32724,4.378378378378378,20.0,0.0
7474,0,7474,[302 603 427 187 180],664,5,32729,4.378461538461538,20.0,0.0
7475,0,7475,[302 603 427 187 180],664,5,32734,4.378544676297485,20.0,0.0
7476,0,7476,[302 603 427 187 180],339,5,32739,4.378627791895145,20.0,0.0
7477,0,7477,[302 603 427 187 180],666,5,32744,4.378710885263439,20.0,0.0
7478,0,7478,[302 603 427 187 180],13,5,32749,4.378793956411285,20.0,0.0
7479,0,7479,[ 50 273 286 173 187],59,3,32752,4.3786096256684495,0.0,20.0
7480,0,7480,[118 161  71 100 313],59,3,32755,4.37842534420532,0.0,20.0
7481,0,7481,[ 71 197  96 275 181],378,4,32759,4.37837476610532,0.0,0.0
7482,0,7482,[302 603 427 187 180],271,5,32764,4.378457837765602,20.0,0.0
7483,0,7483,[302 603 427 187 180],339,5,32769,4.378540887226082,20.0,0.0
7484,0,7484,[302 603 427 187 180],664,5,32774,4.378623914495658,20.0,0.0
7485,0,7485,[423 180  12 313  11],328,4,32778,4.378573336895538,20.0,0.0
7486,0,7486,[ 89 196 144  12 135],13,5,32783,4.37865633765193,20.0,0.0
7487,0,7487,[302 603 427 187 180],271,5,32788,4.378739316239316,20.0,0.0
7488,0,7488,[302 603 427 187 180],664,5,32793,4.378822272666578,20.0,0.0
7489,0,7489,[181 185 153 294 403],648,4,32797,4.378771695594126,0.0,0.0
7490,0,7490,[302 603 427 187 180],664,5,32802,4.378854625550661,20.0,0.0
7491,0,7491,[ 25 318  69   4 121],474,5,32807,4.378937533368926,20.0,0.0
7492,0,7492,[302 603 427 187 180],537,5,32812,4.379020419057787,20.0,0.0
7493,0,7493,[302 603 427 187 180],339,5,32817,4.379103282626101,20.0,0.0
7494,0,7494,[302 603 427 187 180],458,5,32822,4.379186124082722,20.0,0.0
7495,0,7495,[173 180  69 678 228],648,2,32824,4.378868729989327,0.0,0.0
7496,0,7496,[302 603 427 187 180],90,5,32829,4.378951580632253,20.0,0.0
7497,0,7497,[302 603 427 187 180],13,5,32834,4.37903440917578,20.0,0.0
7498,0,7498,[181 172 235  89 118],882,4,32838,4.378983864515269,0.0,0.0
7499,0,7499,[302 603 427 187 180],474,5,32843,4.379066666666667,20.0,0.0
7500,0,7500,[302 603 427 187 180],664,5,32848,4.379149446740435,20.0,0.0
7501,0,7501,[302 603 427 187 180],664,5,32853,4.379232204745401,20.0,0.0
7502,0,7502,[302 603 427 187 180],664,5,32858,4.37931494069039,20.0,0.0
7503,0,7503,[742  82 179  25 121],881,4,32862,4.379264392324094,0.0,0.0
7504,0,7504,[132 151  79  96 153],447,3,32865,4.379080612924717,0.0,0.0
7505,0,7505,[302 603 427 187 180],474,5,32870,4.379163335997869,20.0,0.0
7506,0,7506,[515 228  69 483 183],311,5,32875,4.379246037032104,20.0,0.0
7507,0,7507,[302 603 427 187 180],666,5,32880,4.379328716036228,20.0,0.0
7508,0,7508,[302 603 427 187 180],339,5,32885,4.379411373019043,20.0,0.0
7509,0,7509,[302 603 427 187 180],537,5,32890,4.379494007989347,20.0,0.0
7510,0,7510,[568  96 132 127 195],326,3,32893,4.379310344827586,0.0,20.0
7511,0,7511,[121 135  82 117 195],653,5,32898,4.3793929712460065,0.0,0.0
7512,0,7512,[302 603 427 187 180],666,5,32903,4.379475575668841,20.0,0.0
7513,0,7513,[  9 215 185   1  22],234,1,32904,4.3790258184721855,0.0,0.0
7514,0,7514,[302 603 427 187 180],458,5,32909,4.379108449767132,20.0,0.0
7515,0,7515,[302 603 427 187 180],90,5,32914,4.3791910590739755,20.0,0.0
7516,0,7516,[302 603 427 187 180],474,5,32919,4.37927364640149,20.0,0.0
7517,0,7517,[125 301 215 265 200],378,2,32921,4.378957169459963,0.0,0.0
7518,0,7518,[475 323 173  22 200],13,1,32922,4.378507780289932,0.0,0.0
7519,0,7519,[302 603 427 187 180],339,5,32927,4.378590425531915,20.0,0.0
7520,0,7520,[302 603 427 187 180],13,5,32932,4.378673048796703,20.0,0.0
7521,0,7521,[302 603 427 187 180],458,5,32937,4.37875565009306,20.0,0.0
7522,0,7522,[302 603 427 187 180],537,5,32942,4.378838229429749,20.0,0.0
7523,0,7523,[302 603 427 187 180],90,5,32947,4.378920786815524,20.0,0.0
7524,0,7524,[302 603 427 187 180],13,5,32952,4.379003322259136,20.0,0.0
7525,0,7525,[302 603 427 187 180],474,5,32957,4.379085835769333,20.0,0.0
7526,0,7526,[302 603 427 187 180],458,5,32962,4.379168327354856,20.0,0.0
7527,0,7527,[435 273   1  71 196],892,4,32966,4.379117959617428,0.0,0.0
7528,0,7528,[100   1 180 176 357],325,3,32969,4.378934785496082,20.0,20.0
7529,0,7529,[302 603 427 187 180],537,5,32974,4.379017264276229,20.0,0.0
7530,0,7530,[302 603 427 187 180],13,5,32979,4.37909972115257,20.0,0.0
7531,0,7531,[302 603 427 187 180],664,5,32984,4.379182156133829,20.0,0.0
7532,0,7532,[302 603 427 187 180],13,5,32989,4.379264569228727,20.0,0.0
7533,0,7533,[302 603 427 187 180],458,5,32994,4.379346960445978,20.0,0.0
7534,0,7534,[302 603 427 187 180],271,5,32999,4.379429329794293,20.0,0.0
7535,0,7535,[302 603 427 187 180],474,5,33004,4.379511677282378,20.0,0.0
7536,0,7536,[302 603 427 187 180],537,5,33009,4.3795940029189335,20.0,0.0
7537,0,7537,[302 603 427 187 180],90,5,33014,4.379676306712656,20.0,0.0
7538,0,7538,[ 28  89 181 427 194],833,1,33015,4.379228014325507,0.0,0.0
7539,0,7539,[302 603 427 187 180],458,5,33020,4.379310344827586,20.0,0.0
7540,0,7540,[ 96  25 194  28 405],59,3,33023,4.379127436679486,0.0,0.0
7541,0,7541,[302 603 427 187 180],339,5,33028,4.379209758684699,20.0,0.0
7542,0,7542,[302 603 427 187 180],339,5,33033,4.3792920588625215,20.0,0.0
7543,0,7543,[302 603 427 187 180],13,5,33038,4.379374337221633,20.0,0.0
7544,0,7544,[302 603 427 187 180],271,5,33043,4.379456593770709,20.0,0.0
7545,0,7545,[197 181  79 194 127],339,5,33048,4.37953882851842,0.0,20.0
7546,0,7546,[435 132 313 471 228],234,2,33050,4.3792235325294815,0.0,0.0
7547,0,7547,[302 603 427 187 180],537,5,33055,4.3793057763646,20.0,0.0
7548,0,7548,[300 405 179 357 211],666,3,33058,4.379123062657306,20.0,0.0
7549,0,7549,[302 603 427 187 180],474,5,33063,4.379205298013245,20.0,0.0
7550,0,7550,[302 603 427 187 180],664,5,33068,4.3792875115878696,20.0,0.0
7551,0,7551,[302 603 427 187 180],339,5,33073,4.3793697033898304,20.0,0.0
7552,0,7552,[318 132 111 197 168],452,3,33076,4.379187077982259,20.0,0.0
7553,0,7553,[302 603 427 187 180],666,5,33081,4.379269261318507,20.0,0.0
7554,0,7554,[302 603 427 187 180],339,5,33086,4.3793514228987425,20.0,0.0
7555,0,7555,[302 603 427 187 180],664,5,33091,4.379433562731604,20.0,0.0
7556,0,7556,[302 603 427 187 180],537,5,33096,4.379515680825724,20.0,0.0
7557,0,7557,[228 273 179 185 405],749,4,33100,4.379465467054777,0.0,0.0
7558,0,7558,[302 603 427 187 180],537,5,33105,4.379547559200953,20.0,0.0
7559,0,7559,[742  95 678 302  70],334,1,33106,4.379100529100529,0.0,0.0
7560,0,7560,[302 603 427 187 180],13,5,33111,4.3791826477979106,20.0,0.0
7561,0,7561,[302 603 427 187 180],537,5,33116,4.379264744776514,20.0,0.0
7562,0,7562,[483 275  50 135  69],82,3,33119,4.379082374719027,20.0,20.0
7563,0,7563,[302 603 427 187 180],458,5,33124,4.379164463246959,20.0,0.0
7564,0,7564,[302 603 427 187 180],537,5,33129,4.379246530072703,20.0,0.0
7565,0,7565,[302 603 427 187 180],474,5,33134,4.379328575204864,20.0,0.0
7566,0,7566,[215 302 235 181 508],13,3,33137,4.37914629311484,0.0,0.0
7567,0,7567,[302 603 427 187 180],537,5,33142,4.379228329809725,20.0,0.0
7568,0,7568,[302 603 427 187 180],90,5,33147,4.379310344827586,20.0,0.0
7569,0,7569,[302 603 427 187 180],458,5,33152,4.379392338177015,20.0,0.0
7570,0,7570,[302 603 427 187 180],664,5,33157,4.3794743098665965,20.0,0.0
7571,0,7571,[121 135 185 427 144],328,3,33160,4.379292128895933,0.0,0.0
7572,0,7572,[302 603 427 187 180],458,5,33165,4.37937409216955,20.0,0.0
7573,0,7573,[496  71  50  95 153],308,4,33169,4.379324003168735,0.0,20.0
7574,0,7574,[302 603 427 187 180],666,5,33174,4.37940594059406,20.0,0.0
7575,0,7575,[302 603 427 187 180],537,5,33179,4.379487856388596,20.0,0.0
7576,0,7576,[121   8  89 235 168],479,4,33183,4.379437772205359,0.0,0.0
7577,0,7577,[210  28 168 318 127],527,3,33186,4.379255740300871,20.0,20.0
7578,0,7578,[ 97 197  12 195 191],409,4,33190,4.3792056999604165,20.0,0.0
7579,0,7579,[302 603 427 187 180],13,5,33195,4.379287598944591,20.0,0.0
7580,0,7580,[302 603 427 187 180],664,5,33200,4.379369476322385,20.0,0.0
7581,0,7581,[ 28   1 187   9  70],488,2,33202,4.379055658137695,0.0,0.0
7582,0,7582,[302 603 427 187 180],271,5,33207,4.379137544507451,20.0,0.0
7583,0,7583,[302 603 427 187 180],666,5,33212,4.3792194092827,20.0,0.0
7584,0,7584,[302 603 427 187 180],537,5,33217,4.3793012524719845,20.0,0.0
7585,0,7585,[265 405 204 173 302],883,3,33220,4.379119430529924,0.0,0.0
7586,0,7586,[143 258 245  88 210],207,2,33222,4.378805852115461,0.0,0.0
7587,0,7587,[302 603 427 187 180],537,5,33227,4.378887717448603,20.0,0.0
7588,0,7588,[302 603 427 187 180],474,5,33232,4.37896956120701,20.0,0.0
7589,0,7589,[302 603 427 187 180],666,5,33237,4.37905138339921,20.0,0.0
7590,0,7590,[302 603 427 187 180],537,5,33242,4.379133184033724,20.0,0.0
7591,0,7591,[302 603 427 187 180],664,5,33247,4.379214963119073,20.0,0.0
7592,0,7592,[588 195 191 222 161],64,4,33251,4.379165020413539,0.0,0.0
7593,0,7593,[302 603 427 187 180],666,5,33256,4.379246773768765,20.0,0.0
7594,0,7594,[302 603 427 187 180],474,5,33261,4.379328505595787,20.0,0.0
7595,0,7595,[  4  96  50  56 269],13,4,33265,4.3792785676671935,0.0,20.0
7596,0,7596,[302 603 427 187 180],339,5,33270,4.379360273792287,20.0,0.0
7597,0,7597,[302 603 427 187 180],13,5,33275,4.379441958410108,20.0,0.0
7598,0,7598,[302 603 427 187 180],537,5,33280,4.379523621529149,20.0,0.0
7599,0,7599,[302 603 427 187 180],13,5,33285,4.379605263157894,20.0,0.0
7600,0,7600,[302 603 427 187 180],271,5,33290,4.379686883304828,20.0,0.0
7601,0,7601,[302 603 427 187 180],339,5,33295,4.379768481978426,20.0,0.0
7602,0,7602,[185   9 357 471 194],543,3,33298,4.3795870051295545,20.0,0.0
7603,0,7603,[302 603 427 187 180],339,5,33303,4.3796685954760655,20.0,0.0
7604,0,7604,[302 603 427 187 180],13,5,33308,4.379750164365549,20.0,0.0
7605,0,7605,[302 603 427 187 180],666,5,33313,4.379831711806468,20.0,0.0
7606,0,7606,[187 204 121 300 118],788,3,33316,4.379650322071776,0.0,0.0
7607,0,7607,[144 515  89  12 211],387,4,33320,4.379600420609885,20.0,0.0
7608,0,7608,[302 603 427 187 180],13,5,33325,4.37968195557892,20.0,0.0
7609,0,7609,[302 603 427 187 180],339,5,33330,4.379763469119579,20.0,0.0
7610,0,7610,[  7 194 135 183 245],378,3,33333,4.379582183681514,0.0,0.0
7611,0,7611,[302 603 427 187 180],271,5,33338,4.379663688912244,20.0,0.0
7612,0,7612,[302 603 427 187 180],474,5,33343,4.379745172730855,20.0,0.0
7613,0,7613,[302 603 427 187 180],666,5,33348,4.379826635145784,20.0,0.0
7614,0,7614,[333 405 168 289 268],537,2,33350,4.3795141168745895,0.0,0.0
7615,0,7615,[515  95   4 211  25],194,3,33353,4.379332983193278,0.0,0.0
7616,0,7616,[302 603 427 187 180],90,5,33358,4.379414467638178,20.0,0.0
7617,0,7617,[302 603 427 187 180],537,5,33363,4.37949593069047,20.0,0.0
7618,0,7618,[302 603 427 187 180],537,5,33368,4.379577372358577,20.0,0.0
7619,0,7619,[ 56   8  11 483 268],234,2,33370,4.379265091863517,20.0,0.0
7620,0,7620,[302 603 427 187 180],458,5,33375,4.379346542448498,20.0,0.0
7621,0,7621,[302 603 427 187 180],271,5,33380,4.379427971660982,20.0,0.0
7622,0,7622,[302 603 427 187 180],458,5,33385,4.379509379509379,20.0,0.0
7623,0,7623,[302 603 427 187 180],13,5,33390,4.3795907660020985,20.0,0.0
7624,0,7624,[  4 111  15 286 200],234,2,33392,4.3792786885245905,0.0,0.0
7625,0,7625,[302 603 427 187 180],339,5,33397,4.3793600839234195,20.0,0.0
7626,0,7626,[ 95 168 222 597  50],804,3,33400,4.379179231676937,0.0,20.0
7627,0,7627,[302 603 427 187 180],339,5,33405,4.379260618772942,20.0,0.0
7628,0,7628,[302 603 427 187 180],666,5,33410,4.379341984532704,20.0,0.0
7629,0,7629,[127  82 144 151 181],804,3,33413,4.37916120576671,0.0,20.0
7630,0,7630,[302 603 427 187 180],271,5,33418,4.379242563228934,20.0,0.0
7631,0,7631,[185 196 435 127 238],13,3,33421,4.379061844863732,0.0,20.0
7632,0,7632,[ 22 204   8 294 180],6,2,33423,4.37875016376261,0.0,0.0
7633,0,7633,[ 89   9 121 265 187],328,5,33428,4.378831543096672,0.0,0.0
7634,0,7634,[302 603 427 187 180],537,5,33433,4.378912901113294,20.0,0.0
7635,0,7635,[302 603 427 187 180],537,5,33438,4.378994237820849,20.0,0.0
7636,0,7636,[302 603 427 187 180],664,5,33443,4.3790755532277075,20.0,0.0
7637,0,7637,[302 603 427 187 180],666,5,33448,4.379156847342236,20.0,0.0
7638,0,7638,[302 603 427 187 180],664,5,33453,4.379238120172798,20.0,0.0
7639,0,7639,[302 603 427 187 180],13,5,33458,4.379319371727749,20.0,0.0
7640,0,7640,[302 603 427 187 180],666,5,33463,4.379400602015443,20.0,0.0
7641,0,7641,[191  97  11 515  79],59,5,33468,4.379481811044229,0.0,0.0
7642,0,7642,[302 603 427 187 180],13,5,33473,4.379562998822452,20.0,0.0
7643,0,7643,[302 603 427 187 180],474,5,33478,4.379644165358451,20.0,0.0
7644,0,7644,[302 603 427 187 180],339,5,33483,4.379725310660563,20.0,0.0
7645,0,7645,[496 423 215  56  64],387,1,33484,4.3792832853779755,0.0,0.0
7646,0,7646,[302 603 427 187 180],664,5,33489,4.379364456649666,20.0,0.0
7647,0,7647,[302 603 427 187 180],271,5,33494,4.379445606694561,20.0,0.0
7648,0,7648,[302 603 427 187 180],458,5,33499,4.379526735520983,20.0,0.0
7649,0,7649,[302 603 427 187 180],458,5,33504,4.379607843137255,20.0,0.0
7650,0,7650,[302 603 427 187 180],90,5,33509,4.379688929551692,20.0,0.0
7651,0,7651,[  8 385  12 132  98],64,5,33514,4.379769994772609,20.0,20.0
7652,0,7652,[302 603 427 187 180],458,5,33519,4.379851038808311,20.0,0.0
7653,0,7653,[302 603 427 187 180],271,5,33524,4.379932061667102,20.0,0.0
7654,0,7654,[423 196 204 161  64],85,5,33529,4.380013063357283,0.0,0.0
7655,0,7655,[302 603 427 187 180],474,5,33534,4.380094043887147,20.0,0.0
7656,0,7656,[302 603 427 187 180],666,5,33539,4.380175003264986,20.0,0.0
7657,0,7657,[302 603 427 187 180],458,5,33544,4.380255941499086,20.0,0.0
7658,0,7658,[302 603 427 187 180],474,5,33549,4.380336858597728,20.0,0.0
7659,0,7659,[302 603 427 187 180],537,5,33554,4.380417754569191,20.0,0.0
7660,0,7660,[302 603 427 187 180],271,5,33559,4.380498629421747,20.0,0.0
7661,0,7661,[302 603 427 187 180],339,5,33564,4.380579483163665,20.0,0.0
7662,0,7662,[211 294 135  11 117],13,2,33566,4.38026882422028,0.0,0.0
7663,0,7663,[748 191 483 300 222],488,3,33569,4.38008872651357,20.0,0.0
7664,0,7664,[172  79 180 179 215],659,3,33572,4.379908675799086,0.0,0.0
7665,0,7665,[471 748 121 186 180],207,1,33573,4.37946777980694,0.0,0.0
7666,0,7666,[127 153 216 313  79],738,3,33576,4.379287857049693,0.0,20.0
7667,0,7667,[302 603 427 187 180],339,5,33581,4.379368805425144,20.0,0.0
7668,0,7668,[546 216  98 222 403],881,4,33585,4.379319337592906,0.0,20.0
7669,0,7669,[302 603 427 187 180],339,5,33590,4.379400260756193,20.0,0.0
7670,0,7670,[302 603 427 187 180],474,5,33595,4.379481162821015,20.0,0.0
7671,0,7671,[302 603 427 187 180],537,5,33600,4.37956204379562,20.0,0.0
7672,0,7672,[302 603 427 187 180],664,5,33605,4.379642903688257,20.0,0.0
7673,0,7673,[302 603 427 187 180],13,5,33610,4.379723742507167,20.0,0.0
7674,0,7674,[302 603 427 187 180],537,5,33615,4.379804560260586,20.0,0.0
7675,0,7675,[302 603 427 187 180],13,5,33620,4.379885356956748,20.0,0.0
7676,0,7676,[286 318 179 238 405],458,5,33625,4.379966132603882,20.0,0.0
7677,0,7677,[172  88 294 496 176],125,5,33630,4.380046887210211,0.0,0.0
7678,0,7678,[302 603 427 187 180],474,5,33635,4.380127620783957,20.0,0.0
7679,0,7679,[222   7  50 194 180],339,5,33640,4.380208333333333,0.0,20.0
7680,0,7680,[ 82 269 196 483 222],666,2,33642,4.379898450722562,20.0,0.0
7681,0,7681,[302 603 427 187 180],664,5,33647,4.379979172090602,20.0,0.0
7682,0,7682,[121 228 181 427 435],650,4,33651,4.379929714955096,0.0,0.0
7683,0,7683,[228 748 127  98 289],883,4,33655,4.379880270692348,0.0,40.0
7684,0,7684,[302 603 427 187 180],537,5,33660,4.379960962914769,20.0,0.0
7685,0,7685,[302 603 427 187 180],13,5,33665,4.380041634139995,20.0,0.0
7686,0,7686,[403 174  15 222 275],648,4,33669,4.3799921946142835,0.0,20.0
7687,0,7687,[302 603 427 187 180],474,5,33674,4.3800728407908425,20.0,0.0
7688,0,7688,[302 603 427 187 180],339,5,33679,4.380153465990376,20.0,0.0
7689,0,7689,[302 603 427 187 180],666,5,33684,4.380234070221066,20.0,0.0
7690,0,7690,[197  70 125 187 200],234,3,33687,4.380054609283579,0.0,0.0
7691,0,7691,[302 603 427 187 180],664,5,33692,4.380135205408217,20.0,0.0
7692,0,7692,[302 603 427 187 180],664,5,33697,4.380215780579748,20.0,0.0
7693,0,7693,[180 405  82 195 742],533,3,33700,4.3800363919937615,0.0,0.0
7694,0,7694,[302 603 427 187 180],666,5,33705,4.380116959064328,20.0,0.0
7695,0,7695,[302 603 427 187 180],458,5,33710,4.380197505197505,20.0,0.0
7696,0,7696,[655 742 127 100 222],328,4,33714,4.380148109653112,0.0,40.0
7697,0,7697,[ 70  64 143 483 187],59,3,33717,4.379968823070928,20.0,0.0
7698,0,7698,[302 603 427 187 180],271,5,33722,4.380049357059359,20.0,0.0
7699,0,7699,[302 603 427 187 180],13,5,33727,4.3801298701298705,20.0,0.0
7700,0,7700,[302 603 427 187 180],664,5,33732,4.380210362290612,20.0,0.0
7701,0,7701,[302 603 427 187 180],458,5,33737,4.3802908335497275,20.0,0.0
7702,0,7702,[302 603 427 187 180],271,5,33742,4.380371283915357,20.0,0.0
7703,0,7703,[405 235 215 195 237],378,3,33745,4.380192107995846,0.0,0.0
7704,0,7704,[302 603 427 187 180],90,5,33750,4.380272550292018,20.0,0.0
7705,0,7705,[483   4 234  50 179],406,4,33754,4.380223202699195,20.0,20.0
7706,0,7706,[302 603 427 187 180],664,5,33759,4.380303620085637,20.0,0.0
7707,0,7707,[302 603 427 187 180],664,5,33764,4.380384016606124,20.0,0.0
7708,0,7708,[174 181 187  11 435],749,4,33768,4.380334673757945,0.0,20.0
7709,0,7709,[302 603 427 187 180],90,5,33773,4.380415045395591,20.0,0.0
7710,0,7710,[302 603 427 187 180],537,5,33778,4.380495396187265,20.0,0.0
7711,0,7711,[  1  50 235 546 328],271,1,33779,4.380057053941909,0.0,20.0
7712,0,7712,[302 603 427 187 180],13,5,33784,4.38013743031246,20.0,0.0
7713,0,7713,[181 195 318  96 196],892,5,33789,4.38021778584392,20.0,0.0
7714,0,7714,[ 28 194  71 196  97],380,4,33793,4.380168502916397,0.0,0.0
7715,0,7715,[180 179 597 282 197],653,3,33796,4.379989631933644,0.0,0.0
7716,0,7716,[302 603 427 187 180],666,5,33801,4.380069975379033,20.0,0.0
7717,0,7717,[  9 111 655 195  28],59,5,33806,4.380150298004664,0.0,0.0
7718,0,7718,[302 603 427 187 180],474,5,33811,4.3802305998186295,20.0,0.0
7719,0,7719,[222  11  64 194 191],215,4,33815,4.380181347150259,0.0,0.0
7720,0,7720,[302 603 427 187 180],537,5,33820,4.3802616241419505,20.0,0.0
7721,0,7721,[302 603 427 187 180],666,5,33825,4.380341880341881,20.0,0.0
7722,0,7722,[257 176   8 182 215],92,4,33829,4.380292632396737,0.0,0.0
7723,0,7723,[302 603 427 187 180],271,5,33834,4.380372863801139,20.0,0.0
7724,0,7724,[302 603 427 187 180],90,5,33839,4.380453074433657,20.0,0.0
7725,0,7725,[435 403  89 181 238],379,5,33844,4.380533264302356,0.0,0.0
7726,0,7726,[ 69 143 186  98  11],537,1,33845,4.3800957680859325,0.0,20.0
7727,0,7727,[ 82 234 357 385  71],85,3,33848,4.37991718426501,20.0,0.0
7728,0,7728,[302 603 427 187 180],474,5,33853,4.379997412343124,20.0,0.0
7729,0,7729,[ 56 216  97 357 204],328,2,33855,4.379689521345408,20.0,0.0
7730,0,7730,[151  82 234 546  88],200,3,33858,4.379511059371362,0.0,0.0
7731,0,7731,[427 204 168 125 132],6,3,33861,4.379332643559234,0.0,0.0
7732,0,7732,[302 603 427 187 180],90,5,33866,4.379412905728695,20.0,0.0
7733,0,7733,[  8 496 603 427 678],454,4,33870,4.379363847944143,20.0,0.0
7734,0,7734,[302 603 427 187 180],537,5,33875,4.379444085326439,20.0,0.0
7735,0,7735,[ 98 200 211 357 269],6,4,33879,4.379395036194416,20.0,20.0
7736,0,7736,[302 603 427 187 180],339,5,33884,4.379475248804447,20.0,0.0
7737,0,7737,[333 300   4  56 210],346,5,33889,4.3795554406823465,0.0,0.0
7738,0,7738,[302 603 427 187 180],271,5,33894,4.379635611836155,20.0,0.0
7739,0,7739,[302 603 427 187 180],271,5,33899,4.379715762273902,20.0,0.0
7740,0,7740,[302 603 427 187 180],13,5,33904,4.379795892003617,20.0,0.0
7741,0,7741,[302 603 427 187 180],271,5,33909,4.379876001033325,20.0,0.0
7742,0,7742,[302 603 427 187 180],458,5,33914,4.379956089371045,20.0,0.0
7743,0,7743,[302 603 427 187 180],664,5,33919,4.380036157024794,20.0,0.0
7744,0,7744,[302 603 427 187 180],458,5,33924,4.380116204002582,20.0,0.0
7745,0,7745,[302 603 427 187 180],664,5,33929,4.38019623031242,20.0,0.0
7746,0,7746,[302 603 427 187 180],666,5,33934,4.380276235962308,20.0,0.0
7747,0,7747,[302 603 427 187 180],339,5,33939,4.380356220960248,20.0,0.0
7748,0,7748,[302 603 427 187 180],666,5,33944,4.380436185314234,20.0,0.0
7749,0,7749,[234 176 496 742 286],488,4,33948,4.380387096774194,0.0,0.0
7750,0,7750,[302 603 427 187 180],90,5,33953,4.380467036511418,20.0,0.0
7751,0,7751,[302 603 427 187 180],474,5,33958,4.380546955624355,20.0,0.0
7752,0,7752,[302 603 427 187 180],90,5,33963,4.380626854120986,20.0,0.0
7753,0,7753,[302 603 427 187 180],458,5,33968,4.380706732009285,20.0,0.0
7754,0,7754,[302 603 427 187 180],474,5,33973,4.3807865892972275,20.0,0.0
7755,0,7755,[302 603 427 187 180],90,5,33978,4.38086642599278,20.0,0.0
7756,0,7756,[302 603 427 187 180],537,5,33983,4.3809462421039065,20.0,0.0
7757,0,7757,[302 603 427 187 180],537,5,33988,4.381026037638566,20.0,0.0
7758,0,7758,[302 603 427 187 180],664,5,33993,4.3811058126047175,20.0,0.0
7759,0,7759,[588 204 191 202  96],387,2,33995,4.380798969072165,0.0,0.0
7760,0,7760,[302 603 427 187 180],90,5,34000,4.380878752738049,20.0,0.0
7761,0,7761,[302 603 427 187 180],339,5,34005,4.380958515846431,20.0,0.0
7762,0,7762,[302 603 427 187 180],13,5,34010,4.381038258405256,20.0,0.0
7763,0,7763,[181 161 168  11 237],64,4,34014,4.3809891808346215,0.0,0.0
7764,0,7764,[302 603 427 187 180],271,5,34019,4.381068898905345,20.0,0.0
7765,0,7765,[302 603 427 187 180],666,5,34024,4.381148596446047,20.0,0.0
7766,0,7766,[302 603 427 187 180],271,5,34029,4.381228273464658,20.0,0.0
7767,0,7767,[289 546 211 100 435],271,4,34033,4.381179196704428,0.0,20.0
7768,0,7768,[234 318  25 180 282],474,5,34038,4.381258849272751,20.0,0.0
7769,0,7769,[ 79  70 161 300 568],87,4,34042,4.381209781209781,0.0,0.0
7770,0,7770,[302 603 427 187 180],664,5,34047,4.381289409342427,20.0,0.0
7771,0,7771,[302 603 427 187 180],13,5,34052,4.381369016984046,20.0,0.0
7772,0,7772,[302 603 427 187 180],13,5,34057,4.381448604142545,20.0,0.0
7773,0,7773,[ 97  88 197  71  96],95,5,34062,4.381528170825829,0.0,0.0
7774,0,7774,[132 423 204 195 161],346,4,34066,4.381479099678456,0.0,0.0
7775,0,7775,[588 143 118 186 568],308,4,34070,4.381430041152264,0.0,0.0
7776,0,7776,[294 385 496 181 111],666,1,34071,4.380995242381381,0.0,0.0
7777,0,7777,[302 603 427 187 180],458,5,34076,4.38107482643353,20.0,0.0
7778,0,7778,[302 603 427 187 180],271,5,34081,4.381154390024425,20.0,0.0
7779,0,7779,[302 603 427 187 180],474,5,34086,4.381233933161954,20.0,0.0
7780,0,7780,[302 603 427 187 180],339,5,34091,4.381313455854003,20.0,0.0
7781,0,7781,[302 603 427 187 180],666,5,34096,4.381392958108456,20.0,0.0
7782,0,7782,[302 603 427 187 180],339,5,34101,4.381472439933188,20.0,0.0
7783,0,7783,[302 603 427 187 180],474,5,34106,4.381551901336074,20.0,0.0
7784,0,7784,[282 204 300 151 180],533,3,34109,4.381374438021837,0.0,0.0
7785,0,7785,[302 603 427 187 180],666,5,34114,4.381453891600308,20.0,0.0
7786,0,7786,[302 603 427 187 180],666,5,34119,4.381533324772056,20.0,0.0
7787,0,7787,[117 168   7  97 194],537,2,34121,4.381227529532614,0.0,0.0
7788,0,7788,[748 515 222 385 603],524,1,34122,4.380793426627295,20.0,0.0
7789,0,7789,[294  96 275 385 313],119,4,34126,4.380744544287548,0.0,0.0
7790,0,7790,[385 172 238  28 132],843,0,34126,4.380182261583879,0.0,0.0
7791,0,7791,[302 603 427 187 180],90,5,34131,4.38026180698152,20.0,0.0
7792,0,7792,[282 173 245 121  12],92,4,34135,4.380213011677146,20.0,0.0
7793,0,7793,[183 515 357  28  98],488,5,34140,4.380292532717475,20.0,20.0
7794,0,7794,[118 288 748   1  71],648,3,34143,4.380115458627325,0.0,0.0
7795,0,7795,[302 603 427 187 180],458,5,34148,4.3801949717804005,20.0,0.0
7796,0,7796,[357 483 471 323  69],474,3,34151,4.380017955623958,40.0,0.0
7797,0,7797,[ 79 168 423  97 151],308,4,34155,4.379969222877661,0.0,0.0
7798,0,7798,[302 603 427 187 180],339,5,34160,4.38004872419541,20.0,0.0
7799,0,7799,[302 603 427 187 180],666,5,34165,4.380128205128205,20.0,0.0
7800,0,7800,[302 603 427 187 180],664,5,34170,4.380207665683887,20.0,0.0
7801,0,7801,[302 603 427 187 180],339,5,34175,4.3802871058702895,20.0,0.0
7802,0,7802,[302 603 427 187 180],474,5,34180,4.380366525695245,20.0,0.0
7803,0,7803,[302 603 427 187 180],537,5,34185,4.3804459251665815,20.0,0.0
7804,0,7804,[302 603 427 187 180],474,5,34190,4.380525304292121,20.0,0.0
7805,0,7805,[302 603 427 187 180],13,5,34195,4.380604663079683,20.0,0.0
7806,0,7806,[302 603 427 187 180],666,5,34200,4.380684001537082,20.0,0.0
7807,0,7807,[357 121  22 168   4],749,4,34204,4.380635245901639,20.0,0.0
7808,0,7808,[302 603 427 187 180],90,5,34209,4.380714560122935,20.0,0.0
7809,0,7809,[173 357 179  79 597],643,4,34213,4.38066581306018,20.0,0.0
7810,0,7810,[302 603 427 187 180],458,5,34218,4.3807451030597875,20.0,0.0
7811,0,7811,[174 273  98 588  69],42,4,34222,4.380696364567332,0.0,40.0
7812,0,7812,[302 603 427 187 180],664,5,34227,4.380775630359657,20.0,0.0
7813,0,7813,[302 603 427 187 180],664,5,34232,4.380854875863834,20.0,0.0
7814,0,7814,[302 603 427 187 180],13,5,34237,4.380934101087652,20.0,0.0
7815,0,7815,[302 603 427 187 180],90,5,34242,4.381013306038895,20.0,0.0
7816,0,7816,[302 603 427 187 180],271,5,34247,4.381092490725342,20.0,0.0
7817,0,7817,[ 22 333 294 161  71],328,3,34250,4.380915835251983,0.0,0.0
7818,0,7818,[302 603 427 187 180],458,5,34255,4.380995012149891,20.0,0.0
7819,0,7819,[302 603 427 187 180],90,5,34260,4.381074168797954,20.0,0.0
7820,0,7820,[288  69  89 265 100],13,4,34264,4.381025444316584,0.0,20.0
7821,0,7821,[302 603 427 187 180],458,5,34269,4.381104576834569,20.0,0.0
7822,0,7822,[302 603 427 187 180],90,5,34274,4.38118368912182,20.0,0.0
7823,0,7823,[302 603 427 187 180],339,5,34279,4.381262781186094,20.0,0.0
7824,0,7824,[302 603 427 187 180],458,5,34284,4.381341853035144,20.0,0.0
7825,0,7825,[302 603 427 187 180],666,5,34289,4.381420904676719,20.0,0.0
7826,0,7826,[ 71 385 222 276   9],234,0,34289,4.380861121758017,0.0,0.0
7827,0,7827,[302 603 427 187 180],664,5,34294,4.380940214614205,20.0,0.0
7828,0,7828,[302 603 427 187 180],271,5,34299,4.381019287265295,20.0,0.0
7829,0,7829,[302 603 427 187 180],537,5,34304,4.3810983397190295,20.0,0.0
7830,0,7830,[302 603 427 187 180],666,5,34309,4.381177371983144,20.0,0.0
7831,0,7831,[483 194 258  12  89],234,2,34311,4.380873340143003,40.0,0.0
7832,0,7832,[234 385 318 300 471],90,4,34315,4.3808247159453595,20.0,0.0
7833,0,7833,[302 603 427 187 180],339,5,34320,4.380903752872096,20.0,0.0
7834,0,7834,[143 181  71  88 179],374,1,34321,4.380472239948947,0.0,0.0
7835,0,7835,[318  12 385 427 143],454,3,34324,4.380296069423175,40.0,0.0
7836,0,7836,[ 64 257 496 423 194],339,4,34328,4.380247543702947,0.0,0.0
7837,0,7837,[161 168 238 174 435],210,4,34332,4.3801990303648894,0.0,20.0
7838,0,7838,[302 603 427 187 180],666,5,34337,4.380278096696007,20.0,0.0
7839,0,7839,[302 603 427 187 180],537,5,34342,4.380357142857143,20.0,0.0
7840,0,7840,[302 603 427 187 180],339,5,34347,4.380436168856013,20.0,0.0
7841,0,7841,[302 603 427 187 180],90,5,34352,4.3805151747003315,20.0,0.0
7842,0,7842,[302 603 427 187 180],474,5,34357,4.380594160397807,20.0,0.0
7843,0,7843,[127 135  98 496 204],148,1,34358,4.380163182049975,0.0,40.0
7844,0,7844,[302 603 427 187 180],537,5,34363,4.380242192479286,20.0,0.0
7845,0,7845,[302 603 427 187 180],271,5,34368,4.38032118276829,20.0,0.0
7846,0,7846,[302 603 427 187 180],458,5,34373,4.380400152924684,20.0,0.0
7847,0,7847,[302 603 427 187 180],666,5,34378,4.380479102956167,20.0,0.0
7848,0,7848,[302 603 427 187 180],664,5,34383,4.38055803287043,20.0,0.0
7849,0,7849,[302 603 427 187 180],474,5,34388,4.380636942675159,20.0,0.0
7850,0,7850,[222 483 210  79 405],804,5,34393,4.380715832378041,20.0,0.0
7851,0,7851,[100 197 161 265  12],271,4,34397,4.380667345899134,20.0,20.0
7852,0,7852,[302 603 427 187 180],90,5,34402,4.380746211638864,20.0,0.0
7853,0,7853,[483  69 742 144 100],207,3,34405,4.380570409982175,20.0,20.0
7854,0,7854,[302 603 427 187 180],666,5,34410,4.380649267982177,20.0,0.0
7855,0,7855,[302 603 427 187 180],339,5,34415,4.3807281059063135,20.0,0.0
7856,0,7856,[302 603 427 187 180],13,5,34420,4.3808069237622504,20.0,0.0
7857,0,7857,[302 603 427 187 180],271,5,34425,4.380885721557648,20.0,0.0
7858,0,7858,[302 286  82 197 435],524,5,34430,4.380964499300165,0.0,0.0
7859,0,7859,[302 603 427 187 180],339,5,34435,4.381043256997455,20.0,0.0
7860,0,7860,[215 328 258 286 100],90,2,34437,4.380740363821396,0.0,20.0
7861,0,7861,[302 603 427 187 180],458,5,34442,4.380819129992369,20.0,0.0
7862,0,7862,[302 603 427 187 180],664,5,34447,4.380897876128704,20.0,0.0
7863,0,7863,[302 603 427 187 180],664,5,34452,4.3809766022380465,20.0,0.0
7864,0,7864,[302 603 427 187 180],664,5,34457,4.381055308328036,20.0,0.0
7865,0,7865,[302 603 427 187 180],474,5,34462,4.381133994406306,20.0,0.0
7866,0,7866,[300 143   8 211  98],533,4,34466,4.381085547222575,0.0,20.0
7867,0,7867,[302 603 427 187 180],537,5,34471,4.381164209456024,20.0,0.0
7868,0,7868,[302 603 427 187 180],474,5,34476,4.3812428516965305,20.0,0.0
7869,0,7869,[302 603 427 187 180],666,5,34481,4.381321473951715,20.0,0.0
7870,0,7870,[  4   1  50 153 318],883,4,34485,4.381273027569559,20.0,20.0
7871,0,7871,[302 603 427 187 180],90,5,34490,4.381351626016261,20.0,0.0
7872,0,7872,[302 603 427 187 180],90,5,34495,4.38143020449638,20.0,0.0
7873,0,7873,[302 603 427 187 180],339,5,34500,4.381508763017526,20.0,0.0
7874,0,7874,[302 603 427 187 180],474,5,34505,4.3815873015873015,20.0,0.0
7875,0,7875,[127 151 125  95 289],406,2,34507,4.381284916201118,0.0,20.0
7876,0,7876,[302 603 427 187 180],90,5,34512,4.381363463247429,20.0,0.0
7877,0,7877,[302 603 427 187 180],458,5,34517,4.381441990352881,20.0,0.0
7878,0,7878,[302 603 427 187 180],664,5,34522,4.381520497525067,20.0,0.0
7879,0,7879,[302 603 427 187 180],271,5,34527,4.381598984771574,20.0,0.0
7880,0,7880,[302 603 427 187 180],339,5,34532,4.3816774520999875,20.0,0.0
7881,0,7881,[302 603 427 187 180],666,5,34537,4.381755899517889,20.0,0.0
7882,0,7882,[302 603 427 187 180],271,5,34542,4.3818343270328555,20.0,0.0
7883,0,7883,[153 186 237   4  97],234,1,34543,4.3814053779807205,0.0,0.0
7884,0,7884,[302 603 427 187 180],271,5,34548,4.38148383005707,20.0,0.0
7885,0,7885,[268 176 161 100 173],643,4,34552,4.3814354552371295,0.0,20.0
7886,0,7886,[318 135 258  50 175],465,4,34556,4.381387092684164,20.0,20.0
7887,0,7887,[302 603 427 187 180],537,5,34561,4.381465517241379,20.0,0.0
7888,0,7888,[302 603 427 187 180],458,5,34566,4.381543921916593,20.0,0.0
7889,0,7889,[302 603 427 187 180],13,5,34571,4.381622306717364,20.0,0.0
7890,0,7890,[125 151  22 288  96],892,5,34576,4.381700671651248,0.0,0.0
7891,0,7891,[333  56 496  28 187],488,4,34580,4.381652306132793,0.0,0.0
7892,0,7892,[302 603 427 187 180],13,5,34585,4.381730647409096,20.0,0.0
7893,0,7893,[ 56 286 276 483 435],10,5,34590,4.381808968837092,20.0,0.0
7894,0,7894,[301 294   8 117 423],6,1,34591,4.381380620645978,0.0,0.0
7895,0,7895,[302 603 427 187 180],664,5,34596,4.38145896656535,20.0,0.0
7896,0,7896,[ 79 603 742 588 216],189,3,34599,4.381284031910853,20.0,0.0
7897,0,7897,[302 603 427 187 180],664,5,34604,4.381362370220309,20.0,0.0
7898,0,7898,[302 603 427 187 180],666,5,34609,4.381440688694772,20.0,0.0
7899,0,7899,[302 603 427 187 180],664,5,34614,4.381518987341773,20.0,0.0
7900,0,7900,[302 603 427 187 180],474,5,34619,4.381597266168839,20.0,0.0
7901,0,7901,[  7 238 423 180 318],648,1,34620,4.381169324221716,20.0,0.0
7902,0,7902,[405  11 211 300 483],749,4,34624,4.381121093255726,20.0,0.0
7903,0,7903,[216 655 161 179 475],207,4,34628,4.381072874493927,0.0,0.0
7904,0,7904,[ 50   1 202  11  56],643,4,34632,4.381024667931689,0.0,20.0
7905,0,7905,[302 603 427 187 180],13,5,34637,4.381102959777384,20.0,0.0
7906,0,7906,[302 603 427 187 180],13,5,34642,4.381181231819906,20.0,0.0
7907,0,7907,[302 603 427 187 180],666,5,34647,4.381259484066768,20.0,0.0
7908,0,7908,[302 603 427 187 180],664,5,34652,4.381337716525477,20.0,0.0
7909,0,7909,[302 603 427 187 180],474,5,34657,4.3814159292035395,20.0,0.0
7910,0,7910,[302 603 427 187 180],537,5,34662,4.381494122108457,20.0,0.0
7911,0,7911,[117 144 121 210 597],119,5,34667,4.381572295247725,0.0,0.0
7912,0,7912,[302 603 427 187 180],90,5,34672,4.381650448628839,20.0,0.0
7913,0,7913,[302 603 427 187 180],339,5,34677,4.381728582259288,20.0,0.0
7914,0,7914,[302 603 427 187 180],13,5,34682,4.381806696146557,20.0,0.0
7915,0,7915,[302 603 427 187 180],666,5,34687,4.38188479029813,20.0,0.0
7916,0,7916,[302 603 427 187 180],458,5,34692,4.381962864721485,20.0,0.0
7917,0,7917,[302 603 427 187 180],664,5,34697,4.382040919424097,20.0,0.0
7918,0,7918,[302 603 427 187 180],537,5,34702,4.3821189544134365,20.0,0.0
7919,0,7919,[302 603 427 187 180],458,5,34707,4.382196969696969,20.0,0.0
7920,0,7920,[269 182 275 183 748],64,4,34711,4.382148718596137,0.0,0.0
7921,0,7921,[302 603 427 187 180],90,5,34716,4.38222671042666,20.0,0.0
7922,0,7922,[302 603 427 187 180],90,5,34721,4.382304682569734,20.0,0.0
7923,0,7923,[215 182   8 117 228],387,3,34724,4.382130237253913,0.0,0.0
7924,0,7924,[  9 168 179 180 228],881,2,34726,4.381829652996846,0.0,0.0
7925,0,7925,[302 603 427 187 180],271,5,34731,4.381907645722937,20.0,0.0
7926,0,7926,[318  89 144 313 135],64,3,34734,4.381733316513182,20.0,0.0
7927,0,7927,[ 56   8 276  70 289],234,2,34736,4.381432896064581,0.0,0.0
7928,0,7928,[603 546 288 245 333],666,2,34738,4.381132551393619,20.0,0.0
7929,0,7929,[302 603 427 187 180],474,5,34743,4.381210592686003,20.0,0.0
7930,0,7930,[302 603 427 187 180],271,5,34748,4.381288614298323,20.0,0.0
7931,0,7931,[302 603 427 187 180],339,5,34753,4.381366616238023,20.0,0.0
7932,0,7932,[302 603 427 187 180],90,5,34758,4.381444598512543,20.0,0.0
7933,0,7933,[210  15 655 195 144],308,3,34761,4.3812704814721455,0.0,0.0
7934,0,7934,[ 15 235 423  79  71],313,3,34764,4.38109640831758,0.0,0.0
7935,0,7935,[302 603 427 187 180],664,5,34769,4.38117439516129,20.0,0.0
7936,0,7936,[302 603 427 187 180],664,5,34774,4.381252362353534,20.0,0.0
7937,0,7937,[196   9 175 200 318],343,4,34778,4.381204333585286,20.0,0.0
7938,0,7938,[302 603 427 187 180],664,5,34783,4.381282277364908,20.0,0.0
7939,0,7939,[302 603 427 187 180],13,5,34788,4.381360201511335,20.0,0.0
7940,0,7940,[302 603 427 187 180],666,5,34793,4.381438106031986,20.0,0.0
7941,0,7941,[302 603 427 187 180],271,5,34798,4.381515990934274,20.0,0.0
7942,0,7942,[ 88   8 176 183 276],308,5,34803,4.381593856225607,0.0,0.0
7943,0,7943,[302 603 427 187 180],339,5,34808,4.381671701913394,20.0,0.0
7944,0,7944,[302 603 427 187 180],90,5,34813,4.3817495280050345,20.0,0.0
7945,0,7945,[471 215 210 273  28],234,1,34814,4.38132393657186,0.0,0.0
7946,0,7946,[322   4  64 245 655],328,3,34817,4.3811501195419655,0.0,0.0
7947,0,7947,[174 323 191 748  25],648,3,34820,4.3809763462506295,0.0,20.0
7948,0,7948,[302 603 427 187 180],339,5,34825,4.3810542206566865,20.0,0.0
7949,0,7949,[ 64 588  96 323 185],881,2,34827,4.380754716981132,0.0,0.0
7950,0,7950,[302 603 427 187 180],90,5,34832,4.380832599672997,20.0,0.0
7951,0,7951,[302 603 427 187 180],271,5,34837,4.38091046277666,20.0,0.0
7952,0,7952,[302 603 427 187 180],90,5,34842,4.38098830629951,20.0,0.0
7953,0,7953,[302  11 508 258  70],207,3,34845,4.380814684435504,0.0,0.0
7954,0,7954,[302 603 427 187 180],664,5,34850,4.3808925204274045,20.0,0.0
7955,0,7955,[302 603 427 187 180],271,5,34855,4.38097033685269,20.0,0.0
7956,0,7956,[423 121 237  69 357],474,5,34860,4.381048133718738,20.0,0.0
7957,0,7957,[194  96 405 153 237],749,3,34863,4.380874591605931,0.0,0.0
7958,0,7958,[568 174  96 742 186],158,4,34867,4.380826737027265,0.0,20.0
7959,0,7959,[302 603 427 187 180],339,5,34872,4.380904522613065,20.0,0.0
7960,0,7960,[302 603 427 187 180],537,5,34877,4.380982288657204,20.0,0.0
7961,0,7961,[187 182 655 161 186],318,4,34881,4.380934438583271,0.0,0.0
7962,0,7962,[ 64 271 294 100 222],676,4,34885,4.38088660052744,0.0,20.0
7963,0,7963,[302 603 427 187 180],13,5,34890,4.380964339527876,20.0,0.0
7964,0,7964,[286 176 257 294 202],271,3,34893,4.380790960451978,0.0,0.0
7965,0,7965,[302 603 427 187 180],90,5,34898,4.380868691940748,20.0,0.0
7966,0,7966,[302 603 427 187 180],458,5,34903,4.3809464039161545,20.0,0.0
7967,0,7967,[197 427  71 211 215],59,4,34907,4.38089859437751,0.0,0.0
7968,0,7968,[302 603 427 187 180],666,5,34912,4.3809762830970005,20.0,0.0
7969,0,7969,[302 603 427 187 180],90,5,34917,4.381053952321205,20.0,0.0
7970,0,7970,[302 603 427 187 180],271,5,34922,4.381131602057458,20.0,0.0
7971,0,7971,[302 603 427 187 180],474,5,34927,4.381209232313096,20.0,0.0
7972,0,7972,[ 64  11 195 257 234],454,3,34930,4.381035996488148,0.0,0.0
7973,0,7973,[302 603 427 187 180],90,5,34935,4.381113619262604,20.0,0.0
7974,0,7974,[302 603 427 187 180],339,5,34940,4.381191222570533,20.0,0.0
7975,0,7975,[286  69   7 173 405],200,4,34944,4.381143430290873,0.0,0.0
7976,0,7976,[302 603 427 187 180],271,5,34949,4.381221010404914,20.0,0.0
7977,0,7977,[302 603 427 187 180],458,5,34954,4.3812985710704435,20.0,0.0
7978,0,7978,[302 603 427 187 180],666,5,34959,4.381376112294774,20.0,0.0
7979,0,7979,[302 603 427 187 180],537,5,34964,4.381453634085213,20.0,0.0
7980,0,7980,[302 603 427 187 180],474,5,34969,4.381531136449066,20.0,0.0
7981,0,7981,[427 515 183 238  64],833,1,34970,4.381107491856677,0.0,0.0
7982,0,7982,[200 118  98   4 385],738,3,34973,4.380934485782287,0.0,20.0
7983,0,7983,[ 97 300 328 435  25],533,4,34977,4.380886773547094,0.0,0.0
7984,0,7984,[302 603 427 187 180],474,5,34982,4.380964308077646,20.0,0.0
7985,0,7985,[302 603 427 187 180],537,5,34987,4.381041823190584,20.0,0.0
7986,0,7986,[302 603 427 187 180],90,5,34992,4.381119318893202,20.0,0.0
7987,0,7987,[191 423 603 100 168],452,5,34997,4.381196795192789,20.0,20.0
7988,0,7988,[302 603 427 187 180],13,5,35002,4.381274252096633,20.0,0.0
7989,0,7989,[302 603 427 187 180],13,5,35007,4.381351689612015,20.0,0.0
7990,0,7990,[302 603 427 187 180],339,5,35012,4.381429107746214,20.0,0.0
7991,0,7991,[302 603 427 187 180],474,5,35017,4.381506506506507,20.0,0.0
7992,0,7992,[180  22 204 238 181],7,4,35021,4.381458776429375,0.0,0.0
7993,0,7993,[302 603 427 187 180],271,5,35026,4.381536152114085,20.0,0.0
7994,0,7994,[238 181 265 211 234],234,1,35027,4.381113195747342,0.0,0.0
7995,0,7995,[302 603 427 187 180],339,5,35032,4.381190595297649,20.0,0.0
7996,0,7996,[302 603 427 187 180],90,5,35037,4.381267975490809,20.0,0.0
7997,0,7997,[228  89 117 216 265],648,4,35041,4.381220305076269,0.0,0.0
7998,0,7998,[302 603 427 187 180],537,5,35046,4.381297662207776,20.0,0.0
7999,0,7999,[ 82 234   4 286 125],455,3,35049,4.381125,0.0,0.0
8000,0,8000,[302 603 427 187 180],537,5,35054,4.381202349706287,20.0,0.0
8001,0,8001,[471   1 294 202 151],699,0,35054,4.380654836290927,0.0,0.0
8002,0,8002,[302 603 427 187 180],13,5,35059,4.3807322254154695,20.0,0.0
8003,0,8003,[ 98 405 222 172   7],666,2,35061,4.380434782608695,0.0,20.0
8004,0,8004,[282 127  56 200 197],653,3,35064,4.380262336039975,0.0,20.0
8005,0,8005,[200  69 143  89 100],343,3,35067,4.380089932550587,0.0,20.0
8006,0,8006,[302 603 427 187 180],271,5,35072,4.38016735356563,20.0,0.0
8007,0,8007,[302 603 427 187 180],90,5,35077,4.380244755244755,20.0,0.0
8008,0,8008,[302 603 427 187 180],664,5,35082,4.380322137595205,20.0,0.0
8009,0,8009,[302 603 427 187 180],271,5,35087,4.38039950062422,20.0,0.0
8010,0,8010,[302 603 427 187 180],664,5,35092,4.380476844339034,20.0,0.0
8011,0,8011,[302 603 427 187 180],90,5,35097,4.38055416874688,20.0,0.0
8012,0,8012,[302 603 427 187 180],537,5,35102,4.380631473854986,20.0,0.0
8013,0,8013,[302 603 427 187 180],458,5,35107,4.3807087596705765,20.0,0.0
8014,0,8014,[302 603 427 187 180],13,5,35112,4.380786026200873,20.0,0.0
8015,0,8015,[275  12 742  89   7],119,4,35116,4.380738522954092,20.0,0.0
8016,0,8016,[302 603 427 187 180],666,5,35121,4.3808157664961955,20.0,0.0
8017,0,8017,[302 603 427 187 180],271,5,35126,4.380892990770766,20.0,0.0
8018,0,8018,[423  22 175  89 216],6,3,35129,4.380720788128196,0.0,0.0
8019,0,8019,[151 187 153 234 742],648,3,35132,4.380548628428928,0.0,0.0
8020,0,8020,[234 475 269 196 117],339,4,35136,4.380501184390973,0.0,0.0
8021,0,8021,[302 603 427 187 180],339,5,35141,4.380578409374221,20.0,0.0
8022,0,8022,[ 89 435  25 234  64],59,5,35146,4.380655615106568,0.0,0.0
8023,0,8023,[ 69  97 179 132 180],95,2,35148,4.380358923230309,0.0,0.0
8024,0,8024,[302 603 427 187 180],90,5,35153,4.380436137071651,20.0,0.0
8025,0,8025,[  8 276 121 211 546],207,1,35154,4.380014951407924,0.0,0.0
8026,0,8026,[269 117 276 268 678],334,2,35156,4.379718450230472,0.0,0.0
8027,0,8027,[302 603 427 187 180],474,5,35161,4.379795714997509,20.0,0.0
8028,0,8028,[222 405 288 265 200],92,2,35163,4.379499314983186,0.0,0.0
8029,0,8029,[302 603 427 187 180],339,5,35168,4.379576587795766,20.0,0.0
8030,0,8030,[275 197  64  15 265],378,4,35172,4.3795293238700035,0.0,0.0
8031,0,8031,[357 483 183 195 427],7,5,35177,4.379606573705179,40.0,0.0
8032,0,8032,[302 603 427 187 180],537,5,35182,4.379683804307232,20.0,0.0
8033,0,8033,[302 603 427 187 180],474,5,35187,4.3797610156833455,20.0,0.0
8034,0,8034,[286 435 186   8 568],85,3,35190,4.379589296826385,0.0,0.0
8035,0,8035,[328 187 172 471  97],328,3,35193,4.379417620706819,0.0,0.0
8036,0,8036,[302 603 427 187 180],339,5,35198,4.379494836381735,20.0,0.0
8037,0,8037,[302 603 427 187 180],339,5,35203,4.379572032843991,20.0,0.0
8038,0,8038,[302 603 427 187 180],664,5,35208,4.379649210100759,20.0,0.0
8039,0,8039,[ 22  71 403 197 235],378,4,35212,4.379601990049752,0.0,0.0
8040,0,8040,[302 603 427 187 180],271,5,35217,4.379679144385027,20.0,0.0
8041,0,8041,[302 603 427 187 180],537,5,35222,4.3797562795324545,20.0,0.0
8042,0,8042,[302 603 427 187 180],339,5,35227,4.379833395499192,20.0,0.0
8043,0,8043,[191 168 385 174 269],7,4,35231,4.379786176031825,0.0,20.0
8044,0,8044,[300  79 286  25 216],145,2,35233,4.379490366687383,0.0,0.0
8045,0,8045,[ 79 180  22 313 269],378,4,35237,4.379443201590853,0.0,0.0
8046,0,8046,[302 603 427 187 180],90,5,35242,4.3795203181309805,20.0,0.0
8047,0,8047,[302 603 427 187 180],458,5,35247,4.379597415506958,20.0,0.0
8048,0,8048,[302 603 427 187 180],664,5,35252,4.379674493725929,20.0,0.0
8049,0,8049,[423 471   1 328 588],537,0,35252,4.379130434782609,0.0,0.0
8050,0,8050,[302 603 427 187 180],666,5,35257,4.379207551856912,20.0,0.0
8051,0,8051,[318  98 194 211 237],537,2,35259,4.378912071535022,20.0,20.0
8052,0,8052,[302 603 427 187 180],458,5,35264,4.3789891965727055,20.0,0.0
8053,0,8053,[302 603 427 187 180],13,5,35269,4.379066302458406,20.0,0.0
8054,0,8054,[302 603 427 187 180],13,5,35274,4.379143389199255,20.0,0.0
8055,0,8055,[185 323 265 173  28],804,5,35279,4.379220456802384,0.0,0.0
8056,0,8056,[117 301 302 234 275],328,4,35283,4.3791733895991065,0.0,0.0
8057,0,8057,[302 603 427 187 180],664,5,35288,4.379250434350956,20.0,0.0
8058,0,8058,[302 603 427 187 180],90,5,35293,4.379327459982628,20.0,0.0
8059,0,8059,[302 603 427 187 180],537,5,35298,4.37940446650124,20.0,0.0
8060,0,8060,[302 603 427 187 180],458,5,35303,4.379481453913907,20.0,0.0
8061,0,8061,[302 603 427 187 180],474,5,35308,4.379558422227735,20.0,0.0
8062,0,8062,[302 603 427 187 180],664,5,35313,4.379635371449832,20.0,0.0
8063,0,8063,[588 328  12 187 273],234,1,35314,4.37921626984127,20.0,0.0
8064,0,8064,[302 603 427 187 180],666,5,35319,4.379293242405455,20.0,0.0
8065,0,8065,[357 427 385   1 179],343,4,35323,4.37924621869576,20.0,0.0
8066,0,8066,[405 185 197   1  69],648,3,35326,4.379075244824594,0.0,0.0
8067,0,8067,[302 603 427 187 180],537,5,35331,4.379152206246902,20.0,0.0
8068,0,8068,[  7 357 318  70  11],13,0,35331,4.378609493121824,40.0,0.0
8069,0,8069,[202 483 191  28 357],313,4,35335,4.378562577447336,40.0,0.0
8070,0,8070,[  1  98 125  28 546],200,4,35339,4.378515673398588,0.0,20.0
8071,0,8071,[302 603 427 187 180],537,5,35344,4.378592666005947,20.0,0.0
8072,0,8072,[302 603 427 187 180],666,5,35349,4.378669639539205,20.0,0.0
8073,0,8073,[302 603 427 187 180],458,5,35354,4.37874659400545,20.0,0.0
8074,0,8074,[302 603 427 187 180],339,5,35359,4.378823529411765,20.0,0.0
8075,0,8075,[302 603 427 187 180],666,5,35364,4.378900445765231,20.0,0.0
8076,0,8076,[302 603 427 187 180],666,5,35369,4.378977343072923,20.0,0.0
8077,0,8077,[  1 135  88 603  82],533,4,35373,4.378930428323843,20.0,0.0
8078,0,8078,[210  15 245  25 127],207,3,35376,4.378759747493501,0.0,20.0
8079,0,8079,[289 405  89 471 127],524,4,35380,4.378712871287129,0.0,20.0
8080,0,8080,[405 496 269 181 323],537,1,35381,4.378294765499319,0.0,0.0
8081,0,8081,[302 603 427 187 180],90,5,35386,4.378371690175699,20.0,0.0
8082,0,8082,[ 22 121 117 403 118],638,3,35389,4.378201162934554,0.0,0.0
8083,0,8083,[508 423 286 427 483],334,4,35393,4.378154379020287,20.0,0.0
8084,0,8084,[302 603 427 187 180],474,5,35398,4.378231292517007,20.0,0.0
8085,0,8085,[275   7 216 168 235],13,1,35399,4.377813504823151,0.0,0.0
8086,0,8086,[302 603 427 187 180],666,5,35404,4.37789044144924,20.0,0.0
8087,0,8087,[302 603 427 187 180],474,5,35409,4.377967359050445,20.0,0.0
8088,0,8088,[197  22  97  15 132],488,3,35412,4.377797008282854,0.0,0.0
8089,0,8089,[302 603 427 187 180],13,5,35417,4.3778739184178,20.0,0.0
8090,0,8090,[302 603 427 187 180],339,5,35422,4.377950809541466,20.0,0.0
8091,0,8091,[ 98 202 222 301  25],145,4,35426,4.377904102817598,0.0,20.0
8092,0,8092,[748 318  50 127 235],479,3,35429,4.37773384406277,20.0,40.0
8093,0,8093,[302 603 427 187 180],13,5,35434,4.377810723993082,20.0,0.0
8094,0,8094,[302 603 427 187 180],339,5,35439,4.377887584928969,20.0,0.0
8095,0,8095,[302 603 427 187 180],13,5,35444,4.377964426877471,20.0,0.0
8096,0,8096,[588 132 186 153 173],312,2,35446,4.377670742250216,0.0,0.0
8097,0,8097,[302 603 427 187 180],13,5,35451,4.377747591998024,20.0,0.0
8098,0,8098,[302 603 427 187 180],458,5,35456,4.377824422768243,20.0,0.0
8099,0,8099,[302 603 427 187 180],90,5,35461,4.377901234567902,20.0,0.0
8100,0,8100,[302 603 427 187 180],339,5,35466,4.3779780274040245,20.0,0.0
8101,0,8101,[181 151 273 238 515],537,2,35468,4.377684522340163,0.0,0.0
8102,0,8102,[302 603 427 187 180],271,5,35473,4.377761322966802,20.0,0.0
8103,0,8103,[302 603 427 187 180],537,5,35478,4.377838104639684,20.0,0.0
8104,0,8104,[302 603 427 187 180],458,5,35483,4.377914867365823,20.0,0.0
8105,0,8105,[302 603 427 187 180],90,5,35488,4.377991611152233,20.0,0.0
8106,0,8106,[302 603 427 187 180],458,5,35493,4.378068336005921,20.0,0.0
8107,0,8107,[302 603 427 187 180],537,5,35498,4.378145041933893,20.0,0.0
8108,0,8108,[302 603 427 187 180],537,5,35503,4.378221728943149,20.0,0.0
8109,0,8109,[302 603 427 187 180],458,5,35508,4.37829839704069,20.0,0.0
8110,0,8110,[302 603 427 187 180],458,5,35513,4.3783750462335105,20.0,0.0
8111,0,8111,[  8 100 118 423  89],892,5,35518,4.3784516765285995,0.0,20.0
8112,0,8112,[302 603 427 187 180],271,5,35523,4.378528287932947,20.0,0.0
8113,0,8113,[ 89 173 271   4 144],144,3,35526,4.378358392901158,0.0,0.0
8114,0,8114,[180 100 328 471  56],328,4,35530,4.378311768330253,0.0,20.0
8115,0,8115,[302 603 427 187 180],664,5,35535,4.37838836865451,20.0,0.0
8116,0,8116,[302 603 427 187 180],339,5,35540,4.378464950104719,20.0,0.0
8117,0,8117,[302 603 427 187 180],271,5,35545,4.378541512687854,20.0,0.0
8118,0,8118,[302 603 427 187 180],664,5,35550,4.378618056410888,20.0,0.0
8119,0,8119,[302 603 427 187 180],13,5,35555,4.378694581280788,20.0,0.0
8120,0,8120,[302 603 427 187 180],666,5,35560,4.37877108730452,20.0,0.0
8121,0,8121,[302 603 427 187 180],664,5,35565,4.3788475744890425,20.0,0.0
8122,0,8122,[302 603 427 187 180],458,5,35570,4.378924042841315,20.0,0.0
8123,0,8123,[302 603 427 187 180],666,5,35575,4.3790004923682915,20.0,0.0
8124,0,8124,[ 56  70 204  22 405],7,3,35578,4.3788307692307695,0.0,0.0
8125,0,8125,[ 71 185  28 215  98],815,4,35582,4.378784149643121,0.0,20.0
8126,0,8126,[302 603 427 187 180],664,5,35587,4.3788605881629135,20.0,0.0
8127,0,8127,[302 603 427 187 180],271,5,35592,4.378937007874016,20.0,0.0
8128,0,8128,[302 603 427 187 180],537,5,35597,4.3790134087833685,20.0,0.0
8129,0,8129,[  8  64 603 183 153],326,5,35602,4.379089790897909,20.0,0.0
8130,0,8130,[257 286 328 234 300],548,4,35606,4.379043168122002,0.0,0.0
8131,0,8131,[302 603 427 187 180],664,5,35611,4.379119527791441,20.0,0.0
8132,0,8132,[153 568 187 185 191],7,5,35616,4.3791958686831425,0.0,0.0
8133,0,8133,[302 603 427 187 180],90,5,35621,4.379272190804032,20.0,0.0
8134,0,8134,[655 471 204  12 237],13,4,35625,4.379225568531039,20.0,0.0
8135,0,8135,[302 603 427 187 180],474,5,35630,4.379301868239922,20.0,0.0
8136,0,8136,[302 603 427 187 180],339,5,35635,4.379378149195035,20.0,0.0
8137,0,8137,[302 603 427 187 180],537,5,35640,4.379454411403294,20.0,0.0
8138,0,8138,[ 96 117 182  25 318],892,5,35645,4.379530654871606,20.0,0.0
8139,0,8139,[302 603 427 187 180],537,5,35650,4.37960687960688,20.0,0.0
8140,0,8140,[185 117 216 235 186],406,3,35653,4.379437415550915,0.0,0.0
8141,0,8141,[302 603 427 187 180],537,5,35658,4.379513633014001,20.0,0.0
8142,0,8142,[ 25 742 195  69 265],207,3,35661,4.379344222031192,0.0,0.0
8143,0,8143,[194 186 211 258 427],13,5,35666,4.379420432220039,0.0,0.0
8144,0,8144,[302 603 427 187 180],458,5,35671,4.379496623695519,20.0,0.0
8145,0,8145,[111  71 185 195  69],95,4,35675,4.379450036827891,0.0,0.0
8146,0,8146,[435 151  98 143 210],533,4,35679,4.379403461396834,0.0,20.0
8147,0,8147,[257  64 475 174 357],343,4,35683,4.379356897398135,20.0,20.0
8148,0,8148,[132 172 496  28 180],234,3,35686,4.379187630384096,0.0,0.0
8149,0,8149,[ 71  98 181   1 258],184,4,35690,4.379141104294479,0.0,20.0
8150,0,8150,[302 603 427 187 180],666,5,35695,4.379217273954116,20.0,0.0
8151,0,8151,[302 603 427 187 180],339,5,35700,4.379293424926399,20.0,0.0
8152,0,8152,[302 603 427 187 180],339,5,35705,4.379369557218202,20.0,0.0
8153,0,8153,[302 603 427 187 180],474,5,35710,4.379445670836399,20.0,0.0
8154,0,8154,[302 603 427 187 180],339,5,35715,4.37952176578786,20.0,0.0
8155,0,8155,[302 603 427 187 180],90,5,35720,4.379597842079451,20.0,0.0
8156,0,8156,[302 603 427 187 180],458,5,35725,4.379673899718034,20.0,0.0
8157,0,8157,[211 172 568 471 144],313,5,35730,4.379749938710468,0.0,0.0
8158,0,8158,[302 603 427 187 180],537,5,35735,4.379825959063611,20.0,0.0
8159,0,8159,[302 603 427 187 180],537,5,35740,4.379901960784314,20.0,0.0
8160,0,8160,[302 603 427 187 180],664,5,35745,4.379977943879426,20.0,0.0
8161,0,8161,[273 215 405 222 132],13,2,35747,4.379686351384464,0.0,0.0
8162,0,8162,[302 603 427 187 180],90,5,35752,4.379762342276124,20.0,0.0
8163,0,8163,[302 603 427 187 180],666,5,35757,4.37983831455169,20.0,0.0
8164,0,8164,[271 678  79 173 496],537,2,35759,4.379546846295162,0.0,0.0
8165,0,8165,[302 603 427 187 180],13,5,35764,4.379622826353172,20.0,0.0
8166,0,8166,[302 603 427 187 180],90,5,35769,4.379698787804579,20.0,0.0
8167,0,8167,[302 603 427 187 180],537,5,35774,4.379774730656219,20.0,0.0
8168,0,8168,[185 313  82  98 153],653,2,35776,4.379483412902436,0.0,20.0
8169,0,8169,[302 603 427 187 180],339,5,35781,4.379559363525092,20.0,0.0
8170,0,8170,[302 603 427 187 180],13,5,35786,4.379635295557459,20.0,0.0
8171,0,8171,[655 194 144 237 186],749,4,35790,4.379588839941263,0.0,0.0
8172,0,8172,[187  25 135 546  89],313,4,35794,4.379542395693136,0.0,0.0
8173,0,8173,[237 282 143 185 132],406,2,35796,4.3792512845608025,0.0,0.0
8174,0,8174,[302 603 427 187 180],474,5,35801,4.3793272171253825,20.0,0.0
8175,0,8175,[276 282 127   4  82],334,4,35805,4.379280821917808,0.0,20.0
8176,0,8176,[238 153 742 118 175],92,3,35808,4.379112143818026,0.0,0.0
8177,0,8177,[  9 118   7  69 435],455,5,35813,4.3791880655416975,0.0,0.0
8178,0,8178,[302 603 427 187 180],339,5,35818,4.3792639687003305,20.0,0.0
8179,0,8179,[302 603 427 187 180],90,5,35823,4.379339853300733,20.0,0.0
8180,0,8180,[302 603 427 187 180],339,5,35828,4.379415719349713,20.0,0.0
8181,0,8181,[302 603 427 187 180],271,5,35833,4.37949156685407,20.0,0.0
8182,0,8182,[302 603 427 187 180],90,5,35838,4.379567395820604,20.0,0.0
8183,0,8183,[302 603 427 187 180],666,5,35843,4.37964320625611,20.0,0.0
8184,0,8184,[ 88 286 202 211 546],102,1,35844,4.379230299328039,0.0,0.0
8185,0,8185,[302 603 427 187 180],666,5,35849,4.379306132421207,20.0,0.0
8186,0,8186,[318 215   9 174 153],488,4,35853,4.379259802125321,20.0,20.0
8187,0,8187,[302 603 427 187 180],271,5,35858,4.37933561309233,20.0,0.0
8188,0,8188,[597 427 294 179 125],7,3,35861,4.379167175479301,0.0,0.0
8189,0,8189,[187 300 273 318  98],90,3,35864,4.378998778998779,20.0,20.0
8190,0,8190,[302 603 427 187 180],458,5,35869,4.379074594066658,20.0,0.0
8191,0,8191,[302 603 427 187 180],664,5,35874,4.379150390625,20.0,0.0
8192,0,8192,[302 603 427 187 180],13,5,35879,4.379226168680581,20.0,0.0
8193,0,8193,[302 603 427 187 180],474,5,35884,4.379301928240176,20.0,0.0
8194,0,8194,[302 603 427 187 180],537,5,35889,4.379377669310555,20.0,0.0
8195,0,8195,[302 603 427 187 180],458,5,35894,4.379453391898487,20.0,0.0
8196,0,8196,[302 603 427 187 180],474,5,35899,4.379529096010736,20.0,0.0
8197,0,8197,[ 22 603 265 168 318],686,5,35904,4.379604781654062,40.0,0.0
8198,0,8198,[135  82 121 191 483],200,5,35909,4.379680448835224,20.0,0.0
8199,0,8199,[302 603 427 187 180],339,5,35914,4.379756097560976,20.0,0.0
8200,0,8200,[302 603 427 187 180],474,5,35919,4.379831727838068,20.0,0.0
8201,0,8201,[333 143 496 245 132],653,2,35921,4.379541575225555,0.0,0.0
8202,0,8202,[302 603 427 187 180],474,5,35926,4.379617213214678,20.0,0.0
8203,0,8203,[302 603 427 187 180],666,5,35931,4.379692832764505,20.0,0.0
8204,0,8204,[302 603 427 187 180],666,5,35936,4.37976843388178,20.0,0.0
8205,0,8205,[153 265  28 435 174],13,5,35941,4.379844016573239,0.0,20.0
8206,0,8206,[302 603 427 187 180],474,5,35946,4.37991958084562,20.0,0.0
8207,0,8207,[302 603 427 187 180],13,5,35951,4.379995126705653,20.0,0.0
8208,0,8208,[302 603 427 187 180],474,5,35956,4.380070654160068,20.0,0.0
8209,0,8209,[302 603 427 187 180],474,5,35961,4.380146163215591,20.0,0.0
8210,0,8210,[302 603 427 187 180],13,5,35966,4.380221653878943,20.0,0.0
8211,0,8211,[302 603 427 187 180],271,5,35971,4.380297126156844,20.0,0.0
8212,0,8212,[302 603 427 187 180],13,5,35976,4.380372580056009,20.0,0.0
8213,0,8213,[302 603 427 187 180],664,5,35981,4.380448015583151,20.0,0.0
8214,0,8214,[483 222 603   7 194],82,3,35984,4.3802799756542905,40.0,0.0
8215,0,8215,[216  98 508 423 237],537,1,35985,4.379868549172347,0.0,20.0
8216,0,8216,[302 603 427 187 180],458,5,35990,4.379944018498235,20.0,0.0
8217,0,8217,[302 603 427 187 180],339,5,35995,4.380019469457289,20.0,0.0
8218,0,8218,[302 603 427 187 180],474,5,36000,4.380094902056212,20.0,0.0
8219,0,8219,[302 603 427 187 180],13,5,36005,4.380170316301703,20.0,0.0
8220,0,8220,[302 603 427 187 180],339,5,36010,4.3802457122004625,20.0,0.0
8221,0,8221,[302 603 427 187 180],339,5,36015,4.380321089759183,20.0,0.0
8222,0,8222,[302 603 427 187 180],474,5,36020,4.3803964489845555,20.0,0.0
8223,0,8223,[302 603 427 187 180],271,5,36025,4.380471789883268,20.0,0.0
8224,0,8224,[302 603 427 187 180],537,5,36030,4.380547112462006,20.0,0.0
8225,0,8225,[179 117 655 603 197],334,4,36034,4.380500850960369,20.0,0.0
8226,0,8226,[302 603 427 187 180],666,5,36039,4.380576151695636,20.0,0.0
8227,0,8227,[302 603 427 187 180],666,5,36044,4.38065143412737,20.0,0.0
8228,0,8228,[302 603 427 187 180],666,5,36049,4.380726698262244,20.0,0.0
8229,0,8229,[302 603 427 187 180],664,5,36054,4.380801944106926,20.0,0.0
8230,0,8230,[302 603 427 187 180],666,5,36059,4.380877171668084,20.0,0.0
8231,0,8231,[302 603 427 187 180],90,5,36064,4.380952380952381,20.0,0.0
8232,0,8232,[302 603 427 187 180],90,5,36069,4.381027571966476,20.0,0.0
8233,0,8233,[302 603 427 187 180],537,5,36074,4.381102744717027,20.0,0.0
8234,0,8234,[302 603 427 187 180],664,5,36079,4.3811778992106865,20.0,0.0
8235,0,8235,[118 496   9  22 258],749,3,36082,4.3810101991257895,0.0,0.0
8236,0,8236,[302 603 427 187 180],271,5,36087,4.381085346606774,20.0,0.0
8237,0,8237,[302 603 427 187 180],537,5,36092,4.381160475843651,20.0,0.0
8238,0,8238,[302 603 427 187 180],666,5,36097,4.381235586843063,20.0,0.0
8239,0,8239,[302 603 427 187 180],458,5,36102,4.3813106796116505,20.0,0.0
8240,0,8240,[302 603 427 187 180],666,5,36107,4.381385754156049,20.0,0.0
8241,0,8241,[302 603 427 187 180],664,5,36112,4.381460810482893,20.0,0.0
8242,0,8242,[153 168  98 655 427],664,4,36116,4.381414533543612,0.0,20.0
8243,0,8243,[302 603 427 187 180],537,5,36121,4.381489568170791,20.0,0.0
8244,0,8244,[302 603 427 187 180],90,5,36126,4.381564584596726,20.0,0.0
8245,0,8245,[302 603 427 187 180],664,5,36131,4.381639582828038,20.0,0.0
8246,0,8246,[302 603 427 187 180],664,5,36136,4.381714562871347,20.0,0.0
8247,0,8247,[118 196 275  11 238],308,3,36139,4.381547041707081,0.0,0.0
8248,0,8248,[302 603 427 187 180],537,5,36144,4.381622014789672,20.0,0.0
8249,0,8249,[302 603 427 187 180],537,5,36149,4.38169696969697,20.0,0.0
8250,0,8250,[ 11   4 204 294 194],7,3,36152,4.381529511574355,0.0,0.0
8251,0,8251,[302 603 427 187 180],339,5,36157,4.381604459524963,20.0,0.0
8252,0,8252,[302 603 427 187 180],13,5,36162,4.3816793893129775,20.0,0.0
8253,0,8253,[125  71 210 173 132],897,4,36166,4.381633147564817,0.0,0.0
8254,0,8254,[302 603 427 187 180],666,5,36171,4.381708055723804,20.0,0.0
8255,0,8255,[302 603 427 187 180],537,5,36176,4.381782945736434,20.0,0.0
8256,0,8256,[302 603 427 187 180],664,5,36181,4.381857817609301,20.0,0.0
8257,0,8257,[302 603 427 187 180],90,5,36186,4.381932671348995,20.0,0.0
8258,0,8258,[302 603 427 187 180],13,5,36191,4.382007506962102,20.0,0.0
8259,0,8259,[180 276 423  12  89],378,4,36195,4.381961259079903,20.0,0.0
8260,0,8260,[546 144 211 183 655],7,5,36200,4.382036073114635,0.0,0.0
8261,0,8261,[568 210 238 111  50],13,2,36202,4.381747760832728,0.0,20.0
8262,0,8262,[302 603 427 187 180],339,5,36207,4.3818225825971195,20.0,0.0
8263,0,8263,[302 186 125 286  98],334,3,36210,4.381655372700871,0.0,20.0
8264,0,8264,[403 186 194 237 328],234,1,36211,4.3812462189957655,0.0,0.0
8265,0,8265,[302 603 427 187 180],271,5,36216,4.381321074280184,20.0,0.0
8266,0,8266,[302 603 427 187 180],271,5,36221,4.381395911455184,20.0,0.0
8267,0,8267,[  7 568 182 483 195],328,2,36223,4.381107885824867,20.0,0.0
8268,0,8268,[302 603 427 187 180],458,5,36228,4.381182730680856,20.0,0.0
8269,0,8269,[ 28 200 742 546 471],899,4,36232,4.381136638452237,0.0,0.0
8270,0,8270,[257 568 117 273 153],374,3,36235,4.380969653004473,0.0,0.0
8271,0,8271,[302 603 427 187 180],90,5,36240,4.3810444874274665,20.0,0.0
8272,0,8272,[168  98 265 121 216],64,4,36244,4.380998428623232,0.0,20.0
8273,0,8273,[302 603 427 187 180],664,5,36249,4.381073241479333,20.0,0.0
8274,0,8274,[216 185 100 302 403],524,5,36254,4.3811480362537765,0.0,20.0
8275,0,8275,[118 179 237 191 238],271,4,36258,4.381101981633639,0.0,0.0
8276,0,8276,[186 282 300  71  25],85,1,36259,4.3806934879787365,0.0,0.0
8277,0,8277,[302 603 427 187 180],537,5,36264,4.380768301522107,20.0,0.0
8278,0,8278,[302 603 427 187 180],537,5,36269,4.380843096992391,20.0,0.0
8279,0,8279,[302 603 427 187 180],664,5,36274,4.380917874396135,20.0,0.0
8280,0,8280,[302 603 427 187 180],271,5,36279,4.380992633739886,20.0,0.0
8281,0,8281,[302 603 427 187 180],474,5,36284,4.381067375030186,20.0,0.0
8282,0,8282,[ 88 238 144 496 568],892,5,36289,4.381142098273572,0.0,0.0
8283,0,8283,[302 603 427 187 180],666,5,36294,4.3812168034765815,20.0,0.0
8284,0,8284,[302 603 427 187 180],537,5,36299,4.381291490645745,20.0,0.0
8285,0,8285,[302 603 427 187 180],339,5,36304,4.381366159787594,20.0,0.0
8286,0,8286,[748 289 234 117 121],881,2,36306,4.381078798117533,0.0,0.0
8287,0,8287,[302 603 427 187 180],458,5,36311,4.381153474903475,20.0,0.0
8288,0,8288,[  7 222 181 127 515],234,2,36313,4.380866208227772,0.0,20.0
8289,0,8289,[302 603 427 187 180],474,5,36318,4.380940892641737,20.0,0.0
8290,0,8290,[ 12 222  82 435 179],524,3,36321,4.380774333614763,20.0,0.0
8291,0,8291,[302 603 427 187 180],13,5,36326,4.380849011095031,20.0,0.0
8292,0,8292,[173 301 174 289 427],940,3,36329,4.3806825033160495,0.0,20.0
8293,0,8293,[153  28 125 194 427],788,2,36331,4.380395466602363,0.0,0.0
8294,0,8294,[302 603 427 187 180],13,5,36336,4.380470162748644,20.0,0.0
8295,0,8295,[302 603 427 187 180],664,5,36341,4.3805448408871746,20.0,0.0
8296,0,8296,[302 603 427 187 180],474,5,36346,4.380619501024467,20.0,0.0
8297,0,8297,[302 603 427 187 180],666,5,36351,4.3806941431670285,20.0,0.0
8298,0,8298,[302 603 427 187 180],537,5,36356,4.380768767321364,20.0,0.0
8299,0,8299,[302 603 427 187 180],458,5,36361,4.380843373493976,20.0,0.0
8300,0,8300,[302 603 427 187 180],664,5,36366,4.380917961691362,20.0,0.0
8301,0,8301,[302 603 427 187 180],339,5,36371,4.380992531920019,20.0,0.0
8302,0,8302,[288 318 168 121 235],537,2,36373,4.380705768999157,20.0,0.0
8303,0,8303,[496  69 174   9  50],380,4,36377,4.380659922928709,0.0,40.0
8304,0,8304,[302 603 427 187 180],474,5,36382,4.3807344972907885,20.0,0.0
8305,0,8305,[302 603 427 187 180],90,5,36387,4.380809053696123,20.0,0.0
8306,0,8306,[  9 143  82 172  64],749,4,36391,4.3807632117491275,0.0,0.0
8307,0,8307,[435 588  88 174 168],13,5,36396,4.38083774675012,0.0,20.0
8308,0,8308,[191 202 288 357 655],833,3,36399,4.380671560957997,20.0,0.0
8309,0,8309,[302 603 427 187 180],271,5,36404,4.380746089049338,20.0,0.0
8310,0,8310,[302 603 427 187 180],664,5,36409,4.3808205992058715,20.0,0.0
8311,0,8311,[302 603 427 187 180],666,5,36414,4.380895091434072,20.0,0.0
8312,0,8312,[132 181  89   9 153],328,4,36418,4.380849272224227,0.0,0.0
8313,0,8313,[302 603 427 187 180],13,5,36423,4.3809237430839545,20.0,0.0
8314,0,8314,[288  69  64 153 748],92,3,36426,4.380757666867107,0.0,0.0
8315,0,8315,[195  22 300 234 216],13,2,36428,4.380471380471381,0.0,0.0
8316,0,8316,[313 215   1 161 127],234,2,36430,4.380185162919322,0.0,20.0
8317,0,8317,[196 204   1 186 161],378,4,36434,4.380139456600144,0.0,0.0
8318,0,8318,[302 603 427 187 180],90,5,36439,4.380213968025003,20.0,0.0
8319,0,8319,[302 603 427 187 180],339,5,36444,4.380288461538462,20.0,0.0
8320,0,8320,[302 603 427 187 180],537,5,36449,4.380362937146978,20.0,0.0
8321,0,8321,[302 603 427 187 180],271,5,36454,4.3804373948570055,20.0,0.0
8322,0,8322,[302 603 427 187 180],90,5,36459,4.380511834674997,20.0,0.0
8323,0,8323,[235 197 568 100  88],774,0,36459,4.379985583853917,0.0,20.0
8324,0,8324,[125 228   7 282 151],334,4,36463,4.37993993993994,0.0,0.0
8325,0,8325,[302 603 427 187 180],13,5,36468,4.3800144126831615,20.0,0.0
8326,0,8326,[515 273  79 111  12],666,2,36470,4.379728593731236,20.0,0.0
8327,0,8327,[328 515 288  64 202],537,1,36471,4.379322766570605,0.0,0.0
8328,0,8328,[302 603 427 187 180],13,5,36476,4.379397286589026,20.0,0.0
8329,0,8329,[302 603 427 187 180],339,5,36481,4.379471788715486,20.0,0.0
8330,0,8330,[302 603 427 187 180],13,5,36486,4.379546272956428,20.0,0.0
8331,0,8331,[302 603 427 187 180],271,5,36491,4.379620739318291,20.0,0.0
8332,0,8332,[302 603 427 187 180],339,5,36496,4.3796951878075125,20.0,0.0
8333,0,8333,[173 197 185 286 483],60,5,36501,4.379769618430526,20.0,0.0
8334,0,8334,[302 603 427 187 180],664,5,36506,4.379844031193762,20.0,0.0
8335,0,8335,[655 180 318 245 258],92,4,36510,4.379798464491363,20.0,0.0
8336,0,8336,[302 603 427 187 180],537,5,36515,4.379872855943385,20.0,0.0
8337,0,8337,[202 258   8 181 172],899,4,36519,4.37982729671384,0.0,0.0
8338,0,8338,[ 82 117 127 302  22],115,4,36523,4.37978174841108,0.0,20.0
8339,0,8339,[603 276   8  25  98],234,3,36526,4.3796163069544365,20.0,20.0
8340,0,8340,[302 603 427 187 180],271,5,36531,4.379690684570195,20.0,0.0
8341,0,8341,[302 603 427 187 180],271,5,36536,4.379765044353872,20.0,0.0
8342,0,8342,[302 603 427 187 180],13,5,36541,4.379839386311878,20.0,0.0
8343,0,8343,[222 235  22 172 204],92,3,36544,4.37967401725791,0.0,0.0
8344,0,8344,[302 603 427 187 180],474,5,36549,4.379748352306771,20.0,0.0
8345,0,8345,[172 132  79  28  96],406,3,36552,4.379583033788641,0.0,0.0
8346,0,8346,[302 603 427 187 180],90,5,36557,4.379657361926441,20.0,0.0
8347,0,8347,[302 603 427 187 180],90,5,36562,4.379731672256828,20.0,0.0
8348,0,8348,[302 603 427 187 180],13,5,36567,4.379805964786202,20.0,0.0
8349,0,8349,[302 603 427 187 180],13,5,36572,4.379880239520958,20.0,0.0
8350,0,8350,[286 185 238 597 144],13,1,36573,4.379475511914741,0.0,0.0
8351,0,8351,[302 603 427 187 180],458,5,36578,4.379549808429119,20.0,0.0
8352,0,8352,[ 89 179 678 286  79],664,4,36582,4.379504369687537,0.0,0.0
8353,0,8353,[182 403 273 153 271],13,2,36584,4.379219535551831,0.0,0.0
8354,0,8354,[234 282 294 175  88],881,1,36585,4.378815080789946,0.0,0.0
8355,0,8355,[302 603 427 187 180],537,5,36590,4.378889420775491,20.0,0.0
8356,0,8356,[302 603 427 187 180],474,5,36595,4.378963742969965,20.0,0.0
8357,0,8357,[302 603 427 187 180],666,5,36600,4.379038047379756,20.0,0.0
8358,0,8358,[302 603 427 187 180],474,5,36605,4.3791123340112454,20.0,0.0
8359,0,8359,[302 603 427 187 180],271,5,36610,4.3791866028708135,20.0,0.0
8360,0,8360,[273 168 742 195 194],833,2,36612,4.3789020452099034,0.0,0.0
8361,0,8361,[302 603 427 187 180],13,5,36617,4.378976321454197,20.0,0.0
8362,0,8362,[655   9 286   8 427],85,3,36620,4.378811431304555,0.0,0.0
8363,0,8363,[302 603 427 187 180],13,5,36625,4.378885700621712,20.0,0.0
8364,0,8364,[302 603 427 187 180],474,5,36630,4.3789599521817095,20.0,0.0
8365,0,8365,[302 603 427 187 180],271,5,36635,4.379034185990916,20.0,0.0
8366,0,8366,[302 603 427 187 180],339,5,36640,4.379108402055695,20.0,0.0
8367,0,8367,[568 313 180 185 187],659,5,36645,4.379182600382409,0.0,0.0
8368,0,8368,[111 168  56 117 210],374,3,36648,4.379017803799737,0.0,0.0
8369,0,8369,[302 603 427 187 180],664,5,36653,4.379091995221027,20.0,0.0
8370,0,8370,[302 603 427 187 180],474,5,36658,4.379166168916497,20.0,0.0
8371,0,8371,[302 603 427 187 180],90,5,36663,4.379240324892499,20.0,0.0
8372,0,8372,[228   9 294 181  12],234,0,36663,4.378717305625224,20.0,0.0
8373,0,8373,[186 215  88 603 144],60,5,36668,4.378791497492238,20.0,0.0
8374,0,8374,[125 185 132 151 300],7,5,36673,4.378865671641791,0.0,0.0
8375,0,8375,[302 603 427 187 180],458,5,36678,4.378939828080229,20.0,0.0
8376,0,8376,[302 603 427 187 180],90,5,36683,4.379013966813895,20.0,0.0
8377,0,8377,[302 603 427 187 180],474,5,36688,4.379088087849128,20.0,0.0
8378,0,8378,[302 603 427 187 180],664,5,36693,4.3791621911922665,20.0,0.0
8379,0,8379,[288 111  96  11 403],378,2,36695,4.378878281622912,0.0,0.0
8380,0,8380,[302 603 427 187 180],458,5,36700,4.378952392315953,20.0,0.0
8381,0,8381,[302 603 427 187 180],271,5,36705,4.3790264853256975,20.0,0.0
8382,0,8382,[302 603 427 187 180],271,5,36710,4.379100560658475,20.0,0.0
8383,0,8383,[269   4 135  97  64],666,5,36715,4.379174618320611,0.0,0.0
8384,0,8384,[215 603  89 118 655],749,4,36719,4.379129397734049,20.0,0.0
8385,0,8385,[302 603 427 187 180],537,5,36724,4.379203434295254,20.0,0.0
8386,0,8386,[302 603 427 187 180],666,5,36729,4.379277453201383,20.0,0.0
8387,0,8387,[302 603 427 187 180],664,5,36734,4.37935145445875,20.0,0.0
8388,0,8388,[202 185 187 286  11],406,2,36736,4.3790678269162,0.0,0.0
8389,0,8389,[302 603 427 187 180],664,5,36741,4.379141835518475,20.0,0.0
8390,0,8390,[271  56   1 197   7],883,3,36744,4.378977475867,0.0,0.0
8391,0,8391,[289  56   1 471 271],13,1,36745,4.378574833174452,0.0,0.0
8392,0,8392,[302 603 427 187 180],474,5,36750,4.378648874061718,20.0,0.0
8393,0,8393,[302 603 427 187 180],13,5,36755,4.3787228973076004,20.0,0.0
8394,0,8394,[546 179 173 194 161],648,4,36759,4.378677784395474,0.0,0.0
8395,0,8395,[  7  95 228 403   9],334,4,36763,4.378632682229633,0.0,0.0
8396,0,8396,[471 237 546 180 257],666,3,36766,4.3784685006549955,0.0,0.0
8397,0,8397,[302 603 427 187 180],13,5,36771,4.3785425101214575,20.0,0.0
8398,0,8398,[302 603 427 187 180],90,5,36776,4.37861650196452,20.0,0.0
8399,0,8399,[168 196  12 288 265],892,5,36781,4.378690476190476,20.0,0.0
8400,0,8400,[483 168 127 180 238],95,3,36784,4.3785263659088205,20.0,20.0
8401,0,8401,[302 603 427 187 180],666,5,36789,4.378600333253988,20.0,0.0
8402,0,8402,[302 603 427 187 180],537,5,36794,4.378674282994169,20.0,0.0
8403,0,8403,[313 483  70 191 269],233,5,36799,4.37874821513565,20.0,0.0
8404,0,8404,[302 603 427 187 180],90,5,36804,4.378822129684711,20.0,0.0
8405,0,8405,[302 603 427 187 180],664,5,36809,4.378896026647633,20.0,0.0
8406,0,8406,[269 294  12  50 132],378,4,36813,4.378850957535387,20.0,20.0
8407,0,8407,[302 603 427 187 180],13,5,36818,4.378924833491912,20.0,0.0
8408,0,8408,[302 603 427 187 180],474,5,36823,4.37899869187775,20.0,0.0
8409,0,8409,[302 603 427 187 180],666,5,36828,4.379072532699167,20.0,0.0
8410,0,8410,[  1 215 176 200  97],788,2,36830,4.378789680180716,0.0,0.0
8411,0,8411,[302 603 427 187 180],13,5,36835,4.378863528292915,20.0,0.0
8412,0,8412,[302 603 427 187 180],474,5,36840,4.3789373588494,20.0,0.0
8413,0,8413,[302 603 427 187 180],339,5,36845,4.37901117185643,20.0,0.0
8414,0,8414,[302 603 427 187 180],474,5,36850,4.379084967320262,20.0,0.0
8415,0,8415,[257 182  15 135 175],653,1,36851,4.378683460076045,0.0,0.0
8416,0,8416,[275 204 273  98 179],378,4,36855,4.378638469763573,0.0,20.0
8417,0,8417,[302 268 588 151 258],537,3,36858,4.37847469707769,0.0,0.0
8418,0,8418,[435 322 176 211  50],474,5,36863,4.378548521202043,0.0,20.0
8419,0,8419,[603 187  50 215 257],533,5,36868,4.378622327790974,20.0,20.0
8420,0,8420,[302 603 427 187 180],666,5,36873,4.378696116850731,20.0,0.0
8421,0,8421,[302 603 427 187 180],13,5,36878,4.3787698883875565,20.0,0.0
8422,0,8422,[302 603 427 187 180],664,5,36883,4.378843642407693,20.0,0.0
8423,0,8423,[302 603 427 187 180],339,5,36888,4.378917378917379,20.0,0.0
8424,0,8424,[302 603 427 187 180],90,5,36893,4.378991097922849,20.0,0.0
8425,0,8425,[302 603 427 187 180],474,5,36898,4.379064799430335,20.0,0.0
8426,0,8426,[ 69  95 121 427  64],899,4,36902,4.379019817254064,0.0,0.0
8427,0,8427,[508 172 405 132 357],653,1,36903,4.378618889416232,20.0,0.0
8428,0,8428,[181  88  12 423 435],60,5,36908,4.378692608850398,20.0,0.0
8429,0,8429,[302 603 427 187 180],90,5,36913,4.378766310794781,20.0,0.0
8430,0,8430,[ 98 151  82 182 288],843,1,36914,4.378365555687345,0.0,20.0
8431,0,8431,[302 603 427 187 180],90,5,36919,4.378439278937382,20.0,0.0
8432,0,8432,[302 603 427 187 180],13,5,36924,4.378512984702953,20.0,0.0
8433,0,8433,[302 603 427 187 180],90,5,36929,4.378586672990277,20.0,0.0
8434,0,8434,[302 603 427 187 180],13,5,36934,4.3786603438055725,20.0,0.0
8435,0,8435,[515 117 180 427 357],343,4,36938,4.378615457562826,20.0,0.0
8436,0,8436,[302 603 427 187 180],271,5,36943,4.378689107502667,20.0,0.0
8437,0,8437,[302 603 427 187 180],458,5,36948,4.3787627399857785,20.0,0.0
8438,0,8438,[302 603 427 187 180],664,5,36953,4.378836355018367,20.0,0.0
8439,0,8439,[302 603 427 187 180],474,5,36958,4.3789099526066355,20.0,0.0
8440,0,8440,[ 25 173 496 204 144],234,1,36959,4.378509655254117,0.0,0.0
8441,0,8441,[  1 135 185 216  50],10,5,36964,4.3785832741056625,0.0,20.0
8442,0,8442,[302 603 427 187 180],90,5,36969,4.378656875518181,20.0,0.0
8443,0,8443,[302 603 427 187 180],458,5,36974,4.378730459497868,20.0,0.0
8444,0,8444,[302 603 427 187 180],339,5,36979,4.378804026050918,20.0,0.0
8445,0,8445,[302 603 427 187 180],458,5,36984,4.378877575183519,20.0,0.0
8446,0,8446,[405 515   9 288  89],334,3,36987,4.378714336450811,0.0,0.0
8447,0,8447,[238 328 265 132 100],804,5,36992,4.378787878787879,0.0,20.0
8448,0,8448,[  1  25 546  96 228],882,3,36995,4.378624689312344,0.0,0.0
8449,0,8449,[322 597  71  56  79],92,3,36998,4.378461538461538,0.0,0.0
8450,0,8450,[483 202 273 294 322],749,4,37002,4.378416755413561,20.0,0.0
8451,0,8451,[302 603 427 187 180],474,5,37007,4.378490298154283,20.0,0.0
8452,0,8452,[302 603 427 187 180],474,5,37012,4.378563823494617,20.0,0.0
8453,0,8453,[302 603 427 187 180],664,5,37017,4.378637331440738,20.0,0.0
8454,0,8454,[302 603 427 187 180],458,5,37022,4.378710821998817,20.0,0.0
8455,0,8455,[302 603 427 187 180],537,5,37027,4.3787842951750235,20.0,0.0
8456,0,8456,[302 603 427 187 180],666,5,37032,4.3788577509755235,20.0,0.0
8457,0,8457,[323   9  89 174 216],90,4,37036,4.378812958146134,0.0,20.0
8458,0,8458,[ 88  69 186 245 173],749,5,37041,4.378886393190684,0.0,0.0
8459,0,8459,[ 11  96 161 194 294],653,2,37043,4.378605200945627,0.0,0.0
8460,0,8460,[302 603 427 187 180],13,5,37048,4.378678643186385,20.0,0.0
8461,0,8461,[302 603 427 187 180],474,5,37053,4.378752068069015,20.0,0.0
8462,0,8462,[302 603 427 187 180],271,5,37058,4.378825475599669,20.0,0.0
8463,0,8463,[302 603 427 187 180],13,5,37063,4.378898865784499,20.0,0.0
8464,0,8464,[191 151 546 515 195],882,4,37067,4.378854105138807,0.0,0.0
8465,0,8465,[302 603 427 187 180],13,5,37072,4.3789274746043,20.0,0.0
8466,0,8466,[237 132  96  97 172],653,1,37073,4.378528404393528,0.0,0.0
8467,0,8467,[ 89 245 182  11 496],749,4,37077,4.378483703353803,0.0,0.0
8468,0,8468,[302 603 427 187 180],664,5,37082,4.378557090565592,20.0,0.0
8469,0,8469,[302 603 427 187 180],458,5,37087,4.378630460448642,20.0,0.0
8470,0,8470,[423  69 127  22  97],91,5,37092,4.37870381300909,0.0,20.0
8471,0,8471,[168 403 357  11 118],833,3,37095,4.378541076487252,20.0,0.0
8472,0,8472,[302 603 427 187 180],537,5,37100,4.378614422282545,20.0,0.0
8473,0,8473,[302 603 427 187 180],90,5,37105,4.378687750767052,20.0,0.0
8474,0,8474,[302 603 427 187 180],90,5,37110,4.378761061946903,20.0,0.0
8475,0,8475,[194 118 302  22 185],380,4,37114,4.378716375648891,0.0,0.0
8476,0,8476,[435 143 187  15 245],207,4,37118,4.378671699893831,0.0,0.0
8477,0,8477,[117   4 313 196  15],271,3,37121,4.378509082330738,0.0,0.0
8478,0,8478,[ 64 183 132 603  50],339,5,37126,4.378582379997641,20.0,20.0
8479,0,8479,[302 603 427 187 180],537,5,37131,4.378655660377358,20.0,0.0
8480,0,8480,[302 603 427 187 180],271,5,37136,4.378728923476006,20.0,0.0
8481,0,8481,[302 603 427 187 180],666,5,37141,4.378802169299694,20.0,0.0
8482,0,8482,[423 176  11 237 678],13,2,37143,4.3785217493811155,0.0,0.0
8483,0,8483,[302 603 427 187 180],458,5,37148,4.378595002357379,20.0,0.0
8484,0,8484,[302 603 427 187 180],271,5,37153,4.378668238067178,20.0,0.0
8485,0,8485,[302 603 427 187 180],664,5,37158,4.378741456516615,20.0,0.0
8486,0,8486,[302 603 427 187 180],458,5,37163,4.378814657711795,20.0,0.0
8487,0,8487,[168 405 195  97 161],313,3,37166,4.378652214891612,0.0,0.0
8488,0,8488,[302 603 427 187 180],13,5,37171,4.37872540935328,20.0,0.0
8489,0,8489,[235 200 238  25 185],537,2,37173,4.3784452296819785,0.0,0.0
8490,0,8490,[196 127 546 100 294],479,2,37175,4.3781651160051815,0.0,40.0
8491,0,8491,[302 603 427 187 180],537,5,37180,4.3782383419689115,20.0,0.0
8492,0,8492,[210 194 357 282 179],643,4,37184,4.378193806664312,20.0,0.0
8493,0,8493,[302 603 427 187 180],13,5,37189,4.378267012008477,20.0,0.0
8494,0,8494,[302 603 427 187 180],664,5,37194,4.378340200117717,20.0,0.0
8495,0,8495,[302 603 427 187 180],474,5,37199,4.378413370998117,20.0,0.0
8496,0,8496,[300 471  25 275 269],894,3,37202,4.378251147463811,0.0,0.0
8497,0,8497,[302 603 427 187 180],666,5,37207,4.37832431160273,20.0,0.0
8498,0,8498,[471 276 200  28   1],311,5,37212,4.378397458524533,0.0,0.0
8499,0,8499,[302 603 427 187 180],90,5,37217,4.378470588235294,20.0,0.0
8500,0,8500,[211 603 202 483 186],326,5,37222,4.37854370074109,40.0,0.0
8501,0,8501,[302 603 427 187 180],90,5,37227,4.3786167960479885,20.0,0.0
8502,0,8502,[ 22 187 186 216 168],840,3,37230,4.378454663060096,0.0,0.0
8503,0,8503,[302 603 427 187 180],458,5,37235,4.378527751646284,20.0,0.0
8504,0,8504,[302 603 427 187 180],664,5,37240,4.378600823045267,20.0,0.0
8505,0,8505,[302 603 427 187 180],339,5,37245,4.378673877263108,20.0,0.0
8506,0,8506,[300  70 403 742 127],533,4,37249,4.378629364053133,0.0,20.0
8507,0,8507,[302 603 427 187 180],666,5,37254,4.3787023977433,20.0,0.0
8508,0,8508,[302 603 427 187 180],458,5,37259,4.378775414267246,20.0,0.0
8509,0,8509,[302 603 427 187 180],664,5,37264,4.378848413631022,20.0,0.0
8510,0,8510,[302 603 427 187 180],339,5,37269,4.378921395840677,20.0,0.0
8511,0,8511,[258 100 276 143 271],334,3,37272,4.378759398496241,0.0,20.0
8512,0,8512,[302 603 427 187 180],13,5,37277,4.37883237401621,20.0,0.0
8513,0,8513,[216 186 202 187  50],308,4,37281,4.378787878787879,0.0,20.0
8514,0,8514,[302 603 427 187 180],537,5,37286,4.3788608338226656,20.0,0.0
8515,0,8515,[302 603 427 187 180],339,5,37291,4.378933771723814,20.0,0.0
8516,0,8516,[200 153 597  98  88],92,2,37293,4.378654455794294,0.0,20.0
8517,0,8517,[302 603 427 187 180],13,5,37298,4.37872740079831,20.0,0.0
8518,0,8518,[302 603 427 187 180],537,5,37303,4.378800328677075,20.0,0.0
8519,0,8519,[302 603 427 187 180],339,5,37308,4.378873239436619,20.0,0.0
8520,0,8520,[302 603 427 187 180],13,5,37313,4.378946133082971,20.0,0.0
8521,0,8521,[302 603 427 187 180],271,5,37318,4.379019009622154,20.0,0.0
8522,0,8522,[302 603 427 187 180],666,5,37323,4.37909186906019,20.0,0.0
8523,0,8523,[302 603 427 187 180],458,5,37328,4.379164711403097,20.0,0.0
8524,0,8524,[302 603 427 187 180],666,5,37333,4.379237536656891,20.0,0.0
8525,0,8525,[302 603 427 187 180],271,5,37338,4.379310344827586,20.0,0.0
8526,0,8526,[302 603 427 187 180],664,5,37343,4.379383135921191,20.0,0.0
8527,0,8527,[302 603 427 187 180],537,5,37348,4.379455909943715,20.0,0.0
8528,0,8528,[302 603 427 187 180],474,5,37353,4.379528666901161,20.0,0.0
8529,0,8529,[127  69 257 288 200],343,2,37355,4.379249706916764,0.0,20.0
8530,0,8530,[302 603 427 187 180],666,5,37360,4.379322470988161,20.0,0.0
8531,0,8531,[302 603 427 187 180],474,5,37365,4.379395218002813,20.0,0.0
8532,0,8532,[302 603 427 187 180],666,5,37370,4.379467947966718,20.0,0.0
8533,0,8533,[302 603 427 187 180],339,5,37375,4.379540660885868,20.0,0.0
8534,0,8534,[ 12 191 181 168 111],334,4,37379,4.379496192149971,20.0,0.0
8535,0,8535,[ 95 357 405 161 153],13,3,37382,4.37933458294283,20.0,0.0
8536,0,8536,[302 603 427 187 180],458,5,37387,4.379407285931826,20.0,0.0
8537,0,8537,[302 603 427 187 180],537,5,37392,4.3794799718903725,20.0,0.0
8538,0,8538,[302 603 427 187 180],90,5,37397,4.3795526408244525,20.0,0.0
8539,0,8539,[655  12 185 211  79],643,5,37402,4.379625292740047,20.0,0.0
8540,0,8540,[265 202  69  89  11],653,3,37405,4.379463763025407,0.0,0.0
8541,0,8541,[748  88 258 235 423],479,2,37407,4.3791852025286815,0.0,0.0
8542,0,8542,[195 289  98 182 186],881,2,37409,4.378906707245698,0.0,20.0
8543,0,8543,[302 603 427 187 180],458,5,37414,4.3789794007490634,20.0,0.0
8544,0,8544,[302 603 427 187 180],458,5,37419,4.379052077238151,20.0,0.0
8545,0,8545,[302 603 427 187 180],664,5,37424,4.379124736718933,20.0,0.0
8546,0,8546,[302 603 427 187 180],474,5,37429,4.379197379197379,20.0,0.0
8547,0,8547,[302 603 427 187 180],664,5,37434,4.379270004679457,20.0,0.0
8548,0,8548,[ 96 117 202  25  64],537,0,37434,4.37875774944438,0.0,0.0
8549,0,8549,[ 88  64 216 276 318],184,4,37438,4.3787134502923974,20.0,0.0
8550,0,8550,[302 603 427 187 180],537,5,37443,4.378786106888083,20.0,0.0
8551,0,8551,[302 603 427 187 180],474,5,37448,4.378858746492049,20.0,0.0
8552,0,8552,[302 603 427 187 180],339,5,37453,4.378931369110254,20.0,0.0
8553,0,8553,[302 603 427 187 180],271,5,37458,4.379003974748656,20.0,0.0
8554,0,8554,[302 603 427 187 180],666,5,37463,4.379076563413209,20.0,0.0
8555,0,8555,[  1  70 357 222 172],148,5,37468,4.379149135109865,20.0,0.0
8556,0,8556,[302 603 427 187 180],666,5,37473,4.379221689844572,20.0,0.0
8557,0,8557,[302 603 427 187 180],271,5,37478,4.3792942276232765,20.0,0.0
8558,0,8558,[302 603 427 187 180],339,5,37483,4.379366748451922,20.0,0.0
8559,0,8559,[515 186 385 323  22],328,3,37486,4.379205607476636,0.0,0.0
8560,0,8560,[183  64 423   8 143],892,4,37490,4.379161312930733,0.0,0.0
8561,0,8561,[ 70 197  79 238 322],13,1,37491,4.378766643307638,0.0,0.0
8562,0,8562,[302 603 427 187 180],537,5,37496,4.378839191872007,20.0,0.0
8563,0,8563,[302 603 427 187 180],666,5,37501,4.378911723493695,20.0,0.0
8564,0,8564,[216 175 742 121 181],334,2,37503,4.378633975481611,0.0,0.0
8565,0,8565,[179 172 153 180 111],479,4,37507,4.378589773523231,0.0,0.0
8566,0,8566,[302 603 427 187 180],537,5,37512,4.378662308859577,20.0,0.0
8567,0,8567,[204 423 222 405 127],524,2,37514,4.378384687208217,0.0,20.0
8568,0,8568,[302 603 427 187 180],537,5,37519,4.378457229548372,20.0,0.0
8569,0,8569,[302 603 427 187 180],666,5,37524,4.3785297549591595,20.0,0.0
8570,0,8570,[302 603 427 187 180],664,5,37529,4.378602263446505,20.0,0.0
8571,0,8571,[302 603 427 187 180],271,5,37534,4.378674755016332,20.0,0.0
8572,0,8572,[302 603 427 187 180],90,5,37539,4.37874722967456,20.0,0.0
8573,0,8573,[435 546 427 180 357],234,2,37541,4.378469792395615,20.0,0.0
8574,0,8574,[302 603 427 187 180],90,5,37546,4.378542274052478,20.0,0.0
8575,0,8575,[ 79 357 385   8 294],194,2,37548,4.378264925373134,20.0,0.0
8576,0,8576,[302 603 427 187 180],666,5,37553,4.378337414014224,20.0,0.0
8577,0,8577,[302 603 427 187 180],474,5,37558,4.378409885754255,20.0,0.0
8578,0,8578,[302 603 427 187 180],474,5,37563,4.378482340599137,20.0,0.0
8579,0,8579,[302 603 427 187 180],474,5,37568,4.378554778554778,20.0,0.0
8580,0,8580,[302 603 427 187 180],537,5,37573,4.378627199627083,20.0,0.0
8581,0,8581,[357 210 216 294  82],234,1,37574,4.378233512001865,20.0,0.0
8582,0,8582,[302 603 427 187 180],339,5,37579,4.378305953629267,20.0,0.0
8583,0,8583,[ 69 515 181 546 185],881,4,37583,4.378261882572227,0.0,0.0
8584,0,8584,[302 603 427 187 180],474,5,37588,4.3783343040186375,20.0,0.0
8585,0,8585,[302 603 427 187 180],537,5,37593,4.378406708595388,20.0,0.0
8586,0,8586,[302 603 427 187 180],666,5,37598,4.378479096308373,20.0,0.0
8587,0,8587,[302 603 427 187 180],664,5,37603,4.378551467163484,20.0,0.0
8588,0,8588,[289 288 174 405 294],554,3,37606,4.378390965188031,0.0,20.0
8589,0,8589,[302 603 427 187 180],537,5,37611,4.3784633294528525,20.0,0.0
8590,0,8590,[294 427  96  82 302],666,2,37613,4.378186474217204,0.0,0.0
8591,0,8591,[302 603 427 187 180],271,5,37618,4.378258845437617,20.0,0.0
8592,0,8592,[403 200 234 175 742],788,1,37619,4.377865704643314,0.0,0.0
8593,0,8593,[302 603 427 187 180],90,5,37624,4.377938096346288,20.0,0.0
8594,0,8594,[302 603 427 187 180],474,5,37629,4.378010471204188,20.0,0.0
8595,0,8595,[302 603 427 187 180],271,5,37634,4.378082829222894,20.0,0.0
8596,0,8596,[302 603 427 187 180],666,5,37639,4.378155170408282,20.0,0.0
8597,0,8597,[135  70 475 286 294],207,0,37639,4.377645964177716,0.0,0.0
8598,0,8598,[302 603 427 187 180],339,5,37644,4.377718339341784,20.0,0.0
8599,0,8599,[182 135 204 237 302],328,2,37646,4.377441860465116,0.0,0.0
8600,0,8600,[ 89 282 471 195  50],479,5,37651,4.377514242529938,0.0,20.0
8601,0,8601,[302 603 427 187 180],271,5,37656,4.377586607765636,20.0,0.0
8602,0,8602,[ 64 300 286 211 111],653,3,37659,4.377426479135186,0.0,0.0
8603,0,8603,[302 603 427 187 180],666,5,37664,4.377498837749884,20.0,0.0
8604,0,8604,[302 603 427 187 180],271,5,37669,4.377571179546775,20.0,0.0
8605,0,8605,[302 603 427 187 180],537,5,37674,4.377643504531722,20.0,0.0
8606,0,8606,[275 204 176 215  69],271,4,37678,4.377599628209597,0.0,0.0
8607,0,8607,[302 603 427 187 180],664,5,37683,4.377671933085502,20.0,0.0
8608,0,8608,[302 603 427 187 180],474,5,37688,4.377744221163899,20.0,0.0
8609,0,8609,[183 328 546 100 210],749,3,37691,4.3775842044134725,0.0,20.0
8610,0,8610,[302 603 427 187 180],458,5,37696,4.377656485890141,20.0,0.0
8611,0,8611,[302 603 427 187 180],339,5,37701,4.3777287505805855,20.0,0.0
8612,0,8612,[302 603 427 187 180],474,5,37706,4.377800998490653,20.0,0.0
8613,0,8613,[302 603 427 187 180],271,5,37711,4.37787322962619,20.0,0.0
8614,0,8614,[302 603 427 187 180],271,5,37716,4.377945443993036,20.0,0.0
8615,0,8615,[258 568 301 300 276],537,2,37718,4.377669452181987,0.0,0.0
8616,0,8616,[302 603 427 187 180],339,5,37723,4.377741673436231,20.0,0.0
8617,0,8617,[ 82 182  11 322 100],207,0,37723,4.377233696913437,0.0,20.0
8618,0,8618,[302 603 427 187 180],13,5,37728,4.377305951966585,20.0,0.0
8619,0,8619,[302 603 427 187 180],474,5,37733,4.377378190255221,20.0,0.0
8620,0,8620,[302 603 427 187 180],664,5,37738,4.377450411785175,20.0,0.0
8621,0,8621,[302 603 427 187 180],90,5,37743,4.377522616562283,20.0,0.0
8622,0,8622,[302 603 427 187 180],458,5,37748,4.377594804592369,20.0,0.0
8623,0,8623,[302 603 427 187 180],666,5,37753,4.377666975881262,20.0,0.0
8624,0,8624,[302 603 427 187 180],537,5,37758,4.377739130434783,20.0,0.0
8625,0,8625,[ 95 273   4 100  79],387,3,37761,4.377579411082773,0.0,20.0
8626,0,8626,[302 603 427 187 180],90,5,37766,4.377651559058769,20.0,0.0
8627,0,8627,[271 678 235 268 216],537,1,37767,4.377260083449235,0.0,0.0
8628,0,8628,[302 603 427 187 180],271,5,37772,4.377332251709352,20.0,0.0
8629,0,8629,[302 603 427 187 180],90,5,37777,4.377404403244496,20.0,0.0
8630,0,8630,[302 603 427 187 180],666,5,37782,4.377476538060479,20.0,0.0
8631,0,8631,[333  89 238 385 405],313,4,37786,4.3774328081556995,0.0,0.0
8632,0,8632,[234 125  25 161 197],271,2,37788,4.377157419205375,0.0,0.0
8633,0,8633,[302 603 427 187 180],458,5,37793,4.377229557563123,20.0,0.0
8634,0,8634,[302 603 427 187 180],13,5,37798,4.377301679212508,20.0,0.0
8635,0,8635,[302 603 427 187 180],13,5,37803,4.377373784159333,20.0,0.0
8636,0,8636,[ 96 742 435 286 194],378,5,37808,4.377445872409401,0.0,0.0
8637,0,8637,[302 603 427 187 180],458,5,37813,4.3775179439685115,20.0,0.0
8638,0,8638,[546 121   8 173 215],7,5,37818,4.377589998842459,0.0,0.0
8639,0,8639,[302 603 427 187 180],458,5,37823,4.377662037037037,20.0,0.0
8640,0,8640,[508  56 144 286 153],447,3,37826,4.3775026038652936,0.0,0.0
8641,0,8641,[302 603 427 187 180],13,5,37831,4.377574635501041,20.0,0.0
8642,0,8642,[176 195 135  69 288],843,4,37835,4.377530949901654,0.0,0.0
8643,0,8643,[302 603 427 187 180],13,5,37840,4.3776029615918555,20.0,0.0
8644,0,8644,[435 211 237 173 204],60,5,37845,4.377674956622325,0.0,0.0
8645,0,8645,[302 603 427 187 180],666,5,37850,4.377746934998844,20.0,0.0
8646,0,8646,[302 603 427 187 180],90,5,37855,4.377818896727189,20.0,0.0
8647,0,8647,[302 603 427 187 180],339,5,37860,4.377890841813136,20.0,0.0
8648,0,8648,[302 603 427 187 180],666,5,37865,4.377962770262458,20.0,0.0
8649,0,8649,[183 216 742 173 174],648,5,37870,4.378034682080925,0.0,20.0
8650,0,8650,[302 603 427 187 180],90,5,37875,4.378106577274304,20.0,0.0
8651,0,8651,[302 603 427 187 180],664,5,37880,4.378178455848359,20.0,0.0
8652,0,8652,[294 117 172 191 301],13,1,37881,4.377788050387149,0.0,0.0
8653,0,8653,[302 603 427 187 180],664,5,37886,4.377859949156459,20.0,0.0
8654,0,8654,[302 603 427 187 180],666,5,37891,4.377931831311381,20.0,0.0
8655,0,8655,[302 603 427 187 180],664,5,37896,4.378003696857671,20.0,0.0
8656,0,8656,[135 215  95 268 328],234,1,37897,4.377613491971815,0.0,0.0
8657,0,8657,[182 483  56 385  71],788,1,37898,4.377223377223377,20.0,0.0
8658,0,8658,[302 603 427 187 180],339,5,37903,4.3772952996881855,20.0,0.0
8659,0,8659,[302 603 427 187 180],666,5,37908,4.3773672055427255,20.0,0.0
8660,0,8660,[302 603 427 187 180],458,5,37913,4.3774390947927495,20.0,0.0
8661,0,8661,[302 603 427 187 180],537,5,37918,4.3775109674440085,20.0,0.0
8662,0,8662,[568 357 237 176 423],899,5,37923,4.377582823502251,20.0,0.0
8663,0,8663,[302 603 427 187 180],537,5,37928,4.377654662973223,20.0,0.0
8664,0,8664,[302 603 427 187 180],90,5,37933,4.377726485862666,20.0,0.0
8665,0,8665,[302 603 427 187 180],339,5,37938,4.377798292176322,20.0,0.0
8666,0,8666,[302 603 427 187 180],90,5,37943,4.3778700819199265,20.0,0.0
8667,0,8667,[302 603 427 187 180],474,5,37948,4.377941855099215,20.0,0.0
8668,0,8668,[302 603 427 187 180],474,5,37953,4.378013611719922,20.0,0.0
8669,0,8669,[302 603 427 187 180],90,5,37958,4.378085351787774,20.0,0.0
8670,0,8670,[302 603 427 187 180],13,5,37963,4.3781570753085,20.0,0.0
8671,0,8671,[ 79 427   4 300 185],666,3,37966,4.37799815498155,0.0,0.0
8672,0,8672,[302 603 427 187 180],271,5,37971,4.378069872016603,20.0,0.0
8673,0,8673,[302 603 427 187 180],664,5,37976,4.378141572515564,20.0,0.0
8674,0,8674,[ 79   8 655 357  28],774,0,37976,4.37763688760807,20.0,0.0
8675,0,8675,[475  11 273 176 257],308,4,37980,4.377593360995851,0.0,0.0
8676,0,8676,[302 603 427 187 180],271,5,37985,4.3776650916215285,20.0,0.0
8677,0,8677,[302 603 427 187 180],664,5,37990,4.377736805715602,20.0,0.0
8678,0,8678,[302 603 427 187 180],474,5,37995,4.377808503283789,20.0,0.0
8679,0,8679,[302 603 427 187 180],13,5,38000,4.377880184331797,20.0,0.0
8680,0,8680,[302 603 427 187 180],271,5,38005,4.377951848865338,20.0,0.0
8681,0,8681,[597 237 143 275 515],452,3,38008,4.377793135222299,0.0,0.0
8682,0,8682,[302 603 427 187 180],458,5,38013,4.377864793274214,20.0,0.0
8683,0,8683,[187  15 258 181 322],749,4,38017,4.377821280515891,0.0,0.0
8684,0,8684,[603 268 222  71  50],664,3,38020,4.377662636729994,20.0,20.0
8685,0,8685,[302 603 427 187 180],458,5,38025,4.3777342850564125,20.0,0.0
8686,0,8686,[302 603 427 187 180],537,5,38030,4.3778059168873025,20.0,0.0
8687,0,8687,[ 25 181 194 187 403],194,2,38032,4.377532228360957,0.0,0.0
8688,0,8688,[302 603 427 187 180],13,5,38037,4.377603866958223,20.0,0.0
8689,0,8689,[302 603 427 187 180],13,5,38042,4.377675489067894,20.0,0.0
8690,0,8690,[302 603 427 187 180],271,5,38047,4.377747094695662,20.0,0.0
8691,0,8691,[302 603 427 187 180],13,5,38052,4.377818683847216,20.0,0.0
8692,0,8692,[302 603 427 187 180],664,5,38057,4.377890256528241,20.0,0.0
8693,0,8693,[302 603 427 187 180],339,5,38062,4.377961812744421,20.0,0.0
8694,0,8694,[435 144 117 181 175],313,5,38067,4.378033352501437,0.0,0.0
8695,0,8695,[  4 204 125 328 357],234,2,38069,4.377759889604416,20.0,0.0
8696,0,8696,[302 603 427 187 180],537,5,38074,4.3778314361274,20.0,0.0
8697,0,8697,[302 603 427 187 180],664,5,38079,4.377902966199127,20.0,0.0
8698,0,8698,[435  96 197 237 172],59,4,38083,4.377859524083228,0.0,0.0
8699,0,8699,[302 603 427 187 180],664,5,38088,4.377931034482758,20.0,0.0
8700,0,8700,[302 603 427 187 180],537,5,38093,4.378002528445006,20.0,0.0
8701,0,8701,[302 603 427 187 180],90,5,38098,4.378074005975638,20.0,0.0
8702,0,8702,[302 603 427 187 180],13,5,38103,4.3781454670803175,20.0,0.0
8703,0,8703,[302 603 427 187 180],90,5,38108,4.378216911764706,20.0,0.0
8704,0,8704,[235 125 172 195 174],897,4,38112,4.378173463526709,0.0,20.0
8705,0,8705,[302 603 427 187 180],458,5,38117,4.378244888582587,20.0,0.0
8706,0,8706,[302 603 427 187 180],90,5,38122,4.378316297232112,20.0,0.0
8707,0,8707,[302 603 427 187 180],664,5,38127,4.378387689480937,20.0,0.0
8708,0,8708,[196  22 202 234  28],271,5,38132,4.378459065334711,0.0,0.0
8709,0,8709,[302 603 427 187 180],666,5,38137,4.378530424799082,20.0,0.0
8710,0,8710,[302 603 427 187 180],664,5,38142,4.378601767879692,20.0,0.0
8711,0,8711,[302 603 427 187 180],666,5,38147,4.378673094582186,20.0,0.0
8712,0,8712,[302 603 427 187 180],271,5,38152,4.3787444049122,20.0,0.0
8713,0,8713,[302 603 427 187 180],664,5,38157,4.378815698875373,20.0,0.0
8714,0,8714,[216 403 194 151  95],749,4,38161,4.37877223178428,0.0,0.0
8715,0,8715,[302 603 427 187 180],271,5,38166,4.378843506195502,20.0,0.0
8716,0,8716,[302 603 427 187 180],271,5,38171,4.378914764253757,20.0,0.0
8717,0,8717,[302 603 427 187 180],13,5,38176,4.378986005964671,20.0,0.0
8718,0,8718,[302 603 427 187 180],666,5,38181,4.379057231333869,20.0,0.0
8719,0,8719,[302 603 427 187 180],13,5,38186,4.379128440366973,20.0,0.0
8720,0,8720,[215 204 182 318  97],774,1,38187,4.378740970072239,20.0,0.0
8721,0,8721,[302 603 427 187 180],339,5,38192,4.378812199036918,20.0,0.0
8722,0,8722,[ 12 423  50  56  98],59,5,38197,4.378883411670297,20.0,40.0
8723,0,8723,[302 603 427 187 180],271,5,38202,4.378954607977992,20.0,0.0
8724,0,8724,[427 655 175 435 357],339,5,38207,4.379025787965616,20.0,0.0
8725,0,8725,[302 603 427 187 180],666,5,38212,4.379096951638781,20.0,0.0
8726,0,8726,[302 603 427 187 180],537,5,38217,4.379168099003094,20.0,0.0
8727,0,8727,[302 603 427 187 180],13,5,38222,4.379239230064162,20.0,0.0
8728,0,8728,[385  25 508 121 176],387,1,38223,4.378852102188109,0.0,0.0
8729,0,8729,[302 603 427 187 180],664,5,38228,4.378923253150058,20.0,0.0
8730,0,8730,[235 237 265 111 471],447,3,38231,4.378765318978353,0.0,0.0
8731,0,8731,[302 603 427 187 180],339,5,38236,4.378836463582227,20.0,0.0
8732,0,8732,[302 603 427 187 180],90,5,38241,4.37890759189282,20.0,0.0
8733,0,8733,[302 603 427 187 180],271,5,38246,4.378978703915732,20.0,0.0
8734,0,8734,[597 234  70   7 143],13,1,38247,4.378591871780195,0.0,0.0
8735,0,8735,[322 403 183 235 475],334,3,38250,4.378434065934066,0.0,0.0
8736,0,8736,[302 603 427 187 180],339,5,38255,4.378505207737209,20.0,0.0
8737,0,8737,[302 603 427 187 180],666,5,38260,4.378576333257039,20.0,0.0
8738,0,8738,[210 405 423 228 182],87,4,38264,4.378533012930541,0.0,0.0
8739,0,8739,[ 50 153 186 176  97],387,2,38266,4.378260869565217,0.0,20.0
8740,0,8740,[187 211 100 153 322],234,2,38268,4.377988788468139,0.0,20.0
8741,0,8741,[302 603 427 187 180],339,5,38273,4.378059940517044,20.0,0.0
8742,0,8742,[222 185 202   4 143],653,0,38273,4.37755919020931,0.0,0.0
8743,0,8743,[ 82  79  98 182 515],881,4,38277,4.377516010978957,0.0,20.0
8744,0,8744,[302 603 427 187 180],666,5,38282,4.377587192681532,20.0,0.0
8745,0,8745,[302 603 427 187 180],339,5,38287,4.377658358106563,20.0,0.0
8746,0,8746,[302 603 427 187 180],458,5,38292,4.377729507259632,20.0,0.0
8747,0,8747,[302 603 427 187 180],339,5,38297,4.377800640146319,20.0,0.0
8748,0,8748,[302 603 427 187 180],271,5,38302,4.377871756772203,20.0,0.0
8749,0,8749,[302 603 427 187 180],271,5,38307,4.377942857142857,20.0,0.0
8750,0,8750,[302 603 427 187 180],458,5,38312,4.3780139412638555,20.0,0.0
8751,0,8751,[302 603 427 187 180],666,5,38317,4.378085009140768,20.0,0.0
8752,0,8752,[ 79 121 143  71  28],406,1,38318,4.377699074602993,0.0,0.0
8753,0,8753,[302 603 427 187 180],271,5,38323,4.377770162211561,20.0,0.0
8754,0,8754,[302 603 427 187 180],666,5,38328,4.377841233580811,20.0,0.0
8755,0,8755,[301 603 127 286  15],537,2,38330,4.37756966651439,20.0,20.0
8756,0,8756,[302 603 427 187 180],666,5,38335,4.377640744547219,20.0,0.0
8757,0,8757,[302 603 427 187 180],666,5,38340,4.377711806348481,20.0,0.0
8758,0,8758,[302 603 427 187 180],90,5,38345,4.377782851923736,20.0,0.0
8759,0,8759,[237 174 135 234 194],271,5,38350,4.377853881278539,0.0,20.0
8760,0,8760,[302 603 427 187 180],537,5,38355,4.377924894418445,20.0,0.0
8761,0,8761,[302 603 427 187 180],90,5,38360,4.377995891349007,20.0,0.0
8762,0,8762,[ 97 174 288 237 180],13,4,38364,4.377952755905512,0.0,20.0
8763,0,8763,[302 603 427 187 180],537,5,38369,4.378023733455043,20.0,0.0
8764,0,8764,[302 603 427 187 180],664,5,38374,4.378094694808899,20.0,0.0
8765,0,8765,[176 191 515  95 568],200,5,38379,4.378165639972622,0.0,0.0
8766,0,8766,[182 153 385 176  89],326,2,38381,4.377894376639672,0.0,0.0
8767,0,8767,[302 603 427 187 180],271,5,38386,4.377965328467154,20.0,0.0
8768,0,8768,[302 603 427 187 180],339,5,38391,4.378036264112214,20.0,0.0
8769,0,8769,[302 603 427 187 180],664,5,38396,4.378107183580387,20.0,0.0
8770,0,8770,[196   9  25 186  56],234,0,38396,4.377608026450804,0.0,0.0
8771,0,8771,[302 603 427 187 180],537,5,38401,4.377678978568172,20.0,0.0
8772,0,8772,[302 603 427 187 180],339,5,38406,4.37774991451043,20.0,0.0
8773,0,8773,[302 603 427 187 180],271,5,38411,4.377820834283109,20.0,0.0
8774,0,8774,[302 603 427 187 180],537,5,38416,4.377891737891738,20.0,0.0
8775,0,8775,[302 603 427 187 180],474,5,38421,4.3779626253418416,20.0,0.0
8776,0,8776,[302 603 427 187 180],664,5,38426,4.378033496638943,20.0,0.0
8777,0,8777,[302 603 427 187 180],339,5,38431,4.378104351788562,20.0,0.0
8778,0,8778,[603 237 286 289 179],334,4,38435,4.378061282606219,20.0,0.0
8779,0,8779,[302 603 427 187 180],90,5,38440,4.378132118451025,20.0,0.0
8780,0,8780,[273 168 357 127 204],774,1,38441,4.377747409178909,20.0,20.0
8781,0,8781,[302 603 427 187 180],90,5,38446,4.377818264632202,20.0,0.0
8782,0,8782,[302 603 427 187 180],537,5,38451,4.377889103950814,20.0,0.0
8783,0,8783,[302 603 427 187 180],666,5,38456,4.377959927140255,20.0,0.0
8784,0,8784,[302 603 427 187 180],90,5,38461,4.378030734206033,20.0,0.0
8785,0,8785,[302 603 427 187 180],339,5,38466,4.378101525153654,20.0,0.0
8786,0,8786,[302 603 427 187 180],537,5,38471,4.37817229998862,20.0,0.0
8787,0,8787,[302 603 427 187 180],339,5,38476,4.378243058716431,20.0,0.0
8788,0,8788,[302 603 427 187 180],537,5,38481,4.378313801342587,20.0,0.0
8789,0,8789,[302 603 427 187 180],537,5,38486,4.378384527872583,20.0,0.0
8790,0,8790,[302 603 427 187 180],458,5,38491,4.3784552383119095,20.0,0.0
8791,0,8791,[302 603 427 187 180],666,5,38496,4.37852593266606,20.0,0.0
8792,0,8792,[302 603 427 187 180],474,5,38501,4.378596610940521,20.0,0.0
8793,0,8793,[302 603 427 187 180],664,5,38506,4.378667273140778,20.0,0.0
8794,0,8794,[302 603 427 187 180],666,5,38511,4.3787379192723135,20.0,0.0
8795,0,8795,[302 603 427 187 180],474,5,38516,4.37880854934061,20.0,0.0
8796,0,8796,[ 88 168 125 271 258],749,5,38521,4.378879163351143,0.0,0.0
8797,0,8797,[302 603 427 187 180],666,5,38526,4.378949761309388,20.0,0.0
8798,0,8798,[301 174  56 175 176],788,1,38527,4.378565746107512,0.0,20.0
8799,0,8799,[235 405 174 515   8],87,4,38531,4.378522727272728,0.0,20.0
8800,0,8800,[302 603 427 187 180],458,5,38536,4.37859334166572,20.0,0.0
8801,0,8801,[515 153 168  98 234],85,4,38540,4.378550329470575,0.0,20.0
8802,0,8802,[302 603 427 187 180],474,5,38545,4.378620924684767,20.0,0.0
8803,0,8803,[179 483 127   9 742],189,3,38548,4.378464334393458,20.0,20.0
8804,0,8804,[302 603 427 187 180],474,5,38553,4.378534923339012,20.0,0.0
8805,0,8805,[ 89   8 151 271 268],334,4,38557,4.3784919373154665,0.0,0.0
8806,0,8806,[322 655 117 180 135],749,5,38562,4.378562507096627,0.0,0.0
8807,0,8807,[302 603 427 187 180],537,5,38567,4.378633060853769,20.0,0.0
8808,0,8808,[302 603 427 187 180],13,5,38572,4.378703598592349,20.0,0.0
8809,0,8809,[173 427 196 515 496],406,2,38574,4.378433598183882,0.0,0.0
8810,0,8810,[302 603 427 187 180],537,5,38579,4.378504142549087,20.0,0.0
8811,0,8811,[302 603 427 187 180],474,5,38584,4.378574670903314,20.0,0.0
8812,0,8812,[302 603 427 187 180],458,5,38589,4.378645183252014,20.0,0.0
8813,0,8813,[318 174 185 515  96],7,4,38593,4.378602223734967,20.0,20.0
8814,0,8814,[302 603 427 187 180],458,5,38598,4.378672716959728,20.0,0.0
8815,0,8815,[302 603 427 187 180],474,5,38603,4.378743194192378,20.0,0.0
8816,0,8816,[302 603 427 187 180],271,5,38608,4.378813655438358,20.0,0.0
8817,0,8817,[144 161 111 238 211],543,4,38612,4.378770696303016,0.0,0.0
8818,0,8818,[ 15 195 427  56 182],650,2,38614,4.378500963828098,0.0,0.0
8819,0,8819,[302 603 427 187 180],90,5,38619,4.378571428571429,20.0,0.0
8820,0,8820,[195 161 100 153 300],313,4,38623,4.378528511506632,0.0,20.0
8821,0,8821,[302 603 427 187 180],537,5,38628,4.378598957152573,20.0,0.0
8822,0,8822,[  7 132 196 515 121],194,1,38629,4.378216026294911,0.0,0.0
8823,0,8823,[302 603 427 187 180],458,5,38634,4.378286491387126,20.0,0.0
8824,0,8824,[385 210 228 204 678],13,2,38636,4.378016997167139,0.0,0.0
8825,0,8825,[271  70 222 127 195],64,4,38640,4.377974167233175,0.0,20.0
8826,0,8826,[302 603 427 187 180],458,5,38645,4.378044635776595,20.0,0.0
8827,0,8827,[678 276 322 288  25],486,3,38648,4.3778885364748525,0.0,0.0
8828,0,8828,[302 603 427 187 180],13,5,38653,4.377958998754106,20.0,0.0
8829,0,8829,[302 603 427 187 180],664,5,38658,4.378029445073612,20.0,0.0
8830,0,8830,[174 435 197 568  96],379,5,38663,4.378099875438795,0.0,20.0
8831,0,8831,[180 286 195 328 191],537,2,38665,4.377830615942029,0.0,0.0
8832,0,8832,[302 603 427 187 180],458,5,38670,4.37790105286992,20.0,0.0
8833,0,8833,[238   1 258 423  69],59,3,38673,4.3777450758433325,0.0,0.0
8834,0,8834,[268 357 132  15 175],77,2,38675,4.377475947934352,20.0,0.0
8835,0,8835,[222  89 427  82 191],13,2,38677,4.3772068809416025,0.0,0.0
8836,0,8836,[302 603 427 187 180],271,5,38682,4.377277356568971,20.0,0.0
8837,0,8837,[210 748 186 318 435],313,3,38685,4.377121520706042,20.0,0.0
8838,0,8838,[  4 191 174 603 176],312,4,38689,4.377078855074103,20.0,20.0
8839,0,8839,[302 603 427 187 180],13,5,38694,4.377149321266969,20.0,0.0
8840,0,8840,[195 357  96  25 173],14,3,38697,4.376993552765525,20.0,0.0
8841,0,8841,[302 603 427 187 180],537,5,38702,4.377064012666818,20.0,0.0
8842,0,8842,[302 603 427 187 180],664,5,38707,4.377134456632365,20.0,0.0
8843,0,8843,[302 603 427 187 180],474,5,38712,4.377204884667571,20.0,0.0
8844,0,8844,[302 603 427 187 180],474,5,38717,4.3772752967778406,20.0,0.0
8845,0,8845,[302 603 427 187 180],13,5,38722,4.377345692968573,20.0,0.0
8846,0,8846,[302 603 427 187 180],339,5,38727,4.3774160732451675,20.0,0.0
8847,0,8847,[302 603 427 187 180],666,5,38732,4.37748643761302,20.0,0.0
8848,0,8848,[323 546  98 172  11],374,3,38735,4.377330771838626,0.0,20.0
8849,0,8849,[302 603 427 187 180],458,5,38740,4.377401129943503,20.0,0.0
8850,0,8850,[179   9 117 125 153],334,3,38743,4.377245508982036,0.0,0.0
8851,0,8851,[302 603 427 187 180],339,5,38748,4.377315860822413,20.0,0.0
8852,0,8852,[302 603 427 187 180],271,5,38753,4.377386196769456,20.0,0.0
8853,0,8853,[125  11   8 196 234],64,4,38757,4.3773435735260895,0.0,0.0
8854,0,8854,[302 603 427 187 180],458,5,38762,4.377413890457369,20.0,0.0
8855,0,8855,[191 235 496 318  97],343,5,38767,4.377484191508581,20.0,0.0
8856,0,8856,[302 603 427 187 180],664,5,38772,4.377554476685108,20.0,0.0
8857,0,8857,[302 603 427 187 180],13,5,38777,4.377624745992323,20.0,0.0
8858,0,8858,[302 603 427 187 180],537,5,38782,4.377694999435602,20.0,0.0
8859,0,8859,[302 603 427 187 180],666,5,38787,4.377765237020316,20.0,0.0
8860,0,8860,[302 603 427 187 180],666,5,38792,4.377835458751834,20.0,0.0
8861,0,8861,[204 289 496 597  56],458,2,38794,4.377567140600316,0.0,0.0
8862,0,8862,[302 603 427 187 180],13,5,38799,4.377637368836737,20.0,0.0
8863,0,8863,[ 64  79 179 204  15],207,4,38803,4.37759476534296,0.0,0.0
8864,0,8864,[302 603 427 187 180],666,5,38808,4.3776649746192895,20.0,0.0
8865,0,8865,[179 194  79 173  56],650,2,38810,4.377396796751635,0.0,0.0
8866,0,8866,[302 603 427 187 180],474,5,38815,4.377467012518326,20.0,0.0
8867,0,8867,[ 97 172 238 302 313],13,4,38819,4.377424447451511,0.0,0.0
8868,0,8868,[302 603 427 187 180],666,5,38824,4.377494644266546,20.0,0.0
8869,0,8869,[302 603 427 187 180],90,5,38829,4.377564825253664,20.0,0.0
8870,0,8870,[302 603 427 187 180],666,5,38834,4.377634990418216,20.0,0.0
8871,0,8871,[302 603 427 187 180],666,5,38839,4.377705139765554,20.0,0.0
8872,0,8872,[302 603 427 187 180],664,5,38844,4.377775273301026,20.0,0.0
8873,0,8873,[302 603 427 187 180],458,5,38849,4.377845391029975,20.0,0.0
8874,0,8874,[302 603 427 187 180],13,5,38854,4.377915492957746,20.0,0.0
8875,0,8875,[302 603 427 187 180],474,5,38859,4.37798557908968,20.0,0.0
8876,0,8876,[302 603 427 187 180],458,5,38864,4.378055649431114,20.0,0.0
8877,0,8877,[302 603 427 187 180],458,5,38869,4.378125703987385,20.0,0.0
8878,0,8878,[302 603 427 187 180],271,5,38874,4.3781957427638245,20.0,0.0
8879,0,8879,[302 603 427 187 180],90,5,38879,4.378265765765766,20.0,0.0
8880,0,8880,[302 603 427 187 180],271,5,38884,4.378335772998536,20.0,0.0
8881,0,8881,[302 603 427 187 180],271,5,38889,4.3784057644674625,20.0,0.0
8882,0,8882,[508 588 269 168  70],85,2,38891,4.378138016435889,0.0,0.0
8883,0,8883,[273 186 100 742 132],524,2,38893,4.377870328680775,0.0,20.0
8884,0,8884,[302 603 427 187 180],90,5,38898,4.377940348902645,20.0,0.0
8885,0,8885,[302 603 427 187 180],537,5,38903,4.378010353364844,20.0,0.0
8886,0,8886,[302 603 427 187 180],537,5,38908,4.378080342072691,20.0,0.0
8887,0,8887,[302 603 427 187 180],666,5,38913,4.378150315031503,20.0,0.0
8888,0,8888,[276  12   9 275 215],13,3,38916,4.377995275059062,20.0,0.0
8889,0,8889,[ 89  96  25 181  28],387,4,38920,4.377952755905512,0.0,0.0
8890,0,8890,[302 603 427 187 180],664,5,38925,4.378022719604094,20.0,0.0
8891,0,8891,[275 546 265 568  89],328,3,38928,4.377867746288799,0.0,0.0
8892,0,8892,[302 603 427 187 180],537,5,38933,4.377937703811987,20.0,0.0
8893,0,8893,[302 228   9 245 403],328,3,38936,4.37778277490443,0.0,0.0
8894,0,8894,[318 175 194 121 143],537,2,38938,4.377515458122541,20.0,0.0
8895,0,8895,[302 603 427 187 180],13,5,38943,4.377585431654676,20.0,0.0
8896,0,8896,[302 603 427 187 180],458,5,38948,4.377655389457121,20.0,0.0
8897,0,8897,[302 603 427 187 180],666,5,38953,4.377725331535176,20.0,0.0
8898,0,8898,[302 603 427 187 180],339,5,38958,4.377795257894145,20.0,0.0
8899,0,8899,[302 603 427 187 180],458,5,38963,4.3778651685393255,20.0,0.0
8900,0,8900,[302 603 427 187 180],666,5,38968,4.377935063476014,20.0,0.0
8901,0,8901,[302 603 427 187 180],474,5,38973,4.378004942709503,20.0,0.0
8902,0,8902,[302 603 427 187 180],537,5,38978,4.378074806245086,20.0,0.0
8903,0,8903,[286   4 496  98  11],537,1,38979,4.377695417789758,0.0,20.0
8904,0,8904,[302 603 427 187 180],271,5,38984,4.377765300393038,20.0,0.0
8905,0,8905,[302 603 427 187 180],458,5,38989,4.377835167302941,20.0,0.0
8906,0,8906,[172 151  12 174 132],378,4,38993,4.3777927472774225,20.0,20.0
8907,0,8907,[302 603 427 187 180],458,5,38998,4.377862595419847,20.0,0.0
8908,0,8908,[302 603 427 187 180],13,5,39003,4.377932427881917,20.0,0.0
8909,0,8909,[302 603 427 187 180],474,5,39008,4.378002244668911,20.0,0.0
8910,0,8910,[  7 191 228 118 182],892,4,39012,4.377959824935473,0.0,0.0
8911,0,8911,[313 288  89 174 161],102,2,39014,4.377692998204668,0.0,20.0
8912,0,8912,[234  95 357 144  15],308,2,39016,4.37742623134747,20.0,0.0
8913,0,8913,[172 185 435  71 568],313,5,39021,4.377496073592102,0.0,0.0
8914,0,8914,[597  56  82 151 357],882,5,39026,4.377565900168256,20.0,0.0
8915,0,8915,[302 603 427 187 180],664,5,39031,4.3776357110812025,20.0,0.0
8916,0,8916,[302 603 427 187 180],474,5,39036,4.377705506336212,20.0,0.0
8917,0,8917,[302 603 427 187 180],13,5,39041,4.377775285938551,20.0,0.0
8918,0,8918,[302 603 427 187 180],474,5,39046,4.3778450498934856,20.0,0.0
8919,0,8919,[302 603 427 187 180],474,5,39051,4.377914798206278,20.0,0.0
8920,0,8920,[302 603 427 187 180],271,5,39056,4.3779845308821885,20.0,0.0
8921,0,8921,[302 603 427 187 180],458,5,39061,4.378054247926474,20.0,0.0
8922,0,8922,[302 603 427 187 180],13,5,39066,4.378123949344391,20.0,0.0
8923,0,8923,[302 603 427 187 180],90,5,39071,4.3781936351411925,20.0,0.0
8924,0,8924,[302 603 427 187 180],537,5,39076,4.378263305322129,20.0,0.0
8925,0,8925,[300 161  71 282 318],479,2,39078,4.3779968630965715,20.0,0.0
8926,0,8926,[302 603 427 187 180],537,5,39083,4.378066539710989,20.0,0.0
8927,0,8927,[302 603 427 187 180],537,5,39088,4.378136200716846,20.0,0.0
8928,0,8928,[ 95 204 176 173 328],13,2,39090,4.377869862246612,0.0,0.0
8929,0,8929,[302 603 427 187 180],339,5,39095,4.377939529675252,20.0,0.0
8930,0,8930,[234 187   7 294   1],234,2,39097,4.37767327286978,0.0,0.0
8931,0,8931,[  7 546 258 257 568],378,4,39101,4.377630989699955,0.0,0.0
8932,0,8932,[286 235 185 237 200],537,1,39102,4.377252882570245,0.0,0.0
8933,0,8933,[302 603 427 187 180],339,5,39107,4.377322587866577,20.0,0.0
8934,0,8934,[302 603 427 187 180],666,5,39112,4.377392277560157,20.0,0.0
8935,0,8935,[603  71 215  97 200],298,4,39116,4.377350044762758,20.0,0.0
8936,0,8936,[302 603 427 187 180],339,5,39121,4.377419715788296,20.0,0.0
8937,0,8937,[269 273 173  11  28],537,1,39122,4.3770418438129335,0.0,0.0
8938,0,8938,[302 603 427 187 180],666,5,39127,4.377111533728605,20.0,0.0
8939,0,8939,[302 603 427 187 180],458,5,39132,4.377181208053691,20.0,0.0
8940,0,8940,[175 475 204 111 195],833,2,39134,4.3769153338552735,0.0,0.0
8941,0,8941,[302 603 427 187 180],474,5,39139,4.376985014538135,20.0,0.0
8942,0,8942,[  7 195 603 235 211],524,1,39140,4.376607402437661,20.0,0.0
8943,0,8943,[302 603 427 187 180],664,5,39145,4.3766771019677995,20.0,0.0
8944,0,8944,[ 98 215 176 125 603],64,3,39148,4.376523197316937,20.0,20.0
8945,0,8945,[302 603 427 187 180],271,5,39153,4.376592890677398,20.0,0.0
8946,0,8946,[302 603 427 187 180],664,5,39158,4.376662568458701,20.0,0.0
8947,0,8947,[302 603 427 187 180],664,5,39163,4.376732230666071,20.0,0.0
8948,0,8948,[302 603 427 187 180],13,5,39168,4.376801877304727,20.0,0.0
8949,0,8949,[ 12 194 200 313 597],308,3,39171,4.376648044692738,20.0,0.0
8950,0,8950,[ 98 508 202 215 546],343,4,39175,4.376605965813876,0.0,20.0
8951,0,8951,[302 603 427 187 180],458,5,39180,4.3766756032171585,20.0,0.0
8952,0,8952,[196 181   7  82 121],64,3,39183,4.376521836256003,0.0,0.0
8953,0,8953,[302 603 427 187 180],90,5,39188,4.376591467500559,20.0,0.0
8954,0,8954,[172  89  97 211 515],308,3,39191,4.376437744276941,0.0,0.0
8955,0,8955,[302 603 427 187 180],271,5,39196,4.376507369361322,20.0,0.0
8956,0,8956,[302 603 427 187 180],458,5,39201,4.376576978899185,20.0,0.0
8957,0,8957,[302 603 427 187 180],666,5,39206,4.376646572895735,20.0,0.0
8958,0,8958,[302 603 427 187 180],666,5,39211,4.376716151356178,20.0,0.0
8959,0,8959,[302 603 427 187 180],666,5,39216,4.376785714285714,20.0,0.0
8960,0,8960,[515 168  69 496  56],537,4,39220,4.376743667001451,0.0,0.0
8961,0,8961,[302 603 427 187 180],474,5,39225,4.3768132113367555,20.0,0.0
8962,0,8962,[302 603 427 187 180],474,5,39230,4.376882740153967,20.0,0.0
8963,0,8963,[234 143 144 289 237],92,3,39233,4.376729138777332,0.0,0.0
8964,0,8964,[302 603 427 187 180],339,5,39238,4.376798661461238,20.0,0.0
8965,0,8965,[568 403  98 172 603],899,4,39242,4.3767566361811285,20.0,20.0
8966,0,8966,[ 28 172  25 496 588],194,3,39245,4.376603100256496,0.0,0.0
8967,0,8967,[302 603 427 187 180],13,5,39250,4.3766726137377345,20.0,0.0
8968,0,8968,[302 603 427 187 180],664,5,39255,4.376742111718141,20.0,0.0
8969,0,8969,[302 603 427 187 180],458,5,39260,4.3768115942028984,20.0,0.0
8970,0,8970,[302 603 427 187 180],666,5,39265,4.376881061197191,20.0,0.0
8971,0,8971,[302 603 427 187 180],664,5,39270,4.376950512706197,20.0,0.0
8972,0,8972,[  4 271 153 172 300],940,2,39272,4.376685612392734,0.0,0.0
8973,0,8973,[302 603 427 187 180],90,5,39277,4.376755070202808,20.0,0.0
8974,0,8974,[302 603 427 187 180],474,5,39282,4.376824512534819,20.0,0.0
8975,0,8975,[302 603 427 187 180],458,5,39287,4.3768939393939394,20.0,0.0
8976,0,8976,[302 603 427 187 180],271,5,39292,4.37696335078534,20.0,0.0
8977,0,8977,[302 603 427 187 180],474,5,39297,4.37703274671419,20.0,0.0
8978,0,8978,[302 603 427 187 180],90,5,39302,4.377102127185656,20.0,0.0
8979,0,8979,[302 603 427 187 180],13,5,39307,4.3771714922049,20.0,0.0
8980,0,8980,[302 603 427 187 180],664,5,39312,4.377240841777085,20.0,0.0
8981,0,8981,[302 603 427 187 180],13,5,39317,4.37731017590737,20.0,0.0
8982,0,8982,[302 603 427 187 180],666,5,39322,4.377379494600913,20.0,0.0
8983,0,8983,[302 603 427 187 180],458,5,39327,4.377448797862868,20.0,0.0
8984,0,8984,[302 603 427 187 180],458,5,39332,4.377518085698386,20.0,0.0
8985,0,8985,[302 603 427 187 180],13,5,39337,4.37758735811262,20.0,0.0
8986,0,8986,[302 603 427 187 180],458,5,39342,4.377656615110715,20.0,0.0
8987,0,8987,[  8 294 235 568 185],774,0,39342,4.37716955941255,0.0,0.0
8988,0,8988,[ 82  95 403 181 258],334,4,39346,4.377127600400489,0.0,0.0
8989,0,8989,[302 603 427 187 180],474,5,39351,4.377196885428254,20.0,0.0
8990,0,8990,[385 144  79 322 515],313,4,39355,4.377154932710488,0.0,0.0
8991,0,8991,[187 597 185 127 125],653,3,39358,4.37700177935943,0.0,20.0
8992,0,8992,[302 603 427 187 180],537,5,39363,4.377071055265207,20.0,0.0
8993,0,8993,[302 603 427 187 180],271,5,39368,4.377140315766066,20.0,0.0
8994,0,8994,[176 161 245  12  64],533,3,39371,4.376987215119511,20.0,0.0
8995,0,8995,[302 603 427 187 180],458,5,39376,4.377056469542019,20.0,0.0
8996,0,8996,[172 196  28   1 135],882,5,39381,4.377125708569523,0.0,0.0
8997,0,8997,[302 603 427 187 180],666,5,39386,4.377194932207157,20.0,0.0
8998,0,8998,[302 603 427 187 180],458,5,39391,4.377264140460051,20.0,0.0
8999,0,8999,[302 603 427 187 180],13,5,39396,4.3773333333333335,20.0,0.0
9000,0,9000,[ 79 748 191 173  64],454,4,39400,4.377291412065326,0.0,0.0
9001,0,9001,[176 179   8 187 186],311,3,39403,4.377138413685848,0.0,0.0
9002,0,9002,[294 174 385 546  97],83,4,39407,4.377096523381095,0.0,20.0
9003,0,9003,[302 603 427 187 180],458,5,39412,4.377165704131497,20.0,0.0
9004,0,9004,[302 603 427 187 180],666,5,39417,4.377234869516935,20.0,0.0
9005,0,9005,[302 603 427 187 180],666,5,39422,4.377304019542527,20.0,0.0
9006,0,9006,[302 603 427 187 180],339,5,39427,4.37737315421339,20.0,0.0
9007,0,9007,[143  96 403 151  97],308,4,39431,4.377331261101244,0.0,0.0
9008,0,9008,[174  28 258 202  12],7,4,39435,4.377289377289378,20.0,20.0
9009,0,9009,[302 603 427 187 180],474,5,39440,4.377358490566038,20.0,0.0
9010,0,9010,[302 603 427 187 180],458,5,39445,4.377427588502941,20.0,0.0
9011,0,9011,[302 603 427 187 180],339,5,39450,4.3774966711051935,20.0,0.0
9012,0,9012,[302 603 427 187 180],90,5,39455,4.377565738377899,20.0,0.0
9013,0,9013,[275 234  69 318  95],455,4,39459,4.37752385178611,20.0,0.0
9014,0,9014,[144 174 183  64 655],488,3,39462,4.377371048252912,0.0,20.0
9015,0,9015,[302 603 427 187 180],458,5,39467,4.377440106477374,20.0,0.0
9016,0,9016,[302 603 427 187 180],666,5,39472,4.377509149384496,20.0,0.0
9017,0,9017,[302 603 427 187 180],90,5,39477,4.377578176979375,20.0,0.0
9018,0,9018,[302 603 427 187 180],458,5,39482,4.377647189267103,20.0,0.0
9019,0,9019,[302 603 427 187 180],474,5,39487,4.377716186252772,20.0,0.0
9020,0,9020,[302 603 427 187 180],474,5,39492,4.37778516794147,20.0,0.0
9021,0,9021,[302 603 427 187 180],271,5,39497,4.377854134338285,20.0,0.0
9022,0,9022,[302 603 427 187 180],458,5,39502,4.377923085448299,20.0,0.0
9023,0,9023,[302 603 427 187 180],458,5,39507,4.3779920212765955,20.0,0.0
9024,0,9024,[245 403 742  96  79],378,4,39511,4.377950138504155,0.0,0.0
9025,0,9025,[302 603 427 187 180],339,5,39516,4.37801905606027,20.0,0.0
9026,0,9026,[302 603 427 187 180],339,5,39521,4.378087958347181,20.0,0.0
9027,0,9027,[302 603 427 187 180],474,5,39526,4.37815684536996,20.0,0.0
9028,0,9028,[195  12  69   8 180],774,2,39528,4.3778934544246315,20.0,0.0
9029,0,9029,[302 603 427 187 180],90,5,39533,4.37796234772979,20.0,0.0
9030,0,9030,[302 603 427 187 180],90,5,39538,4.378031225777876,20.0,0.0
9031,0,9031,[186 228 111   8 435],64,5,39543,4.37810008857396,0.0,0.0
9032,0,9032,[302 603 427 187 180],474,5,39548,4.378168936123104,20.0,0.0
9033,0,9033,[302 603 427 187 180],339,5,39553,4.378237768430374,20.0,0.0
9034,0,9034,[302 603 427 187 180],666,5,39558,4.37830658550083,20.0,0.0
9035,0,9035,[302 603 427 187 180],90,5,39563,4.37837538733953,20.0,0.0
9036,0,9036,[302 603 427 187 180],271,5,39568,4.378444173951532,20.0,0.0
9037,0,9037,[302 603 427 187 180],13,5,39573,4.37851294534189,20.0,0.0
9038,0,9038,[357 597 127  64 546],207,3,39576,4.37836043810156,20.0,20.0
9039,0,9039,[302 603 427 187 180],537,5,39581,4.378429203539823,20.0,0.0
9040,0,9040,[302 603 427 187 180],474,5,39586,4.378497953766177,20.0,0.0
9041,0,9041,[302 603 427 187 180],537,5,39591,4.378566688785667,20.0,0.0
9042,0,9042,[302 603 427 187 180],90,5,39596,4.37863540860334,20.0,0.0
9043,0,9043,[ 96 117  22 121 174],406,4,39600,4.37859354268023,0.0,20.0
9044,0,9044,[302 603 427 187 180],537,5,39605,4.378662244333886,20.0,0.0
9045,0,9045,[405 183 174 302 333],144,3,39608,4.378509838602698,0.0,20.0
9046,0,9046,[176  50 234 603  96],189,5,39613,4.378578534320769,20.0,20.0
9047,0,9047,[302 603 427 187 180],90,5,39618,4.378647214854111,20.0,0.0
9048,0,9048,[302 603 427 187 180],474,5,39623,4.378715880207758,20.0,0.0
9049,0,9049,[302 603 427 187 180],664,5,39628,4.37878453038674,20.0,0.0
9050,0,9050,[302 603 427 187 180],664,5,39633,4.378853165396089,20.0,0.0
9051,0,9051,[302 603 427 187 180],458,5,39638,4.378921785240831,20.0,0.0
9052,0,9052,[174 168 100   9 204],379,5,39643,4.378990389925991,0.0,40.0
9053,0,9053,[ 88  70  64 200 742],881,2,39645,4.378727634194831,0.0,0.0
9054,0,9054,[302 603 427 187 180],666,5,39650,4.378796245168415,20.0,0.0
9055,0,9055,[302 603 427 187 180],90,5,39655,4.378864840989399,20.0,0.0
9056,0,9056,[301  88 515 508  82],537,2,39657,4.378602186154356,0.0,0.0
9057,0,9057,[302 603 427 187 180],474,5,39662,4.378670788253477,20.0,0.0
9058,0,9058,[302 603 427 187 180],13,5,39667,4.378739375206976,20.0,0.0
9059,0,9059,[302 603 427 187 180],339,5,39672,4.378807947019868,20.0,0.0
9060,0,9060,[302 603 427 187 180],271,5,39677,4.378876503697164,20.0,0.0
9061,0,9061,[302 603 427 187 180],13,5,39682,4.378945045243875,20.0,0.0
9062,0,9062,[302 603 427 187 180],90,5,39687,4.379013571665012,20.0,0.0
9063,0,9063,[302 603 427 187 180],537,5,39692,4.379082082965578,20.0,0.0
9064,0,9064,[302 603 427 187 180],13,5,39697,4.379150579150579,20.0,0.0
9065,0,9065,[302 603 427 187 180],13,5,39702,4.379219060225017,20.0,0.0
9066,0,9066,[302 603 427 187 180],90,5,39707,4.37928752619389,20.0,0.0
9067,0,9067,[302 603 427 187 180],474,5,39712,4.379355977062197,20.0,0.0
9068,0,9068,[302 603 427 187 180],474,5,39717,4.379424412834932,20.0,0.0
9069,0,9069,[302 603 427 187 180],458,5,39722,4.379492833517089,20.0,0.0
9070,0,9070,[546 273 132 200 186],897,4,39726,4.37945099768493,0.0,0.0
9071,0,9071,[216 144 515 655  69],64,4,39730,4.379409171075838,0.0,0.0
9072,0,9072,[168 117  50 174 276],119,4,39734,4.379367353686763,0.0,40.0
9073,0,9073,[269 202 197 204 237],7,3,39737,4.379215340533392,0.0,0.0
9074,0,9074,[328 475 222   7  79],13,0,39737,4.378732782369146,0.0,0.0
9075,0,9075,[174   1 435 143 186],881,3,39740,4.378580872631115,0.0,20.0
9076,0,9076,[302 603 427 187 180],458,5,39745,4.378649333480225,20.0,0.0
9077,0,9077,[  8 265 143  96 235],313,2,39747,4.378387309980172,0.0,0.0
9078,0,9078,[ 96  71 196 186  69],650,3,39750,4.3782354884899215,0.0,0.0
9079,0,9079,[546  95 276 132 100],13,4,39754,4.378193832599119,0.0,20.0
9080,0,9080,[302 603 427 187 180],664,5,39759,4.378262305913446,20.0,0.0
9081,0,9081,[302 603 427 187 180],271,5,39764,4.378330764148866,20.0,0.0
9082,0,9082,[435 196 173 127 118],271,4,39768,4.378289111527028,0.0,20.0
9083,0,9083,[302 603 427 187 180],90,5,39773,4.378357551739322,20.0,0.0
9084,0,9084,[ 89 215 161 211 185],774,0,39773,4.377875619152449,0.0,0.0
9085,0,9085,[302 603 427 187 180],474,5,39778,4.377944089808497,20.0,0.0
9086,0,9086,[302 603 427 187 180],666,5,39783,4.37801254539452,20.0,0.0
9087,0,9087,[302 603 427 187 180],271,5,39788,4.378080985915493,20.0,0.0
9088,0,9088,[153 191   9 173 300],234,1,39789,4.377709318956981,0.0,0.0
9089,0,9089,[302 603 427 187 180],666,5,39794,4.377777777777778,20.0,0.0
9090,0,9090,[302 603 427 187 180],13,5,39799,4.3778462215377845,20.0,0.0
9091,0,9091,[302 603 427 187 180],271,5,39804,4.377914650241971,20.0,0.0
9092,0,9092,[302 603 427 187 180],666,5,39809,4.377983063895304,20.0,0.0
9093,0,9093,[204  82 427 182 180],666,3,39812,4.377831537277325,0.0,0.0
9094,0,9094,[302 603 427 187 180],666,5,39817,4.377899945024739,20.0,0.0
9095,0,9095,[302 603 427 187 180],666,5,39822,4.377968337730871,20.0,0.0
9096,0,9096,[302 603 427 187 180],666,5,39827,4.378036715400682,20.0,0.0
9097,0,9097,[302 603 427 187 180],339,5,39832,4.3781050780391295,20.0,0.0
9098,0,9098,[302 603 427 187 180],666,5,39837,4.378173425651171,20.0,0.0
9099,0,9099,[ 82 191 289 238 204],554,4,39841,4.378131868131868,0.0,0.0
9100,0,9100,[302 603 427 187 180],271,5,39846,4.378200197780464,20.0,0.0
9101,0,9101,[302 603 427 187 180],339,5,39851,4.378268512414854,20.0,0.0
9102,0,9102,[302 603 427 187 180],271,5,39856,4.378336812039987,20.0,0.0
9103,0,9103,[302 603 427 187 180],271,5,39861,4.378405096660808,20.0,0.0
9104,0,9104,[175 405 144 515 269],666,3,39864,4.37825370675453,0.0,0.0
9105,0,9105,[234 435 275  89  69],378,4,39868,4.37821216780145,0.0,0.0
9106,0,9106,[302 603 427 187 180],666,5,39873,4.378280443614802,20.0,0.0
9107,0,9107,[234 135 427 423  71],843,2,39875,4.378019323671498,0.0,0.0
9108,0,9108,[222 475 183 121 215],537,1,39876,4.377648479525744,0.0,0.0
9109,0,9109,[302 603 427 187 180],474,5,39881,4.3777167947310645,20.0,0.0
9110,0,9110,[302 603 427 187 180],339,5,39886,4.377785094940182,20.0,0.0
9111,0,9111,[176 174 288  69 194],64,5,39891,4.377853380158033,0.0,20.0
9112,0,9112,[ 97 210  50 603 151],313,4,39895,4.377811917041589,20.0,20.0
9113,0,9113,[302 603 427 187 180],271,5,39900,4.377880184331797,20.0,0.0
9114,0,9114,[ 97 302  89  12 655],343,4,39904,4.377838727372463,20.0,0.0
9115,0,9115,[302 603 427 187 180],537,5,39909,4.377906976744186,20.0,0.0
9116,0,9116,[302 603 427 187 180],339,5,39914,4.377975211144017,20.0,0.0
9117,0,9117,[302 603 427 187 180],537,5,39919,4.378043430576881,20.0,0.0
9118,0,9118,[302 603 427 187 180],90,5,39924,4.378111635047703,20.0,0.0
9119,0,9119,[237 286 161 175 125],7,4,39928,4.378070175438596,0.0,0.0
9120,0,9120,[ 11 186 118  96 195],378,2,39930,4.377809450718123,0.0,0.0
9121,0,9121,[200  50  79 282 100],271,4,39934,4.377768033326025,0.0,40.0
9122,0,9122,[302 603 427 187 180],458,5,39939,4.3778362380795794,20.0,0.0
9123,0,9123,[302 603 427 187 180],13,5,39944,4.377904427882508,20.0,0.0
9124,0,9124,[302 603 427 187 180],13,5,39949,4.377972602739726,20.0,0.0
9125,0,9125,[302 603 427 187 180],664,5,39954,4.3780407626561475,20.0,0.0
9126,0,9126,[  7  96 385 271  50],64,4,39958,4.377999342609839,0.0,20.0
9127,0,9127,[195 176 196 143  97],374,2,39960,4.377738825591586,0.0,0.0
9128,0,9128,[302 603 427 187 180],90,5,39965,4.377806988717275,20.0,0.0
9129,0,9129,[234 471 121 186  88],92,4,39969,4.37776560788609,0.0,0.0
9130,0,9130,[216 194   1 202  69],804,5,39974,4.3778337531486144,0.0,0.0
9131,0,9131,[302 603 427 187 180],339,5,39979,4.377901883486641,20.0,0.0
9132,0,9132,[302 603 427 187 180],474,5,39984,4.377969998905069,20.0,0.0
9133,0,9133,[302 603 427 187 180],537,5,39989,4.378038099408802,20.0,0.0
9134,0,9134,[302 603 427 187 180],664,5,39994,4.3781061850027365,20.0,0.0
9135,0,9135,[302 603 427 187 180],339,5,39999,4.378174255691769,20.0,0.0
9136,0,9136,[302 603 427 187 180],271,5,40004,4.3782423114807925,20.0,0.0
9137,0,9137,[302 603 427 187 180],666,5,40009,4.378310352374699,20.0,0.0
9138,0,9138,[302 603 427 187 180],458,5,40014,4.378378378378378,20.0,0.0
9139,0,9139,[302 603 427 187 180],339,5,40019,4.378446389496718,20.0,0.0
9140,0,9140,[435 200 568 546 333],343,1,40020,4.37807679684936,0.0,0.0
9141,0,9141,[302 603 427 187 180],666,5,40025,4.3781448260774445,20.0,0.0
9142,0,9142,[302 603 427 187 180],90,5,40030,4.378212840424369,20.0,0.0
9143,0,9143,[302 603 427 187 180],664,5,40035,4.378280839895013,20.0,0.0
9144,0,9144,[302 194 234 174  11],833,1,40036,4.377911427009295,0.0,20.0
9145,0,9145,[302 603 427 187 180],458,5,40041,4.377979444565931,20.0,0.0
9146,0,9146,[127  97 197 132 515],840,4,40045,4.3779381217885645,0.0,20.0
9147,0,9147,[568 328  50 323 300],506,3,40048,4.377787494534324,0.0,20.0
9148,0,9148,[302 603 427 187 180],666,5,40053,4.377855503333698,20.0,0.0
9149,0,9149,[302 603 427 187 180],458,5,40058,4.377923497267759,20.0,0.0
9150,0,9150,[ 12  56 181 588 237],144,5,40063,4.377991476341384,20.0,0.0
9151,0,9151,[302 603 427 187 180],458,5,40068,4.378059440559441,20.0,0.0
9152,0,9152,[191 245  95   4 210],804,4,40072,4.378018136130231,0.0,0.0
9153,0,9153,[302 603 427 187 180],666,5,40077,4.378086082586847,20.0,0.0
9154,0,9154,[238 215  69 385  98],538,4,40081,4.37804478427089,0.0,20.0
9155,0,9155,[ 97 423 323  98   8],474,4,40085,4.378003494975972,0.0,20.0
9156,0,9156,[385 153   8   1 275],378,5,40090,4.378071420770995,0.0,0.0
9157,0,9157,[302 603 427 187 180],90,5,40095,4.378139331731819,20.0,0.0
9158,0,9158,[302 603 427 187 180],90,5,40100,4.378207227863304,20.0,0.0
9159,0,9159,[176 405 496 385 151],537,1,40101,4.377838427947598,0.0,0.0
9160,0,9160,[302 603 427 187 180],339,5,40106,4.37790634210239,20.0,0.0
9161,0,9161,[175  98 313 655 183],659,5,40111,4.3779742414320015,0.0,20.0
9162,0,9162,[302 603 427 187 180],458,5,40116,4.378042125941286,20.0,0.0
9163,0,9163,[302 603 427 187 180],13,5,40121,4.378109995635094,20.0,0.0
9164,0,9164,[302 603 427 187 180],474,5,40126,4.378177850518276,20.0,0.0
9165,0,9165,[302 603 427 187 180],537,5,40131,4.37824569059568,20.0,0.0
9166,0,9166,[302 603 427 187 180],271,5,40136,4.37831351587215,20.0,0.0
9167,0,9167,[471 237 174 127   9],6,3,40139,4.378163176265271,0.0,40.0
9168,0,9168,[302 603 427 187 180],13,5,40144,4.378230995746537,20.0,0.0
9169,0,9169,[235 597 475  69  64],82,2,40146,4.377971646673937,0.0,0.0
9170,0,9170,[302 603 427 187 180],666,5,40151,4.378039472249482,20.0,0.0
9171,0,9171,[655 215  15 195 210],308,3,40154,4.377889228085477,0.0,0.0
9172,0,9172,[385  56 132  11 135],653,3,40157,4.377739016679385,0.0,0.0
9173,0,9173,[302 603 427 187 180],90,5,40162,4.377806845432745,20.0,0.0
9174,0,9174,[185  70 183  95   7],64,5,40167,4.377874659400545,0.0,0.0
9175,0,9175,[144  88 483 546 210],536,4,40171,4.37783347863993,20.0,0.0
9176,0,9176,[302 603 427 187 180],13,5,40176,4.3779012749264465,20.0,0.0
9177,0,9177,[ 12 135 276  64 294],474,4,40180,4.377860100239704,20.0,0.0
9178,0,9178,[181 483 496 185 182],334,3,40183,4.377709990195011,20.0,0.0
9179,0,9179,[ 28 237 228 357   4],537,1,40184,4.377342047930283,20.0,0.0
9180,0,9180,[ 56 187 186  98  82],313,2,40186,4.377083106415423,0.0,20.0
9181,0,9181,[302 603 427 187 180],339,5,40191,4.3771509475059895,20.0,0.0
9182,0,9182,[302 603 427 187 180],537,5,40196,4.377218773821191,20.0,0.0
9183,0,9183,[302 603 427 187 180],271,5,40201,4.377286585365853,20.0,0.0
9184,0,9184,[302 603 427 187 180],537,5,40206,4.3773543821448015,20.0,0.0
9185,0,9185,[ 22 603  95 118 322],13,4,40210,4.3773133028521665,20.0,0.0
9186,0,9186,[328 195 186 174 282],788,2,40212,4.377054533580059,0.0,20.0
9187,0,9187,[302 603 427 187 180],666,5,40217,4.37712233347845,20.0,0.0
9188,0,9188,[435  15  56 216  25],650,2,40219,4.376863641310262,0.0,0.0
9189,0,9189,[302 603 427 187 180],271,5,40224,4.376931447225245,20.0,0.0
9190,0,9190,[302 603 427 187 180],666,5,40229,4.376999238385377,20.0,0.0
9191,0,9191,[302 603 427 187 180],664,5,40234,4.377067014795474,20.0,0.0
9192,0,9192,[302 135   1 318 405],605,4,40238,4.377025998041988,20.0,0.0
9193,0,9193,[ 98 222   9 496 471],194,3,40241,4.376876223624103,0.0,20.0
9194,0,9194,[385 174 275 175 483],10,4,40245,4.376835236541599,20.0,20.0
9195,0,9195,[302 603 427 187 180],90,5,40250,4.376903001304915,20.0,0.0
9196,0,9196,[302 603 427 187 180],664,5,40255,4.376970751331956,20.0,0.0
9197,0,9197,[302 603 427 187 180],339,5,40260,4.377038486627527,20.0,0.0
9198,0,9198,[302 603 427 187 180],339,5,40265,4.377106207196435,20.0,0.0
9199,0,9199,[546 180 175 471 196],92,4,40269,4.377065217391304,0.0,0.0
9200,0,9200,[302 603 427 187 180],271,5,40274,4.377132920334747,20.0,0.0
9201,0,9201,[302 603 427 187 180],458,5,40279,4.3772006085633555,20.0,0.0
9202,0,9202,[302 603 427 187 180],458,5,40284,4.37726828208193,20.0,0.0
9203,0,9203,[302 603 427 187 180],537,5,40289,4.377335940895263,20.0,0.0
9204,0,9204,[678 117 186  69 181],537,1,40290,4.3769690385659965,0.0,0.0
9205,0,9205,[191 237 176  71 144],234,1,40291,4.376602215946122,0.0,0.0
9206,0,9206,[302 603 427 187 180],90,5,40296,4.376669925057022,20.0,0.0
9207,0,9207,[302 603 427 187 180],90,5,40301,4.376737619461338,20.0,0.0
9208,0,9208,[302 603 427 187 180],13,5,40306,4.376805299163862,20.0,0.0
9209,0,9209,[302 603 427 187 180],90,5,40311,4.376872964169381,20.0,0.0
9210,0,9210,[302 603 427 187 180],90,5,40316,4.376940614482684,20.0,0.0
9211,0,9211,[302 603 427 187 180],664,5,40321,4.377008250108554,20.0,0.0
9212,0,9212,[215   9 186  64  98],311,4,40325,4.376967328774557,0.0,20.0
9213,0,9213,[302 603 427 187 180],13,5,40330,4.377034946820056,20.0,0.0
9214,0,9214,[302 603 427 187 180],271,5,40335,4.377102550189908,20.0,0.0
9215,0,9215,[289  79 268 471   7],537,2,40337,4.376844618055555,0.0,0.0
9216,0,9216,[302 603 427 187 180],13,5,40342,4.376912227405881,20.0,0.0
9217,0,9217,[  7  98 211   1 597],447,3,40345,4.3767628552831415,0.0,20.0
9218,0,9218,[ 22 172 515 234 195],804,5,40350,4.376830458835014,0.0,0.0
9219,0,9219,[302 603 427 187 180],666,5,40355,4.376898047722343,20.0,0.0
9220,0,9220,[302 603 427 187 180],666,5,40360,4.376965621949897,20.0,0.0
9221,0,9221,[173 228  79 151  69],537,1,40361,4.3765994361309914,0.0,0.0
9222,0,9222,[302 603 427 187 180],13,5,40366,4.376667028081969,20.0,0.0
9223,0,9223,[302 603 427 187 180],13,5,40371,4.376734605377277,20.0,0.0
9224,0,9224,[302 603 427 187 180],339,5,40376,4.376802168021681,20.0,0.0
9225,0,9225,[302 603 427 187 180],90,5,40381,4.376869716019944,20.0,0.0
9226,0,9226,[275 151 202  15 496],6,2,40383,4.376612116614284,0.0,0.0
9227,0,9227,[302 603 427 187 180],664,5,40388,4.376679670567837,20.0,0.0
9228,0,9228,[302 603 427 187 180],271,5,40393,4.376747209881894,20.0,0.0
9229,0,9229,[302 603 427 187 180],339,5,40398,4.376814734561213,20.0,0.0
9230,0,9230,[302 603 427 187 180],13,5,40403,4.3768822446105515,20.0,0.0
9231,0,9231,[302 603 427 187 180],271,5,40408,4.376949740034662,20.0,0.0
9232,0,9232,[302 603 427 187 180],474,5,40413,4.377017220838297,20.0,0.0
9233,0,9233,[302 603 427 187 180],537,5,40418,4.3770846870262075,20.0,0.0
9234,0,9234,[302 603 427 187 180],666,5,40423,4.37715213860314,20.0,0.0
9235,0,9235,[302 603 427 187 180],90,5,40428,4.377219575573841,20.0,0.0
9236,0,9236,[302 603 427 187 180],537,5,40433,4.377286997943055,20.0,0.0
9237,0,9237,[302 603 427 187 180],666,5,40438,4.377354405715523,20.0,0.0
9238,0,9238,[151 202 328 258 179],653,2,40440,4.377097088429483,0.0,0.0
9239,0,9239,[196 238 211 234  71],843,1,40441,4.376731601731602,0.0,0.0
9240,0,9240,[302 603 427 187 180],90,5,40446,4.376799047722108,20.0,0.0
9241,0,9241,[302 603 427 187 180],666,5,40451,4.376866479117075,20.0,0.0
9242,0,9242,[302 603 427 187 180],666,5,40456,4.376933895921238,20.0,0.0
9243,0,9243,[302 603 427 187 180],474,5,40461,4.377001298139334,20.0,0.0
9244,0,9244,[357 313  56  79 186],659,4,40465,4.376960519199567,20.0,0.0
9245,0,9245,[302 603 427 187 180],90,5,40470,4.377027903958469,20.0,0.0
9246,0,9246,[302 603 427 187 180],339,5,40475,4.377095274142965,20.0,0.0
9247,0,9247,[144 216 238 403 179],653,1,40476,4.376730103806229,0.0,0.0
9248,0,9248,[475  15  88   8 200],308,4,40480,4.376689371823981,0.0,0.0
9249,0,9249,[302 603 427 187 180],664,5,40485,4.376756756756757,20.0,0.0
9250,0,9250,[302 603 427 187 180],664,5,40490,4.376824127121393,20.0,0.0
9251,0,9251,[302 603 427 187 180],664,5,40495,4.376891482922612,20.0,0.0
9252,0,9252,[  4 235   9  15 161],378,4,40499,4.376850751107749,0.0,0.0
9253,0,9253,[302 603 427 187 180],474,5,40504,4.376918089474822,20.0,0.0
9254,0,9254,[302 603 427 187 180],537,5,40509,4.376985413290114,20.0,0.0
9255,0,9255,[302 603 427 187 180],271,5,40514,4.37705272255834,20.0,0.0
9256,0,9256,[302 603 427 187 180],474,5,40519,4.377120017284217,20.0,0.0
9257,0,9257,[302 603 427 187 180],90,5,40524,4.377187297472457,20.0,0.0
9258,0,9258,[ 95   7  79 127 385],455,4,40528,4.377146560103683,0.0,20.0
9259,0,9259,[302 603 427 187 180],474,5,40533,4.377213822894168,20.0,0.0
9260,0,9260,[333 265 174 161  50],13,4,40537,4.377173091458806,0.0,40.0
9261,0,9261,[302 603 427 187 180],537,5,40542,4.3772403368602895,20.0,0.0
9262,0,9262,[204 222  89  28 405],334,3,40545,4.377091654971392,0.0,0.0
9263,0,9263,[302 603 427 187 180],664,5,40550,4.377158894645941,20.0,0.0
9264,0,9264,[302 603 427 187 180],666,5,40555,4.37722611980572,20.0,0.0
9265,0,9265,[186 269 405 237  25],537,1,40556,4.376861644722642,0.0,0.0
9266,0,9266,[302 603 427 187 180],458,5,40561,4.376928887450092,20.0,0.0
9267,0,9267,[302 603 427 187 180],271,5,40566,4.3769961156668105,20.0,0.0
9268,0,9268,[269 127  79 153  50],64,4,40570,4.376955442874096,0.0,40.0
9269,0,9269,[173  28 597 234 588],13,3,40573,4.37680690399137,0.0,0.0
9270,0,9270,[302 603 427 187 180],339,5,40578,4.376874123611261,20.0,0.0
9271,0,9271,[302 603 427 187 180],90,5,40583,4.376941328731665,20.0,0.0
9272,0,9272,[302 603 427 187 180],537,5,40588,4.377008519357274,20.0,0.0
9273,0,9273,[302 603 427 187 180],664,5,40593,4.377075695492776,20.0,0.0
9274,0,9274,[322 200 286 222 196],234,1,40594,4.376711590296496,0.0,0.0
9275,0,9275,[302 603 427 187 180],474,5,40599,4.376778783958603,20.0,0.0
9276,0,9276,[302 603 427 187 180],339,5,40604,4.376845963134634,20.0,0.0
9277,0,9277,[302 603 427 187 180],271,5,40609,4.376913127829273,20.0,0.0
9278,0,9278,[302 603 427 187 180],666,5,40614,4.376980278047204,20.0,0.0
9279,0,9279,[302 603 427 187 180],339,5,40619,4.377047413793103,20.0,0.0
9280,0,9280,[238 182 288 132  79],474,4,40623,4.377006788061632,0.0,0.0
9281,0,9281,[237 302   4 211 385],343,4,40627,4.376966171083819,0.0,0.0
9282,0,9282,[302 603 427 187 180],271,5,40632,4.377033286653021,20.0,0.0
9283,0,9283,[211 603  69 322 168],313,3,40635,4.376884963377854,20.0,0.0
9284,0,9284,[302 603 427 187 180],664,5,40640,4.376952073236403,20.0,0.0
9285,0,9285,[302 603 427 187 180],537,5,40645,4.377019168640965,20.0,0.0
9286,0,9286,[302 603 427 187 180],13,5,40650,4.37708624959621,20.0,0.0
9287,0,9287,[302 603 427 187 180],90,5,40655,4.377153316106805,20.0,0.0
9288,0,9288,[302 603 427 187 180],664,5,40660,4.377220368177414,20.0,0.0
9289,0,9289,[196  89 210 748 294],92,3,40663,4.377072120559742,0.0,0.0
9290,0,9290,[302 603 427 187 180],458,5,40668,4.377139166935744,20.0,0.0
9291,0,9291,[302 603 427 187 180],339,5,40673,4.377206198880757,20.0,0.0
9292,0,9292,[302 603 427 187 180],666,5,40678,4.37727321639944,20.0,0.0
9293,0,9293,[ 69 135  89 216  22],313,4,40682,4.377232623197762,0.0,0.0
9294,0,9294,[302 603 427 187 180],13,5,40687,4.37729962345347,20.0,0.0
9295,0,9295,[302 603 427 187 180],664,5,40692,4.37736660929432,20.0,0.0
9296,0,9296,[191 597 603 322  25],804,4,40696,4.377326019145961,20.0,0.0
9297,0,9297,[302 603 427 187 180],90,5,40701,4.377392987739299,20.0,0.0
9298,0,9298,[357 742 191 200 655],488,2,40703,4.377137326594258,20.0,0.0
9299,0,9299,[302 603 427 187 180],339,5,40708,4.377204301075269,20.0,0.0
9300,0,9300,[302 603 427 187 180],90,5,40713,4.377271261154714,20.0,0.0
9301,0,9301,[210 127   4 435  69],379,5,40718,4.37733820683724,0.0,20.0
9302,0,9302,[302 603 427 187 180],13,5,40723,4.377405138127486,20.0,0.0
9303,0,9303,[333 144 204 195 546],328,1,40724,4.3770421324161655,0.0,0.0
9304,0,9304,[302 603 427 187 180],537,5,40729,4.377109081139173,20.0,0.0
9305,0,9305,[302 603 427 187 180],339,5,40734,4.3771760154738875,20.0,0.0
9306,0,9306,[235 333 301 210 748],13,1,40735,4.376813151391426,0.0,0.0
9307,0,9307,[302 603 427 187 180],537,5,40740,4.376880103137086,20.0,0.0
9308,0,9308,[302 603 427 187 180],666,5,40745,4.376947040498442,20.0,0.0
9309,0,9309,[302 603 427 187 180],537,5,40750,4.377013963480129,20.0,0.0
9310,0,9310,[228 210  25 117 153],749,5,40755,4.377080872086779,0.0,0.0
9311,0,9311,[302 603 427 187 180],458,5,40760,4.3771477663230245,20.0,0.0
9312,0,9312,[302 603 427 187 180],339,5,40765,4.377214646193493,20.0,0.0
9313,0,9313,[302 603 427 187 180],339,5,40770,4.3772815117028125,20.0,0.0
9314,0,9314,[ 69 211 186  89 195],738,4,40774,4.3772410091250675,0.0,0.0
9315,0,9315,[302 603 427 187 180],271,5,40779,4.377307857449549,20.0,0.0
9316,0,9316,[302 603 427 187 180],90,5,40784,4.377374691424278,20.0,0.0
9317,0,9317,[ 71 294 144 496  15],194,5,40789,4.377441511053874,0.0,0.0
9318,0,9318,[302 603 427 187 180],90,5,40794,4.377508316342955,20.0,0.0
9319,0,9319,[302 603 427 187 180],271,5,40799,4.3775751072961375,20.0,0.0
9320,0,9320,[302 603 427 187 180],90,5,40804,4.377641883918034,20.0,0.0
9321,0,9321,[302 603 427 187 180],271,5,40809,4.377708646213259,20.0,0.0
9322,0,9322,[  8 748  89  97 216],881,3,40812,4.377560870964282,0.0,0.0
9323,0,9323,[302 603 427 187 180],339,5,40817,4.377627627627628,20.0,0.0
9324,0,9324,[222   9 228 197 168],488,4,40821,4.377587131367292,0.0,0.0
9325,0,9325,[257 135 655 275  89],95,2,40823,4.377332189577525,0.0,0.0
9326,0,9326,[302 603 427 187 180],537,5,40828,4.3773989492870164,20.0,0.0
9327,0,9327,[405  69 173 423 187],271,4,40832,4.377358490566038,0.0,0.0
9328,0,9328,[194 403  69  79  96],378,4,40836,4.377318040518812,0.0,0.0
9329,0,9329,[302 603 427 187 180],90,5,40841,4.377384780278671,20.0,0.0
9330,0,9330,[302 603 427 187 180],666,5,40846,4.3774515057335766,20.0,0.0
9331,0,9331,[222  79 289 127 405],474,4,40850,4.377411058722675,0.0,20.0
9332,0,9332,[302 603 427 187 180],666,5,40855,4.37747776706311,20.0,0.0
9333,0,9333,[302 603 427 187 180],474,5,40860,4.37754446110992,20.0,0.0
9334,0,9334,[ 28  11 168  95  89],64,4,40864,4.377504017139796,0.0,0.0
9335,0,9335,[179 328 496 300 195],378,1,40865,4.377142245072836,0.0,0.0
9336,0,9336,[202 257 385 222 403],279,3,40868,4.37699475206169,0.0,0.0
9337,0,9337,[302 603 427 187 180],537,5,40873,4.377061469265367,20.0,0.0
9338,0,9338,[302 603 427 187 180],271,5,40878,4.377128172181176,20.0,0.0
9339,0,9339,[ 64 161 216 200 215],7,4,40882,4.377087794432549,0.0,0.0
9340,0,9340,[302 603 427 187 180],13,5,40887,4.377154480248367,20.0,0.0
9341,0,9341,[302 603 427 187 180],271,5,40892,4.377221151787626,20.0,0.0
9342,0,9342,[302 603 427 187 180],666,5,40897,4.377287809054907,20.0,0.0
9343,0,9343,[568  12 235 216 100],92,2,40899,4.377033390410959,20.0,20.0
9344,0,9344,[302 603 427 187 180],90,5,40904,4.377100053504548,20.0,0.0
9345,0,9345,[302 603 427 187 180],271,5,40909,4.3771667023325485,20.0,0.0
9346,0,9346,[176 385  82 153 180],10,5,40914,4.37723333689954,0.0,0.0
9347,0,9347,[265   7 301  89 153],666,4,40918,4.37719298245614,0.0,0.0
9348,0,9348,[302 603 427 187 180],271,5,40923,4.377259599957215,20.0,0.0
9349,0,9349,[302 603 427 187 180],271,5,40928,4.377326203208556,20.0,0.0
9350,0,9350,[302 603 427 187 180],271,5,40933,4.377392792214736,20.0,0.0
9351,0,9351,[302 603 427 187 180],458,5,40938,4.377459366980325,20.0,0.0
9352,0,9352,[302 603 427 187 180],90,5,40943,4.37752592750989,20.0,0.0
9353,0,9353,[302 603 427 187 180],474,5,40948,4.377592473807996,20.0,0.0
9354,0,9354,[302 603 427 187 180],90,5,40953,4.377659005879209,20.0,0.0
9355,0,9355,[302 603 427 187 180],90,5,40958,4.377725523728089,20.0,0.0
9356,0,9356,[175 179 405 427 135],379,4,40962,4.377685155498558,0.0,0.0
9357,0,9357,[302 603 427 187 180],666,5,40967,4.377751656336824,20.0,0.0
9358,0,9358,[302 603 427 187 180],339,5,40972,4.377818142963992,20.0,0.0
9359,0,9359,[302 603 427 187 180],458,5,40977,4.377884615384615,20.0,0.0
9360,0,9360,[313 286 742 228  11],454,1,40978,4.377523768828117,0.0,0.0
9361,0,9361,[302 603 427 187 180],13,5,40983,4.377590258491775,20.0,0.0
9362,0,9362,[302 603 427 187 180],458,5,40988,4.377656733952793,20.0,0.0
9363,0,9363,[302 603 427 187 180],90,5,40993,4.37772319521572,20.0,0.0
9364,0,9364,[302 603 427 187 180],271,5,40998,4.377789642285104,20.0,0.0
9365,0,9365,[  7 288 181   4 475],64,4,41002,4.377749306000427,0.0,0.0
9366,0,9366,[302 603 427 187 180],458,5,41007,4.377815736094801,20.0,0.0
9367,0,9367,[ 50 174 322 186 204],881,3,41010,4.377668659265585,0.0,40.0
9368,0,9368,[302 603 427 187 180],664,5,41015,4.377735083786957,20.0,0.0
9369,0,9369,[302 603 427 187 180],474,5,41020,4.377801494130202,20.0,0.0
9370,0,9370,[302 603 427 187 180],537,5,41025,4.377867890299862,20.0,0.0
9371,0,9371,[302 603 427 187 180],271,5,41030,4.377934272300469,20.0,0.0
9372,0,9372,[515 143 117 322 286],474,5,41035,4.3780006401365625,0.0,0.0
9373,0,9373,[195 181 427 161   8],13,4,41039,4.377960315767015,0.0,0.0
9374,0,9374,[655 603 427 210 294],848,5,41044,4.378026666666667,20.0,0.0
9375,0,9375,[153 357  25 269 301],650,3,41047,4.377879692832765,20.0,0.0
9376,0,9376,[302 603 427 187 180],474,5,41052,4.377946038178522,20.0,0.0
9377,0,9377,[302 603 427 187 180],13,5,41057,4.378012369375133,20.0,0.0
9378,0,9378,[302 603 427 187 180],90,5,41062,4.378078686427124,20.0,0.0
9379,0,9379,[655  22 333 173  15],144,4,41066,4.378038379530917,0.0,0.0
9380,0,9380,[302 603 427 187 180],474,5,41071,4.378104679671677,20.0,0.0
9381,0,9381,[302 603 427 187 180],271,5,41076,4.37817096567896,20.0,0.0
9382,0,9382,[237 200 313   7  22],474,4,41080,4.378130661835234,0.0,0.0
9383,0,9383,[678 175  82 187  15],881,2,41082,4.377877237851663,0.0,0.0
9384,0,9384,[302 603 427 187 180],458,5,41087,4.377943526904635,20.0,0.0
9385,0,9385,[302 603 427 187 180],13,5,41092,4.378009801832516,20.0,0.0
9386,0,9386,[302 603 427 187 180],474,5,41097,4.378076062639821,20.0,0.0
9387,0,9387,[302 603 427 187 180],339,5,41102,4.378142309331061,20.0,0.0
9388,0,9388,[302 603 427 187 180],271,5,41107,4.378208541910746,20.0,0.0
9389,0,9389,[302 603 427 187 180],271,5,41112,4.378274760383387,20.0,0.0
9390,0,9390,[302 603 427 187 180],13,5,41117,4.378340964753487,20.0,0.0
9391,0,9391,[302 603 427 187 180],537,5,41122,4.378407155025553,20.0,0.0
9392,0,9392,[125 168  50 197 237],406,2,41124,4.378153944426701,0.0,20.0
9393,0,9393,[302 603 427 187 180],664,5,41129,4.378220140515222,20.0,0.0
9394,0,9394,[302 603 427 187 180],458,5,41134,4.378286322511975,20.0,0.0
9395,0,9395,[302 603 427 187 180],664,5,41139,4.378352490421456,20.0,0.0
9396,0,9396,[302 603 427 187 180],339,5,41144,4.378418644248164,20.0,0.0
9397,0,9397,[302 603 427 187 180],90,5,41149,4.378484783996595,20.0,0.0
9398,0,9398,[302 603 427 187 180],458,5,41154,4.378550909671242,20.0,0.0
9399,0,9399,[143  98 176 333 301],666,3,41157,4.378404255319149,0.0,20.0
9400,0,9400,[483 276  79 475 328],13,2,41159,4.378151260504202,20.0,0.0
9401,0,9401,[302 603 427 187 180],271,5,41164,4.378217400553074,20.0,0.0
9402,0,9402,[302 603 427 187 180],458,5,41169,4.3782835265340845,20.0,0.0
9403,0,9403,[302 603 427 187 180],666,5,41174,4.378349638451723,20.0,0.0
9404,0,9404,[302 603 427 187 180],474,5,41179,4.378415736310473,20.0,0.0
9405,0,9405,[302 603 427 187 180],90,5,41184,4.37848182011482,20.0,0.0
9406,0,9406,[302 603 427 187 180],271,5,41189,4.378547889869246,20.0,0.0
9407,0,9407,[127  12 202 655 172],308,5,41194,4.378613945578231,20.0,20.0
9408,0,9408,[302 603 427 187 180],90,5,41199,4.378679987246254,20.0,0.0
9409,0,9409,[302 603 427 187 180],271,5,41204,4.378746014877789,20.0,0.0
9410,0,9410,[202 234   4 100  71],7,4,41208,4.3787057698437994,0.0,20.0
9411,0,9411,[302 603 427 187 180],537,5,41213,4.378771780705482,20.0,0.0
9412,0,9412,[302 603 427 187 180],458,5,41218,4.378837777541698,20.0,0.0
9413,0,9413,[302 603 427 187 180],271,5,41223,4.378903760356915,20.0,0.0
9414,0,9414,[302 603 427 187 180],664,5,41228,4.378969729155603,20.0,0.0
9415,0,9415,[302 603 427 187 180],13,5,41233,4.379035683942226,20.0,0.0
9416,0,9416,[238 300 228  96 357],479,4,41237,4.378995433789954,20.0,0.0
9417,0,9417,[302 603 427 187 180],666,5,41242,4.379061371841155,20.0,0.0
9418,0,9418,[235 176 144 151  50],648,4,41246,4.379021127508228,0.0,20.0
9419,0,9419,[302 603 427 187 180],537,5,41251,4.379087048832272,20.0,0.0
9420,0,9420,[302 603 427 187 180],458,5,41256,4.379152956161766,20.0,0.0
9421,0,9421,[423 216 144  25 200],308,3,41259,4.3790065803438765,0.0,0.0
9422,0,9422,[302 603 427 187 180],13,5,41264,4.379072482224345,20.0,0.0
9423,0,9423,[302 603 427 187 180],339,5,41269,4.379138370118845,20.0,0.0
9424,0,9424,[302 603 427 187 180],339,5,41274,4.37920424403183,20.0,0.0
9425,0,9425,[204 197 196 183  69],326,2,41276,4.378951835349034,0.0,0.0
9426,0,9426,[302 603 427 187 180],339,5,41281,4.379017715073725,20.0,0.0
9427,0,9427,[191 265 423  79 196],13,3,41284,4.378871446754348,0.0,0.0
9428,0,9428,[302 603 427 187 180],339,5,41289,4.378937321030862,20.0,0.0
9429,0,9429,[302 603 427 187 180],664,5,41294,4.379003181336161,20.0,0.0
9430,0,9430,[118 235  28 568 117],774,0,41294,4.378538861202418,0.0,0.0
9431,0,9431,[235  71 151   8  22],82,2,41296,4.378286683630195,0.0,0.0
9432,0,9432,[302 603 427 187 180],537,5,41301,4.37835259196438,20.0,0.0
9433,0,9433,[ 11 216  50  56 204],653,3,41304,4.378206487174051,0.0,20.0
9434,0,9434,[302 603 427 187 180],664,5,41309,4.378272390037096,20.0,0.0
9435,0,9435,[302 603 427 187 180],339,5,41314,4.378338278931751,20.0,0.0
9436,0,9436,[ 64 222  96   9 603],145,4,41318,4.37829818798347,20.0,0.0
9437,0,9437,[172 269  56 234  95],102,1,41319,4.3779402415766056,0.0,0.0
9438,0,9438,[655  96 144  50 385],234,1,41320,4.377582371013879,0.0,20.0
9439,0,9439,[ 11   8 423 483 135],234,4,41324,4.377542372881356,20.0,0.0
9440,0,9440,[ 50 187 496  25  12],343,4,41328,4.377502383222116,20.0,20.0
9441,0,9441,[302 603 427 187 180],90,5,41333,4.377568311798348,20.0,0.0
9442,0,9442,[  9 100 175  64 216],82,5,41338,4.377634226411098,0.0,20.0
9443,0,9443,[302 603 427 187 180],339,5,41343,4.377700127064803,20.0,0.0
9444,0,9444,[302 603 427 187 180],537,5,41348,4.377766013763896,20.0,0.0
9445,0,9445,[302 603 427 187 180],13,5,41353,4.377831886512809,20.0,0.0
9446,0,9446,[302 603 427 187 180],666,5,41358,4.377897745315973,20.0,0.0
9447,0,9447,[ 50 228 200   9 286],145,3,41361,4.377751905165114,0.0,20.0
9448,0,9448,[333 216 294 196 194],881,2,41363,4.377500264578262,0.0,0.0
9449,0,9449,[302 603 427 187 180],90,5,41368,4.377566137566138,20.0,0.0
9450,0,9450,[216 187 405  11 172],537,1,41369,4.377208760977674,0.0,0.0
9451,0,9451,[302 603 427 187 180],474,5,41374,4.377274650867541,20.0,0.0
9452,0,9452,[302 603 427 187 180],271,5,41379,4.377340526816884,20.0,0.0
9453,0,9453,[302 603 427 187 180],339,5,41384,4.377406388830125,20.0,0.0
9454,0,9454,[302 603 427 187 180],13,5,41389,4.377472236911687,20.0,0.0
9455,0,9455,[302 603 427 187 180],537,5,41394,4.37753807106599,20.0,0.0
9456,0,9456,[302 603 427 187 180],13,5,41399,4.3776038912974515,20.0,0.0
9457,0,9457,[302 603 427 187 180],339,5,41404,4.3776696976104885,20.0,0.0
9458,0,9458,[ 82 427 323  56 328],328,3,41407,4.3775240511682,0.0,0.0
9459,0,9459,[302 603 427 187 180],271,5,41412,4.377589852008457,20.0,0.0
9460,0,9460,[ 12 228  97 215 195],406,3,41415,4.377444244794419,20.0,0.0
9461,0,9461,[302 603 427 187 180],666,5,41420,4.377510040160643,20.0,0.0
9462,0,9462,[302 603 427 187 180],458,5,41425,4.3775758216210505,20.0,0.0
9463,0,9463,[302 603 427 187 180],271,5,41430,4.377641589180051,20.0,0.0
9464,0,9464,[302 603 427 187 180],13,5,41435,4.37770734284205,20.0,0.0
9465,0,9465,[302 603 427 187 180],664,5,41440,4.377773082611451,20.0,0.0
9466,0,9466,[302 603 427 187 180],271,5,41445,4.377838808492658,20.0,0.0
9467,0,9467,[302 603 427 187 180],458,5,41450,4.3779045204900715,20.0,0.0
9468,0,9468,[302 603 427 187 180],666,5,41455,4.377970218608089,20.0,0.0
9469,0,9469,[228  56 515 333  82],387,4,41459,4.3779303062302,0.0,0.0
9470,0,9470,[302 603 427 187 180],537,5,41464,4.377995987752085,20.0,0.0
9471,0,9471,[302 603 427 187 180],666,5,41469,4.378061655405405,20.0,0.0
9472,0,9472,[435 228 234 121 211],85,3,41472,4.377916182835427,0.0,0.0
9473,0,9473,[196 748 515 245 546],346,4,41476,4.377876293012455,0.0,0.0
9474,0,9474,[302 603 427 187 180],13,5,41481,4.377941952506596,20.0,0.0
9475,0,9475,[302 603 427 187 180],271,5,41486,4.378007598142676,20.0,0.0
9476,0,9476,[302 603 427 187 180],458,5,41491,4.378073229925082,20.0,0.0
9477,0,9477,[302 603 427 187 180],271,5,41496,4.378138847858198,20.0,0.0
9478,0,9478,[172  79 273 234 294],479,4,41500,4.378098955586032,0.0,0.0
9479,0,9479,[302 603 427 187 180],271,5,41505,4.378164556962025,20.0,0.0
9480,0,9480,[302 603 427 187 180],474,5,41510,4.3782301444995255,20.0,0.0
9481,0,9481,[ 79 301 496 258 603],650,2,41512,4.377979329255432,20.0,0.0
9482,0,9482,[181   7 286  22 204],144,3,41515,4.377834018770431,0.0,0.0
9483,0,9483,[302 603 427 187 180],666,5,41520,4.377899620413328,20.0,0.0
9484,0,9484,[302 603 427 187 180],339,5,41525,4.377965208223511,20.0,0.0
9485,0,9485,[  8  95 546  98 235],882,3,41528,4.377819945182374,0.0,20.0
9486,0,9486,[302 603 427 187 180],339,5,41533,4.377885527564035,20.0,0.0
9487,0,9487,[302 603 427 187 180],666,5,41538,4.377951096121416,20.0,0.0
9488,0,9488,[ 88  89 235 174 191],738,3,41541,4.377805880493202,0.0,20.0
9489,0,9489,[302 603 427 187 180],90,5,41546,4.377871443624868,20.0,0.0
9490,0,9490,[204 496  64 143  98],311,4,41550,4.37783162996523,0.0,20.0
9491,0,9491,[302 603 427 187 180],90,5,41555,4.377897176569743,20.0,0.0
9492,0,9492,[302 603 427 187 180],13,5,41560,4.3779627093647955,20.0,0.0
9493,0,9493,[302 603 427 187 180],90,5,41565,4.378028228354751,20.0,0.0
9494,0,9494,[302 603 427 187 180],537,5,41570,4.37809373354397,20.0,0.0
9495,0,9495,[302 603 427 187 180],13,5,41575,4.378159224936815,20.0,0.0
9496,0,9496,[302 603 427 187 180],90,5,41580,4.3782247025376435,20.0,0.0
9497,0,9497,[302 603 427 187 180],666,5,41585,4.37829016635081,20.0,0.0
9498,0,9498,[302 603 427 187 180],537,5,41590,4.378355616380672,20.0,0.0
9499,0,9499,[302 603 427 187 180],13,5,41595,4.3784210526315785,20.0,0.0
9500,0,9500,[302 603 427 187 180],90,5,41600,4.378486475107883,20.0,0.0
9501,0,9501,[357 191 183 288 172],59,5,41605,4.378551883813934,20.0,0.0
9502,0,9502,[ 95 100  12  96 117],406,5,41610,4.378617278754078,20.0,20.0
9503,0,9503,[302 603 427 187 180],666,5,41615,4.37868265993266,20.0,0.0
9504,0,9504,[496 111 405 655  95],64,4,41619,4.378642819568648,0.0,0.0
9505,0,9505,[318 121 603   4 269],537,2,41621,4.378392594151062,40.0,0.0
9506,0,9506,[302 603 427 187 180],537,5,41626,4.378457978331755,20.0,0.0
9507,0,9507,[302 603 427 187 180],13,5,41631,4.3785233487589394,20.0,0.0
9508,0,9508,[302 603 427 187 180],90,5,41636,4.378588705436955,20.0,0.0
9509,0,9509,[302 603 427 187 180],271,5,41641,4.378654048370136,20.0,0.0
9510,0,9510,[302 603 427 187 180],474,5,41646,4.378719377562822,20.0,0.0
9511,0,9511,[302 603 427 187 180],271,5,41651,4.378784693019344,20.0,0.0
9512,0,9512,[302 603 427 187 180],474,5,41656,4.3788499947440345,20.0,0.0
9513,0,9513,[ 50 258 471 132 127],7,5,41661,4.378915282741223,0.0,40.0
9514,0,9514,[302 603 427 187 180],664,5,41666,4.378980557015239,20.0,0.0
9515,0,9515,[302 603 427 187 180],537,5,41671,4.3790458175704075,20.0,0.0
9516,0,9516,[302 603 427 187 180],271,5,41676,4.379111064411054,20.0,0.0
9517,0,9517,[302 603 427 187 180],474,5,41681,4.3791762975415,20.0,0.0
9518,0,9518,[302 603 427 187 180],458,5,41686,4.379241516966068,20.0,0.0
9519,0,9519,[ 79 173 125 286 168],158,4,41690,4.379201680672269,0.0,0.0
9520,0,9520,[302 603 427 187 180],458,5,41695,4.3792668837307005,20.0,0.0
9521,0,9521,[ 15 182  25 153 265],194,2,41697,4.379017013232514,0.0,0.0
9522,0,9522,[143 135 216 180 186],452,1,41698,4.378662186285834,0.0,0.0
9523,0,9523,[144 483 127 191 245],207,3,41701,4.378517429651407,20.0,20.0
9524,0,9524,[302 603 427 187 180],339,5,41706,4.378582677165355,20.0,0.0
9525,0,9525,[265  11  71 475 161],308,3,41709,4.378437959269368,0.0,0.0
9526,0,9526,[302 603 427 187 180],339,5,41714,4.378503201427522,20.0,0.0
9527,0,9527,[302 603 427 187 180],474,5,41719,4.378568429890848,20.0,0.0
9528,0,9528,[302 603 427 187 180],458,5,41724,4.378633644663658,20.0,0.0
9529,0,9529,[302 603 427 187 180],271,5,41729,4.378698845750263,20.0,0.0
9530,0,9530,[302 603 427 187 180],90,5,41734,4.378764033154968,20.0,0.0
9531,0,9531,[302 603 427 187 180],664,5,41739,4.378829206882082,20.0,0.0
9532,0,9532,[302 603 427 187 180],664,5,41744,4.378894366935907,20.0,0.0
9533,0,9533,[302 603 427 187 180],666,5,41749,4.378959513320747,20.0,0.0
9534,0,9534,[168 125 210   1 289],374,3,41752,4.378814892501311,0.0,0.0
9535,0,9535,[302 603 427 187 180],13,5,41757,4.378880033557047,20.0,0.0
9536,0,9536,[118  56 181 228  25],892,4,41761,4.378840306175946,0.0,0.0
9537,0,9537,[151 300 748 100 471],447,3,41764,4.37869574334242,0.0,20.0
9538,0,9538,[302 603 427 187 180],271,5,41769,4.378760876402138,20.0,0.0
9539,0,9539,[302 603 427 187 180],666,5,41774,4.378825995807128,20.0,0.0
9540,0,9540,[ 71 176 603  64 174],60,4,41778,4.378786290745205,20.0,20.0
9541,0,9541,[302 603 427 187 180],271,5,41783,4.37885139383777,20.0,0.0
9542,0,9542,[302 603 427 187 180],537,5,41788,4.378916483286178,20.0,0.0
9543,0,9543,[ 28  64 202 211  50],804,5,41793,4.378981559094719,0.0,20.0
9544,0,9544,[302 603 427 187 180],339,5,41798,4.37904662126768,20.0,0.0
9545,0,9545,[302 603 427 187 180],13,5,41803,4.379111669809344,20.0,0.0
9546,0,9546,[302 603 427 187 180],271,5,41808,4.379176704723997,20.0,0.0
9547,0,9547,[302 603 427 187 180],664,5,41813,4.37924172601592,20.0,0.0
9548,0,9548,[228 435 333 183  96],387,3,41816,4.379097287674102,0.0,0.0
9549,0,9549,[173   9 168 323 200],59,5,41821,4.379162303664922,0.0,0.0
9550,0,9550,[302 603 427 187 180],90,5,41826,4.379227306041252,20.0,0.0
9551,0,9551,[302 603 427 187 180],90,5,41831,4.37929229480737,20.0,0.0
9552,0,9552,[597 202 182 215 546],653,1,41832,4.378938553334031,0.0,0.0
9553,0,9553,[302 603 427 187 180],474,5,41837,4.379003558718861,20.0,0.0
9554,0,9554,[302 603 427 187 180],537,5,41842,4.379068550497122,20.0,0.0
9555,0,9555,[228 100 655 117 173],194,3,41845,4.378924236082042,0.0,20.0
9556,0,9556,[302 603 427 187 180],666,5,41850,4.3789892225593805,20.0,0.0
9557,0,9557,[603 588 234  96 228],536,4,41854,4.378949571039967,20.0,0.0
9558,0,9558,[302 603 427 187 180],458,5,41859,4.379014541270007,20.0,0.0
9559,0,9559,[210 168 215 132 294],474,3,41862,4.378870292887029,0.0,0.0
9560,0,9560,[174  28 313  50 118],92,3,41865,4.378726074678381,0.0,40.0
9561,0,9561,[ 64 496 294  88 172],378,3,41868,4.378581886634596,0.0,0.0
9562,0,9562,[302 603 427 187 180],271,5,41873,4.378646868137614,20.0,0.0
9563,0,9563,[302 603 427 187 180],474,5,41878,4.3787118360518615,20.0,0.0
9564,0,9564,[302 603 427 187 180],339,5,41883,4.3787767903815995,20.0,0.0
9565,0,9565,[302 603 427 187 180],664,5,41888,4.378841731131089,20.0,0.0
9566,0,9566,[258 216 333 132  15],653,1,41889,4.37848855440577,0.0,0.0
9567,0,9567,[302 603 427 187 180],664,5,41894,4.378553511705686,20.0,0.0
9568,0,9568,[302 603 427 187 180],666,5,41899,4.378618455428989,20.0,0.0
9569,0,9569,[302 603 427 187 180],90,5,41904,4.378683385579937,20.0,0.0
9570,0,9570,[ 98 183 186  79  50],385,1,41905,4.378330373001776,0.0,40.0
9571,0,9571,[302 603 427 187 180],666,5,41910,4.378395319682407,20.0,0.0
9572,0,9572,[302 603 427 187 180],90,5,41915,4.3784602527943175,20.0,0.0
9573,0,9573,[302 603 427 187 180],537,5,41920,4.378525172341759,20.0,0.0
9574,0,9574,[143 173  79 748 194],474,4,41924,4.3784856396866845,0.0,0.0
9575,0,9575,[ 25 235 275  98 294],271,2,41926,4.378237259816207,0.0,20.0
9576,0,9576,[302 603 427 187 180],537,5,41931,4.3783021823117885,20.0,0.0
9577,0,9577,[ 12 100 318  69  11],499,4,41935,4.378262685320526,40.0,20.0
9578,0,9578,[302 603 427 187 180],474,5,41940,4.37832759160664,20.0,0.0
9579,0,9579,[302 603 427 187 180],664,5,41945,4.37839248434238,20.0,0.0
9580,0,9580,[302 603 427 187 180],664,5,41950,4.37845736353199,20.0,0.0
9581,0,9581,[302 603 427 187 180],339,5,41955,4.378522229179712,20.0,0.0
9582,0,9582,[302 603 427 187 180],664,5,41960,4.378587081289784,20.0,0.0
9583,0,9583,[132  56 228  25  28],882,4,41964,4.378547579298831,0.0,0.0
9584,0,9584,[302 603 427 187 180],664,5,41969,4.3786124152321335,20.0,0.0
9585,0,9585,[427   4 300 496 423],780,2,41971,4.37836428124348,0.0,0.0
9586,0,9586,[288 195 191 475 357],144,3,41974,4.378220506936477,20.0,0.0
9587,0,9587,[302 603 427 187 180],664,5,41979,4.37828535669587,20.0,0.0
9588,0,9588,[ 56 483 222 216  71],60,4,41983,4.378245906768172,20.0,0.0
9589,0,9589,[302 603 427 187 180],666,5,41988,4.378310740354536,20.0,0.0
9590,0,9590,[302 603 427 187 180],90,5,41993,4.378375560421229,20.0,0.0
9591,0,9591,[302 603 427 187 180],664,5,41998,4.378440366972477,20.0,0.0
9592,0,9592,[257   1 202  79 135],454,2,42000,4.378192431981653,0.0,0.0
9593,0,9593,[302 603 427 187 180],666,5,42005,4.378257244110903,20.0,0.0
9594,0,9594,[302 603 427 187 180],664,5,42010,4.378322042730589,20.0,0.0
9595,0,9595,[182 435  95 483 286],13,4,42014,4.378282617757399,20.0,0.0
9596,0,9596,[302 603 427 187 180],339,5,42019,4.378347400229238,20.0,0.0
9597,0,9597,[302 603 427 187 180],90,5,42024,4.378412169201917,20.0,0.0
9598,0,9598,[302 603 427 187 180],666,5,42029,4.378476924679654,20.0,0.0
9599,0,9599,[195 143 168  56 496],339,4,42033,4.3784375,0.0,0.0
9600,0,9600,[172 180 282 289 275],474,3,42036,4.378293927715863,0.0,0.0
9601,0,9601,[302 603 427 187 180],271,5,42041,4.378358675275984,20.0,0.0
9602,0,9602,[302 603 427 187 180],474,5,42046,4.378423409351244,20.0,0.0
9603,0,9603,[302 603 427 187 180],458,5,42051,4.378488129945856,20.0,0.0
9604,0,9604,[302 603 427 187 180],458,5,42056,4.378552837064029,20.0,0.0
9605,0,9605,[568  97 216  50  89],13,3,42059,4.378409327503643,0.0,20.0
9606,0,9606,[302 603 427 187 180],13,5,42064,4.378474029353597,20.0,0.0
9607,0,9607,[302 603 427 187 180],458,5,42069,4.37853871773522,20.0,0.0
9608,0,9608,[302 603 427 187 180],458,5,42074,4.378603392652721,20.0,0.0
9609,0,9609,[143 282 318   1 515],406,2,42076,4.378355879292403,20.0,0.0
9610,0,9610,[302 603 427 187 180],271,5,42081,4.3784205597752575,20.0,0.0
9611,0,9611,[302 603 427 187 180],90,5,42086,4.3784852267998335,20.0,0.0
9612,0,9612,[ 50  82 568  89 186],804,5,42091,4.378549880370332,0.0,20.0
9613,0,9613,[302 603 427 187 180],666,5,42096,4.378614520490951,20.0,0.0
9614,0,9614,[302 603 427 187 180],13,5,42101,4.378679147165887,20.0,0.0
9615,0,9615,[ 22 127 302 121 435],271,4,42105,4.378639767054908,0.0,20.0
9616,0,9616,[302 603 427 187 180],458,5,42110,4.378704377664552,20.0,0.0
9617,0,9617,[202 143  22 191 357],650,3,42113,4.378561031399459,20.0,0.0
9618,0,9618,[302 603 427 187 180],537,5,42118,4.378625636760578,20.0,0.0
9619,0,9619,[302 603 427 187 180],666,5,42123,4.378690228690228,20.0,0.0
9620,0,9620,[  9 603 100 200 216],339,4,42127,4.378650867893151,20.0,20.0
9621,0,9621,[302 603 427 187 180],13,5,42132,4.378715443774683,20.0,0.0
9622,0,9622,[302 603 427 187 180],474,5,42137,4.378780006235062,20.0,0.0
9623,0,9623,[302 603 427 187 180],271,5,42142,4.37884455527847,20.0,0.0
9624,0,9624,[302 603 427 187 180],666,5,42147,4.378909090909091,20.0,0.0
9625,0,9625,[302 603 427 187 180],458,5,42152,4.3789736131311034,20.0,0.0
9626,0,9626,[235 175   8 187 318],308,4,42156,4.378934247429106,20.0,0.0
9627,0,9627,[302 603 427 187 180],13,5,42161,4.378998753635231,20.0,0.0
9628,0,9628,[302 603 427 187 180],474,5,42166,4.379063246443037,20.0,0.0
9629,0,9629,[302 603 427 187 180],271,5,42171,4.379127725856698,20.0,0.0
9630,0,9630,[302 603 427 187 180],90,5,42176,4.379192191880386,20.0,0.0
9631,0,9631,[302 603 427 187 180],271,5,42181,4.379256644518272,20.0,0.0
9632,0,9632,[302 603 427 187 180],339,5,42186,4.379321083774525,20.0,0.0
9633,0,9633,[302 603 427 187 180],664,5,42191,4.379385509653311,20.0,0.0
9634,0,9634,[176 515 405 286 333],537,1,42192,4.379034769071095,0.0,0.0
9635,0,9635,[ 64 323 174 100 195],87,4,42196,4.378995433789954,0.0,40.0
9636,0,9636,[302 603 427 187 180],339,5,42201,4.379059873404587,20.0,0.0
9637,0,9637,[302 603 427 187 180],537,5,42206,4.37912429964723,20.0,0.0
9638,0,9638,[288 423 235 216 300],64,4,42210,4.379084967320262,0.0,0.0
9639,0,9639,[302 603 427 187 180],13,5,42215,4.379149377593361,20.0,0.0
9640,0,9640,[302 603 427 187 180],537,5,42220,4.379213774504719,20.0,0.0
9641,0,9641,[302 603 427 187 180],339,5,42225,4.3792781580584945,20.0,0.0
9642,0,9642,[ 89 183 175   4 125],881,3,42228,4.37913512392409,0.0,0.0
9643,0,9643,[302 603 427 187 180],458,5,42233,4.379199502281211,20.0,0.0
9644,0,9644,[302 603 427 187 180],339,5,42238,4.379263867288751,20.0,0.0
9645,0,9645,[173 471 515 153  50],899,3,42241,4.3791208791208796,0.0,20.0
9646,0,9646,[302 603 427 187 180],664,5,42246,4.379185238934384,20.0,0.0
9647,0,9647,[302 603 427 187 180],271,5,42251,4.379249585406302,20.0,0.0
9648,0,9648,[385 175 655 210   4],102,1,42252,4.378899367810136,0.0,0.0
9649,0,9649,[302 603 427 187 180],666,5,42257,4.378963730569948,20.0,0.0
9650,0,9650,[ 12 257 195 597 483],533,4,42261,4.378924463786136,40.0,0.0
9651,0,9651,[302 603 427 187 180],339,5,42266,4.3789888106092,20.0,0.0
9652,0,9652,[302 603 427 187 180],458,5,42271,4.37905314410028,20.0,0.0
9653,0,9653,[302 603 427 187 180],271,5,42276,4.379117464263517,20.0,0.0
9654,0,9654,[302 603 427 187 180],339,5,42281,4.379181771103055,20.0,0.0
9655,0,9655,[435 655 186 173 215],848,4,42285,4.379142502071251,0.0,0.0
9656,0,9656,[302 603 427 187 180],13,5,42290,4.379206792999897,20.0,0.0
9657,0,9657,[302 603 427 187 180],474,5,42295,4.379271070615034,20.0,0.0
9658,0,9658,[302 603 427 187 180],458,5,42300,4.379335334920799,20.0,0.0
9659,0,9659,[235 357  25 168 182],804,5,42305,4.379399585921325,20.0,0.0
9660,0,9660,[302 603 427 187 180],339,5,42310,4.3794638236207435,20.0,0.0
9661,0,9661,[302 603 427 187 180],666,5,42315,4.379528048023183,20.0,0.0
9662,0,9662,[183 187 403 273  28],328,3,42318,4.379385284073269,0.0,0.0
9663,0,9663,[302 603 427 187 180],537,5,42323,4.379449503311259,20.0,0.0
9664,0,9664,[302 603 427 187 180],90,5,42328,4.379513709260217,20.0,0.0
9665,0,9665,[302 603 427 187 180],90,5,42333,4.379577901924271,20.0,0.0
9666,0,9666,[302 603 427 187 180],537,5,42338,4.379642081307541,20.0,0.0
9667,0,9667,[603 179 216 194 471],648,5,42343,4.37970624741415,20.0,0.0
9668,0,9668,[179 235 127   9  98],648,3,42346,4.379563553624987,0.0,40.0
9669,0,9669,[435 483  89  56 200],339,5,42351,4.379627714581179,20.0,0.0
9670,0,9670,[ 25  50 276 228  69],374,4,42355,4.379588460345363,0.0,20.0
9671,0,9671,[172  88 143 191  28],538,2,42357,4.379342431761787,0.0,0.0
9672,0,9672,[181 144 196 288  71],13,4,42361,4.379303215134912,0.0,0.0
9673,0,9673,[ 79 135 176  88 546],881,4,42365,4.379264006615671,0.0,0.0
9674,0,9674,[302 603 427 187 180],458,5,42370,4.379328165374677,20.0,0.0
9675,0,9675,[302 603 427 187 180],339,5,42375,4.379392310872261,20.0,0.0
9676,0,9676,[302 603 427 187 180],458,5,42380,4.3794564431125345,20.0,0.0
9677,0,9677,[302 603 427 187 180],474,5,42385,4.379520562099607,20.0,0.0
9678,0,9678,[302 603 427 187 180],339,5,42390,4.3795846678375865,20.0,0.0
9679,0,9679,[302 603 427 187 180],664,5,42395,4.3796487603305785,20.0,0.0
9680,0,9680,[302 603 427 187 180],458,5,42400,4.379712839582687,20.0,0.0
9681,0,9681,[302 603 427 187 180],666,5,42405,4.379776905598017,20.0,0.0
9682,0,9682,[302 603 427 187 180],13,5,42410,4.379840958380667,20.0,0.0
9683,0,9683,[ 79 588 405 546   8],82,2,42412,4.379595208591491,0.0,0.0
9684,0,9684,[302 603 427 187 180],271,5,42417,4.379659266907589,20.0,0.0
9685,0,9685,[186 182  56 187 173],234,1,42418,4.379310344827586,0.0,0.0
9686,0,9686,[302 603 427 187 180],474,5,42423,4.3793744193248685,20.0,0.0
9687,0,9687,[100 235 196  50 182],774,2,42425,4.379128819157721,0.0,40.0
9688,0,9688,[100 186 197 300 168],379,4,42429,4.379089689338425,0.0,20.0
9689,0,9689,[ 69   4 187 435 117],233,3,42432,4.378947368421053,0.0,0.0
9690,0,9690,[302 603 427 187 180],90,5,42437,4.379011453926323,20.0,0.0
9691,0,9691,[302 603 427 187 180],474,5,42442,4.379075526207181,20.0,0.0
9692,0,9692,[ 28 288 173 238  89],488,3,42445,4.378933250799546,0.0,0.0
9693,0,9693,[302 603 427 187 180],666,5,42450,4.378997317928616,20.0,0.0
9694,0,9694,[302 603 427 187 180],271,5,42455,4.379061371841155,20.0,0.0
9695,0,9695,[302 603 427 187 180],474,5,42460,4.379125412541254,20.0,0.0
9696,0,9696,[302 603 427 187 180],458,5,42465,4.379189440033,20.0,0.0
9697,0,9697,[302 603 427 187 180],664,5,42470,4.379253454320478,20.0,0.0
9698,0,9698,[302 603 427 187 180],458,5,42475,4.379317455407774,20.0,0.0
9699,0,9699,[174 191 132   8 197],85,5,42480,4.3793814432989695,0.0,20.0
9700,0,9700,[302 603 427 187 180],13,5,42485,4.379445417998144,20.0,0.0
9701,0,9701,[302 603 427 187 180],271,5,42490,4.379509379509379,20.0,0.0
9702,0,9702,[302 603 427 187 180],666,5,42495,4.379573327836751,20.0,0.0
9703,0,9703,[302 603 427 187 180],90,5,42500,4.379637262984336,20.0,0.0
9704,0,9704,[302 603 427 187 180],664,5,42505,4.379701184956208,20.0,0.0
9705,0,9705,[302 603 427 187 180],666,5,42510,4.379765093756439,20.0,0.0
9706,0,9706,[302 603 427 187 180],271,5,42515,4.3798289893891,20.0,0.0
9707,0,9707,[237 196 269 121  95],64,4,42519,4.379789864029666,0.0,0.0
9708,0,9708,[302 603 427 187 180],537,5,42524,4.379853743948914,20.0,0.0
9709,0,9709,[302 603 427 187 180],664,5,42529,4.379917610710607,20.0,0.0
9710,0,9710,[302 603 427 187 180],458,5,42534,4.3799814643188135,20.0,0.0
9711,0,9711,[234 196 127 117  69],90,3,42537,4.379839373970346,0.0,20.0
9712,0,9712,[135 100 258 186 423],271,4,42541,4.379800267682487,0.0,20.0
9713,0,9713,[302 603 427 187 180],474,5,42546,4.3798641136504015,20.0,0.0
9714,0,9714,[302 603 427 187 180],664,5,42551,4.379927946474524,20.0,0.0
9715,0,9715,[302 603 427 187 180],90,5,42556,4.379991766158913,20.0,0.0
9716,0,9716,[ 96  56 181   1   4],804,4,42560,4.379952660286096,0.0,0.0
9717,0,9717,[302 603 427 187 180],13,5,42565,4.380016464293065,20.0,0.0
9718,0,9718,[294  98 300 127 268],288,4,42569,4.37997736392633,0.0,40.0
9719,0,9719,[302 603 427 187 180],537,5,42574,4.380041152263375,20.0,0.0
9720,0,9720,[196 603 403 100 265],234,2,42576,4.379796317251311,20.0,20.0
9721,0,9721,[302 603 427 187 180],664,5,42581,4.379860111088253,20.0,0.0
9722,0,9722,[302 603 427 187 180],339,5,42586,4.3799238918029415,20.0,0.0
9723,0,9723,[302 603 427 187 180],339,5,42591,4.379987659399424,20.0,0.0
9724,0,9724,[185 100 117 174 196],374,4,42595,4.379948586118252,0.0,40.0
9725,0,9725,[302 603 427 187 180],339,5,42600,4.380012338062924,20.0,0.0
9726,0,9726,[302 603 427 187 180],271,5,42605,4.3800760768993525,20.0,0.0
9727,0,9727,[302 603 427 187 180],666,5,42610,4.380139802631579,20.0,0.0
9728,0,9728,[302 603 427 187 180],664,5,42615,4.380203515263645,20.0,0.0
9729,0,9729,[302 603 427 187 180],537,5,42620,4.380267214799589,20.0,0.0
9730,0,9730,[302 603 427 187 180],666,5,42625,4.380330901243449,20.0,0.0
9731,0,9731,[302 603 427 187 180],458,5,42630,4.3803945745992605,20.0,0.0
9732,0,9732,[300 748 222  56 515],313,2,42632,4.380150005137162,0.0,0.0
9733,0,9733,[302 603 427 187 180],339,5,42637,4.380213683994247,20.0,0.0
9734,0,9734,[302 603 427 187 180],339,5,42642,4.380277349768876,20.0,0.0
9735,0,9735,[302 603 427 187 180],666,5,42647,4.380341002465078,20.0,0.0
9736,0,9736,[302 603 427 187 180],664,5,42652,4.380404642086885,20.0,0.0
9737,0,9737,[302 603 427 187 180],537,5,42657,4.3804682686383245,20.0,0.0
9738,0,9738,[302 603 427 187 180],271,5,42662,4.380531882123421,20.0,0.0
9739,0,9739,[172  22  12 282 238],145,5,42667,4.380595482546201,20.0,0.0
9740,0,9740,[302 603 427 187 180],339,5,42672,4.380659069910687,20.0,0.0
9741,0,9741,[302 603 427 187 180],339,5,42677,4.380722644220899,20.0,0.0
9742,0,9742,[302 603 427 187 180],474,5,42682,4.380786205480858,20.0,0.0
9743,0,9743,[302 603 427 187 180],90,5,42687,4.380849753694581,20.0,0.0
9744,0,9744,[302 603 427 187 180],666,5,42692,4.380913288866085,20.0,0.0
9745,0,9745,[ 71 125  95 204  69],648,1,42693,4.380566386209727,0.0,0.0
9746,0,9746,[302 603 427 187 180],664,5,42698,4.380629937416641,20.0,0.0
9747,0,9747,[302 603 427 187 180],537,5,42703,4.380693475584735,20.0,0.0
9748,0,9748,[302 603 427 187 180],339,5,42708,4.380757000718022,20.0,0.0
9749,0,9749,[275 276 179  64 423],13,3,42711,4.380615384615385,0.0,0.0
9750,0,9750,[302 603 427 187 180],339,5,42716,4.38067890472772,20.0,0.0
9751,0,9751,[302 603 427 187 180],458,5,42721,4.380742411812961,20.0,0.0
9752,0,9752,[385 194   7 181 197],650,5,42726,4.380805905875115,0.0,0.0
9753,0,9753,[302 603 427 187 180],664,5,42731,4.380869386918188,20.0,0.0
9754,0,9754,[ 71 603  12 269 161],334,2,42733,4.380625320348539,40.0,0.0
9755,0,9755,[302 603 427 187 180],474,5,42738,4.3806888068880685,20.0,0.0
9756,0,9756,[483 238 211 151 176],749,4,42742,4.380649789894435,20.0,0.0
9757,0,9757,[302 603 427 187 180],666,5,42747,4.3807132609141215,20.0,0.0
9758,0,9758,[302 603 427 187 180],537,5,42752,4.3807767189261195,20.0,0.0
9759,0,9759,[302 603 427 187 180],90,5,42757,4.380840163934426,20.0,0.0
9760,0,9760,[302 603 427 187 180],664,5,42762,4.380903595943039,20.0,0.0
9761,0,9761,[100   7 168 173 176],840,4,42766,4.380864576930957,0.0,20.0
9762,0,9762,[302 603 427 187 180],458,5,42771,4.380927993444638,20.0,0.0
9763,0,9763,[118 194 185 215   1],882,4,42775,4.38088897992626,0.0,0.0
9764,0,9764,[302 603 427 187 180],13,5,42780,4.380952380952381,20.0,0.0
9765,0,9765,[302 603 427 187 180],458,5,42785,4.38101576899447,20.0,0.0
9766,0,9766,[173  89 144 301 168],102,1,42786,4.3806696017200775,0.0,0.0
9767,0,9767,[302 603 427 187 180],339,5,42791,4.380733005733005,20.0,0.0
9768,0,9768,[302 603 427 187 180],271,5,42796,4.380796396765278,20.0,0.0
9769,0,9769,[302 603 427 187 180],664,5,42801,4.38085977482088,20.0,0.0
9770,0,9770,[302 603 427 187 180],339,5,42806,4.380923139903797,20.0,0.0
9771,0,9771,[302 603 427 187 180],537,5,42811,4.38098649201801,20.0,0.0
9772,0,9772,[302 603 427 187 180],339,5,42816,4.381049831167502,20.0,0.0
9773,0,9773,[ 25 216 275 204 182],318,5,42821,4.381113157356252,0.0,0.0
9774,0,9774,[302 603 427 187 180],13,5,42826,4.381176470588235,20.0,0.0
9775,0,9775,[ 64 186 182 179 237],95,2,42828,4.380932896890344,0.0,0.0
9776,0,9776,[302 603 427 187 180],90,5,42833,4.38099621560806,20.0,0.0
9777,0,9777,[302 603 427 187 180],90,5,42838,4.381059521374514,20.0,0.0
9778,0,9778,[ 96 496 423 333 385],506,5,42843,4.38112281419368,0.0,0.0
9779,0,9779,[ 96  79 237 211 100],749,3,42846,4.380981595092025,0.0,20.0
9780,0,9780,[302 603 427 187 180],458,5,42851,4.381044882936305,20.0,0.0
9781,0,9781,[302 603 427 187 180],666,5,42856,4.3811081578409325,20.0,0.0
9782,0,9782,[515 300 286 183 234],234,3,42859,4.380966983542881,0.0,0.0
9783,0,9783,[302 603 427 187 180],474,5,42864,4.381030253475061,20.0,0.0
9784,0,9784,[302 603 427 187 180],271,5,42869,4.381093510475218,20.0,0.0
9785,0,9785,[302 603 427 187 180],664,5,42874,4.3811567545473125,20.0,0.0
9786,0,9786,[302 603 427 187 180],339,5,42879,4.38121998569531,20.0,0.0
9787,0,9787,[302 603 427 187 180],474,5,42884,4.3812832039231715,20.0,0.0
9788,0,9788,[174 423 121 289  56],474,4,42888,4.381244253754214,0.0,20.0
9789,0,9789,[302 603 427 187 180],90,5,42893,4.381307456588355,20.0,0.0
9790,0,9790,[302 603 427 187 180],666,5,42898,4.381370646512103,20.0,0.0
9791,0,9791,[ 56 182  11 427 173],271,3,42901,4.381229575163399,0.0,0.0
9792,0,9792,[ 98 172 127 603  82],666,3,42904,4.381088532625345,20.0,40.0
9793,0,9793,[302 603 427 187 180],474,5,42909,4.381151725546252,20.0,0.0
9794,0,9794,[302 603 427 187 180],13,5,42914,4.381214905564064,20.0,0.0
9795,0,9795,[302 603 427 187 180],458,5,42919,4.381278072682727,20.0,0.0
9796,0,9796,[276   1 235 215  15],308,2,42921,4.381035010717566,0.0,0.0
9797,0,9797,[302 603 427 187 180],271,5,42926,4.381098183302715,20.0,0.0
9798,0,9798,[302 603 427 187 180],666,5,42931,4.381161342994183,20.0,0.0
9799,0,9799,[302 603 427 187 180],339,5,42936,4.381224489795918,20.0,0.0
9800,0,9800,[302 603 427 187 180],90,5,42941,4.3812876237118665,20.0,0.0
9801,0,9801,[302 603 427 187 180],474,5,42946,4.38135074474597,20.0,0.0
9802,0,9802,[302 603 427 187 180],664,5,42951,4.381413852902173,20.0,0.0
9803,0,9803,[302 603 427 187 180],666,5,42956,4.381476948184415,20.0,0.0
9804,0,9804,[302 603 427 187 180],339,5,42961,4.381540030596635,20.0,0.0
9805,0,9805,[357 258 168 173 204],6,3,42964,4.3813991433816035,20.0,0.0
9806,0,9806,[302 603 427 187 180],664,5,42969,4.381462220862649,20.0,0.0
9807,0,9807,[302 603 427 187 180],458,5,42974,4.381525285481239,20.0,0.0
9808,0,9808,[302 603 427 187 180],474,5,42979,4.381588337241309,20.0,0.0
9809,0,9809,[132  12 289 204 100],378,5,42984,4.381651376146789,20.0,20.0
9810,0,9810,[302 603 427 187 180],664,5,42989,4.38171440220161,20.0,0.0
9811,0,9811,[273 323 603 168 191],13,2,42991,4.381471667346107,20.0,0.0
9812,0,9812,[302 603 427 187 180],474,5,42996,4.3815346988688475,20.0,0.0
9813,0,9813,[302 603 427 187 180],474,5,43001,4.381597717546362,20.0,0.0
9814,0,9814,[302 603 427 187 180],537,5,43006,4.381660723382578,20.0,0.0
9815,0,9815,[302 202  69 678 191],454,3,43009,4.381519967400163,0.0,0.0
9816,0,9816,[302 603 427 187 180],666,5,43014,4.381582968320261,20.0,0.0
9817,0,9817,[302 603 427 187 180],537,5,43019,4.3816459564066,20.0,0.0
9818,0,9818,[302 603 427 187 180],664,5,43024,4.381708931663102,20.0,0.0
9819,0,9819,[302 603 427 187 180],537,5,43029,4.381771894093687,20.0,0.0
9820,0,9820,[302 603 427 187 180],271,5,43034,4.38183484370227,20.0,0.0
9821,0,9821,[175 195  98 194 185],379,4,43038,4.3817959682345755,0.0,20.0
9822,0,9822,[183 210 216 258 286],488,3,43041,4.381655298788558,0.0,0.0
9823,0,9823,[ 50 405 328 117 568],92,2,43043,4.381412866449511,0.0,20.0
9824,0,9824,[302 603 427 187 180],458,5,43048,4.38147582697201,20.0,0.0
9825,0,9825,[197 318 678 144   8],7,4,43052,4.3814370038672905,20.0,0.0
9826,0,9826,[302 603 427 187 180],271,5,43057,4.381499949119772,20.0,0.0
9827,0,9827,[302 603 427 187 180],666,5,43062,4.381562881562882,20.0,0.0
9828,0,9828,[302 603 427 187 180],90,5,43067,4.381625801200529,20.0,0.0
9829,0,9829,[302 603 427 187 180],13,5,43072,4.381688708036623,20.0,0.0
9830,0,9830,[302 603 427 187 180],458,5,43077,4.381751602075068,20.0,0.0
9831,0,9831,[678 286 289 333 181],13,1,43078,4.3814076484947115,0.0,0.0
9832,0,9832,[302 603 427 187 180],537,5,43083,4.381470558324011,20.0,0.0
9833,0,9833,[302 603 427 187 180],458,5,43088,4.381533455358959,20.0,0.0
9834,0,9834,[172  89 568  70  12],537,2,43090,4.381291306558211,20.0,0.0
9835,0,9835,[302 603 427 187 180],458,5,43095,4.381354209028061,20.0,0.0
9836,0,9836,[302 603 427 187 180],90,5,43100,4.381417098708956,20.0,0.0
9837,0,9837,[200  28  71  82 100],7,4,43104,4.381378328928644,0.0,20.0
9838,0,9838,[302 603 427 187 180],271,5,43109,4.381441203374327,20.0,0.0
9839,0,9839,[302 603 427 187 180],339,5,43114,4.381504065040651,20.0,0.0
9840,0,9840,[302 603 427 187 180],339,5,43119,4.381566913931511,20.0,0.0
9841,0,9841,[ 97 216 127 194 204],406,4,43123,4.3815281446860395,0.0,20.0
9842,0,9842,[302 603 427 187 180],664,5,43128,4.381590978360256,20.0,0.0
9843,0,9843,[302 603 427 187 180],339,5,43133,4.38165379926859,20.0,0.0
9844,0,9844,[302 603 427 187 180],90,5,43138,4.381716607414932,20.0,0.0
9845,0,9845,[ 82 127 191 196 475],387,3,43141,4.381576274629291,0.0,20.0
9846,0,9846,[302 603 427 187 180],458,5,43146,4.381639077891744,20.0,0.0
9847,0,9847,[302 603 427 187 180],13,5,43151,4.381701868399675,20.0,0.0
9848,0,9848,[ 64 183   8  97 678],13,4,43155,4.381663113006397,0.0,0.0
9849,0,9849,[302 603 427 187 180],474,5,43160,4.3817258883248735,20.0,0.0
9850,0,9850,[ 98 127  96 196  97],326,3,43163,4.38158562582479,0.0,40.0
9851,0,9851,[  7 127 318  12 161],7,4,43167,4.381546894031668,40.0,20.0
9852,0,9852,[302 603 427 187 180],474,5,43172,4.3816096620318685,20.0,0.0
9853,0,9853,[302 603 427 187 180],90,5,43177,4.38167241729247,20.0,0.0
9854,0,9854,[  9 228 215 181 471],7,4,43181,4.381633688483004,0.0,0.0
9855,0,9855,[180  64 423 234 301],666,3,43184,4.3814935064935066,0.0,0.0
9856,0,9856,[ 71 276  64 173  95],455,4,43188,4.381454803692807,0.0,0.0
9857,0,9857,[302 603 427 187 180],90,5,43193,4.3815175491986205,20.0,0.0
9858,0,9858,[302 603 427 187 180],13,5,43198,4.38158028197586,20.0,0.0
9859,0,9859,[302 603 427 187 180],666,5,43203,4.381643002028397,20.0,0.0
9860,0,9860,[302 603 427 187 180],537,5,43208,4.381705709360105,20.0,0.0
9861,0,9861,[100 257 176 153 258],447,4,43212,4.381667004664369,0.0,20.0
9862,0,9862,[302 603 427 187 180],13,5,43217,4.381729696846802,20.0,0.0
9863,0,9863,[210 180 215  12 196],892,5,43222,4.381792376317923,20.0,0.0
9864,0,9864,[302 603 427 187 180],458,5,43227,4.381855043081601,20.0,0.0
9865,0,9865,[302 603 427 187 180],339,5,43232,4.381917697141699,20.0,0.0
9866,0,9866,[302 603 427 187 180],339,5,43237,4.3819803385020775,20.0,0.0
9867,0,9867,[302 603 427 187 180],666,5,43242,4.3820429671665995,20.0,0.0
9868,0,9868,[302 603 427 187 180],537,5,43247,4.382105583139123,20.0,0.0
9869,0,9869,[302 603 427 187 180],474,5,43252,4.382168186423505,20.0,0.0
9870,0,9870,[302 603 427 187 180],666,5,43257,4.382230777023604,20.0,0.0
9871,0,9871,[302 603 427 187 180],271,5,43262,4.382293354943274,20.0,0.0
9872,0,9872,[603 302 265 174 483],537,3,43265,4.3821533475134204,40.0,20.0
9873,0,9873,[180 234 265   1 153],804,5,43270,4.382215920599554,0.0,0.0
9874,0,9874,[183 228 515  98  89],92,5,43275,4.3822784810126585,0.0,20.0
9875,0,9875,[302 603 427 187 180],474,5,43280,4.382341028756581,20.0,0.0
9876,0,9876,[357 186 182 258 183],59,4,43284,4.382302318517769,20.0,0.0
9877,0,9877,[302 603 427 187 180],90,5,43289,4.38236485118445,20.0,0.0
9878,0,9878,[403 245 678 435 182],197,2,43291,4.382123696730439,0.0,0.0
9879,0,9879,[181  22 132 117 151],749,5,43296,4.382186234817814,0.0,0.0
9880,0,9880,[ 98 127 195  22 289],234,4,43300,4.3821475559153935,0.0,40.0
9881,0,9881,[302 603 427 187 180],664,5,43305,4.38221007893139,20.0,0.0
9882,0,9882,[ 71 588 191  70 179],59,2,43307,4.381969037741577,0.0,0.0
9883,0,9883,[302 603 427 187 180],664,5,43312,4.3820315661675435,20.0,0.0
9884,0,9884,[302 603 427 187 180],458,5,43317,4.382094081942337,20.0,0.0
9885,0,9885,[172 182 385 273 234],13,3,43320,4.38195427877807,0.0,0.0
9886,0,9886,[302 603 427 187 180],13,5,43325,4.38201678972388,20.0,0.0
9887,0,9887,[302 603 427 187 180],458,5,43330,4.38207928802589,20.0,0.0
9888,0,9888,[176 678 322 238  89],804,5,43335,4.382141773687936,0.0,0.0
9889,0,9889,[302 603 427 187 180],13,5,43340,4.382204246713853,20.0,0.0
9890,0,9890,[176 294 153  89  12],279,2,43342,4.3819634010716815,20.0,0.0
9891,0,9891,[302 603 427 187 180],90,5,43347,4.382025879498585,20.0,0.0
9892,0,9892,[302 603 427 187 180],90,5,43352,4.382088345294653,20.0,0.0
9893,0,9893,[ 88  28 195 191 276],92,3,43355,4.381948655750961,0.0,0.0
9894,0,9894,[302 603 427 187 180],271,5,43360,4.382011116725619,20.0,0.0
9895,0,9895,[333 235 313 135 286],328,2,43362,4.381770412287793,0.0,0.0
9896,0,9896,[302 603 427 187 180],666,5,43367,4.381832878650096,20.0,0.0
9897,0,9897,[302 603 427 187 180],474,5,43372,4.381895332390382,20.0,0.0
9898,0,9898,[168 258  50 179 143],749,5,43377,4.381957773512476,0.0,20.0
9899,0,9899,[302 603 427 187 180],458,5,43382,4.382020202020202,20.0,0.0
9900,0,9900,[  1 153  79  22 286],653,4,43386,4.381981618018382,0.0,0.0
9901,0,9901,[200 172 273 258  79],234,1,43387,4.3816400727125835,0.0,0.0
9902,0,9902,[ 22 183 143 111  15],92,1,43388,4.381298596384934,0.0,0.0
9903,0,9903,[302 603 427 187 180],458,5,43393,4.381361066235864,20.0,0.0
9904,0,9904,[302 603 427 187 180],271,5,43398,4.381423523472994,20.0,0.0
9905,0,9905,[ 69 318  11 423 323],59,5,43403,4.381485968100141,20.0,0.0
9906,0,9906,[187 603 118 216 161],271,3,43406,4.381346522660745,20.0,0.0
9907,0,9907,[302 603 427 187 180],13,5,43411,4.381408962454582,20.0,0.0
9908,0,9908,[302 603 427 187 180],90,5,43416,4.381471389645776,20.0,0.0
9909,0,9909,[302 603 427 187 180],474,5,43421,4.381533804238143,20.0,0.0
9910,0,9910,[302 603 427 187 180],474,5,43426,4.381596206235496,20.0,0.0
9911,0,9911,[496  50  69 357 202],42,5,43431,4.381658595641646,20.0,20.0
9912,0,9912,[111 323 210 216 289],537,0,43431,4.381216584283265,0.0,0.0
9913,0,9913,[  9 515 118  97 655],881,3,43434,4.381077264474481,0.0,0.0
9914,0,9914,[302 603 427 187 180],666,5,43439,4.381139687342411,20.0,0.0
9915,0,9915,[302 603 427 187 180],339,5,43444,4.381202097620008,20.0,0.0
9916,0,9916,[302 603 427 187 180],664,5,43449,4.381264495311082,20.0,0.0
9917,0,9917,[302 603 427 187 180],271,5,43454,4.381326880419439,20.0,0.0
9918,0,9918,[127 144 153  97 200],298,3,43457,4.3811876197197295,0.0,20.0
9919,0,9919,[302 603 427 187 180],339,5,43462,4.38125,20.0,0.0
9920,0,9920,[302 603 427 187 180],666,5,43467,4.381312367704869,20.0,0.0
9921,0,9921,[222 144 195 202 194],102,2,43469,4.381072364442653,0.0,0.0
9922,0,9922,[210  70  71 568  25],533,5,43474,4.381134737478585,0.0,0.0
9923,0,9923,[ 50 181 135  22 435],234,3,43477,4.38099556630391,0.0,20.0
9924,0,9924,[  4 181 118 423 161],194,2,43479,4.380755667506297,0.0,0.0
9925,0,9925,[302 603 427 187 180],537,5,43484,4.380818053596615,20.0,0.0
9926,0,9926,[302 603 427 187 180],271,5,43489,4.380880427117961,20.0,0.0
9927,0,9927,[302 603 427 187 180],339,5,43494,4.380942788074134,20.0,0.0
9928,0,9928,[127 678 200 100 197],537,3,43497,4.380803706314835,0.0,40.0
9929,0,9929,[302 603 427 187 180],339,5,43502,4.380866062437059,20.0,0.0
9930,0,9930,[302 603 427 187 180],666,5,43507,4.380928406001409,20.0,0.0
9931,0,9931,[302 603 427 187 180],664,5,43512,4.38099073701168,20.0,0.0
9932,0,9932,[302 603 427 187 180],90,5,43517,4.38105305547166,20.0,0.0
9933,0,9933,[302 603 427 187 180],90,5,43522,4.381115361385142,20.0,0.0
9934,0,9934,[187 655 183 235 385],328,3,43525,4.3809763462506295,0.0,0.0
9935,0,9935,[302 603 427 187 180],90,5,43530,4.381038647342995,20.0,0.0
9936,0,9936,[302 603 427 187 180],339,5,43535,4.3811009358961455,20.0,0.0
9937,0,9937,[302 603 427 187 180],537,5,43540,4.381163211913866,20.0,0.0
9938,0,9938,[302 603 427 187 180],13,5,43545,4.38122547539994,20.0,0.0
9939,0,9939,[302 603 427 187 180],13,5,43550,4.381287726358149,20.0,0.0
9940,0,9940,[302 603 427 187 180],90,5,43555,4.381349964792275,20.0,0.0
9941,0,9941,[302 603 427 187 180],90,5,43560,4.3814121907060954,20.0,0.0
9942,0,9942,[302 603 427 187 180],666,5,43565,4.38147440410339,20.0,0.0
9943,0,9943,[603  56  95 168 153],843,0,43565,4.38103378921963,20.0,0.0
9944,0,9944,[302 603 427 187 180],537,5,43570,4.381096028154852,20.0,0.0
9945,0,9945,[603 196 265  50  82],42,4,43574,4.381057711642872,20.0,20.0
9946,0,9946,[118  69 185 183 173],7,4,43578,4.381019402835026,0.0,0.0
9947,0,9947,[302 603 427 187 180],271,5,43583,4.381081624447125,20.0,0.0
9948,0,9948,[125  88  50 748  89],313,2,43585,4.380842295708112,0.0,20.0
9949,0,9949,[300 186 187 182 258],13,4,43589,4.380804020100502,0.0,0.0
9950,0,9950,[234   1 100 180 588],537,2,43591,4.380564767360064,0.0,20.0
9951,0,9951,[ 70 496 191 235 202],398,3,43594,4.380426045016077,0.0,0.0
9952,0,9952,[302 603 427 187 180],339,5,43599,4.380488294986436,20.0,0.0
9953,0,9953,[302 603 427 187 180],13,5,43604,4.380550532449266,20.0,0.0
9954,0,9954,[302 603 427 187 180],90,5,43609,4.380612757408337,20.0,0.0
9955,0,9955,[288   1  64 118 568],13,2,43611,4.380373644033749,0.0,0.0
9956,0,9956,[302 603 427 187 180],664,5,43616,4.380435874259315,20.0,0.0
9957,0,9957,[302 603 427 187 180],271,5,43621,4.380498091986342,20.0,0.0
9958,0,9958,[302 603 427 187 180],339,5,43626,4.380560297218596,20.0,0.0
9959,0,9959,[127 172 186 228 144],643,5,43631,4.38062248995984,0.0,20.0
9960,0,9960,[302 603 427 187 180],664,5,43636,4.380684670213834,20.0,0.0
9961,0,9961,[302 603 427 187 180],13,5,43641,4.380746837984341,20.0,0.0
9962,0,9962,[302 603 427 187 180],537,5,43646,4.380808993275118,20.0,0.0
9963,0,9963,[302 603 427 187 180],339,5,43651,4.380871136089923,20.0,0.0
9964,0,9964,[302 603 427 187 180],458,5,43656,4.380933266432514,20.0,0.0
9965,0,9965,[302 603 427 187 180],271,5,43661,4.380995384306643,20.0,0.0
9966,0,9966,[302 603 427 187 180],666,5,43666,4.381057489716063,20.0,0.0
9967,0,9967,[302 603 427 187 180],458,5,43671,4.381119582664526,20.0,0.0
9968,0,9968,[200 237 144 257 127],95,3,43674,4.380981041227806,0.0,20.0
9969,0,9969,[211  89  70 257 179],659,2,43676,4.38074222668004,0.0,0.0
9970,0,9970,[302 603 427 187 180],271,5,43681,4.380804332564437,20.0,0.0
9971,0,9971,[302 603 427 187 180],458,5,43686,4.38086642599278,20.0,0.0
9972,0,9972,[302 603 427 187 180],666,5,43691,4.380928506968816,20.0,0.0
9973,0,9973,[271 313 194 385 235],119,5,43696,4.38099057549629,0.0,0.0
9974,0,9974,[302 603 427 187 180],13,5,43701,4.381052631578948,20.0,0.0
9975,0,9975,[302 603 427 187 180],90,5,43706,4.381114675220529,20.0,0.0
9976,0,9976,[176 204 475 127 235],213,4,43710,4.381076475894558,0.0,20.0
9977,0,9977,[302 603 427 187 180],271,5,43715,4.381138504710362,20.0,0.0
9978,0,9978,[265 333 222 318 678],387,2,43717,4.380899889768514,20.0,0.0
9979,0,9979,[302 603 427 187 180],664,5,43722,4.380961923847695,20.0,0.0
9980,0,9980,[302 603 427 187 180],474,5,43727,4.381023945496443,20.0,0.0
9981,0,9981,[302 603 427 187 180],474,5,43732,4.381085954718493,20.0,0.0
9982,0,9982,[302 603 427 187 180],339,5,43737,4.38114795151758,20.0,0.0
9983,0,9983,[302 603 427 187 180],458,5,43742,4.381209935897436,20.0,0.0
9984,0,9984,[302 603 427 187 180],666,5,43747,4.381271907861793,20.0,0.0
9985,0,9985,[302 603 427 187 180],664,5,43752,4.38133386741438,20.0,0.0
9986,0,9986,[302 603 427 187 180],13,5,43757,4.3813958145589265,20.0,0.0
9987,0,9987,[  9 323 238  96  69],488,2,43759,4.38115738886664,0.0,0.0
9988,0,9988,[183 211  97 235 435],290,1,43760,4.38081890079087,0.0,0.0
9989,0,9989,[302 603 427 187 180],90,5,43765,4.380880880880881,20.0,0.0
9990,0,9990,[302 603 427 187 180],458,5,43770,4.380942848563707,20.0,0.0
9991,0,9991,[  9   4 176 515 234],343,4,43774,4.3809047237790235,0.0,0.0
9992,0,9992,[302 603 427 187 180],474,5,43779,4.380966676673672,20.0,0.0
9993,0,9993,[302 603 427 187 180],664,5,43784,4.381028617170302,20.0,0.0
9994,0,9994,[302 603 427 187 180],90,5,43789,4.381090545272636,20.0,0.0
9995,0,9995,[302 603 427 187 180],339,5,43794,4.381152460984394,20.0,0.0
9996,0,9996,[302 603 427 187 180],474,5,43799,4.381214364309293,20.0,0.0
9997,0,9997,[228 237 258  22 405],788,4,43803,4.381176235247049,0.0,0.0
9998,0,9998,[302 603 427 187 180],666,5,43808,4.381238123812381,20.0,0.0
9999,0,9999,[302 603 427 187 180],664,5,43813,4.3813,20.0,0.0
10000,1,0,[678 118  69  71 197],7,3,3,3.0,0.0,0.0
10001,1,1,[ 69  71 197 678 118],454,3,6,3.0,0.0,0.0
10002,1,2,[ 69 197 118  71 678],749,3,9,3.0,0.0,0.0
10003,1,3,[ 69 197  71 118 678],454,3,12,3.0,0.0,0.0
10004,1,4,[ 69 197 118  71 678],455,3,15,3.0,0.0,0.0
10005,1,5,[471  98 117 121  79],815,2,17,2.8333333333333335,0.0,20.0
10006,1,6,[ 69 197  98  79 118],454,4,21,3.0,0.0,20.0
10007,1,7,[191  71 183   1   8],82,4,25,3.125,0.0,0.0
10008,1,8,[ 69 191 197   8   1],13,3,28,3.111111111111111,0.0,0.0
10009,1,9,[ 69 197   8  79 118],455,5,33,3.3,0.0,0.0
10010,1,10,[ 69 197   8  79 118],343,4,37,3.3636363636363638,0.0,0.0
10011,1,11,[ 69 197   8  79 118],311,4,41,3.4166666666666665,0.0,0.0
10012,1,12,[ 69 197   8  79 118],881,3,44,3.3846153846153846,0.0,0.0
10013,1,13,[742  82  88 174  12],92,2,46,3.2857142857142856,20.0,20.0
10014,1,14,[ 79  12   8 174 197],690,5,51,3.4,20.0,20.0
10015,1,15,[ 79  12   8 174 197],234,2,53,3.3125,20.0,20.0
10016,1,16,[ 89 222  88 204  98],194,2,55,3.235294117647059,0.0,20.0
10017,1,17,[204   8 197  69  79],883,4,59,3.2777777777777777,0.0,0.0
10018,1,18,[204   8 197  79  69],7,5,64,3.3684210526315788,0.0,0.0
10019,1,19,[204   8 197  79  69],883,4,68,3.4,0.0,0.0
10020,1,20,[204   8 197  79  69],536,4,72,3.4285714285714284,0.0,0.0
10021,1,21,[204   8  79 197  69],387,2,74,3.3636363636363638,0.0,0.0
10022,1,22,[  8  79 204 197  69],406,4,78,3.391304347826087,0.0,0.0
10023,1,23,[  8 204  79 197  69],406,4,82,3.4166666666666665,0.0,0.0
10024,1,24,[  8 204 197  79  69],308,3,85,3.4,0.0,0.0
10025,1,25,[  8 204  79 197  69],326,2,87,3.3461538461538463,0.0,0.0
10026,1,26,[  8  79 204 197  69],334,4,91,3.3703703703703702,0.0,0.0
10027,1,27,[  8  79 204 197  12],883,5,96,3.4285714285714284,20.0,0.0
10028,1,28,[405  56 496 183   1],653,2,98,3.3793103448275863,0.0,0.0
10029,1,29,[ 56   8  79 204 197],406,4,102,3.4,0.0,0.0
10030,1,30,[ 56   8 204 197  79],543,5,107,3.4516129032258065,0.0,0.0
10031,1,31,[ 56   8 204  79 197],536,3,110,3.4375,0.0,0.0
10032,1,32,[216 161 483 172   1],899,4,114,3.4545454545454546,20.0,0.0
10033,1,33,[216 172 483 161   8],479,3,117,3.4411764705882355,20.0,0.0
10034,1,34,[  8 172 483 204  79],881,5,122,3.4857142857142858,20.0,0.0
10035,1,35,[  8 172 483 204  79],479,5,127,3.5277777777777777,20.0,0.0
10036,1,36,[  8 172 483 204  79],239,3,130,3.5135135135135136,20.0,0.0
10037,1,37,[ 22 234 118 100   7],833,1,131,3.4473684210526314,0.0,20.0
10038,1,38,[172 100 483   8 204],311,4,135,3.4615384615384617,20.0,20.0
10039,1,39,[  8 172 483 204  79],272,5,140,3.5,20.0,0.0
10040,1,40,[  8 172 483 204  79],326,4,144,3.5121951219512195,20.0,0.0
10041,1,41,[  8 172 483  79 204],881,5,149,3.5476190476190474,20.0,0.0
10042,1,42,[  8 172 483  79 204],385,2,151,3.511627906976744,20.0,0.0
10043,1,43,[  8 483 172  79 204],474,5,156,3.5454545454545454,20.0,0.0
10044,1,44,[  8 483 172  79 204],213,4,160,3.5555555555555554,20.0,0.0
10045,1,45,[483   8 172  79 204],7,5,165,3.5869565217391304,20.0,0.0
10046,1,46,[483   8 172  79 204],60,4,169,3.595744680851064,20.0,0.0
10047,1,47,[483   8 172  79 204],308,4,173,3.6041666666666665,20.0,0.0
10048,1,48,[  8 483 172  79 204],308,4,177,3.6122448979591835,20.0,0.0
10049,1,49,[  8 172 483  79 204],406,4,181,3.62,20.0,0.0
10050,1,50,[  8 172 483 204  79],298,5,186,3.6470588235294117,20.0,0.0
10051,1,51,[  8 172 483 204  79],158,5,191,3.673076923076923,20.0,0.0
10052,1,52,[  8 172 483 204  79],60,4,195,3.6792452830188678,20.0,0.0
10053,1,53,[294 748 678 176 174],881,2,197,3.6481481481481484,0.0,20.0
10054,1,54,[176 172   8 483 204],308,4,201,3.6545454545454548,20.0,0.0
10055,1,55,[176 172   8 483 204],533,3,204,3.642857142857143,20.0,0.0
10056,1,56,[172   8 483 204  79],409,4,208,3.6491228070175437,20.0,0.0
10057,1,57,[172   8 483 204  79],13,4,212,3.6551724137931036,20.0,0.0
10058,1,58,[172   8 483 204  79],239,3,215,3.6440677966101696,20.0,0.0
10059,1,59,[172   8 483 204  79],234,2,217,3.6166666666666667,20.0,0.0
10060,1,60,[172   8 483 204 197],398,4,221,3.622950819672131,20.0,0.0
10061,1,61,[172 483   8 204 197],881,4,225,3.629032258064516,20.0,0.0
10062,1,62,[172 483   8 204  79],7,5,230,3.6507936507936507,20.0,0.0
10063,1,63,[172 483   8 204  79],239,3,233,3.640625,20.0,0.0
10064,1,64,[172 483   8 204 197],398,4,237,3.646153846153846,20.0,0.0
10065,1,65,[172 483   8 204 197],454,3,240,3.6363636363636362,20.0,0.0
10066,1,66,[172 483   8 204 197],326,3,243,3.626865671641791,20.0,0.0
10067,1,67,[172 483   8 204  79],334,4,247,3.6323529411764706,20.0,0.0
10068,1,68,[172 483   8 204  79],239,3,250,3.6231884057971016,20.0,0.0
10069,1,69,[172 483   8 204  56],328,3,253,3.6142857142857143,20.0,0.0
10070,1,70,[172 483   8  56 204],892,5,258,3.6338028169014085,20.0,0.0
10071,1,71,[172 483   8  56 204],194,3,261,3.625,20.0,0.0
10072,1,72,[483 172  56   8 204],313,3,264,3.6164383561643834,20.0,0.0
10073,1,73,[483 172   8 204  56],881,4,268,3.6216216216216215,20.0,0.0
10074,1,74,[483 172   8 204  12],234,2,270,3.6,40.0,0.0
10075,1,75,[483 172   8 204 174],125,5,275,3.6184210526315788,20.0,20.0
10076,1,76,[483 172   8 174 204],312,5,280,3.6363636363636362,20.0,20.0
10077,1,77,[483 172   8 174 204],881,5,285,3.6538461538461537,20.0,20.0
10078,1,78,[ 97 265   8  96  95],387,3,288,3.6455696202531644,0.0,0.0
10079,1,79,[ 96 265 483 172 174],488,2,290,3.625,20.0,20.0
10080,1,80,[265 483 174   8 172],60,4,294,3.6296296296296298,20.0,20.0
10081,1,81,[265 483 174 172   8],313,4,298,3.6341463414634148,20.0,20.0
10082,1,82,[265 174 483 172   8],897,2,300,3.6144578313253013,20.0,20.0
10083,1,83,[174 483 172   8 265],334,3,303,3.607142857142857,20.0,20.0
10084,1,84,[174 483 172   8 204],272,5,308,3.623529411764706,20.0,20.0
10085,1,85,[197  69  98 271 238],650,3,311,3.616279069767442,0.0,20.0
10086,1,86,[238 174 483 172   8],313,4,315,3.6206896551724137,20.0,20.0
10087,1,87,[238 174 483 172   8],308,4,319,3.625,20.0,20.0
10088,1,88,[238 174 483 172   8],488,1,320,3.595505617977528,20.0,20.0
10089,1,89,[174 483 172   8 204],334,4,324,3.6,20.0,20.0
10090,1,90,[174 483 172   8 204],272,5,329,3.6153846153846154,20.0,20.0
10091,1,91,[174 483 172   8 204],311,5,334,3.630434782608696,20.0,20.0
10092,1,92,[174 483 172   8 204],406,5,339,3.6451612903225805,20.0,20.0
10093,1,93,[174 483 172   8 204],312,5,344,3.6595744680851063,20.0,20.0
10094,1,94,[174 483 172   8 204],95,4,348,3.663157894736842,20.0,20.0
10095,1,95,[174 483 172   8 204],533,4,352,3.6666666666666665,20.0,20.0
10096,1,96,[174 483 172 204   8],95,4,356,3.670103092783505,20.0,20.0
10097,1,97,[174 172 483 204   8],452,4,360,3.673469387755102,20.0,20.0
10098,1,98,[174 172 483   8 204],239,4,364,3.676767676767677,20.0,20.0
10099,1,99,[174 172 483   8 204],312,5,369,3.69,20.0,20.0
10100,1,100,[174 172 483   8 204],158,5,374,3.702970297029703,20.0,20.0
10101,1,101,[174 172 483   8 204],298,5,379,3.715686274509804,20.0,20.0
10102,1,102,[174 172 483   8 204],454,3,382,3.70873786407767,20.0,20.0
10103,1,103,[174 172 483   8 204],308,4,386,3.7115384615384617,20.0,20.0
10104,1,104,[174 172 483   8 204],881,5,391,3.723809523809524,20.0,20.0
10105,1,105,[174 172 483   8 204],213,4,395,3.7264150943396226,20.0,20.0
10106,1,106,[174 172 483 204   8],95,4,399,3.7289719626168223,20.0,20.0
10107,1,107,[174 172 483 204   8],200,5,404,3.740740740740741,20.0,20.0
10108,1,108,[174 172 483 204   8],272,5,409,3.7522935779816513,20.0,20.0
10109,1,109,[174 172 483 204   8],200,5,414,3.7636363636363637,20.0,20.0
10110,1,110,[174 172 483 204   8],60,4,418,3.765765765765766,20.0,20.0
10111,1,111,[174 172 483 204   8],334,4,422,3.767857142857143,20.0,20.0
10112,1,112,[174 172 483 204   8],158,5,427,3.7787610619469025,20.0,20.0
10113,1,113,[174 172 483 204   8],536,5,432,3.789473684210526,20.0,20.0
10114,1,114,[174 172 483 204   8],308,4,436,3.791304347826087,20.0,20.0
10115,1,115,[174 172 204 483   8],881,5,441,3.8017241379310347,20.0,20.0
10116,1,116,[174 172 204 483   8],313,4,445,3.8034188034188032,20.0,20.0
10117,1,117,[174 172 204 483   8],7,5,450,3.8135593220338984,20.0,20.0
10118,1,118,[174 172 204 483   8],385,2,452,3.7983193277310923,20.0,20.0
10119,1,119,[174 172 483 204   8],452,4,456,3.8,20.0,20.0
10120,1,120,[174 172 483 204   8],215,3,459,3.793388429752066,20.0,20.0
10121,1,121,[174 172 483   8 204],533,4,463,3.7950819672131146,20.0,20.0
10122,1,122,[174 172 483 204   8],313,4,467,3.796747967479675,20.0,20.0
10123,1,123,[228  88 180 135 202],194,0,467,3.7661290322580645,0.0,0.0
10124,1,124,[174 172 483 204   8],215,3,470,3.76,20.0,20.0
10125,1,125,[174 172 483 204   8],881,5,475,3.7698412698412698,20.0,20.0
10126,1,126,[174 172 483 204   8],215,3,478,3.763779527559055,20.0,20.0
10127,1,127,[597 234 385 153 322],804,4,482,3.765625,0.0,0.0
10128,1,128,[322 385 153 174 172],92,4,486,3.7674418604651163,0.0,20.0
10129,1,129,[385 153 174 172 483],308,4,490,3.769230769230769,20.0,20.0
10130,1,130,[385 153 174 172 483],650,5,495,3.7786259541984735,20.0,20.0
10131,1,131,[385 153 174 172 483],804,5,500,3.787878787878788,20.0,20.0
10132,1,132,[385 153 174 172 483],194,2,502,3.774436090225564,20.0,20.0
10133,1,133,[174 172 483 385 153],95,4,506,3.7761194029850746,20.0,20.0
10134,1,134,[174 385 153 172 483],694,5,511,3.785185185185185,20.0,20.0
10135,1,135,[742   1 183   9 515],59,3,514,3.7794117647058822,0.0,0.0
10136,1,136,[515   9 174 153 385],883,4,518,3.781021897810219,0.0,20.0
10137,1,137,[515   9 174 153 172],334,4,522,3.782608695652174,0.0,20.0
10138,1,138,[515   9 174 153 172],488,3,525,3.776978417266187,0.0,20.0
10139,1,139,[515   9 174 172 483],380,3,528,3.7714285714285714,20.0,20.0
10140,1,140,[515 174 483 172 153],290,3,531,3.765957446808511,20.0,20.0
10141,1,141,[222 174   4 237 197],883,3,534,3.76056338028169,0.0,20.0
10142,1,142,[  4 174 483 515 172],13,4,538,3.762237762237762,20.0,20.0
10143,1,143,[  4 174 483 172   9],648,3,541,3.7569444444444446,20.0,20.0
10144,1,144,[174 483 172 204   8],892,5,546,3.7655172413793103,20.0,20.0
10145,1,145,[174 483 172 204   8],406,5,551,3.7739726027397262,20.0,20.0
10146,1,146,[ 71  25  95 237  98],406,2,553,3.761904761904762,0.0,20.0
10147,1,147,[174 483 172 204  98],295,5,558,3.77027027027027,20.0,40.0
10148,1,148,[174 483 172  98 204],474,5,563,3.778523489932886,20.0,40.0
10149,1,149,[174  98 483 172 204],536,5,568,3.7866666666666666,20.0,40.0
10150,1,150,[174  98 483 172 204],7,5,573,3.794701986754967,20.0,40.0
10151,1,151,[174  98 483 172 204],239,4,577,3.7960526315789473,20.0,40.0
10152,1,152,[174  98 483 172 204],234,2,579,3.784313725490196,20.0,40.0
10153,1,153,[174  98 483 172 204],840,4,583,3.7857142857142856,20.0,40.0
10154,1,154,[174  98 483 172 204],881,5,588,3.793548387096774,20.0,40.0
10155,1,155,[174  98 483 172 204],213,5,593,3.801282051282051,20.0,40.0
10156,1,156,[174  98 483 172 204],13,5,598,3.8089171974522293,20.0,40.0
10157,1,157,[174  98 483 172 204],234,2,600,3.7974683544303796,20.0,40.0
10158,1,158,[ 89 288  50 180 318],488,3,603,3.792452830188679,20.0,20.0
10159,1,159,[ 50 318 174  98 483],776,5,608,3.8,40.0,60.0
10160,1,160,[ 50 318 174  98 483],298,5,613,3.8074534161490683,40.0,60.0
10161,1,161,[ 50 318 174  98 483],409,5,618,3.814814814814815,40.0,60.0
10162,1,162,[ 50 318 174  98 483],13,4,622,3.815950920245399,40.0,60.0
10163,1,163,[ 50 174  98 483 172],13,5,627,3.823170731707317,20.0,60.0
10164,1,164,[ 71 301 483 235 322],788,2,629,3.812121212121212,20.0,0.0
10165,1,165,[ 50 174  98 483 172],659,3,632,3.8072289156626504,20.0,60.0
10166,1,166,[ 98 174 483  50 172],881,4,636,3.808383233532934,20.0,60.0
10167,1,167,[ 98 174 483 172 318],892,5,641,3.8154761904761907,40.0,40.0
10168,1,168,[302 300 216  89 191],537,3,644,3.8106508875739644,0.0,0.0
10169,1,169,[302  98 174 483 318],207,5,649,3.8176470588235296,40.0,40.0
10170,1,170,[302  98 174 483 318],458,3,652,3.8128654970760234,40.0,40.0
10171,1,171,[508 100 194 187 174],387,4,656,3.813953488372093,0.0,40.0
10172,1,172,[742 323 185 588 568],59,3,659,3.8092485549132946,0.0,0.0
10173,1,173,[302 187 323 508 568],537,3,662,3.8045977011494254,0.0,0.0
10174,1,174,[508 187 185 302 174],833,3,665,3.8,0.0,20.0
10175,1,175,[508 187 185 174  98],774,1,666,3.784090909090909,0.0,40.0
10176,1,176,[ 98 174 318 483 172],59,5,671,3.790960451977401,40.0,40.0
10177,1,177,[ 98 174 318 483 172],892,5,676,3.797752808988764,40.0,40.0
10178,1,178,[234 385 603 182 185],524,3,679,3.793296089385475,20.0,0.0
10179,1,179,[182  98 174 318 483],234,3,682,3.7888888888888888,40.0,40.0
10180,1,180,[ 98 174 318 483 172],766,1,683,3.773480662983425,40.0,40.0
10181,1,181,[318 174  98 483 172],380,4,687,3.7747252747252746,40.0,40.0
10182,1,182,[318 174  98 483 172],537,2,689,3.7650273224043715,40.0,40.0
10183,1,183,[318 174  98 483 172],488,3,692,3.760869565217391,40.0,40.0
10184,1,184,[318 174  98 483 172],537,2,694,3.7513513513513512,40.0,40.0
10185,1,185,[318 174 483  98 302],90,5,699,3.7580645161290325,40.0,40.0
10186,1,186,[204 216 202 121 175],648,4,703,3.7593582887700534,0.0,0.0
10187,1,187,[318 174 483  98 302],474,5,708,3.765957446808511,40.0,40.0
10188,1,188,[318 174 483  98 302],788,4,712,3.767195767195767,40.0,40.0
10189,1,189,[318 174 302  98 483],343,5,717,3.7736842105263158,40.0,40.0
10190,1,190,[111  96  88  15 187],207,2,719,3.764397905759162,0.0,0.0
10191,1,191,[ 15 318 302 174  98],605,4,723,3.765625,20.0,40.0
10192,1,192,[ 15 318 302 174  98],271,4,727,3.766839378238342,20.0,40.0
10193,1,193,[318 302 174  98 483],524,4,731,3.768041237113402,40.0,40.0
10194,1,194,[318 302 174 483  98],664,5,736,3.7743589743589743,40.0,40.0
10195,1,195,[318 302 174 483  98],537,3,739,3.770408163265306,40.0,40.0
10196,1,196,[ 95 268 265 197 187],13,5,744,3.7766497461928936,0.0,0.0
10197,1,197,[237 286 471 276  96],13,3,747,3.772727272727273,0.0,0.0
10198,1,198,[276 268 318 302 174],13,4,751,3.7738693467336684,20.0,20.0
10199,1,199,[276 268 302 318 174],537,4,755,3.775,20.0,20.0
10200,1,200,[144  70 180  12 357],308,4,759,3.7761194029850746,40.0,0.0
10201,1,201,[271 183 200 118  98],833,3,762,3.772277227722772,0.0,20.0
10202,1,202,[276 200 357 268  70],6,1,763,3.7586206896551726,20.0,0.0
10203,1,203,[357 302 318 483 174],537,4,767,3.7598039215686274,60.0,20.0
10204,1,204,[357 302 318 483 174],6,5,772,3.765853658536585,60.0,20.0
10205,1,205,[215  79 151 196  56],295,5,777,3.7718446601941746,0.0,0.0
10206,1,206,[357 151 196 215 302],380,4,781,3.7729468599033815,20.0,0.0
10207,1,207,[ 98 194 176 185 269],537,1,782,3.7596153846153846,0.0,20.0
10208,1,208,[286   4  82  28 200],343,4,786,3.7607655502392343,0.0,0.0
10209,1,209,[181 228 435 318 475],537,2,788,3.7523809523809524,20.0,0.0
10210,1,210,[357 475 151  28 196],474,4,792,3.7535545023696684,20.0,0.0
10211,1,211,[357 196 475  28 302],537,3,795,3.75,20.0,0.0
10212,1,212,[357 475 302 318 483],605,4,799,3.751173708920188,60.0,0.0
10213,1,213,[357 302 318 483 174],13,3,802,3.7476635514018692,60.0,20.0
10214,1,214,[302 318 357 483 174],207,5,807,3.7534883720930234,60.0,20.0
10215,1,215,[302 318 357 483 174],474,5,812,3.759259259259259,60.0,20.0
10216,1,216,[302 318 357 483 174],454,3,815,3.7557603686635943,60.0,20.0
10217,1,217,[302 318 483 174 187],666,4,819,3.756880733944954,40.0,20.0
10218,1,218,[302 318 483 174 187],537,4,823,3.7579908675799087,40.0,20.0
10219,1,219,[302 318 187 483 174],6,5,828,3.7636363636363637,40.0,20.0
10220,1,220,[302 318 187 483 174],13,4,832,3.764705882352941,40.0,20.0
10221,1,221,[185 294 288 143 385],7,3,835,3.7612612612612613,0.0,0.0
10222,1,222,[302 187 318 483 174],343,5,840,3.766816143497758,40.0,20.0
10223,1,223,[302 187 318 483 174],13,4,844,3.767857142857143,40.0,20.0
10224,1,224,[302 187 318 483 174],524,5,849,3.7733333333333334,40.0,20.0
10225,1,225,[302 187 318 483 174],664,5,854,3.7787610619469025,40.0,20.0
10226,1,226,[302 187 318 483 174],666,4,858,3.7797356828193833,40.0,20.0
10227,1,227,[302 187 318 483 174],788,4,862,3.780701754385965,40.0,20.0
10228,1,228,[195 238  12  56 176],883,5,867,3.7860262008733625,20.0,0.0
10229,1,229,[195 302 187 318 483],207,4,871,3.7869565217391306,40.0,0.0
10230,1,230,[302 187 318 483 174],458,4,875,3.787878787878788,40.0,20.0
10231,1,231,[  1 471 144 748 180],313,4,879,3.788793103448276,0.0,0.0
10232,1,232,[210 435 204 153 508],643,4,883,3.7896995708154506,0.0,0.0
10233,1,233,[  9  15  88 211 182],271,3,886,3.786324786324786,0.0,0.0
10234,1,234,[211 210 302 187 318],474,5,891,3.7914893617021277,20.0,0.0
10235,1,235,[197 132 125  69 265],234,3,894,3.788135593220339,0.0,0.0
10236,1,236,[132 210 211 302 187],346,3,897,3.7848101265822787,0.0,0.0
10237,1,237,[132 210 211 302 187],271,5,902,3.7899159663865545,0.0,0.0
10238,1,238,[132 210 211 302 187],666,4,906,3.790794979079498,0.0,0.0
10239,1,239,[132 211 302 187 318],346,3,909,3.7875,20.0,0.0
10240,1,240,[318 132 151 173 655],334,4,913,3.788381742738589,20.0,0.0
10241,1,241,[  1 135 100 302 597],378,3,916,3.7851239669421486,0.0,20.0
10242,1,242,[125 172  95 153 182],815,3,919,3.7818930041152266,0.0,0.0
10243,1,243,[655 173 211 302 318],666,5,924,3.7868852459016393,20.0,0.0
10244,1,244,[655 173 211 302 318],474,5,929,3.7918367346938777,20.0,0.0
10245,1,245,[655 173 211 302 318],666,5,934,3.796747967479675,20.0,0.0
10246,1,246,[ 89 357 117 176  69],543,4,938,3.7975708502024292,20.0,0.0
10247,1,247,[655 173 211 302 318],13,3,941,3.7943548387096775,20.0,0.0
10248,1,248,[655 211 302 318 483],343,5,946,3.7991967871485945,40.0,0.0
10249,1,249,[655 211 302 318 483],13,4,950,3.8,40.0,0.0
10250,1,250,[655 211 302 483 318],207,5,955,3.804780876494024,40.0,0.0
10251,1,251,[655 211 302 483 318],328,5,960,3.8095238095238093,40.0,0.0
10252,1,252,[282 597 245 127 194],804,3,963,3.8063241106719365,0.0,20.0
10253,1,253,[655 245 282 211 302],207,4,967,3.8070866141732282,0.0,0.0
10254,1,254,[655 282 211 302 483],788,4,971,3.8078431372549018,20.0,0.0
10255,1,255,[211 282 302 655 483],328,4,975,3.80859375,20.0,0.0
10256,1,256,[211 302 655 483 318],454,2,977,3.801556420233463,40.0,0.0
10257,1,257,[302 211 318 483 187],90,5,982,3.806201550387597,40.0,0.0
10258,1,258,[211 302 318 483 187],328,5,987,3.810810810810811,40.0,0.0
10259,1,259,[211 302 318 483 187],666,5,992,3.8153846153846156,40.0,0.0
10260,1,260,[153 245 515 194 195],207,3,995,3.8122605363984676,0.0,0.0
10261,1,261,[211 302 318 187 483],537,5,1000,3.816793893129771,40.0,0.0
10262,1,262,[211 302 318 187 483],524,5,1005,3.821292775665399,40.0,0.0
10263,1,263,[211 302 187 318 483],537,5,1010,3.8257575757575757,40.0,0.0
10264,1,264,[211 302 187 318 483],524,5,1015,3.830188679245283,40.0,0.0
10265,1,265,[427 132 294 172   8],308,3,1018,3.827067669172932,0.0,0.0
10266,1,266,[427 211 302 187 318],537,5,1023,3.831460674157303,20.0,0.0
10267,1,267,[427 211 302 187 318],6,5,1028,3.8358208955223883,20.0,0.0
10268,1,268,[427 211 302 187 318],90,5,1033,3.840148698884758,20.0,0.0
10269,1,269,[427 211 302 187 318],666,5,1038,3.8444444444444446,20.0,0.0
10270,1,270,[427 211 302 187 318],6,5,1043,3.848708487084871,20.0,0.0
10271,1,271,[427 211 302 187 318],788,4,1047,3.849264705882353,20.0,0.0
10272,1,272,[275 268  12 196 100],334,5,1052,3.8534798534798536,20.0,20.0
10273,1,273,[275 211 302 187 318],474,4,1056,3.854014598540146,20.0,0.0
10274,1,274,[211 302 187 318 483],537,5,1061,3.8581818181818184,40.0,0.0
10275,1,275,[211 302 187 318 483],788,5,1066,3.86231884057971,40.0,0.0
10276,1,276,[211 302 187 318 483],474,5,1071,3.8664259927797833,40.0,0.0
10277,1,277,[300 265 125 423  88],271,3,1074,3.8633093525179856,0.0,0.0
10278,1,278,[258  28 423 216   7],334,3,1077,3.860215053763441,0.0,0.0
10279,1,279,[423 258 211 302 187],90,4,1081,3.8607142857142858,0.0,0.0
10280,1,280,[423 211 302 187 318],6,4,1085,3.8612099644128115,20.0,0.0
10281,1,281,[211 302 187 318 483],788,5,1090,3.8652482269503547,40.0,0.0
10282,1,282,[328 176 222 186 357],328,4,1094,3.8657243816254416,20.0,0.0
10283,1,283,[ 96 202  56 357 153],650,3,1097,3.862676056338028,20.0,0.0
10284,1,284,[186 328 211 302 187],833,1,1098,3.8526315789473684,0.0,0.0
10285,1,285,[211 302 187 318 483],537,5,1103,3.8566433566433567,40.0,0.0
10286,1,286,[405 678 216 179 222],474,4,1107,3.857142857142857,0.0,0.0
10287,1,287,[125  64 423 172  96],899,4,1111,3.857638888888889,0.0,0.0
10288,1,288,[179  64 211 302 187],339,5,1116,3.86159169550173,0.0,0.0
10289,1,289,[179  64 211 302 187],666,5,1121,3.8655172413793104,0.0,0.0
10290,1,290,[183 186 282 228 127],653,3,1124,3.8625429553264605,0.0,20.0
10291,1,291,[179  64 211 302 187],543,5,1129,3.8664383561643834,0.0,0.0
10292,1,292,[179  64 211 302 187],343,5,1134,3.8703071672354947,0.0,0.0
10293,1,293,[179  64 211 302 187],90,5,1139,3.8741496598639458,0.0,0.0
10294,1,294,[179  64 211 302 187],543,5,1144,3.8779661016949154,0.0,0.0
10295,1,295,[179  64 211 302 187],13,4,1148,3.8783783783783785,0.0,0.0
10296,1,296,[ 64 211 302 187 318],6,5,1153,3.8821548821548824,20.0,0.0
10297,1,297,[ 64 211 302 187 318],271,5,1158,3.8859060402684564,20.0,0.0
10298,1,298,[ 64 211 302 187 318],343,5,1163,3.8896321070234112,20.0,0.0
10299,1,299,[ 64 211 302 187 318],524,4,1167,3.89,20.0,0.0
10300,1,300,[211 302 187  64 318],6,5,1172,3.893687707641196,20.0,0.0
10301,1,301,[211 302 187  64 318],788,5,1177,3.8973509933774833,20.0,0.0
10302,1,302,[211 302 187  64 318],788,5,1182,3.900990099009901,20.0,0.0
10303,1,303,[234 182 121 118 323],881,2,1184,3.8947368421052633,0.0,0.0
10304,1,304,[211 302 187  64 318],328,5,1189,3.898360655737705,20.0,0.0
10305,1,305,[211 302 187  64 318],666,5,1194,3.9019607843137254,20.0,0.0
10306,1,306,[211 302 187  64 318],543,4,1198,3.9022801302931596,20.0,0.0
10307,1,307,[211 302 187  64 318],524,4,1202,3.9025974025974026,20.0,0.0
10308,1,308,[211 302 187 318  64],788,5,1207,3.9061488673139158,20.0,0.0
10309,1,309,[211 302 187 318  64],328,5,1212,3.9096774193548387,20.0,0.0
10310,1,310,[211 302 187 318  64],788,5,1217,3.9131832797427655,20.0,0.0
10311,1,311,[161 322 276 282   7],881,4,1221,3.9134615384615383,0.0,0.0
10312,1,312,[216   9  64  70 496],474,5,1226,3.916932907348243,0.0,0.0
10313,1,313,[ 56 100 204   9 496],7,5,1231,3.9203821656050954,0.0,20.0
10314,1,314,[228 202 275 135 435],883,5,1236,3.9238095238095236,0.0,0.0
10315,1,315,[211 302 187 318  64],328,5,1241,3.9272151898734178,20.0,0.0
10316,1,316,[211 302 187  64 318],90,5,1246,3.9305993690851735,20.0,0.0
10317,1,317,[211 302 187  64 318],537,4,1250,3.930817610062893,20.0,0.0
10318,1,318,[211 302 187 318 483],524,5,1255,3.9341692789968654,40.0,0.0
10319,1,319,[211 302 187 318 483],90,5,1260,3.9375,40.0,0.0
10320,1,320,[211 302 187 318 483],537,5,1265,3.940809968847352,40.0,0.0
10321,1,321,[211 302 187 318 483],90,5,1270,3.9440993788819876,40.0,0.0
10322,1,322,[211 302 187 318 483],343,5,1275,3.9473684210526314,40.0,0.0
10323,1,323,[655  71 197 144  64],488,1,1276,3.9382716049382718,0.0,0.0
10324,1,324,[135 174   7 403 121],881,4,1280,3.9384615384615387,0.0,20.0
10325,1,325,[211 302 187 318 483],13,4,1284,3.938650306748466,40.0,0.0
10326,1,326,[  4  11 742 183 168],346,5,1289,3.941896024464832,0.0,0.0
10327,1,327,[405 153  64 237 269],378,4,1293,3.942073170731707,0.0,0.0
10328,1,328,[132 117 176 405 173],334,1,1294,3.933130699088146,0.0,0.0
10329,1,329,[ 11 168 211 302 187],543,3,1297,3.93030303030303,0.0,0.0
10330,1,330,[211 302 187 318  64],343,5,1302,3.933534743202417,20.0,0.0
10331,1,331,[211 302 187 318  64],328,5,1307,3.9367469879518073,20.0,0.0
10332,1,332,[132  50 257 200  69],343,3,1310,3.933933933933934,0.0,20.0
10333,1,333,[ 95 191 196 179 245],749,4,1314,3.934131736526946,0.0,0.0
10334,1,334,[211 302 187 318  64],343,5,1319,3.937313432835821,20.0,0.0
10335,1,335,[211 302 187 318  64],666,5,1324,3.9404761904761907,20.0,0.0
10336,1,336,[211 302 187 318  64],666,5,1329,3.943620178041543,20.0,0.0
10337,1,337,[211 302 187 318  64],271,5,1334,3.9467455621301775,20.0,0.0
10338,1,338,[211 302 187 318  64],343,5,1339,3.949852507374631,20.0,0.0
10339,1,339,[211 302 187 318  64],524,4,1343,3.95,20.0,0.0
10340,1,340,[211 302 187 318 483],666,5,1348,3.9530791788856305,40.0,0.0
10341,1,341,[211 302 187 318 483],90,5,1353,3.956140350877193,40.0,0.0
10342,1,342,[ 56 135 257 202 172],840,3,1356,3.9533527696793005,0.0,0.0
10343,1,343,[211 302 187 318 483],524,5,1361,3.9563953488372094,40.0,0.0
10344,1,344,[211 302 187 318 483],328,5,1366,3.9594202898550726,40.0,0.0
10345,1,345,[  8   1 275 496 143],125,5,1371,3.96242774566474,0.0,0.0
10346,1,346,[211 302 187 318 483],474,5,1376,3.9654178674351583,40.0,0.0
10347,1,347,[211 302 187 318 483],666,5,1381,3.968390804597701,40.0,0.0
10348,1,348,[211 302 187 318 483],537,5,1386,3.9713467048710602,40.0,0.0
10349,1,349,[211 302 187 318 483],343,5,1391,3.974285714285714,40.0,0.0
10350,1,350,[211 302 187 318 483],666,5,1396,3.977207977207977,40.0,0.0
10351,1,351,[211 302 187 318 483],537,5,1401,3.9801136363636362,40.0,0.0
10352,1,352,[211 302 187 318 483],6,5,1406,3.9830028328611897,40.0,0.0
10353,1,353,[423  70 168  96 385],234,1,1407,3.9745762711864407,0.0,0.0
10354,1,354,[211 302 187 318 483],328,5,1412,3.9774647887323944,40.0,0.0
10355,1,355,[211 187 302 318 483],343,5,1417,3.980337078651685,40.0,0.0
10356,1,356,[211 187 302 318 483],666,5,1422,3.9831932773109244,40.0,0.0
10357,1,357,[153 655  15  79 515],184,1,1423,3.974860335195531,0.0,0.0
10358,1,358,[211 187 302 318 483],537,5,1428,3.977715877437326,40.0,0.0
10359,1,359,[117 132  89 172 186],279,3,1431,3.975,0.0,0.0
10360,1,360,[211 187 302 318 483],788,5,1436,3.9778393351800556,40.0,0.0
10361,1,361,[211 187 302 318 483],666,5,1441,3.9806629834254146,40.0,0.0
10362,1,362,[211 187 302 318 483],474,5,1446,3.9834710743801653,40.0,0.0
10363,1,363,[211 187 302 318 483],666,5,1451,3.9862637362637363,40.0,0.0
10364,1,364,[151 168 200 191 546],795,2,1453,3.9808219178082194,0.0,0.0
10365,1,365,[211 187 302 318 483],788,5,1458,3.9836065573770494,40.0,0.0
10366,1,366,[423  98  82 655 185],42,4,1462,3.983651226158038,0.0,20.0
10367,1,367,[183 187 403 333  22],144,3,1465,3.9809782608695654,0.0,0.0
10368,1,368,[211 187 302 318 483],328,5,1470,3.983739837398374,40.0,0.0
10369,1,369,[211 187 302 318 483],788,5,1475,3.9864864864864864,40.0,0.0
10370,1,370,[211 187 302 318 483],328,5,1480,3.98921832884097,40.0,0.0
10371,1,371,[211 187 302 318 483],537,5,1485,3.9919354838709675,40.0,0.0
10372,1,372,[211 187 302 318 483],90,5,1490,3.994638069705094,40.0,0.0
10373,1,373,[211 187 302 318 483],6,5,1495,3.9973262032085564,40.0,0.0
10374,1,374,[211 187 302 318 483],474,5,1500,4.0,40.0,0.0
10375,1,375,[211 187 302 318 483],343,5,1505,4.002659574468085,40.0,0.0
10376,1,376,[211 187 302 318 483],666,5,1510,4.005305039787799,40.0,0.0
10377,1,377,[265 427 322 182 475],474,5,1515,4.007936507936508,0.0,0.0
10378,1,378,[603 328 435   9 117],13,2,1517,4.002638522427441,20.0,0.0
10379,1,379,[211 187 302 318 483],6,5,1522,4.005263157894737,40.0,0.0
10380,1,380,[211 187 302 318 483],537,5,1527,4.0078740157480315,40.0,0.0
10381,1,381,[211 187 302 318 483],666,5,1532,4.010471204188482,40.0,0.0
10382,1,382,[211 187 302 318 483],474,5,1537,4.013054830287206,40.0,0.0
10383,1,383,[ 12 135  98 204  69],380,3,1540,4.010416666666667,20.0,20.0
10384,1,384,[211 187 302 318 483],666,5,1545,4.012987012987013,40.0,0.0
10385,1,385,[211 187 302 318 483],90,5,1550,4.015544041450777,40.0,0.0
10386,1,386,[475 196 132 100 323],474,4,1554,4.015503875968992,0.0,20.0
10387,1,387,[211 187 302 318 483],6,5,1559,4.018041237113402,40.0,0.0
10388,1,388,[168 678 191 496 515],488,3,1562,4.015424164524422,0.0,0.0
10389,1,389,[742 288 588 117 265],308,3,1565,4.012820512820513,0.0,0.0
10390,1,390,[211 187 302 318 483],788,5,1570,4.015345268542199,40.0,0.0
10391,1,391,[  7  98 176  28  79],447,4,1574,4.01530612244898,0.0,20.0
10392,1,392,[ 69 195 475 118   7],92,4,1578,4.015267175572519,0.0,0.0
10393,1,393,[211 187 302 318 483],207,5,1583,4.017766497461929,40.0,0.0
10394,1,394,[211 187 302 318 483],13,4,1587,4.017721518987342,40.0,0.0
10395,1,395,[182 216   8 197 111],64,4,1591,4.017676767676767,0.0,0.0
10396,1,396,[211 187 302 318 483],328,5,1596,4.020151133501259,40.0,0.0
10397,1,397,[ 11 228  89 143 276],343,4,1600,4.0201005025125625,0.0,0.0
10398,1,398,[211 187 302 318 483],788,5,1605,4.022556390977444,40.0,0.0
10399,1,399,[187   4 258  69 153],144,5,1610,4.025,0.0,0.0
10400,1,400,[211 187 302 318 483],13,4,1614,4.024937655860349,40.0,0.0
10401,1,401,[ 70 132  28 289 173],406,1,1615,4.017412935323383,0.0,0.0
10402,1,402,[211 187 302 318 483],343,5,1620,4.01985111662531,40.0,0.0
10403,1,403,[211 187 302 318 483],207,5,1625,4.022277227722772,40.0,0.0
10404,1,404,[211 187 302 318 483],666,5,1630,4.0246913580246915,40.0,0.0
10405,1,405,[125 228 185 143 182],653,1,1631,4.017241379310345,0.0,0.0
10406,1,406,[211 187 302 318 483],328,5,1636,4.019656019656019,40.0,0.0
10407,1,407,[211 187 302 318 483],207,5,1641,4.022058823529412,40.0,0.0
10408,1,408,[211 187 302 318 483],343,5,1646,4.0244498777506115,40.0,0.0
10409,1,409,[ 82 423  64 276 222],343,5,1651,4.0268292682926825,0.0,0.0
10410,1,410,[211 187 302 318 483],524,5,1656,4.029197080291971,40.0,0.0
10411,1,411,[211 187 302 318 483],788,5,1661,4.031553398058253,40.0,0.0
10412,1,412,[238  98 286 228 161],334,4,1665,4.031476997578692,0.0,20.0
10413,1,413,[211 187 302 318 483],13,4,1669,4.031400966183575,40.0,0.0
10414,1,414,[211 187 302 318 483],524,5,1674,4.033734939759036,40.0,0.0
10415,1,415,[ 98 111 144  70 289],488,2,1676,4.028846153846154,0.0,20.0
10416,1,416,[211 187 302 318 483],13,4,1680,4.028776978417266,40.0,0.0
10417,1,417,[211 187 302 318 483],666,5,1685,4.0311004784688995,40.0,0.0
10418,1,418,[211 187 302 318 483],474,5,1690,4.033412887828162,40.0,0.0
10419,1,419,[181  96 161  98  22],897,4,1694,4.033333333333333,0.0,20.0
10420,1,420,[211 187 302 318 483],537,5,1699,4.03562945368171,40.0,0.0
10421,1,421,[187 357 153 210  22],298,4,1703,4.035545023696683,20.0,0.0
10422,1,422,[211 187 302 318 483],537,5,1708,4.037825059101655,40.0,0.0
10423,1,423,[181   8  89 183 237],328,4,1712,4.037735849056604,0.0,0.0
10424,1,424,[211 187 302 318 483],666,5,1717,4.04,40.0,0.0
10425,1,425,[211 187 302 318 483],343,5,1722,4.042253521126761,40.0,0.0
10426,1,426,[211 187 302 318 483],788,5,1727,4.044496487119438,40.0,0.0
10427,1,427,[194 597 496 235  82],59,2,1729,4.039719626168225,0.0,0.0
10428,1,428,[211 187 302 318 483],328,5,1734,4.041958041958042,40.0,0.0
10429,1,429,[211 187 302 318 483],524,5,1739,4.044186046511628,40.0,0.0
10430,1,430,[ 69  98 228  28 168],254,4,1743,4.044083526682135,0.0,20.0
10431,1,431,[211 187 302 318 483],90,5,1748,4.046296296296297,40.0,0.0
10432,1,432,[211 187 302 318 483],90,5,1753,4.048498845265589,40.0,0.0
10433,1,433,[211 187 302 318 483],207,5,1758,4.050691244239632,40.0,0.0
10434,1,434,[211 187 302 318 483],524,5,1763,4.052873563218391,40.0,0.0
10435,1,435,[301 289 125 385  25],455,0,1763,4.043577981651376,0.0,0.0
10436,1,436,[211 187 302 318 483],524,5,1768,4.045766590389016,40.0,0.0
10437,1,437,[ 96 153 300   8  88],454,4,1772,4.045662100456621,0.0,0.0
10438,1,438,[211 187 302 318 483],207,5,1777,4.047835990888383,40.0,0.0
10439,1,439,[211 187 302 318 483],343,5,1782,4.05,40.0,0.0
10440,1,440,[211 187 302 318 483],90,5,1787,4.052154195011338,40.0,0.0
10441,1,441,[211 187 302 318 483],207,5,1792,4.0542986425339365,40.0,0.0
10442,1,442,[211 187 302 318 483],90,5,1797,4.056433408577878,40.0,0.0
10443,1,443,[211 187 302 318 483],474,5,1802,4.058558558558558,40.0,0.0
10444,1,444,[211 187 302 318 483],788,5,1807,4.060674157303371,40.0,0.0
10445,1,445,[211 187 302 318 483],328,5,1812,4.062780269058296,40.0,0.0
10446,1,446,[211 187 302 318 483],13,4,1816,4.062639821029083,40.0,0.0
10447,1,447,[211 187 302 318 483],207,5,1821,4.064732142857143,40.0,0.0
10448,1,448,[211 323 194 300 313],454,2,1823,4.060133630289532,0.0,0.0
10449,1,449,[597 301  71 234  69],13,3,1826,4.057777777777778,0.0,0.0
10450,1,450,[258 435 568 121   4],650,1,1827,4.0509977827051,0.0,0.0
10451,1,451,[161 175 475 322 135],474,5,1832,4.053097345132743,0.0,0.0
10452,1,452,[313 187 211 302 318],207,5,1837,4.0551876379690945,20.0,0.0
10453,1,453,[132 234 135 100 588],378,4,1841,4.0550660792951545,0.0,20.0
10454,1,454,[313 187 211 302 318],543,3,1844,4.052747252747253,20.0,0.0
10455,1,455,[187 211 302 483 318],13,4,1848,4.052631578947368,40.0,0.0
10456,1,456,[187 211 302 483 318],207,5,1853,4.054704595185996,40.0,0.0
10457,1,457,[187 211 302 483 318],207,5,1858,4.056768558951965,40.0,0.0
10458,1,458,[187 211 302 483 318],788,5,1863,4.0588235294117645,40.0,0.0
10459,1,459,[187 211 302 483 318],328,5,1868,4.060869565217391,40.0,0.0
10460,1,460,[117  70 300 328  89],479,3,1871,4.058568329718004,0.0,0.0
10461,1,461,[187 211 302 483 318],6,5,1876,4.0606060606060606,40.0,0.0
10462,1,462,[187 211 302 483 318],788,5,1881,4.0626349892008635,40.0,0.0
10463,1,463,[187 211 302 483 318],788,5,1886,4.064655172413793,40.0,0.0
10464,1,464,[276 257  11 294 403],378,3,1889,4.06236559139785,0.0,0.0
10465,1,465,[187 211 302 483 318],666,5,1894,4.064377682403434,40.0,0.0
10466,1,466,[187 211 302 483 318],328,5,1899,4.0663811563169165,40.0,0.0
10467,1,467,[187 211 302 483 318],343,5,1904,4.068376068376068,40.0,0.0
10468,1,468,[385 508 245  22 234],653,3,1907,4.066098081023454,0.0,0.0
10469,1,469,[111 405 187 286 237],271,4,1911,4.06595744680851,0.0,0.0
10470,1,470,[176 405 100 181 678],825,5,1916,4.067940552016985,0.0,20.0
10471,1,471,[ 22 215 135 655 185],479,4,1920,4.067796610169491,0.0,0.0
10472,1,472,[ 50 435 275   1 294],533,5,1925,4.069767441860465,0.0,20.0
10473,1,473,[187 211 302 483 318],207,5,1930,4.071729957805907,40.0,0.0
10474,1,474,[187 211 302 483 318],13,4,1934,4.071578947368421,40.0,0.0
10475,1,475,[187 211 302 483 318],666,5,1939,4.073529411764706,40.0,0.0
10476,1,476,[187 211 302 483 318],13,4,1943,4.073375262054507,40.0,0.0
10477,1,477,[187 211 302 483 318],6,5,1948,4.075313807531381,40.0,0.0
10478,1,478,[187 211 302 483 318],788,5,1953,4.077244258872652,40.0,0.0
10479,1,479,[187 211 302 483 318],788,5,1958,4.079166666666667,40.0,0.0
10480,1,480,[187 211 302 483 318],328,5,1963,4.081081081081081,40.0,0.0
10481,1,481,[168  95 186 286 125],881,2,1965,4.076763485477178,0.0,0.0
10482,1,482,[187 211 302 483 318],6,5,1970,4.078674948240166,40.0,0.0
10483,1,483,[ 97 222 143 216 194],804,4,1974,4.078512396694215,0.0,0.0
10484,1,484,[187 211 302 483 318],524,5,1979,4.08041237113402,40.0,0.0
10485,1,485,[187 211 302 483 318],788,5,1984,4.082304526748971,40.0,0.0
10486,1,486,[187 211 302 483 318],13,4,1988,4.082135523613963,40.0,0.0
10487,1,487,[181 117  69 182 197],387,2,1990,4.077868852459017,0.0,0.0
10488,1,488,[ 11  28 294 300 385],537,0,1990,4.069529652351738,0.0,0.0
10489,1,489,[195 471 216 172 215],648,4,1994,4.069387755102041,0.0,0.0
10490,1,490,[187 211 302 483 318],666,5,1999,4.071283095723015,40.0,0.0
10491,1,491,[187 211 302 483 318],537,5,2004,4.073170731707317,40.0,0.0
10492,1,492,[117 678 187 234 202],308,2,2006,4.068965517241379,0.0,0.0
10493,1,493,[187 211 302 483 318],207,5,2011,4.07085020242915,40.0,0.0
10494,1,494,[187 211 302 483 318],537,5,2016,4.072727272727272,40.0,0.0
10495,1,495,[187 211 302 483 318],537,5,2021,4.074596774193548,40.0,0.0
10496,1,496,[187 211 302 483 318],90,5,2026,4.076458752515091,40.0,0.0
10497,1,497,[187 211 302 483 318],788,5,2031,4.078313253012048,40.0,0.0
10498,1,498,[187 211 302 483 318],788,5,2036,4.080160320641283,40.0,0.0
10499,1,499,[187 211 302 483 318],343,5,2041,4.082,40.0,0.0
10500,1,500,[187 211 302 483 318],90,5,2046,4.083832335329341,40.0,0.0
10501,1,501,[187 211 302 483 318],90,5,2051,4.085657370517929,40.0,0.0
10502,1,502,[187 211 302 483 318],788,5,2056,4.087475149105368,40.0,0.0
10503,1,503,[187 211 302 483 318],666,5,2061,4.089285714285714,40.0,0.0
10504,1,504,[187 211 302 483 318],328,5,2066,4.091089108910891,40.0,0.0
10505,1,505,[187 211 302 483 318],6,5,2071,4.092885375494071,40.0,0.0
10506,1,506,[ 15  64  82 143 234],313,2,2073,4.088757396449704,0.0,0.0
10507,1,507,[187 211 302 483 318],666,5,2078,4.090551181102362,40.0,0.0
10508,1,508,[187 211 302 483 318],6,5,2083,4.092337917485265,40.0,0.0
10509,1,509,[187 211 302 483 318],788,5,2088,4.094117647058823,40.0,0.0
10510,1,510,[187 211 302 483 318],328,5,2093,4.095890410958904,40.0,0.0
10511,1,511,[187  28 318 132  70],666,4,2097,4.095703125,20.0,0.0
10512,1,512,[187 211 302 483 318],666,5,2102,4.097465886939571,40.0,0.0
10513,1,513,[187 211 302 483 318],207,5,2107,4.099221789883268,40.0,0.0
10514,1,514,[187 211 302 483 318],6,5,2112,4.100970873786408,40.0,0.0
10515,1,515,[187 211 302 483 318],666,5,2117,4.102713178294573,40.0,0.0
10516,1,516,[187 211 302 483 318],788,5,2122,4.104448742746615,40.0,0.0
10517,1,517,[187 211 302 483 318],524,5,2127,4.1061776061776065,40.0,0.0
10518,1,518,[187 211 302 483 318],328,5,2132,4.107899807321773,40.0,0.0
10519,1,519,[187 211 302 483 318],13,4,2136,4.107692307692307,40.0,0.0
10520,1,520,[187 211 302 483 318],666,5,2141,4.109404990403071,40.0,0.0
10521,1,521,[187 211 302 483 318],90,5,2146,4.111111111111111,40.0,0.0
10522,1,522,[187 211 302 483 318],90,5,2151,4.112810707456979,40.0,0.0
10523,1,523,[151 403 435 269 405],934,3,2154,4.1106870229007635,0.0,0.0
10524,1,524,[187 211 302 483 318],343,5,2159,4.112380952380953,40.0,0.0
10525,1,525,[ 82 265 294 357  50],379,4,2163,4.112167300380228,20.0,20.0
10526,1,526,[187 211 302 483 318],537,5,2168,4.1138519924098675,40.0,0.0
10527,1,527,[187 211 302 483 318],666,5,2173,4.115530303030303,40.0,0.0
10528,1,528,[187 211 302 483 318],537,5,2178,4.117202268431002,40.0,0.0
10529,1,529,[127 183  12 483 174],406,5,2183,4.118867924528302,40.0,40.0
10530,1,530,[187 211 302 483 318],788,5,2188,4.120527306967985,40.0,0.0
10531,1,531,[187 211 302 483 318],537,5,2193,4.12218045112782,40.0,0.0
10532,1,532,[187 211 302 483 318],524,5,2198,4.123827392120075,40.0,0.0
10533,1,533,[187 211 302 483 318],343,5,2203,4.1254681647940075,40.0,0.0
10534,1,534,[187 211 302 483 318],207,5,2208,4.1271028037383175,40.0,0.0
10535,1,535,[655 322 748 222 508],92,3,2211,4.125,0.0,0.0
10536,1,536,[153 176 191 187 300],64,3,2214,4.122905027932961,0.0,0.0
10537,1,537,[187 211 302 483 318],343,5,2219,4.12453531598513,40.0,0.0
10538,1,538,[423 238 191  12 125],6,3,2222,4.122448979591836,20.0,0.0
10539,1,539,[ 69 423  28 385 546],899,2,2224,4.118518518518519,0.0,0.0
10540,1,540,[187 211 302 483 318],524,5,2229,4.12014787430684,40.0,0.0
10541,1,541,[187 211 302 483 318],207,5,2234,4.121771217712177,40.0,0.0
10542,1,542,[187 211 302 483 318],666,5,2239,4.123388581952118,40.0,0.0
10543,1,543,[187 211 302 483 318],343,5,2244,4.125,40.0,0.0
10544,1,544,[187 211 302 483 318],343,5,2249,4.126605504587156,40.0,0.0
10545,1,545,[187 211 302 483 318],474,5,2254,4.128205128205129,40.0,0.0
10546,1,546,[187 211 302 483 318],524,5,2259,4.1297989031078615,40.0,0.0
10547,1,547,[187 211 302 483 318],6,5,2264,4.131386861313868,40.0,0.0
10548,1,548,[238  56 597  79 496],458,3,2267,4.129326047358834,0.0,0.0
10549,1,549,[435  98 288  50 111],378,3,2270,4.127272727272727,0.0,40.0
10550,1,550,[187 211 302 483 318],524,5,2275,4.128856624319419,40.0,0.0
10551,1,551,[187 211 302 483 318],13,4,2279,4.128623188405797,40.0,0.0
10552,1,552,[187 211 302 483 318],90,5,2284,4.130198915009042,40.0,0.0
10553,1,553,[187 211 302 483 318],207,5,2289,4.131768953068592,40.0,0.0
10554,1,554,[187 211 302 483 318],474,5,2294,4.133333333333334,40.0,0.0
10555,1,555,[187 211 302 483 318],474,5,2299,4.134892086330935,40.0,0.0
10556,1,556,[187 211 302 483 318],788,5,2304,4.136445242369838,40.0,0.0
10557,1,557,[187 211 302 483 318],524,5,2309,4.137992831541219,40.0,0.0
10558,1,558,[187 211 302 483 318],13,4,2313,4.137745974955277,40.0,0.0
10559,1,559,[187 211 302 483 318],90,5,2318,4.139285714285714,40.0,0.0
10560,1,560,[187 211 302 483 318],13,4,2322,4.13903743315508,40.0,0.0
10561,1,561,[187 211 302 483 318],343,5,2327,4.140569395017794,40.0,0.0
10562,1,562,[187 211 302 483 318],537,5,2332,4.142095914742451,40.0,0.0
10563,1,563,[ 97 196  89 135 186],892,4,2336,4.141843971631205,0.0,0.0
10564,1,564,[187 211 302 483 318],13,4,2340,4.1415929203539825,40.0,0.0
10565,1,565,[187 211 302 483 318],13,4,2344,4.141342756183746,40.0,0.0
10566,1,566,[187 211 302 483 318],90,5,2349,4.142857142857143,40.0,0.0
10567,1,567,[333 204  98 183 127],298,4,2353,4.142605633802817,0.0,40.0
10568,1,568,[187 211 302 483 318],207,5,2358,4.1441124780316345,40.0,0.0
10569,1,569,[187 211 302 483 318],537,5,2363,4.1456140350877195,40.0,0.0
10570,1,570,[187 211 302 483 318],666,5,2368,4.147110332749562,40.0,0.0
10571,1,571,[483 144  97 187 357],840,2,2370,4.143356643356643,40.0,0.0
10572,1,572,[238 265 322 168 257],308,3,2373,4.141361256544503,0.0,0.0
10573,1,573,[211 302 187 483 318],788,5,2378,4.142857142857143,40.0,0.0
10574,1,574,[211 302 187 483 318],207,5,2383,4.144347826086957,40.0,0.0
10575,1,575,[211 302 187 483 318],788,5,2388,4.145833333333333,40.0,0.0
10576,1,576,[ 22 215 423 403 204],774,0,2388,4.138648180242634,0.0,0.0
10577,1,577,[435  64 333 135 276],537,2,2390,4.134948096885813,0.0,0.0
10578,1,578,[211 302 187 483 318],788,5,2395,4.136442141623489,40.0,0.0
10579,1,579,[211 302 187 483 318],524,5,2400,4.137931034482759,40.0,0.0
10580,1,580,[118 100 655  25 125],749,3,2403,4.135972461273666,0.0,20.0
10581,1,581,[  1 655 186   9 180],92,5,2408,4.13745704467354,0.0,0.0
10582,1,582,[179 385 289   8 300],234,2,2410,4.133790737564323,0.0,0.0
10583,1,583,[211 302 187 483 318],343,5,2415,4.135273972602739,40.0,0.0
10584,1,584,[211 302 187 483 318],537,5,2420,4.136752136752137,40.0,0.0
10585,1,585,[211 302 187 483 318],537,5,2425,4.138225255972697,40.0,0.0
10586,1,586,[211 302 187 483 318],328,5,2430,4.1396933560477,40.0,0.0
10587,1,587,[211 302 187 483 318],474,5,2435,4.141156462585034,40.0,0.0
10588,1,588,[211 302 187 483 318],537,5,2440,4.142614601018676,40.0,0.0
10589,1,589,[211 302 187 483 318],788,5,2445,4.1440677966101696,40.0,0.0
10590,1,590,[211 302 187 483 318],343,5,2450,4.145516074450085,40.0,0.0
10591,1,591,[211 302 187 483 318],13,4,2454,4.14527027027027,40.0,0.0
10592,1,592,[211 302 187 483 318],666,5,2459,4.146711635750422,40.0,0.0
10593,1,593,[211 302 187 483 318],207,5,2464,4.148148148148148,40.0,0.0
10594,1,594,[211 302 187 483 318],788,5,2469,4.1495798319327735,40.0,0.0
10595,1,595,[211 302 187 483 318],207,5,2474,4.151006711409396,40.0,0.0
10596,1,596,[211 302 187 483 318],90,5,2479,4.152428810720268,40.0,0.0
10597,1,597,[211 302 187 483 318],537,5,2484,4.153846153846154,40.0,0.0
10598,1,598,[  7 597   9 265   1],374,3,2487,4.151919866444073,0.0,0.0
10599,1,599,[211 302 187 483 318],788,5,2492,4.153333333333333,40.0,0.0
10600,1,600,[211 302 187 483 318],788,5,2497,4.1547420965058235,40.0,0.0
10601,1,601,[211 302 187 483 318],13,4,2501,4.1544850498338874,40.0,0.0
10602,1,602,[215   1  97  15 403],184,2,2503,4.150912106135987,0.0,0.0
10603,1,603,[211 302 187 483 318],328,5,2508,4.152317880794702,40.0,0.0
10604,1,604,[211 302 187 483 318],207,5,2513,4.153719008264463,40.0,0.0
10605,1,605,[211 302 187 483 318],537,5,2518,4.1551155115511555,40.0,0.0
10606,1,606,[211 302 187 483 318],90,5,2523,4.156507413509061,40.0,0.0
10607,1,607,[211 302 187 483 318],328,5,2528,4.157894736842105,40.0,0.0
10608,1,608,[211 302 187 483 318],13,4,2532,4.157635467980295,40.0,0.0
10609,1,609,[182 151   9 748  98],474,3,2535,4.155737704918033,0.0,20.0
10610,1,610,[211 302 187 483 318],524,5,2540,4.157119476268412,40.0,0.0
10611,1,611,[211 302 187 483 318],666,5,2545,4.158496732026144,40.0,0.0
10612,1,612,[211 302 187 483 318],666,5,2550,4.159869494290375,40.0,0.0
10613,1,613,[ 64 748 271 228 204],788,1,2551,4.1547231270358305,0.0,0.0
10614,1,614,[211 302 187 483 318],474,5,2556,4.15609756097561,40.0,0.0
10615,1,615,[423  98 195 302 118],13,4,2560,4.1558441558441555,0.0,20.0
10616,1,616,[588 215  79 216 234],234,1,2561,4.1507293354943275,0.0,0.0
10617,1,617,[211 302 187 483 318],537,5,2566,4.15210355987055,40.0,0.0
10618,1,618,[405 403 258 196 202],653,0,2566,4.145395799676899,0.0,0.0
10619,1,619,[211 302 187 483 318],343,5,2571,4.146774193548387,40.0,0.0
10620,1,620,[483  25 496 125 127],749,5,2576,4.148148148148148,20.0,20.0
10621,1,621,[211 302 187 483 318],537,5,2581,4.14951768488746,40.0,0.0
10622,1,622,[211 302 187 483 318],666,5,2586,4.150882825040129,40.0,0.0
10623,1,623,[  1 204 515 175  25],843,1,2587,4.145833333333333,0.0,0.0
10624,1,624,[211 302 187 483 318],90,5,2592,4.1472,40.0,0.0
10625,1,625,[121 132  69 181 273],213,4,2596,4.146964856230032,0.0,0.0
10626,1,626,[273 211 302 187 483],328,4,2600,4.146730462519936,20.0,0.0
10627,1,627,[211 302 187 483 318],474,5,2605,4.148089171974522,40.0,0.0
10628,1,628,[318 200 328  28 222],488,4,2609,4.14785373608903,20.0,0.0
10629,1,629,[194 588 127 275 175],95,3,2612,4.146031746031746,0.0,20.0
10630,1,630,[211 302 187 483 318],328,5,2617,4.147385103011094,40.0,0.0
10631,1,631,[211 302 187 483 318],666,5,2622,4.14873417721519,40.0,0.0
10632,1,632,[211 302 187 483 318],207,5,2627,4.150078988941548,40.0,0.0
10633,1,633,[211 302 187 483 318],666,5,2632,4.151419558359621,40.0,0.0
10634,1,634,[211 302 187 483 318],524,5,2637,4.152755905511811,40.0,0.0
10635,1,635,[187 100 318 302 508],343,5,2642,4.154088050314465,20.0,20.0
10636,1,636,[211 302 187 483 318],13,4,2646,4.153846153846154,40.0,0.0
10637,1,637,[211 302 187 483 318],524,5,2651,4.155172413793103,40.0,0.0
10638,1,638,[ 70 151 385 265 172],536,3,2654,4.153364632237872,0.0,0.0
10639,1,639,[211 302 187 483 318],343,5,2659,4.1546875,40.0,0.0
10640,1,640,[196 234 100 172 187],194,2,2661,4.151326053042122,0.0,20.0
10641,1,641,[211 302 187 483 318],328,5,2666,4.1526479750778815,40.0,0.0
10642,1,642,[211 302 187 483 318],6,5,2671,4.153965785381026,40.0,0.0
10643,1,643,[211 302 187 483 318],474,5,2676,4.15527950310559,40.0,0.0
10644,1,644,[211 302 187 483 318],328,5,2681,4.156589147286821,40.0,0.0
10645,1,645,[211 302 187 483 318],13,4,2685,4.156346749226006,40.0,0.0
10646,1,646,[211 302 187 483 318],328,5,2690,4.157650695517774,40.0,0.0
10647,1,647,[211 302 187 483 318],537,5,2695,4.158950617283951,40.0,0.0
10648,1,648,[211 302 187 483 318],788,5,2700,4.160246533127889,40.0,0.0
10649,1,649,[211 302 187 483 318],90,5,2705,4.161538461538462,40.0,0.0
10650,1,650,[211 302 187 483 318],6,5,2710,4.162826420890937,40.0,0.0
10651,1,651,[211 302 187 483 318],207,5,2715,4.164110429447852,40.0,0.0
10652,1,652,[ 79 135   7 318 273],537,3,2718,4.162327718223583,20.0,0.0
10653,1,653,[597 403 483 435 385],59,4,2722,4.162079510703364,20.0,0.0
10654,1,654,[211 302 187 483 318],13,4,2726,4.1618320610687025,40.0,0.0
10655,1,655,[211 302 187 483 318],207,5,2731,4.163109756097561,40.0,0.0
10656,1,656,[268 238 197   7 597],7,3,2734,4.161339421613394,0.0,0.0
10657,1,657,[211 302 187 483 318],343,5,2739,4.1626139817629175,40.0,0.0
10658,1,658,[211 302 187 483 318],474,5,2744,4.163884673748103,40.0,0.0
10659,1,659,[211 302 187 483 318],537,5,2749,4.165151515151515,40.0,0.0
10660,1,660,[211 302 187 483 318],13,4,2753,4.164901664145234,40.0,0.0
10661,1,661,[211 302 187 483 318],328,5,2758,4.166163141993958,40.0,0.0
10662,1,662,[423  50 132  88 471],13,4,2762,4.165912518853696,0.0,20.0
10663,1,663,[ 70  22 202 328 300],647,3,2765,4.164156626506024,0.0,0.0
10664,1,664,[211 302 187 483 318],666,5,2770,4.165413533834586,40.0,0.0
10665,1,665,[211 302 187 483 318],474,5,2775,4.166666666666667,40.0,0.0
10666,1,666,[211 302 187 483 318],666,5,2780,4.1679160419790104,40.0,0.0
10667,1,667,[211 302 187 483 318],207,5,2785,4.169161676646707,40.0,0.0
10668,1,668,[211 302 187 483 318],207,5,2790,4.170403587443946,40.0,0.0
10669,1,669,[211 302 187 483 318],6,5,2795,4.1716417910447765,40.0,0.0
10670,1,670,[211 302 187 483 318],90,5,2800,4.172876304023845,40.0,0.0
10671,1,671,[ 82  15 143 471 385],92,2,2802,4.169642857142857,0.0,0.0
10672,1,672,[211 302 187 483 318],207,5,2807,4.170876671619614,40.0,0.0
10673,1,673,[ 12 333  79 546 200],328,3,2810,4.169139465875371,20.0,0.0
10674,1,674,[211 302 187 483 318],6,5,2815,4.17037037037037,40.0,0.0
10675,1,675,[211 302 187 483 318],666,5,2820,4.171597633136095,40.0,0.0
10676,1,676,[211 302 187 483 318],524,5,2825,4.172821270310192,40.0,0.0
10677,1,677,[211 302 187 483 318],207,5,2830,4.174041297935103,40.0,0.0
10678,1,678,[423  64 265 258 180],899,4,2834,4.1737849779086895,0.0,0.0
10679,1,679,[ 28 483 286 385 161],454,2,2836,4.170588235294118,20.0,0.0
10680,1,680,[211 302 187 483 318],788,5,2841,4.171806167400881,40.0,0.0
10681,1,681,[211 302 187 483 318],537,5,2846,4.173020527859237,40.0,0.0
10682,1,682,[742 403 151  98 546],653,0,2846,4.166910688140557,0.0,20.0
10683,1,683,[211 302 187 483 318],90,5,2851,4.168128654970761,40.0,0.0
10684,1,684,[211 302 187 483 318],90,5,2856,4.169343065693431,40.0,0.0
10685,1,685,[211 302 187 483 318],343,5,2861,4.170553935860059,40.0,0.0
10686,1,686,[211 302 187 483 318],328,5,2866,4.1717612809315865,40.0,0.0
10687,1,687,[211 302 187 483 318],207,5,2871,4.1729651162790695,40.0,0.0
10688,1,688,[211 302 187 483 318],13,4,2875,4.172714078374455,40.0,0.0
10689,1,689,[211 302 187 483 318],13,4,2879,4.172463768115942,40.0,0.0
10690,1,690,[211 302 187 483 318],13,4,2883,4.172214182344429,40.0,0.0
10691,1,691,[211 302 187 483 318],343,5,2888,4.173410404624278,40.0,0.0
10692,1,692,[211 302 187 483 318],537,5,2893,4.174603174603175,40.0,0.0
10693,1,693,[211 302 187 483 318],474,5,2898,4.175792507204611,40.0,0.0
10694,1,694,[211 302 187 483 318],666,5,2903,4.176978417266187,40.0,0.0
10695,1,695,[211 302 187 483 318],343,5,2908,4.17816091954023,40.0,0.0
10696,1,696,[211 302 187 483 318],207,5,2913,4.179340028694405,40.0,0.0
10697,1,697,[211 302 187 483 318],328,5,2918,4.180515759312321,40.0,0.0
10698,1,698,[568 328 153 216  88],13,2,2920,4.177396280400572,0.0,0.0
10699,1,699,[211 302 187 483 318],666,5,2925,4.178571428571429,40.0,0.0
10700,1,700,[211 302 187 483 318],474,5,2930,4.1797432239657635,40.0,0.0
10701,1,701,[  4   1 546 216 288],234,1,2931,4.1752136752136755,0.0,0.0
10702,1,702,[185 234 176 265  89],883,4,2935,4.174964438122333,0.0,0.0
10703,1,703,[211 302 187 483 318],788,5,2940,4.176136363636363,40.0,0.0
10704,1,704,[211 302 187 483 318],13,4,2944,4.175886524822695,40.0,0.0
10705,1,705,[211 302 187 483 318],207,5,2949,4.1770538243626065,40.0,0.0
10706,1,706,[211 302 187 483 318],90,5,2954,4.178217821782178,40.0,0.0
10707,1,707,[200 173 265 403 496],650,4,2958,4.177966101694915,0.0,0.0
10708,1,708,[ 64  71  25 222 173],378,4,2962,4.1777150916784205,0.0,0.0
10709,1,709,[211 302 187 483 318],788,5,2967,4.17887323943662,40.0,0.0
10710,1,710,[211 302 187 483 318],524,5,2972,4.180028129395218,40.0,0.0
10711,1,711,[211 302 187 483 318],537,5,2977,4.181179775280899,40.0,0.0
10712,1,712,[211 302 187 483 318],788,5,2982,4.182328190743338,40.0,0.0
10713,1,713,[211 302 187 483 318],666,5,2987,4.1834733893557425,40.0,0.0
10714,1,714,[211 302 187 483 318],328,5,2992,4.184615384615385,40.0,0.0
10715,1,715,[ 69 135 153 678 265],263,3,2995,4.182960893854749,0.0,0.0
10716,1,716,[211 302 187 483 318],788,5,3000,4.184100418410042,40.0,0.0
10717,1,717,[211 302 187 483 318],328,5,3005,4.185236768802229,40.0,0.0
10718,1,718,[211 302 187 483 318],537,5,3010,4.186369958275383,40.0,0.0
10719,1,719,[ 56 117 235  82 187],774,0,3010,4.180555555555555,0.0,0.0
10720,1,720,[211 302 187 483 318],537,5,3015,4.181692094313454,40.0,0.0
10721,1,721,[237 168 197 143 385],60,4,3019,4.1814404432132966,0.0,0.0
10722,1,722,[211 302 187 483 318],6,5,3024,4.182572614107884,40.0,0.0
10723,1,723,[211 302 187 483 318],666,5,3029,4.183701657458563,40.0,0.0
10724,1,724,[211 302 187 483 318],788,5,3034,4.184827586206897,40.0,0.0
10725,1,725,[403 173 655 435 258],7,5,3039,4.18595041322314,0.0,0.0
10726,1,726,[211 302 187 483 318],328,5,3044,4.18707015130674,40.0,0.0
10727,1,727,[211 302 187 483 318],343,5,3049,4.188186813186813,40.0,0.0
10728,1,728,[211 302 187 483 318],343,5,3054,4.189300411522634,40.0,0.0
10729,1,729,[211 302 187 483 318],666,5,3059,4.19041095890411,40.0,0.0
10730,1,730,[222 588  64 202 153],387,2,3061,4.187414500683994,0.0,0.0
10731,1,731,[211 302 187 483 318],207,5,3066,4.188524590163935,40.0,0.0
10732,1,732,[568 508 183 127  96],13,3,3069,4.186903137789905,0.0,20.0
10733,1,733,[211 302 187 483 318],328,5,3074,4.1880108991825615,40.0,0.0
10734,1,734,[187 127 289  50 302],334,4,3078,4.187755102040816,0.0,40.0
10735,1,735,[318 181  64 182 678],213,5,3083,4.188858695652174,20.0,0.0
10736,1,736,[211 302 187 483 318],328,5,3088,4.189959294436906,40.0,0.0
10737,1,737,[ 96 179 265 546 496],479,2,3090,4.186991869918699,0.0,0.0
10738,1,738,[211 302 187 483 318],13,4,3094,4.186738836265223,40.0,0.0
10739,1,739,[211 302 187 483 318],524,5,3099,4.187837837837838,40.0,0.0
10740,1,740,[211 302 187 483 318],343,5,3104,4.188933873144399,40.0,0.0
10741,1,741,[211 302 187 483 318],207,5,3109,4.190026954177897,40.0,0.0
10742,1,742,[211 302 187 483 318],90,5,3114,4.191117092866756,40.0,0.0
10743,1,743,[211 302 187 483 318],666,5,3119,4.192204301075269,40.0,0.0
10744,1,744,[211 302 187 483 318],207,5,3124,4.193288590604027,40.0,0.0
10745,1,745,[211 302 187 483 318],666,5,3129,4.194369973190349,40.0,0.0
10746,1,746,[211 302 187 483 318],474,5,3134,4.195448460508701,40.0,0.0
10747,1,747,[211 302 187 483 318],343,5,3139,4.196524064171123,40.0,0.0
10748,1,748,[211 302 187 483 318],13,4,3143,4.196261682242991,40.0,0.0
10749,1,749,[211 302 187 483 318],788,5,3148,4.197333333333333,40.0,0.0
10750,1,750,[211 302 187 483 318],13,4,3152,4.197070572569907,40.0,0.0
10751,1,751,[211 302 187 483 318],343,5,3157,4.19813829787234,40.0,0.0
10752,1,752,[211 302 187 483 318],788,5,3162,4.199203187250996,40.0,0.0
10753,1,753,[211 302 187 483 318],474,5,3167,4.20026525198939,40.0,0.0
10754,1,754,[186 202 175 204 286],232,4,3171,4.2,0.0,0.0
10755,1,755,[211 302 187 483 318],90,5,3176,4.201058201058201,40.0,0.0
10756,1,756,[ 98 405 185 318 288],537,2,3178,4.198150594451783,20.0,20.0
10757,1,757,[211 302 187 483 318],207,5,3183,4.199208443271768,40.0,0.0
10758,1,758,[211 302 187 483 318],788,5,3188,4.200263504611331,40.0,0.0
10759,1,759,[211 302 187 483 318],328,5,3193,4.201315789473684,40.0,0.0
10760,1,760,[211 302 187 483 318],207,5,3198,4.202365308804205,40.0,0.0
10761,1,761,[211 302 187 483 318],328,5,3203,4.203412073490814,40.0,0.0
10762,1,762,[211 302 187 483 318],474,5,3208,4.204456094364351,40.0,0.0
10763,1,763,[211 302 187 483 318],788,5,3213,4.205497382198953,40.0,0.0
10764,1,764,[211 302 187 483 318],474,5,3218,4.2065359477124185,40.0,0.0
10765,1,765,[211 302 187 483 318],788,5,3223,4.20757180156658,40.0,0.0
10766,1,766,[161 238 403 234 568],524,5,3228,4.208604954367666,0.0,0.0
10767,1,767,[211 302 187 483 318],474,5,3233,4.209635416666667,40.0,0.0
10768,1,768,[211 302 187 483 318],524,5,3238,4.210663198959688,40.0,0.0
10769,1,769,[234 228  15  25 286],402,4,3242,4.21038961038961,0.0,0.0
10770,1,770,[127 196  64 403 496],346,3,3245,4.208819714656291,0.0,20.0
10771,1,771,[211 302 187 483 318],207,5,3250,4.209844559585492,40.0,0.0
10772,1,772,[211 302 187 483 318],13,4,3254,4.2095730918499354,40.0,0.0
10773,1,773,[211 302 187 483 238],524,5,3259,4.210594315245478,20.0,0.0
10774,1,774,[237 194 234 328 174],653,2,3261,4.207741935483871,0.0,20.0
10775,1,775,[211 302 187 483 238],537,5,3266,4.208762886597938,20.0,0.0
10776,1,776,[210 204 196 175 318],207,2,3268,4.205920205920206,20.0,0.0
10777,1,777,[202 100 748 742 322],749,3,3271,4.204370179948586,0.0,20.0
10778,1,778,[211 302 187 483 238],343,5,3276,4.205391527599486,20.0,0.0
10779,1,779,[273 153 228 196 175],234,0,3276,4.2,0.0,0.0
10780,1,780,[ 71 215 216 678 435],804,4,3280,4.199743918053777,0.0,0.0
10781,1,781,[211 302 187 483 238],666,5,3285,4.20076726342711,20.0,0.0
10782,1,782,[211 302 187 483 238],207,4,3289,4.2005108556832695,20.0,0.0
10783,1,783,[211 302 187 483 318],524,5,3294,4.201530612244898,40.0,0.0
10784,1,784,[211 302 187 483 318],90,5,3299,4.202547770700637,40.0,0.0
10785,1,785,[211 302 187 483 318],537,5,3304,4.203562340966921,40.0,0.0
10786,1,786,[286 215 132  50 174],650,3,3307,4.202033036848793,0.0,40.0
10787,1,787,[194 273 228 117 173],158,3,3310,4.200507614213198,0.0,0.0
10788,1,788,[211 302 187 483 318],207,5,3315,4.201520912547529,40.0,0.0
10789,1,789,[211 302 187 483 318],90,5,3320,4.2025316455696204,40.0,0.0
10790,1,790,[ 89 216 187 275 182],524,4,3324,4.202275600505689,0.0,0.0
10791,1,791,[211 302 187 483 318],207,5,3329,4.203282828282828,40.0,0.0
10792,1,792,[211 302 187 483 318],524,5,3334,4.204287515762926,40.0,0.0
10793,1,793,[211 302 187 483 318],90,5,3339,4.2052896725440805,40.0,0.0
10794,1,794,[211 302 187 483 318],537,5,3344,4.206289308176101,40.0,0.0
10795,1,795,[135 186 423 121 742],653,3,3347,4.204773869346734,0.0,0.0
10796,1,796,[211 302 187 483 318],90,5,3352,4.205771643663739,40.0,0.0
10797,1,797,[211 302 187 483 318],343,5,3357,4.206766917293233,40.0,0.0
10798,1,798,[211 302 187 483 318],13,4,3361,4.206508135168961,40.0,0.0
10799,1,799,[211 302 187 483 318],666,5,3366,4.2075,40.0,0.0
10800,1,800,[211 302 187 483 318],328,5,3371,4.2084893882646695,40.0,0.0
10801,1,801,[313 185 508 265 483],13,3,3374,4.206982543640898,20.0,0.0
10802,1,802,[186  95  12   9 125],406,3,3377,4.205479452054795,20.0,0.0
10803,1,803,[245 568 222  69  79],263,5,3382,4.206467661691542,0.0,0.0
10804,1,804,[ 96 127 215 183  98],643,3,3385,4.204968944099379,0.0,40.0
10805,1,805,[211 302 187 483 318],788,5,3390,4.205955334987593,40.0,0.0
10806,1,806,[286   4  89 121 161],648,2,3392,4.203221809169764,0.0,0.0
10807,1,807,[211 302 187 483 318],6,5,3397,4.204207920792079,40.0,0.0
10808,1,808,[211 302 187 483 318],524,5,3402,4.205191594561187,40.0,0.0
10809,1,809,[211 302 187 483 318],90,5,3407,4.206172839506173,40.0,0.0
10810,1,810,[211 302 187 483 318],524,5,3412,4.20715166461159,40.0,0.0
10811,1,811,[187 318 180 435 117],144,5,3417,4.208128078817734,20.0,0.0
10812,1,812,[211 302 187 483 318],474,5,3422,4.2091020910209105,40.0,0.0
10813,1,813,[211 302 187 483 318],6,5,3427,4.2100737100737105,40.0,0.0
10814,1,814,[211 302 187 483 318],666,5,3432,4.211042944785276,40.0,0.0
10815,1,815,[211 302 187 483 318],13,4,3436,4.21078431372549,40.0,0.0
10816,1,816,[211 302 187 483 318],328,5,3441,4.211750305997552,40.0,0.0
10817,1,817,[211 302 187 483 318],328,5,3446,4.212713936430318,40.0,0.0
10818,1,818,[211 302 187 483 318],13,4,3450,4.212454212454213,40.0,0.0
10819,1,819,[211 302 187 483 318],207,5,3455,4.213414634146342,40.0,0.0
10820,1,820,[216 275 357  69 222],537,2,3457,4.210718635809988,20.0,0.0
10821,1,821,[211 302 187 483 318],328,5,3462,4.211678832116788,40.0,0.0
10822,1,822,[ 56   4 182 276 515],406,3,3465,4.210206561360875,0.0,0.0
10823,1,823,[181 603 237   1 135],326,2,3467,4.20752427184466,20.0,0.0
10824,1,824,[211 302 187 483 318],537,5,3472,4.208484848484848,40.0,0.0
10825,1,825,[655 245 313 286 282],378,4,3476,4.208232445520581,0.0,0.0
10826,1,826,[211 302 187 483 318],90,5,3481,4.20918984280532,40.0,0.0
10827,1,827,[742 127 288 423  12],59,4,3485,4.208937198067633,20.0,20.0
10828,1,828,[237 135  70 216 182],7,4,3489,4.208685162846804,0.0,0.0
10829,1,829,[211 302 187 483 127],524,5,3494,4.209638554216867,20.0,20.0
10830,1,830,[ 64  12 294 568 187],788,3,3497,4.208182912154031,20.0,0.0
10831,1,831,[211 302 187 483 127],833,3,3500,4.206730769230769,20.0,20.0
10832,1,832,[211 302 187 483 127],666,5,3505,4.207683073229291,20.0,20.0
10833,1,833,[211 302 187 483 127],328,5,3510,4.2086330935251794,20.0,20.0
10834,1,834,[211 302 187 483 127],207,5,3515,4.209580838323354,20.0,20.0
10835,1,835,[211 302 187 483 127],6,5,3520,4.2105263157894735,20.0,20.0
10836,1,836,[211 302 187 483 127],6,5,3525,4.211469534050179,20.0,20.0
10837,1,837,[211 302 187 483 127],207,5,3530,4.212410501193317,20.0,20.0
10838,1,838,[211 302 187 483 127],328,5,3535,4.213349225268177,20.0,20.0
10839,1,839,[211 302 187 483 127],90,5,3540,4.214285714285714,20.0,20.0
10840,1,840,[211 302 187 483 127],343,5,3545,4.215219976218787,20.0,20.0
10841,1,841,[211 302 187 483 127],537,5,3550,4.216152019002375,20.0,20.0
10842,1,842,[211 302 187 483 127],537,5,3555,4.217081850533808,20.0,20.0
10843,1,843,[174 153   8  64 194],85,4,3559,4.216824644549763,0.0,20.0
10844,1,844,[211 302 187 483 127],6,5,3564,4.217751479289941,20.0,20.0
10845,1,845,[211 302 187 483 127],474,5,3569,4.218676122931442,20.0,20.0
10846,1,846,[135 173 385 175 483],650,5,3574,4.219598583234947,20.0,0.0
10847,1,847,[211 302 187 483 127],343,5,3579,4.220518867924528,20.0,20.0
10848,1,848,[ 28 471  69 588 403],311,5,3584,4.221436984687868,0.0,0.0
10849,1,849,[423 204  25  70 603],804,4,3588,4.221176470588235,20.0,0.0
10850,1,850,[211 302 187 127 483],343,5,3593,4.222091656874266,20.0,20.0
10851,1,851,[211 302 187 127 483],339,5,3598,4.223004694835681,20.0,20.0
10852,1,852,[211 302 187 127 483],339,5,3603,4.223915592028136,20.0,20.0
10853,1,853,[183 228 423 597 172],455,4,3607,4.2236533957845435,0.0,0.0
10854,1,854,[211 302 187 127 483],537,5,3612,4.224561403508772,20.0,20.0
10855,1,855,[211 302 187 127 483],13,5,3617,4.225467289719626,20.0,20.0
10856,1,856,[211 302 187 127 483],13,5,3622,4.226371061843641,20.0,20.0
10857,1,857,[211 302 187 127 483],210,5,3627,4.2272727272727275,20.0,20.0
10858,1,858,[191 238   7 475 405],474,5,3632,4.228172293364377,0.0,0.0
10859,1,859,[211 302 187 127 483],833,3,3635,4.226744186046512,20.0,20.0
10860,1,860,[187 211 302 127 483],339,5,3640,4.227642276422764,20.0,20.0
10861,1,861,[187 211 302 127 483],343,5,3645,4.228538283062645,20.0,20.0
10862,1,862,[187 211 302 127 483],537,5,3650,4.2294322132097335,20.0,20.0
10863,1,863,[748 423 403 546  64],899,3,3653,4.2280092592592595,0.0,0.0
10864,1,864,[187 211 302 127 483],666,5,3658,4.2289017341040465,20.0,20.0
10865,1,865,[187 211 302 127 483],207,5,3663,4.2297921478060045,20.0,20.0
10866,1,866,[603  28 496 483 132],815,4,3667,4.229527104959631,40.0,0.0
10867,1,867,[187 211 302 127 483],666,5,3672,4.2304147465437785,20.0,20.0
10868,1,868,[ 79 172 328   8 183],378,4,3676,4.230149597238205,0.0,0.0
10869,1,869,[187 211 302 127 483],328,5,3681,4.231034482758621,20.0,20.0
10870,1,870,[187 211 302 127 483],339,5,3686,4.2319173363949485,20.0,20.0
10871,1,871,[187 211 302 127 483],6,5,3691,4.2327981651376145,20.0,20.0
10872,1,872,[187 211 302 127 483],90,5,3696,4.233676975945017,20.0,20.0
10873,1,873,[187 211 302 127 483],13,5,3701,4.2345537757437075,20.0,20.0
10874,1,874,[357  79   9  12  56],308,5,3706,4.235428571428572,40.0,0.0
10875,1,875,[187 211 302 127 483],6,5,3711,4.236301369863014,20.0,20.0
10876,1,876,[187 211 302 127 483],666,5,3716,4.237172177879134,20.0,20.0
10877,1,877,[125 144 234  89 168],406,2,3718,4.234624145785877,0.0,0.0
10878,1,878,[323 471 180 151 289],90,2,3720,4.2320819112627985,0.0,0.0
10879,1,879,[187 211 302 127 483],90,5,3725,4.232954545454546,20.0,20.0
10880,1,880,[187 211 302 127 483],524,5,3730,4.233825198637912,20.0,20.0
10881,1,881,[  1  98 181 238 117],653,3,3733,4.232426303854876,0.0,20.0
10882,1,882,[187 211 302 127 483],524,5,3738,4.2332955832389585,20.0,20.0
10883,1,883,[187 211 302 127 483],524,5,3743,4.234162895927602,20.0,20.0
10884,1,884,[187 211 302 127 483],339,5,3748,4.235028248587571,20.0,20.0
10885,1,885,[187 211 302 127 483],210,5,3753,4.235891647855531,20.0,20.0
10886,1,886,[176 175 603 294 238],650,4,3757,4.235625704622322,20.0,0.0
10887,1,887,[187 211 302 127 483],328,5,3762,4.236486486486487,20.0,20.0
10888,1,888,[187 211 302 127 483],6,5,3767,4.237345331833521,20.0,20.0
10889,1,889,[ 79  88 313 194  70],234,2,3769,4.234831460674157,0.0,0.0
10890,1,890,[187 211 302 127 483],537,5,3774,4.235690235690235,20.0,20.0
10891,1,891,[187 211 302 127 483],339,5,3779,4.236547085201794,20.0,20.0
10892,1,892,[ 89 301 183 151  50],234,2,3781,4.23404255319149,0.0,20.0
10893,1,893,[187 211 302 127 483],13,5,3786,4.23489932885906,20.0,20.0
10894,1,894,[427 322 197 161 313],234,3,3789,4.233519553072625,0.0,0.0
10895,1,895,[ 15 265 144 238 168],488,3,3792,4.232142857142857,0.0,0.0
10896,1,896,[151  70  89 294 546],279,2,3794,4.229654403567447,0.0,0.0
10897,1,897,[187 211 302 127 483],343,5,3799,4.2305122494432075,20.0,20.0
10898,1,898,[187 211 302 127 483],524,5,3804,4.231368186874305,20.0,20.0
10899,1,899,[187 211 302 127 483],6,5,3809,4.232222222222222,20.0,20.0
10900,1,900,[313 174 322 265 496],883,2,3811,4.229744728079911,0.0,20.0
10901,1,901,[187 211 302 127 483],207,5,3816,4.23059866962306,20.0,20.0
10902,1,902,[187 211 302 127 483],6,5,3821,4.231450719822813,20.0,20.0
10903,1,903,[187 211 302 127 483],328,5,3826,4.232300884955753,20.0,20.0
10904,1,904,[216 175  22 182 125],378,4,3830,4.232044198895028,0.0,0.0
10905,1,905,[187 211 302 127 483],13,5,3835,4.232891832229581,20.0,20.0
10906,1,906,[202   9 111 117 181],234,0,3835,4.228224917309813,0.0,0.0
10907,1,907,[187 211 302 127 483],339,5,3840,4.229074889867841,20.0,20.0
10908,1,908,[187 211 302 127 483],537,5,3845,4.22992299229923,20.0,20.0
10909,1,909,[187 211 302 127 483],343,5,3850,4.230769230769231,20.0,20.0
10910,1,910,[187 211 302 127 483],666,5,3855,4.2316136114160265,20.0,20.0
10911,1,911,[187 211 302 127 483],90,5,3860,4.232456140350878,20.0,20.0
10912,1,912,[245 197 238 403 216],334,3,3863,4.231106243154436,0.0,0.0
10913,1,913,[187 211 302 127 483],833,3,3866,4.229759299781182,20.0,20.0
10914,1,914,[187 211 302 127 483],328,5,3871,4.230601092896175,20.0,20.0
10915,1,915,[187 211 302 127 483],6,5,3876,4.2314410480349345,20.0,20.0
10916,1,916,[187 211 302 127 483],343,5,3881,4.232279171210469,20.0,20.0
10917,1,917,[187 211 302 127 483],339,5,3886,4.233115468409586,20.0,20.0
10918,1,918,[228 211 197 210  98],311,4,3890,4.232861806311208,0.0,20.0
10919,1,919,[187 302 127 211 483],90,5,3895,4.233695652173913,20.0,20.0
10920,1,920,[ 98 265 204 423 546],374,4,3899,4.233441910966341,0.0,20.0
10921,1,921,[187 302 127 211 483],6,5,3904,4.234273318872018,20.0,20.0
10922,1,922,[187 127 302 211 483],328,5,3909,4.23510292524377,20.0,20.0
10923,1,923,[187 127 302 211 483],537,5,3914,4.235930735930736,20.0,20.0
10924,1,924,[187 127 302 211 483],90,5,3919,4.236756756756757,20.0,20.0
10925,1,925,[187 127 302 211 483],833,3,3922,4.235421166306695,20.0,20.0
10926,1,926,[187 127 302 211 483],833,3,3925,4.234088457389428,20.0,20.0
10927,1,927,[ 12 748   9 179 168],474,3,3928,4.232758620689655,20.0,0.0
10928,1,928,[187 127 302 211 483],6,5,3933,4.233584499461787,20.0,20.0
10929,1,929,[187 127 302 211 483],524,5,3938,4.234408602150538,20.0,20.0
10930,1,930,[187 127 302 211 483],474,5,3943,4.235230934479055,20.0,20.0
10931,1,931,[187 127 302 211 483],524,5,3948,4.236051502145923,20.0,20.0
10932,1,932,[187 127 302 211 483],537,5,3953,4.236870310825295,20.0,20.0
10933,1,933,[222 603 179 135 234],650,4,3957,4.236616702355461,20.0,0.0
10934,1,934,[187 127 302 211 483],666,5,3962,4.237433155080214,20.0,20.0
10935,1,935,[187 127 302 211 483],6,5,3967,4.238247863247863,20.0,20.0
10936,1,936,[187 127 302 211 483],328,5,3972,4.23906083244397,20.0,20.0
10937,1,937,[187 127 302 211 483],6,5,3977,4.2398720682302775,20.0,20.0
10938,1,938,[187 127 302 211 483],13,5,3982,4.240681576144835,20.0,20.0
10939,1,939,[568 191 176 222 258],882,4,3986,4.240425531914894,0.0,0.0
10940,1,940,[187 127 302 211 483],524,5,3991,4.241232731137088,20.0,20.0
10941,1,941,[187 127 302 211 483],6,5,3996,4.24203821656051,20.0,20.0
10942,1,942,[187 127 302 211 483],210,5,4001,4.242841993637327,20.0,20.0
10943,1,943,[187 127 302 211 483],328,5,4006,4.24364406779661,20.0,20.0
10944,1,944,[187 127 302 211 483],339,5,4011,4.2444444444444445,20.0,20.0
10945,1,945,[187 127 302 211 483],90,5,4016,4.245243128964059,20.0,20.0
10946,1,946,[187 127 302 211 483],343,5,4021,4.246040126715945,20.0,20.0
10947,1,947,[187 127 302 211 483],833,3,4024,4.244725738396625,20.0,20.0
10948,1,948,[187 127 302 211 483],343,5,4029,4.245521601685986,20.0,20.0
10949,1,949,[187 127 302 211 483],328,5,4034,4.246315789473684,20.0,20.0
10950,1,950,[187 127 302 211 483],343,5,4039,4.247108307045216,20.0,20.0
10951,1,951,[187 127 302 211 483],537,5,4044,4.2478991596638656,20.0,20.0
10952,1,952,[187 127 302 211 483],207,5,4049,4.248688352570829,20.0,20.0
10953,1,953,[187 127 302 211 483],90,5,4054,4.249475890985325,20.0,20.0
10954,1,954,[187 127 302 211 483],666,5,4059,4.2502617801047125,20.0,20.0
10955,1,955,[187 127 302 211 483],13,5,4064,4.2510460251046025,20.0,20.0
10956,1,956,[ 82  69 357 222 323],263,4,4068,4.2507836990595615,20.0,0.0
10957,1,957,[187 127 302 211 483],537,5,4073,4.251565762004176,20.0,20.0
10958,1,958,[187 127 302 211 483],339,5,4078,4.252346193952033,20.0,20.0
10959,1,959,[127 187 302 211 483],537,5,4083,4.253125,20.0,20.0
10960,1,960,[127 187 302 211 483],339,5,4088,4.253902185223725,20.0,20.0
10961,1,961,[546  25 143  95  71],897,3,4091,4.252598752598753,0.0,0.0
10962,1,962,[127 187 302 211 483],207,5,4096,4.2533748701973,20.0,20.0
10963,1,963,[127 187 302 211 483],328,5,4101,4.254149377593361,20.0,20.0
10964,1,964,[127 187 302 211 483],833,3,4104,4.252849740932643,20.0,20.0
10965,1,965,[181  88 269  25 202],934,4,4108,4.252587991718427,0.0,0.0
10966,1,966,[127 187 302 211 483],13,5,4113,4.253360910031024,20.0,20.0
10967,1,967,[127 187 302 211 483],210,5,4118,4.2541322314049586,20.0,20.0
10968,1,968,[127 187 302 211 483],328,5,4123,4.254901960784314,20.0,20.0
10969,1,969,[127 187 302 211 483],666,5,4128,4.2556701030927835,20.0,20.0
10970,1,970,[127 187 302 211 483],524,5,4133,4.25643666323378,20.0,20.0
10971,1,971,[216   8  56 100 186],315,4,4137,4.256172839506172,0.0,20.0
10972,1,972,[127 187 302 211 483],524,5,4142,4.25693730729702,20.0,20.0
10973,1,973,[127 187 302 211 483],537,5,4147,4.257700205338809,20.0,20.0
10974,1,974,[127 187 302 211 483],343,5,4152,4.258461538461538,20.0,20.0
10975,1,975,[127 187 302 211 483],13,5,4157,4.25922131147541,20.0,20.0
10976,1,976,[127 187 302 211 483],343,5,4162,4.2599795291709315,20.0,20.0
10977,1,977,[273 132  79 318 333],328,3,4165,4.2586912065439675,20.0,0.0
10978,1,978,[127 187 302 211 483],666,5,4170,4.259448416751788,20.0,20.0
10979,1,979,[127 187 302 211 483],90,5,4175,4.260204081632653,20.0,20.0
10980,1,980,[127 187 302 211 483],666,5,4180,4.260958205912335,20.0,20.0
10981,1,981,[282  95  15 151 288],374,3,4183,4.259674134419552,0.0,0.0
10982,1,982,[127 187 302 211 483],666,5,4188,4.260427263479145,20.0,20.0
10983,1,983,[127 187 302 211 483],13,5,4193,4.2611788617886175,20.0,20.0
10984,1,984,[127 187 302 211 483],524,5,4198,4.261928934010152,20.0,20.0
10985,1,985,[ 70 597 228 125 183],804,4,4202,4.261663286004056,0.0,0.0
10986,1,986,[127 187 302 211 483],207,5,4207,4.26241134751773,20.0,20.0
10987,1,987,[127 187 302 211 483],537,5,4212,4.2631578947368425,20.0,20.0
10988,1,988,[568 742 168  50 161],374,3,4215,4.261880687563195,0.0,20.0
10989,1,989,[127 187 302 211 483],90,5,4220,4.262626262626263,20.0,20.0
10990,1,990,[127 187 302 211 483],6,5,4225,4.263370332996972,20.0,20.0
10991,1,991,[127 187 302 211 483],13,5,4230,4.264112903225806,20.0,20.0
10992,1,992,[127 187 302 211 483],339,5,4235,4.264853977844915,20.0,20.0
10993,1,993,[211 127  69 175  95],85,5,4240,4.26559356136821,0.0,20.0
10994,1,994,[ 96 748  69 211  82],533,4,4244,4.265326633165829,0.0,0.0
10995,1,995,[127 187 302 211 483],328,5,4249,4.266064257028113,20.0,20.0
10996,1,996,[168 357  50 234   1],643,5,4254,4.266800401203611,20.0,20.0
10997,1,997,[127 187 302 211 483],207,5,4259,4.267535070140281,20.0,20.0
10998,1,998,[127 187 302 211 483],666,5,4264,4.268268268268268,20.0,20.0
10999,1,999,[127 187 302 211 483],537,5,4269,4.269,20.0,20.0
11000,1,1000,[127 187 302 211 483],207,5,4274,4.26973026973027,20.0,20.0
11001,1,1001,[127 187 302 211 483],207,5,4279,4.270459081836328,20.0,20.0
11002,1,1002,[127 187 302 211 483],474,5,4284,4.271186440677966,20.0,20.0
11003,1,1003,[127 187 302 211 483],328,5,4289,4.27191235059761,20.0,20.0
11004,1,1004,[127 187 302 211 483],339,5,4294,4.272636815920398,20.0,20.0
11005,1,1005,[127 187 302 211 483],90,5,4299,4.273359840954274,20.0,20.0
11006,1,1006,[127 187 302 211 483],524,5,4304,4.274081429990069,20.0,20.0
11007,1,1007,[127 187 302 211 483],339,5,4309,4.274801587301587,20.0,20.0
11008,1,1008,[322 100 195 121 132],533,5,4314,4.275520317145689,0.0,20.0
11009,1,1009,[186  97 265 286 289],13,3,4317,4.274257425742574,0.0,0.0
11010,1,1010,[127 187 302 211 483],474,5,4322,4.274975272007913,20.0,20.0
11011,1,1011,[127 187 302 211 483],833,3,4325,4.273715415019763,20.0,20.0
11012,1,1012,[127 187 302 211 483],343,5,4330,4.2744323790720635,20.0,20.0
11013,1,1013,[127 187 302 211 483],90,5,4335,4.275147928994083,20.0,20.0
11014,1,1014,[ 70 185  22  64 183],59,4,4339,4.27487684729064,0.0,0.0
11015,1,1015,[127 187 302 211 483],524,5,4344,4.275590551181103,20.0,20.0
11016,1,1016,[127 187 302 211 483],328,5,4349,4.276302851524091,20.0,20.0
11017,1,1017,[127 187 302 211 483],833,3,4352,4.275049115913556,20.0,20.0
11018,1,1018,[127 187 302 211 483],474,5,4357,4.275760549558391,20.0,20.0
11019,1,1019,[127 187 302 211 483],666,5,4362,4.276470588235294,20.0,20.0
11020,1,1020,[127 187 302 211 483],524,5,4367,4.277179236043095,20.0,20.0
11021,1,1021,[202 151 187  70  95],537,2,4369,4.2749510763209395,0.0,0.0
11022,1,1022,[127 187 302 211 483],666,5,4374,4.275659824046921,20.0,20.0
11023,1,1023,[127 187 302 211 483],474,5,4379,4.2763671875,20.0,20.0
11024,1,1024,[127 187 302 211 483],343,5,4384,4.277073170731708,20.0,20.0
11025,1,1025,[127 187 302 211 483],474,5,4389,4.277777777777778,20.0,20.0
11026,1,1026,[127 187 302 211 483],207,5,4394,4.2784810126582276,20.0,20.0
11027,1,1027,[127 187 302 211 483],207,5,4399,4.279182879377432,20.0,20.0
11028,1,1028,[127 187 302 211 483],537,5,4404,4.279883381924198,20.0,20.0
11029,1,1029,[127 187 302 211 483],343,5,4409,4.2805825242718445,20.0,20.0
11030,1,1030,[127 187 302 211 483],524,5,4414,4.281280310378274,20.0,20.0
11031,1,1031,[127 187 302 211 483],328,5,4419,4.281976744186046,20.0,20.0
11032,1,1032,[127 187 302 211 483],474,5,4424,4.282671829622459,20.0,20.0
11033,1,1033,[127 187 302 211 483],343,5,4429,4.283365570599613,20.0,20.0
11034,1,1034,[127 187 302 211 483],328,5,4434,4.284057971014493,20.0,20.0
11035,1,1035,[127 187 302 211 483],6,5,4439,4.2847490347490345,20.0,20.0
11036,1,1036,[127 187 302 211 483],207,5,4444,4.285438765670203,20.0,20.0
11037,1,1037,[127 187 302 211 483],210,5,4449,4.286127167630058,20.0,20.0
11038,1,1038,[568  69  28 603  88],738,3,4452,4.2848893166506254,20.0,0.0
11039,1,1039,[194 235 174 172 176],158,4,4456,4.2846153846153845,0.0,20.0
11040,1,1040,[597 181 483 475 276],207,1,4457,4.281460134486071,20.0,0.0
11041,1,1041,[127 187 302 211 483],13,5,4462,4.282149712092131,20.0,20.0
11042,1,1042,[127 187 302 211 483],207,5,4467,4.282837967401726,20.0,20.0
11043,1,1043,[127 187 302 211 483],90,5,4472,4.283524904214559,20.0,20.0
11044,1,1044,[127 187 302 211 483],328,5,4477,4.28421052631579,20.0,20.0
11045,1,1045,[127 187 302 211 483],90,5,4482,4.2848948374761,20.0,20.0
11046,1,1046,[127 187 302 211 483],210,5,4487,4.285577841451767,20.0,20.0
11047,1,1047,[127 187 302 211 483],524,5,4492,4.286259541984733,20.0,20.0
11048,1,1048,[127 187 302 211 483],537,5,4497,4.286939942802669,20.0,20.0
11049,1,1049,[127 187 302 211 483],343,5,4502,4.287619047619048,20.0,20.0
11050,1,1050,[143 187 132  96  95],804,3,4505,4.28639391056137,0.0,0.0
11051,1,1051,[127 187 302 211 483],666,5,4510,4.287072243346008,20.0,20.0
11052,1,1052,[127 187 302 211 483],524,5,4515,4.287749287749287,20.0,20.0
11053,1,1053,[127 187 302 211 483],6,5,4520,4.28842504743833,20.0,20.0
11054,1,1054,[127 187 302 211 483],6,5,4525,4.289099526066351,20.0,20.0
11055,1,1055,[273 228 174 423 179],774,2,4527,4.286931818181818,0.0,20.0
11056,1,1056,[127 187 302 211 483],13,5,4532,4.287606433301797,20.0,20.0
11057,1,1057,[127 187 302 211 483],13,5,4537,4.2882797731569,20.0,20.0
11058,1,1058,[127 187 302 211 483],210,5,4542,4.288951841359774,20.0,20.0
11059,1,1059,[127 187 302 211 483],343,5,4547,4.289622641509434,20.0,20.0
11060,1,1060,[127 187 302 211 483],6,5,4552,4.290292177191329,20.0,20.0
11061,1,1061,[127 187 302 211 483],13,5,4557,4.290960451977401,20.0,20.0
11062,1,1062,[ 56 471 603 182 118],271,1,4558,4.287864534336783,20.0,0.0
11063,1,1063,[127 187 302 211 483],6,5,4563,4.288533834586466,20.0,20.0
11064,1,1064,[127 187 302 211 483],207,5,4568,4.289201877934272,20.0,20.0
11065,1,1065,[  8 202 288 300 100],479,2,4570,4.287054409005629,0.0,20.0
11066,1,1066,[127 187 302 211 483],13,5,4575,4.287722586691659,20.0,20.0
11067,1,1067,[ 50 216 228  22 187],892,4,4579,4.287453183520599,0.0,20.0
11068,1,1068,[127 187 302 211 483],328,5,4584,4.288119738072965,20.0,20.0
11069,1,1069,[127 187 302 211 483],537,5,4589,4.288785046728972,20.0,20.0
11070,1,1070,[ 69 180 276 318 216],406,4,4593,4.288515406162465,20.0,0.0
11071,1,1071,[127 187 302 211 483],339,5,4598,4.289179104477612,20.0,20.0
11072,1,1072,[ 96 276 194 237  69],144,4,4602,4.288909599254427,0.0,0.0
11073,1,1073,[127 187 302 211 483],474,5,4607,4.289571694599627,20.0,20.0
11074,1,1074,[127 187 302 211 483],666,5,4612,4.290232558139535,20.0,20.0
11075,1,1075,[127 187 302 211 483],13,5,4617,4.29089219330855,20.0,20.0
11076,1,1076,[186 200   1 215 357],343,4,4621,4.290622098421541,20.0,0.0
11077,1,1077,[127 187 302 211 483],90,5,4626,4.291280148423006,20.0,20.0
11078,1,1078,[127 187 302 211 483],210,5,4631,4.2919369786839665,20.0,20.0
11079,1,1079,[127 187 302 211 483],90,5,4636,4.292592592592593,20.0,20.0
11080,1,1080,[127 187 302 211 483],328,5,4641,4.293246993524514,20.0,20.0
11081,1,1081,[143 196 323 742  50],290,3,4644,4.292051756007393,0.0,20.0
11082,1,1082,[127 187 302 211 483],90,5,4649,4.292705447830102,20.0,20.0
11083,1,1083,[127 187 302 211 483],90,5,4654,4.293357933579336,20.0,20.0
11084,1,1084,[127 187 302 211 483],207,5,4659,4.294009216589862,20.0,20.0
11085,1,1085,[235 179 168 496  12],343,5,4664,4.294659300184162,20.0,0.0
11086,1,1086,[202 302 515  98  95],6,3,4667,4.293468261269549,0.0,20.0
11087,1,1087,[127 187 302 211 483],537,5,4672,4.294117647058823,20.0,20.0
11088,1,1088,[127 187 302 211 483],343,5,4677,4.294765840220386,20.0,20.0
11089,1,1089,[127 187 302 211 483],339,5,4682,4.295412844036697,20.0,20.0
11090,1,1090,[127 187 302 211 483],339,5,4687,4.2960586617781855,20.0,20.0
11091,1,1091,[127 187 302 211 483],833,3,4690,4.294871794871795,20.0,20.0
11092,1,1092,[181  96 742  50 568],524,3,4693,4.293687099725526,0.0,20.0
11093,1,1093,[127 187 302 211 483],833,3,4696,4.292504570383913,20.0,20.0
11094,1,1094,[127 187 302 211 483],537,5,4701,4.293150684931507,20.0,20.0
11095,1,1095,[191 186 117 179 180],308,4,4705,4.2928832116788325,0.0,0.0
11096,1,1096,[127 187 302 211 483],343,5,4710,4.293527803099362,20.0,20.0
11097,1,1097,[127 187 302 211 483],666,5,4715,4.294171220400728,20.0,20.0
11098,1,1098,[127 187 302 211 483],6,5,4720,4.294813466787989,20.0,20.0
11099,1,1099,[127 187 302 211 483],474,5,4725,4.295454545454546,20.0,20.0
11100,1,1100,[127 187 302 211 483],524,5,4730,4.296094459582198,20.0,20.0
11101,1,1101,[216 515 435 172 195],666,2,4732,4.294010889292196,0.0,0.0
11102,1,1102,[127 187 302 211 483],328,5,4737,4.2946509519492295,20.0,20.0
11103,1,1103,[127 187 302 211 483],524,5,4742,4.295289855072464,20.0,20.0
11104,1,1104,[ 79  11  28 204 323],328,2,4744,4.293212669683258,0.0,0.0
11105,1,1105,[127 187 302 211 483],207,5,4749,4.293851717902351,20.0,20.0
11106,1,1106,[127 187 302 211 483],13,5,4754,4.294489611562782,20.0,20.0
11107,1,1107,[127 187 302 211 483],339,5,4759,4.2951263537906135,20.0,20.0
11108,1,1108,[127 187 302 211 483],666,5,4764,4.2957619477006315,20.0,20.0
11109,1,1109,[127 187 302 211 483],13,5,4769,4.296396396396396,20.0,20.0
11110,1,1110,[127 187 302 211 483],207,5,4774,4.297029702970297,20.0,20.0
11111,1,1111,[333 385 269 313 172],64,4,4778,4.296762589928058,0.0,0.0
11112,1,1112,[127 187 302 211 483],13,5,4783,4.297394429469901,20.0,20.0
11113,1,1113,[127 187 302 211 483],6,5,4788,4.29802513464991,20.0,20.0
11114,1,1114,[127 187 302 211 483],474,5,4793,4.298654708520179,20.0,20.0
11115,1,1115,[127 187 302 211 483],210,5,4798,4.299283154121864,20.0,20.0
11116,1,1116,[127 187 302 211 483],207,5,4803,4.299910474485229,20.0,20.0
11117,1,1117,[127 187 302 211 483],13,5,4808,4.300536672629696,20.0,20.0
11118,1,1118,[175   7 313 301 655],13,3,4811,4.299374441465594,0.0,0.0
11119,1,1119,[265  79 546  22 153],378,4,4815,4.299107142857143,0.0,0.0
11120,1,1120,[127 187 302 211 483],666,5,4820,4.299732381801962,20.0,20.0
11121,1,1121,[127 187 302 211 483],13,5,4825,4.30035650623886,20.0,20.0
11122,1,1122,[127 187 302 211 483],537,5,4830,4.300979519145147,20.0,20.0
11123,1,1123,[153 265 195 180 210],92,5,4835,4.301601423487544,0.0,0.0
11124,1,1124,[127 187 302 211 483],537,5,4840,4.302222222222222,20.0,20.0
11125,1,1125,[ 71 588 228 496 151],290,4,4844,4.301953818827709,0.0,0.0
11126,1,1126,[127 187 302 211 483],210,5,4849,4.302573203194322,20.0,20.0
11127,1,1127,[127 187 302 211 483],13,5,4854,4.303191489361702,20.0,20.0
11128,1,1128,[127 187 302 211 483],13,5,4859,4.303808680248007,20.0,20.0
11129,1,1129,[127 187 302 211 483],6,5,4864,4.304424778761062,20.0,20.0
11130,1,1130,[127 187 302 211 483],207,5,4869,4.305039787798409,20.0,20.0
11131,1,1131,[427 204 153 127 655],85,2,4871,4.303003533568905,0.0,20.0
11132,1,1132,[127 187 302 211 483],474,5,4876,4.303618711385702,20.0,20.0
11133,1,1133,[127 187 302 211 483],13,5,4881,4.304232804232805,20.0,20.0
11134,1,1134,[435 546 100 655 235],339,4,4885,4.3039647577092515,0.0,20.0
11135,1,1135,[127 187 302 211 483],537,5,4890,4.304577464788732,20.0,20.0
11136,1,1136,[127 187 302 211 483],207,5,4895,4.3051890941073,20.0,20.0
11137,1,1137,[125 403 191 385 180],234,1,4896,4.302284710017575,0.0,0.0
11138,1,1138,[127 187 302 211 483],339,5,4901,4.302897278314311,20.0,20.0
11139,1,1139,[127 187 302 211 483],207,5,4906,4.303508771929825,20.0,20.0
11140,1,1140,[132  22 228   8 423],554,5,4911,4.304119193689746,0.0,0.0
11141,1,1141,[238 172 265 151 258],843,1,4912,4.30122591943958,0.0,0.0
11142,1,1142,[127 187 302 211 483],328,5,4917,4.301837270341207,20.0,20.0
11143,1,1143,[127 187 302 211 483],537,5,4922,4.3024475524475525,20.0,20.0
11144,1,1144,[127 187 302 211 483],207,5,4927,4.303056768558952,20.0,20.0
11145,1,1145,[127 187 302 211 483],328,5,4932,4.303664921465969,20.0,20.0
11146,1,1146,[ 56  69 125 483  50],200,5,4937,4.304272013949434,20.0,20.0
11147,1,1147,[127 187 302 211 483],524,5,4942,4.304878048780488,20.0,20.0
11148,1,1148,[210  89 211 175 403],843,2,4944,4.302872062663186,0.0,0.0
11149,1,1149,[ 25 187 258 234 603],90,4,4948,4.302608695652174,20.0,0.0
11150,1,1150,[127 187 302 211 483],90,5,4953,4.303214596003476,20.0,20.0
11151,1,1151,[385 471 100 294 265],374,4,4957,4.302951388888889,0.0,20.0
11152,1,1152,[127 187 302 211 483],339,5,4962,4.303555941023417,20.0,20.0
11153,1,1153,[127 187 302 211 483],13,5,4967,4.304159445407279,20.0,20.0
11154,1,1154,[127 187 302 211 483],474,5,4972,4.304761904761905,20.0,20.0
11155,1,1155,[127 187 302 211 483],474,5,4977,4.305363321799308,20.0,20.0
11156,1,1156,[127 187 302 211 483],207,5,4982,4.305963699222127,20.0,20.0
11157,1,1157,[405 588  15 185 144],479,3,4985,4.304835924006908,0.0,0.0
11158,1,1158,[127 187 302 211 483],474,5,4990,4.305435720448663,20.0,20.0
11159,1,1159,[127 187 302 211 483],343,5,4995,4.306034482758621,20.0,20.0
11160,1,1160,[127 187 302 211 483],339,5,5000,4.306632213608958,20.0,20.0
11161,1,1161,[127 187 302 211 483],6,5,5005,4.307228915662651,20.0,20.0
11162,1,1162,[153  88  22 173 258],538,2,5007,4.30524505588994,0.0,0.0
11163,1,1163,[385   7  15 238 357],653,2,5009,4.303264604810996,20.0,0.0
11164,1,1164,[282 180 588 204 100],406,4,5013,4.303004291845493,0.0,20.0
11165,1,1165,[127 187 302 211 483],13,5,5018,4.303602058319039,20.0,20.0
11166,1,1166,[127 187 302 211 483],207,5,5023,4.30419880034276,20.0,20.0
11167,1,1167,[127 187 302 211 483],343,5,5028,4.304794520547945,20.0,20.0
11168,1,1168,[235 211 172  79  11],59,4,5032,4.30453378956373,0.0,0.0
11169,1,1169,[127 187 302 211 483],6,5,5037,4.305128205128205,20.0,20.0
11170,1,1170,[127 187 302 211 483],328,5,5042,4.305721605465414,20.0,20.0
11171,1,1171,[127 187 302 211 483],339,5,5047,4.3063139931740615,20.0,20.0
11172,1,1172,[127 187 302 211 483],328,5,5052,4.30690537084399,20.0,20.0
11173,1,1173,[127 187 302 211 483],210,5,5057,4.3074957410562185,20.0,20.0
11174,1,1174,[127 187 302 211 483],90,5,5062,4.308085106382979,20.0,20.0
11175,1,1175,[127 187 302 211 483],537,5,5067,4.308673469387755,20.0,20.0
11176,1,1176,[127 187 302 211 483],524,5,5072,4.309260832625319,20.0,20.0
11177,1,1177,[127 187 302 211 483],13,5,5077,4.309847198641766,20.0,20.0
11178,1,1178,[187 742  64   1 655],788,2,5079,4.307888040712468,0.0,0.0
11179,1,1179,[127 187 302 211 483],6,5,5084,4.308474576271187,20.0,20.0
11180,1,1180,[127 187 302 211 483],328,5,5089,4.3090601185436075,20.0,20.0
11181,1,1181,[127 187 302 211 483],343,5,5094,4.309644670050761,20.0,20.0
11182,1,1182,[127 187 302 211 483],339,5,5099,4.310228233305156,20.0,20.0
11183,1,1183,[127 187 302 211 483],90,5,5104,4.3108108108108105,20.0,20.0
11184,1,1184,[127 187 302 211 483],833,3,5107,4.309704641350211,20.0,20.0
11185,1,1185,[127 187 302 211 483],343,5,5112,4.3102866779089375,20.0,20.0
11186,1,1186,[127 187 302 211 483],524,5,5117,4.310867733782645,20.0,20.0
11187,1,1187,[127 187 302 211 483],13,5,5122,4.311447811447811,20.0,20.0
11188,1,1188,[127 187 302 211 483],90,5,5127,4.312026913372582,20.0,20.0
11189,1,1189,[127 187 302 211 483],207,5,5132,4.3126050420168065,20.0,20.0
11190,1,1190,[127 187 302 211 483],537,5,5137,4.313182199832074,20.0,20.0
11191,1,1191,[127 187 302 211 483],210,5,5142,4.313758389261745,20.0,20.0
11192,1,1192,[127 187 302 211 483],666,5,5147,4.314333612740989,20.0,20.0
11193,1,1193,[127 187 302 211 483],90,5,5152,4.314907872696818,20.0,20.0
11194,1,1194,[127 187 302 211 483],13,5,5157,4.315481171548117,20.0,20.0
11195,1,1195,[127 187 302 211 483],90,5,5162,4.316053511705686,20.0,20.0
11196,1,1196,[127 187 302 211 483],339,5,5167,4.316624895572264,20.0,20.0
11197,1,1197,[135 286 237 176 196],144,5,5172,4.317195325542571,0.0,0.0
11198,1,1198,[127 187 302 211 483],207,5,5177,4.317764804003336,20.0,20.0
11199,1,1199,[127 187 302 211 483],343,5,5182,4.318333333333333,20.0,20.0
11200,1,1200,[127 187 302 211 483],90,5,5187,4.318900915903414,20.0,20.0
11201,1,1201,[127 187 302 211 483],474,5,5192,4.319467554076539,20.0,20.0
11202,1,1202,[161 271 678  70 288],334,0,5192,4.315876974231089,0.0,0.0
11203,1,1203,[127 187 302 211 483],13,5,5197,4.3164451827242525,20.0,20.0
11204,1,1204,[127 187 302 211 483],537,5,5202,4.31701244813278,20.0,20.0
11205,1,1205,[423 125 194 238 588],234,2,5204,4.315091210613598,0.0,0.0
11206,1,1206,[127 187 302 211 483],13,5,5209,4.315658657829329,20.0,20.0
11207,1,1207,[118 100 322 475 333],533,4,5213,4.315397350993377,0.0,20.0
11208,1,1208,[127 187 302 211 483],537,5,5218,4.315963606286187,20.0,20.0
11209,1,1209,[127 187 302 211 483],207,5,5223,4.316528925619835,20.0,20.0
11210,1,1210,[127 187 302 211 483],537,5,5228,4.317093311312965,20.0,20.0
11211,1,1211,[127 187 302 211 483],343,5,5233,4.317656765676568,20.0,20.0
11212,1,1212,[153 216   4 151 215],385,1,5234,4.314921681780709,0.0,0.0
11213,1,1213,[127 187 302 211 483],339,5,5239,4.315485996705107,20.0,20.0
11214,1,1214,[127 187 302 211 483],833,3,5242,4.31440329218107,20.0,20.0
11215,1,1215,[127 187 302 211 483],207,5,5247,4.3149671052631575,20.0,20.0
11216,1,1216,[127 187 302 211 483],537,5,5252,4.315529991783073,20.0,20.0
11217,1,1217,[127 187 302 211 483],524,5,5257,4.316091954022989,20.0,20.0
11218,1,1218,[127 187 302 211 483],210,5,5262,4.316652994257588,20.0,20.0
11219,1,1219,[127 187 302 211 483],13,5,5267,4.317213114754098,20.0,20.0
11220,1,1220,[127 187 302 211 483],90,5,5272,4.3177723177723175,20.0,20.0
11221,1,1221,[127 187 302 211 483],833,3,5275,4.316693944353519,20.0,20.0
11222,1,1222,[127 187 302 483 211],833,3,5278,4.315617334423549,20.0,20.0
11223,1,1223,[273 144 222 515 182],387,4,5282,4.315359477124183,0.0,0.0
11224,1,1224,[127 187 302 483 211],537,5,5287,4.315918367346939,20.0,20.0
11225,1,1225,[127 187 302 483 211],207,5,5292,4.3164763458401305,20.0,20.0
11226,1,1226,[127 187 302 483 211],474,5,5297,4.317033414832926,20.0,20.0
11227,1,1227,[127 187 302 483 211],339,5,5302,4.317589576547231,20.0,20.0
11228,1,1228,[127 187 302 483 211],13,5,5307,4.318144833197722,20.0,20.0
11229,1,1229,[127 187 302 483 211],666,5,5312,4.31869918699187,20.0,20.0
11230,1,1230,[176 181 508 588 222],378,4,5316,4.318440292445167,0.0,0.0
11231,1,1231,[127  15 182 265  71],533,3,5319,4.31737012987013,0.0,20.0
11232,1,1232,[127 187 302 483 211],339,5,5324,4.3179237631792375,20.0,20.0
11233,1,1233,[127 187 302 483 211],6,5,5329,4.318476499189627,20.0,20.0
11234,1,1234,[127 187 302 483 211],328,5,5334,4.319028340080972,20.0,20.0
11235,1,1235,[127 187 302 483 211],90,5,5339,4.31957928802589,20.0,20.0
11236,1,1236,[127 187 302 483 211],328,5,5344,4.320129345189976,20.0,20.0
11237,1,1237,[127 187 302 483 211],666,5,5349,4.320678513731825,20.0,20.0
11238,1,1238,[127 187 302 483 211],537,5,5354,4.321226795803067,20.0,20.0
11239,1,1239,[204 194  82 202 546],13,3,5357,4.320161290322581,0.0,0.0
11240,1,1240,[127 187 302 483 211],524,5,5362,4.320709105560033,20.0,20.0
11241,1,1241,[127 187 302 483 211],13,5,5367,4.321256038647343,20.0,20.0
11242,1,1242,[127 187 302 483 211],666,5,5372,4.321802091713596,20.0,20.0
11243,1,1243,[174 186  25   9 195],648,3,5375,4.320739549839228,0.0,20.0
11244,1,1244,[127 187 302 483 211],474,5,5380,4.321285140562249,20.0,20.0
11245,1,1245,[127 187 302 483 211],666,5,5385,4.321829855537721,20.0,20.0
11246,1,1246,[127 187 302 483 211],666,5,5390,4.322373696872494,20.0,20.0
11247,1,1247,[182 186  22 215 322],524,2,5392,4.32051282051282,0.0,0.0
11248,1,1248,[127 187 302 483 211],90,5,5397,4.321056845476381,20.0,20.0
11249,1,1249,[127 187 302 483 211],210,5,5402,4.3216,20.0,20.0
11250,1,1250,[127 187 302 483 211],207,5,5407,4.322142286171063,20.0,20.0
11251,1,1251,[127 187 302 483 211],6,5,5412,4.322683706070287,20.0,20.0
11252,1,1252,[127 187 302 483 211],90,5,5417,4.323224261771748,20.0,20.0
11253,1,1253,[176 173 215 271 403],749,5,5422,4.323763955342903,0.0,0.0
11254,1,1254,[127 187 302 483 211],339,5,5427,4.324302788844622,20.0,20.0
11255,1,1255,[127 187 302 483 211],207,5,5432,4.32484076433121,20.0,20.0
11256,1,1256,[127 187 302 483 211],474,5,5437,4.325377883850438,20.0,20.0
11257,1,1257,[127 187 302 483 211],833,3,5440,4.324324324324325,20.0,20.0
11258,1,1258,[127 187 483 302 211],328,5,5445,4.324861000794281,20.0,20.0
11259,1,1259,[127 187 483 302 211],90,5,5450,4.325396825396825,20.0,20.0
11260,1,1260,[127 187 483 302 211],524,5,5455,4.325931800158604,20.0,20.0
11261,1,1261,[127 187 483 302 211],339,5,5460,4.326465927099841,20.0,20.0
11262,1,1262,[127 187 483 302 211],524,5,5465,4.326999208234363,20.0,20.0
11263,1,1263,[127 187 483 302 211],339,5,5470,4.3275316455696204,20.0,20.0
11264,1,1264,[117 403 161 216  64],533,4,5474,4.327272727272727,0.0,0.0
11265,1,1265,[127 187 483 302 211],207,5,5479,4.327804107424961,20.0,20.0
11266,1,1266,[127 187 483 302 211],13,5,5484,4.328334648776638,20.0,20.0
11267,1,1267,[127 187 483 302 211],666,5,5489,4.328864353312303,20.0,20.0
11268,1,1268,[127 187 483 302 211],6,5,5494,4.3293932230102445,20.0,20.0
11269,1,1269,[127 187 483 302 211],474,5,5499,4.32992125984252,20.0,20.0
11270,1,1270,[127 187 483 302 211],537,5,5504,4.33044846577498,20.0,20.0
11271,1,1271,[127 187 483 302 211],6,5,5509,4.330974842767295,20.0,20.0
11272,1,1272,[127 187 483 302 211],339,5,5514,4.331500392772977,20.0,20.0
11273,1,1273,[588 496 357 748 135],454,2,5516,4.329670329670329,20.0,0.0
11274,1,1274,[127 187 483 302 211],339,5,5521,4.330196078431372,20.0,20.0
11275,1,1275,[127 187 483 302 211],90,5,5526,4.330721003134796,20.0,20.0
11276,1,1276,[ 82 258  95 678   8],454,3,5529,4.3296789350039155,0.0,0.0
11277,1,1277,[127 187 483 302 211],207,5,5534,4.330203442879499,20.0,20.0
11278,1,1278,[181  69 197 294 117],95,4,5538,4.329945269741986,0.0,0.0
11279,1,1279,[508 181  98  50  89],474,4,5542,4.3296875,0.0,40.0
11280,1,1280,[127 187 483 302 211],524,5,5547,4.330210772833723,20.0,20.0
11281,1,1281,[127 187 483 302 211],339,5,5552,4.330733229329173,20.0,20.0
11282,1,1282,[127 187 483 302 211],90,5,5557,4.331254871395168,20.0,20.0
11283,1,1283,[127 187 483 302 211],207,5,5562,4.331775700934579,20.0,20.0
11284,1,1284,[127 187 483 302 211],13,5,5567,4.332295719844358,20.0,20.0
11285,1,1285,[127 187 483 302 211],207,5,5572,4.3328149300155525,20.0,20.0
11286,1,1286,[127 187 483 302 211],90,5,5577,4.333333333333333,20.0,20.0
11287,1,1287,[127 187 483 302 211],343,5,5582,4.333850931677019,20.0,20.0
11288,1,1288,[ 82 135 187 202  95],892,4,5586,4.333591931730023,0.0,0.0
11289,1,1289,[127 187 483 302 211],833,3,5589,4.332558139534884,20.0,20.0
11290,1,1290,[127 187 483 302 211],833,3,5592,4.331525948876839,20.0,20.0
11291,1,1291,[127 187 483 302 211],537,5,5597,4.33204334365325,20.0,20.0
11292,1,1292,[127 187 483 302 211],833,3,5600,4.331013147718484,20.0,20.0
11293,1,1293,[174 286 276 215 173],554,3,5603,4.329984544049459,0.0,20.0
11294,1,1294,[127 187 483 302 211],90,5,5608,4.3305019305019306,20.0,20.0
11295,1,1295,[333 181 195 211 289],13,2,5610,4.328703703703703,0.0,0.0
11296,1,1296,[ 50 294 471 176 748],648,3,5613,4.3276792598303775,0.0,20.0
11297,1,1297,[127 187 483 302 211],207,5,5618,4.328197226502311,20.0,20.0
11298,1,1298,[127 187 483 302 211],6,5,5623,4.3287143956889915,20.0,20.0
11299,1,1299,[186 118  12 111 423],666,1,5624,4.326153846153846,20.0,0.0
11300,1,1300,[127 187 483 302 211],343,5,5629,4.326671790930054,20.0,20.0
11301,1,1301,[111 245 181 121 385],452,3,5632,4.325652841781874,0.0,0.0
11302,1,1302,[127 187 483 302 211],474,5,5637,4.3261703760552574,20.0,20.0
11303,1,1303,[508 121 132 222 211],533,5,5642,4.326687116564417,0.0,0.0
11304,1,1304,[127 187 483 302 211],328,5,5647,4.3272030651341,20.0,20.0
11305,1,1305,[127 187 483 302 211],339,5,5652,4.327718223583461,20.0,20.0
11306,1,1306,[ 95 323 111 588 215],454,1,5653,4.325172149961745,0.0,0.0
11307,1,1307,[127 187 483 302 211],666,5,5658,4.325688073394495,20.0,20.0
11308,1,1308,[127 187 483 302 211],90,5,5663,4.32620320855615,20.0,20.0
11309,1,1309,[183 100  82 678   9],455,4,5667,4.3259541984732826,0.0,20.0
11310,1,1310,[127 187 483 302 211],524,5,5672,4.326468344774981,20.0,20.0
11311,1,1311,[127 187 483 302 211],210,5,5677,4.326981707317073,20.0,20.0
11312,1,1312,[127 187 483 302 211],833,3,5680,4.325971058644326,20.0,20.0
11313,1,1313,[168 216  56   4  97],653,1,5681,4.323439878234399,0.0,0.0
11314,1,1314,[153 273 174 118   7],666,2,5683,4.321673003802282,0.0,20.0
11315,1,1315,[127 187 483 302 211],666,5,5688,4.322188449848024,20.0,20.0
11316,1,1316,[127 187 483 302 211],537,5,5693,4.322703113135915,20.0,20.0
11317,1,1317,[127 187 483 302 211],474,5,5698,4.323216995447648,20.0,20.0
11318,1,1318,[195 357 185 118 245],804,5,5703,4.323730098559515,20.0,0.0
11319,1,1319,[127 187 483 302 211],90,5,5708,4.324242424242424,20.0,20.0
11320,1,1320,[127 187 483 302 211],207,5,5713,4.324753974261923,20.0,20.0
11321,1,1321,[153 568 202 288 496],804,4,5717,4.3245083207261725,0.0,0.0
11322,1,1322,[423 151 172 215 180],897,5,5722,4.325018896447468,0.0,0.0
11323,1,1323,[127 187 483 302 211],666,5,5727,4.325528700906345,20.0,20.0
11324,1,1324,[127 187 483 302 211],13,5,5732,4.326037735849057,20.0,20.0
11325,1,1325,[127 187 483 302 211],524,5,5737,4.326546003016591,20.0,20.0
11326,1,1326,[ 69  15 194 117 182],378,3,5740,4.325546345139412,0.0,0.0
11327,1,1327,[127 187 483 302 211],474,5,5745,4.32605421686747,20.0,20.0
11328,1,1328,[121 742 168 288 161],59,3,5748,4.3250564334085775,0.0,0.0
11329,1,1329,[127 187 483 302 211],537,5,5753,4.325563909774436,20.0,20.0
11330,1,1330,[176 216 286 187  71],474,5,5758,4.326070623591285,0.0,0.0
11331,1,1331,[100 117  98 237 423],538,4,5762,4.3258258258258255,0.0,40.0
11332,1,1332,[603 423  79 144 174],650,2,5764,4.324081020255064,20.0,20.0
11333,1,1333,[127 187 483 302 211],328,5,5769,4.324587706146927,20.0,20.0
11334,1,1334,[127 187 483 302 211],6,5,5774,4.325093632958802,20.0,20.0
11335,1,1335,[127 187 483 302 211],343,5,5779,4.325598802395209,20.0,20.0
11336,1,1336,[127 187 483 302 211],833,3,5782,4.324607329842932,20.0,20.0
11337,1,1337,[127 187 483 302 211],833,3,5785,4.323617339312406,20.0,20.0
11338,1,1338,[127 187 483 302 211],90,5,5790,4.324122479462285,20.0,20.0
11339,1,1339,[127 187 483 302 211],666,5,5795,4.324626865671642,20.0,20.0
11340,1,1340,[127 187 483 302 211],524,5,5800,4.325130499627144,20.0,20.0
11341,1,1341,[127 187 483 302 211],207,5,5805,4.325633383010432,20.0,20.0
11342,1,1342,[144 153 238 195 185],648,4,5809,4.325390915860015,0.0,0.0
11343,1,1343,[194 300 144  96 196],666,0,5809,4.322172619047619,0.0,0.0
11344,1,1344,[127 187 483 302 211],328,5,5814,4.32267657992565,20.0,20.0
11345,1,1345,[127 187 483 302 211],13,5,5819,4.323179791976226,20.0,20.0
11346,1,1346,[127 187 483 302 211],339,5,5824,4.323682256867112,20.0,20.0
11347,1,1347,[172 127 546 183 318],313,5,5829,4.324183976261128,20.0,20.0
11348,1,1348,[127 187 483 302 211],210,5,5834,4.3246849518161605,20.0,20.0
11349,1,1349,[127 187 483 302 211],13,5,5839,4.325185185185185,20.0,20.0
11350,1,1350,[127 187 483 302 211],524,5,5844,4.325684678016284,20.0,20.0
11351,1,1351,[127 187 483 302 211],13,5,5849,4.326183431952662,20.0,20.0
11352,1,1352,[135 191 202 153 216],313,4,5853,4.325942350332594,0.0,0.0
11353,1,1353,[127 187 483 302 211],474,5,5858,4.326440177252585,20.0,20.0
11354,1,1354,[127 187 483 302 211],833,3,5861,4.325461254612546,20.0,20.0
11355,1,1355,[127 187 483 302 211],210,5,5866,4.325958702064897,20.0,20.0
11356,1,1356,[161 235 197 185 196],271,2,5868,4.3242446573323505,0.0,0.0
11357,1,1357,[546  82 211 100 125],313,3,5871,4.323269513991163,0.0,20.0
11358,1,1358,[127 187 483 302 211],474,5,5876,4.323767476085357,20.0,20.0
11359,1,1359,[127 187 483 302 211],343,5,5881,4.324264705882353,20.0,20.0
11360,1,1360,[127 187 483 302 211],339,5,5886,4.324761204996326,20.0,20.0
11361,1,1361,[ 96  56  22 258 210],538,3,5889,4.323788546255507,0.0,0.0
11362,1,1362,[ 96 515 196 185  71],311,4,5893,4.323550990462215,0.0,0.0
11363,1,1363,[135   4 191  11 275],406,3,5896,4.32258064516129,0.0,0.0
11364,1,1364,[655 286 194 121 204],537,0,5896,4.319413919413919,0.0,0.0
11365,1,1365,[127 187 483 302 211],833,3,5899,4.318448023426061,20.0,20.0
11366,1,1366,[237 234  28 597 161],7,3,5902,4.317483540599854,0.0,0.0
11367,1,1367,[268 288 180 265 275],7,4,5906,4.317251461988304,0.0,0.0
11368,1,1368,[ 56 186  95 515  89],234,1,5907,4.314828341855369,0.0,0.0
11369,1,1369,[127 187 483 302 211],666,5,5912,4.315328467153285,20.0,20.0
11370,1,1370,[195 568  22 202  98],892,5,5917,4.315827862873815,0.0,20.0
11371,1,1371,[127 187 483 302 211],537,5,5922,4.316326530612245,20.0,20.0
11372,1,1372,[127 187 483 302 211],339,5,5927,4.3168244719592135,20.0,20.0
11373,1,1373,[127 187 483 302 211],90,5,5932,4.317321688500728,20.0,20.0
11374,1,1374,[127 187 483 302 211],210,5,5937,4.317818181818182,20.0,20.0
11375,1,1375,[197 161 748 211   1],479,3,5940,4.316860465116279,0.0,0.0
11376,1,1376,[127 187 483 302 211],328,5,5945,4.317356572258533,20.0,20.0
11377,1,1377,[127 187 483 302 211],339,5,5950,4.317851959361393,20.0,20.0
11378,1,1378,[ 15 471 194  79 172],882,4,5954,4.317621464829586,0.0,0.0
11379,1,1379,[655 144 288  97 179],666,3,5957,4.316666666666666,0.0,0.0
11380,1,1380,[127 187 483 302 211],537,5,5962,4.317161477190441,20.0,20.0
11381,1,1381,[127 187 483 302 211],210,5,5967,4.317655571635311,20.0,20.0
11382,1,1382,[127 187 483 302 211],339,5,5972,4.318148951554591,20.0,20.0
11383,1,1383,[127 187 483 302 211],6,5,5977,4.31864161849711,20.0,20.0
11384,1,1384,[127 187 483 302 211],833,3,5980,4.317689530685921,20.0,20.0
11385,1,1385,[127 187 483 302 211],13,5,5985,4.318181818181818,20.0,20.0
11386,1,1386,[127 187 483 302 211],474,5,5990,4.318673395818313,20.0,20.0
11387,1,1387,[ 25 210 237 222 655],406,1,5991,4.316282420749279,0.0,0.0
11388,1,1388,[127 187 483 302 211],328,5,5996,4.316774658027358,20.0,20.0
11389,1,1389,[127 187 483 302 211],13,5,6001,4.31726618705036,20.0,20.0
11390,1,1390,[127 187 483 302 211],90,5,6006,4.317757009345795,20.0,20.0
11391,1,1391,[ 28 182 748  11 276],207,1,6007,4.315373563218391,0.0,0.0
11392,1,1392,[127 187 483 302 211],343,5,6012,4.31586503948313,20.0,20.0
11393,1,1393,[  1 175 546 496 269],378,3,6015,4.314921090387374,0.0,0.0
11394,1,1394,[127 187 483 302 211],343,5,6020,4.315412186379929,20.0,20.0
11395,1,1395,[127 187 483 302 211],339,5,6025,4.315902578796561,20.0,20.0
11396,1,1396,[127 187 483 302 211],474,5,6030,4.316392269148174,20.0,20.0
11397,1,1397,[127 187 483 302 211],13,5,6035,4.316881258941344,20.0,20.0
11398,1,1398,[127 187 483 302 211],666,5,6040,4.317369549678341,20.0,20.0
11399,1,1399,[127 187 483 302 211],524,5,6045,4.317857142857143,20.0,20.0
11400,1,1400,[127 187 483 302 211],666,5,6050,4.318344039971449,20.0,20.0
11401,1,1401,[179 121 100 282  98],406,4,6054,4.31811697574893,0.0,40.0
11402,1,1402,[238 202   1 210 235],295,5,6059,4.318602993585174,0.0,0.0
11403,1,1403,[127 187 483 302 211],6,5,6064,4.319088319088319,20.0,20.0
11404,1,1404,[127 187 483 302 211],328,5,6069,4.319572953736655,20.0,20.0
11405,1,1405,[ 56   9 568   4 186],411,5,6074,4.320056899004268,0.0,0.0
11406,1,1406,[238  28 257   4 117],653,2,6076,4.318407960199005,0.0,0.0
11407,1,1407,[127 187 483 302 211],6,5,6081,4.318892045454546,20.0,20.0
11408,1,1408,[127 187 483 302 211],339,5,6086,4.319375443577005,20.0,20.0
11409,1,1409,[175 215 151 168 187],346,3,6089,4.3184397163120565,0.0,0.0
11410,1,1410,[117 100   7 286  25],194,1,6090,4.316087880935506,0.0,20.0
11411,1,1411,[127 187 483 302 211],474,5,6095,4.31657223796034,20.0,20.0
11412,1,1412,[127 187 483 302 211],474,5,6100,4.3170559094125975,20.0,20.0
11413,1,1413,[127 187 483 302 211],90,5,6105,4.317538896746817,20.0,20.0
11414,1,1414,[127 187 483 302 211],343,5,6110,4.318021201413427,20.0,20.0
11415,1,1415,[127 187 483 302 211],474,5,6115,4.318502824858757,20.0,20.0
11416,1,1416,[127 187 483 302 211],537,5,6120,4.318983768525053,20.0,20.0
11417,1,1417,[127 187 483 302 211],524,5,6125,4.319464033850494,20.0,20.0
11418,1,1418,[127 187 483 302 211],833,3,6128,4.318534178999295,20.0,20.0
11419,1,1419,[127 187 483 302 211],13,5,6133,4.319014084507042,20.0,20.0
11420,1,1420,[127 187 483 302 211],524,5,6138,4.3194933145672065,20.0,20.0
11421,1,1421,[127 187 483 302 211],343,5,6143,4.319971870604782,20.0,20.0
11422,1,1422,[127 187 483 302 211],13,5,6148,4.320449754040759,20.0,20.0
11423,1,1423,[127 187 483 302 211],343,5,6153,4.320926966292135,20.0,20.0
11424,1,1424,[117 282 202 211 546],95,3,6156,4.32,0.0,0.0
11425,1,1425,[222   9 515 234 318],430,4,6160,4.319775596072931,20.0,0.0
11426,1,1426,[127 187 483 302 211],339,5,6165,4.320252277505256,20.0,20.0
11427,1,1427,[127 187 483 302 211],6,5,6170,4.320728291316526,20.0,20.0
11428,1,1428,[127 187 483 302 211],474,5,6175,4.321203638908328,20.0,20.0
11429,1,1429,[127 187 483 302 211],90,5,6180,4.321678321678322,20.0,20.0
11430,1,1430,[127 187 483 302 211],666,5,6185,4.322152341020265,20.0,20.0
11431,1,1431,[127 187 483 302 211],666,5,6190,4.322625698324022,20.0,20.0
11432,1,1432,[127 187 483 302 211],474,5,6195,4.323098394975576,20.0,20.0
11433,1,1433,[127 187 483 302 211],474,5,6200,4.323570432357044,20.0,20.0
11434,1,1434,[127 187 483 302 211],90,5,6205,4.32404181184669,20.0,20.0
11435,1,1435,[127 187 483 302 211],666,5,6210,4.3245125348189415,20.0,20.0
11436,1,1436,[ 88 187 191 258 185],13,3,6213,4.323590814196242,0.0,0.0
11437,1,1437,[127 187 483 302 211],339,5,6218,4.324061196105703,20.0,20.0
11438,1,1438,[127 187 483 302 211],210,5,6223,4.3245309242529535,20.0,20.0
11439,1,1439,[127 187 483 302 211],328,5,6228,4.325,20.0,20.0
11440,1,1440,[127 187 483 302 211],833,3,6231,4.324080499653019,20.0,20.0
11441,1,1441,[127 187 483 302 211],524,5,6236,4.324549237170596,20.0,20.0
11442,1,1442,[127 187 483 302 211],6,5,6241,4.325017325017325,20.0,20.0
11443,1,1443,[144 180 269 748 200],488,1,6242,4.322714681440443,0.0,0.0
11444,1,1444,[127 187 483 302 211],524,5,6247,4.32318339100346,20.0,20.0
11445,1,1445,[127 187 483 302 211],328,5,6252,4.323651452282157,20.0,20.0
11446,1,1446,[127 187 483 302 211],339,5,6257,4.324118866620594,20.0,20.0
11447,1,1447,[127 187 483 302 211],343,5,6262,4.324585635359116,20.0,20.0
11448,1,1448,[174 181 748 211 161],454,3,6265,4.323671497584541,0.0,20.0
11449,1,1449,[186  88   9 322 273],13,2,6267,4.322068965517241,0.0,0.0
11450,1,1450,[ 69 191  64  95  97],378,4,6271,4.32184700206754,0.0,0.0
11451,1,1451,[127 187 483 302 211],90,5,6276,4.322314049586777,20.0,20.0
11452,1,1452,[127 187 483 302 211],13,5,6281,4.322780454232622,20.0,20.0
11453,1,1453,[127 187 483 302 211],537,5,6286,4.3232462173315,20.0,20.0
11454,1,1454,[127 187 483 302 211],90,5,6291,4.323711340206185,20.0,20.0
11455,1,1455,[144 228  22  71  97],13,5,6296,4.324175824175824,0.0,0.0
11456,1,1456,[127 187 483 302 211],524,5,6301,4.3246396705559365,20.0,20.0
11457,1,1457,[127 187 483 302 211],474,5,6306,4.325102880658436,20.0,20.0
11458,1,1458,[127 187 483 302 211],210,5,6311,4.325565455791638,20.0,20.0
11459,1,1459,[117 179 276  56 546],308,3,6314,4.324657534246575,0.0,0.0
11460,1,1460,[127 187 483 302 211],666,5,6319,4.325119780971937,20.0,20.0
11461,1,1461,[127 187 483 302 211],13,5,6324,4.325581395348837,20.0,20.0
11462,1,1462,[127 187 483 302 211],13,5,6329,4.326042378673957,20.0,20.0
11463,1,1463,[127 187 483 302 211],6,5,6334,4.326502732240437,20.0,20.0
11464,1,1464,[127 187 483 302 211],207,5,6339,4.326962457337884,20.0,20.0
11465,1,1465,[127 187 483 302 211],210,5,6344,4.327421555252387,20.0,20.0
11466,1,1466,[127 187 483 302 211],537,5,6349,4.327880027266531,20.0,20.0
11467,1,1467,[127 187 483 302 211],90,5,6354,4.3283378746594,20.0,20.0
11468,1,1468,[127 187 483 302 211],666,5,6359,4.328795098706603,20.0,20.0
11469,1,1469,[ 22 194  96  25 237],313,2,6361,4.327210884353741,0.0,0.0
11470,1,1470,[127 187 483 302 211],343,5,6366,4.327668252889191,20.0,20.0
11471,1,1471,[127 187 483 302 211],6,5,6371,4.328125,20.0,20.0
11472,1,1472,[127 187 483 302 211],833,3,6374,4.3272233536999325,20.0,20.0
11473,1,1473,[127 187 483 302 211],207,5,6379,4.3276797829036635,20.0,20.0
11474,1,1474,[127 187 483 302 211],207,5,6384,4.328135593220339,20.0,20.0
11475,1,1475,[127 187 483 302 211],833,3,6387,4.3272357723577235,20.0,20.0
11476,1,1476,[127 187 483 302 211],537,5,6392,4.327691266079892,20.0,20.0
11477,1,1477,[185 228 121   4  89],749,4,6396,4.327469553450609,0.0,0.0
11478,1,1478,[ 89  69 333 483 265],881,4,6400,4.3272481406355645,20.0,0.0
11479,1,1479,[127 187 483 302 211],666,5,6405,4.327702702702703,20.0,20.0
11480,1,1480,[127 187 483 302 211],339,5,6410,4.328156650911546,20.0,20.0
11481,1,1481,[127 187 483 302 211],343,5,6415,4.328609986504723,20.0,20.0
11482,1,1482,[127 187 483 302 211],6,5,6420,4.3290627107215105,20.0,20.0
11483,1,1483,[127 187 483 302 211],343,5,6425,4.329514824797844,20.0,20.0
11484,1,1484,[127 187 483 302 211],833,3,6428,4.328619528619528,20.0,20.0
11485,1,1485,[127 187 483 302 211],833,3,6431,4.327725437415881,20.0,20.0
11486,1,1486,[483  28 234 245 258],263,3,6434,4.326832548755885,20.0,0.0
11487,1,1487,[127 187 483 302 211],524,5,6439,4.327284946236559,20.0,20.0
11488,1,1488,[127 187 483 302 211],339,5,6444,4.327736736064473,20.0,20.0
11489,1,1489,[127 187 483 302 211],537,5,6449,4.328187919463088,20.0,20.0
11490,1,1490,[313 210 151 496  15],234,2,6451,4.326626425217975,0.0,0.0
11491,1,1491,[127 187 483 302 211],666,5,6456,4.327077747989276,20.0,20.0
11492,1,1492,[127 187 483 302 211],833,3,6459,4.326188881446751,20.0,20.0
11493,1,1493,[187 143 228 202  70],234,1,6460,4.323962516733601,0.0,0.0
11494,1,1494,[127 187 483 302 211],524,5,6465,4.3244147157190636,20.0,20.0
11495,1,1495,[127 187 483 302 211],207,5,6470,4.324866310160428,20.0,20.0
11496,1,1496,[127 187 483 302 211],833,3,6473,4.323981295925184,20.0,20.0
11497,1,1497,[127 187 483 302 211],474,5,6478,4.324432576769025,20.0,20.0
11498,1,1498,[127 187 483 302 211],6,5,6483,4.324883255503669,20.0,20.0
11499,1,1499,[127 187 483 302 211],339,5,6488,4.325333333333333,20.0,20.0
11500,1,1500,[127 187 483 302 211],474,5,6493,4.325782811459027,20.0,20.0
11501,1,1501,[ 28 125 173 475 172],92,3,6496,4.324900133155793,0.0,0.0
11502,1,1502,[127 187 483 302 211],474,5,6501,4.325349301397206,20.0,20.0
11503,1,1503,[515 100  22  97 118],774,0,6501,4.3224734042553195,0.0,20.0
11504,1,1504,[127 187 483 302 211],343,5,6506,4.322923588039867,20.0,20.0
11505,1,1505,[127 187 483 302 211],666,5,6511,4.323373173970784,20.0,20.0
11506,1,1506,[127 187 483 302 211],537,5,6516,4.323822163238222,20.0,20.0
11507,1,1507,[186 127 597 153 216],346,1,6517,4.321618037135279,0.0,20.0
11508,1,1508,[127 187 483 302 211],210,5,6522,4.3220675944334,20.0,20.0
11509,1,1509,[127 187 483 302 211],207,5,6527,4.322516556291391,20.0,20.0
11510,1,1510,[127 187 483 302 211],343,5,6532,4.322964923891463,20.0,20.0
11511,1,1511,[127 187 483 302 211],339,5,6537,4.323412698412699,20.0,20.0
11512,1,1512,[127 187 483 302 211],339,5,6542,4.323859881031064,20.0,20.0
11513,1,1513,[127 187 483 302 211],474,5,6547,4.324306472919419,20.0,20.0
11514,1,1514,[179 117 333 111 180],537,2,6549,4.322772277227723,0.0,0.0
11515,1,1515,[127 187 483 302 211],328,5,6554,4.323218997361478,20.0,20.0
11516,1,1516,[ 15 234 135 185 153],234,2,6556,4.321687541199736,0.0,0.0
11517,1,1517,[127 187 483 302 211],207,5,6561,4.322134387351778,20.0,20.0
11518,1,1518,[127 187 483 302 211],666,5,6566,4.32258064516129,20.0,20.0
11519,1,1519,[127 187 483 302 211],343,5,6571,4.323026315789473,20.0,20.0
11520,1,1520,[127 187 483 302 211],833,3,6574,4.32215647600263,20.0,20.0
11521,1,1521,[127 187 483 302 211],833,3,6577,4.321287779237845,20.0,20.0
11522,1,1522,[127 187 483 302 211],524,5,6582,4.321733420879842,20.0,20.0
11523,1,1523,[121 276  25  79 183],200,5,6587,4.322178477690288,0.0,0.0
11524,1,1524,[127 187 483 302 211],537,5,6592,4.322622950819672,20.0,20.0
11525,1,1525,[127 187 483 302 211],833,3,6595,4.3217562254259505,20.0,20.0
11526,1,1526,[127 187 483 302 211],474,5,6600,4.322200392927308,20.0,20.0
11527,1,1527,[496  50 132 182  82],308,3,6603,4.321335078534031,0.0,20.0
11528,1,1528,[127 187 483 302 211],666,5,6608,4.321778940483976,20.0,20.0
11529,1,1529,[  9 258 423 322 286],13,2,6610,4.3202614379084965,0.0,0.0
11530,1,1530,[127 187 483 302 211],524,5,6615,4.3207054212932725,20.0,20.0
11531,1,1531,[127 187 483 302 211],474,5,6620,4.321148825065274,20.0,20.0
11532,1,1532,[127 187 483 302 211],6,5,6625,4.321591650358774,20.0,20.0
11533,1,1533,[385 179  64 144 237],194,3,6628,4.320730117340287,0.0,0.0
11534,1,1534,[127 187 483 302 211],6,5,6633,4.321172638436482,20.0,20.0
11535,1,1535,[655 234 215 211 143],659,4,6637,4.320963541666667,0.0,0.0
11536,1,1536,[127 187 483 302 211],666,5,6642,4.321405335068315,20.0,20.0
11537,1,1537,[127 187 483 302 211],6,5,6647,4.32184655396619,20.0,20.0
11538,1,1538,[135 143 318 234 172],804,3,6650,4.320987654320987,20.0,0.0
11539,1,1539,[127 187 483 302 211],537,5,6655,4.321428571428571,20.0,20.0
11540,1,1540,[127 187 483 302 211],90,5,6660,4.321868916288125,20.0,20.0
11541,1,1541,[127 187 483 302 211],210,5,6665,4.32230869001297,20.0,20.0
11542,1,1542,[127 187 483 302 211],833,3,6668,4.321451717433571,20.0,20.0
11543,1,1543,[127 187 483 302 211],524,5,6673,4.321891191709844,20.0,20.0
11544,1,1544,[127 187 483 302 211],339,5,6678,4.322330097087379,20.0,20.0
11545,1,1545,[191 385 125 200 202],749,4,6682,4.322121604139715,0.0,0.0
11546,1,1546,[508 258 286 294 742],207,3,6685,4.321266968325792,0.0,0.0
11547,1,1547,[211 121 200   1 210],738,3,6688,4.320413436692506,0.0,0.0
11548,1,1548,[183 258 174   4 180],882,4,6692,4.32020658489348,0.0,20.0
11549,1,1549,[269 100 322  98 132],90,5,6697,4.320645161290322,0.0,40.0
11550,1,1550,[127 187 483 302 211],666,5,6702,4.321083172147002,20.0,20.0
11551,1,1551,[127 187 483 302 211],210,5,6707,4.321520618556701,20.0,20.0
11552,1,1552,[127 187 483 302 211],339,5,6712,4.321957501609788,20.0,20.0
11553,1,1553,[194 161 423 294 172],804,4,6716,4.321750321750322,0.0,0.0
11554,1,1554,[127 187 483 302 211],207,5,6721,4.322186495176849,20.0,20.0
11555,1,1555,[127 187 483 302 211],210,5,6726,4.322622107969152,20.0,20.0
11556,1,1556,[121 427 173 185 655],537,3,6729,4.321772639691715,0.0,0.0
11557,1,1557,[127 187 483 302 211],666,5,6734,4.322207958921695,20.0,20.0
11558,1,1558,[127 187 483 302 211],90,5,6739,4.3226427196921104,20.0,20.0
11559,1,1559,[127 187 483 302 211],339,5,6744,4.323076923076923,20.0,20.0
11560,1,1560,[127 187 483 302 211],474,5,6749,4.3235105701473415,20.0,20.0
11561,1,1561,[471 181 222 483  96],313,4,6753,4.323303457106274,20.0,0.0
11562,1,1562,[496 294  69 568 237],804,5,6758,4.3237364043506075,0.0,0.0
11563,1,1563,[127 187 483 302 211],207,5,6763,4.3241687979539645,20.0,20.0
11564,1,1564,[127 187 483 302 211],328,5,6768,4.3246006389776355,20.0,20.0
11565,1,1565,[  4 182 151 742 288],650,0,6768,4.32183908045977,0.0,0.0
11566,1,1566,[234 125 228 202 403],42,4,6772,4.3216336949585195,0.0,0.0
11567,1,1567,[127 187 483 302 211],207,5,6777,4.322066326530612,20.0,20.0
11568,1,1568,[127 187 483 302 211],90,5,6782,4.3224984066284255,20.0,20.0
11569,1,1569,[195 568 204  96 161],87,5,6787,4.322929936305733,0.0,0.0
11570,1,1570,[127 187 483 302 211],666,5,6792,4.3233609166136215,20.0,20.0
11571,1,1571,[127 187 483 302 211],328,5,6797,4.323791348600509,20.0,20.0
11572,1,1572,[127 187 483 302 211],524,5,6802,4.324221233312143,20.0,20.0
11573,1,1573,[127 187 483 302 211],537,5,6807,4.324650571791614,20.0,20.0
11574,1,1574,[127 187 483 302 211],328,5,6812,4.3250793650793655,20.0,20.0
11575,1,1575,[175 286  96 427 132],934,5,6817,4.325507614213198,0.0,0.0
11576,1,1576,[127 187 483 302 211],6,5,6822,4.3259353202282815,20.0,20.0
11577,1,1577,[322 181 174 183 187],334,4,6826,4.325728770595691,0.0,20.0
11578,1,1578,[127 187 483 302 211],833,3,6829,4.324889170360988,20.0,20.0
11579,1,1579,[127 187 483 302 211],833,3,6832,4.324050632911392,20.0,20.0
11580,1,1580,[127 187 483 302 211],666,5,6837,4.324478178368121,20.0,20.0
11581,1,1581,[238 423 245   4 153],749,4,6841,4.324273072060683,0.0,0.0
11582,1,1582,[127 187 483 302 211],13,5,6846,4.324699936828806,20.0,20.0
11583,1,1583,[127 187 483 302 211],537,5,6851,4.325126262626263,20.0,20.0
11584,1,1584,[127 187 483 302 211],6,5,6856,4.325552050473186,20.0,20.0
11585,1,1585,[127 187 483 302 211],207,5,6861,4.325977301387137,20.0,20.0
11586,1,1586,[127 187 483 302 211],343,5,6866,4.3264020163831125,20.0,20.0
11587,1,1587,[111 210 127 222  79],158,4,6870,4.326196473551637,0.0,20.0
11588,1,1588,[748 427 655 161  79],13,4,6874,4.325991189427313,0.0,0.0
11589,1,1589,[183  11 357 215 427],59,5,6879,4.326415094339622,20.0,0.0
11590,1,1590,[127 187 483 302 211],207,5,6884,4.32683846637335,20.0,20.0
11591,1,1591,[ 50 216 496 323 100],474,4,6888,4.326633165829146,0.0,40.0
11592,1,1592,[127 187 483 302 211],339,5,6893,4.327055869428751,20.0,20.0
11593,1,1593,[127 187 483 302 211],13,5,6898,4.327478042659975,20.0,20.0
11594,1,1594,[127 187 483 302 211],833,3,6901,4.326645768025078,20.0,20.0
11595,1,1595,[127 187 483 302 211],339,5,6906,4.327067669172933,20.0,20.0
11596,1,1596,[127 187 483 302 211],666,5,6911,4.327489041953663,20.0,20.0
11597,1,1597,[127 187 483 302 211],6,5,6916,4.327909887359199,20.0,20.0
11598,1,1598,[127 187 483 302 211],524,5,6921,4.328330206378987,20.0,20.0
11599,1,1599,[127 187 483 302 211],6,5,6926,4.32875,20.0,20.0
11600,1,1600,[127 187 483 302 211],537,5,6931,4.329169269206746,20.0,20.0
11601,1,1601,[127 187 483 302 211],666,5,6936,4.329588014981273,20.0,20.0
11602,1,1602,[483 194  70 318 245],452,4,6940,4.329382407985028,40.0,0.0
11603,1,1603,[127 187 483 302 211],90,5,6945,4.329800498753118,20.0,20.0
11604,1,1604,[318 235 161  98 286],524,3,6948,4.328971962616823,20.0,20.0
11605,1,1605,[127 187 483 302 211],6,5,6953,4.329389788293898,20.0,20.0
11606,1,1606,[127 187 483 302 211],343,5,6958,4.3298070939639075,20.0,20.0
11607,1,1607,[127 187 483 302 211],524,5,6963,4.330223880597015,20.0,20.0
11608,1,1608,[127 187 483 302 211],339,5,6968,4.33064014916097,20.0,20.0
11609,1,1609,[127 187 483 302 211],210,5,6973,4.331055900621118,20.0,20.0
11610,1,1610,[127 187 483 302 211],210,5,6978,4.33147113594041,20.0,20.0
11611,1,1611,[127 187 483 302 211],474,5,6983,4.3318858560794045,20.0,20.0
11612,1,1612,[127 187 483 302 211],833,3,6986,4.331060136391817,20.0,20.0
11613,1,1613,[127 187 483 302 211],474,5,6991,4.3314745972738535,20.0,20.0
11614,1,1614,[127 187 483 302 211],210,5,6996,4.33188854489164,20.0,20.0
11615,1,1615,[ 70 471 191 118 185],666,4,7000,4.3316831683168315,0.0,0.0
11616,1,1616,[127 187 483 302 211],6,5,7005,4.332096474953618,20.0,20.0
11617,1,1617,[238 742 289 268 546],92,2,7007,4.330655129789864,0.0,0.0
11618,1,1618,[127 187 483 302 211],210,5,7012,4.331068560840024,20.0,20.0
11619,1,1619,[127 187 483 302 211],90,5,7017,4.3314814814814815,20.0,20.0
11620,1,1620,[127 187 483 302 211],207,5,7022,4.331893892658853,20.0,20.0
11621,1,1621,[127 187 483 302 211],343,5,7027,4.332305795314427,20.0,20.0
11622,1,1622,[ 28 111  11 423  82],554,5,7032,4.33271719038817,0.0,0.0
11623,1,1623,[127 187 483 302 211],210,5,7037,4.333128078817734,20.0,20.0
11624,1,1624,[603   4  88 172 323],537,1,7038,4.331076923076923,20.0,0.0
11625,1,1625,[127 187 483 302 211],343,5,7043,4.331488314883149,20.0,20.0
11626,1,1626,[742 301 313 132 180],650,2,7045,4.330055316533497,0.0,0.0
11627,1,1627,[127 187 483 302 211],6,5,7050,4.330466830466831,20.0,20.0
11628,1,1628,[127 187 483 302 211],339,5,7055,4.330877839165132,20.0,20.0
11629,1,1629,[127 187 483 302 211],537,5,7060,4.331288343558282,20.0,20.0
11630,1,1630,[127 187 483 302 211],666,5,7065,4.331698344573881,20.0,20.0
11631,1,1631,[127 187 483 302 211],666,5,7070,4.332107843137255,20.0,20.0
11632,1,1632,[127 187 483 302 211],833,3,7073,4.331292100428659,20.0,20.0
11633,1,1633,[127 187 483 302 211],474,5,7078,4.331701346389229,20.0,20.0
11634,1,1634,[127 187 483 302 211],474,5,7083,4.332110091743119,20.0,20.0
11635,1,1635,[127 187 483 302 211],210,5,7088,4.332518337408313,20.0,20.0
11636,1,1636,[127 187 483 302 211],339,5,7093,4.33292608430055,20.0,20.0
11637,1,1637,[127 187 483 302 211],537,5,7098,4.333333333333333,20.0,20.0
11638,1,1638,[127 187 483 302 211],343,5,7103,4.333740085417938,20.0,20.0
11639,1,1639,[127 187 483 302 211],207,5,7108,4.3341463414634145,20.0,20.0
11640,1,1640,[127 187 483 302 211],210,5,7113,4.3345521023766,20.0,20.0
11641,1,1641,[271 161 228  69 144],328,3,7116,4.33373934226553,0.0,0.0
11642,1,1642,[127 187 483 302 211],537,5,7121,4.334144856968959,20.0,20.0
11643,1,1643,[475 183 313 132 191],474,5,7126,4.3345498783454985,0.0,0.0
11644,1,1644,[328 121 111 269 288],894,1,7127,4.332522796352584,0.0,0.0
11645,1,1645,[127 187 483 302 211],666,5,7132,4.332928311057108,20.0,20.0
11646,1,1646,[127 187 483 302 211],524,5,7137,4.333333333333333,20.0,20.0
11647,1,1647,[127 187 483 302 211],537,5,7142,4.33373786407767,20.0,20.0
11648,1,1648,[127 187 483 302 211],90,5,7147,4.334141904184354,20.0,20.0
11649,1,1649,[286 132 302 318 289],454,2,7149,4.332727272727273,20.0,0.0
11650,1,1650,[127 187 483 302 211],339,5,7154,4.33313143549364,20.0,20.0
11651,1,1651,[  4 235 385 174 357],738,4,7158,4.332929782082324,20.0,20.0
11652,1,1652,[127 187 483 302 211],474,5,7163,4.333333333333333,20.0,20.0
11653,1,1653,[127 187 483 302 211],13,5,7168,4.333736396614269,20.0,20.0
11654,1,1654,[127 187 483 302 211],833,3,7171,4.332930513595167,20.0,20.0
11655,1,1655,[127 187 483 302 211],90,5,7176,4.333333333333333,20.0,20.0
11656,1,1656,[127 187 483 302 211],210,5,7181,4.333735666867834,20.0,20.0
11657,1,1657,[471 161 195  79 276],92,4,7185,4.333534378769602,0.0,0.0
11658,1,1658,[127 187 483 302 211],13,5,7190,4.333936106088005,20.0,20.0
11659,1,1659,[127 187 483 302 211],90,5,7195,4.3343373493975905,20.0,20.0
11660,1,1660,[127 187 483 302 211],833,3,7198,4.333534015653221,20.0,20.0
11661,1,1661,[127 187 483 302 211],833,3,7201,4.332731648616125,20.0,20.0
11662,1,1662,[127 187 483 302 211],13,5,7206,4.333132892363199,20.0,20.0
11663,1,1663,[127 187 483 302 211],343,5,7211,4.333533653846154,20.0,20.0
11664,1,1664,[127 187 483 302 211],90,5,7216,4.333933933933934,20.0,20.0
11665,1,1665,[127 187 483 302 211],90,5,7221,4.334333733493398,20.0,20.0
11666,1,1666,[127 187 483 302 211],13,5,7226,4.334733053389322,20.0,20.0
11667,1,1667,[153 215 202 181 286],653,2,7228,4.333333333333333,0.0,0.0
11668,1,1668,[127 187 483 302 211],343,5,7233,4.333732774116237,20.0,20.0
11669,1,1669,[127 187 483 302 211],666,5,7238,4.334131736526946,20.0,20.0
11670,1,1670,[127 187 483 302 211],339,5,7243,4.334530221424297,20.0,20.0
11671,1,1671,[127 187 483 302 211],343,5,7248,4.3349282296650715,20.0,20.0
11672,1,1672,[127 187 483 302 211],537,5,7253,4.335325762104005,20.0,20.0
11673,1,1673,[127 187 483 302 211],524,5,7258,4.335722819593787,20.0,20.0
11674,1,1674,[127 187 483 302 211],474,5,7263,4.336119402985075,20.0,20.0
11675,1,1675,[127 187 483 302 211],6,5,7268,4.336515513126492,20.0,20.0
11676,1,1676,[127 187 483 302 211],207,5,7273,4.33691115086464,20.0,20.0
11677,1,1677,[127 187 483 302 211],6,5,7278,4.3373063170441,20.0,20.0
11678,1,1678,[127 187 483 302 211],343,5,7283,4.337701012507445,20.0,20.0
11679,1,1679,[127 187 483 302 211],524,5,7288,4.338095238095238,20.0,20.0
11680,1,1680,[204 289  98 222 603],454,2,7290,4.336704342653182,20.0,20.0
11681,1,1681,[127 187 483 302 211],537,5,7295,4.337098692033294,20.0,20.0
11682,1,1682,[127 187 483 302 211],210,5,7300,4.33749257278669,20.0,20.0
11683,1,1683,[127 187 483 302 211],474,5,7305,4.337885985748218,20.0,20.0
11684,1,1684,[127 187 483 302 211],328,5,7310,4.338278931750742,20.0,20.0
11685,1,1685,[127 187 483 302 211],6,5,7315,4.338671411625148,20.0,20.0
11686,1,1686,[196 143 210 496 174],59,4,7319,4.338470657972732,0.0,20.0
11687,1,1687,[127 187 483 302 211],474,5,7324,4.338862559241706,20.0,20.0
11688,1,1688,[127 187 483 302 211],13,5,7329,4.339253996447602,20.0,20.0
11689,1,1689,[127 187 483 302 211],90,5,7334,4.339644970414201,20.0,20.0
11690,1,1690,[127 187 483 302 211],13,5,7339,4.340035481963335,20.0,20.0
11691,1,1691,[127 187 483 302 211],6,5,7344,4.340425531914893,20.0,20.0
11692,1,1692,[127 187 483 302 211],90,5,7349,4.340815121086828,20.0,20.0
11693,1,1693,[127 187 483 302 211],524,5,7354,4.341204250295159,20.0,20.0
11694,1,1694,[143 276 357 127  88],339,5,7359,4.341592920353983,20.0,20.0
11695,1,1695,[127 187 483 302 211],13,5,7364,4.341981132075472,20.0,20.0
11696,1,1696,[235 174  82 318 143],313,2,7366,4.340601060695345,20.0,20.0
11697,1,1697,[127 187 483 302 211],524,5,7371,4.340989399293286,20.0,20.0
11698,1,1698,[127 187 483 302 211],343,5,7376,4.341377280753385,20.0,20.0
11699,1,1699,[127 187 483 302 211],339,5,7381,4.341764705882353,20.0,20.0
11700,1,1700,[294 121   7 322 678],537,1,7382,4.339800117577895,0.0,0.0
11701,1,1701,[127 187 483 302 211],339,5,7387,4.340188014101058,20.0,20.0
11702,1,1702,[127 187 483 302 211],13,5,7392,4.3405754550792714,20.0,20.0
11703,1,1703,[127 187 483 302 211],833,3,7395,4.339788732394366,20.0,20.0
11704,1,1704,[127 187 483 302 211],474,5,7400,4.340175953079179,20.0,20.0
11705,1,1705,[127 187 483 302 211],343,5,7405,4.340562719812427,20.0,20.0
11706,1,1706,[127 187 483 302 211],6,5,7410,4.340949033391916,20.0,20.0
11707,1,1707,[127 187 483 302 211],524,5,7415,4.341334894613583,20.0,20.0
11708,1,1708,[222 471 546  70  56],447,2,7417,4.3399648917495615,0.0,0.0
11709,1,1709,[174 515  79 748   8],882,5,7422,4.340350877192982,0.0,20.0
11710,1,1710,[127 187 483 302 211],13,5,7427,4.340736411455289,20.0,20.0
11711,1,1711,[127 187 483 302 211],13,5,7432,4.341121495327103,20.0,20.0
11712,1,1712,[127 187 483 302 211],474,5,7437,4.341506129597198,20.0,20.0
11713,1,1713,[127 187 483 302 211],666,5,7442,4.341890315052509,20.0,20.0
11714,1,1714,[127 187 483 302 211],90,5,7447,4.3422740524781345,20.0,20.0
11715,1,1715,[111 294   1 678 323],63,0,7447,4.339743589743589,0.0,0.0
11716,1,1716,[294 228  71  88 257],533,5,7452,4.340128130460105,0.0,0.0
11717,1,1717,[302 125  12 228  82],334,4,7456,4.339930151338766,20.0,0.0
11718,1,1718,[127 187 483 302 211],13,5,7461,4.340314136125654,20.0,20.0
11719,1,1719,[127 187 483 302 211],90,5,7466,4.340697674418605,20.0,20.0
11720,1,1720,[127 187 483 302 211],328,5,7471,4.341080766995932,20.0,20.0
11721,1,1721,[127 187 483 302 211],207,5,7476,4.341463414634147,20.0,20.0
11722,1,1722,[127 187 483 302 211],833,3,7479,4.340684852002322,20.0,20.0
11723,1,1723,[127 187 483 302 211],343,5,7484,4.341067285382831,20.0,20.0
11724,1,1724,[127 187 483 302 211],6,5,7489,4.341449275362319,20.0,20.0
11725,1,1725,[127 187 483 302 211],207,5,7494,4.341830822711471,20.0,20.0
11726,1,1726,[127 187 483 302 211],210,5,7499,4.342211928199189,20.0,20.0
11727,1,1727,[127 187 483 302 211],524,5,7504,4.342592592592593,20.0,20.0
11728,1,1728,[118 475 508  56  12],213,5,7509,4.342972816657027,20.0,0.0
11729,1,1729,[127 187 483 302 211],328,5,7514,4.343352601156069,20.0,20.0
11730,1,1730,[127 187 483 302 211],524,5,7519,4.3437319468515305,20.0,20.0
11731,1,1731,[127 187 483 302 211],328,5,7524,4.344110854503464,20.0,20.0
11732,1,1732,[127 187 483 302 211],537,5,7529,4.3444893248701675,20.0,20.0
11733,1,1733,[127 187 483 302 211],90,5,7534,4.344867358708189,20.0,20.0
11734,1,1734,[127 187 483 302 211],537,5,7539,4.345244956772334,20.0,20.0
11735,1,1735,[127 187 483 302 211],13,5,7544,4.345622119815668,20.0,20.0
11736,1,1736,[127 187 483 302 211],6,5,7549,4.345998848589522,20.0,20.0
11737,1,1737,[127 187 483 302 211],328,5,7554,4.346375143843498,20.0,20.0
11738,1,1738,[127 187 483 302 211],339,5,7559,4.346751006325475,20.0,20.0
11739,1,1739,[127 187 483 302 211],90,5,7564,4.347126436781609,20.0,20.0
11740,1,1740,[  4 245 125 597 286],554,2,7566,4.345778288340035,0.0,0.0
11741,1,1741,[127 187 483 302 211],90,5,7571,4.346153846153846,20.0,20.0
11742,1,1742,[603  50 183 200   9],648,3,7574,4.3453815261044175,20.0,20.0
11743,1,1743,[127 187 483 302 211],207,5,7579,4.345756880733945,20.0,20.0
11744,1,1744,[127 187 483 302 211],6,5,7584,4.346131805157593,20.0,20.0
11745,1,1745,[423 546  98 275 191],524,3,7587,4.345360824742268,0.0,20.0
11746,1,1746,[127 187 483 302 211],524,5,7592,4.345735546651403,20.0,20.0
11747,1,1747,[357 179  82 197 186],774,1,7593,4.343821510297483,20.0,0.0
11748,1,1748,[655 183 181 603   7],843,2,7595,4.342481417953116,20.0,0.0
11749,1,1749,[182  50  69  82 194],537,2,7597,4.341142857142857,0.0,20.0
11750,1,1750,[127 187 483 302 211],666,5,7602,4.341519131924614,20.0,20.0
11751,1,1751,[403 196 435  11 301],13,2,7604,4.340182648401827,0.0,0.0
11752,1,1752,[127 187 483 302 211],339,5,7609,4.340559041642898,20.0,20.0
11753,1,1753,[127 187 483 302 211],339,5,7614,4.340935005701255,20.0,20.0
11754,1,1754,[471 405 294 202 185],374,3,7617,4.34017094017094,0.0,0.0
11755,1,1755,[127 187 483 302 211],343,5,7622,4.340546697038724,20.0,20.0
11756,1,1756,[ 79   4 318   8 161],87,5,7627,4.340922026180991,20.0,0.0
11757,1,1757,[127 187 483 302 211],524,5,7632,4.341296928327645,20.0,20.0
11758,1,1758,[127 187 483 302 211],6,5,7637,4.341671404206936,20.0,20.0
11759,1,1759,[127 187 483 302 211],6,5,7642,4.342045454545454,20.0,20.0
11760,1,1760,[127 187 483 302 211],524,5,7647,4.342419080068143,20.0,20.0
11761,1,1761,[127 187 483 302 211],524,5,7652,4.342792281498298,20.0,20.0
11762,1,1762,[127 187 483 302 211],210,5,7657,4.343165059557572,20.0,20.0
11763,1,1763,[127 187 483 302 211],666,5,7662,4.343537414965986,20.0,20.0
11764,1,1764,[127 187 483 302 211],90,5,7667,4.343909348441926,20.0,20.0
11765,1,1765,[ 25  11 237 496 204],666,2,7669,4.342582106455266,0.0,0.0
11766,1,1766,[117 222 118 215 194],524,2,7671,4.341256366723259,0.0,0.0
11767,1,1767,[127 187 483 302 211],833,3,7674,4.340497737556561,20.0,20.0
11768,1,1768,[127 187 483 302 211],90,5,7679,4.340870548332391,20.0,20.0
11769,1,1769,[265 204 289 172 100],387,3,7682,4.3401129943502825,0.0,20.0
11770,1,1770,[176   8 183 187 237],13,4,7686,4.339920948616601,0.0,0.0
11771,1,1771,[127 187 483 302 211],833,3,7689,4.339164785553048,20.0,20.0
11772,1,1772,[127 187 483 302 211],343,5,7694,4.339537507050197,20.0,20.0
11773,1,1773,[127 187 483 302 211],833,3,7697,4.338782412626832,20.0,20.0
11774,1,1774,[127 187 483 302 211],833,3,7700,4.338028169014085,20.0,20.0
11775,1,1775,[127 187 483 302 211],210,5,7705,4.338400900900901,20.0,20.0
11776,1,1776,[127 187 483 302 211],6,5,7710,4.338773213280811,20.0,20.0
11777,1,1777,[127 187 483 302 211],6,5,7715,4.3391451068616425,20.0,20.0
11778,1,1778,[127 187 483 302 211],13,5,7720,4.339516582349635,20.0,20.0
11779,1,1779,[423 111  82  79 185],374,3,7723,4.3387640449438205,0.0,0.0
11780,1,1780,[328 245 132  12 258],533,4,7727,4.3385738349242,20.0,0.0
11781,1,1781,[265  97  11 234 748],804,5,7732,4.338945005611672,0.0,0.0
11782,1,1782,[127 187 483 302 211],474,5,7737,4.339315759955132,20.0,20.0
11783,1,1783,[127 187 483 302 211],13,5,7742,4.339686098654709,20.0,20.0
11784,1,1784,[127 187 483 302 211],833,3,7745,4.338935574229692,20.0,20.0
11785,1,1785,[127 187 483 302 211],207,5,7750,4.339305711086226,20.0,20.0
11786,1,1786,[127 187 483 302 211],90,5,7755,4.339675433687745,20.0,20.0
11787,1,1787,[127 187 483 302 211],833,3,7758,4.3389261744966445,20.0,20.0
11788,1,1788,[127 187 483 302 211],207,5,7763,4.339295695919508,20.0,20.0
11789,1,1789,[ 95  56  88 197  79],454,3,7766,4.338547486033519,0.0,0.0
11790,1,1790,[127 187 483 302 211],13,5,7771,4.33891680625349,20.0,20.0
11791,1,1791,[127 187 483 302 211],537,5,7776,4.339285714285714,20.0,20.0
11792,1,1792,[127 187 483 302 211],6,5,7781,4.339654210819855,20.0,20.0
11793,1,1793,[127 187 483 302 211],666,5,7786,4.340022296544036,20.0,20.0
11794,1,1794,[127 187 483 302 211],474,5,7791,4.3403899721448465,20.0,20.0
11795,1,1795,[127 187 483 302 211],474,5,7796,4.34075723830735,20.0,20.0
11796,1,1796,[127 187 483 302 211],339,5,7801,4.341124095715081,20.0,20.0
11797,1,1797,[127 187 483 302 211],833,3,7804,4.340378197997775,20.0,20.0
11798,1,1798,[288 238 172 143 100],892,4,7808,4.340188993885492,0.0,20.0
11799,1,1799,[127 187 483 302 211],833,3,7811,4.339444444444444,20.0,20.0
11800,1,1800,[127 187 483 302 211],343,5,7816,4.339811215991116,20.0,20.0
11801,1,1801,[127 187 483 302 211],207,5,7821,4.340177580466149,20.0,20.0
11802,1,1802,[127 187 483 302 211],6,5,7826,4.340543538546866,20.0,20.0
11803,1,1803,[127 187 483 302 211],13,5,7831,4.340909090909091,20.0,20.0
11804,1,1804,[127 187 483 302 211],343,5,7836,4.341274238227147,20.0,20.0
11805,1,1805,[127 187 483 302 211],6,5,7841,4.3416389811738645,20.0,20.0
11806,1,1806,[127 187 483 302 211],474,5,7846,4.342003320420587,20.0,20.0
11807,1,1807,[ 69  82  88 483 151],200,4,7850,4.341814159292035,20.0,0.0
11808,1,1808,[ 96 181   8 742   1],533,4,7854,4.3416252072968495,0.0,0.0
11809,1,1809,[127 187 483 302 211],339,5,7859,4.341988950276243,20.0,20.0
11810,1,1810,[127 187 483 302 211],13,5,7864,4.342352291551629,20.0,20.0
11811,1,1811,[127 187 483 302 211],666,5,7869,4.3427152317880795,20.0,20.0
11812,1,1812,[127 187 483 302 211],6,5,7874,4.343077771649201,20.0,20.0
11813,1,1813,[127 187 483 302 211],343,5,7879,4.343439911797134,20.0,20.0
11814,1,1814,[127 187 483 302 211],13,5,7884,4.343801652892562,20.0,20.0
11815,1,1815,[385  11 234 211 168],488,4,7888,4.343612334801762,0.0,0.0
11816,1,1816,[127 187 483 302 211],13,5,7893,4.343973582828839,20.0,20.0
11817,1,1817,[127 187 483 302 211],90,5,7898,4.344334433443344,20.0,20.0
11818,1,1818,[127 187 483 302 211],210,5,7903,4.344694887300714,20.0,20.0
11819,1,1819,[127 187 483 302 211],339,5,7908,4.345054945054945,20.0,20.0
11820,1,1820,[127 187 483 302 211],339,5,7913,4.345414607358594,20.0,20.0
11821,1,1821,[127 187 483 302 211],524,5,7918,4.345773874862788,20.0,20.0
11822,1,1822,[238 322  22 276 186],234,1,7919,4.343938562808558,0.0,0.0
11823,1,1823,[127 187 483 302 211],833,3,7922,4.343201754385965,20.0,20.0
11824,1,1824,[176  15 748 216 196],653,1,7923,4.341369863013699,0.0,0.0
11825,1,1825,[127 187 483 302 211],6,5,7928,4.341730558598028,20.0,20.0
11826,1,1826,[ 98  96 186 181  22],648,5,7933,4.342090859332239,0.0,20.0
11827,1,1827,[121  97 182 202 117],650,1,7934,4.3402625820568925,0.0,0.0
11828,1,1828,[127 187 483 302 211],210,5,7939,4.340623291416074,20.0,20.0
11829,1,1829,[127 187 483 302 211],6,5,7944,4.340983606557377,20.0,20.0
11830,1,1830,[143  89 132 100 186],524,3,7947,4.340251228836701,0.0,20.0
11831,1,1831,[127 187 483 302 211],13,5,7952,4.3406113537117905,20.0,20.0
11832,1,1832,[127 187 483 302 211],833,3,7955,4.3398799781778505,20.0,20.0
11833,1,1833,[127 187 483 302 211],343,5,7960,4.340239912758997,20.0,20.0
11834,1,1834,[127 187 483 302 211],537,5,7965,4.340599455040872,20.0,20.0
11835,1,1835,[127 187 483 302 211],328,5,7970,4.340958605664488,20.0,20.0
11836,1,1836,[301 508 275 175 228],524,2,7972,4.33968426782798,0.0,0.0
11837,1,1837,[127 187 483 302 211],524,5,7977,4.340043525571273,20.0,20.0
11838,1,1838,[127 187 483 302 211],537,5,7982,4.340402392604677,20.0,20.0
11839,1,1839,[127 187 483 302 211],537,5,7987,4.340760869565218,20.0,20.0
11840,1,1840,[742 597 200   4 222],374,4,7991,4.34057577403585,0.0,0.0
11841,1,1841,[127 187 483 302 211],666,5,7996,4.3409337676438655,20.0,20.0
11842,1,1842,[127 187 483 302 211],524,5,8001,4.341291372761801,20.0,20.0
11843,1,1843,[276 403 197  71 265],234,1,8002,4.339479392624729,0.0,0.0
11844,1,1844,[127 187 483 302 211],339,5,8007,4.339837398373984,20.0,20.0
11845,1,1845,[161  97 211 318   8],479,3,8010,4.33911159263272,20.0,0.0
11846,1,1846,[173 144 234 183 153],102,1,8011,4.3373037357877635,0.0,0.0
11847,1,1847,[127 187 483 302 211],210,5,8016,4.337662337662338,20.0,20.0
11848,1,1848,[127 187 483 302 211],210,5,8021,4.3380205516495405,20.0,20.0
11849,1,1849,[127 187 483 302 211],90,5,8026,4.338378378378378,20.0,20.0
11850,1,1850,[ 70  89 228 265  79],194,1,8027,4.336574824419233,0.0,0.0
11851,1,1851,[127 187 483 302 211],343,5,8032,4.336933045356371,20.0,20.0
11852,1,1852,[127 187 483 302 211],833,3,8035,4.336211548839719,20.0,20.0
11853,1,1853,[127 187 483 302 211],339,5,8040,4.336569579288026,20.0,20.0
11854,1,1854,[237  56 180 211 427],7,5,8045,4.336927223719677,0.0,0.0
11855,1,1855,[127 187 483 302 211],537,5,8050,4.337284482758621,20.0,20.0
11856,1,1856,[127 187 483 302 211],6,5,8055,4.337641357027463,20.0,20.0
11857,1,1857,[127 187 483 302 211],13,5,8060,4.33799784714747,20.0,20.0
11858,1,1858,[234  69 286  64 211],379,5,8065,4.338353953738569,0.0,0.0
11859,1,1859,[ 28 204 185 180 121],189,4,8069,4.338172043010752,0.0,0.0
11860,1,1860,[127 187 483 302 211],210,5,8074,4.338527673293928,20.0,20.0
11861,1,1861,[127 187 483 302 211],666,5,8079,4.338882921589689,20.0,20.0
11862,1,1862,[127 187 483 302 211],537,5,8084,4.339237788513151,20.0,20.0
11863,1,1863,[127 187 483 302 211],328,5,8089,4.339592274678112,20.0,20.0
11864,1,1864,[118 135 210 483 276],194,1,8090,4.337801608579088,20.0,0.0
11865,1,1865,[127 187 483 302 211],537,5,8095,4.338156484458735,20.0,20.0
11866,1,1866,[127 187 483 302 211],339,5,8100,4.33851098018211,20.0,20.0
11867,1,1867,[282  95 385 175 127],479,4,8104,4.338329764453961,0.0,20.0
11868,1,1868,[127 187 483 302 211],666,5,8109,4.33868378812199,20.0,20.0
11869,1,1869,[127 187 483 302 211],210,5,8114,4.33903743315508,20.0,20.0
11870,1,1870,[127 187 483 302 211],666,5,8119,4.339390700160342,20.0,20.0
11871,1,1871,[300 183  89  12 215],506,4,8123,4.339209401709402,20.0,0.0
11872,1,1872,[127 187 483 302 211],537,5,8128,4.3395621996796585,20.0,20.0
11873,1,1873,[127 187 483 302 211],524,5,8133,4.33991462113127,20.0,20.0
11874,1,1874,[127 187 483 302 211],474,5,8138,4.3402666666666665,20.0,20.0
11875,1,1875,[187  28 286 603 143],379,5,8143,4.340618336886994,20.0,0.0
11876,1,1876,[127 187 483 302 211],339,5,8148,4.340969632392115,20.0,20.0
11877,1,1877,[294 191 185 186 176],881,3,8151,4.340255591054313,0.0,0.0
11878,1,1878,[127 187 483 302 211],343,5,8156,4.340606705694518,20.0,20.0
11879,1,1879,[180 496 181  89 121],380,2,8158,4.339361702127659,0.0,0.0
11880,1,1880,[127 187 483 302 211],537,5,8163,4.339712918660287,20.0,20.0
11881,1,1881,[127 187 483 302 211],13,5,8168,4.340063761955367,20.0,20.0
11882,1,1882,[127 187 483 302 211],90,5,8173,4.340414232607541,20.0,20.0
11883,1,1883,[127 187 483 302 211],328,5,8178,4.340764331210191,20.0,20.0
11884,1,1884,[185 153 143 276  69],207,4,8182,4.340583554376658,0.0,0.0
11885,1,1885,[127 187 483 302 211],90,5,8187,4.340933191940615,20.0,20.0
11886,1,1886,[127 187 483 302 211],343,5,8192,4.341282458929518,20.0,20.0
11887,1,1887,[127 187 483 302 211],90,5,8197,4.341631355932203,20.0,20.0
11888,1,1888,[127 187 483 302 211],207,5,8202,4.341979883536262,20.0,20.0
11889,1,1889,[127 187 483 302 211],339,5,8207,4.342328042328043,20.0,20.0
11890,1,1890,[127 187 483 302 211],6,5,8212,4.34267583289265,20.0,20.0
11891,1,1891,[127 187 483 302 211],833,3,8215,4.341966173361522,20.0,20.0
11892,1,1892,[127 187 483 302 211],343,5,8220,4.342313787638669,20.0,20.0
11893,1,1893,[127 187 483 302 211],13,5,8225,4.342661034846885,20.0,20.0
11894,1,1894,[127 187 483 302 211],90,5,8230,4.3430079155672825,20.0,20.0
11895,1,1895,[286 200 515 276 435],59,4,8234,4.3428270042194095,0.0,0.0
11896,1,1896,[127 187 483 302 211],474,5,8239,4.343173431734317,20.0,20.0
11897,1,1897,[127 187 483 302 211],537,5,8244,4.3435194942044255,20.0,20.0
11898,1,1898,[127 187 483 302 211],210,5,8249,4.343865192206424,20.0,20.0
11899,1,1899,[127 187 483 302 211],474,5,8254,4.3442105263157895,20.0,20.0
11900,1,1900,[135  50 204 333 100],13,4,8258,4.3440294581799055,0.0,40.0
11901,1,1901,[127 187 483 302 211],833,3,8261,4.343322818086225,20.0,20.0
11902,1,1902,[127 187 483 302 211],328,5,8266,4.343667892800841,20.0,20.0
11903,1,1903,[127 187 483 302 211],90,5,8271,4.344012605042017,20.0,20.0
11904,1,1904,[127 187 483 302 211],328,5,8276,4.344356955380578,20.0,20.0
11905,1,1905,[127 187 483 302 211],210,5,8281,4.344700944386149,20.0,20.0
11906,1,1906,[127 187 483 302 211],537,5,8286,4.345044572627163,20.0,20.0
11907,1,1907,[127 187 483 302 211],339,5,8291,4.34538784067086,20.0,20.0
11908,1,1908,[127 187 483 302 211],207,5,8296,4.345730749083289,20.0,20.0
11909,1,1909,[127 187 483 302 211],207,5,8301,4.346073298429319,20.0,20.0
11910,1,1910,[127 187 483 302 211],207,5,8306,4.3464154892726325,20.0,20.0
11911,1,1911,[302 475 328 202 276],90,2,8308,4.345188284518828,0.0,0.0
11912,1,1912,[127 187 483 302 211],833,3,8311,4.344485101934135,20.0,20.0
11913,1,1913,[127 187 483 302 211],328,5,8316,4.344827586206897,20.0,20.0
11914,1,1914,[127 187 483 302 211],474,5,8321,4.345169712793734,20.0,20.0
11915,1,1915,[127 187 483 302 211],210,5,8326,4.345511482254698,20.0,20.0
11916,1,1916,[127 187 483 302 211],328,5,8331,4.34585289514867,20.0,20.0
11917,1,1917,[127 187 483 302 211],207,5,8336,4.346193952033368,20.0,20.0
11918,1,1918,[127 187 483 302 211],343,5,8341,4.346534653465347,20.0,20.0
11919,1,1919,[127 187 483 302 211],474,5,8346,4.346875,20.0,20.0
11920,1,1920,[127 187 483 302 211],474,5,8351,4.347214992191567,20.0,20.0
11921,1,1921,[127 187 483 302 211],6,5,8356,4.347554630593132,20.0,20.0
11922,1,1922,[127 187 483 302 211],207,5,8361,4.3478939157566305,20.0,20.0
11923,1,1923,[127 187 483 302 211],666,5,8366,4.348232848232848,20.0,20.0
11924,1,1924,[127 187 483 302 211],833,3,8369,4.347532467532467,20.0,20.0
11925,1,1925,[323 111 215   4 202],13,4,8373,4.3473520249221185,0.0,0.0
11926,1,1926,[  4 161 265  70 748],524,4,8377,4.3471717695900365,0.0,0.0
11927,1,1927,[127 187 483 302 211],210,5,8382,4.347510373443983,20.0,20.0
11928,1,1928,[127 187 483 302 211],524,5,8387,4.347848626231208,20.0,20.0
11929,1,1929,[127 187 483 302 211],524,5,8392,4.3481865284974095,20.0,20.0
11930,1,1930,[127 187 483 302 211],207,5,8397,4.348524080787157,20.0,20.0
11931,1,1931,[127 187 483 302 211],6,5,8402,4.348861283643893,20.0,20.0
11932,1,1932,[127 187 483 302 211],339,5,8407,4.349198137609933,20.0,20.0
11933,1,1933,[546 151 568  95 357],899,3,8410,4.348500517063082,20.0,0.0
11934,1,1934,[127 187 483 302 211],328,5,8415,4.348837209302325,20.0,20.0
11935,1,1935,[127 187 483 302 211],474,5,8420,4.349173553719008,20.0,20.0
11936,1,1936,[191  88 258 195  50],234,2,8422,4.347960764068147,0.0,20.0
11937,1,1937,[127 187 483 302 211],339,5,8427,4.348297213622291,20.0,20.0
11938,1,1938,[385   9  22 228 132],194,2,8429,4.34708612686952,0.0,0.0
11939,1,1939,[127 187 483 302 211],537,5,8434,4.347422680412371,20.0,20.0
11940,1,1940,[127 187 483 302 211],339,5,8439,4.347758887171561,20.0,20.0
11941,1,1941,[127 187 483 302 211],6,5,8444,4.348094747682802,20.0,20.0
11942,1,1942,[194  50 271 127 181],13,4,8448,4.347915594441585,0.0,40.0
11943,1,1943,[127 187 483 302 211],328,5,8453,4.348251028806584,20.0,20.0
11944,1,1944,[127 187 483 302 211],328,5,8458,4.348586118251928,20.0,20.0
11945,1,1945,[151 234 302 173 118],378,4,8462,4.348406988694759,0.0,0.0
11946,1,1946,[127 187 483 302 211],210,5,8467,4.3487416538264,20.0,20.0
11947,1,1947,[127 187 483 302 211],833,3,8470,4.348049281314168,20.0,20.0
11948,1,1948,[127 187 483 302 211],210,5,8475,4.348383786557209,20.0,20.0
11949,1,1949,[127 187 483 302 211],666,5,8480,4.348717948717948,20.0,20.0
11950,1,1950,[127 187 483 302 211],474,5,8485,4.349051768323936,20.0,20.0
11951,1,1951,[127 187 483 302 211],343,5,8490,4.349385245901639,20.0,20.0
11952,1,1952,[187 313 435 200 195],102,1,8491,4.347670250896058,0.0,0.0
11953,1,1953,[127 187 483 302 211],833,3,8494,4.346980552712385,20.0,20.0
11954,1,1954,[127 187 483 302 211],6,5,8499,4.347314578005115,20.0,20.0
11955,1,1955,[127 187 483 302 211],524,5,8504,4.347648261758692,20.0,20.0
11956,1,1956,[127 187 483 302 211],524,5,8509,4.347981604496678,20.0,20.0
11957,1,1957,[127 187 483 302 211],666,5,8514,4.348314606741573,20.0,20.0
11958,1,1958,[127 187 483 302 211],524,5,8519,4.348647269014803,20.0,20.0
11959,1,1959,[127 187 483 302 211],666,5,8524,4.348979591836735,20.0,20.0
11960,1,1960,[127 187 483 302 211],90,5,8529,4.34931157572667,20.0,20.0
11961,1,1961,[127 187 483 302 211],207,5,8534,4.349643221202855,20.0,20.0
11962,1,1962,[127 187 483 302 211],339,5,8539,4.349974528782476,20.0,20.0
11963,1,1963,[127 187 483 302 211],328,5,8544,4.35030549898167,20.0,20.0
11964,1,1964,[127 187 483 302 211],343,5,8549,4.350636132315522,20.0,20.0
11965,1,1965,[127 187 483 302 211],13,5,8554,4.350966429298067,20.0,20.0
11966,1,1966,[127 187 483 302 211],524,5,8559,4.351296390442298,20.0,20.0
11967,1,1967,[127 187 483 302 211],474,5,8564,4.3516260162601625,20.0,20.0
11968,1,1968,[127 187 483 302 211],666,5,8569,4.351955307262569,20.0,20.0
11969,1,1969,[322 175  95 210 195],524,1,8570,4.350253807106599,0.0,0.0
11970,1,1970,[127 187 483 302 211],666,5,8575,4.350583460172501,20.0,20.0
11971,1,1971,[127 187 483 302 211],90,5,8580,4.350912778904665,20.0,20.0
11972,1,1972,[127 187 483 302 211],6,5,8585,4.351241763811455,20.0,20.0
11973,1,1973,[313  95 181  89 286],650,3,8588,4.350557244174265,0.0,0.0
11974,1,1974,[127 187 483 302 211],474,5,8593,4.350886075949367,20.0,20.0
11975,1,1975,[127 187 483 302 211],537,5,8598,4.351214574898785,20.0,20.0
11976,1,1976,[121  56 186 211  50],318,2,8600,4.350025290844714,0.0,20.0
11977,1,1977,[313 655 546  22  64],64,4,8604,4.349848331648129,0.0,0.0
11978,1,1978,[132 143 405 153 222],653,0,8604,4.347650328448712,0.0,0.0
11979,1,1979,[127 187 483 302 211],524,5,8609,4.347979797979798,20.0,20.0
11980,1,1980,[144 173 357 235 483],650,3,8612,4.3472993437657745,40.0,0.0
11981,1,1981,[127 187 483 302 211],13,5,8617,4.347628657921292,20.0,20.0
11982,1,1982,[127 187 483 302 211],339,5,8622,4.3479576399394855,20.0,20.0
11983,1,1983,[127 187 483 302 211],537,5,8627,4.348286290322581,20.0,20.0
11984,1,1984,[127 187 483 302 211],328,5,8632,4.348614609571788,20.0,20.0
11985,1,1985,[127 187 483 302 211],524,5,8637,4.348942598187311,20.0,20.0
11986,1,1986,[127 187 483 302 211],210,5,8642,4.349270256668344,20.0,20.0
11987,1,1987,[127 187 483 302 211],210,5,8647,4.349597585513078,20.0,20.0
11988,1,1988,[300 294 195  50 258],116,2,8649,4.34841628959276,0.0,20.0
11989,1,1989,[127 187 483 302 211],210,5,8654,4.3487437185929645,20.0,20.0
11990,1,1990,[ 22   4  15 135 196],474,5,8659,4.349070818684078,0.0,0.0
11991,1,1991,[186 100  89 302 197],524,4,8663,4.348895582329317,0.0,20.0
11992,1,1992,[127 187 483 302 211],474,5,8668,4.349222277972905,20.0,20.0
11993,1,1993,[127 187 483 302 211],13,5,8673,4.349548645937814,20.0,20.0
11994,1,1994,[127 187 483 302 211],524,5,8678,4.349874686716792,20.0,20.0
11995,1,1995,[127 187 483 302 211],537,5,8683,4.3502004008016035,20.0,20.0
11996,1,1996,[100  96 121 195  95],804,4,8687,4.3500250375563345,0.0,20.0
11997,1,1997,[ 28  50 161 173 568],378,5,8692,4.35035035035035,0.0,20.0
11998,1,1998,[127 187 483 302 211],207,5,8697,4.350675337668834,20.0,20.0
11999,1,1999,[127 187 483 302 211],328,5,8702,4.351,20.0,20.0
12000,1,2000,[127 187 483 302 211],6,5,8707,4.351324337831085,20.0,20.0
12001,1,2001,[180 168 196 151 435],749,5,8712,4.351648351648351,0.0,0.0
12002,1,2002,[127 187 483 302 211],328,5,8717,4.351972041937095,20.0,20.0
12003,1,2003,[127 187 483 302 211],524,5,8722,4.352295409181637,20.0,20.0
12004,1,2004,[ 97 318  98 173 742],59,4,8726,4.35211970074813,20.0,20.0
12005,1,2005,[127 187 483 302 211],6,5,8731,4.352442671984048,20.0,20.0
12006,1,2006,[127 187 483 302 211],328,5,8736,4.352765321375187,20.0,20.0
12007,1,2007,[127 187 483 302 211],207,5,8741,4.35308764940239,20.0,20.0
12008,1,2008,[475 179 427 496 127],474,5,8746,4.353409656545545,0.0,20.0
12009,1,2009,[127 187 483 302 211],524,5,8751,4.353731343283582,20.0,20.0
12010,1,2010,[127 187 483 302 211],90,5,8756,4.35405271009448,20.0,20.0
12011,1,2011,[127 187 483 302 211],537,5,8761,4.354373757455268,20.0,20.0
12012,1,2012,[127 187 483 302 211],666,5,8766,4.3546944858420265,20.0,20.0
12013,1,2013,[127 187 483 302 211],343,5,8771,4.355014895729891,20.0,20.0
12014,1,2014,[ 22  97 269 153  71],488,2,8773,4.3538461538461535,0.0,0.0
12015,1,2015,[ 22  50 318 196 172],378,5,8778,4.354166666666667,20.0,20.0
12016,1,2016,[127 187 483 302 211],833,3,8781,4.353495290034705,20.0,20.0
12017,1,2017,[127 187 483 302 211],524,5,8786,4.353815659068385,20.0,20.0
12018,1,2018,[127 187 483 302 211],6,5,8791,4.354135710747895,20.0,20.0
12019,1,2019,[127 187 483 302 211],537,5,8796,4.354455445544555,20.0,20.0
12020,1,2020,[127 187 483 302 211],343,5,8801,4.354774863928748,20.0,20.0
12021,1,2021,[127 187 483 302 211],13,5,8806,4.355093966369931,20.0,20.0
12022,1,2022,[202 132 234 100 174],308,3,8809,4.3544241225902125,0.0,40.0
12023,1,2023,[127 187 483 302 211],666,5,8814,4.354743083003952,20.0,20.0
12024,1,2024,[216  96   1 172 173],326,2,8816,4.35358024691358,0.0,0.0
12025,1,2025,[127 187 483 302 211],90,5,8821,4.353899308983218,20.0,20.0
12026,1,2026,[127 187 483 302 211],328,5,8826,4.35421805624075,20.0,20.0
12027,1,2027,[127 187 483 302 211],210,5,8831,4.354536489151874,20.0,20.0
12028,1,2028,[127 187 483 302 211],90,5,8836,4.35485460818137,20.0,20.0
12029,1,2029,[127 187 483 302 211],90,5,8841,4.355172413793103,20.0,20.0
12030,1,2030,[127 187 483 302 211],833,3,8844,4.3545051698670605,20.0,20.0
12031,1,2031,[127 187 483 302 211],13,5,8849,4.354822834645669,20.0,20.0
12032,1,2032,[515 655 196  69 748],474,4,8853,4.354648303000492,0.0,0.0
12033,1,2033,[127 187 483 302 211],474,5,8858,4.354965585054081,20.0,20.0
12034,1,2034,[127 187 483 302 211],666,5,8863,4.355282555282555,20.0,20.0
12035,1,2035,[127 187 483 302 211],339,5,8868,4.355599214145383,20.0,20.0
12036,1,2036,[127 187 483 302 211],6,5,8873,4.355915562101129,20.0,20.0
12037,1,2037,[127 187 483 302 211],666,5,8878,4.356231599607458,20.0,20.0
12038,1,2038,[ 88 176 161 179 197],474,5,8883,4.356547327121138,0.0,0.0
12039,1,2039,[127 187 483 302 211],6,5,8888,4.356862745098039,20.0,20.0
12040,1,2040,[127 187 483 302 211],210,5,8893,4.35717785399314,20.0,20.0
12041,1,2041,[127 187 483 302 211],666,5,8898,4.357492654260529,20.0,20.0
12042,1,2042,[127 187 483 302 211],90,5,8903,4.357807146353402,20.0,20.0
12043,1,2043,[127 187 483 302 211],207,5,8908,4.35812133072407,20.0,20.0
12044,1,2044,[127 187 483 302 211],90,5,8913,4.358435207823961,20.0,20.0
12045,1,2045,[127 187 483 302 211],666,5,8918,4.3587487781036165,20.0,20.0
12046,1,2046,[127 187 483 302 211],474,5,8923,4.3590620420127015,20.0,20.0
12047,1,2047,[127 187 483 302 211],833,3,8926,4.3583984375,20.0,20.0
12048,1,2048,[127 187 483 302 211],6,5,8931,4.358711566617862,20.0,20.0
12049,1,2049,[127 187 483 302 211],6,5,8936,4.359024390243903,20.0,20.0
12050,1,2050,[127 187 483 302 211],328,5,8941,4.359336908824964,20.0,20.0
12051,1,2051,[  7 357 546 191 173],7,5,8946,4.359649122807017,20.0,0.0
12052,1,2052,[127 187 483 302 211],833,3,8949,4.358986848514369,20.0,20.0
12053,1,2053,[127 187 483 302 211],666,5,8954,4.359298928919182,20.0,20.0
12054,1,2054,[127 187 483 302 211],537,5,8959,4.359610705596107,20.0,20.0
12055,1,2055,[ 82 258  12 238  96],13,3,8962,4.358949416342412,20.0,0.0
12056,1,2056,[127 187 483 302 211],210,5,8967,4.359261059795819,20.0,20.0
12057,1,2057,[127 187 483 302 211],343,5,8972,4.359572400388727,20.0,20.0
12058,1,2058,[127 187 483 302 211],666,5,8977,4.359883438562409,20.0,20.0
12059,1,2059,[127 187 483 302 211],6,5,8982,4.360194174757281,20.0,20.0
12060,1,2060,[235 172 435 496  69],194,3,8985,4.359534206695779,0.0,0.0
12061,1,2061,[127 187 483 302 211],328,5,8990,4.3598448108632395,20.0,20.0
12062,1,2062,[127 187 483 302 211],339,5,8995,4.360155113911779,20.0,20.0
12063,1,2063,[127 187 483 302 211],90,5,9000,4.3604651162790695,20.0,20.0
12064,1,2064,[196 125  50   8  70],144,5,9005,4.3607748184019375,0.0,20.0
12065,1,2065,[127 187 483 302 211],13,5,9010,4.36108422071636,20.0,20.0
12066,1,2066,[127 187 483 302 211],343,5,9015,4.361393323657475,20.0,20.0
12067,1,2067,[127 187 483 302 211],90,5,9020,4.361702127659575,20.0,20.0
12068,1,2068,[127 187 483 302 211],207,5,9025,4.362010633156114,20.0,20.0
12069,1,2069,[127 187 483 302 211],343,5,9030,4.36231884057971,20.0,20.0
12070,1,2070,[127 187 483 302 211],666,5,9035,4.362626750362144,20.0,20.0
12071,1,2071,[234  98   4 200  89],328,4,9039,4.362451737451737,0.0,20.0
12072,1,2072,[127 187 483 302 211],524,5,9044,4.362759286058852,20.0,20.0
12073,1,2073,[127 187 483 302 211],13,5,9049,4.363066538090646,20.0,20.0
12074,1,2074,[127 187 483 302 211],90,5,9054,4.363373493975904,20.0,20.0
12075,1,2075,[127 187 483 302 211],328,5,9059,4.363680154142582,20.0,20.0
12076,1,2076,[127 187 483 302 211],524,5,9064,4.363986519017814,20.0,20.0
12077,1,2077,[127 187 483 302 211],328,5,9069,4.364292589027912,20.0,20.0
12078,1,2078,[195   7 322 210 181],474,5,9074,4.364598364598365,0.0,0.0
12079,1,2079,[127 187 483 302 211],210,5,9079,4.3649038461538465,20.0,20.0
12080,1,2080,[127 187 483 302 211],343,5,9084,4.365209034118212,20.0,20.0
12081,1,2081,[127 187 483 302 211],524,5,9089,4.365513928914505,20.0,20.0
12082,1,2082,[125 143 187  28 135],892,4,9093,4.365338454152664,0.0,0.0
12083,1,2083,[127 187 483 302 211],524,5,9098,4.365642994241843,20.0,20.0
12084,1,2084,[127 187 483 302 211],524,5,9103,4.365947242206235,20.0,20.0
12085,1,2085,[127 187 483 302 211],328,5,9108,4.366251198465964,20.0,20.0
12086,1,2086,[143 144 176 204 200],479,4,9112,4.366075706756109,0.0,0.0
12087,1,2087,[127 187 483 302 211],339,5,9117,4.366379310344827,20.0,20.0
12088,1,2088,[127 187 483 302 211],537,5,9122,4.36668262326472,20.0,20.0
12089,1,2089,[127 121  71 197 216],64,2,9124,4.36555023923445,0.0,20.0
12090,1,2090,[385 405   4 234 568],533,2,9126,4.36441893830703,0.0,0.0
12091,1,2091,[127 187 483 302 211],207,5,9131,4.36472275334608,20.0,20.0
12092,1,2092,[127 187 483 302 211],524,5,9136,4.365026278069756,20.0,20.0
12093,1,2093,[127 187 483 302 211],666,5,9141,4.365329512893982,20.0,20.0
12094,1,2094,[127 187 483 302 211],207,5,9146,4.365632458233891,20.0,20.0
12095,1,2095,[127 187 483 302 211],328,5,9151,4.3659351145038165,20.0,20.0
12096,1,2096,[127 187 483 302 211],537,5,9156,4.36623748211731,20.0,20.0
12097,1,2097,[174 234 210 144 196],374,4,9160,4.3660629170638705,0.0,20.0
12098,1,2098,[127 187 483 302 211],13,5,9165,4.3663649356836585,20.0,20.0
12099,1,2099,[475 385 195 153 182],374,3,9168,4.365714285714286,0.0,0.0
12100,1,2100,[127 187 483 302 211],537,5,9173,4.366016182770109,20.0,20.0
12101,1,2101,[127 187 483 302 211],6,5,9178,4.366317792578497,20.0,20.0
12102,1,2102,[234 475 117   9 222],339,4,9182,4.366143604374702,0.0,0.0
12103,1,2103,[127 187 483 302 211],13,5,9187,4.366444866920152,20.0,20.0
12104,1,2104,[ 71 204 210 186 161],59,3,9190,4.365795724465558,0.0,0.0
12105,1,2105,[127 187 483 302 211],833,3,9193,4.365147198480532,20.0,20.0
12106,1,2106,[127 187 483 302 211],6,5,9198,4.365448504983389,20.0,20.0
12107,1,2107,[181   9   4 322 191],308,4,9202,4.3652751423149905,0.0,0.0
12108,1,2108,[ 88 568 588  95 257],881,3,9205,4.364627785680417,0.0,0.0
12109,1,2109,[127 187 483 302 211],537,5,9210,4.3649289099526065,20.0,20.0
12110,1,2110,[127 187 483 302 211],339,5,9215,4.365229748934154,20.0,20.0
12111,1,2111,[185 197 318 588 257],804,5,9220,4.365530303030303,20.0,0.0
12112,1,2112,[127 187 483 302 211],537,5,9225,4.365830572645527,20.0,20.0
12113,1,2113,[127 187 483 302 211],6,5,9230,4.366130558183539,20.0,20.0
12114,1,2114,[125 202  69 546 144],194,2,9232,4.365011820330969,0.0,0.0
12115,1,2115,[127 187 483 302 211],339,5,9237,4.36531190926276,20.0,20.0
12116,1,2116,[127 187 483 302 211],328,5,9242,4.3656117146905995,20.0,20.0
12117,1,2117,[127 187 483 302 211],833,3,9245,4.364966949952786,20.0,20.0
12118,1,2118,[ 25  11  12 183 435],7,3,9248,4.364322793770646,20.0,0.0
12119,1,2119,[127 187 483 302 211],833,3,9251,4.363679245283019,20.0,20.0
12120,1,2120,[127 187 483 302 211],210,5,9256,4.363979255068364,20.0,20.0
12121,1,2121,[127 187 483 302 211],666,5,9261,4.364278982092365,20.0,20.0
12122,1,2122,[127 187 483 302 211],90,5,9266,4.364578426754592,20.0,20.0
12123,1,2123,[127 187 483 302 211],537,5,9271,4.364877589453861,20.0,20.0
12124,1,2124,[143 258 403 125   8],533,3,9274,4.364235294117647,0.0,0.0
12125,1,2125,[127 187 483 302 211],524,5,9279,4.3645343367826905,20.0,20.0
12126,1,2126,[127 187 483 302 211],6,5,9284,4.364833098260461,20.0,20.0
12127,1,2127,[127 187 483 302 211],6,5,9289,4.365131578947368,20.0,20.0
12128,1,2128,[127 187 483 302 211],524,5,9294,4.365429779239079,20.0,20.0
12129,1,2129,[127 187 483 302 211],524,5,9299,4.365727699530517,20.0,20.0
12130,1,2130,[127 187 483 302 211],207,5,9304,4.366025340215861,20.0,20.0
12131,1,2131,[127 187 483 302 211],13,5,9309,4.3663227016885555,20.0,20.0
12132,1,2132,[127 187 483 302 211],524,5,9314,4.366619784341303,20.0,20.0
12133,1,2133,[237   4  95 275  56],524,2,9316,4.365510777881912,0.0,0.0
12134,1,2134,[127 187 483 302 211],13,5,9321,4.365807962529274,20.0,20.0
12135,1,2135,[127 187 483 302 211],207,5,9326,4.366104868913857,20.0,20.0
12136,1,2136,[127 187 483 302 211],666,5,9331,4.366401497426298,20.0,20.0
12137,1,2137,[127 187 483 302 211],210,5,9336,4.366697848456502,20.0,20.0
12138,1,2138,[127 187 483 302 211],210,5,9341,4.366993922393642,20.0,20.0
12139,1,2139,[127 187 483 302 211],90,5,9346,4.367289719626168,20.0,20.0
12140,1,2140,[258 483 385 546   8],479,3,9349,4.366651097617935,20.0,0.0
12141,1,2141,[127 187 483 302 211],90,5,9354,4.366946778711484,20.0,20.0
12142,1,2142,[127 187 483 302 211],90,5,9359,4.36724218385441,20.0,20.0
12143,1,2143,[127 187 483 302 211],343,5,9364,4.367537313432836,20.0,20.0
12144,1,2144,[127 187 483 302 211],6,5,9369,4.367832167832168,20.0,20.0
12145,1,2145,[127 187 483 302 211],474,5,9374,4.368126747437092,20.0,20.0
12146,1,2146,[127 187 483 302 211],90,5,9379,4.368421052631579,20.0,20.0
12147,1,2147,[ 12  98 748 403 268],13,4,9383,4.368249534450651,20.0,20.0
12148,1,2148,[144 546 357 176 235],643,4,9387,4.368078175895765,20.0,0.0
12149,1,2149,[127 187 483 302 211],6,5,9392,4.368372093023256,20.0,20.0
12150,1,2150,[151  79  98 127  82],892,4,9396,4.368200836820083,0.0,40.0
12151,1,2151,[127 187 483 302 211],90,5,9401,4.368494423791821,20.0,20.0
12152,1,2152,[127 187 483 302 211],524,5,9406,4.368787738039944,20.0,20.0
12153,1,2153,[111 153 183 196 475],334,4,9410,4.368616527390901,0.0,0.0
12154,1,2154,[333 237  97 323 175],13,3,9413,4.3679814385150815,0.0,0.0
12155,1,2155,[  9 257  89 228 144],749,3,9416,4.36734693877551,0.0,0.0
12156,1,2156,[127 187 483 302 211],207,5,9421,4.367640241075568,20.0,20.0
12157,1,2157,[121 191  15 144 175],648,3,9424,4.367006487488415,0.0,0.0
12158,1,2158,[216  22 286 228 294],95,4,9428,4.366836498378879,0.0,0.0
12159,1,2159,[127 187 483 302 211],6,5,9433,4.36712962962963,20.0,20.0
12160,1,2160,[127 187 483 302 211],90,5,9438,4.3674224895881535,20.0,20.0
12161,1,2161,[127 187 483 302 211],328,5,9443,4.367715078630897,20.0,20.0
12162,1,2162,[127 187 483 302 211],210,5,9448,4.368007397133611,20.0,20.0
12163,1,2163,[196 175 265 655 161],95,3,9451,4.367375231053605,0.0,0.0
12164,1,2164,[127 187 483 302 211],210,5,9456,4.367667436489607,20.0,20.0
12165,1,2165,[191 210  69 121 483],694,5,9461,4.3679593721144965,20.0,0.0
12166,1,2166,[127 187 483 302 211],339,5,9466,4.3682510383018,20.0,20.0
12167,1,2167,[127 187 483 302 211],474,5,9471,4.368542435424354,20.0,20.0
12168,1,2168,[222 588 176 135 435],378,3,9474,4.3679114799446745,0.0,0.0
12169,1,2169,[127 187 483 302 211],339,5,9479,4.368202764976958,20.0,20.0
12170,1,2170,[127 187 483 302 211],524,5,9484,4.368493781667435,20.0,20.0
12171,1,2171,[127 187 483 302 211],343,5,9489,4.3687845303867405,20.0,20.0
12172,1,2172,[127 187 483 302 211],833,3,9492,4.368154624942476,20.0,20.0
12173,1,2173,[127 187 483 302 211],90,5,9497,4.368445262189512,20.0,20.0
12174,1,2174,[197 211 132 273 483],10,5,9502,4.368735632183908,20.0,0.0
12175,1,2175,[127 187 483 302 211],474,5,9507,4.369025735294118,20.0,20.0
12176,1,2176,[127 187 483 302 211],6,5,9512,4.3693155718879195,20.0,20.0
12177,1,2177,[127 187 483 302 211],339,5,9517,4.369605142332415,20.0,20.0
12178,1,2178,[121 655 195 161 357],387,2,9519,4.368517668655347,20.0,0.0
12179,1,2179,[127 187 483 302 211],328,5,9524,4.368807339449542,20.0,20.0
12180,1,2180,[127 187 483 302 211],343,5,9529,4.3690967446125635,20.0,20.0
12181,1,2181,[127 187 483 302 211],833,3,9532,4.3684692942254815,20.0,20.0
12182,1,2182,[127 187 483 302 211],524,5,9537,4.368758589097572,20.0,20.0
12183,1,2183,[180 186 215   8 181],271,5,9542,4.369047619047619,0.0,0.0
12184,1,2184,[127 187 483 302 211],666,5,9547,4.369336384439359,20.0,20.0
12185,1,2185,[127 187 483 302 211],207,5,9552,4.369624885635864,20.0,20.0
12186,1,2186,[127 187 483 302 211],13,5,9557,4.3699131229995425,20.0,20.0
12187,1,2187,[127 187 483 302 211],524,5,9562,4.3702010968921385,20.0,20.0
12188,1,2188,[655  71 597  96  11],7,3,9565,4.369575148469621,0.0,0.0
12189,1,2189,[ 89 187  79 161 211],474,5,9570,4.36986301369863,0.0,0.0
12190,1,2190,[127 187 483 302 211],524,5,9575,4.370150616157006,20.0,20.0
12191,1,2191,[127 187 483 302 211],6,5,9580,4.37043795620438,20.0,20.0
12192,1,2192,[127 187 483 302 211],474,5,9585,4.370725034199727,20.0,20.0
12193,1,2193,[127 187 483 302 211],207,5,9590,4.371011850501367,20.0,20.0
12194,1,2194,[318   4 471 423   9],328,3,9593,4.370387243735763,20.0,0.0
12195,1,2195,[127 187 483 302 211],6,5,9598,4.370673952641166,20.0,20.0
12196,1,2196,[180 238 603 588 216],804,5,9603,4.370960400546199,20.0,0.0
12197,1,2197,[127 187 483 302 211],833,3,9606,4.370336669699727,20.0,20.0
12198,1,2198,[127 187 483 302 211],524,5,9611,4.370623010459299,20.0,20.0
12199,1,2199,[127 187 483 302 211],328,5,9616,4.370909090909091,20.0,20.0
12200,1,2200,[127 187 483 302 211],339,5,9621,4.371194911403907,20.0,20.0
12201,1,2201,[301 195 135 238  50],524,3,9624,4.370572207084469,0.0,20.0
12202,1,2202,[127 187 483 302 211],210,5,9629,4.370857921016795,20.0,20.0
12203,1,2203,[127 187 483 302 211],210,5,9634,4.371143375680581,20.0,20.0
12204,1,2204,[127 187 483 302 211],833,3,9637,4.370521541950113,20.0,20.0
12205,1,2205,[127 187 483 302 211],833,3,9640,4.369900271985494,20.0,20.0
12206,1,2206,[127 187 483 302 211],90,5,9645,4.370185772541912,20.0,20.0
12207,1,2207,[127 187 483 302 211],666,5,9650,4.370471014492754,20.0,20.0
12208,1,2208,[403  71  89 176 568],830,4,9654,4.370303304662744,0.0,0.0
12209,1,2209,[127 187 483 302 211],537,5,9659,4.370588235294117,20.0,20.0
12210,1,2210,[174  97 655 385 300],454,3,9662,4.369968340117594,0.0,20.0
12211,1,2211,[234 265  88  22 483],200,5,9667,4.370253164556962,20.0,0.0
12212,1,2212,[127 187 483 302 211],13,5,9672,4.370537731586082,20.0,20.0
12213,1,2213,[127 187 483 302 211],474,5,9677,4.370822041553748,20.0,20.0
12214,1,2214,[ 70 202   9  64 204],234,1,9678,4.369300225733634,0.0,0.0
12215,1,2215,[125   8  89 135  11],7,4,9682,4.36913357400722,0.0,0.0
12216,1,2216,[127 187 483 302 211],833,3,9685,4.36851601262968,20.0,20.0
12217,1,2217,[127 187 483 302 211],343,5,9690,4.368800721370604,20.0,20.0
12218,1,2218,[ 15  82  71 294 202],830,3,9693,4.3681838666065795,0.0,0.0
12219,1,2219,[135   7 100 151 323],59,5,9698,4.3684684684684685,0.0,20.0
12220,1,2220,[471  56 546 121  50],328,3,9701,4.367852318775326,0.0,20.0
12221,1,2221,[127 187 483 302 211],339,5,9706,4.368136813681368,20.0,20.0
12222,1,2222,[257 268   7 118 187],669,1,9707,4.366621682411156,0.0,0.0
12223,1,2223,[127 187 483 302 211],210,5,9712,4.366906474820144,20.0,20.0
12224,1,2224,[655 127 168 135  79],881,4,9716,4.366741573033708,0.0,20.0
12225,1,2225,[127 187 483 302 211],13,5,9721,4.367026055705301,20.0,20.0
12226,1,2226,[405 111 275  96 318],13,2,9723,4.365963179164796,20.0,0.0
12227,1,2227,[127 187 483 302 211],207,5,9728,4.36624775583483,20.0,20.0
12228,1,2228,[127 187 483 302 211],537,5,9733,4.366532077164647,20.0,20.0
12229,1,2229,[127 187 483 302 211],474,5,9738,4.366816143497758,20.0,20.0
12230,1,2230,[127 187 483 302 211],13,5,9743,4.367099955177051,20.0,20.0
12231,1,2231,[127 187 483 302 211],524,5,9748,4.367383512544803,20.0,20.0
12232,1,2232,[127 187 483 302 211],13,5,9753,4.367666815942678,20.0,20.0
12233,1,2233,[127 187 483 302 211],328,5,9758,4.3679498657117275,20.0,20.0
12234,1,2234,[204 111 197 144 423],899,4,9762,4.367785234899329,0.0,0.0
12235,1,2235,[127 187 483 302 211],339,5,9767,4.3680679785330945,20.0,20.0
12236,1,2236,[127 187 483 302 211],207,5,9772,4.368350469378632,20.0,20.0
12237,1,2237,[127 187 483 302 211],343,5,9777,4.368632707774799,20.0,20.0
12238,1,2238,[127 187 483 302 211],13,5,9782,4.368914694059848,20.0,20.0
12239,1,2239,[100 300 125 322 328],164,5,9787,4.369196428571429,0.0,20.0
12240,1,2240,[127 187 483 302 211],343,5,9792,4.3694779116465865,20.0,20.0
12241,1,2241,[357 175 216 435 211],90,4,9796,4.369313113291704,20.0,0.0
12242,1,2242,[127 187 483 302 211],210,5,9801,4.369594293357111,20.0,20.0
12243,1,2243,[127 187 483 302 211],328,5,9806,4.3698752228163995,20.0,20.0
12244,1,2244,[  9 238 435 357 234],749,3,9809,4.369265033407572,20.0,0.0
12245,1,2245,[235  28 187 294 121],648,3,9812,4.3686553873552985,0.0,0.0
12246,1,2246,[127 187 483 302 211],6,5,9817,4.368936359590565,20.0,20.0
12247,1,2247,[144 333 300 153 245],653,3,9820,4.368327402135232,0.0,0.0
12248,1,2248,[ 56 183 403  64 210],378,5,9825,4.368608270342374,0.0,0.0
12249,1,2249,[127 187 483 302 211],328,5,9830,4.368888888888889,20.0,20.0
12250,1,2250,[ 69 435  79 181 204],650,3,9833,4.368280764104842,0.0,0.0
12251,1,2251,[127 187 483 302 211],474,5,9838,4.368561278863233,20.0,20.0
12252,1,2252,[127 187 483 302 211],13,5,9843,4.36884154460719,20.0,20.0
12253,1,2253,[127 187 483 302 211],833,3,9846,4.368234250221827,20.0,20.0
12254,1,2254,[135 222  71 234 196],901,5,9851,4.368514412416851,0.0,0.0
12255,1,2255,[127 187 483 302 211],210,5,9856,4.368794326241135,20.0,20.0
12256,1,2256,[127 187 483 302 211],339,5,9861,4.369073992024812,20.0,20.0
12257,1,2257,[181 496 216 385 234],59,5,9866,4.369353410097431,0.0,0.0
12258,1,2258,[ 56 515 211 423   7],882,5,9871,4.369632580787959,0.0,0.0
12259,1,2259,[195  88 202 174 515],840,5,9876,4.3699115044247785,0.0,20.0
12260,1,2260,[127 187 483 302 211],666,5,9881,4.370190181335692,20.0,20.0
12261,1,2261,[127 187 483 302 211],666,5,9886,4.370468611847922,20.0,20.0
12262,1,2262,[127 187 483 302 211],90,5,9891,4.370746796288113,20.0,20.0
12263,1,2263,[127 187 483 302 211],833,3,9894,4.370141342756184,20.0,20.0
12264,1,2264,[127 187 483 302 211],339,5,9899,4.370419426048565,20.0,20.0
12265,1,2265,[127 187 483 302 211],207,5,9904,4.370697263901147,20.0,20.0
12266,1,2266,[127 187 483 302 211],339,5,9909,4.370974856638729,20.0,20.0
12267,1,2267,[127 187 483 302 211],13,5,9914,4.371252204585538,20.0,20.0
12268,1,2268,[127 187 483 302 211],666,5,9919,4.371529308065227,20.0,20.0
12269,1,2269,[234 191 143 288 301],537,1,9920,4.370044052863436,0.0,0.0
12270,1,2270,[181  15  12 196 118],92,3,9923,4.369440774988991,20.0,0.0
12271,1,2271,[127 187 483 302 211],13,5,9928,4.369718309859155,20.0,20.0
12272,1,2272,[234  25 186 435 168],13,4,9932,4.369555653321601,0.0,0.0
12273,1,2273,[127 187 483 302 211],537,5,9937,4.369832893579596,20.0,20.0
12274,1,2274,[405 385 117 748 483],648,3,9940,4.369230769230769,20.0,0.0
12275,1,2275,[127 187 483 302 211],6,5,9945,4.369507908611599,20.0,20.0
12276,1,2276,[127 187 483 302 211],524,5,9950,4.369784804567414,20.0,20.0
12277,1,2277,[127 187 483 302 211],474,5,9955,4.370061457418789,20.0,20.0
12278,1,2278,[216 318  96 273  28],538,3,9958,4.369460289600702,20.0,0.0
12279,1,2279,[  4  97 273 655 175],537,1,9959,4.367982456140351,0.0,0.0
12280,1,2280,[127 187 483 302 211],13,5,9964,4.368259535291539,20.0,20.0
12281,1,2281,[176  69 100  70 200],788,5,9969,4.368536371603856,0.0,20.0
12282,1,2282,[127 187 483 302 211],537,5,9974,4.368812965396408,20.0,20.0
12283,1,2283,[127 187 483 302 211],474,5,9979,4.369089316987741,20.0,20.0
12284,1,2284,[127 187 483 302 211],210,5,9984,4.369365426695842,20.0,20.0
12285,1,2285,[ 95 121 179 318 187],387,2,9986,4.36832895888014,20.0,0.0
12286,1,2286,[127 187 483 302 211],666,5,9991,4.368605159597727,20.0,20.0
12287,1,2287,[127 187 483 302 211],474,5,9996,4.368881118881119,20.0,20.0
12288,1,2288,[127 187 483 302 211],474,5,10001,4.369156837046745,20.0,20.0
12289,1,2289,[127 187 483 302 211],474,5,10006,4.3694323144104805,20.0,20.0
12290,1,2290,[127 187 483 302 211],666,5,10011,4.3697075512876475,20.0,20.0
12291,1,2291,[222 153 568  82 235],738,3,10014,4.369109947643979,0.0,0.0
12292,1,2292,[127 187 483 302 211],210,5,10019,4.36938508504143,20.0,20.0
12293,1,2293,[127 187 483 302 211],339,5,10024,4.369659982563208,20.0,20.0
12294,1,2294,[ 79  69 121 427 216],843,0,10024,4.367755991285403,0.0,0.0
12295,1,2295,[302 357  50 174  22],10,5,10029,4.368031358885017,20.0,40.0
12296,1,2296,[127 187 483 302 211],90,5,10034,4.368306486721811,20.0,20.0
12297,1,2297,[127 187 483 302 211],343,5,10039,4.36858137510879,20.0,20.0
12298,1,2298,[127 187 483 302 211],343,5,10044,4.368856024358417,20.0,20.0
12299,1,2299,[127 187 483 302 211],207,5,10049,4.369130434782608,20.0,20.0
12300,1,2300,[127 187 483 302 211],343,5,10054,4.3694046066927426,20.0,20.0
12301,1,2301,[322 153 237 161 127],234,1,10055,4.367940920938315,0.0,20.0
12302,1,2302,[678  82  96 200 328],749,4,10059,4.367781155015198,0.0,0.0
12303,1,2303,[127 187 483 302 211],833,3,10062,4.3671875,20.0,20.0
12304,1,2304,[127 187 483 302 211],474,5,10067,4.367462039045553,20.0,20.0
12305,1,2305,[127 187 483 302 211],90,5,10072,4.367736339982654,20.0,20.0
12306,1,2306,[127 187 483 302 211],833,3,10075,4.3671434763762464,20.0,20.0
12307,1,2307,[127 187 483 302 211],13,5,10080,4.3674176776429805,20.0,20.0
12308,1,2308,[127 187 483 302 211],328,5,10085,4.367691641403205,20.0,20.0
12309,1,2309,[127 187 483 302 211],833,3,10088,4.367099567099567,20.0,20.0
12310,1,2310,[127 187 483 302 211],524,5,10093,4.367373431414972,20.0,20.0
12311,1,2311,[127 187 483 302 211],6,5,10098,4.367647058823529,20.0,20.0
12312,1,2312,[127 187 483 302 211],6,5,10103,4.3679204496325115,20.0,20.0
12313,1,2313,[127 187 483 302 211],6,5,10108,4.368193604148661,20.0,20.0
12314,1,2314,[127 187 483 302 211],666,5,10113,4.368466522678186,20.0,20.0
12315,1,2315,[127 187 483 302 211],666,5,10118,4.36873920552677,20.0,20.0
12316,1,2316,[127 187 483 302 211],666,5,10123,4.369011652999569,20.0,20.0
12317,1,2317,[127 187 483 302 211],833,3,10126,4.368421052631579,20.0,20.0
12318,1,2318,[185 508 265 496  11],115,3,10129,4.367830961621388,0.0,0.0
12319,1,2319,[127 187 483 302 211],537,5,10134,4.368103448275862,20.0,20.0
12320,1,2320,[127 187 483 302 211],6,5,10139,4.3683757001292545,20.0,20.0
12321,1,2321,[127 187 483 302 211],833,3,10142,4.367786391042205,20.0,20.0
12322,1,2322,[127 187 483 302 211],666,5,10147,4.368058544984933,20.0,20.0
12323,1,2323,[127 187 483 302 211],6,5,10152,4.368330464716007,20.0,20.0
12324,1,2324,[237 276 100  25 286],63,4,10156,4.368172043010753,0.0,20.0
12325,1,2325,[127 187 483 302 211],474,5,10161,4.368443680137576,20.0,20.0
12326,1,2326,[294  88 195  69 135],901,4,10165,4.368285345938977,0.0,0.0
12327,1,2327,[127 187 483 302 211],666,5,10170,4.368556701030927,20.0,20.0
12328,1,2328,[194  15 546 597 100],308,2,10172,4.367539716616574,0.0,20.0
12329,1,2329,[191  70 215 546 515],234,2,10174,4.366523605150214,0.0,0.0
12330,1,2330,[127 187 483 302 211],524,5,10179,4.366795366795367,20.0,20.0
12331,1,2331,[127 187 483 302 211],474,5,10184,4.367066895368782,20.0,20.0
12332,1,2332,[515 403  25 322 175],881,2,10186,4.36605229318474,0.0,0.0
12333,1,2333,[127 187 483 302 211],833,3,10189,4.3654670094258785,20.0,20.0
12334,1,2334,[127 187 483 302 211],666,5,10194,4.365738758029979,20.0,20.0
12335,1,2335,[127 187 483 302 211],474,5,10199,4.366010273972603,20.0,20.0
12336,1,2336,[127 187 483 302 211],6,5,10204,4.366281557552417,20.0,20.0
12337,1,2337,[127 187 483 302 211],328,5,10209,4.366552609067579,20.0,20.0
12338,1,2338,[127 187 483 302 211],13,5,10214,4.366823428815733,20.0,20.0
12339,1,2339,[127 187 483 302 211],207,5,10219,4.367094017094017,20.0,20.0
12340,1,2340,[127 187 483 302 211],343,5,10224,4.36736437419906,20.0,20.0
12341,1,2341,[127 187 483 302 211],339,5,10229,4.367634500426986,20.0,20.0
12342,1,2342,[300 318 313  79  56],328,5,10234,4.36790439607341,20.0,0.0
12343,1,2343,[127 187 483 302 211],343,5,10239,4.368174061433447,20.0,20.0
12344,1,2344,[127 187 483 302 211],339,5,10244,4.368443496801706,20.0,20.0
12345,1,2345,[127 275 269 144  79],360,4,10248,4.368286445012788,0.0,20.0
12346,1,2346,[127 187 483 302 211],207,5,10253,4.368555602897316,20.0,20.0
12347,1,2347,[127 187 483 302 211],524,5,10258,4.368824531516184,20.0,20.0
12348,1,2348,[127 187 483 302 211],207,5,10263,4.369093231162196,20.0,20.0
12349,1,2349,[127 187 483 302 211],90,5,10268,4.36936170212766,20.0,20.0
12350,1,2350,[127 187 483 302 211],474,5,10273,4.369629944704381,20.0,20.0
12351,1,2351,[127 187 483 302 211],207,5,10278,4.369897959183674,20.0,20.0
12352,1,2352,[100 515 496  97 174],339,5,10283,4.370165745856354,0.0,40.0
12353,1,2353,[127 187 483 302 211],207,5,10288,4.370433305012744,20.0,20.0
12354,1,2354,[127 187 483 302 211],210,5,10293,4.370700636942675,20.0,20.0
12355,1,2355,[127 187 483 302 211],207,5,10298,4.370967741935484,20.0,20.0
12356,1,2356,[294 268 475 288 300],537,2,10300,4.3699618158676286,0.0,0.0
12357,1,2357,[127 187 483 302 211],207,5,10305,4.370229007633588,20.0,20.0
12358,1,2358,[127 187 483 302 211],833,3,10308,4.369648155998305,20.0,20.0
12359,1,2359,[127 187 483 302 211],6,5,10313,4.369915254237288,20.0,20.0
12360,1,2360,[127 187 483 302 211],474,5,10318,4.3701821262177045,20.0,20.0
12361,1,2361,[111 180 173 183 655],479,5,10323,4.3704487722269265,0.0,0.0
12362,1,2362,[127 187 483 302 211],833,3,10326,4.369868810833686,20.0,20.0
12363,1,2363,[127 187 483 302 211],6,5,10331,4.370135363790186,20.0,20.0
12364,1,2364,[127 187 483 302 211],339,5,10336,4.3704016913319235,20.0,20.0
12365,1,2365,[127 187 483 302 211],90,5,10341,4.370667793744717,20.0,20.0
12366,1,2366,[127 187 483 302 211],6,5,10346,4.3709336713138995,20.0,20.0
12367,1,2367,[127 187 483 302 211],207,5,10351,4.371199324324325,20.0,20.0
12368,1,2368,[127 187 483 302 211],343,5,10356,4.371464753060363,20.0,20.0
12369,1,2369,[127 187 483 302 211],328,5,10361,4.371729957805907,20.0,20.0
12370,1,2370,[127 187 483 302 211],6,5,10366,4.371994938844369,20.0,20.0
12371,1,2371,[127 187 483 302 211],833,3,10369,4.37141652613828,20.0,20.0
12372,1,2372,[515 121 483   9 742],59,4,10373,4.37126000842815,20.0,0.0
12373,1,2373,[186 182 235 197 194],59,3,10376,4.370682392586352,0.0,0.0
12374,1,2374,[127 187 483 302 211],210,5,10381,4.370947368421053,20.0,20.0
12375,1,2375,[496   4 200 168 181],474,3,10384,4.37037037037037,0.0,0.0
12376,1,2376,[ 95 228 288   4 111],537,0,10384,4.368531762726126,0.0,0.0
12377,1,2377,[143 423  82 118 235],374,2,10386,4.367535744322961,0.0,0.0
12378,1,2378,[127 187 483 302 211],666,5,10391,4.367801597309794,20.0,20.0
12379,1,2379,[127 187 483 302 211],90,5,10396,4.368067226890756,20.0,20.0
12380,1,2380,[127 187 483 302 211],474,5,10401,4.368332633347333,20.0,20.0
12381,1,2381,[127 187 483 302 211],13,5,10406,4.368597816960538,20.0,20.0
12382,1,2382,[127 187 483 302 211],524,5,10411,4.368862778010911,20.0,20.0
12383,1,2383,[127 187 483 302 211],207,5,10416,4.369127516778524,20.0,20.0
12384,1,2384,[127 187 483 302 211],474,5,10421,4.369392033542977,20.0,20.0
12385,1,2385,[127 187 483 302 211],339,5,10426,4.369656328583403,20.0,20.0
12386,1,2386,[127 187 483 302 211],833,3,10429,4.369082530372853,20.0,20.0
12387,1,2387,[180 385 153 211 265],653,3,10432,4.368509212730318,0.0,0.0
12388,1,2388,[127 187 483 302 211],328,5,10437,4.368773545416492,20.0,20.0
12389,1,2389,[597 313 294 197 187],650,2,10439,4.367782426778243,0.0,0.0
12390,1,2390,[127 187 483 302 211],343,5,10444,4.368046842325387,20.0,20.0
12391,1,2391,[127 187 483 302 211],474,5,10449,4.368311036789297,20.0,20.0
12392,1,2392,[127 187 483 302 211],90,5,10454,4.368575010447137,20.0,20.0
12393,1,2393,[127 187 483 302 211],13,5,10459,4.368838763575606,20.0,20.0
12394,1,2394,[127 187 483 302 211],833,3,10462,4.368267223382046,20.0,20.0
12395,1,2395,[127 187 483 302 211],328,5,10467,4.368530884808013,20.0,20.0
12396,1,2396,[268 288 403 655 100],387,1,10468,4.367125573633709,0.0,20.0
12397,1,2397,[127 187 483 302 211],537,5,10473,4.367389491242702,20.0,20.0
12398,1,2398,[127 187 483 302 211],328,5,10478,4.367653188828679,20.0,20.0
12399,1,2399,[127 187 483 302 211],6,5,10483,4.367916666666667,20.0,20.0
12400,1,2400,[127 187 483 302 211],13,5,10488,4.368179925031237,20.0,20.0
12401,1,2401,[127 187 483 302 211],339,5,10493,4.368442964196503,20.0,20.0
12402,1,2402,[127 187 483 302 211],6,5,10498,4.368705784436122,20.0,20.0
12403,1,2403,[127 187 483 302 211],90,5,10503,4.368968386023295,20.0,20.0
12404,1,2404,[127 187 483 302 211],90,5,10508,4.369230769230769,20.0,20.0
12405,1,2405,[127 187 483 302 211],474,5,10513,4.3694929343308395,20.0,20.0
12406,1,2406,[300 423 515 161 282],455,4,10517,4.369339426672206,0.0,0.0
12407,1,2407,[127 187 483 302 211],13,5,10522,4.369601328903655,20.0,20.0
12408,1,2408,[127 187 483 302 211],833,3,10525,4.369032793690328,20.0,20.0
12409,1,2409,[ 50 182 202 180 174],6,4,10529,4.368879668049792,0.0,40.0
12410,1,2410,[127 187 483 302 211],537,5,10534,4.369141435089174,20.0,20.0
12411,1,2411,[127 187 483 302 211],666,5,10539,4.369402985074627,20.0,20.0
12412,1,2412,[ 12 135 265 313 211],207,2,10541,4.368421052631579,20.0,0.0
12413,1,2413,[127 187 483 302 211],524,5,10546,4.368682684341342,20.0,20.0
12414,1,2414,[173 174  89 200 182],145,5,10551,4.368944099378882,0.0,20.0
12415,1,2415,[127 187 483 302 211],207,5,10556,4.369205298013245,20.0,20.0
12416,1,2416,[127 187 483 302 211],474,5,10561,4.369466280513032,20.0,20.0
12417,1,2417,[176 546 294 186 258],7,3,10564,4.368899917287014,0.0,0.0
12418,1,2418,[127 187 483 302 211],666,5,10569,4.36916081025217,20.0,20.0
12419,1,2419,[127 187 483 302 211],6,5,10574,4.369421487603306,20.0,20.0
12420,1,2420,[125 742  25 276  89],119,4,10578,4.369268897149938,0.0,0.0
12421,1,2421,[127 187 483 302 211],666,5,10583,4.3695293146160195,20.0,20.0
12422,1,2422,[127 187 483 302 211],833,3,10586,4.368964094098225,20.0,20.0
12423,1,2423,[127 187 483 302 211],474,5,10591,4.369224422442244,20.0,20.0
12424,1,2424,[127 187 483 302 211],339,5,10596,4.369484536082474,20.0,20.0
12425,1,2425,[127 187 483 302 211],666,5,10601,4.369744435284419,20.0,20.0
12426,1,2426,[180  56  82 121 257],804,4,10605,4.369592088998764,0.0,0.0
12427,1,2427,[127 187 483 302 211],207,5,10610,4.369851729818781,20.0,20.0
12428,1,2428,[276 588 179 180 173],312,4,10614,4.36969946480033,0.0,0.0
12429,1,2429,[127 187 483 302 211],6,5,10619,4.369958847736625,20.0,20.0
12430,1,2430,[127 187 483 302 211],537,5,10624,4.370218017276841,20.0,20.0
12431,1,2431,[183  95 187 181 174],766,3,10627,4.3696546052631575,0.0,20.0
12432,1,2432,[127 187 483 302 211],90,5,10632,4.369913686806412,20.0,20.0
12433,1,2433,[  4 265 288  69 186],339,3,10635,4.369350862777321,0.0,0.0
12434,1,2434,[ 28 258   1 182 742],313,2,10637,4.368377823408625,0.0,0.0
12435,1,2435,[127 187 483 302 211],833,3,10640,4.367816091954023,20.0,20.0
12436,1,2436,[127 187 483 302 211],524,5,10645,4.368075502667214,20.0,20.0
12437,1,2437,[127 187 483 302 211],833,3,10648,4.367514356029532,20.0,20.0
12438,1,2438,[127 187 483 302 211],90,5,10653,4.3677736777367775,20.0,20.0
12439,1,2439,[210  22 174  56 471],648,4,10657,4.367622950819672,0.0,20.0
12440,1,2440,[127 187 483 302 211],339,5,10662,4.367882015567391,20.0,20.0
12441,1,2441,[127 187 483 302 211],207,5,10667,4.368140868140868,20.0,20.0
12442,1,2442,[127 187 483 302 211],328,5,10672,4.368399508800655,20.0,20.0
12443,1,2443,[127 187 483 302 211],90,5,10677,4.368657937806874,20.0,20.0
12444,1,2444,[222 588 215 144 135],13,4,10681,4.3685071574642125,0.0,0.0
12445,1,2445,[328 168 313  96 180],13,4,10685,4.368356500408831,0.0,0.0
12446,1,2446,[127 187 483 302 211],210,5,10690,4.368614630159379,20.0,20.0
12447,1,2447,[127 187 483 302 211],474,5,10695,4.368872549019608,20.0,20.0
12448,1,2448,[127 187 483 302 211],210,5,10700,4.369130257247856,20.0,20.0
12449,1,2449,[127 187 483 302 211],207,5,10705,4.369387755102041,20.0,20.0
12450,1,2450,[180 475 655 237 222],474,5,10710,4.369645042839657,0.0,0.0
12451,1,2451,[127 187 483 302 211],339,5,10715,4.369902120717781,20.0,20.0
12452,1,2452,[216 174 191 294 179],881,4,10719,4.369751324908275,0.0,20.0
12453,1,2453,[127 187 483 302 211],343,5,10724,4.37000814995925,20.0,20.0
12454,1,2454,[127 187 483 302 211],343,5,10729,4.370264765784114,20.0,20.0
12455,1,2455,[ 96 197 179 135 200],537,3,10732,4.369706840390879,0.0,0.0
12456,1,2456,[127 187 483 302 211],13,5,10737,4.3699633699633695,20.0,20.0
12457,1,2457,[127 187 483 302 211],6,5,10742,4.370219690805533,20.0,20.0
12458,1,2458,[216 183 294 143  15],92,1,10743,4.368849125660838,0.0,0.0
12459,1,2459,[127 187 483 302 211],537,5,10748,4.369105691056911,20.0,20.0
12460,1,2460,[127 187 483 302 211],833,3,10751,4.368549370174725,20.0,20.0
12461,1,2461,[127 187 483 302 211],207,5,10756,4.368805848903331,20.0,20.0
12462,1,2462,[186  97 258 515 153],313,2,10758,4.367844092570037,0.0,0.0
12463,1,2463,[127 187 483 302 211],343,5,10763,4.36810064935065,20.0,20.0
12464,1,2464,[127 187 483 302 211],90,5,10768,4.368356997971603,20.0,20.0
12465,1,2465,[153 173  88 323 121],374,2,10770,4.367396593673966,0.0,0.0
12466,1,2466,[191  70  56 483 121],932,4,10774,4.367247669233888,20.0,0.0
12467,1,2467,[127 187 483 302 211],339,5,10779,4.3675040518638575,20.0,20.0
12468,1,2468,[ 70 195 194 228 603],804,5,10784,4.367760226812475,20.0,0.0
12469,1,2469,[127 187 483 302 211],6,5,10789,4.368016194331984,20.0,20.0
12470,1,2470,[127 187 483 302 211],666,5,10794,4.368271954674221,20.0,20.0
12471,1,2471,[127 187 483 302 211],210,5,10799,4.368527508090615,20.0,20.0
12472,1,2472,[127 187 483 302 211],666,5,10804,4.368782854832188,20.0,20.0
12473,1,2473,[127 187 483 302 211],537,5,10809,4.369037995149555,20.0,20.0
12474,1,2474,[127 187 483 302 211],13,5,10814,4.3692929292929295,20.0,20.0
12475,1,2475,[127 187 483 302 211],207,5,10819,4.369547657512117,20.0,20.0
12476,1,2476,[127 187 483 302 211],13,5,10824,4.36980218005652,20.0,20.0
12477,1,2477,[268 313  96 655 117],13,4,10828,4.369652945924132,0.0,0.0
12478,1,2478,[127 187 483 302 211],666,5,10833,4.36990722065349,20.0,20.0
12479,1,2479,[127 187 483 302 211],343,5,10838,4.370161290322581,20.0,20.0
12480,1,2480,[ 22 174 357 237 196],95,4,10842,4.370012091898428,20.0,20.0
12481,1,2481,[ 71  97 234 197 235],59,3,10845,4.3694601128122486,0.0,0.0
12482,1,2482,[127 187 483 302 211],328,5,10850,4.36971405557793,20.0,20.0
12483,1,2483,[127 187 483 302 211],343,5,10855,4.3699677938808374,20.0,20.0
12484,1,2484,[ 96 515 174 215 328],753,3,10858,4.369416498993964,0.0,20.0
12485,1,2485,[127 187 483 302 211],474,5,10863,4.369670152855994,20.0,20.0
12486,1,2486,[216 403 471 118  71],328,1,10864,4.368315239244069,0.0,0.0
12487,1,2487,[127 187 483 302 211],90,5,10869,4.368569131832797,20.0,20.0
12488,1,2488,[127 187 483 302 211],343,5,10874,4.368822820409803,20.0,20.0
12489,1,2489,[127 187 483 302 211],207,5,10879,4.369076305220884,20.0,20.0
12490,1,2490,[121 132  56 118 235],447,4,10883,4.368928141308712,0.0,0.0
12491,1,2491,[127 187 483 302 211],833,3,10886,4.368378812199037,20.0,20.0
12492,1,2492,[127 187 483 302 211],328,5,10891,4.368632170076213,20.0,20.0
12493,1,2493,[127 187 483 302 211],90,5,10896,4.368885324779471,20.0,20.0
12494,1,2494,[127 187 483 302 211],343,5,10901,4.369138276553106,20.0,20.0
12495,1,2495,[127 187 483 302 211],343,5,10906,4.3693910256410255,20.0,20.0
12496,1,2496,[496   8 423 546 196],64,4,10910,4.369243091710052,0.0,0.0
12497,1,2497,[127 187 483 302 211],833,3,10913,4.368694955964772,20.0,20.0
12498,1,2498,[127 187 483 302 211],328,5,10918,4.368947579031612,20.0,20.0
12499,1,2499,[161 322  70  79 475],207,2,10920,4.368,0.0,0.0
12500,1,2500,[127 187 483 302 211],524,5,10925,4.368252698920432,20.0,20.0
12501,1,2501,[ 22 172  79 187 258],184,2,10927,4.367306155075939,0.0,0.0
12502,1,2502,[127 187 483 302 211],90,5,10932,4.367558929284858,20.0,20.0
12503,1,2503,[111 196 238  82 318],334,4,10936,4.36741214057508,20.0,0.0
12504,1,2504,[ 28 143  64 210 127],527,2,10938,4.366467065868264,0.0,20.0
12505,1,2505,[597 265  79 475 269],13,1,10939,4.36512370311253,0.0,0.0
12506,1,2506,[235  89 200  88   1],374,2,10941,4.364180295173514,0.0,0.0
12507,1,2507,[127 187 483 302 211],833,3,10944,4.363636363636363,20.0,20.0
12508,1,2508,[127 187 483 302 211],339,5,10949,4.363889996014349,20.0,20.0
12509,1,2509,[127 187 483 302 211],207,5,10954,4.364143426294821,20.0,20.0
12510,1,2510,[127 187 483 302 211],339,5,10959,4.364396654719235,20.0,20.0
12511,1,2511,[127 187 483 302 211],6,5,10964,4.364649681528663,20.0,20.0
12512,1,2512,[127 187 483 302 211],90,5,10969,4.364902506963788,20.0,20.0
12513,1,2513,[127  22 603  56 194],90,5,10974,4.365155131264917,20.0,20.0
12514,1,2514,[127 187 483 302 211],474,5,10979,4.365407554671968,20.0,20.0
12515,1,2515,[127 187 483 302 211],90,5,10984,4.365659777424483,20.0,20.0
12516,1,2516,[127 187 483 302 211],339,5,10989,4.365911799761621,20.0,20.0
12517,1,2517,[127 187 483 302 211],210,5,10994,4.36616362192216,20.0,20.0
12518,1,2518,[127 187 483 302 211],833,3,10997,4.365621278285034,20.0,20.0
12519,1,2519,[127 187 483 302 211],210,5,11002,4.3658730158730155,20.0,20.0
12520,1,2520,[ 28  50  96   4 144],13,5,11007,4.366124553748513,0.0,20.0
12521,1,2521,[127 187 483 302 211],210,5,11012,4.366375892149088,20.0,20.0
12522,1,2522,[127 187 483 302 211],207,5,11017,4.36662703131193,20.0,20.0
12523,1,2523,[127 187 483 302 211],13,5,11022,4.366877971473851,20.0,20.0
12524,1,2524,[127 187 483 302 211],537,5,11027,4.3671287128712875,20.0,20.0
12525,1,2525,[127 187 483 302 211],833,3,11030,4.36658749010293,20.0,20.0
12526,1,2526,[127 187 483 302 211],343,5,11035,4.366838148001583,20.0,20.0
12527,1,2527,[127 187 483 302 211],537,5,11040,4.367088607594937,20.0,20.0
12528,1,2528,[313 515 186 121 132],64,4,11044,4.366943455911428,0.0,0.0
12529,1,2529,[127 187 483 302 211],90,5,11049,4.367193675889328,20.0,20.0
12530,1,2530,[127 187 483 302 211],343,5,11054,4.367443698143027,20.0,20.0
12531,1,2531,[127 187 483 302 211],90,5,11059,4.3676935229067935,20.0,20.0
12532,1,2532,[405 403  97 357 257],343,4,11063,4.36754836162653,20.0,0.0
12533,1,2533,[127 187 483 302 211],339,5,11068,4.367797947908445,20.0,20.0
12534,1,2534,[127 187 483 302 211],339,5,11073,4.368047337278107,20.0,20.0
12535,1,2535,[127 187 483 302 211],90,5,11078,4.368296529968454,20.0,20.0
12536,1,2536,[127 187 483 302 211],339,5,11083,4.368545526212062,20.0,20.0
12537,1,2537,[127 187 483 302 211],833,3,11086,4.368006304176517,20.0,20.0
12538,1,2538,[127 187 483 302 211],207,5,11091,4.368255218589996,20.0,20.0
12539,1,2539,[127 187 483 302 211],343,5,11096,4.368503937007874,20.0,20.0
12540,1,2540,[127 187 483 302 211],666,5,11101,4.36875245966155,20.0,20.0
12541,1,2541,[127 187 483 302 211],328,5,11106,4.3690007867820615,20.0,20.0
12542,1,2542,[117 748 181 185 168],474,3,11109,4.368462445930004,0.0,0.0
12543,1,2543,[127 187 483 302 211],474,5,11114,4.3687106918239,20.0,20.0
12544,1,2544,[185 323 318 168  64],488,4,11118,4.368565815324165,20.0,0.0
12545,1,2545,[127 187 483 302 211],537,5,11123,4.3688138256087985,20.0,20.0
12546,1,2546,[127 187 483 302 211],207,5,11128,4.3690616411464465,20.0,20.0
12547,1,2547,[127 187 483 302 211],90,5,11133,4.369309262166405,20.0,20.0
12548,1,2548,[127 187 483 302 211],666,5,11138,4.369556688897607,20.0,20.0
12549,1,2549,[127 187 483 302 211],207,5,11143,4.369803921568628,20.0,20.0
12550,1,2550,[742  64 186 143 196],653,2,11145,4.368874950999608,0.0,0.0
12551,1,2551,[127 187 483 302 211],6,5,11150,4.3691222570532915,20.0,20.0
12552,1,2552,[427 204 238  50 301],234,2,11152,4.368194281237759,0.0,20.0
12553,1,2553,[127 187 483 302 211],328,5,11157,4.368441660140955,20.0,20.0
12554,1,2554,[191 172 187  64 121],13,4,11161,4.368297455968689,0.0,0.0
12555,1,2555,[127 187 483 302 211],343,5,11166,4.368544600938967,20.0,20.0
12556,1,2556,[127 187 483 302 211],524,5,11171,4.368791552600704,20.0,20.0
12557,1,2557,[127 187 483 302 211],90,5,11176,4.36903831118061,20.0,20.0
12558,1,2558,[127 187 483 302 211],210,5,11181,4.369284876905041,20.0,20.0
12559,1,2559,[127 187 483 302 211],328,5,11186,4.36953125,20.0,20.0
12560,1,2560,[211 423 168 117 135],95,3,11189,4.368996485747755,0.0,0.0
12561,1,2561,[127 187 483 302 211],6,5,11194,4.369242779078845,20.0,20.0
12562,1,2562,[  9 135 215 427 117],234,2,11196,4.368318376902068,0.0,0.0
12563,1,2563,[127 187 483 302 211],210,5,11201,4.368564742589704,20.0,20.0
12564,1,2564,[127 187 483 302 211],537,5,11206,4.368810916179338,20.0,20.0
12565,1,2565,[127 187 483 302 211],833,3,11209,4.368277474668745,20.0,20.0
12566,1,2566,[210 318 185 268  50],537,4,11213,4.3681340085703155,20.0,20.0
12567,1,2567,[202 288 132 328 289],537,0,11213,4.366433021806854,0.0,0.0
12568,1,2568,[127 187 483 302 211],6,5,11218,4.3666796418840015,20.0,20.0
12569,1,2569,[127 187 483 302 211],474,5,11223,4.36692607003891,20.0,20.0
12570,1,2570,[127 187 483 302 211],210,5,11228,4.367172306495527,20.0,20.0
12571,1,2571,[435   4   8 176 111],533,2,11230,4.366251944012442,0.0,0.0
12572,1,2572,[176  89 435  70 222],378,4,11234,4.366109599689079,0.0,0.0
12573,1,2573,[127 187 483 302 211],474,5,11239,4.366355866355867,20.0,20.0
12574,1,2574,[127 187 483 302 211],339,5,11244,4.3666019417475725,20.0,20.0
12575,1,2575,[ 56   1 268 357  89],537,4,11248,4.366459627329193,20.0,0.0
12576,1,2576,[127 187 483 302 211],13,5,11253,4.366705471478463,20.0,20.0
12577,1,2577,[127 187 483 302 211],207,5,11258,4.366951124903026,20.0,20.0
12578,1,2578,[ 88 385 127 322 234],474,5,11263,4.367196587824738,0.0,20.0
12579,1,2579,[127 187 483 302 211],833,3,11266,4.366666666666666,20.0,20.0
12580,1,2580,[127 187 483 302 211],474,5,11271,4.366912049593181,20.0,20.0
12581,1,2581,[127 187 483 302 211],666,5,11276,4.367157242447715,20.0,20.0
12582,1,2582,[127 187 483 302 211],210,5,11281,4.367402245451026,20.0,20.0
12583,1,2583,[127 187 483 302 211],474,5,11286,4.367647058823529,20.0,20.0
12584,1,2584,[127 187 483 302 211],666,5,11291,4.3678916827853,20.0,20.0
12585,1,2585,[127 187 483 302 211],210,5,11296,4.368136117556071,20.0,20.0
12586,1,2586,[ 11 597 185 245 144],328,3,11299,4.367607267104755,0.0,0.0
12587,1,2587,[127 187 483 302 211],90,5,11304,4.367851622874807,20.0,20.0
12588,1,2588,[127 187 483 302 211],339,5,11309,4.368095789880263,20.0,20.0
12589,1,2589,[127 187 483 302 211],90,5,11314,4.3683397683397684,20.0,20.0
12590,1,2590,[183 200 483 237 172],95,2,11316,4.36742570436125,20.0,0.0
12591,1,2591,[127 187 483 302 211],666,5,11321,4.36766975308642,20.0,20.0
12592,1,2592,[127 187 483 302 211],90,5,11326,4.36791361357501,20.0,20.0
12593,1,2593,[181  69 483  15 515],488,4,11330,4.367771781033153,20.0,0.0
12594,1,2594,[127 187 483 302 211],210,5,11335,4.368015414258188,20.0,20.0
12595,1,2595,[127 187 483 302 211],524,5,11340,4.368258859784284,20.0,20.0
12596,1,2596,[127 187 483 302 211],207,5,11345,4.368502117828263,20.0,20.0
12597,1,2597,[127 187 483 302 211],328,5,11350,4.368745188606621,20.0,20.0
12598,1,2598,[127 187 483 302 211],474,5,11355,4.3689880723355135,20.0,20.0
12599,1,2599,[127 187 483 302 211],339,5,11360,4.369230769230769,20.0,20.0
12600,1,2600,[127 187 483 302 211],90,5,11365,4.369473279507882,20.0,20.0
12601,1,2601,[127 187 483 302 211],328,5,11370,4.369715603382014,20.0,20.0
12602,1,2602,[127 187 483 302 211],328,5,11375,4.369957741067998,20.0,20.0
12603,1,2603,[127 187 483 302 211],207,5,11380,4.370199692780338,20.0,20.0
12604,1,2604,[127 187 483 302 211],524,5,11385,4.370441458733206,20.0,20.0
12605,1,2605,[182 515 210   4 423],64,3,11388,4.36991557943208,0.0,0.0
12606,1,2606,[127 187 483 302 211],339,5,11393,4.370157268891446,20.0,20.0
12607,1,2607,[127 187 483 302 211],207,5,11398,4.370398773006135,20.0,20.0
12608,1,2608,[127 187 483 302 211],339,5,11403,4.370640091989268,20.0,20.0
12609,1,2609,[258 435 268 235 222],537,2,11405,4.369731800766283,0.0,0.0
12610,1,2610,[127 187 483 302 211],343,5,11410,4.369973190348525,20.0,20.0
12611,1,2611,[127 187 483 302 211],328,5,11415,4.3702143950995405,20.0,20.0
12612,1,2612,[127 187 483 302 211],537,5,11420,4.370455415231534,20.0,20.0
12613,1,2613,[228 588 475 235 143],479,1,11421,4.369166029074216,0.0,0.0
12614,1,2614,[ 15 427 515 197 135],313,4,11425,4.369024856596559,0.0,0.0
12615,1,2615,[127 187 483 302 211],666,5,11430,4.3692660550458715,20.0,20.0
12616,1,2616,[328  56 235 200  82],102,0,11430,4.367596484524264,0.0,0.0
12617,1,2617,[269 179 183 655 197],378,3,11433,4.36707410236822,0.0,0.0
12618,1,2618,[179 175 288 273 318],7,4,11437,4.366933944253532,20.0,0.0
12619,1,2619,[127 187 483 302 211],210,5,11442,4.367175572519084,20.0,20.0
12620,1,2620,[127 187 483 302 211],833,3,11445,4.366653948874475,20.0,20.0
12621,1,2621,[127 187 483 302 211],524,5,11450,4.366895499618612,20.0,20.0
12622,1,2622,[127 187 483 302 211],474,5,11455,4.367136866183759,20.0,20.0
12623,1,2623,[127 187 483 302 211],328,5,11460,4.367378048780488,20.0,20.0
12624,1,2624,[127 187 483 302 211],524,5,11465,4.367619047619048,20.0,20.0
12625,1,2625,[127 187 483 302 211],207,5,11470,4.367859862909368,20.0,20.0
12626,1,2626,[286  11 228 211 168],13,3,11473,4.367339170156072,0.0,0.0
12627,1,2627,[127 187 483 302 211],6,5,11478,4.367579908675799,20.0,20.0
12628,1,2628,[127 187 483 302 211],328,5,11483,4.367820464054773,20.0,20.0
12629,1,2629,[195 222 357 121   1],312,3,11486,4.367300380228137,20.0,0.0
12630,1,2630,[234 174 117  97 282],406,4,11490,4.367160775370581,0.0,20.0
12631,1,2631,[135 127 282 405 215],144,5,11495,4.367401215805471,0.0,20.0
12632,1,2632,[127 187 483 302 211],6,5,11500,4.3676414736042535,20.0,20.0
12633,1,2633,[127 187 483 302 211],328,5,11505,4.367881548974943,20.0,20.0
12634,1,2634,[127 187 483 302 211],537,5,11510,4.368121442125237,20.0,20.0
12635,1,2635,[127 187 483 302 211],6,5,11515,4.368361153262519,20.0,20.0
12636,1,2636,[127 187 483 302 211],474,5,11520,4.368600682593857,20.0,20.0
12637,1,2637,[127 187 483 302 211],339,5,11525,4.368840030326004,20.0,20.0
12638,1,2638,[127 187 483 302 211],207,5,11530,4.369079196665403,20.0,20.0
12639,1,2639,[313 403  95 210 405],184,3,11533,4.368560606060606,0.0,0.0
12640,1,2640,[127 187 483 302 211],524,5,11538,4.368799697084437,20.0,20.0
12641,1,2641,[127 187 483 302 211],474,5,11543,4.369038607115821,20.0,20.0
12642,1,2642,[127 187 483 302 211],207,5,11548,4.369277336360197,20.0,20.0
12643,1,2643,[328 286 427 118 405],13,2,11550,4.368381240544629,0.0,0.0
12644,1,2644,[  9 143  97 121 125],378,4,11554,4.368241965973535,0.0,0.0
12645,1,2645,[ 79  96 121 181 117],454,3,11557,4.367724867724868,0.0,0.0
12646,1,2646,[127 187 483 302 211],13,5,11562,4.3679637325273895,20.0,20.0
12647,1,2647,[286 289  28 185 187],788,5,11567,4.368202416918429,0.0,0.0
12648,1,2648,[127 187 483 302 211],6,5,11572,4.3684409211023025,20.0,20.0
12649,1,2649,[127 187 483 302 211],666,5,11577,4.368679245283019,20.0,20.0
12650,1,2650,[127 187 483 302 211],537,5,11582,4.3689173896642775,20.0,20.0
12651,1,2651,[228  79 151 483 187],892,4,11586,4.368778280542986,20.0,0.0
12652,1,2652,[127 187 483 302 211],328,5,11591,4.36901620806634,20.0,20.0
12653,1,2653,[127 187 483 302 211],210,5,11596,4.369253956292389,20.0,20.0
12654,1,2654,[127 187 483 302 211],474,5,11601,4.3694915254237285,20.0,20.0
12655,1,2655,[127 187 483 302 211],13,5,11606,4.369728915662651,20.0,20.0
12656,1,2656,[127 187 483 302 211],210,5,11611,4.36996612721114,20.0,20.0
12657,1,2657,[195 403  28  11  71],308,4,11615,4.369826937547028,0.0,0.0
12658,1,2658,[127 187 483 302 211],210,5,11620,4.3700639338097025,20.0,20.0
12659,1,2659,[127 187 483 302 211],537,5,11625,4.370300751879699,20.0,20.0
12660,1,2660,[127 187 483 302 211],210,5,11630,4.37053739195791,20.0,20.0
12661,1,2661,[127 187 483 302 211],210,5,11635,4.370773854244929,20.0,20.0
12662,1,2662,[127 187 483 302 211],343,5,11640,4.371010138941044,20.0,20.0
12663,1,2663,[127 187 483 302 211],524,5,11645,4.371246246246246,20.0,20.0
12664,1,2664,[385 427 265 222 215],295,5,11650,4.371482176360225,0.0,0.0
12665,1,2665,[127 187 483 302 211],210,5,11655,4.3717179294823705,20.0,20.0
12666,1,2666,[127 187 483 302 211],90,5,11660,4.371953505811773,20.0,20.0
12667,1,2667,[127 187 483 302 211],666,5,11665,4.372188905547226,20.0,20.0
12668,1,2668,[127 187 483 302 211],339,5,11670,4.372424128887224,20.0,20.0
12669,1,2669,[176  12 435 135 568],64,5,11675,4.372659176029963,20.0,0.0
12670,1,2670,[127 187 483 302 211],328,5,11680,4.372894047173343,20.0,20.0
12671,1,2671,[127 187 483 302 211],666,5,11685,4.37312874251497,20.0,20.0
12672,1,2672,[127 187 483 302 211],524,5,11690,4.373363262252151,20.0,20.0
12673,1,2673,[215 228 300 568 603],537,1,11691,4.372101720269259,20.0,0.0
12674,1,2674,[127 187 483 302 211],339,5,11696,4.372336448598131,20.0,20.0
12675,1,2675,[127 187 483 302 211],13,5,11701,4.3725710014947685,20.0,20.0
12676,1,2676,[127 187 483 302 211],524,5,11706,4.372805379155771,20.0,20.0
12677,1,2677,[210 423  96  97  98],13,4,11710,4.372666168782674,0.0,20.0
12678,1,2678,[435 174 179 182 185],7,5,11715,4.372900335946248,0.0,20.0
12679,1,2679,[127 187 483 302 211],13,5,11720,4.373134328358209,20.0,20.0
12680,1,2680,[127 187 483 302 211],666,5,11725,4.3733681462141,20.0,20.0
12681,1,2681,[127 187 483 302 211],6,5,11730,4.373601789709173,20.0,20.0
12682,1,2682,[127 187 483 302 211],328,5,11735,4.3738352590383895,20.0,20.0
12683,1,2683,[127 187 483 302 211],207,5,11740,4.374068554396423,20.0,20.0
12684,1,2684,[127 187 483 302 211],207,5,11745,4.374301675977653,20.0,20.0
12685,1,2685,[127 187 483 302 211],328,5,11750,4.374534623976173,20.0,20.0
12686,1,2686,[127 187 483 302 211],524,5,11755,4.374767398585783,20.0,20.0
12687,1,2687,[ 95  82  64  25 181],194,1,11756,4.373511904761905,0.0,0.0
12688,1,2688,[127 187 483 302 211],207,5,11761,4.373744886574935,20.0,20.0
12689,1,2689,[127 187 483 302 211],343,5,11766,4.373977695167286,20.0,20.0
12690,1,2690,[127 187 483 302 211],90,5,11771,4.37421033073207,20.0,20.0
12691,1,2691,[127 187 483 302 211],666,5,11776,4.3744427934621095,20.0,20.0
12692,1,2692,[127 187 483 302 211],13,5,11781,4.374675083549945,20.0,20.0
12693,1,2693,[127 187 483 302 211],666,5,11786,4.374907201187825,20.0,20.0
12694,1,2694,[  8  12 423 678 405],92,2,11788,4.374025974025974,20.0,0.0
12695,1,2695,[127 187 483 302 211],210,5,11793,4.374258160237389,20.0,20.0
12696,1,2696,[127 187 483 302 211],13,5,11798,4.374490174267705,20.0,20.0
12697,1,2697,[302 111   4 186 245],378,1,11799,4.373239436619718,0.0,0.0
12698,1,2698,[127 187 483 302 211],210,5,11804,4.3734716561689515,20.0,20.0
12699,1,2699,[127 187 483 302 211],210,5,11809,4.373703703703704,20.0,20.0
12700,1,2700,[127 187 483 302 211],6,5,11814,4.373935579415032,20.0,20.0
12701,1,2701,[174 117 144  71 257],901,5,11819,4.374167283493708,0.0,20.0
12702,1,2702,[127 187 483 302 211],666,5,11824,4.374398816130226,20.0,20.0
12703,1,2703,[181  50 127  28 216],538,3,11827,4.373890532544379,0.0,40.0
12704,1,2704,[127 187 483 302 211],833,3,11830,4.373382624768946,20.0,20.0
12705,1,2705,[423 238  96 405 174],458,3,11833,4.372875092387288,0.0,20.0
12706,1,2706,[127 187 483 302 211],207,5,11838,4.373106760251201,20.0,20.0
12707,1,2707,[127 187 483 302 211],90,5,11843,4.373338257016248,20.0,20.0
12708,1,2708,[127 187 483 302 211],13,5,11848,4.373569582871909,20.0,20.0
12709,1,2709,[515 174 603 245 179],666,3,11851,4.373062730627306,20.0,20.0
12710,1,2710,[127 187 483 302 211],537,5,11856,4.373293987458503,20.0,20.0
12711,1,2711,[127 187 483 302 211],666,5,11861,4.373525073746313,20.0,20.0
12712,1,2712,[127 187 483 302 211],339,5,11866,4.373755989679322,20.0,20.0
12713,1,2713,[322 127 215 180 289],328,3,11869,4.373249815770081,0.0,20.0
12714,1,2714,[127 187 483 302 211],537,5,11874,4.373480662983425,20.0,20.0
12715,1,2715,[194 144  79 568 237],328,3,11877,4.372974963181148,0.0,0.0
12716,1,2716,[127 187 483 302 211],6,5,11882,4.373205741626794,20.0,20.0
12717,1,2717,[127 187 483 302 211],13,5,11887,4.373436350257542,20.0,20.0
12718,1,2718,[127 187 483 302 211],90,5,11892,4.373666789260757,20.0,20.0
12719,1,2719,[ 79 483 286 135 289],13,2,11894,4.372794117647059,20.0,0.0
12720,1,2720,[127 187 483 302 211],210,5,11899,4.373024623300258,20.0,20.0
12721,1,2721,[127 187 483 302 211],474,5,11904,4.373254959588538,20.0,20.0
12722,1,2722,[ 71  89 168 403 237],7,5,11909,4.373485126698494,0.0,0.0
12723,1,2723,[127 187 483 302 211],474,5,11914,4.373715124816447,20.0,20.0
12724,1,2724,[257 237 210  71 180],95,3,11917,4.3732110091743115,0.0,0.0
12725,1,2725,[127 187 483 302 211],6,5,11922,4.373440939104916,20.0,20.0
12726,1,2726,[222 385 127 197  95],85,3,11925,4.372937293729373,0.0,20.0
12727,1,2727,[187 318 172 357 194],666,3,11928,4.372434017595308,40.0,0.0
12728,1,2728,[127 187 483 302 211],328,5,11933,4.372663979479663,20.0,20.0
12729,1,2729,[  4 300  97 357 118],328,2,11935,4.371794871794871,20.0,0.0
12730,1,2730,[127 187 483 302 211],537,5,11940,4.372024899304284,20.0,20.0
12731,1,2731,[127 187 483 302 211],537,5,11945,4.372254758418741,20.0,20.0
12732,1,2732,[216 496 173 403 202],295,5,11950,4.372484449323088,0.0,0.0
12733,1,2733,[127 187 483 302 211],339,5,11955,4.372713972201902,20.0,20.0
12734,1,2734,[127 187 483 302 211],666,5,11960,4.372943327239488,20.0,20.0
12735,1,2735,[  1 427  15 282 182],533,4,11964,4.37280701754386,0.0,0.0
12736,1,2736,[127 187 483 302 211],524,5,11969,4.373036170990135,20.0,20.0
12737,1,2737,[127 187 483 302 211],90,5,11974,4.373265157048941,20.0,20.0
12738,1,2738,[127 187 483 302 211],90,5,11979,4.373493975903615,20.0,20.0
12739,1,2739,[127 187 483 302 211],90,5,11984,4.3737226277372265,20.0,20.0
12740,1,2740,[127 187 483 302 211],207,5,11989,4.37395111273258,20.0,20.0
12741,1,2741,[127 187 483 302 211],13,5,11994,4.37417943107221,20.0,20.0
12742,1,2742,[127 187 483 302 211],328,5,11999,4.374407582938389,20.0,20.0
12743,1,2743,[127 187 483 302 211],13,5,12004,4.37463556851312,20.0,20.0
12744,1,2744,[127 187 483 302 211],343,5,12009,4.3748633879781424,20.0,20.0
12745,1,2745,[655   4  71  98 273],749,5,12014,4.3750910415149304,0.0,20.0
12746,1,2746,[127 187 483 302 211],537,5,12019,4.375318529304696,20.0,20.0
12747,1,2747,[127 187 483 302 211],6,5,12024,4.3755458515283845,20.0,20.0
12748,1,2748,[127 187 483 302 211],207,5,12029,4.375773008366679,20.0,20.0
12749,1,2749,[127 187 483 302 211],343,5,12034,4.376,20.0,20.0
12750,1,2750,[127 187 483 302 211],207,5,12039,4.376226826608506,20.0,20.0
12751,1,2751,[258  69 174 183 172],537,1,12040,4.375,0.0,20.0
12752,1,2752,[237 121 427 194 180],533,3,12043,4.374500544860153,0.0,0.0
12753,1,2753,[127 187 483 302 211],339,5,12048,4.374727668845316,20.0,20.0
12754,1,2754,[181 211 151  98  97],533,3,12051,4.374228675136116,0.0,20.0
12755,1,2755,[127 187 483 302 211],524,5,12056,4.374455732946299,20.0,20.0
12756,1,2756,[127 187 483 302 211],328,5,12061,4.3746826260428,20.0,20.0
12757,1,2757,[127 187 483 302 211],537,5,12066,4.374909354604786,20.0,20.0
12758,1,2758,[127 187 483 302 211],339,5,12071,4.375135918811163,20.0,20.0
12759,1,2759,[127 187 483 302 211],328,5,12076,4.37536231884058,20.0,20.0
12760,1,2760,[195  22  96 185  79],479,5,12081,4.375588554871423,0.0,0.0
12761,1,2761,[185 302 211  82  28],207,4,12085,4.375452570601014,0.0,0.0
12762,1,2762,[127 187 483 302 211],210,5,12090,4.375678610206298,20.0,20.0
12763,1,2763,[127 187 483 302 211],207,5,12095,4.375904486251809,20.0,20.0
12764,1,2764,[127 187 483 302 211],210,5,12100,4.376130198915009,20.0,20.0
12765,1,2765,[127 187 483 302 211],474,5,12105,4.376355748373102,20.0,20.0
12766,1,2766,[127 187 483 302 211],339,5,12110,4.376581134803036,20.0,20.0
12767,1,2767,[265 515 496 403 222],60,4,12114,4.3764450867052025,0.0,0.0
12768,1,2768,[127 187 483 302 211],210,5,12119,4.376670278078729,20.0,20.0
12769,1,2769,[127 187 483 302 211],666,5,12124,4.376895306859206,20.0,20.0
12770,1,2770,[100  88 423 175  56],774,0,12124,4.375315770479971,0.0,20.0
12771,1,2771,[288  89 435 385  79],455,2,12126,4.374458874458875,0.0,0.0
12772,1,2772,[127 187 483 302 211],833,3,12129,4.37396321673278,20.0,20.0
12773,1,2773,[  4 234 403 216 176],144,4,12133,4.373828406633021,0.0,0.0
12774,1,2774,[127 187 483 302 211],90,5,12138,4.374054054054054,20.0,20.0
12775,1,2775,[127 187 483 302 211],524,5,12143,4.374279538904899,20.0,20.0
12776,1,2776,[127 187 483 302 211],474,5,12148,4.374504861361181,20.0,20.0
12777,1,2777,[127 187 483 302 211],524,5,12153,4.374730021598272,20.0,20.0
12778,1,2778,[475 546  70  89 597],374,3,12156,4.374235336451961,0.0,0.0
12779,1,2779,[435 222 294  89 180],194,2,12158,4.3733812949640285,0.0,0.0
12780,1,2780,[121 301 508 100 111],63,3,12161,4.372887450557354,0.0,20.0
12781,1,2781,[127 187 483 302 211],339,5,12166,4.373112868439971,20.0,20.0
12782,1,2782,[127 187 483 302 211],537,5,12171,4.373338124326267,20.0,20.0
12783,1,2783,[127 187 483 302 211],90,5,12176,4.373563218390805,20.0,20.0
12784,1,2784,[127 187 483 302 211],328,5,12181,4.3737881508079,20.0,20.0
12785,1,2785,[127 187 483 302 211],6,5,12186,4.374012921751615,20.0,20.0
12786,1,2786,[127 187 483 302 211],207,5,12191,4.374237531395766,20.0,20.0
12787,1,2787,[172  56 222 179 655],537,2,12193,4.37338593974175,0.0,0.0
12788,1,2788,[ 71 435 228 357 237],60,4,12197,4.37325206167085,20.0,0.0
12789,1,2789,[127 187 483 302 211],833,3,12200,4.372759856630824,20.0,20.0
12790,1,2790,[127 187 483 302 211],6,5,12205,4.372984593335722,20.0,20.0
12791,1,2791,[127 187 483 302 211],210,5,12210,4.373209169054442,20.0,20.0
12792,1,2792,[127 187 483 302 211],210,5,12215,4.3734335839598995,20.0,20.0
12793,1,2793,[127 187 483 302 211],537,5,12220,4.3736578382247675,20.0,20.0
12794,1,2794,[127 187 483 302 211],474,5,12225,4.373881932021467,20.0,20.0
12795,1,2795,[127 187 483 302 211],210,5,12230,4.374105865522175,20.0,20.0
12796,1,2796,[127 187 483 302 211],210,5,12235,4.37432963889882,20.0,20.0
12797,1,2797,[286 300 204  70 483],334,3,12238,4.373838456040029,20.0,0.0
12798,1,2798,[127 187 483 302 211],210,5,12243,4.37406216505895,20.0,20.0
12799,1,2799,[179 168 191 151 385],666,3,12246,4.373571428571428,0.0,0.0
12800,1,2800,[127 187 483 302 211],210,5,12251,4.373795073188147,20.0,20.0
12801,1,2801,[127 187 483 302 211],6,5,12256,4.374018558172733,20.0,20.0
12802,1,2802,[127 187 483 302 211],343,5,12261,4.37424188369604,20.0,20.0
12803,1,2803,[127 187 483 302 211],474,5,12266,4.3744650499286735,20.0,20.0
12804,1,2804,[127 187 483 302 211],833,3,12269,4.37397504456328,20.0,20.0
12805,1,2805,[127 187 483 302 211],524,5,12274,4.374198146828225,20.0,20.0
12806,1,2806,[276 172 202 174 483],298,3,12277,4.373708585678661,20.0,20.0
12807,1,2807,[127 187 483 302 211],666,5,12282,4.3739316239316235,20.0,20.0
12808,1,2808,[127 187 483 302 211],474,5,12287,4.374154503381987,20.0,20.0
12809,1,2809,[127 187 483 302 211],343,5,12292,4.374377224199288,20.0,20.0
12810,1,2810,[127 187 483 302 211],13,5,12297,4.374599786552828,20.0,20.0
12811,1,2811,[127 187 483 302 211],328,5,12302,4.374822190611664,20.0,20.0
12812,1,2812,[222 603 245 302 313],454,3,12305,4.374333451830785,20.0,0.0
12813,1,2813,[127 187 483 302 211],833,3,12308,4.373845060412225,20.0,20.0
12814,1,2814,[127 187 483 302 211],537,5,12313,4.374067495559503,20.0,20.0
12815,1,2815,[127 187 483 302 211],339,5,12318,4.3742897727272725,20.0,20.0
12816,1,2816,[127 187 483 302 211],328,5,12323,4.374511892083777,20.0,20.0
12817,1,2817,[127 187 483 302 211],474,5,12328,4.374733853797019,20.0,20.0
12818,1,2818,[ 12 273 508 483 597],833,3,12331,4.37424618659099,40.0,0.0
12819,1,2819,[127 187 483 302 211],343,5,12336,4.374468085106383,20.0,20.0
12820,1,2820,[235 313 195 748  69],13,3,12339,4.3739808578518256,0.0,0.0
12821,1,2821,[127 187 483 302 211],6,5,12344,4.374202693125443,20.0,20.0
12822,1,2822,[127 187 483 302 211],13,5,12349,4.374424371236273,20.0,20.0
12823,1,2823,[127 187 483 302 211],537,5,12354,4.374645892351275,20.0,20.0
12824,1,2824,[127 187 483 302 211],210,5,12359,4.3748672566371685,20.0,20.0
12825,1,2825,[127 187 483 302 211],833,3,12362,4.374380750176929,20.0,20.0
12826,1,2826,[127 187 483 302 211],13,5,12367,4.374602051644853,20.0,20.0
12827,1,2827,[182 186 322  96 588],308,4,12371,4.374469589816124,0.0,0.0
12828,1,2828,[127 187 483 302 211],339,5,12376,4.374690703428773,20.0,20.0
12829,1,2829,[127 187 483 302 211],666,5,12381,4.374911660777385,20.0,20.0
12830,1,2830,[127 187 483 302 211],328,5,12386,4.375132462027552,20.0,20.0
12831,1,2831,[ 12 515 271 423   1],92,3,12389,4.374646892655368,20.0,0.0
12832,1,2832,[127 187 483 302 211],13,5,12394,4.374867631486057,20.0,20.0
12833,1,2833,[471 196 405 216 496],533,4,12398,4.374735356386733,0.0,0.0
12834,1,2834,[127 187 483 302 211],666,5,12403,4.374955908289242,20.0,20.0
12835,1,2835,[ 95 182 238 588 181],59,3,12406,4.374471086036672,0.0,0.0
12836,1,2836,[  4 200 179 286  12],527,1,12407,4.37328163553049,20.0,0.0
12837,1,2837,[127 187 483 302 211],524,5,12412,4.373502466525722,20.0,20.0
12838,1,2838,[127 187 483 302 211],210,5,12417,4.373723141951391,20.0,20.0
12839,1,2839,[  9  71   8 153 276],6,4,12421,4.373591549295774,0.0,0.0
12840,1,2840,[127 187 483 302 211],207,5,12426,4.373812038014783,20.0,20.0
12841,1,2841,[143 222 483 257 423],334,4,12430,4.3736805066854325,20.0,0.0
12842,1,2842,[127 187 483 302 211],833,3,12433,4.3731973267674995,20.0,20.0
12843,1,2843,[127 187 483 302 211],210,5,12438,4.3734177215189876,20.0,20.0
12844,1,2844,[127 187 483 302 211],524,5,12443,4.373637961335676,20.0,20.0
12845,1,2845,[127 187 483 302 211],666,5,12448,4.373858046380885,20.0,20.0
12846,1,2846,[127 187 483 302 211],474,5,12453,4.374077976817703,20.0,20.0
12847,1,2847,[127 187 483 302 211],343,5,12458,4.374297752808989,20.0,20.0
12848,1,2848,[127 187 483 302 211],210,5,12463,4.374517374517374,20.0,20.0
12849,1,2849,[127 187 483 302 211],207,5,12468,4.374736842105263,20.0,20.0
12850,1,2850,[294 313 111 508 185],537,3,12471,4.3742546474921085,0.0,0.0
12851,1,2851,[289 204 197 187  69],194,4,12475,4.3741234221598875,0.0,0.0
12852,1,2852,[ 95 257 191 568 289],455,4,12479,4.373992288818787,0.0,0.0
12853,1,2853,[127 187 483 302 211],210,5,12484,4.374211632796076,20.0,20.0
12854,1,2854,[127 187 483 302 211],343,5,12489,4.374430823117338,20.0,20.0
12855,1,2855,[127 187 483 302 211],524,5,12494,4.374649859943977,20.0,20.0
12856,1,2856,[127 187 483 302 211],328,5,12499,4.374868743437172,20.0,20.0
12857,1,2857,[127 187 483 302 211],833,3,12502,4.374387683694891,20.0,20.0
12858,1,2858,[127 187 483 302 211],524,5,12507,4.374606505771249,20.0,20.0
12859,1,2859,[127 187 483 302 211],207,5,12512,4.374825174825175,20.0,20.0
12860,1,2860,[127 187 483 302 211],666,5,12517,4.375043691017127,20.0,20.0
12861,1,2861,[127 187 483 302 211],210,5,12522,4.3752620545073375,20.0,20.0
12862,1,2862,[127 187 483 302 211],90,5,12527,4.375480265455815,20.0,20.0
12863,1,2863,[127 187 483 302 211],6,5,12532,4.375698324022347,20.0,20.0
12864,1,2864,[ 56  98   1 322 176],13,2,12534,4.374869109947644,0.0,20.0
12865,1,2865,[127 187 483 302 211],524,5,12539,4.375087229588276,20.0,20.0
12866,1,2866,[127 187 483 302 211],474,5,12544,4.375305197070108,20.0,20.0
12867,1,2867,[127 187 483 302 211],210,5,12549,4.375523012552302,20.0,20.0
12868,1,2868,[200 183 258 405 301],145,4,12553,4.375392122690833,0.0,0.0
12869,1,2869,[127 187 483 302 211],328,5,12558,4.375609756097561,20.0,20.0
12870,1,2870,[127 187 483 302 211],6,5,12563,4.375827237896203,20.0,20.0
12871,1,2871,[127 187 483 302 211],474,5,12568,4.376044568245125,20.0,20.0
12872,1,2872,[127 187 483 302 211],210,5,12573,4.376261747302471,20.0,20.0
12873,1,2873,[127 187 483 302 211],524,5,12578,4.376478775226166,20.0,20.0
12874,1,2874,[127 187 483 302 211],474,5,12583,4.376695652173913,20.0,20.0
12875,1,2875,[127 187 483 302 211],524,5,12588,4.3769123783031985,20.0,20.0
12876,1,2876,[127 187 483 302 211],13,5,12593,4.377128953771289,20.0,20.0
12877,1,2877,[127 187 483 302 211],210,5,12598,4.3773453787352326,20.0,20.0
12878,1,2878,[127 187 483 302 211],339,5,12603,4.377561653351858,20.0,20.0
12879,1,2879,[127 187 483 302 211],833,3,12606,4.377083333333333,20.0,20.0
12880,1,2880,[127 187 483 302 211],343,5,12611,4.377299548767789,20.0,20.0
12881,1,2881,[127 187 483 302 211],666,5,12616,4.377515614156835,20.0,20.0
12882,1,2882,[127 187 483 302 211],537,5,12621,4.377731529656607,20.0,20.0
12883,1,2883,[127 187 483 302 211],207,5,12626,4.377947295423024,20.0,20.0
12884,1,2884,[127 187 483 302 211],207,5,12631,4.378162911611785,20.0,20.0
12885,1,2885,[204  28  22  89  88],311,5,12636,4.378378378378378,0.0,0.0
12886,1,2886,[483 127 271  98 211],328,4,12640,4.378247315552477,20.0,40.0
12887,1,2887,[127 187 483 302 211],833,3,12643,4.377770083102493,20.0,20.0
12888,1,2888,[127 187 483 302 211],343,5,12648,4.3779854620976115,20.0,20.0
12889,1,2889,[127 187 483 302 211],13,5,12653,4.378200692041522,20.0,20.0
12890,1,2890,[127 187 483 302 211],666,5,12658,4.378415773088896,20.0,20.0
12891,1,2891,[127 187 483 302 211],339,5,12663,4.378630705394191,20.0,20.0
12892,1,2892,[257  28 144 483  22],339,4,12667,4.378499827169029,20.0,0.0
12893,1,2893,[127 187 483 302 211],328,5,12672,4.378714581893573,20.0,20.0
12894,1,2894,[127 187 483 302 211],524,5,12677,4.378929188255613,20.0,20.0
12895,1,2895,[127 187 483 302 211],474,5,12682,4.379143646408839,20.0,20.0
12896,1,2896,[127 187 483 302 211],13,5,12687,4.379357956506731,20.0,20.0
12897,1,2897,[471  96  97 294 333],666,2,12689,4.378536922015183,0.0,0.0
12898,1,2898,[200 175   9 237 100],6,3,12692,4.378061400482925,0.0,20.0
12899,1,2899,[127 187 483 302 211],666,5,12697,4.378275862068966,20.0,20.0
12900,1,2900,[127 187 483 302 211],524,5,12702,4.378490175801447,20.0,20.0
12901,1,2901,[ 88 496 117  12 257],271,4,12706,4.378359751895244,20.0,0.0
12902,1,2902,[127 187 483 302 211],524,5,12711,4.378573889080262,20.0,20.0
12903,1,2903,[127 187 483 302 211],339,5,12716,4.378787878787879,20.0,20.0
12904,1,2904,[127 187 483 302 211],339,5,12721,4.379001721170396,20.0,20.0
12905,1,2905,[127 187 483 302 211],13,5,12726,4.379215416379903,20.0,20.0
12906,1,2906,[127 187 483 302 211],328,5,12731,4.379428964568284,20.0,20.0
12907,1,2907,[127 187 483 302 211],90,5,12736,4.379642365887208,20.0,20.0
12908,1,2908,[194 195  95 151 187],648,2,12738,4.3788243382605705,0.0,0.0
12909,1,2909,[127 187 483 302 211],474,5,12743,4.379037800687286,20.0,20.0
12910,1,2910,[127 187 483 302 211],210,5,12748,4.379251116454826,20.0,20.0
12911,1,2911,[127 187 483 302 211],666,5,12753,4.379464285714286,20.0,20.0
12912,1,2912,[127 187 483 302 211],13,5,12758,4.379677308616547,20.0,20.0
12913,1,2913,[191  12 135 196 258],92,5,12763,4.379890185312285,20.0,0.0
12914,1,2914,[258 496 515 191  95],6,3,12766,4.379416809605489,0.0,0.0
12915,1,2915,[127 187 483 302 211],833,3,12769,4.378943758573389,20.0,20.0
12916,1,2916,[127 187 483 302 211],474,5,12774,4.379156667809394,20.0,20.0
12917,1,2917,[127 187 483 302 211],666,5,12779,4.379369431117204,20.0,20.0
12918,1,2918,[127 187 483 302 211],666,5,12784,4.379582048646797,20.0,20.0
12919,1,2919,[127 187 483 302 211],13,5,12789,4.379794520547946,20.0,20.0
12920,1,2920,[127 187 483 302 211],328,5,12794,4.380006846970216,20.0,20.0
12921,1,2921,[127 187 483 302 211],524,5,12799,4.380219028062971,20.0,20.0
12922,1,2922,[127 187 483 302 211],833,3,12802,4.379746835443038,20.0,20.0
12923,1,2923,[127 187 483 302 211],537,5,12807,4.3799589603283176,20.0,20.0
12924,1,2924,[127 187 483 302 211],524,5,12812,4.38017094017094,20.0,20.0
12925,1,2925,[127 187 483 302 211],339,5,12817,4.380382775119617,20.0,20.0
12926,1,2926,[127 187 483 302 211],6,5,12822,4.380594465322856,20.0,20.0
12927,1,2927,[294  88 405  70 111],378,2,12824,4.379781420765028,0.0,0.0
12928,1,2928,[127 187 483 302 211],90,5,12829,4.379993171730966,20.0,20.0
12929,1,2929,[127 187 483 302 211],6,5,12834,4.380204778156997,20.0,20.0
12930,1,2930,[127 187 483 302 211],90,5,12839,4.380416240191061,20.0,20.0
12931,1,2931,[127 187 483 302 211],6,5,12844,4.3806275579809,20.0,20.0
12932,1,2932,[127 187 483 302 211],524,5,12849,4.380838731674054,20.0,20.0
12933,1,2933,[ 28 403 197 191 275],7,5,12854,4.381049761417859,0.0,0.0
12934,1,2934,[127 187 483 302 211],474,5,12859,4.381260647359455,20.0,20.0
12935,1,2935,[127 187 483 302 211],90,5,12864,4.381471389645776,20.0,20.0
12936,1,2936,[258 300 423 176 204],653,2,12866,4.380660537963909,0.0,0.0
12937,1,2937,[127 187 483 302 211],207,5,12871,4.380871341048332,20.0,20.0
12938,1,2938,[127 187 483 302 211],666,5,12876,4.381082000680504,20.0,20.0
12939,1,2939,[127 187 483 302 211],328,5,12881,4.381292517006803,20.0,20.0
12940,1,2940,[127 187 483 302 211],339,5,12886,4.381502890173411,20.0,20.0
12941,1,2941,[127 143  71 403 187],533,4,12890,4.38137321549966,0.0,20.0
12942,1,2942,[127 187 483 302 211],90,5,12895,4.381583418280666,20.0,20.0
12943,1,2943,[403   1 385 181 204],749,4,12899,4.381453804347826,0.0,0.0
12944,1,2944,[127 187 483 302 211],343,5,12904,4.381663837011884,20.0,20.0
12945,1,2945,[127 187 483 302 211],90,5,12909,4.3818737270875765,20.0,20.0
12946,1,2946,[127 187 483 302 211],210,5,12914,4.382083474720054,20.0,20.0
12947,1,2947,[127 187 483 302 211],328,5,12919,4.382293080054274,20.0,20.0
12948,1,2948,[111 132 143 172 125],42,4,12923,4.3821634452356735,0.0,0.0
12949,1,2949,[127 187 483 302 211],210,5,12928,4.382372881355932,20.0,20.0
12950,1,2950,[127 187 483 302 211],339,5,12933,4.3825821755337175,20.0,20.0
12951,1,2951,[127 187 483 302 211],537,5,12938,4.382791327913279,20.0,20.0
12952,1,2952,[127 187 483 302 211],328,5,12943,4.383000338638673,20.0,20.0
12953,1,2953,[173 216   7 181 200],7,4,12947,4.382870683818551,0.0,0.0
12954,1,2954,[127 187 483 302 211],339,5,12952,4.383079526226735,20.0,20.0
12955,1,2955,[127 187 483 302 211],6,5,12957,4.383288227334235,20.0,20.0
12956,1,2956,[127 187 483 302 211],328,5,12962,4.38349678728441,20.0,20.0
12957,1,2957,[127 187 483 302 211],210,5,12967,4.383705206220419,20.0,20.0
12958,1,2958,[127 187 483 302 211],474,5,12972,4.383913484285231,20.0,20.0
12959,1,2959,[ 56 173  50 302 117],524,4,12976,4.383783783783784,0.0,20.0
12960,1,2960,[196 222  88 151 471],479,5,12981,4.383991894630192,0.0,0.0
12961,1,2961,[127 187 483 302 211],524,5,12986,4.384199864956111,20.0,20.0
12962,1,2962,[127 187 483 302 211],474,5,12991,4.384407694903814,20.0,20.0
12963,1,2963,[135   1 111 118 258],271,2,12993,4.383603238866397,0.0,0.0
12964,1,2964,[127 187 483 302 211],343,5,12998,4.38381112984823,20.0,20.0
12965,1,2965,[153  64 151 182 132],7,5,13003,4.384018880647337,0.0,0.0
12966,1,2966,[357  12  69 286  64],458,3,13006,4.383552409841591,40.0,0.0
12967,1,2967,[127 187 483 302 211],537,5,13011,4.383760107816712,20.0,20.0
12968,1,2968,[127 187 483 302 211],6,5,13016,4.383967665880768,20.0,20.0
12969,1,2969,[127 187 483 302 211],833,3,13019,4.383501683501684,20.0,20.0
12970,1,2970,[127 187 483 302 211],339,5,13024,4.3837091888253115,20.0,20.0
12971,1,2971,[127 187 483 302 211],474,5,13029,4.383916554508748,20.0,20.0
12972,1,2972,[385 269 289 423 228],537,0,13029,4.382441977800202,0.0,0.0
12973,1,2973,[127 187 483 302 211],474,5,13034,4.382649630127774,20.0,20.0
12974,1,2974,[127 187 483 302 211],833,3,13037,4.38218487394958,20.0,20.0
12975,1,2975,[127 187 483 302 211],474,5,13042,4.38239247311828,20.0,20.0
12976,1,2976,[127 187 483 302 211],210,5,13047,4.382599932818273,20.0,20.0
12977,1,2977,[127 187 483 302 211],537,5,13052,4.382807253190061,20.0,20.0
12978,1,2978,[127 187 483 302 211],207,5,13057,4.383014434373951,20.0,20.0
12979,1,2979,[172 180 385 100  89],346,4,13061,4.3828859060402685,0.0,20.0
12980,1,2980,[127 187 483 302 211],6,5,13066,4.383092921838309,20.0,20.0
12981,1,2981,[127 187 483 302 211],6,5,13071,4.383299798792756,20.0,20.0
12982,1,2982,[211 294 161 202  70],479,3,13074,4.382836071069393,0.0,0.0
12983,1,2983,[ 88 132  64   8 405],840,5,13079,4.383042895442359,0.0,0.0
12984,1,2984,[127 187 483 302 211],474,5,13084,4.383249581239531,20.0,20.0
12985,1,2985,[127 187 483 302 211],524,5,13089,4.383456128600134,20.0,20.0
12986,1,2986,[  1 135 180 121 357],213,4,13093,4.383327753598929,20.0,0.0
12987,1,2987,[127 187 483 302 211],343,5,13098,4.383534136546185,20.0,20.0
12988,1,2988,[127 187 483 302 211],210,5,13103,4.383740381398461,20.0,20.0
12989,1,2989,[  8 179 143 318  64],311,3,13106,4.383277591973244,20.0,0.0
12990,1,2990,[127 187 483 302 211],343,5,13111,4.383483784687395,20.0,20.0
12991,1,2991,[127 187 483 302 211],90,5,13116,4.383689839572193,20.0,20.0
12992,1,2992,[  1  89 135 127   8],455,4,13120,4.383561643835616,0.0,20.0
12993,1,2993,[127 187 483 302 211],210,5,13125,4.38376753507014,20.0,20.0
12994,1,2994,[127 187 483 302 211],343,5,13130,4.383973288814691,20.0,20.0
12995,1,2995,[127 187 483 302 211],343,5,13135,4.384178905206943,20.0,20.0
12996,1,2996,[127 187 483 302 211],90,5,13140,4.384384384384385,20.0,20.0
12997,1,2997,[127 187 483 302 211],339,5,13145,4.3845897264843225,20.0,20.0
12998,1,2998,[127 187 483 302 211],210,5,13150,4.3847949316438815,20.0,20.0
12999,1,2999,[127 187 483 302 211],524,5,13155,4.385,20.0,20.0
13000,1,3000,[127 187 483 302 211],90,5,13160,4.385204931689437,20.0,20.0
13001,1,3001,[127 187 483 302 211],6,5,13165,4.385409726848767,20.0,20.0
13002,1,3002,[127 187 483 302 211],90,5,13170,4.385614385614385,20.0,20.0
13003,1,3003,[127 187 483 302 211],13,5,13175,4.385818908122503,20.0,20.0
13004,1,3004,[125 323 238  28 196],378,2,13177,4.385024958402663,0.0,0.0
13005,1,3005,[176 323 496 215 211],311,3,13180,4.384564204923486,0.0,0.0
13006,1,3006,[127 187 483 302 211],210,5,13185,4.384768872630529,20.0,20.0
13007,1,3007,[127 187 483 302 211],328,5,13190,4.3849734042553195,20.0,20.0
13008,1,3008,[127 187 483 302 211],474,5,13195,4.385177799933532,20.0,20.0
13009,1,3009,[127 187 483 302 211],339,5,13200,4.385382059800665,20.0,20.0
13010,1,3010,[127 187 483 302 211],13,5,13205,4.38558618399203,20.0,20.0
13011,1,3011,[546 185 118 357 238],308,3,13208,4.385126162018592,20.0,0.0
13012,1,3012,[127 187 483 302 211],666,5,13213,4.385330235645536,20.0,20.0
13013,1,3013,[127 187 483 302 211],833,3,13216,4.384870603848706,20.0,20.0
13014,1,3014,[127 187 483 302 211],666,5,13221,4.385074626865672,20.0,20.0
13015,1,3015,[127 187 483 302 211],13,5,13226,4.385278514588859,20.0,20.0
13016,1,3016,[568  98 168 127   9],85,4,13230,4.385150812064965,0.0,40.0
13017,1,3017,[127 187 483 302 211],537,5,13235,4.385354539430086,20.0,20.0
13018,1,3018,[237 742   9 172 121],145,3,13238,4.3848956608148395,0.0,0.0
13019,1,3019,[127 187 483 302 211],524,5,13243,4.385099337748344,20.0,20.0
13020,1,3020,[127 187 483 302 211],339,5,13248,4.385302879841112,20.0,20.0
13021,1,3021,[186   9  22  82 403],334,4,13252,4.3851753805426865,0.0,0.0
13022,1,3022,[273 194 121 323 153],328,1,13253,4.384055573933179,0.0,0.0
13023,1,3023,[127 187 483 302 211],6,5,13258,4.3842592592592595,20.0,20.0
13024,1,3024,[127 187 483 302 211],537,5,13263,4.3844628099173555,20.0,20.0
13025,1,3025,[127 187 483 302 211],524,5,13268,4.384666226040978,20.0,20.0
13026,1,3026,[117 100 269 301 127],650,3,13271,4.38420878757846,0.0,40.0
13027,1,3027,[238 216  28  50 294],125,3,13274,4.383751651254954,0.0,20.0
13028,1,3028,[127 187 483 302 211],833,3,13277,4.383294816771212,20.0,20.0
13029,1,3029,[286  96 195 238  50],7,5,13282,4.3834983498349835,0.0,20.0
13030,1,3030,[127 187 483 302 211],90,5,13287,4.383701748597822,20.0,20.0
13031,1,3031,[127 187 483 302 211],6,5,13292,4.383905013192612,20.0,20.0
13032,1,3032,[127 187 483 302 211],666,5,13297,4.38410814375206,20.0,20.0
13033,1,3033,[127 187 483 302 211],833,3,13300,4.383651944627554,20.0,20.0
13034,1,3034,[127 187 483 302 211],328,5,13305,4.383855024711697,20.0,20.0
13035,1,3035,[127 187 483 302 211],343,5,13310,4.384057971014493,20.0,20.0
13036,1,3036,[127 187 483 302 211],13,5,13315,4.384260783668093,20.0,20.0
13037,1,3037,[127 187 483 302 211],6,5,13320,4.384463462804477,20.0,20.0
13038,1,3038,[127 187 483 302 211],833,3,13323,4.38400789733465,20.0,20.0
13039,1,3039,[127 187 483 302 211],328,5,13328,4.38421052631579,20.0,20.0
13040,1,3040,[121 127  82   8 187],892,4,13332,4.384084182834594,0.0,20.0
13041,1,3041,[ 96 127  50 318 228],533,5,13337,4.384286653517423,20.0,40.0
13042,1,3042,[127 187 483 302 211],833,3,13340,4.383831744988498,20.0,20.0
13043,1,3043,[301 238 237 546   7],13,1,13341,4.382720105124836,0.0,0.0
13044,1,3044,[127 187 483 302 211],524,5,13346,4.382922824302135,20.0,20.0
13045,1,3045,[269 181 435 143 357],125,3,13349,4.382468811556139,20.0,0.0
13046,1,3046,[127 187 483 302 211],210,5,13354,4.382671480144404,20.0,20.0
13047,1,3047,[127 187 483 302 211],343,5,13359,4.3828740157480315,20.0,20.0
13048,1,3048,[127 187 483 302 211],524,5,13364,4.383076418497868,20.0,20.0
13049,1,3049,[127 187 483 302 211],328,5,13369,4.38327868852459,20.0,20.0
13050,1,3050,[597  88 483 185 276],643,3,13372,4.382825303179286,20.0,0.0
13051,1,3051,[471 215 328 187 182],788,2,13374,4.382044560943643,0.0,0.0
13052,1,3052,[127 187 483 302 211],90,5,13379,4.382246970193252,20.0,20.0
13053,1,3053,[151 496 210 546  25],200,3,13382,4.381794368041912,0.0,0.0
13054,1,3054,[546 265 323 427  69],13,3,13385,4.381342062193126,0.0,0.0
13055,1,3055,[127 187 483 302 211],207,5,13390,4.3815445026178015,20.0,20.0
13056,1,3056,[748  82 328   4  25],207,2,13392,4.380765456329735,0.0,0.0
13057,1,3057,[191  98  79 174 195],7,5,13397,4.380967952910399,0.0,40.0
13058,1,3058,[174  50 181 288 153],334,4,13401,4.380843412880026,0.0,40.0
13059,1,3059,[127 187 483 302 211],6,5,13406,4.381045751633987,20.0,20.0
13060,1,3060,[127 187 483 302 211],666,5,13411,4.3812479581836,20.0,20.0
13061,1,3061,[127 187 483 302 211],13,5,13416,4.381450032658393,20.0,20.0
13062,1,3062,[294 269 196 301  11],666,3,13419,4.380999020568071,0.0,0.0
13063,1,3063,[127 187 483 302 211],207,5,13424,4.381201044386423,20.0,20.0
13064,1,3064,[127 187 483 302 211],210,5,13429,4.381402936378467,20.0,20.0
13065,1,3065,[245 186 151 135 172],804,3,13432,4.380952380952381,0.0,0.0
13066,1,3066,[127 187 483 302 211],207,5,13437,4.381154222367134,20.0,20.0
13067,1,3067,[127 187 483 302 211],666,5,13442,4.38135593220339,20.0,20.0
13068,1,3068,[100 273  98 183  11],378,4,13446,4.381231671554252,0.0,40.0
13069,1,3069,[127 187 483 302 211],90,5,13451,4.381433224755701,20.0,20.0
13070,1,3070,[127 187 483 302 211],833,3,13454,4.380983393031586,20.0,20.0
13071,1,3071,[127 187 483 302 211],328,5,13459,4.381184895833333,20.0,20.0
13072,1,3072,[515 235 121 183  89],145,4,13463,4.381060852587049,0.0,0.0
13073,1,3073,[127 187 483 302 211],328,5,13468,4.381262199089135,20.0,20.0
13074,1,3074,[127 187 483 302 211],6,5,13473,4.381463414634147,20.0,20.0
13075,1,3075,[127 187 483 302 211],833,3,13476,4.381014304291288,20.0,20.0
13076,1,3076,[ 96 181  71 294  22],452,2,13478,4.3802404939876505,0.0,0.0
13077,1,3077,[127 187 483 302 211],339,5,13483,4.380441845354126,20.0,20.0
13078,1,3078,[ 97  15 187 286  50],474,5,13488,4.380643065930497,0.0,20.0
13079,1,3079,[127 187 483 302 211],524,5,13493,4.380844155844156,20.0,20.0
13080,1,3080,[127 187 483 302 211],6,5,13498,4.381045115222331,20.0,20.0
13081,1,3081,[127 187 483 302 211],537,5,13503,4.3812459441920835,20.0,20.0
13082,1,3082,[127 187 483 302 211],210,5,13508,4.381446642880311,20.0,20.0
13083,1,3083,[127 187 483 302 211],207,5,13513,4.381647211413749,20.0,20.0
13084,1,3084,[127 187 483 302 211],474,5,13518,4.381847649918963,20.0,20.0
13085,1,3085,[127 187 483 302 211],210,5,13523,4.382047958522359,20.0,20.0
13086,1,3086,[135 228 195  28 168],194,2,13525,4.38127632005183,0.0,0.0
13087,1,3087,[127 187 483 302 211],524,5,13530,4.381476683937824,20.0,20.0
13088,1,3088,[127 187 483 302 211],339,5,13535,4.381676918096471,20.0,20.0
13089,1,3089,[127 187 483 302 211],207,5,13540,4.381877022653722,20.0,20.0
13090,1,3090,[222  82  15 179 423],650,1,13541,4.380782918149467,0.0,0.0
13091,1,3091,[127 187 483 302 211],207,5,13546,4.38098318240621,20.0,20.0
13092,1,3092,[127 187 483 302 211],6,5,13551,4.381183317167798,20.0,20.0
13093,1,3093,[127 187 483 302 211],833,3,13554,4.380736910148675,20.0,20.0
13094,1,3094,[127 187 483 302 211],339,5,13559,4.380936995153474,20.0,20.0
13095,1,3095,[127 187 483 302 211],524,5,13564,4.381136950904393,20.0,20.0
13096,1,3096,[127 187 483 302 211],474,5,13569,4.381336777526639,20.0,20.0
13097,1,3097,[302 127 174 182 194],271,4,13573,4.381213686249193,0.0,40.0
13098,1,3098,[127 187 483 302 211],833,3,13576,4.380767989674088,20.0,20.0
13099,1,3099,[ 89 288 748 144 179],648,4,13580,4.380645161290323,0.0,0.0
13100,1,3100,[191  70 186  50 118],648,4,13584,4.380522412125121,0.0,20.0
13101,1,3101,[515 216 161 483  97],95,3,13587,4.380077369439071,20.0,0.0
13102,1,3102,[127 187 483 302 211],833,3,13590,4.3796326135997425,20.0,20.0
13103,1,3103,[181 313  95 202 403],64,5,13595,4.379832474226804,0.0,0.0
13104,1,3104,[127 187 483 302 211],207,5,13600,4.3800322061191626,20.0,20.0
13105,1,3105,[ 69  71 174  89 515],7,4,13604,4.37990985189955,0.0,20.0
13106,1,3106,[127 187 483 302 211],339,5,13609,4.380109430318635,20.0,20.0
13107,1,3107,[127 187 483 302 211],666,5,13614,4.38030888030888,20.0,20.0
13108,1,3108,[127 187 483 302 211],833,3,13617,4.379864908330653,20.0,20.0
13109,1,3109,[127 187 483 302 211],13,5,13622,4.380064308681672,20.0,20.0
13110,1,3110,[127 187 483 302 211],524,5,13627,4.380263580842173,20.0,20.0
13111,1,3111,[127 187 483 302 211],474,5,13632,4.380462724935732,20.0,20.0
13112,1,3112,[127 187 483 302 211],207,5,13637,4.38066174108577,20.0,20.0
13113,1,3113,[ 79 215 161  28 234],13,4,13641,4.380539499036609,0.0,0.0
13114,1,3114,[127 187 483 302 211],524,5,13646,4.380738362760835,20.0,20.0
13115,1,3115,[127 187 483 302 211],339,5,13651,4.380937098844672,20.0,20.0
13116,1,3116,[127 187 483 302 211],833,3,13654,4.380494064805903,20.0,20.0
13117,1,3117,[235  22 186  56  11],295,5,13659,4.380692751763951,0.0,0.0
13118,1,3118,[294 186 196 191 216],92,3,13662,4.380250080153895,0.0,0.0
13119,1,3119,[127 187 483 302 211],328,5,13667,4.380448717948718,20.0,20.0
13120,1,3120,[318 215 216  70 265],13,2,13669,4.379685998077539,20.0,0.0
13121,1,3121,[127 187 483 302 211],474,5,13674,4.37988468930173,20.0,20.0
13122,1,3122,[289 302 222 508 215],537,2,13676,4.379122638488632,0.0,0.0
13123,1,3123,[127 187 483 302 211],537,5,13681,4.37932138284251,20.0,20.0
13124,1,3124,[  7  71  25 191 568],648,2,13683,4.37856,0.0,0.0
13125,1,3125,[127 187 483 302 211],210,5,13688,4.378758797184901,20.0,20.0
13126,1,3126,[127 187 483 302 211],343,5,13693,4.378957467220979,20.0,20.0
13127,1,3127,[127 187 483 302 211],343,5,13698,4.379156010230179,20.0,20.0
13128,1,3128,[127 187 483 302 211],6,5,13703,4.3793544263342925,20.0,20.0
13129,1,3129,[127 187 483 302 211],6,5,13708,4.379552715654952,20.0,20.0
13130,1,3130,[127 187 483 302 211],207,5,13713,4.379750878313637,20.0,20.0
13131,1,3131,[179 228 174 265 245],653,5,13718,4.379948914431673,0.0,20.0
13132,1,3132,[  1 191  71 405 204],804,5,13723,4.380146824130227,0.0,0.0
13133,1,3133,[127 187 483 302 211],537,5,13728,4.380344607530312,20.0,20.0
13134,1,3134,[ 22 143  11  12 275],64,5,13733,4.380542264752791,20.0,0.0
13135,1,3135,[127 187 483 302 211],210,5,13738,4.380739795918367,20.0,20.0
13136,1,3136,[127 187 483 302 211],343,5,13743,4.380937201147593,20.0,20.0
13137,1,3137,[127 187 483 302 211],210,5,13748,4.381134480560867,20.0,20.0
13138,1,3138,[100 127 423 258 196],666,3,13751,4.380694488690666,0.0,40.0
13139,1,3139,[597 202 328 288 405],804,3,13754,4.380254777070063,0.0,0.0
13140,1,3140,[127 187 483 302 211],13,5,13759,4.380452085323146,20.0,20.0
13141,1,3141,[127 187 483 302 211],537,5,13764,4.380649267982177,20.0,20.0
13142,1,3142,[127 187 483 302 211],90,5,13769,4.380846325167038,20.0,20.0
13143,1,3143,[127 187 483 302 211],328,5,13774,4.381043256997455,20.0,20.0
13144,1,3144,[186 100 195 191 269],339,4,13778,4.380922098569157,0.0,20.0
13145,1,3145,[127 187 483 302 211],343,5,13783,4.381118881118881,20.0,20.0
13146,1,3146,[ 15 385 222 135 234],92,4,13787,4.380997775659358,0.0,0.0
13147,1,3147,[211 175 143 181 471],207,2,13789,4.380241423125794,0.0,0.0
13148,1,3148,[127 187 483 302 211],833,3,13792,4.379803112099079,20.0,20.0
13149,1,3149,[127 187 483 302 211],537,5,13797,4.38,20.0,20.0
13150,1,3150,[276 508 258 143 322],334,2,13799,4.3792446842272295,0.0,0.0
13151,1,3151,[127 187 483 302 211],343,5,13804,4.379441624365482,20.0,20.0
13152,1,3152,[313  69  12 238 471],378,2,13806,4.378686964795433,20.0,0.0
13153,1,3153,[127 187 483 302 211],328,5,13811,4.378883956880152,20.0,20.0
13154,1,3154,[127 187 483 302 211],207,5,13816,4.379080824088748,20.0,20.0
13155,1,3155,[ 70 273  22  98 385],59,3,13819,4.3786438529784535,0.0,20.0
13156,1,3156,[127 187 483 302 211],339,5,13824,4.378840671523599,20.0,20.0
13157,1,3157,[546 405 423 496 151],95,3,13827,4.378404053198227,0.0,0.0
13158,1,3158,[742 197 143 181 282],653,1,13828,4.377334599556821,0.0,0.0
13159,1,3159,[ 22 215 228 204 172],648,4,13832,4.377215189873418,0.0,0.0
13160,1,3160,[508  28 196 294 435],406,2,13834,4.376463144574502,0.0,0.0
13161,1,3161,[127 187 483 302 211],90,5,13839,4.3766603415559775,20.0,20.0
13162,1,3162,[ 97 173 180 186 603],234,1,13840,4.375592791653493,20.0,0.0
13163,1,3163,[127 187 483 302 211],13,5,13845,4.375790139064476,20.0,20.0
13164,1,3164,[ 70 235 172 234 204],194,1,13846,4.374723538704582,0.0,0.0
13165,1,3165,[127 187 483 302 211],90,5,13851,4.3749210360075805,20.0,20.0
13166,1,3166,[  7 603  56 172 276],643,5,13856,4.37511840858857,20.0,0.0
13167,1,3167,[127 187 483 302 211],474,5,13861,4.375315656565657,20.0,20.0
13168,1,3168,[ 98 191 204 423 588],95,4,13865,4.37519722309877,0.0,20.0
13169,1,3169,[127 187 483 302 211],339,5,13870,4.375394321766562,20.0,20.0
13170,1,3170,[127 187 483 302 211],90,5,13875,4.375591296121097,20.0,20.0
13171,1,3171,[  4 655 127 186 181],326,3,13878,4.37515762925599,0.0,20.0
13172,1,3172,[127 187 483 302 211],339,5,13883,4.375354554049795,20.0,20.0
13173,1,3173,[127 187 483 302 211],90,5,13888,4.375551354757404,20.0,20.0
13174,1,3174,[153  71  64 288  15],378,4,13892,4.3754330708661415,0.0,0.0
13175,1,3175,[127 187 483 302 211],90,5,13897,4.375629722921914,20.0,20.0
13176,1,3176,[323 496  28  70  15],311,4,13901,4.3755114888259365,0.0,0.0
13177,1,3177,[127 187 483 302 211],210,5,13906,4.37570799244808,20.0,20.0
13178,1,3178,[127 187 483 302 211],6,5,13911,4.375904372444165,20.0,20.0
13179,1,3179,[127 187 483 302 211],207,5,13916,4.376100628930818,20.0,20.0
13180,1,3180,[ 50  98 289 423 153],41,3,13919,4.375668028921723,0.0,40.0
13181,1,3181,[127 187 483 302 211],6,5,13924,4.3758642363293525,20.0,20.0
13182,1,3182,[127 187 483 302 211],328,5,13929,4.376060320452403,20.0,20.0
13183,1,3183,[127 187 483 302 211],328,5,13934,4.376256281407035,20.0,20.0
13184,1,3184,[127 187 483 302 211],339,5,13939,4.3764521193092625,20.0,20.0
13185,1,3185,[294  96 435 127 204],533,5,13944,4.376647834274953,0.0,20.0
13186,1,3186,[173  50  70 168  71],148,5,13949,4.37684342641983,0.0,20.0
13187,1,3187,[127 187 483 302 211],537,5,13954,4.377038895859473,20.0,20.0
13188,1,3188,[127 187 483 302 211],13,5,13959,4.377234242709314,20.0,20.0
13189,1,3189,[127 187 483 302 211],343,5,13964,4.37742946708464,20.0,20.0
13190,1,3190,[127 187 483 302 211],6,5,13969,4.377624569100595,20.0,20.0
13191,1,3191,[  4 204 215 168 125],648,2,13971,4.3768796992481205,0.0,0.0
13192,1,3192,[127 187 483 302 211],666,5,13976,4.377074851237081,20.0,20.0
13193,1,3193,[127 187 483 302 211],207,5,13981,4.377269881026925,20.0,20.0
13194,1,3194,[127 187 483 302 211],833,3,13984,4.376838810641628,20.0,20.0
13195,1,3195,[301 197 143  70 117],6,1,13985,4.375782227784731,0.0,0.0
13196,1,3196,[127 187 483 302 211],207,5,13990,4.3759774788864565,20.0,20.0
13197,1,3197,[127 187 483 302 211],207,5,13995,4.376172607879925,20.0,20.0
13198,1,3198,[496 111 117  71 187],479,2,13997,4.375429821819319,0.0,0.0
13199,1,3199,[234  71 191 180 427],452,3,14000,4.375,0.0,0.0
13200,1,3200,[ 88 405  98 423 265],815,5,14005,4.375195251483912,0.0,20.0
13201,1,3201,[127 187 483 302 211],474,5,14010,4.375390381011868,20.0,20.0
13202,1,3202,[127 187 483 302 211],343,5,14015,4.375585388698095,20.0,20.0
13203,1,3203,[127 187 483 302 211],207,5,14020,4.375780274656679,20.0,20.0
13204,1,3204,[173 144 496 175  79],650,3,14023,4.375351014040562,0.0,0.0
13205,1,3205,[117 257 173 118 234],738,2,14025,4.374610106051154,0.0,0.0
13206,1,3206,[127 187 483 302 211],6,5,14030,4.374805113813533,20.0,20.0
13207,1,3207,[127 187 483 302 211],474,5,14035,4.375,20.0,20.0
13208,1,3208,[127 187 483 302 211],833,3,14038,4.374571517606731,20.0,20.0
13209,1,3209,[127 187 483 302 211],474,5,14043,4.374766355140187,20.0,20.0
13210,1,3210,[127 187 483 302 211],210,5,14048,4.374961071317347,20.0,20.0
13211,1,3211,[127 187 483 302 211],210,5,14053,4.3751556662515565,20.0,20.0
13212,1,3212,[ 69  15 161 182 222],881,1,14054,4.374105197634609,0.0,0.0
13213,1,3213,[127 187 483 302 211],210,5,14059,4.374299937772246,20.0,20.0
13214,1,3214,[127 187 483 302 211],6,5,14064,4.374494556765163,20.0,20.0
13215,1,3215,[127 187 483 302 211],474,5,14069,4.374689054726368,20.0,20.0
13216,1,3216,[127 187 483 302 211],537,5,14074,4.374883431768729,20.0,20.0
13217,1,3217,[127 187 483 302 211],328,5,14079,4.375077688004972,20.0,20.0
13218,1,3218,[ 71 191 194  79 427],7,5,14084,4.375271823547686,0.0,0.0
13219,1,3219,[127 187 483 302 211],339,5,14089,4.375465838509316,20.0,20.0
13220,1,3220,[127 187 483 302 211],524,5,14094,4.375659733002173,20.0,20.0
13221,1,3221,[127 187 483 302 211],339,5,14099,4.375853507138423,20.0,20.0
13222,1,3222,[127 187 483 302 211],666,5,14104,4.376047161030097,20.0,20.0
13223,1,3223,[222 186  71 182 135],380,1,14105,4.375,0.0,0.0
13224,1,3224,[127 187 483 302 211],474,5,14110,4.3751937984496125,20.0,20.0
13225,1,3225,[127 187 483 302 211],207,5,14115,4.375387476751395,20.0,20.0
13226,1,3226,[127 187 483 302 211],537,5,14120,4.375581035017044,20.0,20.0
13227,1,3227,[405   1 111 234 117],648,4,14124,4.37546468401487,0.0,0.0
13228,1,3228,[127 187 483 302 211],328,5,14129,4.375658098482503,20.0,20.0
13229,1,3229,[127 187 483 302 211],339,5,14134,4.375851393188855,20.0,20.0
13230,1,3230,[328 182  71 173 603],13,3,14137,4.375425564840606,20.0,0.0
13231,1,3231,[127 187 483 302 211],13,5,14142,4.375618811881188,20.0,20.0
13232,1,3232,[127 187 483 302 211],537,5,14147,4.375811939375193,20.0,20.0
13233,1,3233,[127 187 483 302 211],666,5,14152,4.376004947433519,20.0,20.0
13234,1,3234,[127 187 483 302 211],474,5,14157,4.3761978361669245,20.0,20.0
13235,1,3235,[127 187 483 302 211],207,5,14162,4.376390605686032,20.0,20.0
13236,1,3236,[127 187 483 302 211],13,5,14167,4.376583256101329,20.0,20.0
13237,1,3237,[127 187 483 302 211],343,5,14172,4.3767757875231625,20.0,20.0
13238,1,3238,[ 98 210 423 182 234],749,4,14176,4.37665946279716,0.0,20.0
13239,1,3239,[127 187 483 302 211],524,5,14181,4.3768518518518515,20.0,20.0
13240,1,3240,[127 187 483 302 211],90,5,14186,4.377044122184511,20.0,20.0
13241,1,3241,[127 187 483 302 211],343,5,14191,4.377236273904997,20.0,20.0
13242,1,3242,[127 187 483 302 211],524,5,14196,4.377428307123035,20.0,20.0
13243,1,3243,[127 187 483 302 211],328,5,14201,4.377620221948212,20.0,20.0
13244,1,3244,[127 187 483 302 211],833,3,14204,4.377195685670262,20.0,20.0
13245,1,3245,[127 187 483 302 211],207,5,14209,4.377387553912508,20.0,20.0
13246,1,3246,[ 12 742 496 121 435],690,3,14212,4.37696335078534,20.0,0.0
13247,1,3247,[179 153 172 655  22],749,5,14217,4.377155172413793,0.0,0.0
13248,1,3248,[127 187 483 302 211],328,5,14222,4.377346875961835,20.0,20.0
13249,1,3249,[ 97  89 322 678 195],13,2,14224,4.376615384615385,0.0,0.0
13250,1,3250,[273 180 172 257 175],378,4,14228,4.376499538603507,0.0,0.0
13251,1,3251,[127 187 483 302 211],13,5,14233,4.376691266912669,20.0,20.0
13252,1,3252,[127 187 483 302 211],210,5,14238,4.3768828773439905,20.0,20.0
13253,1,3253,[405  96 423 117   7],840,3,14241,4.376459741856177,0.0,0.0
13254,1,3254,[228  11 588  71 151],295,5,14246,4.376651305683564,0.0,0.0
13255,1,3255,[127 187 483 302 211],13,5,14251,4.3768427518427515,20.0,20.0
13256,1,3256,[127 187 483 302 211],339,5,14256,4.377034080442125,20.0,20.0
13257,1,3257,[127 187 483 302 211],474,5,14261,4.377225291589933,20.0,20.0
13258,1,3258,[181  50  96  89   1],447,4,14265,4.377109542804542,0.0,20.0
13259,1,3259,[127 187 483 302 211],339,5,14270,4.377300613496932,20.0,20.0
13260,1,3260,[127 187 483 302 211],474,5,14275,4.377491567003987,20.0,20.0
13261,1,3261,[204  69 588 515  28],815,5,14280,4.377682403433476,0.0,0.0
13262,1,3262,[127 187 483 302 211],339,5,14285,4.377873122893043,20.0,20.0
13263,1,3263,[127 187 483 302 211],6,5,14290,4.378063725490196,20.0,20.0
13264,1,3264,[127 187 483 302 211],666,5,14295,4.378254211332313,20.0,20.0
13265,1,3265,[127 187 483 302 211],474,5,14300,4.378444580526638,20.0,20.0
13266,1,3266,[127 187 483 302 211],6,5,14305,4.378634833180287,20.0,20.0
13267,1,3267,[127 187 483 302 211],90,5,14310,4.378824969400245,20.0,20.0
13268,1,3268,[127 187 483 302 211],6,5,14315,4.379014989293362,20.0,20.0
13269,1,3269,[127 187 483 302 211],207,5,14320,4.379204892966361,20.0,20.0
13270,1,3270,[127 187 483 302 211],339,5,14325,4.3793946805258335,20.0,20.0
13271,1,3271,[127 187 483 302 211],537,5,14330,4.37958435207824,20.0,20.0
13272,1,3272,[127 187 483 302 211],833,3,14333,4.379162847540483,20.0,20.0
13273,1,3273,[168   4 172   8  96],882,5,14338,4.379352474037874,0.0,0.0
13274,1,3274,[127 187 483 302 211],207,5,14343,4.379541984732825,20.0,20.0
13275,1,3275,[186 678 323  15 172],648,3,14346,4.3791208791208796,0.0,0.0
13276,1,3276,[127 187 483 302 211],833,3,14349,4.3787000305157155,20.0,20.0
13277,1,3277,[127 187 483 302 211],524,5,14354,4.37888956680903,20.0,20.0
13278,1,3278,[135  11 742 187  50],749,4,14358,4.3787740164684354,0.0,20.0
13279,1,3279,[127 187 483 302 211],90,5,14363,4.378963414634146,20.0,20.0
13280,1,3280,[111  89  79  98 258],447,3,14366,4.378543127095398,0.0,20.0
13281,1,3281,[168 234 191   4 175],804,5,14371,4.378732480195003,0.0,0.0
13282,1,3282,[333  25 111 268 121],13,3,14374,4.378312519037466,0.0,0.0
13283,1,3283,[ 97 135  89 238  64],311,5,14379,4.3785018270401945,0.0,0.0
13284,1,3284,[100 143 275 195 172],311,3,14382,4.3780821917808215,0.0,20.0
13285,1,3285,[237 269  89 222 200],13,2,14384,4.377358490566038,0.0,0.0
13286,1,3286,[127 187 483 302 211],343,5,14389,4.3775479160328565,20.0,20.0
13287,1,3287,[127 187 483 302 211],6,5,14394,4.377737226277373,20.0,20.0
13288,1,3288,[127 187 483 302 211],833,3,14397,4.377318333840073,20.0,20.0
13289,1,3289,[127 187 483 302 211],474,5,14402,4.377507598784194,20.0,20.0
13290,1,3290,[153 435 179 127   7],87,5,14407,4.377696748708599,0.0,20.0
13291,1,3291,[127 187 483 302 211],666,5,14412,4.377885783718105,20.0,20.0
13292,1,3292,[127 187 483 302 211],6,5,14417,4.378074703917401,20.0,20.0
13293,1,3293,[127 187 483 302 211],90,5,14422,4.378263509411051,20.0,20.0
13294,1,3294,[127 187 483 302 211],90,5,14427,4.3784522003034905,20.0,20.0
13295,1,3295,[127 187 483 302 211],90,5,14432,4.378640776699029,20.0,20.0
13296,1,3296,[127 187 483 302 211],524,5,14437,4.37882923870185,20.0,20.0
13297,1,3297,[127 187 483 302 211],666,5,14442,4.37901758641601,20.0,20.0
13298,1,3298,[127 187 483 302 211],833,3,14445,4.378599575628979,20.0,20.0
13299,1,3299,[127 187 483 302 211],328,5,14450,4.378787878787879,20.0,20.0
13300,1,3300,[ 96 435 215 234 385],378,5,14455,4.378976067858225,0.0,0.0
13301,1,3301,[127 187 483 302 211],474,5,14460,4.3791641429436705,20.0,20.0
13302,1,3302,[127 187 483 302 211],537,5,14465,4.379352104147745,20.0,20.0
13303,1,3303,[127 187 483 302 211],339,5,14470,4.37953995157385,20.0,20.0
13304,1,3304,[127 187 483 302 211],210,5,14475,4.379727685325265,20.0,20.0
13305,1,3305,[318 161 286 194 333],13,2,14477,4.379007864488808,20.0,0.0
13306,1,3306,[176 182 117 204  98],749,4,14481,4.378893256728152,0.0,20.0
13307,1,3307,[435 288 174  28  25],59,5,14486,4.379081015719468,0.0,20.0
13308,1,3308,[265 174  98 175 215],804,5,14491,4.3792686612269565,0.0,40.0
13309,1,3309,[ 22 127 300 603  56],7,5,14496,4.379456193353474,20.0,20.0
13310,1,3310,[127 187 483 302 211],13,5,14501,4.379643612201752,20.0,20.0
13311,1,3311,[127 187 483 302 211],833,3,14504,4.379227053140097,20.0,20.0
13312,1,3312,[127 187 483 302 211],474,5,14509,4.3794144280108664,20.0,20.0
13313,1,3313,[127 187 483 302 211],343,5,14514,4.379601689800845,20.0,20.0
13314,1,3314,[127 187 483 302 211],666,5,14519,4.3797888386123685,20.0,20.0
13315,1,3315,[127 187 483 302 211],210,5,14524,4.379975874547648,20.0,20.0
13316,1,3316,[127 187 483 302 211],207,5,14529,4.380162797708773,20.0,20.0
13317,1,3317,[  4 265 403 302  56],102,0,14529,4.378842676311031,0.0,0.0
13318,1,3318,[ 50 144 471 135  97],374,4,14533,4.37872853269057,0.0,20.0
13319,1,3319,[127 187 483 302 211],666,5,14538,4.378915662650602,20.0,20.0
13320,1,3320,[127 187 483 302 211],666,5,14543,4.379102679915688,20.0,20.0
13321,1,3321,[127 187 483 302 211],343,5,14548,4.379289584587598,20.0,20.0
13322,1,3322,[127 187 483 302 211],6,5,14553,4.379476376767981,20.0,20.0
13323,1,3323,[127 187 483 302 211],207,5,14558,4.379663056558363,20.0,20.0
13324,1,3324,[127 187 483 302 211],210,5,14563,4.37984962406015,20.0,20.0
13325,1,3325,[127 187 483 302 211],474,5,14568,4.380036079374624,20.0,20.0
13326,1,3326,[127 187 483 302 211],833,3,14571,4.379621280432822,20.0,20.0
13327,1,3327,[127 187 483 302 211],339,5,14576,4.3798076923076925,20.0,20.0
13328,1,3328,[127 187 483 302 211],328,5,14581,4.3799939921898465,20.0,20.0
13329,1,3329,[127 187 483 302 211],537,5,14586,4.38018018018018,20.0,20.0
13330,1,3330,[127 187 483 302 211],339,5,14591,4.380366256379466,20.0,20.0
13331,1,3331,[127 187 483 302 211],13,5,14596,4.380552220888355,20.0,20.0
13332,1,3332,[127 187 483 302 211],537,5,14601,4.380738073807381,20.0,20.0
13333,1,3333,[127 187 483 302 211],343,5,14606,4.380923815236953,20.0,20.0
13334,1,3334,[ 22 197 258 271 196],749,5,14611,4.381109445277361,0.0,0.0
13335,1,3335,[ 98 357 204  97  50],290,3,14614,4.380695443645084,20.0,40.0
13336,1,3336,[127 187 483 302 211],666,5,14619,4.380881030866047,20.0,20.0
13337,1,3337,[127 187 483 302 211],474,5,14624,4.381066506890353,20.0,20.0
13338,1,3338,[127 187 483 302 211],537,5,14629,4.381251871817909,20.0,20.0
13339,1,3339,[127 187 483 302 211],474,5,14634,4.381437125748503,20.0,20.0
13340,1,3340,[603  64 161 357 483],533,4,14638,4.381322957198444,60.0,0.0
13341,1,3341,[176 211 435 318  11],537,2,14640,4.380610412926392,20.0,0.0
13342,1,3342,[127 187 483 302 211],833,3,14643,4.380197427460365,20.0,20.0
13343,1,3343,[127 187 483 302 211],537,5,14648,4.380382775119617,20.0,20.0
13344,1,3344,[127 187 483 302 211],833,3,14651,4.379970104633782,20.0,20.0
13345,1,3345,[127 187 483 302 211],666,5,14656,4.380155409444113,20.0,20.0
13346,1,3346,[127 187 483 302 211],666,5,14661,4.380340603525545,20.0,20.0
13347,1,3347,[127 187 483 302 211],6,5,14666,4.3805256869772995,20.0,20.0
13348,1,3348,[127 187 483 302 211],328,5,14671,4.380710659898477,20.0,20.0
13349,1,3349,[127 187 483 302 211],343,5,14676,4.38089552238806,20.0,20.0
13350,1,3350,[238 496  98  95  22],125,4,14680,4.38078185616234,0.0,20.0
13351,1,3351,[127 187 483 302 211],90,5,14685,4.380966587112172,20.0,20.0
13352,1,3352,[546 276  98 496 286],339,5,14690,4.381151207873546,0.0,20.0
13353,1,3353,[127 187 483 302 211],537,5,14695,4.381335718545021,20.0,20.0
13354,1,3354,[100 182  56 195 173],749,2,14697,4.3806259314456035,0.0,20.0
13355,1,3355,[127 187 483 302 211],833,3,14700,4.380214541120381,20.0,20.0
13356,1,3356,[195 427 216 403  12],42,4,14704,4.380101280905571,20.0,0.0
13357,1,3357,[127 187 483 302 211],474,5,14709,4.3802858844550325,20.0,20.0
13358,1,3358,[127 187 483 302 211],833,3,14712,4.379874962786544,20.0,20.0
13359,1,3359,[289  97  96 475   4],374,2,14714,4.379166666666666,0.0,0.0
13360,1,3360,[179  15 286 318 237],271,4,14718,4.3790538530199346,20.0,0.0
13361,1,3361,[748   1 269  28 186],488,3,14721,4.378643664485425,0.0,0.0
13362,1,3362,[ 11 234 508 180 179],543,4,14725,4.378531073446328,0.0,0.0
13363,1,3363,[ 79 185 515 238  56],64,5,14730,4.37871581450654,0.0,0.0
13364,1,3364,[127 187 483 302 211],6,5,14735,4.378900445765231,20.0,20.0
13365,1,3365,[127 187 483 302 211],833,3,14738,4.378490790255496,20.0,20.0
13366,1,3366,[127 187 483 302 211],328,5,14743,4.3786753786753785,20.0,20.0
13367,1,3367,[127 187 483 302 211],833,3,14746,4.378266033254157,20.0,20.0
13368,1,3368,[127 187 483 302 211],339,5,14751,4.378450578806768,20.0,20.0
13369,1,3369,[127 187 483 302 211],537,5,14756,4.378635014836795,20.0,20.0
13370,1,3370,[127 187 483 302 211],537,5,14761,4.378819341441709,20.0,20.0
13371,1,3371,[127 187 483 302 211],666,5,14766,4.379003558718861,20.0,20.0
13372,1,3372,[127 187 483 302 211],474,5,14771,4.379187666765491,20.0,20.0
13373,1,3373,[127 187 483 302 211],207,5,14776,4.37937166567872,20.0,20.0
13374,1,3374,[127 187 483 302 211],666,5,14781,4.379555555555555,20.0,20.0
13375,1,3375,[471 111 195 211 210],537,1,14782,4.378554502369668,0.0,0.0
13376,1,3376,[127 187 483 302 211],210,5,14787,4.3787385253183295,20.0,20.0
13377,1,3377,[132  70   8 202 121],795,1,14788,4.3777383066903495,0.0,0.0
13378,1,3378,[127 187 483 302 211],6,5,14793,4.377922462266943,20.0,20.0
13379,1,3379,[127 187 483 302 211],90,5,14798,4.37810650887574,20.0,20.0
13380,1,3380,[127 187 483 302 211],210,5,14803,4.378290446613428,20.0,20.0
13381,1,3381,[127 187 483 302 211],210,5,14808,4.378474275576582,20.0,20.0
13382,1,3382,[127 187 483 302 211],524,5,14813,4.378657995861661,20.0,20.0
13383,1,3383,[127 187 483 302 211],833,3,14816,4.378250591016548,20.0,20.0
13384,1,3384,[118  82 196 318 300],13,2,14818,4.3775480059084195,20.0,0.0
13385,1,3385,[127 187 483 302 211],666,5,14823,4.377731836975783,20.0,20.0
13386,1,3386,[127 187 483 302 211],6,5,14828,4.377915559492176,20.0,20.0
13387,1,3387,[228 655  28   8  50],899,4,14832,4.37780401416765,0.0,20.0
13388,1,3388,[127 187 483 302 211],474,5,14837,4.377987606963706,20.0,20.0
13389,1,3389,[127 187 483 302 211],13,5,14842,4.378171091445428,20.0,20.0
13390,1,3390,[265 132 151 405 204],7,4,14846,4.37805956944854,0.0,0.0
13391,1,3391,[127 187 483 302 211],339,5,14851,4.378242924528302,20.0,20.0
13392,1,3392,[127 187 483 302 211],210,5,14856,4.37842617152962,20.0,20.0
13393,1,3393,[195 204  71 742 288],804,4,14860,4.378314672952269,0.0,0.0
13394,1,3394,[127 187 483 302 211],210,5,14865,4.378497790868925,20.0,20.0
13395,1,3395,[288 135 176 191 202],378,2,14867,4.377797408716137,0.0,0.0
13396,1,3396,[127 187 483 302 211],339,5,14872,4.37798057109214,20.0,20.0
13397,1,3397,[127 187 483 302 211],210,5,14877,4.378163625662154,20.0,20.0
13398,1,3398,[275 174 288 215 183],648,4,14881,4.3780523683436305,0.0,20.0
13399,1,3399,[ 22 655 405 161 180],92,2,14883,4.37735294117647,0.0,0.0
13400,1,3400,[127 187 483 302 211],328,5,14888,4.377536018817994,20.0,20.0
13401,1,3401,[127 187 483 302 211],328,5,14893,4.3777189888301,20.0,20.0
13402,1,3402,[127 187 483 302 211],210,5,14898,4.377901851307669,20.0,20.0
13403,1,3403,[127 187 483 302 211],339,5,14903,4.3780846063454755,20.0,20.0
13404,1,3404,[127 187 483 302 211],90,5,14908,4.378267254038179,20.0,20.0
13405,1,3405,[127 187 483 302 211],90,5,14913,4.3784497944803284,20.0,20.0
13406,1,3406,[127 187 483 302 211],524,5,14918,4.378632227766364,20.0,20.0
13407,1,3407,[127 187 483 302 211],474,5,14923,4.37881455399061,20.0,20.0
13408,1,3408,[127 187 483 302 211],343,5,14928,4.3789967732472865,20.0,20.0
13409,1,3409,[127 187 483 302 211],13,5,14933,4.379178885630498,20.0,20.0
13410,1,3410,[127 187 483 302 211],6,5,14938,4.379360891234242,20.0,20.0
13411,1,3411,[127 187 483 302 211],6,5,14943,4.379542790152403,20.0,20.0
13412,1,3412,[127 187 483 302 211],207,5,14948,4.379724582478758,20.0,20.0
13413,1,3413,[ 50 318  25 588 603],458,3,14951,4.379320445225542,40.0,20.0
13414,1,3414,[127 187 483 302 211],343,5,14956,4.379502196193265,20.0,20.0
13415,1,3415,[127 187 483 302 211],666,5,14961,4.379683840749414,20.0,20.0
13416,1,3416,[127 187 483 302 211],537,5,14966,4.379865378987416,20.0,20.0
13417,1,3417,[127 187 483 302 211],6,5,14971,4.380046811000585,20.0,20.0
13418,1,3418,[100  96 286 181 135],488,2,14973,4.379350687335478,0.0,20.0
13419,1,3419,[127 187 483 302 211],339,5,14978,4.37953216374269,20.0,20.0
13420,1,3420,[127 187 483 302 211],339,5,14983,4.37971353405437,20.0,20.0
13421,1,3421,[357 185 181 265  22],115,3,14986,4.379310344827586,20.0,0.0
13422,1,3422,[222  95 496 180 143],194,1,14987,4.378323108384458,0.0,0.0
13423,1,3423,[127 187 483 302 211],90,5,14992,4.378504672897196,20.0,20.0
13424,1,3424,[127 187 483 302 211],524,5,14997,4.3786861313868615,20.0,20.0
13425,1,3425,[405 132 182  69 191],194,2,14999,4.377991827203736,0.0,0.0
13426,1,3426,[127 187 483 302 211],13,5,15004,4.378173329442661,20.0,20.0
13427,1,3427,[127 187 483 302 211],207,5,15009,4.378354725787632,20.0,20.0
13428,1,3428,[185 183 282 300 202],311,4,15013,4.378244386118402,0.0,0.0
13429,1,3429,[127 187 483 302 211],13,5,15018,4.3784256559766765,20.0,20.0
13430,1,3430,[127 187 483 302 211],474,5,15023,4.378606820169047,20.0,20.0
13431,1,3431,[127 187 483 302 211],666,5,15028,4.378787878787879,20.0,20.0
13432,1,3432,[127 187 483 302 211],524,5,15033,4.378968831925429,20.0,20.0
13433,1,3433,[127 187 483 302 211],210,5,15038,4.37914967967385,20.0,20.0
13434,1,3434,[174 302 172  79 118],13,4,15042,4.379039301310043,0.0,20.0
13435,1,3435,[127 187 483 302 211],343,5,15047,4.379220023282887,20.0,20.0
13436,1,3436,[127 187 483 302 211],210,5,15052,4.379400640093104,20.0,20.0
13437,1,3437,[127 187 483 302 211],537,5,15057,4.37958115183246,20.0,20.0
13438,1,3438,[127 187 483 302 211],833,3,15060,4.379179994184356,20.0,20.0
13439,1,3439,[313  82 483  98 144],207,3,15063,4.378779069767442,20.0,20.0
13440,1,3440,[127 187 483 302 211],6,5,15068,4.378959604766056,20.0,20.0
13441,1,3441,[496 427 195  64 423],194,3,15071,4.3785589773387565,0.0,0.0
13442,1,3442,[127 187 483 302 211],666,5,15076,4.378739471391229,20.0,20.0
13443,1,3443,[127 187 483 302 211],207,5,15081,4.378919860627177,20.0,20.0
13444,1,3444,[127 187 483 302 211],210,5,15086,4.379100145137881,20.0,20.0
13445,1,3445,[127 187 483 302 211],207,5,15091,4.379280325014509,20.0,20.0
13446,1,3446,[127 187 483 302 211],833,3,15094,4.378880185668698,20.0,20.0
13447,1,3447,[127 187 483 302 211],666,5,15099,4.3790603248259865,20.0,20.0
13448,1,3448,[405 403  97 196 483],934,4,15103,4.378950420411713,20.0,0.0
13449,1,3449,[127 187 483 302 211],210,5,15108,4.379130434782609,20.0,20.0
13450,1,3450,[182 655  64 294  50],13,4,15112,4.3790205737467405,0.0,20.0
13451,1,3451,[496 357 175 655 179],815,2,15114,4.378331402085747,20.0,0.0
13452,1,3452,[127 187 483 302 211],666,5,15119,4.37851143932812,20.0,20.0
13453,1,3453,[153 269 194 403 288],339,3,15122,4.378112333526346,0.0,0.0
13454,1,3454,[471 234 172 161 100],194,2,15124,4.377424023154848,0.0,20.0
13455,1,3455,[127 187 483 302 211],13,5,15129,4.377604166666667,20.0,20.0
13456,1,3456,[127 187 483 302 211],524,5,15134,4.377784205958924,20.0,20.0
13457,1,3457,[471 117 191 322 568],311,5,15139,4.377964141122036,0.0,0.0
13458,1,3458,[127 187 483 302 211],524,5,15144,4.378143972246314,20.0,20.0
13459,1,3459,[127 187 483 302 211],6,5,15149,4.378323699421966,20.0,20.0
13460,1,3460,[127 187 483 302 211],328,5,15154,4.378503322739093,20.0,20.0
13461,1,3461,[127 187 483 302 211],537,5,15159,4.378682842287695,20.0,20.0
13462,1,3462,[748 175 357 118 210],804,5,15164,4.378862258157667,20.0,0.0
13463,1,3463,[318 288  79 186  15],308,4,15168,4.378752886836028,20.0,0.0
13464,1,3464,[127 187 483 302 211],339,5,15173,4.378932178932179,20.0,20.0
13465,1,3465,[127 187 483 302 211],474,5,15178,4.379111367570687,20.0,20.0
13466,1,3466,[195  95 435   7 269],650,4,15182,4.379002019036631,0.0,0.0
13467,1,3467,[127 187 483 302 211],666,5,15187,4.379181084198385,20.0,20.0
13468,1,3468,[127 187 483 302 211],339,5,15192,4.379360046122802,20.0,20.0
13469,1,3469,[127 187 483 302 211],328,5,15197,4.379538904899135,20.0,20.0
13470,1,3470,[127 187 483 302 211],6,5,15202,4.379717660616537,20.0,20.0
13471,1,3471,[127 187 483 302 211],833,3,15205,4.379320276497696,20.0,20.0
13472,1,3472,[127 187 483 302 211],666,5,15210,4.3794989922257415,20.0,20.0
13473,1,3473,[127 187 483 302 211],537,5,15215,4.379677605066206,20.0,20.0
13474,1,3474,[127 187 483 302 211],13,5,15220,4.379856115107914,20.0,20.0
13475,1,3475,[ 25   8 258 181 286],378,5,15225,4.380034522439586,0.0,0.0
13476,1,3476,[678 405 294 173 176],7,1,15226,4.3790624101236695,0.0,0.0
13477,1,3477,[  8 143 194 181 118],13,4,15230,4.378953421506613,0.0,0.0
13478,1,3478,[127 187 483 302 211],524,5,15235,4.379131934463927,20.0,20.0
13479,1,3479,[127 187 483 302 211],13,5,15240,4.379310344827586,20.0,20.0
13480,1,3480,[  1 222 357 211  22],380,3,15243,4.378914105142201,20.0,0.0
13481,1,3481,[127 187 483 302 211],13,5,15248,4.379092475588742,20.0,20.0
13482,1,3482,[ 88 121 322 496 748],533,4,15252,4.378983634797589,0.0,0.0
13483,1,3483,[181  88  70 186 301],378,3,15255,4.378587830080368,0.0,0.0
13484,1,3484,[127 187 483 302 211],833,3,15258,4.37819225251076,20.0,20.0
13485,1,3485,[127 187 483 302 211],666,5,15263,4.378370625358577,20.0,20.0
13486,1,3486,[195  12 228 318 202],374,2,15265,4.377688557499283,40.0,0.0
13487,1,3487,[127 187 483 302 211],6,5,15270,4.377866972477064,20.0,20.0
13488,1,3488,[127 187 483 302 211],833,3,15273,4.377472055030094,20.0,20.0
13489,1,3489,[127 187 483 302 211],13,5,15278,4.377650429799427,20.0,20.0
13490,1,3490,[127 187 483 302 211],537,5,15283,4.377828702377542,20.0,20.0
13491,1,3491,[127 187 483 302 211],6,5,15288,4.378006872852234,20.0,20.0
13492,1,3492,[127 187 483 302 211],666,5,15293,4.3781849413111935,20.0,20.0
13493,1,3493,[127 187 483 302 211],90,5,15298,4.378362907842015,20.0,20.0
13494,1,3494,[127 187 483 302 211],343,5,15303,4.3785407725321885,20.0,20.0
13495,1,3495,[127 187 483 302 211],328,5,15308,4.378718535469107,20.0,20.0
13496,1,3496,[127 187 483 302 211],328,5,15313,4.378896196740063,20.0,20.0
13497,1,3497,[127 187 483 302 211],339,5,15318,4.379073756432247,20.0,20.0
13498,1,3498,[127 187 483 302 211],207,5,15323,4.3792512146327525,20.0,20.0
13499,1,3499,[435 294 186 300 176],234,0,15323,4.378,0.0,0.0
13500,1,3500,[508  11 222 435 174],387,3,15326,4.377606398171951,0.0,20.0
13501,1,3501,[127 187 483 302 211],666,5,15331,4.377784123358081,20.0,20.0
13502,1,3502,[127 187 483 302 211],537,5,15336,4.377961747073937,20.0,20.0
13503,1,3503,[127 187 483 302 211],328,5,15341,4.378139269406392,20.0,20.0
13504,1,3504,[216 202 127 117 125],749,5,15346,4.378316690442225,0.0,20.0
13505,1,3505,[127 187 483 302 211],339,5,15351,4.378494010268112,20.0,20.0
13506,1,3506,[127 187 483 302 211],13,5,15356,4.37867122897063,20.0,20.0
13507,1,3507,[127 187 483 302 211],474,5,15361,4.37884834663626,20.0,20.0
13508,1,3508,[  8 187 135  95 196],271,5,15366,4.379025363351382,0.0,0.0
13509,1,3509,[127 187 483 302 211],339,5,15371,4.379202279202279,20.0,20.0
13510,1,3510,[ 79 118 172 211 125],788,2,15373,4.378524636855596,0.0,0.0
13511,1,3511,[127 187 483 302 211],474,5,15378,4.378701594533029,20.0,20.0
13512,1,3512,[127 187 483 302 211],328,5,15383,4.378878451465983,20.0,20.0
13513,1,3513,[286 191 258 228   1],454,2,15385,4.378201479795106,0.0,0.0
13514,1,3514,[127 187 483 302 211],6,5,15390,4.378378378378378,20.0,20.0
13515,1,3515,[234 322 187 546 515],308,1,15391,4.377417519908987,0.0,0.0
13516,1,3516,[127 187 483 302 211],833,3,15394,4.377025874324708,20.0,20.0
13517,1,3517,[127 187 483 302 211],339,5,15399,4.377202956225128,20.0,20.0
13518,1,3518,[127 187 483 302 211],13,5,15404,4.377379937482239,20.0,20.0
13519,1,3519,[127 187 483 302 211],343,5,15409,4.3775568181818185,20.0,20.0
13520,1,3520,[ 12  69 182 204 185],527,5,15414,4.3777335984095425,20.0,0.0
13521,1,3521,[127 187 483 302 211],833,3,15417,4.377342419080068,20.0,20.0
13522,1,3522,[127 187 483 302 211],328,5,15422,4.377519159806982,20.0,20.0
13523,1,3523,[127 187 483 302 211],666,5,15427,4.3776958002270145,20.0,20.0
13524,1,3524,[ 79 273  89 237  82],92,4,15431,4.377588652482269,0.0,0.0
13525,1,3525,[328  79 196 222 180],92,4,15435,4.37748156551333,0.0,0.0
13526,1,3526,[127 187 483 302 211],833,3,15438,4.377091012191665,20.0,20.0
13527,1,3527,[127 187 483 302 211],339,5,15443,4.3772675736961455,20.0,20.0
13528,1,3528,[127 187 483 302 211],339,5,15448,4.377444035137433,20.0,20.0
13529,1,3529,[215  82 300  98 153],694,4,15452,4.377337110481586,0.0,20.0
13530,1,3530,[127 187 483 302 211],6,5,15457,4.377513452279808,20.0,20.0
13531,1,3531,[127 187 483 302 211],328,5,15462,4.377689694224236,20.0,20.0
13532,1,3532,[127 187 483 302 211],537,5,15467,4.3778658363996605,20.0,20.0
13533,1,3533,[127 187 483 302 211],207,5,15472,4.378041878890775,20.0,20.0
13534,1,3534,[127 187 483 302 211],524,5,15477,4.3782178217821786,20.0,20.0
13535,1,3535,[742 265 228  25 200],804,4,15481,4.3781108597285066,0.0,0.0
13536,1,3536,[ 70 210  96 597 117],95,4,15485,4.37800395815663,0.0,0.0
13537,1,3537,[127 204 300 258 423],479,3,15488,4.377614471452798,0.0,20.0
13538,1,3538,[127 187 483 302 211],833,3,15491,4.37722520486013,20.0,20.0
13539,1,3539,[127 187 483 302 211],474,5,15496,4.377401129943503,20.0,20.0
13540,1,3540,[127 187 483 302 211],90,5,15501,4.377576955662242,20.0,20.0
13541,1,3541,[127 187 483 302 211],343,5,15506,4.377752682100509,20.0,20.0
13542,1,3542,[168 318 172 234  96],774,0,15506,4.376517075924358,20.0,0.0
13543,1,3543,[475  96  22 515 435],833,1,15507,4.375564334085778,0.0,0.0
13544,1,3544,[127 187 483 302 211],833,3,15510,4.375176304654443,20.0,20.0
13545,1,3545,[127 187 483 302 211],207,5,15515,4.375352509870276,20.0,20.0
13546,1,3546,[127 187 483 302 211],833,3,15518,4.374964758951227,20.0,20.0
13547,1,3547,[127 187 483 302 211],537,5,15523,4.375140924464487,20.0,20.0
13548,1,3548,[403 182 196 186 173],59,5,15528,4.375316990701606,0.0,0.0
13549,1,3549,[234  97 237 228  79],524,3,15531,4.374929577464789,0.0,0.0
13550,1,3550,[127 187 483 302 211],474,5,15536,4.375105604055196,20.0,20.0
13551,1,3551,[ 97 100 385 200 357],59,5,15541,4.375281531531532,20.0,20.0
13552,1,3552,[127 187 483 302 211],474,5,15546,4.375457359977484,20.0,20.0
13553,1,3553,[245 678 322 143 496],804,4,15550,4.375351716375914,0.0,0.0
13554,1,3554,[127 187 483 302 211],537,5,15555,4.375527426160337,20.0,20.0
13555,1,3555,[546 216 403 173  64],339,3,15558,4.375140607424072,0.0,0.0
13556,1,3556,[127 187 483 302 211],537,5,15563,4.375316277762159,20.0,20.0
13557,1,3557,[127 187 483 302 211],343,5,15568,4.375491849353569,20.0,20.0
13558,1,3558,[127 187 483 302 211],13,5,15573,4.37566732228154,20.0,20.0
13559,1,3559,[127 187 483 302 211],524,5,15578,4.375842696629213,20.0,20.0
13560,1,3560,[405  96 161  71  95],60,4,15582,4.375737152485257,0.0,0.0
13561,1,3561,[127 187 483 302 211],13,5,15587,4.375912408759124,20.0,20.0
13562,1,3562,[127 187 483 302 211],833,3,15590,4.375526241930957,20.0,20.0
13563,1,3563,[127 187 483 302 211],328,5,15595,4.375701459034793,20.0,20.0
13564,1,3564,[127 187 483 302 211],328,5,15600,4.3758765778401125,20.0,20.0
13565,1,3565,[748 161 275 288 258],13,3,15603,4.37549074593382,0.0,0.0
13566,1,3566,[127 187 483 302 211],207,5,15608,4.3756658256237735,20.0,20.0
13567,1,3567,[132  69 423 180 121],210,5,15613,4.375840807174888,0.0,0.0
13568,1,3568,[172 161 143 496 195],311,4,15617,4.375735500140095,0.0,0.0
13569,1,3569,[ 28 273  70 275 194],308,3,15620,4.375350140056023,0.0,0.0
13570,1,3570,[127 187 483 302 211],328,5,15625,4.375525063007561,20.0,20.0
13571,1,3571,[258 228 161 202  15],59,3,15628,4.375139977603584,0.0,0.0
13572,1,3572,[127 187 483 302 211],833,3,15631,4.374755107752589,20.0,20.0
13573,1,3573,[127 187 483 302 211],537,5,15636,4.374930050363738,20.0,20.0
13574,1,3574,[127 187 483 302 211],833,3,15639,4.374545454545455,20.0,20.0
13575,1,3575,[127 187 483 302 211],13,5,15644,4.374720357941834,20.0,20.0
13576,1,3576,[ 71 603 357 185 302],454,2,15646,4.37405647190383,40.0,0.0
13577,1,3577,[127 187 483 302 211],328,5,15651,4.374231414197876,20.0,20.0
13578,1,3578,[127 187 483 302 211],90,5,15656,4.374406258731489,20.0,20.0
13579,1,3579,[127 187 483 302 211],210,5,15661,4.374581005586593,20.0,20.0
13580,1,3580,[127 187 483 302 211],90,5,15666,4.374755654845015,20.0,20.0
13581,1,3581,[ 69  88 121 117 282],474,5,15671,4.374930206588498,0.0,0.0
13582,1,3582,[127 187 483 302 211],474,5,15676,4.375104660898688,20.0,20.0
13583,1,3583,[127 187 483 302 211],13,5,15681,4.375279017857143,20.0,20.0
13584,1,3584,[127 187 483 302 211],210,5,15686,4.375453277545327,20.0,20.0
13585,1,3585,[127 187 483 302 211],343,5,15691,4.375627440044618,20.0,20.0
13586,1,3586,[127 187 483 302 211],6,5,15696,4.375801505436297,20.0,20.0
13587,1,3587,[127 187 483 302 211],343,5,15701,4.375975473801561,20.0,20.0
13588,1,3588,[127 187 483 302 211],833,3,15704,4.3755920869322935,20.0,20.0
13589,1,3589,[127 187 483 302 211],537,5,15709,4.375766016713092,20.0,20.0
13590,1,3590,[127 187 483 302 211],343,5,15714,4.37593984962406,20.0,20.0
13591,1,3591,[127 187 483 302 211],343,5,15719,4.376113585746102,20.0,20.0
13592,1,3592,[127 187 483 302 211],833,3,15722,4.375730587252992,20.0,20.0
13593,1,3593,[196 185 294 194   9],881,1,15723,4.374791318864775,0.0,0.0
13594,1,3594,[427 215 294   4  70],882,4,15727,4.374687065368567,0.0,0.0
13595,1,3595,[127 187 483 302 211],210,5,15732,4.374860956618465,20.0,20.0
13596,1,3596,[172 117 235 222 546],92,3,15735,4.374478732276898,0.0,0.0
13597,1,3597,[127 187 483 302 211],343,5,15740,4.374652584769316,20.0,20.0
13598,1,3598,[127 187 483 302 211],537,5,15745,4.374826340650181,20.0,20.0
13599,1,3599,[423 195 257   9   8],298,5,15750,4.375,0.0,0.0
13600,1,3600,[127 187 483 302 211],833,3,15753,4.374618161621772,20.0,20.0
13601,1,3601,[127 187 483 302 211],90,5,15758,4.374791782343142,20.0,20.0
13602,1,3602,[127 187 483 302 211],339,5,15763,4.37496530668887,20.0,20.0
13603,1,3603,[174   1 210 175 483],892,5,15768,4.375138734739179,20.0,20.0
13604,1,3604,[127 187 483 302 211],13,5,15773,4.375312066574202,20.0,20.0
13605,1,3605,[496 176 174 265 222],815,5,15778,4.3754853022739875,0.0,20.0
13606,1,3606,[127 187 483 302 211],13,5,15783,4.375658441918492,20.0,20.0
13607,1,3607,[127 187 483 302 211],6,5,15788,4.375831485587583,20.0,20.0
13608,1,3608,[127 187 483 302 211],343,5,15793,4.376004433361042,20.0,20.0
13609,1,3609,[127 187 483 302 211],474,5,15798,4.376177285318559,20.0,20.0
13610,1,3610,[127 187 483 302 211],6,5,15803,4.37635004153974,20.0,20.0
13611,1,3611,[127 187 483 302 211],207,5,15808,4.376522702104097,20.0,20.0
13612,1,3612,[127 187 483 302 211],833,3,15811,4.376141710489898,20.0,20.0
13613,1,3613,[127 187 483 302 211],339,5,15816,4.376314333148866,20.0,20.0
13614,1,3614,[127 187 483 302 211],210,5,15821,4.376486860304288,20.0,20.0
13615,1,3615,[127 187 483 302 211],666,5,15826,4.376659292035399,20.0,20.0
13616,1,3616,[100  96 125 323  64],119,5,15831,4.3768316284213435,0.0,20.0
13617,1,3617,[127 187 483 302 211],666,5,15836,4.377003869541183,20.0,20.0
13618,1,3618,[127 187 483 302 211],537,5,15841,4.3771760154738875,20.0,20.0
13619,1,3619,[127 187 483 302 211],833,3,15844,4.376795580110497,20.0,20.0
13620,1,3620,[328 161 186 568 403],95,3,15847,4.376415354874344,0.0,0.0
13621,1,3621,[200 228 275  22 237],328,4,15851,4.376311430149089,0.0,0.0
13622,1,3622,[127 187 483 302 211],207,5,15856,4.376483577146011,20.0,20.0
13623,1,3623,[127 187 483 302 211],207,5,15861,4.376655629139073,20.0,20.0
13624,1,3624,[127 187 483 302 211],6,5,15866,4.376827586206897,20.0,20.0
13625,1,3625,[127 187 483 302 211],474,5,15871,4.37699944842802,20.0,20.0
13626,1,3626,[127 187 483 302 211],666,5,15876,4.377171215880893,20.0,20.0
13627,1,3627,[127 187 483 302 211],343,5,15881,4.377342888643881,20.0,20.0
13628,1,3628,[127 187 483 302 211],339,5,15886,4.377514466795261,20.0,20.0
13629,1,3629,[273 100 181 168 173],749,4,15890,4.377410468319559,0.0,20.0
13630,1,3630,[127 187 483 302 211],6,5,15895,4.377581933351694,20.0,20.0
13631,1,3631,[127 187 483 302 211],666,5,15900,4.377753303964758,20.0,20.0
13632,1,3632,[127 187 483 302 211],210,5,15905,4.377924580236719,20.0,20.0
13633,1,3633,[151 322 191 603 301],537,2,15907,4.3772702256466705,20.0,0.0
13634,1,3634,[127 187 483 302 211],343,5,15912,4.377441540577717,20.0,20.0
13635,1,3635,[127 187 483 302 211],210,5,15917,4.3776127612761275,20.0,20.0
13636,1,3636,[127 187 483 302 211],666,5,15922,4.377783887819631,20.0,20.0
13637,1,3637,[127 187 483 302 211],343,5,15927,4.377954920285871,20.0,20.0
13638,1,3638,[ 64 435 300 117   4],271,3,15930,4.37757625721352,0.0,0.0
13639,1,3639,[127 187 483 302 211],474,5,15935,4.377747252747253,20.0,20.0
13640,1,3640,[127 187 483 302 211],6,5,15940,4.3779181543532,20.0,20.0
13641,1,3641,[127 187 483 302 211],537,5,15945,4.378088962108731,20.0,20.0
13642,1,3642,[127 187 483 302 211],328,5,15950,4.378259676091134,20.0,20.0
13643,1,3643,[127 187 483 302 211],328,5,15955,4.378430296377607,20.0,20.0
13644,1,3644,[127 187 483 302 211],6,5,15960,4.378600823045267,20.0,20.0
13645,1,3645,[127 187 483 302 211],90,5,15965,4.378771256171146,20.0,20.0
13646,1,3646,[127 187 483 302 211],537,5,15970,4.378941595832191,20.0,20.0
13647,1,3647,[127 187 483 302 211],339,5,15975,4.379111842105263,20.0,20.0
13648,1,3648,[127 187 483 302 211],474,5,15980,4.379281995067141,20.0,20.0
13649,1,3649,[127 187 483 302 211],833,3,15983,4.378904109589041,20.0,20.0
13650,1,3650,[127 187 483 302 211],328,5,15988,4.3790742262393865,20.0,20.0
13651,1,3651,[127 187 483 302 211],666,5,15993,4.379244249726177,20.0,20.0
13652,1,3652,[127 187 483 302 211],474,5,15998,4.379414180125924,20.0,20.0
13653,1,3653,[127 187 483 302 211],13,5,16003,4.379584017515052,20.0,20.0
13654,1,3654,[127 187 483 302 211],537,5,16008,4.379753761969904,20.0,20.0
13655,1,3655,[385 282 237 168  97],653,1,16009,4.378829321663019,0.0,0.0
13656,1,3656,[127 187 483 302 211],537,5,16014,4.378999179655455,20.0,20.0
13657,1,3657,[127 187 483 302 211],666,5,16019,4.379168944778567,20.0,20.0
13658,1,3658,[127 187 483 302 211],339,5,16024,4.3793386171085,20.0,20.0
13659,1,3659,[127 187 483 302 211],474,5,16029,4.379508196721312,20.0,20.0
13660,1,3660,[318   4 187 176 200],234,4,16033,4.379404534280251,20.0,0.0
13661,1,3661,[127 187 483 302 211],537,5,16038,4.379574003276898,20.0,20.0
13662,1,3662,[265 234 238 127 196],95,3,16041,4.379197379197379,0.0,20.0
13663,1,3663,[127 187 483 302 211],339,5,16046,4.379366812227074,20.0,20.0
13664,1,3664,[127 187 483 302 211],833,3,16049,4.378990450204639,20.0,20.0
13665,1,3665,[127 187 483 302 211],90,5,16054,4.379159847244954,20.0,20.0
13666,1,3666,[  9 471 268 172 182],234,0,16054,4.37796563948732,0.0,0.0
13667,1,3667,[127 187 483 302 211],90,5,16059,4.378135223555071,20.0,20.0
13668,1,3668,[127 187 483 302 211],90,5,16064,4.378304715181248,20.0,20.0
13669,1,3669,[127 187 483 302 211],6,5,16069,4.378474114441417,20.0,20.0
13670,1,3670,[127 187 483 302 211],13,5,16074,4.378643421411059,20.0,20.0
13671,1,3671,[127 187 483 302 211],328,5,16079,4.378812636165577,20.0,20.0
13672,1,3672,[127 187 483 302 211],339,5,16084,4.378981758780289,20.0,20.0
13673,1,3673,[127 187 483 302 211],339,5,16089,4.3791507893304304,20.0,20.0
13674,1,3674,[191 197 405 313 282],144,5,16094,4.379319727891157,0.0,0.0
13675,1,3675,[127 187 483 302 211],328,5,16099,4.3794885745375405,20.0,20.0
13676,1,3676,[127 187 483 302 211],666,5,16104,4.379657329344575,20.0,20.0
13677,1,3677,[127 187 483 302 211],207,5,16109,4.3798259923871665,20.0,20.0
13678,1,3678,[127 187 483 302 211],343,5,16114,4.379994563740147,20.0,20.0
13679,1,3679,[127 187 483 302 211],339,5,16119,4.380163043478261,20.0,20.0
13680,1,3680,[385  69 183 568  12],194,2,16121,4.379516435751155,20.0,0.0
13681,1,3681,[127 187 483 302  12],6,5,16126,4.3796849538294405,40.0,20.0
13682,1,3682,[127 187 483 302  12],664,5,16131,4.379853380396416,40.0,20.0
13683,1,3683,[127 187 483 302  12],13,5,16136,4.380021715526602,40.0,20.0
13684,1,3684,[  1 603 175 161 151],234,1,16137,4.37910447761194,20.0,0.0
13685,1,3685,[127 187 483  12 302],666,5,16142,4.37927292457949,40.0,20.0
13686,1,3686,[357 179 427 183 194],932,5,16147,4.379441280173583,20.0,0.0
13687,1,3687,[127 187 483  12 302],666,5,16152,4.379609544468547,40.0,20.0
13688,1,3688,[202 161 195 176 111],378,2,16154,4.378964489021415,0.0,0.0
13689,1,3689,[127 187 483  12 302],334,5,16159,4.379132791327914,40.0,20.0
13690,1,3690,[127 187 483  12 302],90,5,16164,4.379301002438363,40.0,20.0
13691,1,3691,[282  71 173 100  50],479,3,16167,4.3789274106175515,0.0,40.0
13692,1,3692,[222 234 655 289 135],881,3,16170,4.378554021121039,0.0,0.0
13693,1,3693,[127 187 483  12 302],90,5,16175,4.378722252301029,40.0,20.0
13694,1,3694,[127 187 483  12 302],339,5,16180,4.378890392422192,40.0,20.0
13695,1,3695,[127 187 483  12 302],339,5,16185,4.379058441558442,40.0,20.0
13696,1,3696,[127 187 483  12 302],474,5,16190,4.379226399783608,40.0,20.0
13697,1,3697,[127 187 483  12 302],458,5,16195,4.379394267171444,40.0,20.0
13698,1,3698,[127 187 483  12 302],537,4,16199,4.379291700459584,40.0,20.0
13699,1,3699,[127 187 483 302 211],343,5,16204,4.37945945945946,20.0,20.0
13700,1,3700,[127 187 483 302 211],474,5,16209,4.379627127803296,20.0,20.0
13701,1,3701,[200 269 202  69 196],288,5,16214,4.37979470556456,0.0,0.0
13702,1,3702,[127 187 483 302 211],524,5,16219,4.3799621928166355,20.0,20.0
13703,1,3703,[127 187 483 302 211],6,5,16224,4.380129589632829,20.0,20.0
13704,1,3704,[127 187 483 302 211],343,5,16229,4.38029689608637,20.0,20.0
13705,1,3705,[127 187 483 302 211],343,5,16234,4.380464112250404,20.0,20.0
13706,1,3706,[127 187 483 302 211],343,5,16239,4.380631238198004,20.0,20.0
13707,1,3707,[181 135 187 405   4],379,4,16243,4.380528586839266,0.0,0.0
13708,1,3708,[127 187 483 302 211],13,5,16248,4.380695605284443,20.0,20.0
13709,1,3709,[204 275  22   1  64],95,4,16252,4.380592991913747,0.0,0.0
13710,1,3710,[127 187 483 302 211],6,5,16257,4.380759902991108,20.0,20.0
13711,1,3711,[127 187 483 302 211],833,3,16260,4.380387931034483,20.0,20.0
13712,1,3712,[127 187 483 302 211],90,5,16265,4.3805548074333425,20.0,20.0
13713,1,3713,[127 187 483 302 211],207,5,16270,4.380721593968767,20.0,20.0
13714,1,3714,[127 187 483 302 211],207,5,16275,4.380888290713324,20.0,20.0
13715,1,3715,[127 187 483 302 211],666,5,16280,4.381054897739505,20.0,20.0
13716,1,3716,[127 187 483 302 211],328,5,16285,4.38122141511972,20.0,20.0
13717,1,3717,[288 286 121 194  98],650,2,16287,4.380580957504034,0.0,20.0
13718,1,3718,[127 187 483 302 211],343,5,16292,4.380747512772251,20.0,20.0
13719,1,3719,[127 187 483 302 211],474,5,16297,4.380913978494624,20.0,20.0
13720,1,3720,[127 187 483 302 211],90,5,16302,4.381080354743348,20.0,20.0
13721,1,3721,[127 187 483 302 211],524,5,16307,4.3812466415905424,20.0,20.0
13722,1,3722,[  1 276 172 318 132],189,4,16311,4.381144238517325,20.0,0.0
13723,1,3723,[127 187 483 302 211],666,5,16316,4.381310418904404,20.0,20.0
13724,1,3724,[127 187 483 302 211],524,5,16321,4.381476510067114,20.0,20.0
13725,1,3725,[185 183 125 202  22],313,3,16324,4.381105743424584,0.0,0.0
13726,1,3726,[127 187 483 302 211],833,3,16327,4.380735175744567,20.0,20.0
13727,1,3727,[127 187 483 302 211],207,5,16332,4.380901287553648,20.0,20.0
13728,1,3728,[127 187 483 302 211],90,5,16337,4.38106731027085,20.0,20.0
13729,1,3729,[127 187 483 302 211],537,5,16342,4.381233243967828,20.0,20.0
13730,1,3730,[127 187 483 302 211],524,5,16347,4.381399088716162,20.0,20.0
13731,1,3731,[210 508 603 181 237],334,3,16350,4.381028938906752,20.0,0.0
13732,1,3732,[127 187 483 302 211],833,3,16353,4.38065898740959,20.0,20.0
13733,1,3733,[127 187 483 302 211],474,5,16358,4.380824852704874,20.0,20.0
13734,1,3734,[357 195 435 180  98],840,5,16363,4.3809906291834,20.0,20.0
13735,1,3735,[127 187 483 302 211],339,5,16368,4.381156316916488,20.0,20.0
13736,1,3736,[127 187 483 302 211],666,5,16373,4.381321915975382,20.0,20.0
13737,1,3737,[127 187 483 302 211],666,5,16378,4.381487426431247,20.0,20.0
13738,1,3738,[127 187 483 302 211],343,5,16383,4.381652848355175,20.0,20.0
13739,1,3739,[127 187 483 302 211],210,5,16388,4.381818181818182,20.0,20.0
13740,1,3740,[127 187 483 302 211],6,5,16393,4.381983426891206,20.0,20.0
13741,1,3741,[175 357 222 118 161],479,3,16396,4.38161411010155,20.0,0.0
13742,1,3742,[125 195 144 405  28],815,5,16401,4.3817793213999465,0.0,0.0
13743,1,3743,[127 187 483 302 211],207,5,16406,4.381944444444445,20.0,20.0
13744,1,3744,[127 187 483 302 211],339,5,16411,4.382109479305741,20.0,20.0
13745,1,3745,[127 187 483 302 211],537,5,16416,4.382274426054458,20.0,20.0
13746,1,3746,[210 748  69 276 125],207,2,16418,4.381638644248732,0.0,0.0
13747,1,3747,[172 288 238 191  28],7,5,16423,4.381803628601921,0.0,0.0
13748,1,3748,[127 187 483 302 211],833,3,16426,4.381435049346492,20.0,20.0
13749,1,3749,[127 187 483 302 211],13,5,16431,4.3816,20.0,20.0
13750,1,3750,[127 187 483 302 211],339,5,16436,4.381764862703279,20.0,20.0
13751,1,3751,[127 187 483 302 211],90,5,16441,4.381929637526652,20.0,20.0
13752,1,3752,[127 187 483 302 211],328,5,16446,4.382094324540367,20.0,20.0
13753,1,3753,[127 187 483 302 211],833,3,16449,4.3817261587639855,20.0,20.0
13754,1,3754,[127 187 483 302 211],210,5,16454,4.381890812250333,20.0,20.0
13755,1,3755,[127 187 483 302 211],13,5,16459,4.382055378061768,20.0,20.0
13756,1,3756,[127 187 483 302 211],207,5,16464,4.382219856268299,20.0,20.0
13757,1,3757,[127 187 483 302 211],339,5,16469,4.3823842469398615,20.0,20.0
13758,1,3758,[127 187 483 302 211],328,5,16474,4.382548550146316,20.0,20.0
13759,1,3759,[127 187 483 302 211],210,5,16479,4.3827127659574465,20.0,20.0
13760,1,3760,[127 187 483 302 211],666,5,16484,4.382876894442967,20.0,20.0
13761,1,3761,[127 187 483 302 211],339,5,16489,4.383040935672515,20.0,20.0
13762,1,3762,[127 187 483 302 211],524,5,16494,4.383204889715652,20.0,20.0
13763,1,3763,[127 187 483 302 211],328,5,16499,4.38336875664187,20.0,20.0
13764,1,3764,[127 187 483 302 211],6,5,16504,4.383532536520584,20.0,20.0
13765,1,3765,[127 187 483 302 211],207,5,16509,4.383696229421137,20.0,20.0
13766,1,3766,[127 187 483 302 211],13,5,16514,4.383859835412795,20.0,20.0
13767,1,3767,[127 187 483 302 211],537,5,16519,4.384023354564756,20.0,20.0
13768,1,3768,[127 187 483 302 211],207,5,16524,4.38418678694614,20.0,20.0
13769,1,3769,[323 328  95 194 135],804,3,16527,4.383819628647215,0.0,0.0
13770,1,3770,[185 588  95 143  79],843,0,16527,4.382657120127287,0.0,0.0
13771,1,3771,[127 187 483 302 211],210,5,16532,4.382820784729587,20.0,20.0
13772,1,3772,[333 100 151 181 183],666,2,16534,4.382189239332097,0.0,20.0
13773,1,3773,[127 187 483 302 211],666,5,16539,4.382352941176471,20.0,20.0
13774,1,3774,[127 187 483 302 211],343,5,16544,4.382516556291391,20.0,20.0
13775,1,3775,[127 187 483 302 211],13,5,16549,4.382680084745763,20.0,20.0
13776,1,3776,[ 64 202 238 118 111],13,4,16553,4.382578766216574,0.0,0.0
13777,1,3777,[127 187 483 302 211],6,5,16558,4.382742191635786,20.0,20.0
13778,1,3778,[127 187 483 302 211],210,5,16563,4.382905530563641,20.0,20.0
13779,1,3779,[127 187 483 302 211],90,5,16568,4.383068783068783,20.0,20.0
13780,1,3780,[127 187 483 302 211],339,5,16573,4.383231949219783,20.0,20.0
13781,1,3781,[568  69  28 204  98],882,5,16578,4.38339502908514,0.0,20.0
13782,1,3782,[127 187 483 302 211],524,5,16583,4.383558022733281,20.0,20.0
13783,1,3783,[127 187 483 302 211],90,5,16588,4.383720930232558,20.0,20.0
13784,1,3784,[127 187 483 302 211],343,5,16593,4.383883751651255,20.0,20.0
13785,1,3785,[127 187 483 302 211],328,5,16598,4.384046487057581,20.0,20.0
13786,1,3786,[127 187 483 302 211],6,5,16603,4.384209136519672,20.0,20.0
13787,1,3787,[508  12 125 187 194],144,5,16608,4.384371700105596,20.0,0.0
13788,1,3788,[127 187 483 302 211],207,5,16613,4.384534177883347,20.0,20.0
13789,1,3789,[196  88  11  79 174],378,4,16617,4.3844327176781,0.0,20.0
13790,1,3790,[127 187 483 302 211],210,5,16622,4.384595093642838,20.0,20.0
13791,1,3791,[127 187 483 302 211],328,5,16627,4.384757383966245,20.0,20.0
13792,1,3792,[127 187 483 302 211],6,5,16632,4.3849195887160555,20.0,20.0
13793,1,3793,[127 187 483 302 211],343,5,16637,4.3850817079599365,20.0,20.0
13794,1,3794,[127 187 483 302 211],666,5,16642,4.385243741765481,20.0,20.0
13795,1,3795,[127 187 483 302 211],474,5,16647,4.38540569020021,20.0,20.0
13796,1,3796,[ 97  11 211   7 153],234,0,16647,4.384250724255992,0.0,0.0
13797,1,3797,[127 187 483 302  12],13,5,16652,4.384412848867825,40.0,20.0
13798,1,3798,[127 187 483 302  12],6,5,16657,4.384574888128455,40.0,20.0
13799,1,3799,[ 97  96 333 151 282],653,2,16659,4.383947368421053,0.0,0.0
13800,1,3800,[127 187 483 302  12],833,4,16663,4.383846356222047,40.0,20.0
13801,1,3801,[127 187 483 302  12],669,4,16667,4.38374539715939,40.0,20.0
13802,1,3802,[127 187 483  12 302],458,5,16672,4.383907441493558,40.0,20.0
13803,1,3803,[127 187 483  12 302],6,5,16677,4.384069400630914,40.0,20.0
13804,1,3804,[153 228  97 323   9],328,1,16678,4.383180026281209,0.0,0.0
13805,1,3805,[127 187 483  12 302],458,5,16683,4.383342091434577,40.0,20.0
13806,1,3806,[215 118 257 181 172],271,4,16687,4.383241397425794,0.0,0.0
13807,1,3807,[127 187 483  12 302],6,5,16692,4.383403361344538,40.0,20.0
13808,1,3808,[127 187 483  12 302],343,5,16697,4.3835652402205305,40.0,20.0
13809,1,3809,[127 187 483  12 302],458,5,16702,4.383727034120735,40.0,20.0
13810,1,3810,[127 187 483  12 302],537,4,16706,4.383626344791393,40.0,20.0
13811,1,3811,[127 187 483 302 211],6,5,16711,4.383788037775446,20.0,20.0
13812,1,3812,[127 187 483 302 211],207,5,16716,4.383949645948072,20.0,20.0
13813,1,3813,[127 187 483 302 211],537,5,16721,4.384111169375983,20.0,20.0
13814,1,3814,[132 215 328  56 200],13,3,16724,4.383748361730013,0.0,0.0
13815,1,3815,[127 187 483 302 211],207,5,16729,4.383909853249476,20.0,20.0
13816,1,3816,[127 187 483 302 211],474,5,16734,4.384071260151952,20.0,20.0
13817,1,3817,[127 187 483 302 211],537,5,16739,4.3842325825039286,20.0,20.0
13818,1,3818,[127 187 483 302 211],537,5,16744,4.384393820371825,20.0,20.0
13819,1,3819,[127 187 483 302 211],339,5,16749,4.38455497382199,20.0,20.0
13820,1,3820,[323 175  89 546 318],13,2,16751,4.383930908139231,20.0,0.0
13821,1,3821,[127 187 483 302 211],6,5,16756,4.384092098377812,20.0,20.0
13822,1,3822,[127 187 483 302 211],210,5,16761,4.384253204289824,20.0,20.0
13823,1,3823,[127 187 483 302 211],666,5,16766,4.3844142259414225,20.0,20.0
13824,1,3824,[127 187 483 302 211],210,5,16771,4.384575163398693,20.0,20.0
13825,1,3825,[127 187 483 302 211],666,5,16776,4.384736016727653,20.0,20.0
13826,1,3826,[127 187 483 302 211],210,5,16781,4.384896785994251,20.0,20.0
13827,1,3827,[127 187 483 302 211],666,5,16786,4.385057471264368,20.0,20.0
13828,1,3828,[ 95  98 173 568 286],200,5,16791,4.385218072603813,0.0,20.0
13829,1,3829,[127 187 483 302 211],833,3,16794,4.384856396866841,20.0,20.0
13830,1,3830,[127 187 483 302 211],207,5,16799,4.385016966849387,20.0,20.0
13831,1,3831,[127 187 483 302 211],343,5,16804,4.38517745302714,20.0,20.0
13832,1,3832,[127 187 483 302 211],474,5,16809,4.385337855465693,20.0,20.0
13833,1,3833,[127 187 483 302 211],90,5,16814,4.385498174230569,20.0,20.0
13834,1,3834,[127 187 483 302 211],328,5,16819,4.385658409387223,20.0,20.0
13835,1,3835,[  8 174  11  25  79],378,4,16823,4.38555787278415,0.0,20.0
13836,1,3836,[127 187 483 302 211],339,5,16828,4.385718008861089,20.0,20.0
13837,1,3837,[127 187 483 302 211],90,5,16833,4.385878061490359,20.0,20.0
13838,1,3838,[127 187 483 302 211],833,3,16836,4.385517061734827,20.0,20.0
13839,1,3839,[127 187 483 302 211],666,5,16841,4.385677083333333,20.0,20.0
13840,1,3840,[127 187 483 302 211],833,3,16844,4.385316323873991,20.0,20.0
13841,1,3841,[127 187 483 302 211],90,5,16849,4.385476314419573,20.0,20.0
13842,1,3842,[  4   1 423 117 118],653,2,16851,4.384855581576893,0.0,0.0
13843,1,3843,[127 187 483 302 211],474,5,16856,4.385015608740895,20.0,20.0
13844,1,3844,[323 117  50  79 194],13,2,16858,4.384395318595579,0.0,20.0
13845,1,3845,[127 187 483 302 211],833,3,16861,4.3840353614144565,20.0,20.0
13846,1,3846,[185 515 300  64  96],311,4,16865,4.38393553418248,0.0,0.0
13847,1,3847,[127 187 483 302 211],833,3,16868,4.383575883575884,20.0,20.0
13848,1,3848,[127 187 483 302 211],90,5,16873,4.383736035333853,20.0,20.0
13849,1,3849,[127 187 483 302 211],343,5,16878,4.383896103896104,20.0,20.0
13850,1,3850,[127 187 483 302 211],537,5,16883,4.384056089327448,20.0,20.0
13851,1,3851,[127 187 483 302 211],13,5,16888,4.384215991692627,20.0,20.0
13852,1,3852,[127 187 483 302 211],666,5,16893,4.384375811056319,20.0,20.0
13853,1,3853,[127 187 483 302 211],666,5,16898,4.384535547483134,20.0,20.0
13854,1,3854,[127 187 483 302 211],666,5,16903,4.384695201037614,20.0,20.0
13855,1,3855,[168 496   7   9 265],648,3,16906,4.384336099585062,0.0,0.0
13856,1,3856,[176   4 515 183 100],406,3,16909,4.383977184340161,0.0,20.0
13857,1,3857,[127 187 483 302 211],524,5,16914,4.384136858475895,20.0,20.0
13858,1,3858,[127 187 483 302 211],90,5,16919,4.384296449857476,20.0,20.0
13859,1,3859,[127 187 483 302 211],666,5,16924,4.384455958549223,20.0,20.0
13860,1,3860,[127 187 483 302 211],210,5,16929,4.384615384615385,20.0,20.0
13861,1,3861,[127 187 483 302 211],666,5,16934,4.384774728120145,20.0,20.0
13862,1,3862,[127 187 483 302 211],343,5,16939,4.384933989127621,20.0,20.0
13863,1,3863,[216 181 215 187 333],144,4,16943,4.38483436853002,0.0,0.0
13864,1,3864,[127 187 483 302 211],474,5,16948,4.384993531694696,20.0,20.0
13865,1,3865,[127 187 483 302 211],13,5,16953,4.3851526125194,20.0,20.0
13866,1,3866,[127 187 483 302 211],90,5,16958,4.385311611068011,20.0,20.0
13867,1,3867,[228  56 423 181 196],749,4,16962,4.385211995863496,0.0,0.0
13868,1,3868,[127 187 483 302 211],524,5,16967,4.385370896872577,20.0,20.0
13869,1,3869,[127 187 483 302 211],207,5,16972,4.3855297157622735,20.0,20.0
13870,1,3870,[127 187 483 302 211],833,3,16975,4.3851717902350815,20.0,20.0
13871,1,3871,[127 187 483 302 211],6,5,16980,4.385330578512397,20.0,20.0
13872,1,3872,[ 70 405 173 210 151],42,4,16984,4.385231087012651,0.0,0.0
13873,1,3873,[127 187 483 302 211],833,3,16987,4.384873515745999,20.0,20.0
13874,1,3874,[228 222 245 196  69],454,1,16988,4.384,0.0,0.0
13875,1,3875,[127 187 483 302 211],343,5,16993,4.3841589267285865,20.0,20.0
13876,1,3876,[127 187 483 302 211],474,5,16998,4.384317771472788,20.0,20.0
13877,1,3877,[ 56 176 182 273 300],666,3,17001,4.383960804538422,0.0,0.0
13878,1,3878,[127 187 483 302 211],537,5,17006,4.3841196184583655,20.0,20.0
13879,1,3879,[127 187 483 302 211],666,5,17011,4.384278350515464,20.0,20.0
13880,1,3880,[127 187 483 302 211],524,5,17016,4.384437000772997,20.0,20.0
13881,1,3881,[127 187 483 302 211],537,5,17021,4.384595569294178,20.0,20.0
13882,1,3882,[127 187 483 302 211],524,5,17026,4.3847540561421585,20.0,20.0
13883,1,3883,[268 271 742 144 216],92,2,17028,4.3841400617919675,0.0,0.0
13884,1,3884,[100 125 174 182  56],406,4,17032,4.384041184041184,0.0,40.0
13885,1,3885,[127 187 483 302 211],833,3,17035,4.383685023160062,20.0,20.0
13886,1,3886,[200 127 176 161 235],738,3,17038,4.383329045536404,0.0,20.0
13887,1,3887,[496 172 194 200  70],7,4,17042,4.383230452674897,0.0,0.0
13888,1,3888,[127 187 483 302 211],207,5,17047,4.383389046027256,20.0,20.0
13889,1,3889,[127 187 483 302 211],666,5,17052,4.383547557840617,20.0,20.0
13890,1,3890,[258 357 180  82 210],653,4,17056,4.383448984836803,20.0,0.0
13891,1,3891,[127 187 483 302 211],343,5,17061,4.3836073997944505,20.0,20.0
13892,1,3892,[127 187 483 302 211],833,3,17064,4.383251990752633,20.0,20.0
13893,1,3893,[127 187 483 302 211],90,5,17069,4.383410374935798,20.0,20.0
13894,1,3894,[127 187 483 302 211],833,3,17072,4.383055198973042,20.0,20.0
13895,1,3895,[127 187 483 302 211],6,5,17077,4.383213552361396,20.0,20.0
13896,1,3896,[127 187 483 302 211],833,3,17080,4.382858609186553,20.0,20.0
13897,1,3897,[302 194 286   8  70],328,3,17083,4.382503848127245,0.0,0.0
13898,1,3898,[127 187 483 302 211],90,5,17088,4.382662221082329,20.0,20.0
13899,1,3899,[143 211 125 282 276],207,4,17092,4.3825641025641024,0.0,0.0
13900,1,3900,[427 286  22 276 197],59,4,17096,4.382466034350166,0.0,0.0
13901,1,3901,[117 118 423 546 288],479,0,17096,4.381342901076371,0.0,0.0
13902,1,3902,[127 187 483 302 211],207,5,17101,4.381501409172431,20.0,20.0
13903,1,3903,[127 187 483 302 211],207,5,17106,4.381659836065574,20.0,20.0
13904,1,3904,[127 187 483 302 211],833,3,17109,4.381306017925736,20.0,20.0
13905,1,3905,[127 187 483 302 211],6,5,17114,4.381464413722478,20.0,20.0
13906,1,3906,[127 187 483 302 211],339,5,17119,4.38162272843614,20.0,20.0
13907,1,3907,[ 12 588 195  15 235],144,4,17123,4.381525076765609,20.0,0.0
13908,1,3908,[475 179 117  79 238],207,2,17125,4.380915835251983,0.0,0.0
13909,1,3909,[127 187 483 302  12],334,5,17130,4.381074168797954,40.0,20.0
13910,1,3910,[127 187 483 302  12],537,4,17134,4.380976732293531,40.0,20.0
13911,1,3911,[ 22 258 318 435  89],537,3,17137,4.38062372188139,20.0,0.0
13912,1,3912,[127 187 483 302 211],13,5,17142,4.3807820086889855,20.0,20.0
13913,1,3913,[275 118 655 328   8],13,3,17145,4.380429228410833,0.0,0.0
13914,1,3914,[282 215 286 121 194],298,5,17150,4.38058748403576,0.0,0.0
13915,1,3915,[127 187 483 302 211],90,5,17155,4.380745658835546,20.0,20.0
13916,1,3916,[127 187 483 302 211],833,3,17158,4.380393158029104,20.0,20.0
13917,1,3917,[127 187 483 302 211],207,5,17163,4.380551301684533,20.0,20.0
13918,1,3918,[127 187 483 302 211],474,5,17168,4.3807093646338355,20.0,20.0
13919,1,3919,[127 187 483 302 211],666,5,17173,4.380867346938776,20.0,20.0
13920,1,3920,[127 187 483 302 211],339,5,17178,4.3810252486610555,20.0,20.0
13921,1,3921,[127 187 483 302 211],328,5,17183,4.381183069862315,20.0,20.0
13922,1,3922,[127 187 483 302 211],474,5,17188,4.381340810604129,20.0,20.0
13923,1,3923,[127 187 483 302 211],666,5,17193,4.381498470948012,20.0,20.0
13924,1,3924,[127 187 483 302 211],474,5,17198,4.381656050955414,20.0,20.0
13925,1,3925,[234 333 496 286 216],537,1,17199,4.380794701986755,0.0,0.0
13926,1,3926,[127 187 483 302 211],537,5,17204,4.380952380952381,20.0,20.0
13927,1,3927,[127 187 483 302 211],343,5,17209,4.381109979633401,20.0,20.0
13928,1,3928,[508 515 153 111 144],207,3,17212,4.380758462713159,0.0,0.0
13929,1,3929,[127 187 483 302 211],343,5,17217,4.380916030534351,20.0,20.0
13930,1,3930,[168   9 282 215 125],881,2,17219,4.380310353599593,0.0,0.0
13931,1,3931,[144 423 100 322  22],308,3,17222,4.379959308240081,0.0,20.0
13932,1,3932,[742  56  15  25 135],374,4,17226,4.379862700228833,0.0,0.0
13933,1,3933,[127 187 483 302 211],13,5,17231,4.38002033553635,20.0,20.0
13934,1,3934,[ 22 289 238 273 204],387,3,17234,4.379669631512071,0.0,0.0
13935,1,3935,[135 328 496 294 196],749,4,17238,4.379573170731708,0.0,0.0
13936,1,3936,[127 187 483 302 211],90,5,17243,4.379730759461519,20.0,20.0
13937,1,3937,[100 357  15 204 238],308,4,17247,4.3796343321482984,20.0,20.0
13938,1,3938,[127 187 483 302 211],833,3,17250,4.3792840822543795,20.0,20.0
13939,1,3939,[127 187 483 302 211],833,3,17253,4.3789340101522845,20.0,20.0
13940,1,3940,[127 187 483 302 211],537,5,17258,4.379091601116468,20.0,20.0
13941,1,3941,[127 187 483 302 211],474,5,17263,4.379249112125825,20.0,20.0
13942,1,3942,[127 187 483 302 211],339,5,17268,4.379406543241187,20.0,20.0
13943,1,3943,[127 187 483 302 211],207,5,17273,4.379563894523327,20.0,20.0
13944,1,3944,[127 187 483 302 211],90,5,17278,4.379721166032953,20.0,20.0
13945,1,3945,[127 187 483 302 211],13,5,17283,4.379878357830715,20.0,20.0
13946,1,3946,[127 187 483 302 211],328,5,17288,4.380035469977198,20.0,20.0
13947,1,3947,[333 423 237 195 294],346,4,17292,4.379939209726444,0.0,0.0
13948,1,3948,[127 187 483 302 211],6,5,17297,4.380096226892884,20.0,20.0
13949,1,3949,[ 79  97 132 175  95],815,3,17300,4.379746835443038,0.0,0.0
13950,1,3950,[ 97  96 333  82 235],13,2,17302,4.379144520374589,0.0,0.0
13951,1,3951,[127 187 483 302 211],666,5,17307,4.379301619433198,20.0,20.0
13952,1,3952,[275  95  69 235 318],64,5,17312,4.379458639008348,20.0,0.0
13953,1,3953,[127 187 483 302 211],207,5,17317,4.379615579160344,20.0,20.0
13954,1,3954,[127 187 483 302 211],13,5,17322,4.379772439949431,20.0,20.0
13955,1,3955,[202  25  88 187 655],308,5,17327,4.379929221435794,0.0,0.0
13956,1,3956,[127 187 483 302 211],90,5,17332,4.380085923679555,20.0,20.0
13957,1,3957,[568 176 168 245 194],102,0,17332,4.378979282465892,0.0,0.0
13958,1,3958,[127 187 483 302 211],90,5,17337,4.379136145491286,20.0,20.0
13959,1,3959,[127 187 483 302 211],666,5,17342,4.379292929292929,20.0,20.0
13960,1,3960,[ 79 403  71 153 323],13,2,17344,4.378692249431961,0.0,0.0
13961,1,3961,[127 187 483 302 211],666,5,17349,4.378849066128218,20.0,20.0
13962,1,3962,[127 187 483 302 211],6,5,17354,4.379005803684078,20.0,20.0
13963,1,3963,[127 187 483 302 211],6,5,17359,4.379162462159435,20.0,20.0
13964,1,3964,[127 187 483 302 211],833,3,17362,4.378814627994956,20.0,20.0
13965,1,3965,[132 161   4 300 403],234,2,17364,4.37821482602118,0.0,0.0
13966,1,3966,[127 187 483 302 211],328,5,17369,4.378371565414671,20.0,20.0
13967,1,3967,[127 187 483 302 211],328,5,17374,4.378528225806452,20.0,20.0
13968,1,3968,[127 187 483 302 211],339,5,17379,4.378684807256236,20.0,20.0
13969,1,3969,[127 187 483 302 211],328,5,17384,4.378841309823677,20.0,20.0
13970,1,3970,[127 187 483 302 211],13,5,17389,4.3789977335683705,20.0,20.0
13971,1,3971,[127 187 483 302 211],328,5,17394,4.379154078549849,20.0,20.0
13972,1,3972,[127 187 483 302 211],210,5,17399,4.379310344827586,20.0,20.0
13973,1,3973,[127 187 483 302 211],6,5,17404,4.379466532460996,20.0,20.0
13974,1,3974,[127 187 483 302 211],833,3,17407,4.3791194968553455,20.0,20.0
13975,1,3975,[127 187 483 302 211],339,5,17412,4.379275653923541,20.0,20.0
13976,1,3976,[127 187 483 302 211],328,5,17417,4.379431732461654,20.0,20.0
13977,1,3977,[127 187 483 302 211],474,5,17422,4.379587732528909,20.0,20.0
13978,1,3978,[211 180  98   7 179],474,5,17427,4.379743654184469,0.0,20.0
13979,1,3979,[127 187 483 302 211],13,5,17432,4.379899497487437,20.0,20.0
13980,1,3980,[173 546 174  96  79],749,4,17436,4.379804069329314,0.0,20.0
13981,1,3981,[127 187 483 302 211],6,5,17441,4.379959819186339,20.0,20.0
13982,1,3982,[127 187 483 302 211],339,5,17446,4.380115490836054,20.0,20.0
13983,1,3983,[127 187 483 302 211],343,5,17451,4.380271084337349,20.0,20.0
13984,1,3984,[127 187 483 302 211],328,5,17456,4.380426599749059,20.0,20.0
13985,1,3985,[127 187 483 302 211],328,5,17461,4.380582037129955,20.0,20.0
13986,1,3986,[127 187 483 302 211],537,5,17466,4.380737396538751,20.0,20.0
13987,1,3987,[483 385 179   8 153],90,5,17471,4.380892678034102,20.0,0.0
13988,1,3988,[127 187 483 302 211],537,5,17476,4.381047881674605,20.0,20.0
13989,1,3989,[127 187 483 302 211],833,3,17479,4.3807017543859645,20.0,20.0
13990,1,3990,[127 187 483 302 211],474,5,17484,4.380856928088199,20.0,20.0
13991,1,3991,[127 187 483 302 211],13,5,17489,4.381012024048096,20.0,20.0
13992,1,3992,[127 187 483 302 211],666,5,17494,4.381167042324067,20.0,20.0
13993,1,3993,[179 288 176 546  25],666,3,17497,4.380821231847771,0.0,0.0
13994,1,3994,[127 187 483 302 211],666,5,17502,4.380976220275344,20.0,20.0
13995,1,3995,[127 187 483 302 211],207,5,17507,4.381131131131131,20.0,20.0
13996,1,3996,[302 237 294  25 271],145,4,17511,4.381035776832625,0.0,0.0
13997,1,3997,[127 187 483 302 211],13,5,17516,4.381190595297649,20.0,20.0
13998,1,3998,[127 187 483 302 211],833,3,17519,4.380845211302826,20.0,20.0
13999,1,3999,[127 187 483 302 211],90,5,17524,4.381,20.0,20.0
14000,1,4000,[483 187 568 191 135],339,4,17528,4.380904773806549,20.0,0.0
14001,1,4001,[127 187 483 302 211],524,5,17533,4.3810594702648675,20.0,20.0
14002,1,4002,[127 187 483 302 211],343,5,17538,4.381214089432925,20.0,20.0
14003,1,4003,[127 187 483 302 211],328,5,17543,4.381368631368631,20.0,20.0
14004,1,4004,[127 187 483 302 211],6,5,17548,4.381523096129838,20.0,20.0
14005,1,4005,[423 132 180 568 328],537,1,17549,4.3806789815277085,0.0,0.0
14006,1,4006,[200 183 202  25 748],881,2,17551,4.380084851509857,0.0,0.0
14007,1,4007,[153 568  97  96 423],95,5,17556,4.380239520958084,0.0,0.0
14008,1,4008,[127 187 483 302 211],666,5,17561,4.380394113245198,20.0,20.0
14009,1,4009,[265 748 228 195 238],64,4,17565,4.3802992518703245,0.0,0.0
14010,1,4010,[127 187 483 302 211],537,5,17570,4.380453752181501,20.0,20.0
14011,1,4011,[127 187 483 302 211],339,5,17575,4.380608175473579,20.0,20.0
14012,1,4012,[127 187 483 302 211],328,5,17580,4.380762521804137,20.0,20.0
14013,1,4013,[127 187 483 302 211],90,5,17585,4.3809167912306926,20.0,20.0
14014,1,4014,[127 187 483 302 211],90,5,17590,4.38107098381071,20.0,20.0
14015,1,4015,[127 187 483 302 211],90,5,17595,4.381225099601593,20.0,20.0
14016,1,4016,[127 187 483 302 211],207,5,17600,4.381379138660692,20.0,20.0
14017,1,4017,[121 508 127 238 187],833,3,17603,4.381035340965655,0.0,20.0
14018,1,4018,[127 187 483 302 211],13,5,17608,4.381189350584722,20.0,20.0
14019,1,4019,[127 187 483 302 211],666,5,17613,4.38134328358209,20.0,20.0
14020,1,4020,[127 187 483 302 211],474,5,17618,4.381497140014922,20.0,20.0
14021,1,4021,[435 475 273 182 202],90,1,17619,4.380656389855793,0.0,0.0
14022,1,4022,[127 187 483 302 211],537,5,17624,4.380810340541884,20.0,20.0
14023,1,4023,[ 79 289 268 187 191],85,3,17627,4.380467196819086,0.0,0.0
14024,1,4024,[127 187 483 302 191],666,5,17632,4.380621118012423,20.0,20.0
14025,1,4025,[127 187 483 302 191],537,5,17637,4.3807749627421755,20.0,20.0
14026,1,4026,[127 187 483 302 191],524,5,17642,4.38092873106531,20.0,20.0
14027,1,4027,[  4  50 271 515 655],334,3,17645,4.380585898709037,0.0,20.0
14028,1,4028,[ 12 385  89  71 405],378,4,17649,4.380491437081162,20.0,0.0
14029,1,4029,[127 187 483 191 302],666,5,17654,4.380645161290323,20.0,20.0
14030,1,4030,[127 187 483 191 302],360,5,17659,4.380798809228479,20.0,20.0
14031,1,4031,[127 187 483 191 302],524,5,17664,4.380952380952381,20.0,20.0
14032,1,4032,[127 187 483 191 302],666,5,17669,4.3811058765187205,20.0,20.0
14033,1,4033,[127 187 483 191 302],13,4,17673,4.381011403073872,20.0,20.0
14034,1,4034,[168  89  88 237 357],537,3,17676,4.380669144981413,20.0,0.0
14035,1,4035,[127 187 483 302 211],90,5,17681,4.380822596630327,20.0,20.0
14036,1,4036,[127 187 483 302 211],537,5,17686,4.380975972256627,20.0,20.0
14037,1,4037,[127 187 483 302 211],474,5,17691,4.381129271916791,20.0,20.0
14038,1,4038,[183 180 269 302   1],339,5,17696,4.381282495667245,0.0,0.0
14039,1,4039,[ 96 187 200  88 202],308,5,17701,4.381435643564356,0.0,0.0
14040,1,4040,[127 187 483 302 211],666,5,17706,4.3815887156644395,20.0,20.0
14041,1,4041,[202  95  69 196 191],398,4,17710,4.38149430974765,0.0,0.0
14042,1,4042,[127 187 483 302 211],339,5,17715,4.381647291615137,20.0,20.0
14043,1,4043,[182 302   4 186 273],158,3,17718,4.381305637982196,0.0,0.0
14044,1,4044,[125   1  22  56 194],295,5,17723,4.381458590852905,0.0,0.0
14045,1,4045,[187 100 135  95 117],234,3,17726,4.3811171527434505,0.0,20.0
14046,1,4046,[ 71 186 181 187 333],506,5,17731,4.38127007659995,0.0,0.0
14047,1,4047,[748 238 275  64 176],474,3,17734,4.3809288537549405,0.0,0.0
14048,1,4048,[127 187 483 302 211],207,5,17739,4.381081748579896,20.0,20.0
14049,1,4049,[127 187 483 302 211],666,5,17744,4.3812345679012346,20.0,20.0
14050,1,4050,[ 15 127 588  97 186],313,3,17747,4.380893606516909,0.0,20.0
14051,1,4051,[265 186 357 271 172],328,4,17751,4.380799605133268,20.0,0.0
14052,1,4052,[127 187 483 302 211],339,5,17756,4.380952380952381,20.0,20.0
14053,1,4053,[127 187 483 302 211],537,5,17761,4.381105081401086,20.0,20.0
14054,1,4054,[127 187 483 302 211],343,5,17766,4.381257706535142,20.0,20.0
14055,1,4055,[179 186 191 143 238],378,2,17768,4.380670611439842,0.0,0.0
14056,1,4056,[127 187 483 302 211],339,5,17773,4.380823268424945,20.0,20.0
14057,1,4057,[127 187 483 302 211],666,5,17778,4.380975850172499,20.0,20.0
14058,1,4058,[127 187 483 302 211],13,5,17783,4.381128356738113,20.0,20.0
14059,1,4059,[174  28 117 153  22],892,5,17788,4.38128078817734,0.0,20.0
14060,1,4060,[127 187 483 302 211],207,5,17793,4.381433144545678,20.0,20.0
14061,1,4061,[127 187 483 302 211],210,5,17798,4.381585425898572,20.0,20.0
14062,1,4062,[127 187 483 302 211],90,5,17803,4.3817376322914106,20.0,20.0
14063,1,4063,[403 300 182  56 174],313,3,17806,4.381397637795276,0.0,20.0
14064,1,4064,[127 187 483 302 211],474,5,17811,4.381549815498155,20.0,20.0
14065,1,4065,[127 187 483 302 211],474,5,17816,4.38170191834727,20.0,20.0
14066,1,4066,[127 187 483 302 211],474,5,17821,4.381853946397836,20.0,20.0
14067,1,4067,[269 288 515 151 216],279,2,17823,4.381268436578171,0.0,0.0
14068,1,4068,[127 187 483 302 211],328,5,17828,4.381420496436471,20.0,20.0
14069,1,4069,[127 187 483 302 211],524,5,17833,4.381572481572482,20.0,20.0
14070,1,4070,[127 187 483 302 211],537,5,17838,4.381724392041267,20.0,20.0
14071,1,4071,[127 187 483 302 211],833,3,17841,4.381385068762279,20.0,20.0
14072,1,4072,[127 187 483 302 211],666,5,17846,4.381536950650626,20.0,20.0
14073,1,4073,[588 748 603 191 200],804,4,17850,4.381443298969073,20.0,0.0
14074,1,4074,[127 187 483 302 211],328,5,17855,4.38159509202454,20.0,20.0
14075,1,4075,[127 187 483 302 211],13,5,17860,4.381746810598626,20.0,20.0
14076,1,4076,[127 187 483 302 211],13,5,17865,4.381898454746137,20.0,20.0
14077,1,4077,[127 187 483 302 211],666,5,17870,4.382050024521824,20.0,20.0
14078,1,4078,[127 187 483 302 211],207,5,17875,4.382201519980387,20.0,20.0
14079,1,4079,[127  12  82 265 100],64,4,17879,4.382107843137255,20.0,40.0
14080,1,4080,[127 187 483 302 211],90,5,17884,4.382259250183778,20.0,20.0
14081,1,4081,[127 187 483 302 211],210,5,17889,4.382410583047526,20.0,20.0
14082,1,4082,[127 187 483 302 211],90,5,17894,4.382561841783002,20.0,20.0
14083,1,4083,[127 187 483 302 211],207,5,17899,4.382713026444662,20.0,20.0
14084,1,4084,[127 187 483 302 211],339,5,17904,4.382864137086903,20.0,20.0
14085,1,4085,[127 187 483 302 211],210,5,17909,4.383015173764073,20.0,20.0
14086,1,4086,[275 742 172 173 257],271,4,17913,4.382921458282358,0.0,0.0
14087,1,4087,[127 187 483 302 211],474,5,17918,4.3830724070450096,20.0,20.0
14088,1,4088,[289 333 435  82 143],533,4,17922,4.382978723404255,0.0,0.0
14089,1,4089,[127 187 483 302 211],90,5,17927,4.383129584352078,20.0,20.0
14090,1,4090,[127 187 483 302 211],13,5,17932,4.383280371547299,20.0,20.0
14091,1,4091,[  9  88 357  11 117],543,3,17935,4.3829423264907135,20.0,0.0
14092,1,4092,[ 56 748  70 187 322],328,3,17938,4.382604446616174,0.0,0.0
14093,1,4093,[ 88 276 286 117 118],271,2,17940,4.382022471910112,0.0,0.0
14094,1,4094,[127 187 483 302 211],343,5,17945,4.382173382173383,20.0,20.0
14095,1,4095,[127 187 483 302 211],90,5,17950,4.38232421875,20.0,20.0
14096,1,4096,[127 187 483 302 211],524,5,17955,4.382474981693923,20.0,20.0
14097,1,4097,[127 187 483 302 211],210,5,17960,4.382625671059053,20.0,20.0
14098,1,4098,[132 282 471   9 121],92,4,17964,4.382532324957307,0.0,0.0
14099,1,4099,[127 187 483 302 211],474,5,17969,4.382682926829268,20.0,20.0
14100,1,4100,[127 187 483 302 211],13,5,17974,4.382833455254816,20.0,20.0
14101,1,4101,[127 187 483 302 211],343,5,17979,4.382983910287664,20.0,20.0
14102,1,4102,[127 187 483 302 211],207,5,17984,4.383134291981477,20.0,20.0
14103,1,4103,[127 187 483 302 211],90,5,17989,4.383284600389864,20.0,20.0
14104,1,4104,[127 187 483 302 211],13,5,17994,4.383434835566383,20.0,20.0
14105,1,4105,[ 98 117 568 121 100],343,2,17996,4.38285435947394,0.0,40.0
14106,1,4106,[127 187 483 302 211],210,5,18001,4.383004626247869,20.0,20.0
14107,1,4107,[127 187 483 302 211],210,5,18006,4.38315481986368,20.0,20.0
14108,1,4108,[127 187 483 302 211],90,5,18011,4.383304940374787,20.0,20.0
14109,1,4109,[127 187 483 302 211],328,5,18016,4.38345498783455,20.0,20.0
14110,1,4110,[127 187 483 302 211],537,5,18021,4.383604962296278,20.0,20.0
14111,1,4111,[127 187 483 302 211],537,5,18026,4.3837548638132295,20.0,20.0
14112,1,4112,[127 187 483 302 211],339,5,18031,4.383904692438609,20.0,20.0
14113,1,4113,[127 187 483 302 211],210,5,18036,4.384054448225571,20.0,20.0
14114,1,4114,[127 187 483 302 211],328,5,18041,4.384204131227217,20.0,20.0
14115,1,4115,[127 187 483 302 211],474,5,18046,4.384353741496598,20.0,20.0
14116,1,4116,[127 187 483 302 211],90,5,18051,4.384503279086713,20.0,20.0
14117,1,4117,[127 187 483 302 211],537,5,18056,4.38465274405051,20.0,20.0
14118,1,4118,[127 187 483 302 211],328,5,18061,4.384802136440884,20.0,20.0
14119,1,4119,[127 187 483 302 211],666,5,18066,4.38495145631068,20.0,20.0
14120,1,4120,[238 182 313   1 471],13,2,18068,4.384372725066731,0.0,0.0
14121,1,4121,[127 187 483 302 211],13,5,18073,4.384522076661814,20.0,20.0
14122,1,4122,[ 11  22 678   1 655],13,2,18075,4.383943730293476,0.0,0.0
14123,1,4123,[ 89 282 183 427 161],194,2,18077,4.383365664403492,0.0,0.0
14124,1,4124,[ 98 234  70 483  28],881,3,18080,4.383030303030303,20.0,20.0
14125,1,4125,[127 187 483 302 211],524,5,18085,4.383179835191469,20.0,20.0
14126,1,4126,[151 191  82 357 328],533,3,18088,4.38284468136661,20.0,0.0
14127,1,4127,[127 187 483 302 211],343,5,18093,4.382994186046512,20.0,20.0
14128,1,4128,[127 187 483 302 211],343,5,18098,4.383143618309518,20.0,20.0
14129,1,4129,[ 28 175 300 118 235],313,3,18101,4.3828087167070215,0.0,0.0
14130,1,4130,[127 187 483 302 211],210,5,18106,4.382958121520213,20.0,20.0
14131,1,4131,[ 79 211  56  69  89],788,4,18110,4.382865440464666,0.0,0.0
14132,1,4132,[127 187 483 302 211],6,5,18115,4.383014759254778,20.0,20.0
14133,1,4133,[286 175  96 176 302],378,5,18120,4.383164005805515,0.0,0.0
14134,1,4134,[127 187 483 302 211],524,5,18125,4.383313180169287,20.0,20.0
14135,1,4135,[127 187 483 302 211],339,5,18130,4.383462282398453,20.0,20.0
14136,1,4136,[127 187 483 302 211],537,5,18135,4.383611312545323,20.0,20.0
14137,1,4137,[127 187 483 302 211],343,5,18140,4.3837602706621555,20.0,20.0
14138,1,4138,[200 568  11 655  69],537,0,18140,4.382701135539985,0.0,0.0
14139,1,4139,[127 187 483 302 211],90,5,18145,4.382850241545894,20.0,20.0
14140,1,4140,[127 187 483 302 211],833,3,18148,4.382516300410529,20.0,20.0
14141,1,4141,[127 187 483 302 211],524,5,18153,4.3826653790439405,20.0,20.0
14142,1,4142,[328 172 117  97   8],271,3,18156,4.382331643736423,0.0,0.0
14143,1,4143,[127 187 483 302 211],537,5,18161,4.382480694980695,20.0,20.0
14144,1,4144,[127 187 483 302 211],343,5,18166,4.3826296743063935,20.0,20.0
14145,1,4145,[ 71 216 173 143 135],92,2,18168,4.38205499276411,0.0,0.0
14146,1,4146,[127 187 483 302 211],210,5,18173,4.382204002893658,20.0,20.0
14147,1,4147,[127 187 483 302 211],6,5,18178,4.382352941176471,20.0,20.0
14148,1,4148,[127 187 483 302 211],207,5,18183,4.3825018076644975,20.0,20.0
14149,1,4149,[127 187 483 302 211],339,5,18188,4.3826506024096386,20.0,20.0
14150,1,4150,[204 603  96 186 288],234,1,18189,4.381835702240424,20.0,0.0
14151,1,4151,[127 187 483 302 211],207,5,18194,4.381984585741812,20.0,20.0
14152,1,4152,[127 187 483 302 211],524,5,18199,4.382133397543944,20.0,20.0
14153,1,4153,[127 187 483 302 211],6,5,18204,4.382282137698604,20.0,20.0
14154,1,4154,[127 187 483 302 211],339,5,18209,4.3824308062575215,20.0,20.0
14155,1,4155,[127 187 483 302 211],328,5,18214,4.382579403272377,20.0,20.0
14156,1,4156,[678 144 318 211  11],454,2,18216,4.382006254510464,20.0,0.0
14157,1,4157,[151 132 135 483 234],339,5,18221,4.382154882154882,20.0,0.0
14158,1,4158,[127 187 483 302 211],6,5,18226,4.382303438326521,20.0,20.0
14159,1,4159,[127 187 483 302 211],666,5,18231,4.382451923076923,20.0,20.0
14160,1,4160,[127 187 483 302 211],524,5,18236,4.382600336457583,20.0,20.0
14161,1,4161,[127 187 483 302 211],90,5,18241,4.382748678519943,20.0,20.0
14162,1,4162,[127 187 483 302 211],666,5,18246,4.3828969493153975,20.0,20.0
14163,1,4163,[  4 273 194 174 186],524,3,18249,4.382564841498559,0.0,20.0
14164,1,4164,[127 187 483 302 211],207,5,18254,4.382713085234093,20.0,20.0
14165,1,4165,[127 187 483 302 211],524,5,18259,4.382861257801248,20.0,20.0
14166,1,4166,[127 187 483 302 211],207,5,18264,4.38300935925126,20.0,20.0
14167,1,4167,[127 187 483 302 211],833,3,18267,4.382677543186181,20.0,20.0
14168,1,4168,[127 187 483 302 211],210,5,18272,4.382825617654114,20.0,20.0
14169,1,4169,[183 132 269  69 403],339,4,18276,4.38273381294964,0.0,0.0
14170,1,4170,[ 28 678 215 385  88],881,2,18278,4.382162550947015,0.0,0.0
14171,1,4171,[127 187 483 302 211],339,5,18283,4.382310642377757,20.0,20.0
14172,1,4172,[127 187 483 302 211],6,5,18288,4.382458662832494,20.0,20.0
14173,1,4173,[127 187 483 302 211],343,5,18293,4.382606612362243,20.0,20.0
14174,1,4174,[127 187 483 302 211],328,5,18298,4.382754491017964,20.0,20.0
14175,1,4175,[127 187 483 302 211],833,3,18301,4.382423371647509,20.0,20.0
14176,1,4176,[183 483 204 210 182],892,5,18306,4.382571223366052,20.0,0.0
14177,1,4177,[127 187 483 302 211],13,5,18311,4.3827190043082815,20.0,20.0
14178,1,4178,[127 187 483 302 211],339,5,18316,4.382866714525006,20.0,20.0
14179,1,4179,[181  79   8  69 187],406,3,18319,4.3825358851674645,0.0,0.0
14180,1,4180,[127 187 483 302 211],524,5,18324,4.382683568524277,20.0,20.0
14181,1,4181,[127 187 483 302 211],524,5,18329,4.382831181252989,20.0,20.0
14182,1,4182,[127 187 483 302 211],90,5,18334,4.382978723404255,20.0,20.0
14183,1,4183,[515 216   1 132  28],290,3,18337,4.382648183556405,0.0,0.0
14184,1,4184,[235 179  12 194 117],339,3,18340,4.382317801672641,20.0,0.0
14185,1,4185,[127 187 483 302 211],474,5,18345,4.38246536072623,20.0,20.0
14186,1,4186,[186 265 222 603 176],804,5,18350,4.382612849295438,20.0,0.0
14187,1,4187,[127 187 483 302 211],833,3,18353,4.382282712511939,20.0,20.0
14188,1,4188,[127 187 483 302 211],207,5,18358,4.382430174265934,20.0,20.0
14189,1,4189,[144 172 211 318 210],454,3,18361,4.382100238663485,20.0,0.0
14190,1,4190,[215 286 153 196 211],387,2,18363,4.381531853972799,0.0,0.0
14191,1,4191,[127 187 483 302 211],90,5,18368,4.3816793893129775,20.0,20.0
14192,1,4192,[127 187 483 302 211],6,5,18373,4.381826854280945,20.0,20.0
14193,1,4193,[215  56  79   1 403],843,0,18373,4.3807820696232715,0.0,0.0
14194,1,4194,[127 187 483 302 211],328,5,18378,4.38092967818832,20.0,20.0
14195,1,4195,[127 187 483 302 211],833,3,18381,4.380600571973308,20.0,20.0
14196,1,4196,[127 187 483 302 211],524,5,18386,4.380748153442935,20.0,20.0
14197,1,4197,[191 603 313 275 121],533,5,18391,4.380895664602192,20.0,0.0
14198,1,4198,[132  97  12 196 202],454,1,18392,4.380090497737557,20.0,0.0
14199,1,4199,[127 187 483 302 211],13,5,18397,4.380238095238095,20.0,20.0
14200,1,4200,[127 187 483 302 211],13,5,18402,4.380385622470841,20.0,20.0
14201,1,4201,[655 403 127 385  64],313,4,18406,4.380295097572584,0.0,20.0
14202,1,4202,[127 187 483 302 211],666,5,18411,4.380442541042113,20.0,20.0
14203,1,4203,[127 187 483 302 211],474,5,18416,4.3805899143672695,20.0,20.0
14204,1,4204,[127 187 483 302 211],328,5,18421,4.380737217598098,20.0,20.0
14205,1,4205,[127 187 483 302 211],328,5,18426,4.380884450784594,20.0,20.0
14206,1,4206,[127 187 483 302 211],207,5,18431,4.381031613976705,20.0,20.0
14207,1,4207,[ 22 276   7 121 222],339,4,18435,4.380941064638783,0.0,0.0
14208,1,4208,[127 187 483 302 211],210,5,18440,4.381088144452364,20.0,20.0
14209,1,4209,[ 70  69  15  28 195],543,4,18444,4.380997624703088,0.0,0.0
14210,1,4210,[127 187 483 302 211],474,5,18449,4.381144621230112,20.0,20.0
14211,1,4211,[204 153 318  22  28],188,4,18453,4.381054131054131,20.0,0.0
14212,1,4212,[127 187 483 302 211],343,5,18458,4.381201044386423,20.0,20.0
14213,1,4213,[127 187 483 302 211],343,5,18463,4.381347887992407,20.0,20.0
14214,1,4214,[127 187 483 302 211],90,5,18468,4.3814946619217086,20.0,20.0
14215,1,4215,[127 187 483 302 211],328,5,18473,4.381641366223909,20.0,20.0
14216,1,4216,[127 187 483 302 211],833,3,18476,4.38131373013991,20.0,20.0
14217,1,4217,[127 187 483 302 211],474,5,18481,4.381460407776197,20.0,20.0
14218,1,4218,[127 187 483 302 211],524,5,18486,4.38160701588054,20.0,20.0
14219,1,4219,[ 71 211  28 405 191],882,5,18491,4.38175355450237,0.0,0.0
14220,1,4220,[127 187 483 302 191],90,5,18496,4.381900023691069,20.0,20.0
14221,1,4221,[471 222 197 228 194],343,5,18501,4.382046423495973,0.0,0.0
14222,1,4222,[127 187 483 302 191],207,5,18506,4.3821927539663745,20.0,20.0
14223,1,4223,[127 187 483 302 191],207,5,18511,4.382339015151516,20.0,20.0
14224,1,4224,[127 187 483 302 191],360,5,18516,4.382485207100592,20.0,20.0
14225,1,4225,[127 187 483 302 191],664,4,18520,4.382394699479413,20.0,20.0
14226,1,4226,[127 187 483 302 211],833,3,18523,4.382067660279158,20.0,20.0
14227,1,4227,[127 187 483 302 211],343,5,18528,4.382213812677389,20.0,20.0
14228,1,4228,[127 187 483 302 211],474,5,18533,4.382359895956491,20.0,20.0
14229,1,4229,[127 187 483 302 211],537,5,18538,4.382505910165484,20.0,20.0
14230,1,4230,[127 187 483 302 211],6,5,18543,4.382651855353345,20.0,20.0
14231,1,4231,[127 187 483 302 211],210,5,18548,4.382797731568998,20.0,20.0
14232,1,4232,[127 187 483 302 211],339,5,18553,4.382943538861328,20.0,20.0
14233,1,4233,[127 187 483 302 211],474,5,18558,4.3830892772791685,20.0,20.0
14234,1,4234,[  4  70  50  71 175],524,3,18561,4.382762691853601,0.0,20.0
14235,1,4235,[ 64  89 546 195 211],328,3,18564,4.38243626062323,0.0,0.0
14236,1,4236,[127 187 483 302 211],13,5,18569,4.382582015577059,20.0,20.0
14237,1,4237,[127 187 483 302 211],524,5,18574,4.382727701746107,20.0,20.0
14238,1,4238,[127 187 483 302 211],474,5,18579,4.382873319179052,20.0,20.0
14239,1,4239,[ 64 176 286 143 313],537,1,18580,4.382075471698113,0.0,0.0
14240,1,4240,[127 187 483 302 211],210,5,18585,4.382221174251356,20.0,20.0
14241,1,4241,[  9 197  89 176   1],326,1,18586,4.381423856671382,0.0,0.0
14242,1,4242,[127 187 483 302 211],210,5,18591,4.381569644119726,20.0,20.0
14243,1,4243,[127 187 483 302 211],474,5,18596,4.381715362865221,20.0,20.0
14244,1,4244,[127 187 483 302 211],666,5,18601,4.38186101295642,20.0,20.0
14245,1,4245,[127 187 483 302 211],13,5,18606,4.382006594441828,20.0,20.0
14246,1,4246,[127 187 483 302 211],524,5,18611,4.382152107369908,20.0,20.0
14247,1,4247,[127 187 483 302 211],6,5,18616,4.382297551789077,20.0,20.0
14248,1,4248,[127 187 483 302 211],339,5,18621,4.3824429277477055,20.0,20.0
14249,1,4249,[127 187 483 302 211],328,5,18626,4.382588235294118,20.0,20.0
14250,1,4250,[172  11 238  22  79],272,5,18631,4.382733474476594,0.0,0.0
14251,1,4251,[127 187 483 302 211],6,5,18636,4.382878645343368,20.0,20.0
14252,1,4252,[127 187 483 302 211],210,5,18641,4.383023747942628,20.0,20.0
14253,1,4253,[127 187 483 302 211],13,5,18646,4.38316878232252,20.0,20.0
14254,1,4254,[127 187 483 302 211],207,5,18651,4.3833137485311395,20.0,20.0
14255,1,4255,[127 187 483 302 211],6,5,18656,4.383458646616542,20.0,20.0
14256,1,4256,[127 187 483 302 211],524,5,18661,4.383603476626733,20.0,20.0
14257,1,4257,[127 187 483 302 211],524,5,18666,4.383748238609676,20.0,20.0
14258,1,4258,[127 187 483 302 211],90,5,18671,4.383892932613289,20.0,20.0
14259,1,4259,[127 187 483 302 211],474,5,18676,4.384037558685446,20.0,20.0
14260,1,4260,[127 187 483 302 211],537,5,18681,4.384182116873974,20.0,20.0
14261,1,4261,[179 168  69 234 496],536,4,18685,4.38409197559831,0.0,0.0
14262,1,4262,[127 187 483 302 211],328,5,18690,4.384236453201971,20.0,20.0
14263,1,4263,[117 151  96  95 180],650,2,18692,4.3836772983114445,0.0,0.0
14264,1,4264,[127 187 483 302 211],343,5,18697,4.383821805392731,20.0,20.0
14265,1,4265,[204 235  88 200 174],374,3,18700,4.383497421472105,0.0,20.0
14266,1,4266,[127 187 483 302 211],13,5,18705,4.38364190297633,20.0,20.0
14267,1,4267,[127 187 483 302 211],328,5,18710,4.383786316776008,20.0,20.0
14268,1,4268,[127 187 483 302 211],666,5,18715,4.383930662918717,20.0,20.0
14269,1,4269,[127 187 483 302 211],328,5,18720,4.384074941451991,20.0,20.0
14270,1,4270,[234  95 172 405  50],194,0,18720,4.383048466401311,0.0,20.0
14271,1,4271,[127 187 483 302 211],666,5,18725,4.3831928838951315,20.0,20.0
14272,1,4272,[127 187 483 302 211],537,5,18730,4.383337233793588,20.0,20.0
14273,1,4273,[127 187 483 302 211],524,5,18735,4.383481516144127,20.0,20.0
14274,1,4274,[597 265 151 568 288],378,2,18737,4.382923976608187,0.0,0.0
14275,1,4275,[127 187 483 302 211],210,5,18742,4.3830682881197385,20.0,20.0
14276,1,4276,[127 187 483 302 211],666,5,18747,4.383212532148702,20.0,20.0
14277,1,4277,[127 187 483 302 211],207,5,18752,4.383356708742403,20.0,20.0
14278,1,4278,[127 187 483 302 211],328,5,18757,4.383500817948119,20.0,20.0
14279,1,4279,[127 187 483 302 211],833,3,18760,4.383177570093458,20.0,20.0
14280,1,4280,[127 187 483 302 211],6,5,18765,4.383321653819201,20.0,20.0
14281,1,4281,[127 187 483 302 211],833,3,18768,4.382998598785615,20.0,20.0
14282,1,4282,[127 187 483 302 211],537,5,18773,4.38314265701611,20.0,20.0
14283,1,4283,[172   7 197 568  82],455,5,18778,4.383286647992531,0.0,0.0
14284,1,4284,[  8 568  15 117 175],892,5,18783,4.38343057176196,0.0,0.0
14285,1,4285,[ 50 435 200  56  82],455,5,18788,4.383574428371442,0.0,20.0
14286,1,4286,[183 111 195 180 135],474,5,18793,4.3837182178679726,0.0,0.0
14287,1,4287,[174  89  96 187 508],13,4,18797,4.383628731343284,0.0,20.0
14288,1,4288,[127 187 483 302 211],207,5,18802,4.383772441128468,20.0,20.0
14289,1,4289,[127 187 483 302 211],90,5,18807,4.383916083916084,20.0,20.0
14290,1,4290,[127 187 483 302 211],13,5,18812,4.384059659752971,20.0,20.0
14291,1,4291,[127 187 483 302 211],210,5,18817,4.384203168685928,20.0,20.0
14292,1,4292,[127 187 483 302 211],537,5,18822,4.384346610761705,20.0,20.0
14293,1,4293,[127 187 483 302 211],13,5,18827,4.384489986027014,20.0,20.0
14294,1,4294,[127 187 483 302 211],833,3,18830,4.3841676367869615,20.0,20.0
14295,1,4295,[ 70 271 195 204 546],788,1,18831,4.3833798882681565,0.0,0.0
14296,1,4296,[121 322 228 175 211],313,3,18834,4.383057947405167,0.0,0.0
14297,1,4297,[127 187 483 302 211],524,5,18839,4.383201489064681,20.0,20.0
14298,1,4298,[127 187 483 302 211],13,5,18844,4.383344963945103,20.0,20.0
14299,1,4299,[127 187 483 302 211],474,5,18849,4.383488372093023,20.0,20.0
14300,1,4300,[127 187 483 302 211],90,5,18854,4.383631713554987,20.0,20.0
14301,1,4301,[127 187 483 302 211],524,5,18859,4.383774988377499,20.0,20.0
14302,1,4302,[127 187 483 302 211],90,5,18864,4.383918196607018,20.0,20.0
14303,1,4303,[127 187 483 302 211],474,5,18869,4.384061338289963,20.0,20.0
14304,1,4304,[117 143 357 191  70],308,4,18873,4.38397212543554,20.0,0.0
14305,1,4305,[127 187 483 302 211],13,5,18878,4.3841151881096145,20.0,20.0
14306,1,4306,[127 187 483 302 211],328,5,18883,4.384258184351056,20.0,20.0
14307,1,4307,[127 187 483 302 211],210,5,18888,4.3844011142061285,20.0,20.0
14308,1,4308,[748 385 117 357 471],533,3,18891,4.384079832907867,20.0,0.0
14309,1,4309,[127 187 483 302 211],90,5,18896,4.384222737819026,20.0,20.0
14310,1,4310,[180 423  64  70 172],59,4,18900,4.384133611691023,0.0,0.0
14311,1,4311,[568  96 210 132 222],454,3,18903,4.383812615955473,0.0,0.0
14312,1,4312,[174 603 181 132 121],7,4,18907,4.3837236262462325,20.0,20.0
14313,1,4313,[127 187 483 302 211],833,3,18910,4.383402874362541,20.0,20.0
14314,1,4314,[127 187 483 302 211],833,3,18913,4.383082271147161,20.0,20.0
14315,1,4315,[127 187 483 302 211],339,5,18918,4.383225208526413,20.0,20.0
14316,1,4316,[127 187 483 302 211],210,5,18923,4.383368079684966,20.0,20.0
14317,1,4317,[127 187 483 302 211],343,5,18928,4.383510884668828,20.0,20.0
14318,1,4318,[195  25 403  88 172],650,2,18930,4.382959018291271,0.0,0.0
14319,1,4319,[294   9 271 168 176],13,1,18931,4.382175925925926,0.0,0.0
14320,1,4320,[127 187 483 302 211],90,5,18936,4.382318907660264,20.0,20.0
14321,1,4321,[135 179  22 197 111],524,3,18939,4.381999074502545,0.0,0.0
14322,1,4322,[127 187 483 302 211],666,5,18944,4.3821420309969925,20.0,20.0
14323,1,4323,[127 187 483 302 211],210,5,18949,4.382284921369103,20.0,20.0
14324,1,4324,[127 187 483 302 211],537,5,18954,4.38242774566474,20.0,20.0
14325,1,4325,[127 187 483 302 211],666,5,18959,4.382570503929728,20.0,20.0
14326,1,4326,[127 187 483 302 211],833,3,18962,4.382250982204761,20.0,20.0
14327,1,4327,[127 187 483 302 211],6,5,18967,4.382393715341959,20.0,20.0
14328,1,4328,[127 187 483 302 211],666,5,18972,4.382536382536382,20.0,20.0
14329,1,4329,[127 187 483 302 211],210,5,18977,4.382678983833718,20.0,20.0
14330,1,4330,[127 187 483 302 211],666,5,18982,4.382821519279612,20.0,20.0
14331,1,4331,[127 187 483 302 211],524,5,18987,4.382963988919667,20.0,20.0
14332,1,4332,[127 187 483 302 211],537,5,18992,4.383106392799446,20.0,20.0
14333,1,4333,[127 187 483 302 211],833,3,18995,4.3827872634979235,20.0,20.0
14334,1,4334,[121 216 294 258 210],666,1,18996,4.3820069204152245,0.0,0.0
14335,1,4335,[127 187 483 302 211],666,5,19001,4.382149446494465,20.0,20.0
14336,1,4336,[127 187 483 302 211],13,5,19006,4.382291906848051,20.0,20.0
14337,1,4337,[127 187 483 302 211],524,5,19011,4.382434301521439,20.0,20.0
14338,1,4338,[ 69 471  96 403  82],533,4,19015,4.382346162710302,0.0,0.0
14339,1,4339,[127 187 483 302 211],207,5,19020,4.382488479262673,20.0,20.0
14340,1,4340,[127 187 483 302 211],328,5,19025,4.382630730246487,20.0,20.0
14341,1,4341,[127 187 483 302 211],524,5,19030,4.382772915707047,20.0,20.0
14342,1,4342,[127 187 483 302 211],666,5,19035,4.382915035689615,20.0,20.0
14343,1,4343,[127 187 483 302 211],537,5,19040,4.383057090239411,20.0,20.0
14344,1,4344,[127 187 483 302 211],6,5,19045,4.383199079401611,20.0,20.0
14345,1,4345,[ 82 172   7 153  79],804,5,19050,4.383341003221353,0.0,0.0
14346,1,4346,[127 187 483 302 211],666,5,19055,4.383482861743731,20.0,20.0
14347,1,4347,[127 187 483 302 211],6,5,19060,4.3836246550138,20.0,20.0
14348,1,4348,[127 187 483 302 211],6,5,19065,4.383766383076569,20.0,20.0
14349,1,4349,[127 187 483 302 211],343,5,19070,4.3839080459770114,20.0,20.0
14350,1,4350,[127 187 483 302 211],328,5,19075,4.384049643760055,20.0,20.0
14351,1,4351,[127 187 483 302 211],6,5,19080,4.384191176470588,20.0,20.0
14352,1,4352,[  8 135 742 183 181],308,5,19085,4.384332644153457,0.0,0.0
14353,1,4353,[153 222 286 235 168],343,5,19090,4.384474046853468,0.0,0.0
14354,1,4354,[127 187 483 302 211],210,5,19095,4.384615384615385,20.0,20.0
14355,1,4355,[127 187 483 302 211],474,5,19100,4.38475665748393,20.0,20.0
14356,1,4356,[127 187 483 302 211],833,3,19103,4.384438834060133,20.0,20.0
14357,1,4357,[301 234 175  70 655],666,4,19107,4.384350619550252,0.0,0.0
14358,1,4358,[127 187 483 302 211],6,5,19112,4.384491855930259,20.0,20.0
14359,1,4359,[127 187 483 302 211],666,5,19117,4.384633027522936,20.0,20.0
14360,1,4360,[127 187 483 302 211],666,5,19122,4.38477413437285,20.0,20.0
14361,1,4361,[127 187 483 302 211],328,5,19127,4.3849151765245304,20.0,20.0
14362,1,4362,[127 187 483 302 211],210,5,19132,4.385056154022462,20.0,20.0
14363,1,4363,[127 187 483 302 211],90,5,19137,4.385197066911091,20.0,20.0
14364,1,4364,[127 187 483 302 211],474,5,19142,4.385337915234823,20.0,20.0
14365,1,4365,[127 187 483 302 211],6,5,19147,4.385478699038021,20.0,20.0
14366,1,4366,[  4 328 181  71 568],328,3,19150,4.385161438058163,0.0,0.0
14367,1,4367,[127 187 483 302 211],474,5,19155,4.385302197802198,20.0,20.0
14368,1,4368,[127 187 483 302 211],90,5,19160,4.385442893110552,20.0,20.0
14369,1,4369,[127 187 483 302 211],537,5,19165,4.38558352402746,20.0,20.0
14370,1,4370,[127 187 483 302 211],6,5,19170,4.385724090597117,20.0,20.0
14371,1,4371,[127 187 483 302 211],13,5,19175,4.385864592863678,20.0,20.0
14372,1,4372,[127 187 483 302 211],339,5,19180,4.386005030871256,20.0,20.0
14373,1,4373,[127 187 483 302 211],537,5,19185,4.386145404663923,20.0,20.0
14374,1,4374,[127 187 483 302 211],90,5,19190,4.386285714285714,20.0,20.0
14375,1,4375,[127 187 483 302 211],666,5,19195,4.386425959780621,20.0,20.0
14376,1,4376,[301 276  64  50 423],13,4,19199,4.386337674206077,0.0,20.0
14377,1,4377,[127 187 483 302 211],343,5,19204,4.3864778437642755,20.0,20.0
14378,1,4378,[ 22   7 289 471 228],328,3,19207,4.386161224023749,0.0,0.0
14379,1,4379,[127 187 483 302 211],666,5,19212,4.3863013698630136,20.0,20.0
14380,1,4380,[168 194 196  64  50],85,5,19217,4.386441451723351,0.0,20.0
14381,1,4381,[127 187 483 302 211],207,5,19222,4.386581469648562,20.0,20.0
14382,1,4382,[127 187 483 302 211],339,5,19227,4.38672142368241,20.0,20.0
14383,1,4383,[127 187 483 302 211],474,5,19232,4.386861313868613,20.0,20.0
14384,1,4384,[127 117  89   1 200],643,2,19234,4.386316989737742,0.0,20.0
14385,1,4385,[125 435 268 151 175],234,0,19234,4.38531691746466,0.0,0.0
14386,1,4386,[127 187 483 302 211],343,5,19239,4.3854570321404145,20.0,20.0
14387,1,4387,[127 187 483 302 211],474,5,19244,4.38559708295351,20.0,20.0
14388,1,4388,[127 187 483 302 211],207,5,19249,4.385737069947596,20.0,20.0
14389,1,4389,[127 187 483 302 211],666,5,19254,4.385876993166287,20.0,20.0
14390,1,4390,[127 187 483 302 211],6,5,19259,4.386016852653154,20.0,20.0
14391,1,4391,[127 187 483 302 211],343,5,19264,4.38615664845173,20.0,20.0
14392,1,4392,[127 187 483 302 211],537,5,19269,4.386296380605509,20.0,20.0
14393,1,4393,[ 97 111  98 173  69],666,3,19272,4.385980883022303,0.0,20.0
14394,1,4394,[127 187 483 302 211],210,5,19277,4.386120591581342,20.0,20.0
14395,1,4395,[ 88 742 222 257 546],650,1,19278,4.385350318471337,0.0,0.0
14396,1,4396,[127 187 483 302 211],339,5,19283,4.385490106891062,20.0,20.0
14397,1,4397,[  8 200 191 135  97],543,4,19287,4.385402455661664,0.0,0.0
14398,1,4398,[127 187 483 302 211],339,5,19292,4.385542168674699,20.0,20.0
14399,1,4399,[127 187 483 302 211],339,5,19297,4.385681818181818,20.0,20.0
14400,1,4400,[127 187 483 302 211],210,5,19302,4.385821404226312,20.0,20.0
14401,1,4401,[127 187 483 302 211],537,5,19307,4.385960926851431,20.0,20.0
14402,1,4402,[127 187 483 302 211],524,5,19312,4.386100386100386,20.0,20.0
14403,1,4403,[127 173  25 100 176],804,4,19316,4.3860127157129885,0.0,40.0
14404,1,4404,[127 187 483 302 211],537,5,19321,4.386152099886493,20.0,20.0
14405,1,4405,[127 187 483 302 211],524,5,19326,4.386291420789832,20.0,20.0
14406,1,4406,[ 95 301 117 423 597],455,2,19328,4.385749943272067,0.0,0.0
14407,1,4407,[127 187 483 302 211],207,5,19333,4.3858892921960075,20.0,20.0
14408,1,4408,[127 187 483 302 211],210,5,19338,4.386028577908823,20.0,20.0
14409,1,4409,[127 187 483 302 211],537,5,19343,4.3861678004535145,20.0,20.0
14410,1,4410,[127 187 483 302 211],6,5,19348,4.386306959873044,20.0,20.0
14411,1,4411,[127 187 483 302 211],474,5,19353,4.386446056210335,20.0,20.0
14412,1,4412,[  7 515 132 196 151],59,5,19358,4.386585089508271,0.0,0.0
14413,1,4413,[127 187 483 302 211],210,5,19363,4.386724059809697,20.0,20.0
14414,1,4414,[127 187 483 302 211],537,5,19368,4.386862967157418,20.0,20.0
14415,1,4415,[289 222 175   7  12],474,4,19372,4.386775362318841,20.0,0.0
14416,1,4416,[568  56  69 655 357],788,2,19374,4.38623500113199,20.0,0.0
14417,1,4417,[435  71 237 235  22],524,1,19375,4.38546853779991,0.0,0.0
14418,1,4418,[127 187 483 302 211],6,5,19380,4.38560760353021,20.0,20.0
14419,1,4419,[127 187 483 302 211],524,5,19385,4.385746606334842,20.0,20.0
14420,1,4420,[100 179 196 318 215],380,3,19388,4.385433159918571,20.0,20.0
14421,1,4421,[127 187 483 302 211],343,5,19393,4.385572139303482,20.0,20.0
14422,1,4422,[127 187 483 302 211],6,5,19398,4.38571105584445,20.0,20.0
14423,1,4423,[127 187 483 302 211],833,3,19401,4.385397830018083,20.0,20.0
14424,1,4424,[127 187 483 302 211],339,5,19406,4.385536723163842,20.0,20.0
14425,1,4425,[127 187 483 302 211],537,5,19411,4.385675553547221,20.0,20.0
14426,1,4426,[127 187 483 302 211],666,5,19416,4.385814321210752,20.0,20.0
14427,1,4427,[127 187 483 302 211],537,5,19421,4.385953026196929,20.0,20.0
14428,1,4428,[546  22 185 161 121],774,0,19421,4.384962745540754,0.0,0.0
14429,1,4429,[127 187 483 302 211],6,5,19426,4.38510158013544,20.0,20.0
14430,1,4430,[127 187 483 302 211],90,5,19431,4.385240352064996,20.0,20.0
14431,1,4431,[127 187 483 302 211],474,5,19436,4.385379061371841,20.0,20.0
14432,1,4432,[  4 216 174  71  56],233,4,19440,4.385292127227611,0.0,20.0
14433,1,4433,[168 276 237 143  88],374,2,19442,4.384754172304916,0.0,0.0
14434,1,4434,[  4 275 195 655  50],538,3,19445,4.384441939120632,0.0,20.0
14435,1,4435,[127 187 483 302 211],474,5,19450,4.384580703336339,20.0,20.0
14436,1,4436,[127 187 483 302 211],537,5,19455,4.384719405003381,20.0,20.0
14437,1,4437,[117 282 269 100   9],26,4,19459,4.384632717440288,0.0,20.0
14438,1,4438,[127 187 483 302 211],207,5,19464,4.3847713448975,20.0,20.0
14439,1,4439,[186 234 357 196 603],738,5,19469,4.38490990990991,40.0,0.0
14440,1,4440,[127 187 483 302 211],833,3,19472,4.384598063499212,20.0,20.0
14441,1,4441,[ 79 118 111 121   7],294,4,19476,4.384511481314723,0.0,0.0
14442,1,4442,[405 245 111 234 216],749,3,19479,4.384199864956111,0.0,0.0
14443,1,4443,[127 187 483 302 211],343,5,19484,4.384338433843384,20.0,20.0
14444,1,4444,[127 187 483 302 211],833,3,19487,4.384026996625422,20.0,20.0
14445,1,4445,[127 187 483 302 211],207,5,19492,4.384165542060279,20.0,20.0
14446,1,4446,[  7 175 496 179 118],738,3,19495,4.383854283786823,0.0,0.0
14447,1,4447,[127 187 483 302 211],339,5,19500,4.383992805755396,20.0,20.0
14448,1,4448,[127 187 483 302 211],524,5,19505,4.384131265452911,20.0,20.0
14449,1,4449,[127 187 483 302 211],339,5,19510,4.384269662921349,20.0,20.0
14450,1,4450,[127 187 483 302 211],90,5,19515,4.384407998202651,20.0,20.0
14451,1,4451,[127 187 483 302 211],524,5,19520,4.384546271338724,20.0,20.0
14452,1,4452,[127 187 483 302 211],90,5,19525,4.384684482371435,20.0,20.0
14453,1,4453,[127 286 603 568 181],387,3,19528,4.3843735967669515,20.0,20.0
14454,1,4454,[127 187 483 302 211],524,5,19533,4.384511784511784,20.0,20.0
14455,1,4455,[127 187 483 302 211],339,5,19538,4.384649910233393,20.0,20.0
14456,1,4456,[127 187 483 302 211],90,5,19543,4.384787973973525,20.0,20.0
14457,1,4457,[127 187 483 302 211],666,5,19548,4.384925975773889,20.0,20.0
14458,1,4458,[127 187 483 302 211],343,5,19553,4.38506391567616,20.0,20.0
14459,1,4459,[127 187 483 302 211],343,5,19558,4.385201793721973,20.0,20.0
14460,1,4460,[127 187 483 302 211],207,5,19563,4.385339609952926,20.0,20.0
14461,1,4461,[127 187 483 302 211],537,5,19568,4.385477364410578,20.0,20.0
14462,1,4462,[195 238 181 427 655],379,4,19572,4.3853909926058705,0.0,0.0
14463,1,4463,[127 187 483 302 211],13,5,19577,4.385528673835125,20.0,20.0
14464,1,4464,[127 187 483 302 211],90,5,19582,4.385666293393057,20.0,20.0
14465,1,4465,[127 187 483 302 211],524,5,19587,4.385803851321093,20.0,20.0
14466,1,4466,[127 187 483 302 211],339,5,19592,4.385941347660622,20.0,20.0
14467,1,4467,[172 173  22 496 216],311,5,19597,4.386078782452999,0.0,0.0
14468,1,4468,[127 187 483 302 211],90,5,19602,4.386216155739539,20.0,20.0
14469,1,4469,[265 423  82 175 183],387,4,19606,4.386129753914989,0.0,0.0
14470,1,4470,[127 187 483 302 211],537,5,19611,4.386267054350257,20.0,20.0
14471,1,4471,[127 187 483 302 211],90,5,19616,4.386404293381037,20.0,20.0
14472,1,4472,[127 187 483 302 211],339,5,19621,4.386541471048513,20.0,20.0
14473,1,4473,[100  56 125 185  50],59,4,19625,4.3864550737595,0.0,40.0
14474,1,4474,[127 187 483 302 211],833,3,19628,4.386145251396648,20.0,20.0
14475,1,4475,[127 187 483 302 211],537,5,19633,4.386282394995532,20.0,20.0
14476,1,4476,[127 187 483 302 211],343,5,19638,4.386419477328568,20.0,20.0
14477,1,4477,[127 187 483 302 211],833,3,19641,4.386109870477892,20.0,20.0
14478,1,4478,[127 187 483 302 211],6,5,19646,4.38624693011833,20.0,20.0
14479,1,4479,[195 197  88 435 288],650,3,19649,4.3859375,0.0,0.0
14480,1,4480,[127 187 483 302 211],328,5,19654,4.38607453693372,20.0,20.0
14481,1,4481,[678 202  96 180 288],387,2,19656,4.385542168674699,0.0,0.0
14482,1,4482,[127 187 483 302 211],90,5,19661,4.385679232656703,20.0,20.0
14483,1,4483,[  4 204 234  82 515],102,1,19662,4.384924174843889,0.0,0.0
14484,1,4484,[655 195 483 496 111],666,3,19665,4.384615384615385,20.0,0.0
14485,1,4485,[127 187 483 302 211],13,5,19670,4.384752563530985,20.0,20.0
14486,1,4486,[423  25 196 269 153],90,5,19675,4.384889681301538,0.0,0.0
14487,1,4487,[202 127 257 210 172],650,1,19676,4.384135472370766,0.0,20.0
14488,1,4488,[161 121  70 276  88],42,3,19679,4.383827132991757,0.0,0.0
14489,1,4489,[127 187 483 302 211],524,5,19684,4.383964365256125,20.0,20.0
14490,1,4490,[127 187 483 302 211],524,5,19689,4.3841015364061455,20.0,20.0
14491,1,4491,[127 187 483 302 211],328,5,19694,4.384238646482636,20.0,20.0
14492,1,4492,[204 181 117 742 357],387,2,19696,4.383707990206989,20.0,0.0
14493,1,4493,[127 187 483 302 211],90,5,19701,4.383845126835781,20.0,20.0
14494,1,4494,[127 187 483 302 211],328,5,19706,4.3839822024471635,20.0,20.0
14495,1,4495,[127 187 483 302 211],207,5,19711,4.38411921708185,20.0,20.0
14496,1,4496,[127 187 483 302 211],207,5,19716,4.38425617078052,20.0,20.0
14497,1,4497,[127 187 483 302 211],13,5,19721,4.384393063583815,20.0,20.0
14498,1,4498,[127 187 483 302 211],524,5,19726,4.38452989553234,20.0,20.0
14499,1,4499,[127 187 483 302 211],474,5,19731,4.384666666666667,20.0,20.0
14500,1,4500,[127 187 483 302 211],537,5,19736,4.384803377027327,20.0,20.0
14501,1,4501,[127 187 483 302 211],210,5,19741,4.38494002665482,20.0,20.0
14502,1,4502,[127 187 483 302 211],474,5,19746,4.385076615589607,20.0,20.0
14503,1,4503,[127 187 483 302 211],474,5,19751,4.385213143872114,20.0,20.0
14504,1,4504,[216 496 313  98 258],64,4,19755,4.385127635960044,0.0,20.0
14505,1,4505,[127 187 483 302 211],339,5,19760,4.385264092321349,20.0,20.0
14506,1,4506,[127 187 483 302 211],666,5,19765,4.3854004881295765,20.0,20.0
14507,1,4507,[127 187 483 302 211],13,5,19770,4.3855368234250225,20.0,20.0
14508,1,4508,[127 187 483 302 211],666,5,19775,4.385673098247948,20.0,20.0
14509,1,4509,[ 97 196  25  79  64],59,5,19780,4.385809312638581,0.0,0.0
14510,1,4510,[127 187 483 302 211],343,5,19785,4.385945466637109,20.0,20.0
14511,1,4511,[127 187 483 302 211],13,5,19790,4.386081560283688,20.0,20.0
14512,1,4512,[127 187 483 302 211],13,5,19795,4.3862175936184356,20.0,20.0
14513,1,4513,[176 328 202 655 275],13,2,19797,4.385688967656181,0.0,0.0
14514,1,4514,[ 28 234 483 237 286],234,3,19800,4.385382059800665,20.0,0.0
14515,1,4515,[597 435  89 265 183],650,4,19804,4.385296722763507,0.0,0.0
14516,1,4516,[  4 313 546 161 186],102,1,19805,4.384547265884437,0.0,0.0
14517,1,4517,[127 187 483 302 211],833,3,19808,4.384240814519699,20.0,20.0
14518,1,4518,[ 96 357 215   8 175],60,4,19812,4.384155786678469,20.0,0.0
14519,1,4519,[127 187 483 302 211],207,5,19817,4.38429203539823,20.0,20.0
14520,1,4520,[215  71 181 127 182],488,3,19820,4.3839858438398585,0.0,20.0
14521,1,4521,[127 187 483 302 211],666,5,19825,4.384122069880584,20.0,20.0
14522,1,4522,[127 187 483 302 211],207,5,19830,4.38425823568428,20.0,20.0
14523,1,4523,[127 187 483 302 211],210,5,19835,4.384394341290893,20.0,20.0
14524,1,4524,[127 187 483 302 211],833,3,19838,4.384088397790055,20.0,20.0
14525,1,4525,[127 187 483 302 211],833,3,19841,4.383782589482987,20.0,20.0
14526,1,4526,[127 187 483 302 211],524,5,19846,4.3839187099624475,20.0,20.0
14527,1,4527,[127 187 483 302 211],343,5,19851,4.384054770318021,20.0,20.0
14528,1,4528,[127 187 483 302 211],343,5,19856,4.384190770589534,20.0,20.0
14529,1,4529,[127 187 483 302 211],90,5,19861,4.384326710816777,20.0,20.0
14530,1,4530,[127 187 483 302 211],339,5,19866,4.384462591039505,20.0,20.0
14531,1,4531,[127 187 483 302 211],328,5,19871,4.38459841129744,20.0,20.0
14532,1,4532,[127 187 483 302 211],207,5,19876,4.384734171630267,20.0,20.0
14533,1,4533,[228 265  96 328 185],145,5,19881,4.384869872077636,0.0,0.0
14534,1,4534,[127 187 483 302 211],6,5,19886,4.385005512679162,20.0,20.0
14535,1,4535,[127 187 483 302 211],537,5,19891,4.385141093474426,20.0,20.0
14536,1,4536,[127 187 483 302 211],537,5,19896,4.385276614502976,20.0,20.0
14537,1,4537,[127 187 483 302 211],210,5,19901,4.385412075804319,20.0,20.0
14538,1,4538,[127 187 483 302 211],13,5,19906,4.3855474774179335,20.0,20.0
14539,1,4539,[176 200  11 204  97],543,3,19909,4.385242290748899,0.0,0.0
14540,1,4540,[127 187 483 302 211],6,5,19914,4.385377670116714,20.0,20.0
14541,1,4541,[127 187 483 302 211],833,3,19917,4.385072655217965,20.0,20.0
14542,1,4542,[286 313 194 132 238],380,4,19921,4.38498789346247,0.0,0.0
14543,1,4543,[127 187 483 302 211],537,5,19926,4.38512323943662,20.0,20.0
14544,1,4544,[127 187 483 302 211],6,5,19931,4.385258525852585,20.0,20.0
14545,1,4545,[127 187 483 302 211],13,5,19936,4.38539375274967,20.0,20.0
14546,1,4546,[127 187 483 302 211],90,5,19941,4.385528920167143,20.0,20.0
14547,1,4547,[127 187 483 302 211],207,5,19946,4.385664028144239,20.0,20.0
14548,1,4548,[286 302 100  28 194],454,3,19949,4.385359419652671,0.0,20.0
14549,1,4549,[100 300   1 515 276],894,5,19954,4.385494505494505,0.0,20.0
14550,1,4550,[180 211  28 234 204],738,4,19958,4.385409800043947,0.0,0.0
14551,1,4551,[127 187 483 302 211],833,3,19961,4.385105448154658,20.0,20.0
14552,1,4552,[127 187 483 302 211],6,5,19966,4.385240500768724,20.0,20.0
14553,1,4553,[186 194 275  71 568],13,3,19969,4.384936319718928,0.0,0.0
14554,1,4554,[127 187 483 302 211],524,5,19974,4.3850713501646545,20.0,20.0
14555,1,4555,[127 187 483 302 211],13,5,19979,4.385206321334504,20.0,20.0
14556,1,4556,[127 187 483 302 211],339,5,19984,4.385341233267501,20.0,20.0
14557,1,4557,[127 187 483 302 211],210,5,19989,4.385476086002633,20.0,20.0
14558,1,4558,[127 187 483 302 211],13,5,19994,4.385610879578855,20.0,20.0
14559,1,4559,[127 187 483 302 211],339,5,19999,4.385745614035088,20.0,20.0
14560,1,4560,[127 187 483 302 211],474,5,20004,4.385880289410217,20.0,20.0
14561,1,4561,[127 187 483 302 211],474,5,20009,4.386014905743095,20.0,20.0
14562,1,4562,[127 187 483 302 211],537,5,20014,4.38614946307254,20.0,20.0
14563,1,4563,[187  71  96 748 515],328,4,20018,4.386064855390009,0.0,0.0
14564,1,4564,[127 187 483 302 211],6,5,20023,4.386199342825849,20.0,20.0
14565,1,4565,[127 187 483 302 211],474,5,20028,4.386333771353482,20.0,20.0
14566,1,4566,[127 187 483 302 211],13,5,20033,4.386468141011605,20.0,20.0
14567,1,4567,[127 187 483 302 211],474,5,20038,4.386602451838879,20.0,20.0
14568,1,4568,[127 187 483 302 211],210,5,20043,4.386736703873933,20.0,20.0
14569,1,4569,[127 187 483 302 211],13,5,20048,4.386870897155361,20.0,20.0
14570,1,4570,[127 187 483 302 211],339,5,20053,4.387005031721724,20.0,20.0
14571,1,4571,[127 187 483 302 211],537,5,20058,4.3871391076115485,20.0,20.0
14572,1,4572,[127 187 483 302 211],339,5,20063,4.387273124863328,20.0,20.0
14573,1,4573,[127 187 483 302 211],207,5,20068,4.387407083515522,20.0,20.0
14574,1,4574,[127 187 483 302 211],328,5,20073,4.3875409836065575,20.0,20.0
14575,1,4575,[127 187 483 302 211],524,5,20078,4.387674825174825,20.0,20.0
14576,1,4576,[127 187 483 302 211],13,5,20083,4.387808608258685,20.0,20.0
14577,1,4577,[275 385 475 302  98],537,3,20086,4.387505460899956,0.0,20.0
14578,1,4578,[127 187 483 302 211],524,5,20091,4.387639222537672,20.0,20.0
14579,1,4579,[127 187 483 302 211],537,5,20096,4.387772925764192,20.0,20.0
14580,1,4580,[127 187 483 302 211],524,5,20101,4.387906570617769,20.0,20.0
14581,1,4581,[127 187 483 302 211],13,5,20106,4.388040157136621,20.0,20.0
14582,1,4582,[127 187 483 302 211],90,5,20111,4.388173685358935,20.0,20.0
14583,1,4583,[127 187 483 302 211],833,3,20114,4.387870855148342,20.0,20.0
14584,1,4584,[127 187 483 302 211],328,5,20119,4.388004362050164,20.0,20.0
14585,1,4585,[127 187 483 302 211],474,5,20124,4.388137810728304,20.0,20.0
14586,1,4586,[127 187 483 302 211],474,5,20129,4.388271201220841,20.0,20.0
14587,1,4587,[127 187 483 302 211],343,5,20134,4.388404533565824,20.0,20.0
14588,1,4588,[181 275 568  15  69],533,5,20139,4.388537807801264,0.0,0.0
14589,1,4589,[127 187 483 302 211],343,5,20144,4.388671023965141,20.0,20.0
14590,1,4590,[175 151 405  71 313],64,2,20146,4.388150729688521,0.0,0.0
14591,1,4591,[127 187 483 302 211],6,5,20151,4.388283972125436,20.0,20.0
14592,1,4592,[127 187 483 302 211],666,5,20156,4.388417156542565,20.0,20.0
14593,1,4593,[127 187 483 302 211],537,5,20161,4.388550282977797,20.0,20.0
14594,1,4594,[127 187 483 302 211],537,5,20166,4.3886833514689885,20.0,20.0
14595,1,4595,[127 187 483 302 211],90,5,20171,4.3888163620539595,20.0,20.0
14596,1,4596,[127 187 483 302 211],207,5,20176,4.388949314770502,20.0,20.0
14597,1,4597,[127 187 483 302 211],524,5,20181,4.389082209656372,20.0,20.0
14598,1,4598,[127 187 483 302 211],328,5,20186,4.389215046749293,20.0,20.0
14599,1,4599,[127 187 483 302 211],13,5,20191,4.389347826086957,20.0,20.0
14600,1,4600,[742 294  88 180 300],533,4,20195,4.38926320365138,0.0,0.0
14601,1,4601,[127 187 483 302 211],210,5,20200,4.3893959148196435,20.0,20.0
14602,1,4602,[127 187 483 302 211],474,5,20205,4.389528568325005,20.0,20.0
14603,1,4603,[118 197  71 655 328],804,5,20210,4.389661164205039,0.0,0.0
14604,1,4604,[127 187 483 302 211],524,5,20215,4.389793702497285,20.0,20.0
14605,1,4605,[127 187 483 302 211],13,5,20220,4.389926183239253,20.0,20.0
14606,1,4606,[127 187 483 302 211],13,5,20225,4.3900586064684175,20.0,20.0
14607,1,4607,[127 187 483 302 211],13,5,20230,4.390190972222222,20.0,20.0
14608,1,4608,[127 187 483 302 211],6,5,20235,4.390323280538078,20.0,20.0
14609,1,4609,[127 187 483 302 211],339,5,20240,4.390455531453362,20.0,20.0
14610,1,4610,[127 187 483 302 211],328,5,20245,4.390587725005422,20.0,20.0
14611,1,4611,[127 187 483 302 211],343,5,20250,4.390719861231569,20.0,20.0
14612,1,4612,[127 187 483 302 211],833,3,20253,4.39041838283113,20.0,20.0
14613,1,4613,[127 187 483 302 211],210,5,20258,4.390550498482878,20.0,20.0
14614,1,4614,[127 187 483 302 211],537,5,20263,4.39068255687974,20.0,20.0
14615,1,4615,[127 187 483 302 211],13,5,20268,4.390814558058925,20.0,20.0
14616,1,4616,[127 187 483 302 211],328,5,20273,4.390946502057613,20.0,20.0
14617,1,4617,[127 187 483 302 211],328,5,20278,4.391078388912949,20.0,20.0
14618,1,4618,[127 187 483 302 211],666,5,20283,4.391210218662048,20.0,20.0
14619,1,4619,[313 222  98 323 204],328,2,20285,4.390692640692641,0.0,20.0
14620,1,4620,[127 187 483 302 211],343,5,20290,4.390824496862151,20.0,20.0
14621,1,4621,[ 11 135  98 515  89],59,5,20295,4.390956295975768,0.0,20.0
14622,1,4622,[ 11 588  89 153  97],234,0,20295,4.390006489292667,0.0,0.0
14623,1,4623,[127 187 483 302 211],339,5,20300,4.390138408304498,20.0,20.0
14624,1,4624,[257 118 282 508 181],92,3,20303,4.389837837837838,0.0,0.0
14625,1,4625,[127 187 483 302 211],666,5,20308,4.389969736273239,20.0,20.0
14626,1,4626,[127 187 483 302 211],343,5,20313,4.390101577696131,20.0,20.0
14627,1,4627,[ 28  11 191 435 143],666,3,20316,4.389801210025929,0.0,0.0
14628,1,4628,[127 187 483 302 211],13,5,20321,4.389933030892202,20.0,20.0
14629,1,4629,[127 187 483 302 211],537,5,20326,4.390064794816415,20.0,20.0
14630,1,4630,[471 197 144 742 202],666,3,20329,4.389764629669618,0.0,0.0
14631,1,4631,[127 187 483 302 211],343,5,20334,4.389896373056994,20.0,20.0
14632,1,4632,[127 187 483 302 211],343,5,20339,4.390028059572631,20.0,20.0
14633,1,4633,[127 187 483 302 211],13,5,20344,4.390159689253345,20.0,20.0
14634,1,4634,[143  69 127 288 245],458,2,20346,4.389644012944983,0.0,20.0
14635,1,4635,[127 187 483 302 211],210,5,20351,4.3897756686798965,20.0,20.0
14636,1,4636,[127 187 483 302 211],339,5,20356,4.389907267629933,20.0,20.0
14637,1,4637,[655 187  50   9  28],339,5,20361,4.390038809831824,0.0,20.0
14638,1,4638,[127 187 483 302 211],207,5,20366,4.390170295322267,20.0,20.0
14639,1,4639,[127 187 483 302 211],90,5,20371,4.390301724137931,20.0,20.0
14640,1,4640,[127 187 483 302 211],207,5,20376,4.39043309631545,20.0,20.0
14641,1,4641,[127 187 483 302 211],474,5,20381,4.390564411891426,20.0,20.0
14642,1,4642,[127 187 483 302 211],210,5,20386,4.390695670902434,20.0,20.0
14643,1,4643,[127 187 483 302 211],90,5,20391,4.390826873385013,20.0,20.0
14644,1,4644,[127 187 483 302 211],13,5,20396,4.390958019375673,20.0,20.0
14645,1,4645,[127 187 483 302 211],90,5,20401,4.391089108910891,20.0,20.0
14646,1,4646,[127 187 483 302 211],343,5,20406,4.391220142027114,20.0,20.0
14647,1,4647,[127 187 483 302 211],6,5,20411,4.391351118760757,20.0,20.0
14648,1,4648,[127 187 483 302 211],339,5,20416,4.391482039148204,20.0,20.0
14649,1,4649,[127 187 483 302 211],537,5,20421,4.391612903225806,20.0,20.0
14650,1,4650,[127 187 483 302 211],6,5,20426,4.3917437110298865,20.0,20.0
14651,1,4651,[127 187 483 302 211],474,5,20431,4.391874462596733,20.0,20.0
14652,1,4652,[127 187 483 302 211],343,5,20436,4.392005157962605,20.0,20.0
14653,1,4653,[127 187 483 302 211],207,5,20441,4.39213579716373,20.0,20.0
14654,1,4654,[127 187 483 302 211],474,5,20446,4.392266380236305,20.0,20.0
14655,1,4655,[210 588 135 546 318],13,2,20448,4.391752577319588,20.0,0.0
14656,1,4656,[127 187 483 302 211],524,5,20453,4.391883186600816,20.0,20.0
14657,1,4657,[127 187 483 302 211],474,5,20458,4.392013739802491,20.0,20.0
14658,1,4658,[127 187 483 302 211],666,5,20463,4.392144236960721,20.0,20.0
14659,1,4659,[127 187 483 302 211],833,3,20466,4.391845493562232,20.0,20.0
14660,1,4660,[127 187 483 302 211],13,5,20471,4.391975970821712,20.0,20.0
14661,1,4661,[127 187 483 302 211],13,5,20476,4.392106392106392,20.0,20.0
14662,1,4662,[  9 132 195 182 313],64,5,20481,4.392236757452284,0.0,0.0
14663,1,4663,[127 187 483 302 211],210,5,20486,4.3923670668953685,20.0,20.0
14664,1,4664,[127 187 483 302 211],210,5,20491,4.392497320471597,20.0,20.0
14665,1,4665,[127 187 483 302 211],666,5,20496,4.392627518216888,20.0,20.0
14666,1,4666,[127 187 483 302 211],343,5,20501,4.392757660167131,20.0,20.0
14667,1,4667,[127 187 483 302 211],13,5,20506,4.392887746358183,20.0,20.0
14668,1,4668,[127 187 483 302 211],90,5,20511,4.3930177768258725,20.0,20.0
14669,1,4669,[127 187 483 302 211],328,5,20516,4.393147751605996,20.0,20.0
14670,1,4670,[127 187 483 302 211],537,5,20521,4.393277670734318,20.0,20.0
14671,1,4671,[423 508 276 204  11],59,5,20526,4.393407534246576,0.0,0.0
14672,1,4672,[121 179 194  50 191],343,4,20530,4.393323346886368,0.0,20.0
14673,1,4673,[ 11 176 435 172 234],788,1,20531,4.3925973470261015,0.0,0.0
14674,1,4674,[127 187 483 302 211],833,3,20534,4.392299465240642,20.0,20.0
14675,1,4675,[127 187 483 302 211],343,5,20539,4.392429426860565,20.0,20.0
14676,1,4676,[127 187 483 302 211],666,5,20544,4.392559332905709,20.0,20.0
14677,1,4677,[127 187 483 302 211],207,5,20549,4.392689183411714,20.0,20.0
14678,1,4678,[427 161 302 276 357],474,5,20554,4.392818978414191,20.0,0.0
14679,1,4679,[117 313  70 357  79],474,5,20559,4.392948717948718,20.0,0.0
14680,1,4680,[127 187 483 302 211],207,5,20564,4.393078402050844,20.0,20.0
14681,1,4681,[127 187 483 302 211],537,5,20569,4.393208030756087,20.0,20.0
14682,1,4682,[ 79  89  96  50 179],899,4,20573,4.393124065769806,0.0,20.0
14683,1,4683,[127 187 483 302 211],90,5,20578,4.393253629376601,20.0,20.0
14684,1,4684,[176 191 202 742 678],308,4,20582,4.393169690501601,0.0,0.0
14685,1,4685,[127 187 483 302 211],210,5,20587,4.393299189073837,20.0,20.0
14686,1,4686,[215  15 385 173 546],95,4,20591,4.3932152762961385,0.0,0.0
14687,1,4687,[127 187 483 302 211],833,3,20594,4.3929180887372015,20.0,20.0
14688,1,4688,[127 187 483 302 211],90,5,20599,4.393047558114737,20.0,20.0
14689,1,4689,[234 288 127 269   8],455,4,20603,4.392963752665246,0.0,20.0
14690,1,4690,[127 187 483 302 211],524,5,20608,4.393093157109359,20.0,20.0
14691,1,4691,[127 187 483 302 211],90,5,20613,4.393222506393862,20.0,20.0
14692,1,4692,[127 187 483 302 211],90,5,20618,4.393351800554017,20.0,20.0
14693,1,4693,[127 187 483 302 211],210,5,20623,4.393481039625053,20.0,20.0
14694,1,4694,[173 288 100  15 185],488,3,20626,4.393184238551651,0.0,20.0
14695,1,4695,[127 187 483 302 211],207,5,20631,4.393313458262351,20.0,20.0
14696,1,4696,[ 56 294 194 496 151],406,3,20634,4.393016819246327,0.0,0.0
14697,1,4697,[127 187 483 302 211],339,5,20639,4.393146019582801,20.0,20.0
14698,1,4698,[127 187 483 302 211],524,5,20644,4.393275164928708,20.0,20.0
14699,1,4699,[127 187 483 302 211],537,5,20649,4.393404255319149,20.0,20.0
14700,1,4700,[127 187 483 302 211],207,5,20654,4.393533290789194,20.0,20.0
14701,1,4701,[127 187 483 302 211],666,5,20659,4.393662271373883,20.0,20.0
14702,1,4702,[127 187 483 302 211],90,5,20664,4.393791197108229,20.0,20.0
14703,1,4703,[194 228 655 197 234],774,1,20665,4.393069727891157,0.0,0.0
14704,1,4704,[127 187 483 302 211],537,5,20670,4.393198724760893,20.0,20.0
14705,1,4705,[210 172  11 276 289],13,2,20672,4.392690182745431,0.0,0.0
14706,1,4706,[127 187 483 302 211],339,5,20677,4.392819205438708,20.0,20.0
14707,1,4707,[127 187 483 302 211],339,5,20682,4.392948173322005,20.0,20.0
14708,1,4708,[127 187 483 302 211],328,5,20687,4.39307708643024,20.0,20.0
14709,1,4709,[127 187 483 302 211],537,5,20692,4.393205944798302,20.0,20.0
14710,1,4710,[127 187 483 302 211],666,5,20697,4.393334748461049,20.0,20.0
14711,1,4711,[127 187 483 302 211],13,5,20702,4.393463497453311,20.0,20.0
14712,1,4712,[127 187 483 302 211],207,5,20707,4.393592191809888,20.0,20.0
14713,1,4713,[127 187 483 302 211],207,5,20712,4.39372083156555,20.0,20.0
14714,1,4714,[127 187 483 302 211],474,5,20717,4.393849416755037,20.0,20.0
14715,1,4715,[127 187 483 302 211],343,5,20722,4.393977947413062,20.0,20.0
14716,1,4716,[127 187 483 302 211],210,5,20727,4.394106423574306,20.0,20.0
14717,1,4717,[127 187 483 302 211],90,5,20732,4.394234845273421,20.0,20.0
14718,1,4718,[127 187 483 302 211],474,5,20737,4.394363212545031,20.0,20.0
14719,1,4719,[127 187 483 302 211],328,5,20742,4.394491525423729,20.0,20.0
14720,1,4720,[127 187 483 302 211],339,5,20747,4.39461978394408,20.0,20.0
14721,1,4721,[127 187 483 302 211],339,5,20752,4.394747988140618,20.0,20.0
14722,1,4722,[195 405 258 435  22],64,3,20755,4.394452678382384,0.0,0.0
14723,1,4723,[210   7 186 427 286],194,2,20757,4.393945808636748,0.0,0.0
14724,1,4724,[257 175 179 318  50],474,4,20761,4.3938624338624335,20.0,20.0
14725,1,4725,[127 187 483 302 211],339,5,20766,4.3939906898011,20.0,20.0
14726,1,4726,[127 187 483 302 211],474,5,20771,4.394118891474508,20.0,20.0
14727,1,4727,[127 187 483 302 211],537,5,20776,4.39424703891709,20.0,20.0
14728,1,4728,[127 187 483 302 211],210,5,20781,4.3943751321632485,20.0,20.0
14729,1,4729,[127 471  88  25 423],343,4,20785,4.394291754756871,0.0,20.0
14730,1,4730,[ 22 515 215 655 194],774,0,20785,4.393362925385754,0.0,0.0
14731,1,4731,[127 187 483 302 211],13,5,20790,4.393491124260355,20.0,20.0
14732,1,4732,[127 187 483 302 211],6,5,20795,4.393619268962603,20.0,20.0
14733,1,4733,[127 187 483 302 211],328,5,20800,4.393747359526827,20.0,20.0
14734,1,4734,[127 187 483 302 211],207,5,20805,4.393875395987329,20.0,20.0
14735,1,4735,[127 187 483 302 211],339,5,20810,4.394003378378378,20.0,20.0
14736,1,4736,[127 187 483 302 211],328,5,20815,4.39413130673422,20.0,20.0
14737,1,4737,[127 187 483 302 211],210,5,20820,4.394259181089067,20.0,20.0
14738,1,4738,[127 187 483 302 211],833,3,20823,4.393964971512977,20.0,20.0
14739,1,4739,[127 187 483 302 211],13,5,20828,4.394092827004219,20.0,20.0
14740,1,4740,[127 187 483 302 211],210,5,20833,4.394220628559376,20.0,20.0
14741,1,4741,[127 187 483 302 211],90,5,20838,4.394348376212569,20.0,20.0
14742,1,4742,[ 50  12 117 121 200],92,4,20842,4.39426523297491,20.0,20.0
14743,1,4743,[127 187 483 302 211],13,5,20847,4.394392917369308,20.0,20.0
14744,1,4744,[127 187 483 302 211],524,5,20852,4.394520547945206,20.0,20.0
14745,1,4745,[127 187 483 302 211],343,5,20857,4.39464812473662,20.0,20.0
14746,1,4746,[127 187 483 302 211],210,5,20862,4.394775647777544,20.0,20.0
14747,1,4747,[127 187 483 302 211],474,5,20867,4.394903117101937,20.0,20.0
14748,1,4748,[127 187 483 302 211],343,5,20872,4.395030532743736,20.0,20.0
14749,1,4749,[127 187 483 302 211],207,5,20877,4.395157894736842,20.0,20.0
14750,1,4750,[127 187 483 302 211],833,3,20880,4.394864239107556,20.0,20.0
14751,1,4751,[127 187 483 302 211],210,5,20885,4.394991582491582,20.0,20.0
14752,1,4752,[127 187 483 302 211],207,5,20890,4.395118872291184,20.0,20.0
14753,1,4753,[127 187 483 302 211],210,5,20895,4.395246108540177,20.0,20.0
14754,1,4754,[173 405 191 132  69],95,3,20898,4.394952681388013,0.0,0.0
14755,1,4755,[127 187 483 302 211],207,5,20903,4.395079899074853,20.0,20.0
14756,1,4756,[127 187 483 302 211],524,5,20908,4.395207063275174,20.0,20.0
14757,1,4757,[127 187 483 302 211],474,5,20913,4.3953341740226985,20.0,20.0
14758,1,4758,[127 187 483 302 211],474,5,20918,4.395461231351124,20.0,20.0
14759,1,4759,[127 187 483 302 211],833,3,20921,4.395168067226891,20.0,20.0
14760,1,4760,[127 187 483 302 211],524,5,20926,4.3952951060701535,20.0,20.0
14761,1,4761,[127 187 483 302 211],343,5,20931,4.395422091558169,20.0,20.0
14762,1,4762,[127 187 483 302 211],210,5,20936,4.395549023724543,20.0,20.0
14763,1,4763,[ 25  69 322 483  95],313,2,20938,4.39504617968094,20.0,0.0
14764,1,4764,[168  25 471 111 121],92,3,20941,4.3947534102833155,0.0,0.0
14765,1,4765,[127 187 483 302 211],474,5,20946,4.394880402853546,20.0,20.0
14766,1,4766,[127 187 483 302 211],474,5,20951,4.395007342143906,20.0,20.0
14767,1,4767,[127 187 483 302 211],328,5,20956,4.39513422818792,20.0,20.0
14768,1,4768,[210 195 568 234 385],379,3,20959,4.394841685888027,0.0,0.0
14769,1,4769,[127 187 483 302 211],90,5,20964,4.39496855345912,20.0,20.0
14770,1,4770,[333  70 202 328 174],533,5,20969,4.395095367847412,0.0,20.0
14771,1,4771,[127 187 483 302 211],339,5,20974,4.395222129086337,20.0,20.0
14772,1,4772,[127 187 483 302 211],207,5,20979,4.395348837209302,20.0,20.0
14773,1,4773,[196 153   8 385 748],92,4,20983,4.395266024298282,0.0,0.0
14774,1,4774,[127 187 483 302 211],339,5,20988,4.395392670157068,20.0,20.0
14775,1,4775,[127 187 483 302 211],474,5,20993,4.3955192629815745,20.0,20.0
14776,1,4776,[127 187 483 302 211],666,5,20998,4.395645802805108,20.0,20.0
14777,1,4777,[127 187 483 302 211],13,5,21003,4.395772289660946,20.0,20.0
14778,1,4778,[127 187 483 302 211],210,5,21008,4.39589872358234,20.0,20.0
14779,1,4779,[144  97  22 568 318],125,4,21012,4.39581589958159,20.0,0.0
14780,1,4780,[127 187 483 302 211],666,5,21017,4.39594227149132,20.0,20.0
14781,1,4781,[127 187 483 302 211],207,5,21022,4.396068590547888,20.0,20.0
14782,1,4782,[127 187 483 302 211],6,5,21027,4.396194856784445,20.0,20.0
14783,1,4783,[127 187 483 302 211],833,3,21030,4.395903010033445,20.0,20.0
14784,1,4784,[127 187 483 302 211],537,5,21035,4.396029258098223,20.0,20.0
14785,1,4785,[194 151 515 172  97],890,5,21040,4.3961554534057665,0.0,0.0
14786,1,4786,[127 187 483 302 211],210,5,21045,4.396281595989137,20.0,20.0
14787,1,4787,[ 70 125 385 194 276],378,4,21049,4.396198830409356,0.0,0.0
14788,1,4788,[127 187 483 302 211],6,5,21054,4.396324911254959,20.0,20.0
14789,1,4789,[127 187 483 302 211],833,3,21057,4.396033402922756,20.0,20.0
14790,1,4790,[127 187 483 302 211],13,5,21062,4.396159465664788,20.0,20.0
14791,1,4791,[117 603 228 179  97],234,1,21063,4.395450751252087,20.0,0.0
14792,1,4792,[127 187 483 302 211],524,5,21068,4.395576882954308,20.0,20.0
14793,1,4793,[127 187 483 302 211],524,5,21073,4.3957029620358785,20.0,20.0
14794,1,4794,[176 173 132 195 678],804,5,21078,4.395828988529718,0.0,0.0
14795,1,4795,[143 269 405 216 183],13,1,21079,4.39512093411176,0.0,0.0
14796,1,4796,[216 588 182 127 143],843,0,21079,4.394204711277882,0.0,20.0
14797,1,4797,[127 187 483 302 211],207,5,21084,4.394330971238015,20.0,20.0
14798,1,4798,[183 175 168 275 191],648,4,21088,4.394248801833715,0.0,0.0
14799,1,4799,[127 187 483 302 211],90,5,21093,4.394375,20.0,20.0
14800,1,4800,[  4 211 173  97  50],271,5,21098,4.394501145594668,0.0,20.0
14801,1,4801,[127 187 483 302 211],6,5,21103,4.394627238650562,20.0,20.0
14802,1,4802,[127 187 483 302 211],6,5,21108,4.3947532792005,20.0,20.0
14803,1,4803,[127 187 483 302 211],339,5,21113,4.394879267277269,20.0,20.0
14804,1,4804,[127 187 483 302 211],207,5,21118,4.395005202913632,20.0,20.0
14805,1,4805,[204 151 515 118 183],833,2,21120,4.394506866416979,0.0,0.0
14806,1,4806,[127 187 483 302 211],90,5,21125,4.394632827127106,20.0,20.0
14807,1,4807,[127 187 483 302 211],210,5,21130,4.394758735440932,20.0,20.0
14808,1,4808,[127 187 483 302 211],6,5,21135,4.394884591391142,20.0,20.0
14809,1,4809,[182 132 135  79  64],454,2,21137,4.394386694386695,0.0,0.0
14810,1,4810,[127 187 483 302 211],339,5,21142,4.394512575348161,20.0,20.0
14811,1,4811,[127 187 483 302 211],6,5,21147,4.394638403990025,20.0,20.0
14812,1,4812,[200 603 471  69 132],815,3,21150,4.394348639102431,20.0,0.0
14813,1,4813,[127 187 483 302 211],210,5,21155,4.394474449522227,20.0,20.0
14814,1,4814,[288 144 187 228 100],387,3,21158,4.3941848390446525,0.0,20.0
14815,1,4815,[127 187 483 302 211],6,5,21163,4.394310631229236,20.0,20.0
14816,1,4816,[127 187 483 302 211],328,5,21168,4.394436371185385,20.0,20.0
14817,1,4817,[127 187 483 302 211],537,5,21173,4.3945620589456205,20.0,20.0
14818,1,4818,[234  50  22 196  96],804,5,21178,4.394687694542436,0.0,20.0
14819,1,4819,[127 187 483 302 211],90,5,21183,4.394813278008299,20.0,20.0
14820,1,4820,[127 187 483 302 211],90,5,21188,4.394938809375648,20.0,20.0
14821,1,4821,[127 187 483 302 211],666,5,21193,4.395064288676897,20.0,20.0
14822,1,4822,[127 187 483 302 211],90,5,21198,4.395189715944433,20.0,20.0
14823,1,4823,[127 187 483 302 211],210,5,21203,4.395315091210613,20.0,20.0
14824,1,4824,[127 187 483 302 211],524,5,21208,4.395440414507772,20.0,20.0
14825,1,4825,[127 187 483 302 211],343,5,21213,4.395565685868214,20.0,20.0
14826,1,4826,[204  96 435 258 185],815,4,21217,4.395483737310959,0.0,0.0
14827,1,4827,[185  95 515 238 742],804,4,21221,4.3954018227009115,0.0,0.0
14828,1,4828,[127 187 483 302 211],343,5,21226,4.395527024228619,20.0,20.0
14829,1,4829,[127 187 483 302 211],90,5,21231,4.395652173913043,20.0,20.0
14830,1,4830,[127 187 483 302 211],90,5,21236,4.39577727178638,20.0,20.0
14831,1,4831,[127 187 483 302 211],537,5,21241,4.395902317880795,20.0,20.0
14832,1,4832,[127 187 483 302 211],6,5,21246,4.39602731222843,20.0,20.0
14833,1,4833,[127 187 483 302 211],6,5,21251,4.3961522548613985,20.0,20.0
14834,1,4834,[238 117 435 183  98],648,3,21254,4.395863495346433,0.0,20.0
14835,1,4835,[127 187 483 302 211],13,5,21259,4.395988420181968,20.0,20.0
14836,1,4836,[127 187 483 302 211],210,5,21264,4.396113293363655,20.0,20.0
14837,1,4837,[127 187 483 302 211],90,5,21269,4.396238114923522,20.0,20.0
14838,1,4838,[127 187 483 302 211],328,5,21274,4.396362884893573,20.0,20.0
14839,1,4839,[127 187 483 302 211],537,5,21279,4.396487603305785,20.0,20.0
14840,1,4840,[405 318 275  12  79],328,5,21284,4.396612270192109,40.0,0.0
14841,1,4841,[127 187 483 302 211],207,5,21289,4.3967368855844695,20.0,20.0
14842,1,4842,[132 100 268  79  97],85,2,21291,4.396241998761099,0.0,20.0
14843,1,4843,[127 187 483 302 211],537,5,21296,4.396366639141205,20.0,20.0
14844,1,4844,[127 187 483 302 211],833,3,21299,4.396078431372549,20.0,20.0
14845,1,4845,[127 187 483 302 211],328,5,21304,4.396203054065208,20.0,20.0
14846,1,4846,[ 25   8 197 496  79],7,4,21308,4.3961213121518465,0.0,0.0
14847,1,4847,[127 187 483 302 211],210,5,21313,4.396245874587459,20.0,20.0
14848,1,4848,[127 187 483 302 211],6,5,21318,4.3963703856465255,20.0,20.0
14849,1,4849,[127 187 483 302 211],210,5,21323,4.396494845360825,20.0,20.0
14850,1,4850,[127 187 483 302 211],328,5,21328,4.396619253762111,20.0,20.0
14851,1,4851,[181 588  12 185 211],42,5,21333,4.39674361088211,20.0,0.0
14852,1,4852,[127 187 483 302 211],210,5,21338,4.396867916752524,20.0,20.0
14853,1,4853,[127 187 483 302 211],328,5,21343,4.396992171405027,20.0,20.0
14854,1,4854,[127 187 483 302 211],343,5,21348,4.397116374871267,20.0,20.0
14855,1,4855,[515 655  11 265   4],666,4,21352,4.397034596375618,0.0,0.0
14856,1,4856,[127 187 483 302 211],339,5,21357,4.39715873996294,20.0,20.0
14857,1,4857,[127 187 483 302 211],343,5,21362,4.397282832441334,20.0,20.0
14858,1,4858,[127 187 483 302 211],524,5,21367,4.397406873842354,20.0,20.0
14859,1,4859,[127 187 483 302 211],328,5,21372,4.397530864197531,20.0,20.0
14860,1,4860,[127 187 483 302 211],13,5,21377,4.397654803538367,20.0,20.0
14861,1,4861,[ 96  88 258 127 200],749,5,21382,4.397778691896339,0.0,20.0
14862,1,4862,[100 288  88 168 276],533,3,21385,4.397491260538762,0.0,20.0
14863,1,4863,[127 187 483 302 211],6,5,21390,4.397615131578948,20.0,20.0
14864,1,4864,[161  82 187 204 333],533,5,21395,4.3977389516957865,0.0,0.0
14865,1,4865,[127 187 483 302 211],13,5,21400,4.397862720920674,20.0,20.0
14866,1,4866,[197 176 508 294 132],533,4,21404,4.397780973905897,0.0,0.0
14867,1,4867,[127 187 483 302 211],328,5,21409,4.397904683648315,20.0,20.0
14868,1,4868,[127 187 483 302 211],339,5,21414,4.398028342575477,20.0,20.0
14869,1,4869,[127 187 483 302 211],328,5,21419,4.3981519507186855,20.0,20.0
14870,1,4870,[127 187 483 302 211],328,5,21424,4.398275508109218,20.0,20.0
14871,1,4871,[678  96 289  98 117],455,2,21426,4.397783251231527,0.0,20.0
14872,1,4872,[ 89   7 144  69 257],339,4,21430,4.397701621177919,0.0,0.0
14873,1,4873,[  9 435 100 265 132],234,2,21432,4.397209684037751,0.0,20.0
14874,1,4874,[183  95 405 234 423],374,4,21436,4.3971282051282055,0.0,0.0
14875,1,4875,[ 95 132 175 210   7],843,2,21438,4.396636587366694,0.0,0.0
14876,1,4876,[127 187 483 302 211],474,5,21443,4.396760303465245,20.0,20.0
14877,1,4877,[127 187 483 302 211],339,5,21448,4.396883968839688,20.0,20.0
14878,1,4878,[318 423 258  12  11],474,5,21453,4.397007583521213,40.0,0.0
14879,1,4879,[127 187 483 302 211],13,5,21458,4.397131147540984,20.0,20.0
14880,1,4880,[294 234 286  25 183],537,0,21458,4.3962302806801885,0.0,0.0
14881,1,4881,[ 22  11 603 301 483],537,2,21460,4.395739451044654,40.0,0.0
14882,1,4882,[127 187 483 302 211],328,5,21465,4.3958631988531645,20.0,20.0
14883,1,4883,[127 187 483 302 211],328,5,21470,4.395986895986896,20.0,20.0
14884,1,4884,[ 71 483 197 323  50],59,4,21474,4.3959058341862844,20.0,20.0
14885,1,4885,[ 50 211 175 121 483],308,3,21477,4.395620139173148,20.0,20.0
14886,1,4886,[127 187 483 302 211],210,5,21482,4.395743810108451,20.0,20.0
14887,1,4887,[132 435 323 238 180],897,4,21486,4.395662847790508,0.0,0.0
14888,1,4888,[143 191 187 475 132],308,4,21490,4.395581918592759,0.0,0.0
14889,1,4889,[568 423   9 385 318],543,1,21491,4.394887525562372,20.0,0.0
14890,1,4890,[127 187 483 302 211],666,5,21496,4.3950112451441425,20.0,20.0
14891,1,4891,[ 98 289 435   9 117],234,2,21498,4.3945216680294354,0.0,20.0
14892,1,4892,[127 187 483 302 211],13,5,21503,4.394645411812794,20.0,20.0
14893,1,4893,[127 187 483 302 211],524,5,21508,4.394769105026563,20.0,20.0
14894,1,4894,[127 187 483 302 211],207,5,21513,4.3948927477017365,20.0,20.0
14895,1,4895,[127 187 483 302 211],537,5,21518,4.395016339869281,20.0,20.0
14896,1,4896,[127 187 483 302 211],343,5,21523,4.395139881560139,20.0,20.0
14897,1,4897,[127 187 483 302 211],474,5,21528,4.395263372805227,20.0,20.0
14898,1,4898,[127 187 483 302 211],328,5,21533,4.395386813635436,20.0,20.0
14899,1,4899,[127 187 483 302 211],474,5,21538,4.395510204081632,20.0,20.0
14900,1,4900,[127 187 483 302 211],833,3,21541,4.395225464190982,20.0,20.0
14901,1,4901,[ 95 117  69  28 172],194,2,21543,4.394736842105263,0.0,0.0
14902,1,4902,[127 187 483 302 211],13,5,21548,4.394860289618601,20.0,20.0
14903,1,4903,[127 187 483 302 211],666,5,21553,4.394983686786297,20.0,20.0
14904,1,4904,[228 216 403 125 111],158,3,21556,4.394699286442406,0.0,0.0
14905,1,4905,[127 187 483 302 211],666,5,21561,4.3948226661231145,20.0,20.0
14906,1,4906,[127 187 483 302 211],90,5,21566,4.394945995516609,20.0,20.0
14907,1,4907,[127 187 483 302 211],666,5,21571,4.395069274653626,20.0,20.0
14908,1,4908,[127 187 483 302 211],666,5,21576,4.395192503564881,20.0,20.0
14909,1,4909,[127 187 483 302 211],6,5,21581,4.395315682281059,20.0,20.0
14910,1,4910,[127 187 483 302 211],537,5,21586,4.395438810832824,20.0,20.0
14911,1,4911,[127 187 483 302 211],666,5,21591,4.395561889250814,20.0,20.0
14912,1,4912,[127 187 483 302 211],328,5,21596,4.395684917565642,20.0,20.0
14913,1,4913,[265 435 515 289 195],13,2,21598,4.395197395197395,0.0,0.0
14914,1,4914,[127 187 483 302 211],207,5,21603,4.395320447609359,20.0,20.0
14915,1,4915,[127 187 483 302 211],328,5,21608,4.395443449959316,20.0,20.0
14916,1,4916,[127 187 483 302 211],343,5,21613,4.395566402277812,20.0,20.0
14917,1,4917,[211 195  97 151 182],843,1,21614,4.3948759658397725,0.0,0.0
14918,1,4918,[127 187 483 302 211],537,5,21619,4.394998983533238,20.0,20.0
14919,1,4919,[183 597  82 288 191],452,3,21622,4.394715447154471,0.0,0.0
14920,1,4920,[127 187 483 302 211],537,5,21627,4.394838447470026,20.0,20.0
14921,1,4921,[127 187 483 302 211],90,5,21632,4.39496139780577,20.0,20.0
14922,1,4922,[127 187 483 302 211],343,5,21637,4.39508429819216,20.0,20.0
14923,1,4923,[127 187 483 302 211],833,3,21640,4.394800974817222,20.0,20.0
14924,1,4924,[269 186 655 100 196],488,1,21641,4.394111675126903,0.0,20.0
14925,1,4925,[127 187 483 302 211],207,5,21646,4.39423467316281,20.0,20.0
14926,1,4926,[127 187 483 302 211],524,5,21651,4.39435762127055,20.0,20.0
14927,1,4927,[ 95  82 588  69 323],897,4,21655,4.394277597402597,0.0,0.0
14928,1,4928,[127 187 483 302 211],343,5,21660,4.394400486914181,20.0,20.0
14929,1,4929,[228 195 237 111 118],374,3,21663,4.394117647058824,0.0,0.0
14930,1,4930,[127 187 483 302 211],343,5,21668,4.39424051916447,20.0,20.0
14931,1,4931,[127 187 483 302 211],328,5,21673,4.394363341443634,20.0,20.0
14932,1,4932,[210 215  71 132 655],64,3,21676,4.394080681127103,0.0,0.0
14933,1,4933,[258 216 222 173 183],334,4,21680,4.3940008107012565,0.0,0.0
14934,1,4934,[127 187 483 302 211],90,5,21685,4.394123606889564,20.0,20.0
14935,1,4935,[127 187 483 302 211],210,5,21690,4.394246353322528,20.0,20.0
14936,1,4936,[127 187 483 302 211],207,5,21695,4.394369050030383,20.0,20.0
14937,1,4937,[211 322 202 483 187],207,3,21698,4.394086674767112,20.0,0.0
14938,1,4938,[127 187 483 302 211],343,5,21703,4.394209354120267,20.0,20.0
14939,1,4939,[127 187 483 302 211],6,5,21708,4.394331983805668,20.0,20.0
14940,1,4940,[153  64 294 175   1],234,1,21709,4.39364501113135,0.0,0.0
14941,1,4941,[127 187 483 302 211],328,5,21714,4.393767705382436,20.0,20.0
14942,1,4942,[127 187 483 302 211],343,5,21719,4.393890349989885,20.0,20.0
14943,1,4943,[127 187 483 302 211],339,5,21724,4.394012944983818,20.0,20.0
14944,1,4944,[127 187 483 302 211],328,5,21729,4.394135490394338,20.0,20.0
14945,1,4945,[202  22 204 357 435],371,4,21733,4.394055802668824,20.0,0.0
14946,1,4946,[127 187 483 302 211],537,5,21738,4.3941782898726505,20.0,20.0
14947,1,4947,[234  50 588 181 121],254,3,21741,4.393896523848019,0.0,20.0
14948,1,4948,[127 187 483 302 211],339,5,21746,4.3940189937361085,20.0,20.0
14949,1,4949,[515 186  12 111 191],6,4,21750,4.393939393939394,20.0,0.0
14950,1,4950,[175  12 265 121 183],194,2,21752,4.3934558675015145,20.0,0.0
14951,1,4951,[127 187 483 302 211],90,5,21757,4.393578352180937,20.0,20.0
14952,1,4952,[127 187 483 302 211],13,5,21762,4.393700787401575,20.0,20.0
14953,1,4953,[127 187 483 302 211],524,5,21767,4.393823173193379,20.0,20.0
14954,1,4954,[127 187 483 302 211],833,3,21770,4.393541876892028,20.0,20.0
14955,1,4955,[211 235 273 185 121],13,2,21772,4.393058918482647,0.0,0.0
14956,1,4956,[127 187 483 302 211],207,5,21777,4.393181359693363,20.0,20.0
14957,1,4957,[127 187 483 302 211],207,5,21782,4.393303751512707,20.0,20.0
14958,1,4958,[127 187 483 302 211],90,5,21787,4.393426093970558,20.0,20.0
14959,1,4959,[127 187 483 302 211],343,5,21792,4.393548387096774,20.0,20.0
14960,1,4960,[235  79 216 222 195],882,4,21796,4.393469058657529,0.0,0.0
14961,1,4961,[127 187 483 302 211],339,5,21801,4.393591293833132,20.0,20.0
14962,1,4962,[216  70 121 200 265],648,3,21804,4.393310497682853,0.0,0.0
14963,1,4963,[127 187 483 302 211],328,5,21809,4.393432715551974,20.0,20.0
14964,1,4964,[127 187 483 302 211],666,5,21814,4.393554884189325,20.0,20.0
14965,1,4965,[289 125 151 100 405],637,2,21816,4.393072895690697,0.0,20.0
14966,1,4966,[127 187 483 302 211],474,5,21821,4.393195087578015,20.0,20.0
14967,1,4967,[127 187 483 302 211],474,5,21826,4.393317230273752,20.0,20.0
14968,1,4968,[127 187 483 302 211],328,5,21831,4.393439323807607,20.0,20.0
14969,1,4969,[127 187 483 302 211],328,5,21836,4.393561368209255,20.0,20.0
14970,1,4970,[127 187 483 302 211],210,5,21841,4.393683363508348,20.0,20.0
14971,1,4971,[127 187 483 302 211],474,5,21846,4.393805309734513,20.0,20.0
14972,1,4972,[127 187 483 302 211],339,5,21851,4.393927206917354,20.0,20.0
14973,1,4973,[127 187 483 302 211],210,5,21856,4.39404905508645,20.0,20.0
14974,1,4974,[ 56   9 172 508 196],13,3,21859,4.393768844221105,0.0,0.0
14975,1,4975,[127 187 483 302 211],339,5,21864,4.393890675241158,20.0,20.0
14976,1,4976,[182 546 588 179 161],13,3,21867,4.393610608800482,0.0,0.0
14977,1,4977,[127 187 483 302 211],474,5,21872,4.393732422659703,20.0,20.0
14978,1,4978,[127 187 483 302 211],666,5,21877,4.393854187587869,20.0,20.0
14979,1,4979,[127 187 483 302 211],343,5,21882,4.393975903614458,20.0,20.0
14980,1,4980,[127 187 483 302 211],833,3,21885,4.3936960449708895,20.0,20.0
14981,1,4981,[222   9 333  79  69],64,4,21889,4.3936170212765955,0.0,0.0
14982,1,4982,[127 187 483 302 211],13,5,21894,4.393738711619506,20.0,20.0
14983,1,4983,[127 187 483 302 211],474,5,21899,4.393860353130016,20.0,20.0
14984,1,4984,[200 204 195 268   7],537,2,21901,4.393380140421264,0.0,0.0
14985,1,4985,[127 187 483 302 211],210,5,21906,4.393501805054152,20.0,20.0
14986,1,4986,[127 187 483 302 211],474,5,21911,4.3936234208943254,20.0,20.0
14987,1,4987,[127 187 483 302 211],90,5,21916,4.3937449879711306,20.0,20.0
14988,1,4988,[ 96 286 182 135 322],90,4,21920,4.393666065343757,0.0,0.0
14989,1,4989,[127 187 483 302 211],474,5,21925,4.3937875751503,20.0,20.0
14990,1,4990,[127 187 483 302 211],343,5,21930,4.393909036265278,20.0,20.0
14991,1,4991,[127 187 483 302 211],207,5,21935,4.394030448717949,20.0,20.0
14992,1,4992,[127 187 483 302 211],90,5,21940,4.394151812537553,20.0,20.0
14993,1,4993,[127 187 483 302 211],328,5,21945,4.394273127753304,20.0,20.0
14994,1,4994,[127 187 483 302 211],343,5,21950,4.394394394394395,20.0,20.0
14995,1,4995,[127 187 483 302 211],524,5,21955,4.394515612489992,20.0,20.0
14996,1,4996,[196 125 423 194  70],194,1,21956,4.393836301781069,0.0,0.0
14997,1,4997,[127 187 483 302 211],524,5,21961,4.393957583033213,20.0,20.0
14998,1,4998,[127 187 483 302 211],210,5,21966,4.3940788157631525,20.0,20.0
14999,1,4999,[127 187 483 302 211],833,3,21969,4.3938,20.0,20.0
15000,1,5000,[127 187 483 302 211],6,5,21974,4.393921215756849,20.0,20.0
15001,1,5001,[127 187 483 302 211],537,5,21979,4.394042383046782,20.0,20.0
15002,1,5002,[127 187 483 302 211],343,5,21984,4.394163501898861,20.0,20.0
15003,1,5003,[127 187 483 302 211],666,5,21989,4.394284572342126,20.0,20.0
15004,1,5004,[127 187 483 302 211],666,5,21994,4.394405594405594,20.0,20.0
15005,1,5005,[357 435 258 197  25],90,4,21998,4.394326807830604,20.0,0.0
15006,1,5006,[268 294 143 435 222],13,2,22000,4.393848611943279,0.0,0.0
15007,1,5007,[127 187 483 302 211],537,5,22005,4.3939696485623,20.0,20.0
15008,1,5008,[127 187 483 302 211],328,5,22010,4.394090636853663,20.0,20.0
15009,1,5009,[127 187 483 302 211],210,5,22015,4.394211576846307,20.0,20.0
15010,1,5010,[174 286 276 496 235],200,4,22019,4.3941329076032725,0.0,20.0
15011,1,5011,[127 187 483 302 211],524,5,22024,4.3942537909018355,20.0,20.0
15012,1,5012,[173 175 200 678  70],506,4,22028,4.394175144623977,0.0,0.0
15013,1,5013,[127 187 483 302 211],13,5,22033,4.394295971280415,20.0,20.0
15014,1,5014,[127 187 483 302 211],328,5,22038,4.394416749750747,20.0,20.0
15015,1,5015,[127 187 483 302 211],328,5,22043,4.3945374800637955,20.0,20.0
15016,1,5016,[127 187 483 302 211],833,3,22046,4.394259517640024,20.0,20.0
15017,1,5017,[173 168 125 182 196],334,3,22049,4.393981666002391,0.0,0.0
15018,1,5018,[127 187 483 302 211],537,5,22054,4.394102410838813,20.0,20.0
15019,1,5019,[ 97   4  22 222  56],537,1,22055,4.393426294820717,0.0,0.0
15020,1,5020,[127 187 483 302 211],524,5,22060,4.393547102170882,20.0,20.0
15021,1,5021,[127 187 483 302 211],90,5,22065,4.393667861409797,20.0,20.0
15022,1,5022,[597 385 435  22 182],207,1,22066,4.392992235715708,0.0,0.0
15023,1,5023,[127 187 483 302 211],833,3,22069,4.392714968152866,20.0,20.0
15024,1,5024,[127 187 483 302 211],474,5,22074,4.392835820895522,20.0,20.0
15025,1,5025,[127 187 483 302 211],6,5,22079,4.392956625547154,20.0,20.0
15026,1,5026,[127 187 483 302 211],90,5,22084,4.393077382136463,20.0,20.0
15027,1,5027,[127 187 483 302 211],524,5,22089,4.393198090692124,20.0,20.0
15028,1,5028,[127 187 483 302 211],13,5,22094,4.393318751242791,20.0,20.0
15029,1,5029,[118   9 179 318 204],374,2,22096,4.392842942345925,20.0,0.0
15030,1,5030,[127 187 483 302 211],328,5,22101,4.392963625521765,20.0,20.0
15031,1,5031,[127 187 483 302 211],474,5,22106,4.393084260731319,20.0,20.0
15032,1,5032,[173 385 357 210 180],659,5,22111,4.393204848003179,20.0,0.0
15033,1,5033,[127 187 483 302 211],13,5,22116,4.393325387365912,20.0,20.0
15034,1,5034,[ 56  88 174 471 276],13,4,22120,4.393247269116187,0.0,20.0
15035,1,5035,[127 187 483 302 211],328,5,22125,4.3933677521842736,20.0,20.0
15036,1,5036,[  9 318   1 175 172],883,4,22129,4.393289656541592,20.0,0.0
15037,1,5037,[204 132 245  15 483],200,4,22133,4.393211591901548,20.0,0.0
15038,1,5038,[127 187 483 302 211],343,5,22138,4.393332010319508,20.0,20.0
15039,1,5039,[127 187 483 302 211],6,5,22143,4.393452380952381,20.0,20.0
15040,1,5040,[202 174 403 181 300],892,4,22147,4.393374330489982,0.0,20.0
15041,1,5041,[127 187 483 302 211],207,5,22152,4.39349464498215,20.0,20.0
15042,1,5042,[202 200 603 197 483],59,5,22157,4.393614911758874,40.0,0.0
15043,1,5043,[127 187 483 302 211],343,5,22162,4.393735130848533,20.0,20.0
15044,1,5044,[127 187 483 302 211],328,5,22167,4.393855302279484,20.0,20.0
15045,1,5045,[127 187 483 302 211],90,5,22172,4.393975426080063,20.0,20.0
15046,1,5046,[127 187 483 302 211],207,5,22177,4.3940955022785815,20.0,20.0
15047,1,5047,[ 28   4   7  89 168],881,3,22180,4.393819334389858,0.0,0.0
15048,1,5048,[127 187 483 302 211],210,5,22185,4.393939393939394,20.0,20.0
15049,1,5049,[127 187 483 302 211],666,5,22190,4.394059405940594,20.0,20.0
15050,1,5050,[127 187 483 302 211],524,5,22195,4.394179370421699,20.0,20.0
15051,1,5051,[127 187 483 302 211],13,5,22200,4.394299287410926,20.0,20.0
15052,1,5052,[127 187 483 302 211],339,5,22205,4.394419156936474,20.0,20.0
15053,1,5053,[127 187 483 302 211],210,5,22210,4.394538979026514,20.0,20.0
15054,1,5054,[127 187 483 302 211],666,5,22215,4.394658753709199,20.0,20.0
15055,1,5055,[ 12 135 294  15 289],406,3,22218,4.394382911392405,20.0,0.0
15056,1,5056,[132 265 210 172  56],653,3,22221,4.394107178168875,0.0,0.0
15057,1,5057,[127 187 483 302 211],524,5,22226,4.394226967180704,20.0,20.0
15058,1,5058,[127 187 483 302 211],666,5,22231,4.394346708835738,20.0,20.0
15059,1,5059,[678 423  95 111 211],749,2,22233,4.393873517786561,0.0,0.0
15060,1,5060,[132  89 282  95   7],776,3,22236,4.393598103141672,0.0,0.0
15061,1,5061,[117 100 181 748 195],474,4,22240,4.393520347688661,0.0,20.0
15062,1,5062,[127 187 483 302 211],833,3,22243,4.393245111593917,20.0,20.0
15063,1,5063,[127 187 483 302 211],833,3,22246,4.392969984202212,20.0,20.0
15064,1,5064,[127 187 483 302 211],90,5,22251,4.393089832181639,20.0,20.0
15065,1,5065,[127 187 483 302 211],339,5,22256,4.393209632846427,20.0,20.0
15066,1,5066,[127 187 483 302 211],343,5,22261,4.393329386224591,20.0,20.0
15067,1,5067,[127 187 483 302 211],13,5,22266,4.39344909234412,20.0,20.0
15068,1,5068,[405  95 235  70 748],882,3,22269,4.393174196093904,0.0,0.0
15069,1,5069,[127 187 483 302 211],13,5,22274,4.393293885601578,20.0,20.0
15070,1,5070,[301 191 121 161 132],334,1,22275,4.3926247288503255,0.0,0.0
15071,1,5071,[127 187 483 302 191],664,4,22279,4.392547318611987,20.0,20.0
15072,1,5072,[127 187 483 302 211],6,5,22284,4.3926670609107035,20.0,20.0
15073,1,5073,[127 187 483 302 211],207,5,22289,4.392786756011037,20.0,20.0
15074,1,5074,[117 318 323  98 172],311,4,22293,4.392709359605911,20.0,20.0
15075,1,5075,[127 187 483 302 211],328,5,22298,4.392828999211978,20.0,20.0
15076,1,5076,[235 475 185 546 132],64,4,22302,4.3927516249753795,0.0,0.0
15077,1,5077,[127 187 483 302 211],90,5,22307,4.392871209137455,20.0,20.0
15078,1,5078,[127 187 483 302 211],537,5,22312,4.392990746209884,20.0,20.0
15079,1,5079,[471 288 181   1 328],92,3,22315,4.392716535433071,0.0,0.0
15080,1,5080,[127 187 483 302 211],6,5,22320,4.3928360558945085,20.0,20.0
15081,1,5081,[127 187 483 302 211],90,5,22325,4.392955529319166,20.0,20.0
15082,1,5082,[215 194 237 515 222],234,2,22327,4.392484753098564,0.0,0.0
15083,1,5083,[127 187 483 302 211],90,5,22332,4.392604248623131,20.0,20.0
15084,1,5084,[127 187 483 302 211],13,5,22337,4.392723697148476,20.0,20.0
15085,1,5085,[127 187 483 302 211],328,5,22342,4.39284309870232,20.0,20.0
15086,1,5086,[127 187 483 302 211],339,5,22347,4.392962453312365,20.0,20.0
15087,1,5087,[318 423  12  28 172],13,4,22351,4.392885220125786,40.0,0.0
15088,1,5088,[265 238 135 151 185],650,3,22354,4.3926115150324225,0.0,0.0
15089,1,5089,[187 328  79 168 132],506,5,22359,4.3927308447937135,0.0,0.0
15090,1,5090,[127 187 483 302 211],537,5,22364,4.392850127676292,20.0,20.0
15091,1,5091,[127 187 483 302 211],474,5,22369,4.392969363707777,20.0,20.0
15092,1,5092,[127 187 483 302 211],524,5,22374,4.393088552915767,20.0,20.0
15093,1,5093,[127 187 483 302 211],339,5,22379,4.3932076953278365,20.0,20.0
15094,1,5094,[127 187 483 302 211],210,5,22384,4.393326790971541,20.0,20.0
15095,1,5095,[127 187 483 302 211],210,5,22389,4.393445839874412,20.0,20.0
15096,1,5096,[127  82 132  70 100],881,3,22392,4.393172454384932,0.0,40.0
15097,1,5097,[127 187 483 302 211],90,5,22397,4.393291486857591,20.0,20.0
15098,1,5098,[173 117 176 181 294],13,1,22398,4.392626005099039,0.0,0.0
15099,1,5099,[127 187 483 302 211],474,5,22403,4.3927450980392155,20.0,20.0
15100,1,5100,[127 187 483 302 211],207,5,22408,4.392864144285435,20.0,20.0
15101,1,5101,[127 187 483 302 211],6,5,22413,4.392983143865151,20.0,20.0
15102,1,5102,[127 187 483 302 211],13,5,22418,4.3931020968058005,20.0,20.0
15103,1,5103,[127 187 483 302 211],6,5,22423,4.393221003134796,20.0,20.0
15104,1,5104,[328  28 405 333 195],533,4,22427,4.393143976493634,0.0,0.0
15105,1,5105,[127 187 483 302 211],666,5,22432,4.393262828045437,20.0,20.0
15106,1,5106,[127 187 483 302 211],666,5,22437,4.393381633052673,20.0,20.0
15107,1,5107,[127 187 483 302 211],6,5,22442,4.393500391542678,20.0,20.0
15108,1,5108,[568   8 143 197 300],454,5,22447,4.393619103542767,0.0,0.0
15109,1,5109,[127 187 483 302 211],328,5,22452,4.393737769080235,20.0,20.0
15110,1,5110,[127 187 483 302 211],474,5,22457,4.393856388182352,20.0,20.0
15111,1,5111,[475 228 168  12 265],537,2,22459,4.393388106416276,20.0,0.0
15112,1,5112,[127 187 483 302 211],6,5,22464,4.393506747506357,20.0,20.0
15113,1,5113,[127 187 483 302 211],524,5,22469,4.393625342197888,20.0,20.0
15114,1,5114,[127 187 483 302 211],328,5,22474,4.393743890518084,20.0,20.0
15115,1,5115,[127 187 483 302 211],537,5,22479,4.393862392494136,20.0,20.0
15116,1,5116,[127 187 483 302 211],13,5,22484,4.393980848153215,20.0,20.0
15117,1,5117,[127 187 483 302 211],666,5,22489,4.39409925752247,20.0,20.0
15118,1,5118,[121   1 161  79 405],13,2,22491,4.393631568665755,0.0,0.0
15119,1,5119,[127 187 483 302 211],339,5,22496,4.39375,20.0,20.0
15120,1,5120,[127 187 483 302 211],339,5,22501,4.3938683850810385,20.0,20.0
15121,1,5121,[127 187 483 302 211],328,5,22506,4.393986723935963,20.0,20.0
15122,1,5122,[127 187 483 302 211],210,5,22511,4.3941050165918405,20.0,20.0
15123,1,5123,[127 187 483 302 211],474,5,22516,4.394223263075722,20.0,20.0
15124,1,5124,[127 187 483 302 211],210,5,22521,4.3943414634146345,20.0,20.0
15125,1,5125,[423 187 271 234 222],650,2,22523,4.3938743659773705,0.0,0.0
15126,1,5126,[127 187 483 302 211],13,5,22528,4.393992588258241,20.0,20.0
15127,1,5127,[127 187 483 302 211],339,5,22533,4.394110764430577,20.0,20.0
15128,1,5128,[191 215 168 117  22],92,4,22537,4.394033924741665,0.0,0.0
15129,1,5129,[127 187 483 302 211],210,5,22542,4.394152046783626,20.0,20.0
15130,1,5130,[127 187 483 302 211],339,5,22547,4.394270122783083,20.0,20.0
15131,1,5131,[127 187 483 302 211],833,3,22550,4.393998441153546,20.0,20.0
15132,1,5132,[127 187 483 302 211],13,5,22555,4.394116501071498,20.0,20.0
15133,1,5133,[483  82  28   8 196],892,4,22559,4.394039735099338,20.0,0.0
15134,1,5134,[127 187 483 302 211],207,5,22564,4.394157740993184,20.0,20.0
15135,1,5135,[127 187 483 302 211],833,3,22567,4.393886292834891,20.0,20.0
15136,1,5136,[127 187 483 302 211],328,5,22572,4.394004282655247,20.0,20.0
15137,1,5137,[127 187 483 302 211],210,5,22577,4.394122226547295,20.0,20.0
15138,1,5138,[118 318   8 210 121],13,3,22580,4.393850943763378,20.0,0.0
15139,1,5139,[385 265 151 228 275],843,1,22581,4.3931906614786,0.0,0.0
15140,1,5140,[302 172 144 282 195],378,4,22585,4.393114180120599,0.0,0.0
15141,1,5141,[127 187 483 302 211],90,5,22590,4.393232205367561,20.0,20.0
15142,1,5142,[127 187 483 302 211],833,3,22593,4.392961306630371,20.0,20.0
15143,1,5143,[127 187 483 302 211],6,5,22598,4.39307931570762,20.0,20.0
15144,1,5144,[127 187 483 302 211],6,5,22603,4.393197278911565,20.0,20.0
15145,1,5145,[127 187 483 302 211],833,3,22606,4.392926544889234,20.0,20.0
15146,1,5146,[ 50 515 211  15 300],271,3,22609,4.392655916067612,0.0,20.0
15147,1,5147,[286 183  56 385  95],102,2,22611,4.392191142191142,0.0,0.0
15148,1,5148,[ 98 588 427 265 269],650,4,22615,4.392114973781316,0.0,20.0
15149,1,5149,[127 187 483 302 211],207,5,22620,4.392233009708738,20.0,20.0
15150,1,5150,[127 187 483 302 211],6,5,22625,4.3923509998058625,20.0,20.0
15151,1,5151,[127 187 483 302 211],474,5,22630,4.392468944099379,20.0,20.0
15152,1,5152,[127 187 483 302 211],343,5,22635,4.392586842615952,20.0,20.0
15153,1,5153,[127 187 483 302 211],339,5,22640,4.3927046953822275,20.0,20.0
15154,1,5154,[127 187 483 302 211],90,5,22645,4.39282250242483,20.0,20.0
15155,1,5155,[151 127   9 515  15],881,2,22647,4.392358417377812,0.0,20.0
15156,1,5156,[127 187 483 302 211],524,5,22652,4.392476245879387,20.0,20.0
15157,1,5157,[ 97 238 168 603 496],537,4,22656,4.392400155098875,20.0,0.0
15158,1,5158,[127 187 483 302 211],339,5,22661,4.392517929831363,20.0,20.0
15159,1,5159,[508 121 211 210  97],474,4,22665,4.392441860465116,0.0,0.0
15160,1,5160,[127 187 483 302 211],524,5,22670,4.392559581476458,20.0,20.0
15161,1,5161,[132  69  50 211 301],234,3,22673,4.392289810151104,0.0,20.0
15162,1,5162,[127 187 483 302 211],328,5,22678,4.392407515010652,20.0,20.0
15163,1,5163,[127 187 483 302 211],207,5,22683,4.392525174283501,20.0,20.0
15164,1,5164,[ 69 191 748 323  82],881,2,22685,4.392061955469506,0.0,0.0
15165,1,5165,[127 187 483 302 211],328,5,22690,4.3921796360820755,20.0,20.0
15166,1,5166,[127 187 483 302 211],537,5,22695,4.392297271143797,20.0,20.0
15167,1,5167,[127 187 483 302 211],6,5,22700,4.392414860681114,20.0,20.0
15168,1,5168,[127 187 483 302 211],210,5,22705,4.392532404720449,20.0,20.0
15169,1,5169,[175 318 597 508 435],82,3,22708,4.392263056092843,20.0,0.0
15170,1,5170,[127 187 483 302 211],833,3,22711,4.391993811641849,20.0,20.0
15171,1,5171,[127 187 483 302 211],524,5,22716,4.392111368909513,20.0,20.0
15172,1,5172,[127 187 483 302 211],328,5,22721,4.392228880726851,20.0,20.0
15173,1,5173,[ 98 546 294 100 132],749,2,22723,4.391766524932354,0.0,40.0
15174,1,5174,[127 187 483 302 211],666,5,22728,4.391884057971015,20.0,20.0
15175,1,5175,[127 187 483 302 211],328,5,22733,4.392001545595054,20.0,20.0
15176,1,5176,[186 180 135 211   7],95,2,22735,4.391539501641877,0.0,0.0
15177,1,5177,[186 475 222  79 121],339,4,22739,4.391463885670143,0.0,0.0
15178,1,5178,[127 187 483 302 211],537,5,22744,4.391581386368025,20.0,20.0
15179,1,5179,[127 187 483 302 211],6,5,22749,4.391698841698842,20.0,20.0
15180,1,5180,[127 187 483 302 211],524,5,22754,4.391816251688863,20.0,20.0
15181,1,5181,[176   7 132   1 196],380,3,22757,4.391547664994211,0.0,0.0
15182,1,5182,[127 187 483 302 211],666,5,22762,4.391665058846228,20.0,20.0
15183,1,5183,[127 187 483 302 211],537,5,22767,4.391782407407407,20.0,20.0
15184,1,5184,[234 216  69 153 435],899,3,22770,4.391513982642238,0.0,0.0
15185,1,5185,[127 187 483 302 211],524,5,22775,4.391631315079059,20.0,20.0
15186,1,5186,[127 187 483 302 211],537,5,22780,4.391748602274918,20.0,20.0
15187,1,5187,[127 187 483 302 211],537,5,22785,4.3918658442559755,20.0,20.0
15188,1,5188,[127 187 483 302 211],474,5,22790,4.391983041048372,20.0,20.0
15189,1,5189,[151 143  69  98 180],339,5,22795,4.392100192678227,0.0,20.0
15190,1,5190,[127 187 483 302 211],90,5,22800,4.3922172991716435,20.0,20.0
15191,1,5191,[127 187 483 302 211],328,5,22805,4.3923343605547,20.0,20.0
15192,1,5192,[127 187 483 302 211],833,3,22808,4.39206624301945,20.0,20.0
15193,1,5193,[132 143 423 172 300],537,0,22808,4.391220639199076,0.0,0.0
15194,1,5194,[127 187 483 302 211],339,5,22813,4.391337824831568,20.0,20.0
15195,1,5195,[127 187 483 302 211],207,5,22818,4.391454965357967,20.0,20.0
15196,1,5196,[127 187 483 302 211],6,5,22823,4.39157206080431,20.0,20.0
15197,1,5197,[127 187 483 302 211],666,5,22828,4.391689111196614,20.0,20.0
15198,1,5198,[127 187 483 302 211],13,5,22833,4.391806116560877,20.0,20.0
15199,1,5199,[127 187 483 302 211],339,5,22838,4.391923076923077,20.0,20.0
15200,1,5200,[127 187 483 302 211],328,5,22843,4.392039992309171,20.0,20.0
15201,1,5201,[301  89   9  96 153],328,3,22846,4.391772395232603,0.0,0.0
15202,1,5202,[127 187 483 302 211],90,5,22851,4.391889294637709,20.0,20.0
15203,1,5203,[127 187 483 302 211],537,5,22856,4.392006149116065,20.0,20.0
15204,1,5204,[127 187 483 302 211],207,5,22861,4.392122958693564,20.0,20.0
15205,1,5205,[127 187 483 302 211],210,5,22866,4.392239723396082,20.0,20.0
15206,1,5206,[127 187 483 302 211],328,5,22871,4.392356443249472,20.0,20.0
15207,1,5207,[127 187 483 302 211],207,5,22876,4.39247311827957,20.0,20.0
15208,1,5208,[127 187 483 302 211],537,5,22881,4.39258974851219,20.0,20.0
15209,1,5209,[127 187 483 302 211],13,5,22886,4.392706333973129,20.0,20.0
15210,1,5210,[127 187 483 302 211],524,5,22891,4.39282287468816,20.0,20.0
15211,1,5211,[127 187 483 302 211],207,5,22896,4.392939370683039,20.0,20.0
15212,1,5212,[268 202 655 471 234],234,1,22897,4.392288509495492,0.0,0.0
15213,1,5213,[127 187 483 302 211],666,5,22902,4.3924050632911396,20.0,20.0
15214,1,5214,[300  98 204 200 153],788,3,22905,4.392138063279003,0.0,20.0
15215,1,5215,[161  96 245  79 195],749,4,22909,4.392062883435583,0.0,0.0
15216,1,5216,[127 187 483 302 211],207,5,22914,4.3921794134560095,20.0,20.0
15217,1,5217,[127 187 483 302 211],90,5,22919,4.392295898811805,20.0,20.0
15218,1,5218,[174  28 288  69 222],554,4,22923,4.392220731940985,0.0,20.0
15219,1,5219,[127 187 483 302 211],90,5,22928,4.392337164750958,20.0,20.0
15220,1,5220,[183  79 483 294  71],311,5,22933,4.3924535529592035,20.0,0.0
15221,1,5221,[127 187 483 302 211],6,5,22938,4.392569896591344,20.0,20.0
15222,1,5222,[127 187 483 302 211],90,5,22943,4.392686195672985,20.0,20.0
15223,1,5223,[127 187 483 302 211],833,3,22946,4.392419601837672,20.0,20.0
15224,1,5224,[127 187 483 302 211],210,5,22951,4.392535885167464,20.0,20.0
15225,1,5225,[127 187 483 302 211],207,5,22956,4.392652123995408,20.0,20.0
15226,1,5226,[  4 234  89 187 186],664,4,22960,4.392577004017601,0.0,0.0
15227,1,5227,[127 187 483 302 211],524,5,22965,4.392693190512625,20.0,20.0
15228,1,5228,[127 187 483 302 211],207,5,22970,4.392809332568369,20.0,20.0
15229,1,5229,[132 288 237 185 196],334,3,22973,4.3925430210325045,0.0,0.0
15230,1,5230,[127 187 483 302 211],13,5,22978,4.392659147390557,20.0,20.0
15231,1,5231,[127 187 483 302 211],474,5,22983,4.392775229357798,20.0,20.0
15232,1,5232,[127 187 483 302 211],524,5,22988,4.392891266959679,20.0,20.0
15233,1,5233,[132 195  79 187 238],85,2,22990,4.392434084829958,0.0,0.0
15234,1,5234,[127 187 483 302 211],13,5,22995,4.392550143266476,20.0,20.0
15235,1,5235,[127 187 483 302 211],666,5,23000,4.39266615737204,20.0,20.0
15236,1,5236,[127 187 483 302 211],13,5,23005,4.392782127172045,20.0,20.0
15237,1,5237,[127 187 483 302 211],13,5,23010,4.3928980526918675,20.0,20.0
15238,1,5238,[127 187 483 302 211],328,5,23015,4.393013933956862,20.0,20.0
15239,1,5239,[ 70 258 185 515  22],7,3,23018,4.392748091603053,0.0,0.0
15240,1,5240,[127 187 483 302 211],474,5,23023,4.392863957260065,20.0,20.0
15241,1,5241,[546 174 403 276 183],346,3,23026,4.392598244944677,0.0,20.0
15242,1,5242,[127 187 483 302 211],339,5,23031,4.392714094983788,20.0,20.0
15243,1,5243,[127 187 483 302 211],524,5,23036,4.392829900839054,20.0,20.0
15244,1,5244,[127 187 483 302 211],524,5,23041,4.392945662535748,20.0,20.0
15245,1,5245,[127 187 483 302 211],524,5,23046,4.393061380099123,20.0,20.0
15246,1,5246,[127 187 483 302 211],343,5,23051,4.393177053554412,20.0,20.0
15247,1,5247,[127 187 483 302 211],328,5,23056,4.3932926829268295,20.0,20.0
15248,1,5248,[127 187 483 302 211],474,5,23061,4.393408268241569,20.0,20.0
15249,1,5249,[127 187 483 302 211],474,5,23066,4.39352380952381,20.0,20.0
15250,1,5250,[127 187 483 302 211],666,5,23071,4.393639306798705,20.0,20.0
15251,1,5251,[127 187 483 302 211],6,5,23076,4.393754760091394,20.0,20.0
15252,1,5252,[127 187 483 302 211],90,5,23081,4.393870169426994,20.0,20.0
15253,1,5253,[143 180 151 546 204],897,5,23086,4.393985534830605,0.0,0.0
15254,1,5254,[127 187 483 302 211],328,5,23091,4.394100856327308,20.0,20.0
15255,1,5255,[127 187 483 302 211],90,5,23096,4.3942161339421615,20.0,20.0
15256,1,5256,[127 187 483 302 211],13,5,23101,4.394331367700209,20.0,20.0
15257,1,5257,[ 69  88 403  82 655],42,3,23104,4.394066184861164,0.0,0.0
15258,1,5258,[435  98  11  64 143],537,0,23104,4.39323065221525,0.0,20.0
15259,1,5259,[127 187 483 302 211],537,5,23109,4.3933460076045625,20.0,20.0
15260,1,5260,[127 187 483 302 211],339,5,23114,4.393461319140847,20.0,20.0
15261,1,5261,[275 191  25 100 435],533,5,23119,4.393576586849107,0.0,20.0
15262,1,5262,[127 187 483 302 211],13,5,23124,4.393691810754323,20.0,20.0
15263,1,5263,[127 187 483 302 211],524,5,23129,4.393806990881459,20.0,20.0
15264,1,5264,[127 187 483 302 211],328,5,23134,4.39392212725546,20.0,20.0
15265,1,5265,[127 187 483 302 211],328,5,23139,4.394037219901254,20.0,20.0
15266,1,5266,[127 187 483 302 211],833,3,23142,4.39377254604139,20.0,20.0
15267,1,5267,[127 187 483 302 211],339,5,23147,4.393887623386484,20.0,20.0
15268,1,5268,[127 187 483 302 211],328,5,23152,4.394002657050674,20.0,20.0
15269,1,5269,[127 187 483 302 211],339,5,23157,4.394117647058824,20.0,20.0
15270,1,5270,[127 187 483 302 211],833,3,23160,4.393853158793398,20.0,20.0
15271,1,5271,[127 187 483 302 211],666,5,23165,4.39396813353566,20.0,20.0
15272,1,5272,[435 180 174 197 748],881,2,23167,4.3935141285795565,0.0,20.0
15273,1,5273,[127 187 483 302 211],210,5,23172,4.39362912400455,20.0,20.0
15274,1,5274,[655  82 588 282  64],311,5,23177,4.3937440758293835,0.0,0.0
15275,1,5275,[475   1  12 568  71],533,4,23181,4.393669446550417,20.0,0.0
15276,1,5276,[202 151  96  82 117],313,3,23184,4.393405343945424,0.0,0.0
15277,1,5277,[496 153 318  64 237],313,3,23187,4.393141341417204,20.0,0.0
15278,1,5278,[127 187 483 302 211],328,5,23192,4.393256298541391,20.0,20.0
15279,1,5279,[127 187 483 302 211],537,5,23197,4.393371212121212,20.0,20.0
15280,1,5280,[127 187 483 302 211],474,5,23202,4.393486082181405,20.0,20.0
15281,1,5281,[127 187 483 302 211],474,5,23207,4.393600908746687,20.0,20.0
15282,1,5282,[ 56 483 234 385 268],234,2,23209,4.393147832670831,20.0,0.0
15283,1,5283,[127 187 483 302 211],339,5,23214,4.393262679788039,20.0,20.0
15284,1,5284,[127 187 483 302 211],833,3,23217,4.392999053926206,20.0,20.0
15285,1,5285,[127 187 483 302 211],343,5,23222,4.393113885735906,20.0,20.0
15286,1,5286,[127 187 483 302 211],13,5,23227,4.3932286741062985,20.0,20.0
15287,1,5287,[127 187 483 302 211],666,5,23232,4.3933434190620275,20.0,20.0
15288,1,5288,[127 187 483 302 211],90,5,23237,4.393458120627718,20.0,20.0
15289,1,5289,[127 187 483 302 211],13,5,23242,4.393572778827977,20.0,20.0
15290,1,5290,[127 187 483 302 211],210,5,23247,4.393687393687394,20.0,20.0
15291,1,5291,[216 182 210  96 237],406,3,23250,4.393424036281179,0.0,0.0
15292,1,5292,[127 187 483 302 211],6,5,23255,4.393538635934253,20.0,20.0
15293,1,5293,[127 187 483 302 211],537,5,23260,4.393653192293162,20.0,20.0
15294,1,5294,[127 187 483 302 211],207,5,23265,4.393767705382436,20.0,20.0
15295,1,5295,[234 211 135 197 742],650,4,23269,4.39369335347432,0.0,0.0
15296,1,5296,[ 96 117 245  89 323],200,3,23272,4.393430243534076,0.0,0.0
15297,1,5297,[127 187 483 302 211],537,5,23277,4.393544733861835,20.0,20.0
15298,1,5298,[127 187 483 302 211],524,5,23282,4.393659180977543,20.0,20.0
15299,1,5299,[127 187 483 302 211],13,5,23287,4.39377358490566,20.0,20.0
15300,1,5300,[127 187 483 302 211],6,5,23292,4.393887945670628,20.0,20.0
15301,1,5301,[127 187 483 302 211],339,5,23297,4.394002263296869,20.0,20.0
15302,1,5302,[127 187 483 302 211],210,5,23302,4.394116537808787,20.0,20.0
15303,1,5303,[471 144 258 435 173],234,0,23302,4.393288084464555,0.0,0.0
15304,1,5304,[191 196 176  70  12],455,2,23304,4.392836946277097,20.0,0.0
15305,1,5305,[238 318 161 423 187],7,4,23308,4.392762909913306,20.0,0.0
15306,1,5306,[127 187 483 302 211],474,5,23313,4.392877331825891,20.0,20.0
15307,1,5307,[ 89   4 186 173 181],7,4,23317,4.392803315749812,0.0,0.0
15308,1,5308,[127 187 483 302 211],207,5,23322,4.392917686946694,20.0,20.0
15309,1,5309,[127 187 483 302 211],210,5,23327,4.393032015065914,20.0,20.0
15310,1,5310,[127 187 483 302 211],339,5,23332,4.393146300131802,20.0,20.0
15311,1,5311,[127 187 483 302 211],474,5,23337,4.393260542168675,20.0,20.0
15312,1,5312,[  9  96 202 318 237],64,5,23342,4.393374741200828,20.0,0.0
15313,1,5313,[228  69 385 168  98],850,4,23346,4.393300715092209,0.0,20.0
15314,1,5314,[191 286 176 655 318],13,1,23347,4.392662276575729,20.0,0.0
15315,1,5315,[121 180 185 405 655],881,5,23352,4.3927765237020315,0.0,0.0
15316,1,5316,[127 187 483 302 211],474,5,23357,4.392890727854053,20.0,20.0
15317,1,5317,[ 70 427 403 475 132],334,3,23360,4.39262880782249,0.0,0.0
15318,1,5318,[127 187 483 302 211],328,5,23365,4.392742996803911,20.0,20.0
15319,1,5319,[127 187 483 302 211],666,5,23370,4.392857142857143,20.0,20.0
15320,1,5320,[127 187 483 302 211],210,5,23375,4.39297124600639,20.0,20.0
15321,1,5321,[127 187 483 302 211],474,5,23380,4.393085306275836,20.0,20.0
15322,1,5322,[127 187 483 302 211],343,5,23385,4.3931993236896485,20.0,20.0
15323,1,5323,[127 187 483 302 211],90,5,23390,4.393313298271976,20.0,20.0
15324,1,5324,[127 187 483 302 211],666,5,23395,4.393427230046949,20.0,20.0
15325,1,5325,[127 187 483 302 211],666,5,23400,4.393541119038678,20.0,20.0
15326,1,5326,[127 187 483 302 211],210,5,23405,4.39365496527126,20.0,20.0
15327,1,5327,[127 187 483 302 211],328,5,23410,4.393768768768769,20.0,20.0
15328,1,5328,[127 187 483 302 211],343,5,23415,4.393882529555263,20.0,20.0
15329,1,5329,[127 187 483 302 211],537,5,23420,4.393996247654784,20.0,20.0
15330,1,5330,[ 97  12 302 196 222],380,3,23423,4.393734758957044,20.0,0.0
15331,1,5331,[127 187 483 302 211],207,5,23428,4.393848462115529,20.0,20.0
15332,1,5332,[176 100  79 153 318],883,5,23433,4.393962122632664,20.0,20.0
15333,1,5333,[127 187 483 302 211],343,5,23438,4.3940757405324335,20.0,20.0
15334,1,5334,[127 187 483 302 211],343,5,23443,4.3941893158388,20.0,20.0
15335,1,5335,[127 187 483 302 211],343,5,23448,4.3943028485757125,20.0,20.0
15336,1,5336,[318   9  11   8 275],328,3,23451,4.394041596402474,20.0,0.0
15337,1,5337,[127 187 483 302 211],328,5,23456,4.3941551142750095,20.0,20.0
15338,1,5338,[127 187 483 302 211],210,5,23461,4.394268589623525,20.0,20.0
15339,1,5339,[127 187 483 302 211],207,5,23466,4.39438202247191,20.0,20.0
15340,1,5340,[127 187 483 302 211],833,3,23469,4.394120951132747,20.0,20.0
15341,1,5341,[127 187 483 302 211],666,5,23474,4.394234369150131,20.0,20.0
15342,1,5342,[127 187 483 302 211],524,5,23479,4.394347744712708,20.0,20.0
15343,1,5343,[ 22 174  64   9 603],474,5,23484,4.394461077844311,20.0,20.0
15344,1,5344,[237  69 655  56 196],804,4,23488,4.394387277829748,0.0,0.0
15345,1,5345,[ 28  98 435 403 655],378,5,23493,4.394500561167228,0.0,20.0
15346,1,5346,[127 187 483 302 211],207,5,23498,4.394613802132037,20.0,20.0
15347,1,5347,[127 187 483 302 211],90,5,23503,4.3947270007479435,20.0,20.0
15348,1,5348,[127 187 483 302 211],210,5,23508,4.394840157038699,20.0,20.0
15349,1,5349,[194 515 222 271 215],13,2,23510,4.394392523364486,0.0,0.0
15350,1,5350,[403  79 153 245 742],328,3,23513,4.394131937955522,0.0,0.0
15351,1,5351,[174  12   7 191 168],474,4,23517,4.3940582959641254,20.0,20.0
15352,1,5352,[127 187 483 302 211],339,5,23522,4.39417149262096,20.0,20.0
15353,1,5353,[215  69 204 405 423],378,3,23525,4.393911094508779,0.0,0.0
15354,1,5354,[172 144 655   7 202],308,4,23529,4.393837535014006,0.0,0.0
15355,1,5355,[127 187 483 302 211],666,5,23534,4.39395070948469,20.0,20.0
15356,1,5356,[  8 322  79  82 185],207,2,23536,4.393503826768714,0.0,0.0
15357,1,5357,[127 187 483 302 211],339,5,23541,4.3936170212765955,20.0,20.0
15358,1,5358,[385 286 238 100 202],666,4,23545,4.3935435715618585,0.0,20.0
15359,1,5359,[127 187 483 302 211],474,5,23550,4.393656716417911,20.0,20.0
15360,1,5360,[127 187 483 302 211],207,5,23555,4.393769819063608,20.0,20.0
15361,1,5361,[118 423 175 185 196],840,4,23559,4.393696381947034,0.0,0.0
15362,1,5362,[ 12  97  22 181 121],194,2,23561,4.3932500466157,20.0,0.0
15363,1,5363,[  9 185 161 191   4],13,2,23563,4.392803877703207,0.0,0.0
15364,1,5364,[127 187 483 302 211],537,5,23568,4.392917054986021,20.0,20.0
15365,1,5365,[127 187 483 302 211],339,5,23573,4.393030190085725,20.0,20.0
15366,1,5366,[127 187 483 302 211],339,5,23578,4.393143283025899,20.0,20.0
15367,1,5367,[302 153 168 196 118],666,3,23581,4.392883755588674,0.0,0.0
15368,1,5368,[ 89 237 197 172  56],59,4,23585,4.3928105792512575,0.0,0.0
15369,1,5369,[127 187 483 302 211],90,5,23590,4.39292364990689,20.0,20.0
15370,1,5370,[127 187 483 302 211],537,5,23595,4.393036678458388,20.0,20.0
15371,1,5371,[127 187 483 302 211],210,5,23600,4.393149664929263,20.0,20.0
15372,1,5372,[127 187 483 302 211],343,5,23605,4.393262609343012,20.0,20.0
15373,1,5373,[127 187 483 302 211],207,5,23610,4.393375511723112,20.0,20.0
15374,1,5374,[127 187 483 302 211],210,5,23615,4.393488372093024,20.0,20.0
15375,1,5375,[127 187 483 302 211],474,5,23620,4.393601190476191,20.0,20.0
15376,1,5376,[181  79 742  28 121],795,2,23622,4.393156034963734,0.0,0.0
15377,1,5377,[186 118  98  95 222],650,4,23626,4.393082930457419,0.0,20.0
15378,1,5378,[127 187 483 302 211],328,5,23631,4.393195761293921,20.0,20.0
15379,1,5379,[127 187 483 302 211],343,5,23636,4.393308550185874,20.0,20.0
15380,1,5380,[127 187 483 302 211],210,5,23641,4.393421297156662,20.0,20.0
15381,1,5381,[194  28 238 258 121],666,2,23643,4.392976588628763,0.0,0.0
15382,1,5382,[127 187 483 302 211],524,5,23648,4.393089355378042,20.0,20.0
15383,1,5383,[183 182 173 200 176],749,4,23652,4.393016344725112,0.0,0.0
15384,1,5384,[127 187 483 302 211],666,5,23657,4.393129062209842,20.0,20.0
15385,1,5385,[153 151  97 678 269],339,4,23661,4.393056071295953,0.0,0.0
15386,1,5386,[127 187 483 302 211],474,5,23666,4.393168739558195,20.0,20.0
15387,1,5387,[127 187 483 302 211],524,5,23671,4.393281365998515,20.0,20.0
15388,1,5388,[127 187 483 302 211],537,5,23676,4.393393950640193,20.0,20.0
15389,1,5389,[127 187 483 302 211],328,5,23681,4.393506493506494,20.0,20.0
15390,1,5390,[127 187 483 302 211],13,5,23686,4.393618994620664,20.0,20.0
15391,1,5391,[127 187 483 302 211],90,5,23691,4.393731454005935,20.0,20.0
15392,1,5392,[257 183 471 196 121],95,5,23696,4.393843871685518,0.0,0.0
15393,1,5393,[748 228 191   1 175],313,3,23699,4.39358546533185,0.0,0.0
15394,1,5394,[127 187 483 302 211],343,5,23704,4.393697868396663,20.0,20.0
15395,1,5395,[127 187 483 302 211],210,5,23709,4.393810229799851,20.0,20.0
15396,1,5396,[127 187 483 302 211],90,5,23714,4.393922549564573,20.0,20.0
15397,1,5397,[127 187 483 302 211],13,5,23719,4.394034827713968,20.0,20.0
15398,1,5398,[ 12 196 195 268  97],7,4,23723,4.393961844786071,20.0,0.0
15399,1,5399,[127 187 483 302 211],343,5,23728,4.394074074074074,20.0,20.0
15400,1,5400,[127 187 483 302 211],833,3,23731,4.393815960007406,20.0,20.0
15401,1,5401,[597 211 385  79 176],279,3,23734,4.393557941503147,0.0,0.0
15402,1,5402,[127 187 483 302 211],13,5,23739,4.393670183231538,20.0,20.0
15403,1,5403,[127 187 483 302 211],343,5,23744,4.393782383419689,20.0,20.0
15404,1,5404,[127 187 483 302 211],833,3,23747,4.3935245143385755,20.0,20.0
15405,1,5405,[127 187 483 302 211],90,5,23752,4.393636699963004,20.0,20.0
15406,1,5406,[125 318  96 176 258],533,4,23756,4.393563898649898,20.0,0.0
15407,1,5407,[127 187 483 302 211],210,5,23761,4.393676035502959,20.0,20.0
15408,1,5408,[127 187 483 302 211],90,5,23766,4.393788130892956,20.0,20.0
15409,1,5409,[748 269 143 471  56],524,3,23769,4.393530499075785,0.0,0.0
15410,1,5410,[357  89 289 196 302],454,1,23770,4.392903345037886,20.0,0.0
15411,1,5411,[127 187 483 302 211],6,5,23775,4.393015521064301,20.0,20.0
15412,1,5412,[127 187 483 302 211],339,5,23780,4.393127655643821,20.0,20.0
15413,1,5413,[127 187 483 302 211],666,5,23785,4.393239748799409,20.0,20.0
15414,1,5414,[127 187 483 302 211],207,5,23790,4.393351800554017,20.0,20.0
15415,1,5415,[286 183 385 127 181],666,3,23793,4.393094534711965,0.0,20.0
15416,1,5416,[127 187 483 302 211],328,5,23798,4.393206571903267,20.0,20.0
15417,1,5417,[127 187 483 302 211],328,5,23803,4.393318567737173,20.0,20.0
15418,1,5418,[127 187 483 302 211],343,5,23808,4.393430522236575,20.0,20.0
15419,1,5419,[127 187 483 302 211],328,5,23813,4.393542435424354,20.0,20.0
15420,1,5420,[127 187 483 302 211],343,5,23818,4.393654307323372,20.0,20.0
15421,1,5421,[204 197   4 515 405],804,5,23823,4.393766137956473,0.0,0.0
15422,1,5422,[127 187 483 302 211],833,3,23826,4.393509127789047,20.0,20.0
15423,1,5423,[ 15 161 183 211 176],474,5,23831,4.3936209439528024,0.0,0.0
15424,1,5424,[127 187 483 302 211],833,3,23834,4.393364055299539,20.0,20.0
15425,1,5425,[127 187 483 302 211],210,5,23839,4.393475856984888,20.0,20.0
15426,1,5426,[301 204  89 258 179],378,3,23842,4.393219089736503,0.0,0.0
15427,1,5427,[127 187 483 302 211],833,3,23845,4.392962417096537,20.0,20.0
15428,1,5428,[127 187 483 302 211],339,5,23850,4.393074230981765,20.0,20.0
15429,1,5429,[127 187 483 302 211],666,5,23855,4.393186003683241,20.0,20.0
15430,1,5430,[222 245  11 187 216],653,2,23857,4.392745350764132,0.0,0.0
15431,1,5431,[196 300 172 237 275],271,4,23861,4.392673048600884,0.0,0.0
15432,1,5432,[125   1 216 237 176],313,3,23864,4.39241671268176,0.0,0.0
15433,1,5433,[127 187 483 302 211],13,5,23869,4.392528524107472,20.0,20.0
15434,1,5434,[127 187 483 302 211],90,5,23874,4.392640294388224,20.0,20.0
15435,1,5435,[195 197 323 132  95],454,2,23876,4.392200147167035,0.0,0.0
15436,1,5436,[385 125  25  95 186],59,3,23879,4.391944086812581,0.0,0.0
15437,1,5437,[127 187 483 302 211],537,5,23884,4.39205590290548,20.0,20.0
15438,1,5438,[276  64  70 183 357],881,4,23888,4.391983820555249,20.0,0.0
15439,1,5439,[100 237 427 197 238],334,5,23893,4.392095588235295,0.0,20.0
15440,1,5440,[127 187 483 302 211],90,5,23898,4.392207314831833,20.0,20.0
15441,1,5441,[127 187 483 302 211],13,5,23903,4.392319000367512,20.0,20.0
15442,1,5442,[127 187 483 302 211],833,3,23906,4.3920632004409335,20.0,20.0
15443,1,5443,[127 187 483 302 211],666,5,23911,4.392174871418075,20.0,20.0
15444,1,5444,[ 96 322  22  28 100],263,3,23914,4.391919191919192,0.0,20.0
15445,1,5445,[127 187 483 302 211],90,5,23919,4.392030848329049,20.0,20.0
15446,1,5446,[127 187 483 302 211],474,5,23924,4.392142463741509,20.0,20.0
15447,1,5447,[144 187 238  97 173],840,2,23926,4.391703377386197,0.0,0.0
15448,1,5448,[127 187 483 302 211],474,5,23931,4.391815011928794,20.0,20.0
15449,1,5449,[127 187 483 302 211],339,5,23936,4.391926605504588,20.0,20.0
15450,1,5450,[127 187 483 302 211],666,5,23941,4.392038158136121,20.0,20.0
15451,1,5451,[228 435 121 403 496],295,5,23946,4.392149669845928,0.0,0.0
15452,1,5452,[ 64  50  28 202 258],378,4,23950,4.39207775536402,0.0,20.0
15453,1,5453,[196  96  56 748 257],533,3,23953,4.391822515584892,0.0,0.0
15454,1,5454,[127 187 483 302 211],13,5,23958,4.391934005499541,20.0,20.0
15455,1,5455,[127 187 483 302 211],207,5,23963,4.392045454545454,20.0,20.0
15456,1,5456,[127 187 483 302 211],666,5,23968,4.392156862745098,20.0,20.0
15457,1,5457,[127 187 483 302 211],524,5,23973,4.392268230120924,20.0,20.0
15458,1,5458,[204 186 597  70   8],378,3,23976,4.392013189228797,0.0,0.0
15459,1,5459,[127 187 483 302 211],474,5,23981,4.3921245421245425,20.0,20.0
15460,1,5460,[127 187 483 302 211],13,5,23986,4.39223585423915,20.0,20.0
15461,1,5461,[127 187 483 302 211],6,5,23991,4.39234712559502,20.0,20.0
15462,1,5462,[127 187 483 302 211],537,5,23996,4.392458356214534,20.0,20.0
15463,1,5463,[202 748 403 186 323],648,4,24000,4.392386530014641,0.0,0.0
15464,1,5464,[127 187 483 302 211],343,5,24005,4.392497712717292,20.0,20.0
15465,1,5465,[588 176 210  22  79],892,5,24010,4.392608854738382,0.0,0.0
15466,1,5466,[403 204  79 143 194],524,3,24013,4.392354124748491,0.0,0.0
15467,1,5467,[127 187 483 302 211],666,5,24018,4.392465252377469,20.0,20.0
15468,1,5468,[127 187 483 302 211],537,5,24023,4.392576339367343,20.0,20.0
15469,1,5469,[127 187 483 302 211],474,5,24028,4.392687385740402,20.0,20.0
15470,1,5470,[127 187 483 302 211],328,5,24033,4.392798391518918,20.0,20.0
15471,1,5471,[127 187 483 302 211],6,5,24038,4.392909356725146,20.0,20.0
15472,1,5472,[127 187 483 302 211],343,5,24043,4.393020281381326,20.0,20.0
15473,1,5473,[127 187 483 302 211],6,5,24048,4.393131165509682,20.0,20.0
15474,1,5474,[588 176 204 568  50],897,5,24053,4.39324200913242,0.0,20.0
15475,1,5475,[127 187 483 302 211],666,5,24058,4.393352812271731,20.0,20.0
15476,1,5476,[127 187 483 302 211],537,5,24063,4.39346357494979,20.0,20.0
15477,1,5477,[127 187 483 302 211],90,5,24068,4.393574297188755,20.0,20.0
15478,1,5478,[271  96 588 215 322],263,2,24070,4.393137433838292,0.0,0.0
15479,1,5479,[127 187 483 302 211],833,3,24073,4.392883211678832,20.0,20.0
15480,1,5480,[127 187 483 302 211],537,5,24078,4.392993979200876,20.0,20.0
15481,1,5481,[127 187 483 302 211],207,5,24083,4.393104706311565,20.0,20.0
15482,1,5482,[127 187 483 302 211],524,5,24088,4.393215393033011,20.0,20.0
15483,1,5483,[127 187 483 302 211],537,5,24093,4.393326039387309,20.0,20.0
15484,1,5484,[191 204 195 603 483],804,5,24098,4.393436645396536,40.0,0.0
15485,1,5485,[127 187 483 302 211],474,5,24103,4.3935472110827565,20.0,20.0
15486,1,5486,[181  56 597 546 328],533,2,24105,4.3931109896118095,0.0,0.0
15487,1,5487,[127 187 483 302 211],343,5,24110,4.3932215743440235,20.0,20.0
15488,1,5488,[127 187 483 302 211],343,5,24115,4.393332118783021,20.0,20.0
15489,1,5489,[127 187 483 302 211],6,5,24120,4.39344262295082,20.0,20.0
15490,1,5490,[127 187 483 302 211],524,5,24125,4.393553086869423,20.0,20.0
15491,1,5491,[127 187 483 302 211],328,5,24130,4.393663510560816,20.0,20.0
15492,1,5492,[127 187 483 302 211],833,3,24133,4.393409794283634,20.0,20.0
15493,1,5493,[127  25  96 405 168],533,4,24137,4.393338187113215,0.0,20.0
15494,1,5494,[  4  64  70  25 161],455,2,24139,4.392902638762512,0.0,0.0
15495,1,5495,[127 187 483 302 211],524,5,24144,4.393013100436681,20.0,20.0
15496,1,5496,[127 187 483 302 211],474,5,24149,4.393123521921048,20.0,20.0
15497,1,5497,[127 187 483 302 211],339,5,24154,4.393233903237541,20.0,20.0
15498,1,5498,[127 187 483 302 211],210,5,24159,4.393344244408074,20.0,20.0
15499,1,5499,[127 187 483 302 211],537,5,24164,4.393454545454546,20.0,20.0
15500,1,5500,[127 187 483 302 211],90,5,24169,4.393564806398836,20.0,20.0
15501,1,5501,[127 187 483 302 211],6,5,24174,4.393675027262813,20.0,20.0
15502,1,5502,[127 187 483 302 211],524,5,24179,4.393785208068326,20.0,20.0
15503,1,5503,[127 187 483 302 211],210,5,24184,4.3938953488372094,20.0,20.0
15504,1,5504,[127 187 483 302 211],328,5,24189,4.394005449591281,20.0,20.0
15505,1,5505,[127 187 483 302 211],343,5,24194,4.394115510352343,20.0,20.0
15506,1,5506,[127 187 483 302 211],6,5,24199,4.394225531142182,20.0,20.0
15507,1,5507,[127 187 483 302 211],524,5,24204,4.394335511982571,20.0,20.0
15508,1,5508,[195 678 302 111  11],454,2,24206,4.393900889453621,0.0,0.0
15509,1,5509,[127 187 483 302 211],666,5,24211,4.394010889292196,20.0,20.0
15510,1,5510,[210  89 211 423  50],87,4,24215,4.393939393939394,0.0,20.0
15511,1,5511,[127 187 483 302 211],474,5,24220,4.394049346879536,20.0,20.0
15512,1,5512,[127 187 483 302 211],328,5,24225,4.394159259931072,20.0,20.0
15513,1,5513,[127 187 483 302 211],666,5,24230,4.3942691331157056,20.0,20.0
15514,1,5514,[127 187 483 302 211],210,5,24235,4.394378966455123,20.0,20.0
15515,1,5515,[127 187 483 302 211],666,5,24240,4.394488759970994,20.0,20.0
15516,1,5516,[127 187 483 302 211],524,5,24245,4.394598513684974,20.0,20.0
15517,1,5517,[127 187 483 302 211],13,5,24250,4.394708227618702,20.0,20.0
15518,1,5518,[127 187 483 302 211],474,5,24255,4.394817901793803,20.0,20.0
15519,1,5519,[181 294 483  89 172],666,2,24257,4.394384057971014,20.0,0.0
15520,1,5520,[127 187 483 302 211],328,5,24262,4.394493751132042,20.0,20.0
15521,1,5521,[127 187 483 302 211],343,5,24267,4.394603404563564,20.0,20.0
15522,1,5522,[127 187 483 302 211],666,5,24272,4.394713018287163,20.0,20.0
15523,1,5523,[127 187 483 302 211],6,5,24277,4.394822592324402,20.0,20.0
15524,1,5524,[176 210  11 742 302],271,3,24280,4.394570135746607,0.0,0.0
15525,1,5525,[127 187 483 302 211],474,5,24285,4.394679695982628,20.0,20.0
15526,1,5526,[127 187 483 302 211],207,5,24290,4.394789216573186,20.0,20.0
15527,1,5527,[127 187 483 302 211],537,5,24295,4.394898697539797,20.0,20.0
15528,1,5528,[127 187 483 302 211],666,5,24300,4.395008138903961,20.0,20.0
15529,1,5529,[200 135 508 568 183],92,3,24303,4.394755877034358,0.0,0.0
15530,1,5530,[127 187 483 302 211],328,5,24308,4.394865304646538,20.0,20.0
15531,1,5531,[127 187 483 302 211],210,5,24313,4.394974692697035,20.0,20.0
15532,1,5532,[127 187 483 302 211],537,5,24318,4.395084041207301,20.0,20.0
15533,1,5533,[127 187 483 302 211],339,5,24323,4.395193350198771,20.0,20.0
15534,1,5534,[ 25  70 235 275 111],648,3,24326,4.394941282746161,0.0,0.0
15535,1,5535,[546  69 234 271 588],536,2,24328,4.394508670520231,0.0,0.0
15536,1,5536,[127 187 483 302 211],339,5,24333,4.394618024200831,20.0,20.0
15537,1,5537,[127 187 483 302 211],339,5,24338,4.39472733838931,20.0,20.0
15538,1,5538,[127 187 483 302 211],666,5,24343,4.394836613107059,20.0,20.0
15539,1,5539,[127 187 483 302 211],833,3,24346,4.394584837545127,20.0,20.0
15540,1,5540,[127 187 483 302 211],666,5,24351,4.39469409853817,20.0,20.0
15541,1,5541,[127 187 483 302 211],90,5,24356,4.394803320101047,20.0,20.0
15542,1,5542,[127 187 483 302 211],328,5,24361,4.394912502255097,20.0,20.0
15543,1,5543,[318 568 475  88 403],533,3,24364,4.394660894660895,20.0,0.0
15544,1,5544,[127 187 483 302 211],343,5,24369,4.394770063119928,20.0,20.0
15545,1,5545,[127 187 483 302 211],343,5,24374,4.3948791922106025,20.0,20.0
15546,1,5546,[127 187 483 302 211],666,5,24379,4.39498828195421,20.0,20.0
15547,1,5547,[238 144 435 127 385],194,4,24383,4.394917087238644,0.0,20.0
15548,1,5548,[183 121 276 196 117],892,5,24388,4.395026130834385,0.0,0.0
15549,1,5549,[186 471 427 322 268],13,3,24391,4.394774774774775,0.0,0.0
15550,1,5550,[127 187 483 302 211],833,3,24394,4.394523509277608,20.0,20.0
15551,1,5551,[127 187 483 302 211],474,5,24399,4.394632564841499,20.0,20.0
15552,1,5552,[127 187 483 302 211],13,5,24404,4.3947415811273185,20.0,20.0
15553,1,5553,[100 151  96 423 121],64,3,24407,4.394490457328052,0.0,20.0
15554,1,5554,[127 187 483 302 211],207,5,24412,4.3945994599459945,20.0,20.0
15555,1,5555,[483 175 174 603  56],804,4,24416,4.394528437724982,40.0,20.0
15556,1,5556,[127 187 483 302 211],537,5,24421,4.3946373942774875,20.0,20.0
15557,1,5557,[127 187 483 302 211],343,5,24426,4.394746311622886,20.0,20.0
15558,1,5558,[127 187 483 302 211],666,5,24431,4.394855189782335,20.0,20.0
15559,1,5559,[215   9 496  82  56],7,4,24435,4.39478417266187,0.0,0.0
15560,1,5560,[127 187 483 302 211],474,5,24440,4.394893004855242,20.0,20.0
15561,1,5561,[127 187 483 302 211],90,5,24445,4.39500179791442,20.0,20.0
15562,1,5562,[127 187 483 302 211],666,5,24450,4.395110551860507,20.0,20.0
15563,1,5563,[127 187 483 302 211],210,5,24455,4.3952192667145935,20.0,20.0
15564,1,5564,[127 187 483 302 211],90,5,24460,4.395327942497754,20.0,20.0
15565,1,5565,[127 187 483 302 211],537,5,24465,4.3954365792310455,20.0,20.0
15566,1,5566,[127 187 483 302 211],13,5,24470,4.395545176935513,20.0,20.0
15567,1,5567,[127 187 483 302 211],6,5,24475,4.395653735632184,20.0,20.0
15568,1,5568,[127 187 483 302 211],13,5,24480,4.395762255342072,20.0,20.0
15569,1,5569,[181 405 568 427 204],85,2,24482,4.3953321364452425,0.0,0.0
15570,1,5570,[127 187 483 302 211],833,3,24485,4.3950816729492015,20.0,20.0
15571,1,5571,[127 187 483 302 211],328,5,24490,4.395190236898779,20.0,20.0
15572,1,5572,[127 187 483 302 211],339,5,24495,4.395298761887672,20.0,20.0
15573,1,5573,[127 187 483 302 211],537,5,24500,4.395407247936849,20.0,20.0
15574,1,5574,[127 187 483 302 211],537,5,24505,4.395515695067265,20.0,20.0
15575,1,5575,[127 187 483 302 211],207,5,24510,4.395624103299856,20.0,20.0
15576,1,5576,[127 187 483 302 211],524,5,24515,4.39573247265555,20.0,20.0
15577,1,5577,[127 187 483 302 211],207,5,24520,4.395840803155253,20.0,20.0
15578,1,5578,[127 187 483 302 211],339,5,24525,4.39594909481986,20.0,20.0
15579,1,5579,[195 435 143  71   7],7,4,24529,4.395878136200717,0.0,0.0
15580,1,5580,[127 187 483 302 211],833,3,24532,4.395628023651676,20.0,20.0
15581,1,5581,[127 187 483 302 211],328,5,24537,4.395736295234683,20.0,20.0
15582,1,5582,[127 187 483 302 211],474,5,24542,4.395844528031525,20.0,20.0
15583,1,5583,[127 187 483 302 211],343,5,24547,4.395952722063037,20.0,20.0
15584,1,5584,[127 187 483 302 211],833,3,24550,4.395702775290958,20.0,20.0
15585,1,5585,[127 187 483 302 211],343,5,24555,4.395810955961332,20.0,20.0
15586,1,5586,[127 187 483 302 211],524,5,24560,4.3959190979058524,20.0,20.0
15587,1,5587,[127 187 483 302 211],474,5,24565,4.396027201145311,20.0,20.0
15588,1,5588,[127 187 483 302 211],537,5,24570,4.396135265700483,20.0,20.0
15589,1,5589,[127 187 483 302 211],833,3,24573,4.395885509838998,20.0,20.0
15590,1,5590,[127 187 483 302 211],524,5,24578,4.395993561080307,20.0,20.0
15591,1,5591,[ 56  79 191  22 286],653,5,24583,4.396101573676681,0.0,0.0
15592,1,5592,[127 187 483 302 211],328,5,24588,4.396209547648847,20.0,20.0
15593,1,5593,[127 187 483 302 211],90,5,24593,4.396317483017519,20.0,20.0
15594,1,5594,[185 275 427 268 405],6,3,24596,4.396067917783736,0.0,0.0
15595,1,5595,[127 187 483 302 211],474,5,24601,4.3961758398856325,20.0,20.0
15596,1,5596,[127 187 483 302 211],524,5,24606,4.396283723423262,20.0,20.0
15597,1,5597,[127 187 483 302 211],6,5,24611,4.396391568417292,20.0,20.0
15598,1,5598,[127 187 483 302 211],90,5,24616,4.396499374888373,20.0,20.0
15599,1,5599,[127 187 483 302 211],207,5,24621,4.3966071428571425,20.0,20.0
15600,1,5600,[127 187 483 302 211],90,5,24626,4.396714872344225,20.0,20.0
15601,1,5601,[127 187 483 302 211],6,5,24631,4.3968225633702245,20.0,20.0
15602,1,5602,[127 187 483 302 211],339,5,24636,4.396930215955738,20.0,20.0
15603,1,5603,[127 187 483 302 211],210,5,24641,4.3970378301213415,20.0,20.0
15604,1,5604,[127 187 483 302 211],343,5,24646,4.3971454058876,20.0,20.0
15605,1,5605,[127 187 483 302 211],328,5,24651,4.397252943275062,20.0,20.0
15606,1,5606,[180 275 173  25  71],85,2,24653,4.396825396825397,0.0,0.0
15607,1,5607,[132 471 258  96 125],119,4,24657,4.396754636233951,0.0,0.0
15608,1,5608,[127 187 483 302 211],666,5,24662,4.396862185772865,20.0,20.0
15609,1,5609,[127 187 483 302 211],328,5,24667,4.3969696969696965,20.0,20.0
15610,1,5610,[127 187 483 302 211],13,5,24672,4.397077169844947,20.0,20.0
15611,1,5611,[127 187 483 302 211],474,5,24677,4.397184604419102,20.0,20.0
15612,1,5612,[222   1 175 475 288],479,3,24680,4.396935685016925,0.0,0.0
15613,1,5613,[127 187 483 302 211],833,3,24683,4.396686854292839,20.0,20.0
15614,1,5614,[127 187 483 302 211],328,5,24688,4.396794300979519,20.0,20.0
15615,1,5615,[127 187 483 302 211],339,5,24693,4.3969017094017095,20.0,20.0
15616,1,5616,[228 117  88  56   1],343,4,24697,4.396831048602457,0.0,0.0
15617,1,5617,[127 187 483 302 211],90,5,24702,4.396938412246351,20.0,20.0
15618,1,5618,[234 546 174  50   4],455,3,24705,4.396689802455953,0.0,40.0
15619,1,5619,[127 187 483 302 211],666,5,24710,4.396797153024911,20.0,20.0
15620,1,5620,[127 187 483 302 211],339,5,24715,4.396904465397616,20.0,20.0
15621,1,5621,[127 187 483 302 211],13,5,24720,4.397011739594451,20.0,20.0
15622,1,5622,[127 187 483 302 211],328,5,24725,4.397118975635782,20.0,20.0
15623,1,5623,[127 187 483 302 211],90,5,24730,4.397226173541963,20.0,20.0
15624,1,5624,[127 187 483 302 211],343,5,24735,4.397333333333333,20.0,20.0
15625,1,5625,[127 187 483 302 211],833,3,24738,4.397084962673302,20.0,20.0
15626,1,5626,[ 71   1  82 245 194],749,5,24743,4.397192109472187,0.0,0.0
15627,1,5627,[127 187 483 302 211],90,5,24748,4.397299218194741,20.0,20.0
15628,1,5628,[127 187 483 302 211],524,5,24753,4.397406288861254,20.0,20.0
15629,1,5629,[127 187 483 302 211],474,5,24758,4.397513321492007,20.0,20.0
15630,1,5630,[ 22 515 121 143 286],881,4,24762,4.397442727757059,0.0,0.0
15631,1,5631,[127 187 483 302 211],328,5,24767,4.397549715909091,20.0,20.0
15632,1,5632,[127 187 483 302 211],328,5,24772,4.397656666074916,20.0,20.0
15633,1,5633,[127 187 483 302 211],13,5,24777,4.39776357827476,20.0,20.0
15634,1,5634,[127 187 483 302 211],210,5,24782,4.397870452528838,20.0,20.0
15635,1,5635,[318 405 215 191 153],378,4,24786,4.397799858055358,20.0,0.0
15636,1,5636,[200 597 204  11 273],102,1,24787,4.397197090651056,0.0,0.0
15637,1,5637,[748 322 111  25 186],749,3,24790,4.39694927279177,0.0,0.0
15638,1,5638,[127 187 483 302 211],474,5,24795,4.397056215641071,20.0,20.0
15639,1,5639,[ 95 546   8  50 282],200,4,24799,4.396985815602837,0.0,20.0
15640,1,5640,[172   4  69 228 195],312,3,24802,4.3967381669916685,0.0,0.0
15641,1,5641,[127 187 483 302 211],343,5,24807,4.3968450903934775,20.0,20.0
15642,1,5642,[286 748   7 405 258],294,3,24810,4.396597554492291,0.0,0.0
15643,1,5643,[127 187 483 302 211],339,5,24815,4.396704464918497,20.0,20.0
15644,1,5644,[127 187 483 302 211],474,5,24820,4.396811337466785,20.0,20.0
15645,1,5645,[127 187 483 302 211],474,5,24825,4.39691817215728,20.0,20.0
15646,1,5646,[127 187 483 302 211],328,5,24830,4.3970249690100935,20.0,20.0
15647,1,5647,[127 187 483 302 211],6,5,24835,4.397131728045326,20.0,20.0
15648,1,5648,[127 187 483 302 211],833,3,24838,4.396884404319349,20.0,20.0
15649,1,5649,[127 187 483 302 211],666,5,24843,4.396991150442478,20.0,20.0
15650,1,5650,[127 187 483 302 211],6,5,24848,4.397097858786055,20.0,20.0
15651,1,5651,[127 187 483 302 211],339,5,24853,4.397204529370135,20.0,20.0
15652,1,5652,[127 187 483 302 211],474,5,24858,4.397311162214753,20.0,20.0
15653,1,5653,[127 187 483 302 211],833,3,24861,4.397064025468695,20.0,20.0
15654,1,5654,[127 187 483 302 211],6,5,24866,4.397170645446508,20.0,20.0
15655,1,5655,[127 187 483 302 211],474,5,24871,4.397277227722772,20.0,20.0
15656,1,5656,[127 187 483 302 211],537,5,24876,4.3973837723174825,20.0,20.0
15657,1,5657,[127 187 483 302 211],13,5,24881,4.3974902792506185,20.0,20.0
15658,1,5658,[216 269 403  98 423],650,3,24884,4.397243329210108,0.0,20.0
15659,1,5659,[496 385 204  79  22],200,5,24889,4.397349823321555,0.0,0.0
15660,1,5660,[127 187 483 302 211],90,5,24894,4.397456279809221,20.0,20.0
15661,1,5661,[127 187 483 302 211],474,5,24899,4.397562698693041,20.0,20.0
15662,1,5662,[127 187 483 302 211],833,3,24902,4.397315910294897,20.0,20.0
15663,1,5663,[127 187 483 302 211],6,5,24907,4.397422316384181,20.0,20.0
15664,1,5664,[127 187 483 302 211],6,5,24912,4.397528684907326,20.0,20.0
15665,1,5665,[127 187 483 302 211],6,5,24917,4.397635015884221,20.0,20.0
15666,1,5666,[168 179  89 235 132],334,3,24920,4.397388388918299,0.0,0.0
15667,1,5667,[127 187 483 302 211],343,5,24925,4.397494707127735,20.0,20.0
15668,1,5668,[127 187 483 302 211],210,5,24930,4.397600987828541,20.0,20.0
15669,1,5669,[121 269 313 508 276],378,5,24935,4.397707231040564,0.0,0.0
15670,1,5670,[127 187 483 302 211],207,5,24940,4.397813436783636,20.0,20.0
15671,1,5671,[258 508 183  79 175],537,3,24943,4.397566995768688,0.0,0.0
15672,1,5672,[127 187 483 302 211],524,5,24948,4.397673188789001,20.0,20.0
15673,1,5673,[127 187 483 302 211],210,5,24953,4.397779344377864,20.0,20.0
15674,1,5674,[127 187 483 302 211],537,5,24958,4.397885462555066,20.0,20.0
15675,1,5675,[127 187 483 302 211],524,5,24963,4.397991543340381,20.0,20.0
15676,1,5676,[127 187 483 302 211],343,5,24968,4.398097586753567,20.0,20.0
15677,1,5677,[ 22 202 235 475 100],537,2,24970,4.397675237759775,0.0,20.0
15678,1,5678,[127 187 483 302 211],666,5,24975,4.397781299524564,20.0,20.0
15679,1,5679,[127 187 483 302 211],339,5,24980,4.397887323943662,20.0,20.0
15680,1,5680,[127 187 483 302 211],210,5,24985,4.39799331103679,20.0,20.0
15681,1,5681,[127 187 483 302 211],524,5,24990,4.3980992608236535,20.0,20.0
15682,1,5682,[333   9  64 135 181],145,3,24993,4.397853246524723,0.0,0.0
15683,1,5683,[127 187 483 302 211],90,5,24998,4.3979591836734695,20.0,20.0
15684,1,5684,[127 187 483 302 211],833,3,25001,4.3977132805628845,20.0,20.0
15685,1,5685,[127 187 483 302 211],90,5,25006,4.397819205065072,20.0,20.0
15686,1,5686,[127 187 483 302 211],13,5,25011,4.397925092315808,20.0,20.0
15687,1,5687,[127 187 483 302 211],328,5,25016,4.3980309423347395,20.0,20.0
15688,1,5688,[127 187 483 302 211],328,5,25021,4.398136755141501,20.0,20.0
15689,1,5689,[127 187 483 302 211],474,5,25026,4.398242530755712,20.0,20.0
15690,1,5690,[127 187 483 302 211],666,5,25031,4.398348269196978,20.0,20.0
15691,1,5691,[127 187 483 302 211],474,5,25036,4.3984539704848915,20.0,20.0
15692,1,5692,[127 187 483 302 211],343,5,25041,4.398559634639031,20.0,20.0
15693,1,5693,[127 187 483 302 211],90,5,25046,4.3986652616789605,20.0,20.0
15694,1,5694,[127 187 483 302 211],328,5,25051,4.398770851624231,20.0,20.0
15695,1,5695,[127 187 483 302 211],90,5,25056,4.398876404494382,20.0,20.0
15696,1,5696,[127 187 483 302 211],210,5,25061,4.398981920308935,20.0,20.0
15697,1,5697,[183 168  98 172 655],387,4,25065,4.398911898911899,0.0,20.0
15698,1,5698,[127 187 483 302 211],524,5,25070,4.399017371468679,20.0,20.0
15699,1,5699,[127 187 483 302 211],13,5,25075,4.399122807017544,20.0,20.0
15700,1,5700,[234 210  88 215 161],653,2,25077,4.398701982108402,0.0,0.0
15701,1,5701,[127 187 483 302 211],343,5,25082,4.398807435987373,20.0,20.0
15702,1,5702,[117 100 286  98 471],194,2,25084,4.398386813957567,0.0,40.0
15703,1,5703,[127 187 483 302 211],339,5,25089,4.398492286115007,20.0,20.0
15704,1,5704,[127 187 483 302 211],666,5,25094,4.398597721297108,20.0,20.0
15705,1,5705,[127 187 483 302 211],328,5,25099,4.398703119523309,20.0,20.0
15706,1,5706,[127 187 483 302 211],207,5,25104,4.398808480813036,20.0,20.0
15707,1,5707,[197 403  28 179 195],339,3,25107,4.398563419761738,0.0,0.0
15708,1,5708,[127 187 483 302 211],833,3,25110,4.39831844456122,20.0,20.0
15709,1,5709,[323 151   1  64 127],59,4,25114,4.398248686514886,0.0,20.0
15710,1,5710,[127 187 483 302 211],339,5,25119,4.3983540535808086,20.0,20.0
15711,1,5711,[ 82 181 168 742 235],158,3,25122,4.398109243697479,0.0,0.0
15712,1,5712,[127 187 483 302 211],207,5,25127,4.398214598284614,20.0,20.0
15713,1,5713,[127 187 483 302 211],207,5,25132,4.3983199159958,20.0,20.0
15714,1,5714,[ 50   1  64 202 215],234,2,25134,4.397900262467192,0.0,20.0
15715,1,5715,[127 187 483 302 211],343,5,25139,4.398005598320504,20.0,20.0
15716,1,5716,[127 187 483 302 211],6,5,25144,4.398110897323771,20.0,20.0
15717,1,5717,[204  96 143 211  79],95,4,25148,4.398041273172438,0.0,0.0
15718,1,5718,[655 100 423 196 174],295,5,25153,4.398146529113482,0.0,40.0
15719,1,5719,[127 187 483 302 211],90,5,25158,4.398251748251749,20.0,20.0
15720,1,5720,[127 187 483 302 211],474,5,25163,4.398356930606537,20.0,20.0
15721,1,5721,[127 187 483 302 211],833,3,25166,4.398112548060118,20.0,20.0
15722,1,5722,[127 187 483 302 211],6,5,25171,4.3982177179800805,20.0,20.0
15723,1,5723,[127 187 483 302 211],524,5,25176,4.39832285115304,20.0,20.0
15724,1,5724,[127 187 483 302 211],343,5,25181,4.398427947598253,20.0,20.0
15725,1,5725,[127 187 483 302 211],328,5,25186,4.398533007334963,20.0,20.0
15726,1,5726,[ 50 197   1  98 427],194,4,25190,4.398463418892963,0.0,40.0
15727,1,5727,[127 187 483 302 211],339,5,25195,4.39856843575419,20.0,20.0
15728,1,5728,[ 28   8 286  70 742],95,5,25200,4.398673415953919,0.0,0.0
15729,1,5729,[127 187 483 302 211],343,5,25205,4.398778359511343,20.0,20.0
15730,1,5730,[127 187 483 302 211],343,5,25210,4.3988832664456465,20.0,20.0
15731,1,5731,[127 187 483 302 211],6,5,25215,4.398988136775994,20.0,20.0
15732,1,5732,[127 187 483 302 211],6,5,25220,4.399092970521542,20.0,20.0
15733,1,5733,[127 187 483 302 211],666,5,25225,4.3991977677014305,20.0,20.0
15734,1,5734,[127 187 483 302 211],90,5,25230,4.399302528334786,20.0,20.0
15735,1,5735,[127 187 483 302 211],90,5,25235,4.399407252440725,20.0,20.0
15736,1,5736,[127 187 483 302 211],6,5,25240,4.399511940038348,20.0,20.0
15737,1,5737,[127 187 483 302 211],474,5,25245,4.399616591146741,20.0,20.0
15738,1,5738,[127 187 483 302 211],524,5,25250,4.39972120578498,20.0,20.0
15739,1,5739,[127 187 483 302 211],524,5,25255,4.399825783972125,20.0,20.0
15740,1,5740,[222 328 546 322 288],294,4,25259,4.399756140045288,0.0,0.0
15741,1,5741,[127 187 483 302 211],210,5,25264,4.399860675722745,20.0,20.0
15742,1,5742,[127 187 483 302 211],90,5,25269,4.399965174995647,20.0,20.0
15743,1,5743,[ 12  28 151 302 237],537,1,25270,4.399373259052925,20.0,0.0
15744,1,5744,[265 403 483 151 197],536,2,25272,4.398955613577024,20.0,0.0
15745,1,5745,[127 187 483 302 211],328,5,25277,4.399060215802297,20.0,20.0
15746,1,5746,[546  71 143 161 179],897,4,25281,4.398990777797112,0.0,0.0
15747,1,5747,[127 187 483 302 211],90,5,25286,4.399095337508698,20.0,20.0
15748,1,5748,[127 187 483 302 211],90,5,25291,4.399199860845364,20.0,20.0
15749,1,5749,[483  71 143 245 234],452,1,25292,4.3986086956521735,20.0,0.0
15750,1,5750,[127 187 483 302 211],328,5,25297,4.398713267257868,20.0,20.0
15751,1,5751,[127 187 483 302 211],666,5,25302,4.398817802503477,20.0,20.0
15752,1,5752,[127 187 483 302 211],6,5,25307,4.3989223014079615,20.0,20.0
15753,1,5753,[127 187 483 302 211],90,5,25312,4.399026763990268,20.0,20.0
15754,1,5754,[127 187 483 302 211],13,5,25317,4.399131190269331,20.0,20.0
15755,1,5755,[127 187 483 302 211],210,5,25322,4.399235580264072,20.0,20.0
15756,1,5756,[127 187 483 302 211],13,5,25327,4.399339933993399,20.0,20.0
15757,1,5757,[127 187 483 302 211],207,5,25332,4.399444251476207,20.0,20.0
15758,1,5758,[ 50 568 385 258  69],387,2,25334,4.399027608959889,0.0,20.0
15759,1,5759,[172   7 405   1 144],378,4,25338,4.398958333333334,0.0,0.0
15760,1,5760,[127 187 483 302 211],90,5,25343,4.399062662732165,20.0,20.0
15761,1,5761,[127 187 483 302 211],210,5,25348,4.399166955918084,20.0,20.0
15762,1,5762,[127 187 483 302 211],833,3,25351,4.398924171438487,20.0,20.0
15763,1,5763,[ 69  97  12  96 318],533,4,25355,4.398854961832061,40.0,0.0
15764,1,5764,[127 187 483 302 211],90,5,25360,4.398959236773634,20.0,20.0
15765,1,5765,[168 286 427 174 176],385,1,25361,4.398369753728755,0.0,20.0
15766,1,5766,[127 187 483 302 211],339,5,25366,4.398474076642969,20.0,20.0
15767,1,5767,[127 187 483 302 211],210,5,25371,4.398578363384189,20.0,20.0
15768,1,5768,[127 187 483 302 211],207,5,25376,4.398682613971226,20.0,20.0
15769,1,5769,[204 168 211 238  50],833,1,25377,4.398093587521664,0.0,20.0
15770,1,5770,[483 186 423 269 678],13,3,25380,4.397851325593485,20.0,0.0
15771,1,5771,[127 187 483 302 211],13,5,25385,4.397955647955648,20.0,20.0
15772,1,5772,[ 22  64  89 121 742],881,5,25390,4.398059934176338,0.0,0.0
15773,1,5773,[127 187 483 302 211],833,3,25393,4.397817803948736,20.0,20.0
15774,1,5774,[127 187 483 302 211],13,5,25398,4.397922077922078,20.0,20.0
15775,1,5775,[127 187 483 302 211],90,5,25403,4.3980263157894735,20.0,20.0
15776,1,5776,[127 187 483 302 211],6,5,25408,4.3981305175696725,20.0,20.0
15777,1,5777,[127 187 483 302 211],328,5,25413,4.398234683281412,20.0,20.0
15778,1,5778,[127 187 483 302 211],6,5,25418,4.3983388129434156,20.0,20.0
15779,1,5779,[427 515   8 174 200],271,5,25423,4.398442906574394,0.0,20.0
15780,1,5780,[ 15 238 282  28 300],378,4,25427,4.3983739837398375,0.0,0.0
15781,1,5781,[127 187 483 302 211],90,5,25432,4.39847803528191,20.0,20.0
15782,1,5782,[127 187 483 302 211],524,5,25437,4.398582050838665,20.0,20.0
15783,1,5783,[127 187 483 302 211],343,5,25442,4.398686030428769,20.0,20.0
15784,1,5784,[127 187 483 302 211],666,5,25447,4.398789974070873,20.0,20.0
15785,1,5785,[181 121 168 200 483],897,2,25449,4.3983753888696855,20.0,0.0
15786,1,5786,[127 187 483 302 211],666,5,25454,4.398479350267841,20.0,20.0
15787,1,5787,[127 187 483 302 211],343,5,25459,4.398583275742916,20.0,20.0
15788,1,5788,[127 187 483 302 211],328,5,25464,4.398687165313525,20.0,20.0
15789,1,5789,[127 187 483 302 211],13,5,25469,4.398791018998273,20.0,20.0
15790,1,5790,[127 187 483 302 211],328,5,25474,4.3988948368157486,20.0,20.0
15791,1,5791,[ 64  96 265 135 211],7,5,25479,4.39899861878453,0.0,0.0
15792,1,5792,[127 187 483 302 211],328,5,25484,4.399102364923183,20.0,20.0
15793,1,5793,[127 187 483 302 211],537,5,25489,4.399206075250259,20.0,20.0
15794,1,5794,[127 187 483 302 211],537,5,25494,4.399309749784297,20.0,20.0
15795,1,5795,[127 187 483 302 211],524,5,25499,4.399413388543823,20.0,20.0
15796,1,5796,[127 187 483 302 211],537,5,25504,4.399516991547352,20.0,20.0
15797,1,5797,[127 187 483 302 211],537,5,25509,4.399620558813384,20.0,20.0
15798,1,5798,[127 187 483 302 211],474,5,25514,4.399724090360407,20.0,20.0
15799,1,5799,[127 187 483 302 211],90,5,25519,4.3998275862068965,20.0,20.0
15800,1,5800,[127 187 483 302 211],339,5,25524,4.399931046371315,20.0,20.0
15801,1,5801,[127 187 483 302 211],339,5,25529,4.400034470872113,20.0,20.0
15802,1,5802,[127 187 483 302 211],6,5,25534,4.400137859727727,20.0,20.0
15803,1,5803,[ 70 603 210 179   9],13,1,25535,4.399552033080634,20.0,0.0
15804,1,5804,[127 187 483 302 211],524,5,25540,4.399655469422911,20.0,20.0
15805,1,5805,[127 187 483 302 211],328,5,25545,4.3997588701343435,20.0,20.0
15806,1,5806,[127 187 483 302 211],666,5,25550,4.399862235233339,20.0,20.0
15807,1,5807,[127 187 483 302 211],833,3,25553,4.399621212121212,20.0,20.0
15808,1,5808,[127 187 483 302 211],524,5,25558,4.399724565329661,20.0,20.0
15809,1,5809,[127 187 483 302 211],6,5,25563,4.399827882960413,20.0,20.0
15810,1,5810,[215 183 127  88  96],234,2,25565,4.399414902770608,0.0,20.0
15811,1,5811,[294  15 748 257  71],901,4,25569,4.399346180316586,0.0,0.0
15812,1,5812,[127 187 483 302 211],207,5,25574,4.399449509719594,20.0,20.0
15813,1,5813,[127 187 483 302 211],666,5,25579,4.3995528035775715,20.0,20.0
15814,1,5814,[127 187 483 302 211],13,5,25584,4.399656061908856,20.0,20.0
15815,1,5815,[127 187 483 302 211],339,5,25589,4.399759284731775,20.0,20.0
15816,1,5816,[127 187 483 302 211],207,5,25594,4.399862472064638,20.0,20.0
15817,1,5817,[127 187 483 302 211],6,5,25599,4.399965623925747,20.0,20.0
15818,1,5818,[ 28 121  69  25 423],343,3,25602,4.399725038666437,0.0,0.0
15819,1,5819,[127 187 483 302 211],343,5,25607,4.399828178694158,20.0,20.0
15820,1,5820,[127 187 483 302 211],6,5,25612,4.399931283284659,20.0,20.0
15821,1,5821,[127 187 483 302 211],537,5,25617,4.400034352456201,20.0,20.0
15822,1,5822,[127 187 483 302 211],339,5,25622,4.400137386227031,20.0,20.0
15823,1,5823,[  9  11 678 196 496],334,3,25625,4.399896978021978,0.0,0.0
15824,1,5824,[185 117 282 125 182],207,3,25628,4.399656652360515,0.0,0.0
15825,1,5825,[127 187 483 302 211],13,5,25633,4.399759697905939,20.0,20.0
15826,1,5826,[127 187 483 302 211],343,5,25638,4.399862708083061,20.0,20.0
15827,1,5827,[127 187 483 302 211],339,5,25643,4.399965682910089,20.0,20.0
15828,1,5828,[  1 228 289  25  89],387,3,25646,4.399725510379139,0.0,0.0
15829,1,5829,[127 187 483 302 211],666,5,25651,4.399828473413379,20.0,20.0
15830,1,5830,[127 187 483 302 211],339,5,25656,4.399931401131881,20.0,20.0
15831,1,5831,[127 187 483 302 211],524,5,25661,4.400034293552812,20.0,20.0
15832,1,5832,[ 56 318 483 181 182],454,1,25662,4.399451397222698,40.0,0.0
15833,1,5833,[127 187 483 302 211],666,5,25667,4.39955433664724,20.0,20.0
15834,1,5834,[127 187 483 302 211],210,5,25672,4.399657240788346,20.0,20.0
15835,1,5835,[127 187 483 302 211],90,5,25677,4.399760109664154,20.0,20.0
15836,1,5836,[216 174 742 282 111],92,2,25679,4.39934898064074,0.0,20.0
15837,1,5837,[186 435 195 286   8],158,4,25683,4.399280575539568,0.0,0.0
15838,1,5838,[127 187 483 302 211],339,5,25688,4.399383456071245,20.0,20.0
15839,1,5839,[127 187 483 302 211],537,5,25693,4.399486301369863,20.0,20.0
15840,1,5840,[191  12 195 153 183],543,4,25697,4.399417907892484,20.0,0.0
15841,1,5841,[127 187 483 302 211],537,5,25702,4.399520712084902,20.0,20.0
15842,1,5842,[127 187 483 302 211],343,5,25707,4.399623481088482,20.0,20.0
15843,1,5843,[127 187 483 302 211],339,5,25712,4.399726214921286,20.0,20.0
15844,1,5844,[132 211   8  97 322],313,3,25715,4.3994867408041065,0.0,0.0
15845,1,5845,[127 187 483 302 211],537,5,25720,4.399589462880602,20.0,20.0
15846,1,5846,[153 405  56 234 237],85,2,25722,4.399179066187789,0.0,0.0
15847,1,5847,[127 187 483 302 211],207,5,25727,4.399281805745554,20.0,20.0
15848,1,5848,[127 187 483 302 211],524,5,25732,4.399384510172679,20.0,20.0
15849,1,5849,[127 187 483 302 211],207,5,25737,4.3994871794871795,20.0,20.0
15850,1,5850,[127 187 483 302 211],90,5,25742,4.399589813707059,20.0,20.0
15851,1,5851,[127 187 483 302 211],207,5,25747,4.399692412850308,20.0,20.0
15852,1,5852,[127 187 483 302 211],524,5,25752,4.399794976934905,20.0,20.0
15853,1,5853,[127 187 483 302 211],210,5,25757,4.399897505978818,20.0,20.0
15854,1,5854,[127 187 483 302 211],343,5,25762,4.4,20.0,20.0
15855,1,5855,[127 187 483 302 211],537,5,25767,4.400102459016393,20.0,20.0
15856,1,5856,[127 187 483 302 211],833,3,25770,4.399863411302714,20.0,20.0
15857,1,5857,[127 187 483 302 211],833,3,25773,4.399624445203141,20.0,20.0
15858,1,5858,[  8 289 175 186   7],95,4,25777,4.399556238265916,0.0,0.0
15859,1,5859,[ 64 132 118 258 265],254,4,25781,4.399488054607509,0.0,0.0
15860,1,5860,[282 597 435 186 100],378,3,25784,4.39924927486777,0.0,20.0
15861,1,5861,[127 187 483 302 211],666,5,25789,4.399351757079495,20.0,20.0
15862,1,5862,[127 187 483 302 211],339,5,25794,4.399454204332253,20.0,20.0
15863,1,5863,[127 187 483 302 211],524,5,25799,4.399556616643929,20.0,20.0
15864,1,5864,[127 187 483 302 211],833,3,25802,4.399317988064791,20.0,20.0
15865,1,5865,[127 187 483 302 211],343,5,25807,4.399420388680532,20.0,20.0
15866,1,5866,[127 187 483 302 211],339,5,25812,4.399522754388955,20.0,20.0
15867,1,5867,[127 187 483 302 211],524,5,25817,4.399625085207908,20.0,20.0
15868,1,5868,[127 187 483 302 211],90,5,25822,4.399727381155222,20.0,20.0
15869,1,5869,[127 187 483 302 211],524,5,25827,4.399829642248722,20.0,20.0
15870,1,5870,[127 187 483 302 211],207,5,25832,4.399931868506217,20.0,20.0
15871,1,5871,[127 187 483 302 211],210,5,25837,4.400034059945504,20.0,20.0
15872,1,5872,[127 187 483 302 211],666,5,25842,4.400136216584369,20.0,20.0
15873,1,5873,[ 15 182 179 118 405],194,2,25844,4.399727613210759,0.0,0.0
15874,1,5874,[127 187 483 302 211],6,5,25849,4.399829787234043,20.0,20.0
15875,1,5875,[127 187 483 302 211],210,5,25854,4.399931926480599,20.0,20.0
15876,1,5876,[127 187 483 302 211],90,5,25859,4.400034030968181,20.0,20.0
15877,1,5877,[127 187 483 302 211],537,5,25864,4.400136100714529,20.0,20.0
15878,1,5878,[127 187 483 302 211],90,5,25869,4.4002381357373705,20.0,20.0
15879,1,5879,[175 151 191  64 515],279,2,25871,4.399829931972789,0.0,0.0
15880,1,5880,[127 187 483 302 211],666,5,25876,4.399931984356402,20.0,20.0
15881,1,5881,[333 100 471 322 282],548,5,25881,4.4000340020401225,0.0,20.0
15882,1,5882,[127 187 483 302 211],90,5,25886,4.400135985041645,20.0,20.0
15883,1,5883,[  1   8 286 185 678],454,1,25887,4.399558123725357,0.0,0.0
15884,1,5884,[127 187 483 302 211],207,5,25892,4.399660152931181,20.0,20.0
15885,1,5885,[127 187 483 302 211],339,5,25897,4.39976214746857,20.0,20.0
15886,1,5886,[211 215  12  88 180],346,4,25901,4.399694241549176,20.0,0.0
15887,1,5887,[127 187 483 302 211],90,5,25906,4.399796195652174,20.0,20.0
15888,1,5888,[127 187 483 302 211],6,5,25911,4.399898115129903,20.0,20.0
15889,1,5889,[127 187 483 302 211],90,5,25916,4.4,20.0,20.0
15890,1,5890,[197  50   9  56 483],60,5,25921,4.400101850280088,20.0,20.0
15891,1,5891,[127 187 483 302 211],6,5,25926,4.40020366598778,20.0,20.0
15892,1,5892,[127 187 483 302 211],90,5,25931,4.400305447140675,20.0,20.0
15893,1,5893,[127 187 483 302 211],207,5,25936,4.4004071937563625,20.0,20.0
15894,1,5894,[127 187 483 302 211],343,5,25941,4.400508905852417,20.0,20.0
15895,1,5895,[127 187 483 302 211],474,5,25946,4.400610583446404,20.0,20.0
15896,1,5896,[135  82 174 127 268],234,2,25948,4.400203493301679,0.0,40.0
15897,1,5897,[127 187 483 302 211],474,5,25953,4.40030518819939,20.0,20.0
15898,1,5898,[ 11 175 357 678 273],387,3,25956,4.400067808103068,20.0,0.0
15899,1,5899,[483 269 427 202 153],343,5,25961,4.400169491525424,20.0,0.0
15900,1,5900,[127 187 483 302 211],474,5,25966,4.400271140484664,20.0,20.0
15901,1,5901,[127 187 483 302 211],210,5,25971,4.400372754998306,20.0,20.0
15902,1,5902,[127 187 483 302 211],13,5,25976,4.400474335083856,20.0,20.0
15903,1,5903,[127 187 483 302 211],524,5,25981,4.400575880758808,20.0,20.0
15904,1,5904,[127 187 483 302 211],343,5,25986,4.4006773920406435,20.0,20.0
15905,1,5905,[127 187 483 302 211],524,5,25991,4.4007788689468335,20.0,20.0
15906,1,5906,[127 187 483 302 211],13,5,25996,4.400880311494837,20.0,20.0
15907,1,5907,[ 64 183 197 508 182],144,4,26000,4.400812457684496,0.0,0.0
15908,1,5908,[127 187 483 302 211],339,5,26005,4.400913860213234,20.0,20.0
15909,1,5909,[127 187 483 302 211],833,3,26008,4.400676818950931,20.0,20.0
15910,1,5910,[127 187 483 302 211],328,5,26013,4.400778210116732,20.0,20.0
15911,1,5911,[427 286 180 288 357],7,5,26018,4.400879566982408,20.0,0.0
15912,1,5912,[ 98  56 194 181 318],406,5,26023,4.400980889565364,20.0,20.0
15913,1,5913,[127 187 483 302 211],524,5,26028,4.40108217788299,20.0,20.0
15914,1,5914,[127 187 483 302 211],524,5,26033,4.401183431952663,20.0,20.0
15915,1,5915,[127 187 483 302 211],210,5,26038,4.401284651791751,20.0,20.0
15916,1,5916,[333  82 175 546 289],881,3,26041,4.401047828291364,0.0,0.0
15917,1,5917,[127 187 483 302 211],343,5,26046,4.401149036836769,20.0,20.0
15918,1,5918,[127 187 483 302 211],666,5,26051,4.401250211184322,20.0,20.0
15919,1,5919,[435 180 258 187  98],533,4,26055,4.4011824324324325,0.0,20.0
15920,1,5920,[127 187 483 302 211],343,5,26060,4.40128356696504,20.0,20.0
15921,1,5921,[127 187 483 302 211],474,5,26065,4.401384667342114,20.0,20.0
15922,1,5922,[127 187 483 302 211],328,5,26070,4.401485733580955,20.0,20.0
15923,1,5923,[181  71 515 483 127],59,4,26074,4.401417960837272,20.0,20.0
15924,1,5924,[127 187 483 302 211],474,5,26079,4.401518987341772,20.0,20.0
15925,1,5925,[271 318 289 423   4],92,1,26080,4.400944988187647,20.0,0.0
15926,1,5926,[173 186 216   1 135],326,2,26082,4.400539902142737,0.0,0.0
15927,1,5927,[127 187 483 302 211],474,5,26087,4.4006410256410255,20.0,20.0
15928,1,5928,[127 187 483 302 211],210,5,26092,4.400742115027829,20.0,20.0
15929,1,5929,[127 187 483 302 211],6,5,26097,4.400843170320405,20.0,20.0
15930,1,5930,[127 187 483 302 211],524,5,26102,4.400944191535998,20.0,20.0
15931,1,5931,[127 187 483 302 211],6,5,26107,4.401045178691841,20.0,20.0
15932,1,5932,[546 172 174   8 403],92,4,26111,4.400977583010281,0.0,20.0
15933,1,5933,[127 187 483 302 211],328,5,26116,4.401078530502191,20.0,20.0
15934,1,5934,[127 187 483 302 211],537,5,26121,4.401179443976411,20.0,20.0
15935,1,5935,[127 187 483 302 211],537,5,26126,4.401280323450135,20.0,20.0
15936,1,5936,[403 568 215 210 175],650,1,26127,4.400707427993936,0.0,0.0
15937,1,5937,[127 187 483 302 211],328,5,26132,4.4008083529808015,20.0,20.0
15938,1,5938,[127 187 483 302 211],207,5,26137,4.400909243980468,20.0,20.0
15939,1,5939,[127 187 483 302 211],537,5,26142,4.401010101010101,20.0,20.0
15940,1,5940,[168 265 161  64 132],380,2,26144,4.40060595859283,0.0,0.0
15941,1,5941,[127 187 483 302 211],666,5,26149,4.400706832716257,20.0,20.0
15942,1,5942,[276 172 234 127 200],271,4,26153,4.400639407706546,0.0,20.0
15943,1,5943,[127 187 483 302 211],90,5,26158,4.4007402422611035,20.0,20.0
15944,1,5944,[496 121 194  69 245],454,3,26161,4.400504625735913,0.0,0.0
15945,1,5945,[127 187 483 302 211],13,5,26166,4.400605449041373,20.0,20.0
15946,1,5946,[127 187 483 302 211],210,5,26171,4.4007062384395494,20.0,20.0
15947,1,5947,[127 187 483 302 211],339,5,26176,4.400806993947546,20.0,20.0
15948,1,5948,[127 187 483 302 211],90,5,26181,4.400907715582451,20.0,20.0
15949,1,5949,[127 187 483 302 211],90,5,26186,4.401008403361344,20.0,20.0
15950,1,5950,[127 187 483 302 211],207,5,26191,4.401109057301294,20.0,20.0
15951,1,5951,[ 79 427 183  22 121],474,5,26196,4.401209677419355,0.0,0.0
15952,1,5952,[127 187 483 302 211],343,5,26201,4.401310263732571,20.0,20.0
15953,1,5953,[127 187 483 302 211],6,5,26206,4.401410816257978,20.0,20.0
15954,1,5954,[127 187 483 302 211],6,5,26211,4.401511335012595,20.0,20.0
15955,1,5955,[127 187 483 302 211],524,5,26216,4.401611820013432,20.0,20.0
15956,1,5956,[286  28 357 204 118],380,3,26219,4.401376531811314,20.0,0.0
15957,1,5957,[127 187 483 302 211],474,5,26224,4.401477005706613,20.0,20.0
15958,1,5958,[127 187 483 302 211],524,5,26229,4.401577445880181,20.0,20.0
15959,1,5959,[191  11 318 111 597],92,2,26231,4.401174496644296,20.0,0.0
15960,1,5960,[127 187 483 302 211],13,5,26236,4.401274953866801,20.0,20.0
15961,1,5961,[127 187 483 302 211],13,5,26241,4.401375377390138,20.0,20.0
15962,1,5962,[127 187 483 302 211],210,5,26246,4.401475767231259,20.0,20.0
15963,1,5963,[127 187 483 302 211],833,3,26249,4.401240778001341,20.0,20.0
15964,1,5964,[121 435 117 655   7],881,4,26253,4.401173512154233,0.0,0.0
15965,1,5965,[127 187 483 302 211],666,5,26258,4.401273885350318,20.0,20.0
15966,1,5966,[748  97 121 597 265],804,4,26262,4.4012066365007545,0.0,0.0
15967,1,5967,[216  89 273 385 187],328,2,26264,4.400804289544236,0.0,0.0
15968,1,5968,[127 187 483 302 211],207,5,26269,4.400904674149774,20.0,20.0
15969,1,5969,[127 187 483 302 211],6,5,26274,4.401005025125628,20.0,20.0
15970,1,5970,[127 187 483 302 211],13,5,26279,4.4011053424886954,20.0,20.0
15971,1,5971,[127 187 483 302 211],6,5,26284,4.4012056262558605,20.0,20.0
15972,1,5972,[127 187 483 302 211],474,5,26289,4.401305876443998,20.0,20.0
15973,1,5973,[127 187 483 302 211],833,3,26292,4.401071309005691,20.0,20.0
15974,1,5974,[127 187 483 302 211],537,5,26297,4.401171548117155,20.0,20.0
15975,1,5975,[127 187 483 302 211],207,5,26302,4.401271753681392,20.0,20.0
15976,1,5976,[127 187 483 302 211],328,5,26307,4.4013719257152415,20.0,20.0
15977,1,5977,[127 187 483 302 211],339,5,26312,4.40147206423553,20.0,20.0
15978,1,5978,[403   1 204 258  56],59,3,26315,4.401237665161398,0.0,0.0
15979,1,5979,[127 187 483 302 211],343,5,26320,4.40133779264214,20.0,20.0
15980,1,5980,[127 187 483 302 211],474,5,26325,4.4014378866410295,20.0,20.0
15981,1,5981,[127 187 483 302 211],207,5,26330,4.401537947174858,20.0,20.0
15982,1,5982,[655   8 172 135  79],479,5,26335,4.401637974260405,0.0,0.0
15983,1,5983,[127 187 483 302 211],833,3,26338,4.401403743315508,20.0,20.0
15984,1,5984,[127 187 483 302 211],474,5,26343,4.401503759398496,20.0,20.0
15985,1,5985,[127 187 483 302 211],13,5,26348,4.401603742064818,20.0,20.0
15986,1,5986,[173 423 210 515 183],474,5,26353,4.4017036913312175,0.0,0.0
15987,1,5987,[144 475 237 568  15],92,3,26356,4.4014696058784235,0.0,0.0
15988,1,5988,[127 187 483 302 211],207,5,26361,4.4015695441643015,20.0,20.0
15989,1,5989,[127 187 483 302 211],666,5,26366,4.401669449081803,20.0,20.0
15990,1,5990,[ 56 405 678 655  22],13,3,26369,4.401435486563178,0.0,0.0
15991,1,5991,[127 187 483 302 211],207,5,26374,4.401535380507343,20.0,20.0
15992,1,5992,[496 238  11  96 257],474,4,26378,4.401468379776405,0.0,0.0
15993,1,5993,[  4 200  71 185 135],234,3,26381,4.401234567901234,0.0,0.0
15994,1,5994,[127 187 483 302 211],537,5,26386,4.401334445371143,20.0,20.0
15995,1,5995,[127 187 483 302 211],210,5,26391,4.4014342895263505,20.0,20.0
15996,1,5996,[181 238 265 111 496],64,5,26396,4.401534100383525,0.0,0.0
15997,1,5997,[127 187 483 302 211],524,5,26401,4.40163387795932,20.0,20.0
15998,1,5998,[127 187 483 302 211],666,5,26406,4.4017336222703785,20.0,20.0
15999,1,5999,[127 187 483 302 211],210,5,26411,4.401833333333333,20.0,20.0
16000,1,6000,[127 187 483 302 211],343,5,26416,4.401933011164806,20.0,20.0
16001,1,6001,[127 187 483 302 211],343,5,26421,4.402032655781406,20.0,20.0
16002,1,6002,[127 187 483 302 211],90,5,26426,4.402132267199733,20.0,20.0
16003,1,6003,[127 187 483 302 211],343,5,26431,4.402231845436376,20.0,20.0
16004,1,6004,[127 187 483 302 211],666,5,26436,4.40233139050791,20.0,20.0
16005,1,6005,[127 187 483 302 211],524,5,26441,4.402430902430902,20.0,20.0
16006,1,6006,[127 187 483 302 211],13,5,26446,4.402530381221908,20.0,20.0
16007,1,6007,[127 187 483 302 211],207,5,26451,4.40262982689747,20.0,20.0
16008,1,6008,[ 69 183  56 301 258],334,3,26454,4.4023964053919125,0.0,0.0
16009,1,6009,[127 187 483 302 211],207,5,26459,4.402495840266223,20.0,20.0
16010,1,6010,[168 471  97 385  82],666,3,26462,4.402262518715688,0.0,0.0
16011,1,6011,[127 187 483 302 211],207,5,26467,4.402361942781105,20.0,20.0
16012,1,6012,[127 187 483 302 211],343,5,26472,4.402461333776817,20.0,20.0
16013,1,6013,[181   9  56 100 328],13,3,26475,4.402228134353176,0.0,20.0
16014,1,6014,[ 82 185 483 197 174],184,3,26478,4.401995012468828,20.0,20.0
16015,1,6015,[127 187 483 302 211],207,5,26483,4.402094414893617,20.0,20.0
16016,1,6016,[568 234 405 168  22],95,3,26486,4.401861392720625,0.0,0.0
16017,1,6017,[ 25 328 568 237 196],92,2,26488,4.401462279827185,0.0,0.0
16018,1,6018,[ 98 597  50  12 405],458,2,26490,4.401063299551421,20.0,40.0
16019,1,6019,[127 187 483 302 211],833,3,26493,4.400830564784053,20.0,20.0
16020,1,6020,[127 187 483 302 211],833,3,26496,4.400597907324364,20.0,20.0
16021,1,6021,[216 176 183 568   8],64,5,26501,4.400697442710063,0.0,0.0
16022,1,6022,[127 187 483 302 211],207,5,26506,4.400796945043998,20.0,20.0
16023,1,6023,[127 187 483 302 211],833,3,26509,4.400564409030545,20.0,20.0
16024,1,6024,[127 187 483 302 211],328,5,26514,4.400663900414938,20.0,20.0
16025,1,6025,[125 568 245 234 405],200,3,26517,4.400431463657484,0.0,0.0
16026,1,6026,[127 187 483 302 211],6,5,26522,4.400530944084951,20.0,20.0
16027,1,6027,[127 187 483 302 211],13,5,26527,4.400630391506304,20.0,20.0
16028,1,6028,[238 182 258  89 176],537,4,26531,4.400563940952065,0.0,0.0
16029,1,6029,[300 234 405 265  79],102,0,26531,4.39983416252073,0.0,0.0
16030,1,6030,[127 187 483 302 211],666,5,26536,4.399933676007295,20.0,20.0
16031,1,6031,[127 187 483 302 211],666,5,26541,4.400033156498674,20.0,20.0
16032,1,6032,[127 187 483 302 211],328,5,26546,4.400132604011271,20.0,20.0
16033,1,6033,[127 187 483 302 211],343,5,26551,4.400232018561485,20.0,20.0
16034,1,6034,[127 187 483 302 211],6,5,26556,4.4003314001657,20.0,20.0
16035,1,6035,[151   1 742 238 222],899,2,26558,4.399933730947647,0.0,0.0
16036,1,6036,[127 187 483 302 211],13,5,26563,4.400033129037602,20.0,20.0
16037,1,6037,[127 187 483 302 211],90,5,26568,4.400132494203379,20.0,20.0
16038,1,6038,[127 187 483 302 211],343,5,26573,4.400231826461335,20.0,20.0
16039,1,6039,[127 187 483 302 211],524,5,26578,4.400331125827814,20.0,20.0
16040,1,6040,[127 187 483 302 211],833,3,26581,4.4000993213044195,20.0,20.0
16041,1,6041,[127 187 483 302 211],13,5,26586,4.400198609731877,20.0,20.0
16042,1,6042,[333 117  96  15 427],537,1,26587,4.399635942412709,0.0,0.0
16043,1,6043,[127 187 483 302 211],833,3,26590,4.399404367968233,20.0,20.0
16044,1,6044,[127 187 483 302 211],90,5,26595,4.399503722084368,20.0,20.0
16045,1,6045,[597  97 235 222 153],13,2,26597,4.399106847502481,0.0,0.0
16046,1,6046,[127 187 483 302 211],833,3,26600,4.3988754754423685,20.0,20.0
16047,1,6047,[127 187 483 302 211],833,3,26603,4.3986441798941796,20.0,20.0
16048,1,6048,[127 187 483 302 211],537,5,26608,4.398743593982476,20.0,20.0
16049,1,6049,[127 187 483 302 211],833,3,26611,4.398512396694215,20.0,20.0
16050,1,6050,[127 187 483 302 211],90,5,26616,4.398611799702529,20.0,20.0
16051,1,6051,[127 187 483 302 211],537,5,26621,4.398711169861203,20.0,20.0
16052,1,6052,[127 187 483 302 211],90,5,26626,4.398810507186519,20.0,20.0
16053,1,6053,[127 187 483 302 211],833,3,26629,4.398579451602246,20.0,20.0
16054,1,6054,[127 187 483 302 211],13,5,26634,4.398678777869529,20.0,20.0
16055,1,6055,[127 187 483 302 211],833,3,26637,4.398447820343461,20.0,20.0
16056,1,6056,[127 187 483 302 211],90,5,26642,4.39854713554565,20.0,20.0
16057,1,6057,[127 187 483 302 211],13,5,26647,4.398646417959723,20.0,20.0
16058,1,6058,[127 187 483 302 211],207,5,26652,4.398745667601914,20.0,20.0
16059,1,6059,[127 187 483 302 211],210,5,26657,4.398844884488449,20.0,20.0
16060,1,6060,[127 187 483 302 211],666,5,26662,4.398944068635538,20.0,20.0
16061,1,6061,[127 187 483 302 211],343,5,26667,4.3990432200593865,20.0,20.0
16062,1,6062,[127 187 483 302 211],343,5,26672,4.399142338776183,20.0,20.0
16063,1,6063,[127 187 483 302 211],13,5,26677,4.399241424802111,20.0,20.0
16064,1,6064,[127 187 483 302 211],328,5,26682,4.399340478153339,20.0,20.0
16065,1,6065,[127 187 483 302 211],90,5,26687,4.399439498846027,20.0,20.0
16066,1,6066,[385  25 200 174 238],666,2,26689,4.399044008570957,0.0,20.0
16067,1,6067,[127 187 483 302 211],474,5,26694,4.399143045484509,20.0,20.0
16068,1,6068,[127 187 483 302 211],833,3,26697,4.3989125061789425,20.0,20.0
16069,1,6069,[127 258 475 222  70],213,3,26700,4.398682042833608,0.0,20.0
16070,1,6070,[127 187 483 302 211],13,5,26705,4.398781090429913,20.0,20.0
16071,1,6071,[127 187 483 302 211],210,5,26710,4.398880105401845,20.0,20.0
16072,1,6072,[127 187 483 302 211],6,5,26715,4.39897908776552,20.0,20.0
16073,1,6073,[127 187 483 302 211],6,5,26720,4.399078037537043,20.0,20.0
16074,1,6074,[127 187 483 302 211],537,5,26725,4.399176954732511,20.0,20.0
16075,1,6075,[ 79  64 100 286  50],213,4,26729,4.399111257406188,0.0,40.0
16076,1,6076,[127 187 483 302 211],666,5,26734,4.39921013658055,20.0,20.0
16077,1,6077,[  8 180 282 496 322],474,5,26739,4.399308983218164,0.0,0.0
16078,1,6078,[100 588 483 678 222],82,3,26742,4.399078795854582,20.0,20.0
16079,1,6079,[127 187 483 302 211],207,5,26747,4.399177631578947,20.0,20.0
16080,1,6080,[127 187 483 302 211],666,5,26752,4.399276434796908,20.0,20.0
16081,1,6081,[127 187 483 302 211],343,5,26757,4.399375205524499,20.0,20.0
16082,1,6082,[127 187 483 302 211],666,5,26762,4.399473943777741,20.0,20.0
16083,1,6083,[127 187 483 302 211],207,5,26767,4.39957264957265,20.0,20.0
16084,1,6084,[127 187 483 302 211],207,5,26772,4.399671322925226,20.0,20.0
16085,1,6085,[127 187 483 302 211],13,5,26777,4.399769963851463,20.0,20.0
16086,1,6086,[127 187 483 302 211],207,5,26782,4.39986857236734,20.0,20.0
16087,1,6087,[127 187 483 302 211],328,5,26787,4.39996714848883,20.0,20.0
16088,1,6088,[125  56 183   1 181],374,4,26791,4.39990146165216,0.0,0.0
16089,1,6089,[127 187 483 302 211],207,5,26796,4.4,20.0,20.0
16090,1,6090,[127 187 483 302 211],210,5,26801,4.400098505992448,20.0,20.0
16091,1,6091,[127 187 483 302 211],210,5,26806,4.400196979645437,20.0,20.0
16092,1,6092,[127 187 483 302 211],90,5,26811,4.4002954209748895,20.0,20.0
16093,1,6093,[127 187 483 302 211],90,5,26816,4.400393829996718,20.0,20.0
16094,1,6094,[127 187 483 302 211],339,5,26821,4.400492206726825,20.0,20.0
16095,1,6095,[127 187 483 302 211],339,5,26826,4.400590551181103,20.0,20.0
16096,1,6096,[127 187 483 302 211],339,5,26831,4.40068886337543,20.0,20.0
16097,1,6097,[127 187 483 302 211],524,5,26836,4.40078714332568,20.0,20.0
16098,1,6098,[127 187 483 302 211],328,5,26841,4.400885391047713,20.0,20.0
16099,1,6099,[127 187 483 302 211],537,5,26846,4.400983606557377,20.0,20.0
16100,1,6100,[258 483 403 161 427],13,4,26850,4.400917882314375,20.0,0.0
16101,1,6101,[127 187 483 302 211],343,5,26855,4.401016060308096,20.0,20.0
16102,1,6102,[127 187 483 302 211],339,5,26860,4.401114206128134,20.0,20.0
16103,1,6103,[127 187 483 302 211],6,5,26865,4.401212319790301,20.0,20.0
16104,1,6104,[127 187 483 302 211],537,5,26870,4.401310401310401,20.0,20.0
16105,1,6105,[179   4 143 185 588],13,2,26872,4.4009171306911234,0.0,0.0
16106,1,6106,[127 187 483 302 211],328,5,26877,4.401015228426396,20.0,20.0
16107,1,6107,[127 187 483 302 211],339,5,26882,4.401113294040602,20.0,20.0
16108,1,6108,[111 180 121 161  70],59,3,26885,4.400883941725323,0.0,0.0
16109,1,6109,[  1 186 181 202 597],279,3,26888,4.400654664484452,0.0,0.0
16110,1,6110,[435 588  28 427 235],13,4,26892,4.40058910162003,0.0,0.0
16111,1,6111,[127 187 483 302 211],6,5,26897,4.4006871727748695,20.0,20.0
16112,1,6112,[127 187 483 302 211],343,5,26902,4.400785211843612,20.0,20.0
16113,1,6113,[127 187 483 302 211],343,5,26907,4.400883218842002,20.0,20.0
16114,1,6114,[127 187 483 302 211],207,5,26912,4.400981193785773,20.0,20.0
16115,1,6115,[127 187 483 302 211],6,5,26917,4.401079136690647,20.0,20.0
16116,1,6116,[127 187 483 302 211],210,5,26922,4.4011770475723395,20.0,20.0
16117,1,6117,[127 187 483 302 211],339,5,26927,4.401274926446551,20.0,20.0
16118,1,6118,[300 427   4  25 175],666,3,26930,4.401045922536362,0.0,0.0
16119,1,6119,[ 69  22 245  79 185],653,4,26934,4.400980392156863,0.0,0.0
16120,1,6120,[127 187 483 302 211],6,5,26939,4.401078255187061,20.0,20.0
16121,1,6121,[ 89 403 174 313  71],234,1,26940,4.400522704998367,0.0,20.0
16122,1,6122,[182  89 423 172 175],479,4,26944,4.4004572921770375,0.0,0.0
16123,1,6123,[237  95 483  89  22],334,4,26948,4.400391900718485,20.0,0.0
16124,1,6124,[202 195 475   4 121],537,1,26949,4.399836734693878,0.0,0.0
16125,1,6125,[127 187 483 302 211],90,5,26954,4.399934704538035,20.0,20.0
16126,1,6126,[127 187 483 302 211],833,3,26957,4.3997062183776725,20.0,20.0
16127,1,6127,[127 187 483 302 211],13,5,26962,4.3998041775456915,20.0,20.0
16128,1,6128,[127 187 483 302 211],343,5,26967,4.39990210474792,20.0,20.0
16129,1,6129,[127 187 483 302 211],90,5,26972,4.4,20.0,20.0
16130,1,6130,[ 79 423 282 546 168],899,4,26976,4.399934757788289,0.0,0.0
16131,1,6131,[121 181  71 568  96],454,3,26979,4.399706457925636,0.0,0.0
16132,1,6132,[127 187 483 302 211],474,5,26984,4.399804337192239,20.0,20.0
16133,1,6133,[127 187 483 302 211],339,5,26989,4.399902184545158,20.0,20.0
16134,1,6134,[127 187 483 302 211],13,5,26994,4.4,20.0,20.0
16135,1,6135,[127 187 483 302 211],339,5,26999,4.40009778357236,20.0,20.0
16136,1,6136,[127 187 483 302 211],833,3,27002,4.399869643148118,20.0,20.0
16137,1,6137,[127 187 483 302 211],90,5,27007,4.399967416096448,20.0,20.0
16138,1,6138,[127 187 483 302 211],328,5,27012,4.400065157191725,20.0,20.0
16139,1,6139,[127 187 483 302 211],6,5,27017,4.400162866449511,20.0,20.0
16140,1,6140,[127 187 483 302 211],343,5,27022,4.400260543885361,20.0,20.0
16141,1,6141,[127 187 483 302 211],339,5,27027,4.400358189514816,20.0,20.0
16142,1,6142,[127 187 483 302 211],6,5,27032,4.4004558033534105,20.0,20.0
16143,1,6143,[127 187 483 302 211],328,5,27037,4.400553385416667,20.0,20.0
16144,1,6144,[127 187 483 302 211],328,5,27042,4.400650935720098,20.0,20.0
16145,1,6145,[127 187 483 302 211],537,5,27047,4.400748454279206,20.0,20.0
16146,1,6146,[127 187 483 302 211],833,3,27050,4.400520579144298,20.0,20.0
16147,1,6147,[405  82 153 328 161],92,1,27051,4.399967469095641,0.0,0.0
16148,1,6148,[127 187 483 302 211],13,5,27056,4.400065051227842,20.0,20.0
16149,1,6149,[127 187 483 302 211],328,5,27061,4.4001626016260165,20.0,20.0
16150,1,6150,[127 187 483 302 211],833,3,27064,4.3999349699235895,20.0,20.0
16151,1,6151,[127 187 483 302 211],537,5,27069,4.400032509752926,20.0,20.0
16152,1,6152,[127 187 483 302 211],6,5,27074,4.4001300178774585,20.0,20.0
16153,1,6153,[127 187 483 302 211],537,5,27079,4.4002274943126425,20.0,20.0
16154,1,6154,[127 187 483 302 211],537,5,27084,4.400324939073924,20.0,20.0
16155,1,6155,[100 322  96 215 151],749,4,27088,4.400259909031839,0.0,20.0
16156,1,6156,[127 187 483 302 211],524,5,27093,4.400357316875102,20.0,20.0
16157,1,6157,[127 187 483 302 211],524,5,27098,4.400454693082169,20.0,20.0
16158,1,6158,[127 187 483 302 211],343,5,27103,4.400552037668453,20.0,20.0
16159,1,6159,[127 187 483 302 211],833,3,27106,4.400324675324676,20.0,20.0
16160,1,6160,[127 187 483 302 211],339,5,27111,4.400422009414056,20.0,20.0
16161,1,6161,[127 187 483 302 211],207,5,27116,4.400519311911717,20.0,20.0
16162,1,6162,[127 187 483 302 211],524,5,27121,4.4006165828330355,20.0,20.0
16163,1,6163,[127 187 483 302 211],6,5,27126,4.400713822193381,20.0,20.0
16164,1,6164,[515 135 210 333 257],666,2,27128,4.400324412003244,0.0,0.0
16165,1,6165,[181  50 197 204 496],749,5,27133,4.400421667207266,0.0,20.0
16166,1,6166,[ 22 183 357  96  50],59,5,27138,4.400518890870764,20.0,20.0
16167,1,6167,[127 187 483 302 211],210,5,27143,4.400616083009079,20.0,20.0
16168,1,6168,[127 187 483 302 211],343,5,27148,4.400713243637543,20.0,20.0
16169,1,6169,[127 187 483 302 211],666,5,27153,4.400810372771475,20.0,20.0
16170,1,6170,[127 187 483 302 211],328,5,27158,4.400907470426187,20.0,20.0
16171,1,6171,[127 187 483 302 211],833,3,27161,4.400680492546987,20.0,20.0
16172,1,6172,[127 187 483 302 211],537,5,27166,4.400777579782925,20.0,20.0
16173,1,6173,[111 268  69 302 265],334,2,27168,4.400388726919339,0.0,0.0
16174,1,6174,[127 187 483 302 211],339,5,27173,4.400485829959514,20.0,20.0
16175,1,6175,[127 187 483 302 211],328,5,27178,4.4005829015544045,20.0,20.0
16176,1,6176,[127 187 483 302 211],666,5,27183,4.4006799417192815,20.0,20.0
16177,1,6177,[144 216 302 173 294],666,2,27185,4.4002913564260275,0.0,0.0
16178,1,6178,[127 187 483 302 211],339,5,27190,4.40038841236446,20.0,20.0
16179,1,6179,[127 187 483 302 211],207,5,27195,4.400485436893204,20.0,20.0
16180,1,6180,[238 168 289 153 257],92,3,27198,4.400258857790002,0.0,0.0
16181,1,6181,[202 245 153 143 742],653,1,27199,4.399708832093173,0.0,0.0
16182,1,6182,[127 187 483 302 211],207,5,27204,4.399805919456575,20.0,20.0
16183,1,6183,[127 187 483 302 211],339,5,27209,4.3999029754204395,20.0,20.0
16184,1,6184,[181 175 748 161 546],102,1,27210,4.399353274050121,0.0,0.0
16185,1,6185,[127 187 483 302 211],666,5,27215,4.399450371807307,20.0,20.0
16186,1,6186,[127 187 483 302 211],339,5,27220,4.399547438176822,20.0,20.0
16187,1,6187,[127 187 483 302 211],524,5,27225,4.399644473173885,20.0,20.0
16188,1,6188,[ 69 183 173 117   7],840,4,27229,4.399579899822266,0.0,0.0
16189,1,6189,[257 118 197 161 172],650,3,27232,4.39935379644588,0.0,0.0
16190,1,6190,[237  89 135 423 265],455,3,27235,4.399127766112098,0.0,0.0
16191,1,6191,[127 187 483 302 211],537,5,27240,4.39922480620155,20.0,20.0
16192,1,6192,[127 187 483 302 211],210,5,27245,4.399321814952366,20.0,20.0
16193,1,6193,[127 187 483 302 211],339,5,27250,4.3994187923797226,20.0,20.0
16194,1,6194,[127 187 483 302 211],833,3,27253,4.399192897497982,20.0,20.0
16195,1,6195,[127 187 483 302 211],666,5,27258,4.399289864428663,20.0,20.0
16196,1,6196,[127 187 483 302 211],343,5,27263,4.399386800064548,20.0,20.0
16197,1,6197,[127 187 483 302 211],524,5,27268,4.399483704420781,20.0,20.0
16198,1,6198,[237 546 235 228 405],524,1,27269,4.39893531214712,0.0,0.0
16199,1,6199,[127 187 483 302 211],328,5,27274,4.3990322580645165,20.0,20.0
16200,1,6200,[191   8 276  56 202],378,4,27278,4.398967908401871,0.0,0.0
16201,1,6201,[258 323 289 204 144],13,3,27281,4.398742341180265,0.0,0.0
16202,1,6202,[127 187 483 302 211],474,5,27286,4.398839271320329,20.0,20.0
16203,1,6203,[127 187 483 302 211],666,5,27291,4.398936170212766,20.0,20.0
16204,1,6204,[496  95 286 301 234],524,3,27294,4.398710717163578,0.0,0.0
16205,1,6205,[ 64 179 174  12  95],234,1,27295,4.398163067998711,20.0,20.0
16206,1,6206,[127 187 483 302 211],6,5,27300,4.398260028999517,20.0,20.0
16207,1,6207,[127 187 483 302 211],210,5,27305,4.398356958762887,20.0,20.0
16208,1,6208,[127 187 483 302 211],666,5,27310,4.398453857303914,20.0,20.0
16209,1,6209,[196 496  82 127 655],398,5,27315,4.398550724637682,0.0,20.0
16210,1,6210,[179 173  96  56 117],387,4,27319,4.398486556110127,0.0,0.0
16211,1,6211,[127 187 483 302 211],207,5,27324,4.398583386992917,20.0,20.0
16212,1,6212,[127 187 483 302 211],339,5,27329,4.398680186705295,20.0,20.0
16213,1,6213,[135 234 603 742  69],271,4,27333,4.398616028323142,20.0,0.0
16214,1,6214,[180 196 405 174 588],840,5,27338,4.398712791633145,0.0,20.0
16215,1,6215,[222 235 546 435 180],378,2,27340,4.398326898326898,0.0,0.0
16216,1,6216,[127 187 483 302 211],13,5,27345,4.398423677014637,20.0,20.0
16217,1,6217,[127 187 483 302 211],6,5,27350,4.398520424573818,20.0,20.0
16218,1,6218,[127 187 483 302 211],328,5,27355,4.398617141019456,20.0,20.0
16219,1,6219,[127 187 483 302 211],207,5,27360,4.398713826366559,20.0,20.0
16220,1,6220,[127 187 483 302 211],666,5,27365,4.398810480630123,20.0,20.0
16221,1,6221,[127 187 483 302 211],13,5,27370,4.398907103825136,20.0,20.0
16222,1,6222,[196  56 483 132   7],59,5,27375,4.3990036959665755,20.0,0.0
16223,1,6223,[127 187 483 302 211],90,5,27380,4.399100257069409,20.0,20.0
16224,1,6224,[127 187 483 302 211],666,5,27385,4.399196787148594,20.0,20.0
16225,1,6225,[127 187 483 302 211],537,5,27390,4.3992932862190814,20.0,20.0
16226,1,6226,[127 187 483 302 211],90,5,27395,4.399389754295808,20.0,20.0
16227,1,6227,[328 127 508 475 195],13,1,27396,4.398843930635838,0.0,20.0
16228,1,6228,[127 187 483 302 211],207,5,27401,4.39894043987799,20.0,20.0
16229,1,6229,[127 187 483 302 211],210,5,27406,4.399036918138042,20.0,20.0
16230,1,6230,[127 187 483 302 211],13,5,27411,4.39913336543091,20.0,20.0
16231,1,6231,[127 187 483 302 211],339,5,27416,4.399229781771502,20.0,20.0
16232,1,6232,[100 237 546 742  98],825,5,27421,4.399326167174715,0.0,40.0
16233,1,6233,[127 187 483 302 211],13,5,27426,4.399422521655438,20.0,20.0
16234,1,6234,[ 56  89 322 286 125],234,0,27426,4.398716920609463,0.0,0.0
16235,1,6235,[127 187 483 302 211],90,5,27431,4.398813341885824,20.0,20.0
16236,1,6236,[127 187 483 302 211],13,5,27436,4.398909732243066,20.0,20.0
16237,1,6237,[286 471 568 496 121],378,3,27439,4.398685476114139,0.0,0.0
16238,1,6238,[127 187 483 302 211],343,5,27444,4.398781856066678,20.0,20.0
16239,1,6239,[ 88 742  71 748 322],881,3,27447,4.398557692307692,0.0,0.0
16240,1,6240,[127 187 483 302 211],339,5,27452,4.398654061849062,20.0,20.0
16241,1,6241,[127 187 483 302 211],90,5,27457,4.3987504005126565,20.0,20.0
16242,1,6242,[127 187 483 302 211],833,3,27460,4.398526349511453,20.0,20.0
16243,1,6243,[127 187 483 302 211],666,5,27465,4.39862267777066,20.0,20.0
16244,1,6244,[127 187 483 302 211],666,5,27470,4.398718975180144,20.0,20.0
16245,1,6245,[127 187 483 302 211],343,5,27475,4.398815241754723,20.0,20.0
16246,1,6246,[127 187 483 302 211],343,5,27480,4.398911477509205,20.0,20.0
16247,1,6247,[127 187 483 302 211],207,5,27485,4.399007682458387,20.0,20.0
16248,1,6248,[127 187 483 302 211],13,5,27490,4.399103856617058,20.0,20.0
16249,1,6249,[127 187 483 302 211],210,5,27495,4.3992,20.0,20.0
16250,1,6250,[127 187 483 302 211],537,5,27500,4.399296112621981,20.0,20.0
16251,1,6251,[228 194 161 273 515],13,3,27503,4.399072296865003,0.0,0.0
16252,1,6252,[127 187 483 302 211],339,5,27508,4.399168399168399,20.0,20.0
16253,1,6253,[127 187 483 302 211],474,5,27513,4.399264470738728,20.0,20.0
16254,1,6254,[127 187 483 302 211],90,5,27518,4.399360511590728,20.0,20.0
16255,1,6255,[127 187 483 302 211],666,5,27523,4.399456521739131,20.0,20.0
16256,1,6256,[289 269 222 100 288],455,2,27525,4.399073038197219,0.0,20.0
16257,1,6257,[127 187 483 302 211],13,5,27530,4.399169063598594,20.0,20.0
16258,1,6258,[127 187 483 302 211],474,5,27535,4.399265058316025,20.0,20.0
16259,1,6259,[127 187 483 302 211],666,5,27540,4.399361022364217,20.0,20.0
16260,1,6260,[127 187 483 302 211],474,5,27545,4.399456955757866,20.0,20.0
16261,1,6261,[  7  22  70 194 269],378,5,27550,4.399552858511657,0.0,0.0
16262,1,6262,[127 187 483 302 211],6,5,27555,4.399648730640268,20.0,20.0
16263,1,6263,[180 179 546 186   7],87,4,27559,4.399584929757344,0.0,0.0
16264,1,6264,[ 28 328 294 302 197],271,3,27562,4.399361532322426,0.0,0.0
16265,1,6265,[127 187 483 302 211],210,5,27567,4.3994573890839455,20.0,20.0
16266,1,6266,[127 187 483 302 211],6,5,27572,4.399553215254508,20.0,20.0
16267,1,6267,[127 187 483 302 211],210,5,27577,4.399649010848756,20.0,20.0
16268,1,6268,[127 187 483 302 211],833,3,27580,4.399425745732972,20.0,20.0
16269,1,6269,[127 187 483 302 211],328,5,27585,4.399521531100478,20.0,20.0
16270,1,6270,[127 187 483 302 211],6,5,27590,4.3996172859193114,20.0,20.0
16271,1,6271,[127 187 483 302 211],207,5,27595,4.399713010204081,20.0,20.0
16272,1,6272,[144 197 228 423 385],749,4,27599,4.3996492906105535,0.0,0.0
16273,1,6273,[183 186 234 191   4],833,2,27601,4.399266815428754,0.0,0.0
16274,1,6274,[127 187 483 302 211],474,5,27606,4.399362549800797,20.0,20.0
16275,1,6275,[127 187 483 302 211],474,5,27611,4.399458253664754,20.0,20.0
16276,1,6276,[127 187 483 302 211],666,5,27616,4.399553927035208,20.0,20.0
16277,1,6277,[161 194 588 204 191],85,4,27620,4.399490283529786,0.0,0.0
16278,1,6278,[127 187 483 302 211],207,5,27625,4.399585921325052,20.0,20.0
16279,1,6279,[127 187 483 302 211],343,5,27630,4.399681528662421,20.0,20.0
16280,1,6280,[127 187 483 302 211],90,5,27635,4.39977710555644,20.0,20.0
16281,1,6281,[127 187 483 302 211],343,5,27640,4.399872652021649,20.0,20.0
16282,1,6282,[127 187 483 302 211],207,5,27645,4.399968168072577,20.0,20.0
16283,1,6283,[127 187 483 302 211],537,5,27650,4.400063653723743,20.0,20.0
16284,1,6284,[127 187 483 302 211],328,5,27655,4.400159108989658,20.0,20.0
16285,1,6285,[127 187 483 302 211],524,5,27660,4.400254533884824,20.0,20.0
16286,1,6286,[127 187 483 302 211],474,5,27665,4.400349928423731,20.0,20.0
16287,1,6287,[ 88 322 191 475 427],533,4,27669,4.400286259541985,0.0,0.0
16288,1,6288,[127 187 483 302 211],474,5,27674,4.400381618699316,20.0,20.0
16289,1,6289,[257 182 289 271 174],92,2,27676,4.4,0.0,20.0
16290,1,6290,[127 187 483 302 211],6,5,27681,4.400095374344302,20.0,20.0
16291,1,6291,[127 187 483 302 211],207,5,27686,4.400190718372537,20.0,20.0
16292,1,6292,[127 187 483 302 211],524,5,27691,4.4002860320991575,20.0,20.0
16293,1,6293,[127 187 483 302 211],474,5,27696,4.400381315538608,20.0,20.0
16294,1,6294,[127 187 483 302 211],524,5,27701,4.400476568705321,20.0,20.0
16295,1,6295,[ 50 211 197  82 496],234,3,27704,4.4002541296060995,0.0,20.0
16296,1,6296,[127 187 483 302 211],666,5,27709,4.400349372717167,20.0,20.0
16297,1,6297,[175 181  97  64  69],64,4,27713,4.400285805017466,0.0,0.0
16298,1,6298,[100 174 181 405 172],144,5,27718,4.400381012859184,0.0,40.0
16299,1,6299,[127 187 483 302 211],343,5,27723,4.400476190476191,20.0,20.0
16300,1,6300,[127 187 483 302 211],474,5,27728,4.400571337882876,20.0,20.0
16301,1,6301,[127 187 483 302 211],207,5,27733,4.400666455093621,20.0,20.0
16302,1,6302,[ 96 172 211 182  71],506,5,27738,4.400761542122798,0.0,0.0
16303,1,6303,[127 187 483 302 211],13,5,27743,4.400856598984771,20.0,20.0
16304,1,6304,[127 187 483 302 211],833,3,27746,4.400634417129263,20.0,20.0
16305,1,6305,[127 187 483 302 211],339,5,27751,4.400729464002537,20.0,20.0
16306,1,6306,[ 64 423 546   7 294],7,4,27755,4.400665926748058,0.0,0.0
16307,1,6307,[127 187 483 302 211],524,5,27760,4.400760938490805,20.0,20.0
16308,1,6308,[127 187 483 302 211],6,5,27765,4.400855920114123,20.0,20.0
16309,1,6309,[127 187 483 302 211],343,5,27770,4.40095087163233,20.0,20.0
16310,1,6310,[127 187 483 302 211],343,5,27775,4.401045793059737,20.0,20.0
16311,1,6311,[127 187 483 302 211],6,5,27780,4.401140684410646,20.0,20.0
16312,1,6312,[127 187 483 302 211],207,5,27785,4.40123554569935,20.0,20.0
16313,1,6313,[ 64 144 197 215 678],263,4,27789,4.401171998732974,0.0,0.0
16314,1,6314,[127 187 483 302 211],339,5,27794,4.401266825019794,20.0,20.0
16315,1,6315,[127 187 483 302 211],6,5,27799,4.401361621279291,20.0,20.0
16316,1,6316,[127 187 483 302 211],6,5,27804,4.401456387525724,20.0,20.0
16317,1,6317,[195 405 282  69 204],653,3,27807,4.401234567901234,0.0,0.0
16318,1,6318,[265 300 179 423 185],64,4,27811,4.401171071372053,0.0,0.0
16319,1,6319,[127 187 483 302 211],474,5,27816,4.4012658227848105,20.0,20.0
16320,1,6320,[127 187 483 302 211],343,5,27821,4.401360544217687,20.0,20.0
16321,1,6321,[508 286  56 301  12],13,2,27823,4.400980702309396,20.0,0.0
16322,1,6322,[127 187 483 302 211],524,5,27828,4.401075438873952,20.0,20.0
16323,1,6323,[127 187 483 302 211],90,5,27833,4.401170145477546,20.0,20.0
16324,1,6324,[127 187 483 302 211],666,5,27838,4.4012648221343875,20.0,20.0
16325,1,6325,[127 187 483 302 211],6,5,27843,4.401359468858678,20.0,20.0
16326,1,6326,[127 187 483 302 211],666,5,27848,4.401454085664612,20.0,20.0
16327,1,6327,[127 187 483 302 211],339,5,27853,4.4015486725663715,20.0,20.0
16328,1,6328,[127 187 483 302 211],537,5,27858,4.4016432295781325,20.0,20.0
16329,1,6329,[127 187 483 302 211],343,5,27863,4.40173775671406,20.0,20.0
16330,1,6330,[127 187 483 302 211],833,3,27866,4.401516348128258,20.0,20.0
16331,1,6331,[546 588 423 172 153],536,3,27869,4.401295009475679,0.0,0.0
16332,1,6332,[127 187 483 302 211],339,5,27874,4.401389546818254,20.0,20.0
16333,1,6333,[ 97 216 302 300  79],871,3,27877,4.401168298073887,0.0,0.0
16334,1,6334,[127 187 483 302 211],833,3,27880,4.400947119179164,20.0,20.0
16335,1,6335,[144 286 471 237 496],378,3,27883,4.40072601010101,0.0,0.0
16336,1,6336,[405 202 435 568   1],64,4,27887,4.400662774183368,0.0,0.0
16337,1,6337,[127 187 483 302 211],6,5,27892,4.400757336699274,20.0,20.0
16338,1,6338,[127 187 483 302 211],328,5,27897,4.400851869380029,20.0,20.0
16339,1,6339,[127 187 483 302 211],339,5,27902,4.400946372239748,20.0,20.0
16340,1,6340,[127 187 483 302 211],6,5,27907,4.401040845292541,20.0,20.0
16341,1,6341,[117 508 748 257 288],474,1,27908,4.400504572690003,0.0,0.0
16342,1,6342,[127 187 483 302 211],210,5,27913,4.40059908560618,20.0,20.0
16343,1,6343,[127 187 483 302 211],328,5,27918,4.400693568726355,20.0,20.0
16344,1,6344,[127 187 483 302 211],90,5,27923,4.400788022064618,20.0,20.0
16345,1,6345,[127 187 483 302 211],537,5,27928,4.4008824456350455,20.0,20.0
16346,1,6346,[176  22 742 215 211],533,4,27932,4.400819284701433,0.0,0.0
16347,1,6347,[127 187 483 302 211],339,5,27937,4.400913673597984,20.0,20.0
16348,1,6348,[127 187 483 302 211],210,5,27942,4.401008032761065,20.0,20.0
16349,1,6349,[127 187 483 302 211],833,3,27945,4.400787401574803,20.0,20.0
16350,1,6350,[127 187 483 302 211],210,5,27950,4.400881750905369,20.0,20.0
16351,1,6351,[127 187 483 302 211],537,5,27955,4.4009760705289676,20.0,20.0
16352,1,6352,[127 187 483 302 211],207,5,27960,4.4010703604596255,20.0,20.0
16353,1,6353,[127 187 483 302 211],207,5,27965,4.401164620711363,20.0,20.0
16354,1,6354,[127 187 483 302 211],343,5,27970,4.4012588512981905,20.0,20.0
16355,1,6355,[127 187 483 302 211],339,5,27975,4.40135305223411,20.0,20.0
16356,1,6356,[127 187 483 302 211],6,5,27980,4.401447223533113,20.0,20.0
16357,1,6357,[127 187 483 302 211],537,5,27985,4.4015413652091855,20.0,20.0
16358,1,6358,[127 187 483 302 211],666,5,27990,4.401635477276301,20.0,20.0
16359,1,6359,[127 187 483 302 211],207,5,27995,4.401729559748428,20.0,20.0
16360,1,6360,[322 265 195 151 186],234,0,27995,4.4010375727086934,0.0,0.0
16361,1,6361,[127 187 483 302 211],328,5,28000,4.401131719585036,20.0,20.0
16362,1,6362,[269  71 175 151 286],6,3,28003,4.400911519723401,0.0,0.0
16363,1,6363,[127 187 483 302 211],474,5,28008,4.40100565681961,20.0,20.0
16364,1,6364,[161 288 273 180 176],92,3,28011,4.400785545954438,0.0,0.0
16365,1,6365,[ 22 144 181 121 288],479,4,28015,4.400722588752749,0.0,0.0
16366,1,6366,[127 187 483 302 211],210,5,28020,4.4008167111669545,20.0,20.0
16367,1,6367,[127 187 483 302 211],13,5,28025,4.400910804020101,20.0,20.0
16368,1,6368,[127 187 483 302 211],343,5,28030,4.401004867326111,20.0,20.0
16369,1,6369,[258 180 216 173 238],474,5,28035,4.4010989010989015,0.0,0.0
16370,1,6370,[174  71 269 210 286],488,2,28037,4.40072202166065,0.0,20.0
16371,1,6371,[ 79 483  98 228  28],60,5,28042,4.400816070307596,20.0,20.0
16372,1,6372,[127 187 483 302 211],474,5,28047,4.400910089439824,20.0,20.0
16373,1,6373,[127 187 483 302 211],666,5,28052,4.401004079071227,20.0,20.0
16374,1,6374,[288 603 132 222 211],474,4,28056,4.400941176470588,20.0,0.0
16375,1,6375,[127 187 483 302 211],13,5,28061,4.40103513174404,20.0,20.0
16376,1,6376,[195 121 742 405 313],653,3,28064,4.400815430453191,0.0,0.0
16377,1,6377,[ 89  50  69   1 143],312,5,28069,4.400909375979931,0.0,20.0
16378,1,6378,[127 187 483 302 211],339,5,28074,4.401003292052046,20.0,20.0
16379,1,6379,[127 187 483 302 211],328,5,28079,4.4010971786833855,20.0,20.0
16380,1,6380,[127 187 483 302 211],339,5,28084,4.401191035887792,20.0,20.0
16381,1,6381,[127 187 483 302 211],328,5,28089,4.4012848636790975,20.0,20.0
16382,1,6382,[127 187 483 302 211],339,5,28094,4.401378662071126,20.0,20.0
16383,1,6383,[185 195 204 179 197],234,1,28095,4.400845864661654,0.0,0.0
16384,1,6384,[127 187 483 302 211],6,5,28100,4.400939702427564,20.0,20.0
16385,1,6385,[127 187 483 302 211],210,5,28105,4.4010335108048855,20.0,20.0
16386,1,6386,[313 179 151 216 423],537,2,28107,4.400657585720996,0.0,0.0
16387,1,6387,[127 187 483 302 211],207,5,28112,4.400751408891672,20.0,20.0
16388,1,6388,[127 187 483 302 211],328,5,28117,4.400845202692127,20.0,20.0
16389,1,6389,[127 187 483 302 211],6,5,28122,4.40093896713615,20.0,20.0
16390,1,6390,[210 187 282 183 435],326,1,28123,4.4004068220935695,0.0,0.0
16391,1,6391,[127 187 483 302 211],13,5,28128,4.400500625782228,20.0,20.0
16392,1,6392,[127 187 483 302 211],537,5,28133,4.4005944001251365,20.0,20.0
16393,1,6393,[127 187 483 302 211],833,3,28136,4.400375351892399,20.0,20.0
16394,1,6394,[127 187 483 302 211],90,5,28141,4.400469116497264,20.0,20.0
16395,1,6395,[127 187 483 302 211],339,5,28146,4.400562851782364,20.0,20.0
16396,1,6396,[127 187 483 302 211],90,5,28151,4.400656557761451,20.0,20.0
16397,1,6397,[127 187 483 302 211],207,5,28156,4.400750234448265,20.0,20.0
16398,1,6398,[127 187 483 302 211],90,5,28161,4.40084388185654,20.0,20.0
16399,1,6399,[143 186 258  89  71],311,3,28164,4.400625,0.0,0.0
16400,1,6400,[127 187 483 302 211],210,5,28169,4.400718637712857,20.0,20.0
16401,1,6401,[127 187 483 302 211],13,5,28174,4.4008122461730705,20.0,20.0
16402,1,6402,[127 187 483 302 211],328,5,28179,4.4009058253943465,20.0,20.0
16403,1,6403,[ 88 275 427 435 276],13,4,28183,4.400843222985634,0.0,0.0
16404,1,6404,[186 216 111  70  79],334,1,28184,4.400312256049961,0.0,0.0
16405,1,6405,[127 187 483 302 211],13,5,28189,4.400405869497346,20.0,20.0
16406,1,6406,[194   1 603 655 273],749,5,28194,4.400499453722491,20.0,0.0
16407,1,6407,[127 187 483 302 211],537,5,28199,4.400593008739076,20.0,20.0
16408,1,6408,[127 187 483 302 211],833,3,28202,4.400374473396786,20.0,20.0
16409,1,6409,[483 318 215 161  12],59,4,28206,4.400312012480499,60.0,0.0
16410,1,6410,[127 187 483 302 211],474,5,28211,4.400405552955857,20.0,20.0
16411,1,6411,[127 187 483 302 211],537,5,28216,4.4004990642545225,20.0,20.0
16412,1,6412,[127 187 483 302 211],13,5,28221,4.400592546390145,20.0,20.0
16413,1,6413,[127 187 483 302 211],474,5,28226,4.400685999376364,20.0,20.0
16414,1,6414,[127 187 483 302 211],210,5,28231,4.400779423226812,20.0,20.0
16415,1,6415,[127 187 483 302 211],6,5,28236,4.400872817955112,20.0,20.0
16416,1,6416,[127 187 483 302 211],6,5,28241,4.400966183574879,20.0,20.0
16417,1,6417,[127 187 483 302 211],207,5,28246,4.40105952009972,20.0,20.0
16418,1,6418,[127 187 483 302 211],339,5,28251,4.401152827543231,20.0,20.0
16419,1,6419,[127 187 483 302 211],339,5,28256,4.401246105919003,20.0,20.0
16420,1,6420,[127 187 483 302 211],90,5,28261,4.401339355240617,20.0,20.0
16421,1,6421,[127 187 483 302 211],6,5,28266,4.401432575521644,20.0,20.0
16422,1,6422,[127 187 483 302 211],90,5,28271,4.40152576677565,20.0,20.0
16423,1,6423,[127 187 483 302 211],6,5,28276,4.401618929016189,20.0,20.0
16424,1,6424,[127 187 483 302 211],13,5,28281,4.401712062256809,20.0,20.0
16425,1,6425,[127 187 483 302 211],6,5,28286,4.401805166511049,20.0,20.0
16426,1,6426,[127 187 483 302 211],339,5,28291,4.401898241792438,20.0,20.0
16427,1,6427,[127 187 483 302 211],6,5,28296,4.401991288114499,20.0,20.0
16428,1,6428,[127 187 483 302 211],474,5,28301,4.402084305490745,20.0,20.0
16429,1,6429,[127 187 483 302 211],666,5,28306,4.402177293934681,20.0,20.0
16430,1,6430,[127 187 483 302 211],339,5,28311,4.402270253459804,20.0,20.0
16431,1,6431,[127 187 483 302 211],13,5,28316,4.402363184079602,20.0,20.0
16432,1,6432,[ 97 515 195 273 172],234,1,28317,4.401834291932224,0.0,0.0
16433,1,6433,[127 187 483 302 211],524,5,28322,4.401927261423687,20.0,20.0
16434,1,6434,[483   7 181 125   4],158,3,28325,4.401709401709402,20.0,0.0
16435,1,6435,[127 187 483 302 211],339,5,28330,4.401802361715351,20.0,20.0
16436,1,6436,[257 294 202 197 357],659,4,28334,4.401739940966289,20.0,0.0
16437,1,6437,[143 135 475 258 483],213,5,28339,4.401832867350109,20.0,0.0
16438,1,6438,[127 187 483 302 211],537,5,28344,4.401925764870321,20.0,20.0
16439,1,6439,[127 187 483 302 211],6,5,28349,4.402018633540373,20.0,20.0
16440,1,6440,[ 70  50 211 357 258],311,4,28353,4.401956217978575,20.0,20.0
16441,1,6441,[127 187 483 302 211],343,5,28358,4.402049053089103,20.0,20.0
16442,1,6442,[127 187 483 302 211],524,5,28363,4.402141859382275,20.0,20.0
16443,1,6443,[127 187 483 302 211],90,5,28368,4.402234636871508,20.0,20.0
16444,1,6444,[127 187 483 302 211],328,5,28373,4.402327385570209,20.0,20.0
16445,1,6445,[269 385 174 111 182],378,4,28377,4.402264970524357,0.0,20.0
16446,1,6446,[127 187 483 302 211],6,5,28382,4.402357685745308,20.0,20.0
16447,1,6447,[127 187 483 302 211],90,5,28387,4.4024503722084365,20.0,20.0
16448,1,6448,[  7 748   9  95 181],13,3,28390,4.402232904326252,0.0,0.0
16449,1,6449,[127 187 483 302 211],537,5,28395,4.402325581395349,20.0,20.0
16450,1,6450,[127 187 483 302 211],207,5,28400,4.402418229731825,20.0,20.0
16451,1,6451,[127 187 483 302 211],666,5,28405,4.4025108493490395,20.0,20.0
16452,1,6452,[132 276 313  98 179],234,3,28408,4.402293506896017,0.0,20.0
16453,1,6453,[127 187 483 302 211],343,5,28413,4.402386117136659,20.0,20.0
16454,1,6454,[127 187 483 302 211],328,5,28418,4.402478698683192,20.0,20.0
16455,1,6455,[127 187 483 302 211],833,3,28421,4.4022614622057,20.0,20.0
16456,1,6456,[603 197  79  97 322],524,4,28425,4.402199163698312,20.0,0.0
16457,1,6457,[127 187 483 302 211],666,5,28430,4.402291731186126,20.0,20.0
16458,1,6458,[127 187 483 302 211],666,5,28435,4.402384270010837,20.0,20.0
16459,1,6459,[127 187 483 302 211],524,5,28440,4.402476780185759,20.0,20.0
16460,1,6460,[127 187 483 302 211],90,5,28445,4.402569261724191,20.0,20.0
16461,1,6461,[127 187 483 302 211],537,5,28450,4.4026617146394305,20.0,20.0
16462,1,6462,[127 187 483 302 211],474,5,28455,4.402754138944762,20.0,20.0
16463,1,6463,[127 187 483 302 211],6,5,28460,4.402846534653466,20.0,20.0
16464,1,6464,[127 187 483 302 211],666,5,28465,4.402938901778809,20.0,20.0
16465,1,6465,[127 187 483 302 211],339,5,28470,4.403031240334055,20.0,20.0
16466,1,6466,[127 187 483 302 211],207,5,28475,4.403123550332457,20.0,20.0
16467,1,6467,[127 187 483 302 211],339,5,28480,4.403215831787261,20.0,20.0
16468,1,6468,[328  79 181 265  71],479,4,28484,4.403153501313959,0.0,0.0
16469,1,6469,[127 187 483 302 211],343,5,28489,4.4032457496136015,20.0,20.0
16470,1,6470,[127 187 483 302 211],6,5,28494,4.403337969401947,20.0,20.0
16471,1,6471,[127 187 483 302 211],328,5,28499,4.403430160692213,20.0,20.0
16472,1,6472,[127 187 483 302 211],328,5,28504,4.403522323497605,20.0,20.0
16473,1,6473,[127 187 483 302 211],343,5,28509,4.403614457831325,20.0,20.0
16474,1,6474,[127 187 483 302 211],833,3,28512,4.403397683397683,20.0,20.0
16475,1,6475,[127 187 483 302 211],339,5,28517,4.40348980852378,20.0,20.0
16476,1,6476,[127 187 483 302 211],13,5,28522,4.403581905203026,20.0,20.0
16477,1,6477,[127 187 483 302 211],328,5,28527,4.403673973448595,20.0,20.0
16478,1,6478,[127 187 483 302 211],666,5,28532,4.403766013273653,20.0,20.0
16479,1,6479,[127 187 483 302 211],207,5,28537,4.403858024691358,20.0,20.0
16480,1,6480,[127 187 483 302 211],524,5,28542,4.403950007714859,20.0,20.0
16481,1,6481,[228 151 742 318  56],387,2,28544,4.40357914224005,20.0,0.0
16482,1,6482,[127 187 483 302 211],666,5,28549,4.4036711399043655,20.0,20.0
16483,1,6483,[127 187 483 302 211],207,5,28554,4.403763109191857,20.0,20.0
16484,1,6484,[194 196 185 161 515],271,3,28557,4.403546646106399,0.0,0.0
16485,1,6485,[127 187 483 302 211],339,5,28562,4.4036386062288,20.0,20.0
16486,1,6486,[127 187 483 302 211],339,5,28567,4.403730537999075,20.0,20.0
16487,1,6487,[127 187 483 302 211],474,5,28572,4.403822441430333,20.0,20.0
16488,1,6488,[127 187 483 302 211],207,5,28577,4.403914316535675,20.0,20.0
16489,1,6489,[127 187 483 302 211],210,5,28582,4.404006163328197,20.0,20.0
16490,1,6490,[127 187 483 302 211],339,5,28587,4.404097981820983,20.0,20.0
16491,1,6491,[111 216 742 228 588],59,3,28590,4.403881700554528,0.0,0.0
16492,1,6492,[127 187 483 302 211],833,3,28593,4.403665485907901,20.0,20.0
16493,1,6493,[258 322 603 568 174],533,5,28598,4.4037573144441025,20.0,20.0
16494,1,6494,[127 187 483 302 211],339,5,28603,4.403849114703618,20.0,20.0
16495,1,6495,[496 187  11 121 173],334,3,28606,4.4036330049261085,0.0,0.0
16496,1,6496,[127 187 483 302 211],207,5,28611,4.40372479605972,20.0,20.0
16497,1,6497,[127 187 483 302 211],833,3,28614,4.4035087719298245,20.0,20.0
16498,1,6498,[127 187 483 302 211],666,5,28619,4.403600553931374,20.0,20.0
16499,1,6499,[127 187 483 302 211],524,5,28624,4.403692307692308,20.0,20.0
16500,1,6500,[127 187 483 302 211],537,5,28629,4.403784033225658,20.0,20.0
16501,1,6501,[ 22 427  88  79 215],194,2,28631,4.403414334051061,0.0,0.0
16502,1,6502,[127 187 483 302 211],207,5,28636,4.403506074119637,20.0,20.0
16503,1,6503,[127 187 483 302 211],210,5,28641,4.40359778597786,20.0,20.0
16504,1,6504,[127 187 483 302 211],210,5,28646,4.403689469638739,20.0,20.0
16505,1,6505,[196 385  69 127  22],738,4,28650,4.4036274208423,0.0,20.0
16506,1,6506,[127 187 483 302 211],339,5,28655,4.403719071768864,20.0,20.0
16507,1,6507,[176  69  22 174 168],881,3,28658,4.403503380454825,0.0,20.0
16508,1,6508,[127 187 483 302 211],210,5,28663,4.403595022276847,20.0,20.0
16509,1,6509,[127 187 483 302 211],339,5,28668,4.403686635944701,20.0,20.0
16510,1,6510,[333 257 588 196  22],881,3,28671,4.40347104899401,0.0,0.0
16511,1,6511,[127 187 483 302 211],666,5,28676,4.403562653562654,20.0,20.0
16512,1,6512,[127 187 483 302 211],474,5,28681,4.4036542300015356,20.0,20.0
16513,1,6513,[135  11 185   9 187],339,5,28686,4.403745778323611,0.0,0.0
16514,1,6514,[302 678 121 435 258],537,2,28688,4.403376822716807,0.0,0.0
16515,1,6515,[127 187 483 302 211],207,5,28693,4.403468385512585,20.0,20.0
16516,1,6516,[127 187 483 302 211],13,5,28698,4.403559920208685,20.0,20.0
16517,1,6517,[127 187 483 302 211],6,5,28703,4.403651426818042,20.0,20.0
16518,1,6518,[127 187 483 302 211],833,3,28706,4.403436109832796,20.0,20.0
16519,1,6519,[127 475 357 234  82],10,5,28711,4.403527607361963,20.0,20.0
16520,1,6520,[127 187 483 302 211],328,5,28716,4.403619076828707,20.0,20.0
16521,1,6521,[127 187 483 302 211],328,5,28721,4.403710518245937,20.0,20.0
16522,1,6522,[127 187 483 302 211],666,5,28726,4.403801931626552,20.0,20.0
16523,1,6523,[357 423 238 111  70],271,5,28731,4.403893316983446,20.0,0.0
16524,1,6524,[127 187 483 302 211],339,5,28736,4.403984674329502,20.0,20.0
16525,1,6525,[748 235 322 271 546],13,1,28737,4.403463070793748,0.0,0.0
16526,1,6526,[127 187 483 302 211],537,5,28742,4.403554466064041,20.0,20.0
16527,1,6527,[127 187 483 302 211],343,5,28747,4.403645833333333,20.0,20.0
16528,1,6528,[127 187 483 302 211],210,5,28752,4.403737172614489,20.0,20.0
16529,1,6529,[127 187 483 302 211],90,5,28757,4.403828483920368,20.0,20.0
16530,1,6530,[ 70 268 168  96 172],7,3,28760,4.403613535446333,0.0,0.0
16531,1,6531,[127 187 483 302 211],339,5,28765,4.4037048377219845,20.0,20.0
16532,1,6532,[127 187 483 302 211],339,5,28770,4.403796112046533,20.0,20.0
16533,1,6533,[127 187 483 302 211],833,3,28773,4.403581267217631,20.0,20.0
16534,1,6534,[127 187 483 302 211],474,5,28778,4.403672532517215,20.0,20.0
16535,1,6535,[127 187 483 302 211],13,5,28783,4.403763769889841,20.0,20.0
16536,1,6536,[127 187 483 302 211],833,3,28786,4.4035490286063945,20.0,20.0
16537,1,6537,[127 187 483 302 211],537,5,28791,4.4036402569593145,20.0,20.0
16538,1,6538,[127 187 483 302 211],537,5,28796,4.40373145740939,20.0,20.0
16539,1,6539,[ 71 135 195 318 181],533,4,28800,4.4036697247706424,20.0,0.0
16540,1,6540,[127 187 483 302 211],210,5,28805,4.403760892829842,20.0,20.0
16541,1,6541,[ 71 289 117  96 161],474,4,28809,4.403699174564354,0.0,0.0
16542,1,6542,[127 187 483 302 211],210,5,28814,4.403790310255235,20.0,20.0
16543,1,6543,[127 187 483 302 211],207,5,28819,4.40388141809291,20.0,20.0
16544,1,6544,[127 187 483 302 211],343,5,28824,4.403972498090146,20.0,20.0
16545,1,6545,[127 187 483 302 211],207,5,28829,4.404063550259701,20.0,20.0
16546,1,6546,[318 265 173 153 405],13,2,28831,4.403696349473041,20.0,0.0
16547,1,6547,[403   9 655 483 181],881,3,28834,4.4034819792303,20.0,0.0
16548,1,6548,[127 187 483 302 211],339,5,28839,4.403573064590014,20.0,20.0
16549,1,6549,[127 187 483 302 211],666,5,28844,4.403664122137404,20.0,20.0
16550,1,6550,[127 187 483 302 211],207,5,28849,4.403755151885209,20.0,20.0
16551,1,6551,[ 97 215 282 471 176],311,5,28854,4.403846153846154,0.0,0.0
16552,1,6552,[215  50 172   8 313],64,5,28859,4.403937128032962,0.0,20.0
16553,1,6553,[127 187 483 302 211],13,5,28864,4.404028074458346,20.0,20.0
16554,1,6554,[603   1  88 172 180],738,4,28868,4.403966437833715,20.0,0.0
16555,1,6555,[127 187 483 302 211],339,5,28873,4.404057352043929,20.0,20.0
16556,1,6556,[127 187 483 302 211],666,5,28878,4.404148238523715,20.0,20.0
16557,1,6557,[127 187 483 302 211],474,5,28883,4.404239097285758,20.0,20.0
16558,1,6558,[127 187 483 302 211],210,5,28888,4.404329928342735,20.0,20.0
16559,1,6559,[ 96  50  97 196 181],326,4,28892,4.404268292682927,0.0,20.0
16560,1,6560,[127 187 483 302 211],537,5,28897,4.40435909160189,20.0,20.0
16561,1,6561,[127 187 483 302 211],524,5,28902,4.404449862846693,20.0,20.0
16562,1,6562,[127 187 483 302 211],90,5,28907,4.404540606429986,20.0,20.0
16563,1,6563,[127 187 483 302 211],207,5,28912,4.404631322364412,20.0,20.0
16564,1,6564,[222 748  22 265 276],13,4,28916,4.404569687738005,0.0,0.0
16565,1,6565,[ 97 185 127   7 286],406,4,28920,4.404508071885471,0.0,20.0
16566,1,6566,[127 187 483 302 211],210,5,28925,4.404598751332419,20.0,20.0
16567,1,6567,[286 403 435  56 222],533,3,28928,4.404384896467723,0.0,0.0
16568,1,6568,[ 11 191 196 357 153],339,5,28933,4.404475567057391,20.0,0.0
16569,1,6569,[127 187 483 302 211],339,5,28938,4.404566210045662,20.0,20.0
16570,1,6570,[235  96  64 216 186],279,2,28940,4.4042002739309085,0.0,0.0
16571,1,6571,[222  25 191 200  12],795,3,28943,4.403986609860012,20.0,0.0
16572,1,6572,[127 187 483 302 211],210,5,28948,4.404077285866423,20.0,20.0
16573,1,6573,[127 187 483 302 211],343,5,28953,4.404167934286583,20.0,20.0
16574,1,6574,[127 187 483 302 211],90,5,28958,4.4042585551330795,20.0,20.0
16575,1,6575,[127 187 483 302 211],537,5,28963,4.404349148418492,20.0,20.0
16576,1,6576,[127 187 483 302 211],343,5,28968,4.40443971415539,20.0,20.0
16577,1,6577,[127 187 483 302 211],666,5,28973,4.40453025235634,20.0,20.0
16578,1,6578,[127 187 483 302 211],833,3,28976,4.404316765465876,20.0,20.0
16579,1,6579,[127 187 483 302 211],666,5,28981,4.404407294832827,20.0,20.0
16580,1,6580,[127 187 483 302 211],90,5,28986,4.4044977966874335,20.0,20.0
16581,1,6581,[127 187 483 302 211],328,5,28991,4.404588271042236,20.0,20.0
16582,1,6582,[127 187 483 302 211],210,5,28996,4.404678717909768,20.0,20.0
16583,1,6583,[127 187 483 302 211],210,5,29001,4.4047691373025515,20.0,20.0
16584,1,6584,[  8 187 385  28  11],897,2,29003,4.404403948367502,0.0,0.0
16585,1,6585,[127 187 483 302 211],343,5,29008,4.404494382022472,20.0,20.0
16586,1,6586,[127 187 483 302 211],207,5,29013,4.4045847882192195,20.0,20.0
16587,1,6587,[127 187 483 302 211],343,5,29018,4.404675166970249,20.0,20.0
16588,1,6588,[127 187 483 302 211],207,5,29023,4.404765518288056,20.0,20.0
16589,1,6589,[127 187 483 302 211],524,5,29028,4.404855842185129,20.0,20.0
16590,1,6590,[127 187 483 302 211],210,5,29033,4.4049461386739495,20.0,20.0
16591,1,6591,[127 187 483 302 211],210,5,29038,4.40503640776699,20.0,20.0
16592,1,6592,[127 187 483 302 211],833,3,29041,4.404823297436676,20.0,20.0
16593,1,6593,[127 187 483 302 211],666,5,29046,4.4049135577798,20.0,20.0
16594,1,6594,[127 187 483 302 211],537,5,29051,4.405003790750569,20.0,20.0
16595,1,6595,[294 678  50 238  28],82,2,29053,4.404639175257732,0.0,20.0
16596,1,6596,[127 187 483 302 211],474,5,29058,4.404729422464757,20.0,20.0
16597,1,6597,[127 187 483 302 211],537,5,29063,4.404819642315854,20.0,20.0
16598,1,6598,[127 187 483 302 211],13,5,29068,4.404909834823458,20.0,20.0
16599,1,6599,[180 186  89 483   4],7,5,29073,4.405,20.0,0.0
16600,1,6600,[127 187 483 302 211],524,5,29078,4.405090137857901,20.0,20.0
16601,1,6601,[127 187 483 302 211],210,5,29083,4.405180248409573,20.0,20.0
16602,1,6602,[127 187 483 302 211],210,5,29088,4.405270331667424,20.0,20.0
16603,1,6603,[127 187 483 302 211],207,5,29093,4.405360387643852,20.0,20.0
16604,1,6604,[127 187 483 302 211],524,5,29098,4.405450416351249,20.0,20.0
16605,1,6605,[127 187 483 302 211],90,5,29103,4.405540417801999,20.0,20.0
16606,1,6606,[127 187 483 302 211],6,5,29108,4.405630392008476,20.0,20.0
16607,1,6607,[194 168 322 228 191],537,2,29110,4.405266343825666,0.0,0.0
16608,1,6608,[127 187 483 302 211],13,5,29115,4.405356332274172,20.0,20.0
16609,1,6609,[127 187 483 302 211],207,5,29120,4.405446293494705,20.0,20.0
16610,1,6610,[127 187 483 302 211],90,5,29125,4.4055362274996215,20.0,20.0
16611,1,6611,[546  22 216 289 144],92,1,29126,4.405021173623714,0.0,0.0
16612,1,6612,[127 187 483 302 211],537,5,29131,4.405111144714955,20.0,20.0
16613,1,6613,[191 173 508  96  82],455,5,29136,4.40520108859994,0.0,0.0
16614,1,6614,[127 187 483 302 211],13,5,29141,4.405291005291005,20.0,20.0
16615,1,6615,[153 182  96 191  97],892,5,29146,4.405380894800484,0.0,0.0
16616,1,6616,[127 187 483 302 211],339,5,29151,4.405470757140698,20.0,20.0
16617,1,6617,[127 187 483 302 211],339,5,29156,4.405560592323965,20.0,20.0
16618,1,6618,[496  11 204 678   4],749,4,29160,4.405499320138993,0.0,0.0
16619,1,6619,[196 268 186 179 546],13,3,29163,4.405287009063444,0.0,0.0
16620,1,6620,[127 187 483 302 211],833,3,29166,4.405074762120526,20.0,20.0
16621,1,6621,[127 187 483 302 211],328,5,29171,4.4051646028390214,20.0,20.0
16622,1,6622,[ 25 515 174 180 282],881,4,29175,4.405103427449796,0.0,20.0
16623,1,6623,[127 187 483 302 211],13,5,29180,4.405193236714976,20.0,20.0
16624,1,6624,[127 187 483 302 211],833,3,29183,4.404981132075472,20.0,20.0
16625,1,6625,[333 151 168 228 748],653,3,29186,4.404769091457893,0.0,0.0
16626,1,6626,[127 187 483 302 211],328,5,29191,4.4048589105175795,20.0,20.0
16627,1,6627,[127 187 483 302 211],6,5,29196,4.404948702474352,20.0,20.0
16628,1,6628,[127 187 483 302 211],328,5,29201,4.405038467340474,20.0,20.0
16629,1,6629,[127 187 483 302 211],6,5,29206,4.4051282051282055,20.0,20.0
16630,1,6630,[176 168 183  11 228],749,5,29211,4.405217915849796,0.0,0.0
16631,1,6631,[182 144 132 288 333],488,1,29212,4.404704463208685,0.0,0.0
16632,1,6632,[132 183 273 200 275],328,4,29216,4.404643449419569,0.0,0.0
16633,1,6633,[127 187 483 302 211],90,5,29221,4.404733192643955,20.0,20.0
16634,1,6634,[127 187 483 302 211],6,5,29226,4.40482290881688,20.0,20.0
16635,1,6635,[143 357 258  89 151],6,2,29228,4.404460518384569,20.0,0.0
16636,1,6636,[196  79 546 385 153],346,3,29231,4.404248907638993,0.0,0.0
16637,1,6637,[127 187 483 302 211],13,5,29236,4.4043386562217535,20.0,20.0
16638,1,6638,[127 187 483 302 211],210,5,29241,4.404428377767736,20.0,20.0
16639,1,6639,[127 187 483 302 211],666,5,29246,4.404518072289156,20.0,20.0
16640,1,6640,[127 187 483 302 211],6,5,29251,4.404607739798223,20.0,20.0
16641,1,6641,[127 187 483 302 211],833,3,29254,4.404396266184884,20.0,20.0
16642,1,6642,[127 187 483 302 211],90,5,29259,4.40448592503387,20.0,20.0
16643,1,6643,[127 187 483 302 211],6,5,29264,4.4045755568934375,20.0,20.0
16644,1,6644,[127 187 483 302 211],90,5,29269,4.404665161775771,20.0,20.0
16645,1,6645,[127 187 483 302 211],537,5,29274,4.404754739693049,20.0,20.0
16646,1,6646,[127 187 483 302 211],90,5,29279,4.404844290657439,20.0,20.0
16647,1,6647,[127 187 483 302 211],524,5,29284,4.404933814681107,20.0,20.0
16648,1,6648,[127 187 483 302 211],13,5,29289,4.4050233117762065,20.0,20.0
16649,1,6649,[127 187 483 302 211],328,5,29294,4.405112781954887,20.0,20.0
16650,1,6650,[127 187 483 302 211],328,5,29299,4.405202225229289,20.0,20.0
16651,1,6651,[597 475 282  97 568],455,3,29302,4.404990980156344,0.0,0.0
16652,1,6652,[127 187 483 302 211],90,5,29307,4.405080414850444,20.0,20.0
16653,1,6653,[ 95 228 435 151   9],648,2,29309,4.4047189660354675,0.0,0.0
16654,1,6654,[568 333 216 195 121],13,1,29310,4.404207362885049,0.0,0.0
16655,1,6655,[127 187 483 302 211],207,5,29315,4.404296875,20.0,20.0
16656,1,6656,[127 187 483 302 211],207,5,29320,4.404386360222323,20.0,20.0
16657,1,6657,[151 168 172 222 118],380,2,29322,4.404025232802644,0.0,0.0
16658,1,6658,[127 187 483 302 211],537,5,29327,4.404114731941733,20.0,20.0
16659,1,6659,[127 187 483 302 211],666,5,29332,4.404204204204204,20.0,20.0
16660,1,6660,[127 187 483 302 211],833,3,29335,4.403993394385227,20.0,20.0
16661,1,6661,[127 187 483 302 211],666,5,29340,4.4040828580006,20.0,20.0
16662,1,6662,[127 187 483 302 211],6,5,29345,4.40417229476212,20.0,20.0
16663,1,6663,[ 15 475 173 182 204],479,3,29348,4.403961584633853,0.0,0.0
16664,1,6664,[127 187 483 302 211],524,5,29353,4.404051012753189,20.0,20.0
16665,1,6665,[127 187 483 302 211],6,5,29358,4.404140414041404,20.0,20.0
16666,1,6666,[176 403 271 568  11],92,3,29361,4.403929803509825,0.0,0.0
16667,1,6667,[127 187 483 302 211],537,5,29366,4.4040191961607675,20.0,20.0
16668,1,6668,[127 187 483 302 211],207,5,29371,4.404108562003299,20.0,20.0
16669,1,6669,[127 187 483 302 211],833,3,29374,4.4038980509745125,20.0,20.0
16670,1,6670,[127 187 483 302 211],207,5,29379,4.40398740818468,20.0,20.0
16671,1,6671,[127 187 483 302 211],339,5,29384,4.404076738609112,20.0,20.0
16672,1,6672,[127 187 483 302 211],13,5,29389,4.404166042259853,20.0,20.0
16673,1,6673,[127 187 483 302 211],328,5,29394,4.404255319148936,20.0,20.0
16674,1,6674,[127 187 483 302 211],833,3,29397,4.4040449438202245,20.0,20.0
16675,1,6675,[127 187 483 302 211],328,5,29402,4.404134212103056,20.0,20.0
16676,1,6676,[127 187 483 302 211],343,5,29407,4.404223453646847,20.0,20.0
16677,1,6677,[127 187 483 302 211],207,5,29412,4.404312668463612,20.0,20.0
16678,1,6678,[127 187 483 302 211],6,5,29417,4.404401856565354,20.0,20.0
16679,1,6679,[ 79 180 187 211  56],207,4,29421,4.40434131736527,0.0,0.0
16680,1,6680,[100 216 603 111 172],234,2,29423,4.403981439904206,20.0,20.0
16681,1,6681,[127 187 483 302 211],524,5,29428,4.404070637533673,20.0,20.0
16682,1,6682,[127 187 483 302 211],339,5,29433,4.404159808469251,20.0,20.0
16683,1,6683,[127 187 483 302 211],666,5,29438,4.40424895272292,20.0,20.0
16684,1,6684,[127 187 483 302 211],328,5,29443,4.404338070306657,20.0,20.0
16685,1,6685,[127 187 483 302 211],210,5,29448,4.404427161232426,20.0,20.0
16686,1,6686,[127 187 483 302 211],13,5,29453,4.404516225512188,20.0,20.0
16687,1,6687,[ 56 179  64   8  98],271,4,29457,4.404455741626794,0.0,20.0
16688,1,6688,[127 187 483 302 211],90,5,29462,4.404544775003737,20.0,20.0
16689,1,6689,[127 187 483 302 211],474,5,29467,4.404633781763827,20.0,20.0
16690,1,6690,[127 187 483 302 211],13,5,29472,4.404722761918996,20.0,20.0
16691,1,6691,[216 228 322 568  64],749,5,29477,4.404811715481172,0.0,0.0
16692,1,6692,[127 187 483 302 211],343,5,29482,4.404900642462274,20.0,20.0
16693,1,6693,[127 187 483 302 211],207,5,29487,4.404989542874215,20.0,20.0
16694,1,6694,[127 187 483 302 211],524,5,29492,4.4050784167289025,20.0,20.0
16695,1,6695,[127 187 483 302 211],524,5,29497,4.405167264038232,20.0,20.0
16696,1,6696,[127 187 483 302 211],474,5,29502,4.405256084814096,20.0,20.0
16697,1,6697,[127 187 483 302 211],339,5,29507,4.4053448790683785,20.0,20.0
16698,1,6698,[282 143  95 235  89],334,2,29509,4.404985818778922,0.0,0.0
16699,1,6699,[127 187 483 302 211],343,5,29514,4.405074626865671,20.0,20.0
16700,1,6700,[318 161 228 423 100],295,5,29519,4.405163408446501,20.0,20.0
16701,1,6701,[127 187 483 302 211],13,5,29524,4.405252163533274,20.0,20.0
16702,1,6702,[ 56   9 127 216 194],194,4,29528,4.405191705206624,0.0,20.0
16703,1,6703,[127 187 483 302 211],524,5,29533,4.4052804295942725,20.0,20.0
16704,1,6704,[127 187 483 302 211],474,5,29538,4.405369127516779,20.0,20.0
16705,1,6705,[127 187 483 302 211],13,5,29543,4.405457798985982,20.0,20.0
16706,1,6706,[127 187 483 302 211],474,5,29548,4.405546444013717,20.0,20.0
16707,1,6707,[127 187 483 302 211],6,5,29553,4.405635062611807,20.0,20.0
16708,1,6708,[127 187 483 302 211],207,5,29558,4.40572365479207,20.0,20.0
16709,1,6709,[127 187 483 302 211],6,5,29563,4.405812220566319,20.0,20.0
16710,1,6710,[127 187 483 302 211],6,5,29568,4.405900759946356,20.0,20.0
16711,1,6711,[127 187 483 302 211],339,5,29573,4.405989272943981,20.0,20.0
16712,1,6712,[127 187 483 302 211],210,5,29578,4.406077759570982,20.0,20.0
16713,1,6713,[127 187 483 302 211],90,5,29583,4.406166219839142,20.0,20.0
16714,1,6714,[127 187 483 302 211],210,5,29588,4.4062546537602385,20.0,20.0
16715,1,6715,[181 405 174 655 496],194,3,29591,4.406045265038713,0.0,20.0
16716,1,6716,[127 187 483 302 211],666,5,29596,4.4061336906357,20.0,20.0
16717,1,6717,[127 187 483 302 211],833,3,29599,4.405924382256624,20.0,20.0
16718,1,6718,[282 135  56 143 508],653,2,29601,4.4055663045096,0.0,0.0
16719,1,6719,[ 22 294  95 475 202],92,1,29602,4.405059523809523,0.0,0.0
16720,1,6720,[127 187 483 302 211],666,5,29607,4.405148043445916,20.0,20.0
16721,1,6721,[127 187 483 302 211],328,5,29612,4.405236536745017,20.0,20.0
16722,1,6722,[127 187 483 302 211],6,5,29617,4.405325003718578,20.0,20.0
16723,1,6723,[271 238 191 181 161],833,2,29619,4.404967281380131,0.0,0.0
16724,1,6724,[127 187 483 302 211],207,5,29624,4.405055762081784,20.0,20.0
16725,1,6725,[127 187 483 302 211],210,5,29629,4.405144216473387,20.0,20.0
16726,1,6726,[127 187 483 302 211],6,5,29634,4.405232644566672,20.0,20.0
16727,1,6727,[127 187 483 302 211],339,5,29639,4.405321046373365,20.0,20.0
16728,1,6728,[127 187 483 302 211],666,5,29644,4.405409421905187,20.0,20.0
16729,1,6729,[127 187 483 302 211],537,5,29649,4.405497771173849,20.0,20.0
16730,1,6730,[127 187 483 302 211],833,3,29652,4.405288961521319,20.0,20.0
16731,1,6731,[127 187 483 302 211],833,3,29655,4.4050802139037435,20.0,20.0
16732,1,6732,[127 187 483 302 211],6,5,29660,4.405168572701619,20.0,20.0
16733,1,6733,[508  95 323 301 265],455,3,29663,4.404959904959905,0.0,0.0
16734,1,6734,[127 187 483 302 211],524,5,29668,4.405048255382331,20.0,20.0
16735,1,6735,[127 187 483 302 211],343,5,29673,4.405136579572447,20.0,20.0
16736,1,6736,[127 187 483 302 211],339,5,29678,4.405224877541933,20.0,20.0
16737,1,6737,[127 187 483 302 211],343,5,29683,4.405313149302463,20.0,20.0
16738,1,6738,[127 187 483 302 211],210,5,29688,4.405401394865707,20.0,20.0
16739,1,6739,[127 187 483 302 211],207,5,29693,4.405489614243323,20.0,20.0
16740,1,6740,[127 187 483 302 211],524,5,29698,4.405577807446966,20.0,20.0
16741,1,6741,[132 235  79 204  56],200,4,29702,4.4055176505487985,0.0,0.0
16742,1,6742,[127 187 483 302 211],207,5,29707,4.405605813436156,20.0,20.0
16743,1,6743,[127 187 483 302 211],328,5,29712,4.405693950177936,20.0,20.0
16744,1,6744,[237 496 322  71  70],334,1,29713,4.4051890289103035,0.0,0.0
16745,1,6745,[ 22 546 135 508  98],447,3,29716,4.404980729321079,0.0,20.0
16746,1,6746,[121 183 597  71 117],275,0,29716,4.404327849414555,0.0,0.0
16747,1,6747,[300 403 258 222 182],653,1,29717,4.403823355068169,0.0,0.0
16748,1,6748,[127 187 483 302 211],343,5,29722,4.403911690620832,20.0,20.0
16749,1,6749,[127 187 483 302 211],833,3,29725,4.4037037037037035,20.0,20.0
16750,1,6750,[127 187 483 302 211],210,5,29730,4.4037920308102505,20.0,20.0
16751,1,6751,[127 187 483 302 211],207,5,29735,4.403880331753554,20.0,20.0
16752,1,6752,[301 328 237 323  25],13,1,29736,4.403376277210129,0.0,0.0
16753,1,6753,[143 197 496 118 282],194,2,29738,4.403020432336393,0.0,0.0
16754,1,6754,[127 187 483 302 211],524,5,29743,4.403108808290155,20.0,20.0
16755,1,6755,[127 187 483 302 211],6,5,29748,4.4031971580817055,20.0,20.0
16756,1,6756,[127 187 483 302 211],833,3,29751,4.402989492378274,20.0,20.0
16757,1,6757,[127 187 483 302 211],537,5,29756,4.403077833678603,20.0,20.0
16758,1,6758,[  4 234   9  82   1],343,4,29760,4.403018197958278,0.0,0.0
16759,1,6759,[655 403 568 515 186],899,3,29763,4.402810650887574,0.0,0.0
16760,1,6760,[127 187 483 302 211],6,5,29768,4.402898979440911,20.0,20.0
16761,1,6761,[127 187 483 302 211],328,5,29773,4.40298728186927,20.0,20.0
16762,1,6762,[127 187 483 302 211],833,3,29776,4.402779831435754,20.0,20.0
16763,1,6763,[127 187 483 302 211],343,5,29781,4.402868125369603,20.0,20.0
16764,1,6764,[127 187 483 302 211],6,5,29786,4.402956393200296,20.0,20.0
16765,1,6765,[127 187 483 302 211],210,5,29791,4.403044634939403,20.0,20.0
16766,1,6766,[127 187 483 302 211],207,5,29796,4.403132850598492,20.0,20.0
16767,1,6767,[ 89  50 508  82  69],537,3,29799,4.402925531914893,0.0,20.0
16768,1,6768,[127 187 483 302 211],474,5,29804,4.403013739104742,20.0,20.0
16769,1,6769,[117  71  98 195 127],648,2,29806,4.402658788774003,0.0,40.0
16770,1,6770,[ 79 328 588 357 215],95,4,29810,4.402599320632108,20.0,0.0
16771,1,6771,[127 187 483 302 211],328,5,29815,4.402687536916716,20.0,20.0
16772,1,6772,[275 508 182 153   4],527,2,29817,4.402332791968108,0.0,0.0
16773,1,6773,[127 187 483 302 211],343,5,29822,4.402421021552997,20.0,20.0
16774,1,6774,[127 187 483 302 211],328,5,29827,4.402509225092251,20.0,20.0
16775,1,6775,[127 187 483 302 211],328,5,29832,4.402597402597403,20.0,20.0
16776,1,6776,[127 187 483 302 211],474,5,29837,4.4026855540799765,20.0,20.0
16777,1,6777,[127 187 483 302 211],339,5,29842,4.4027736795514905,20.0,20.0
16778,1,6778,[127 187 483 302 211],524,5,29847,4.402861779023455,20.0,20.0
16779,1,6779,[168 125 234   4 237],59,3,29850,4.402654867256637,0.0,0.0
16780,1,6780,[127 187 483 302 211],90,5,29855,4.402742958265742,20.0,20.0
16781,1,6781,[127 187 483 302 211],537,5,29860,4.4028310232969625,20.0,20.0
16782,1,6782,[127 187 483 302 211],207,5,29865,4.402919062361787,20.0,20.0
16783,1,6783,[127 187 483 302 211],537,5,29870,4.403007075471698,20.0,20.0
16784,1,6784,[127 187 483 302 211],210,5,29875,4.403095062638172,20.0,20.0
16785,1,6785,[127 187 483 302 211],343,5,29880,4.403183023872679,20.0,20.0
16786,1,6786,[127 187 483 302 211],524,5,29885,4.40327095918668,20.0,20.0
16787,1,6787,[127 187 483 302 211],207,5,29890,4.403358868591632,20.0,20.0
16788,1,6788,[127 187 483 302 211],13,5,29895,4.403446752098984,20.0,20.0
16789,1,6789,[127 187 483 302 211],833,3,29898,4.403240058910162,20.0,20.0
16790,1,6790,[127 187 483 302 211],328,5,29903,4.403327934030334,20.0,20.0
16791,1,6791,[127 187 483 302 211],328,5,29908,4.403415783274441,20.0,20.0
16792,1,6792,[127 187 483 302 211],833,3,29911,4.4032091859266895,20.0,20.0
16793,1,6793,[302 179 427 515   9],90,5,29916,4.4032970267883424,0.0,0.0
16794,1,6794,[127 187 483 302 427],666,5,29921,4.403384841795438,20.0,20.0
16795,1,6795,[127 187 483 302 427],664,5,29926,4.403472630959388,20.0,20.0
16796,1,6796,[127 187 483 302 427],474,5,29931,4.403560394291599,20.0,20.0
16797,1,6797,[127 187 483 427 302],669,4,29935,4.403501029714622,20.0,20.0
16798,1,6798,[127 187 483 427 302],343,5,29940,4.40358876305339,20.0,20.0
16799,1,6799,[127 187 483 427 302],666,5,29945,4.403676470588235,20.0,20.0
16800,1,6800,[265 228  82  88 216],234,0,29945,4.403028966328481,0.0,0.0
16801,1,6801,[127 187 483 427 302],474,5,29950,4.403116730373419,20.0,20.0
16802,1,6802,[127 187 483 427 302],90,5,29955,4.403204468616787,20.0,20.0
16803,1,6803,[127 187 483 427 302],339,5,29960,4.403292181069959,20.0,20.0
16804,1,6804,[742 125 180 153 508],653,1,29961,4.40279206465834,0.0,0.0
16805,1,6805,[127 187 483 427 302],343,5,29966,4.402879811930649,20.0,20.0
16806,1,6806,[127 187 483 427 302],334,5,29971,4.402967533421478,20.0,20.0
16807,1,6807,[127 187 483 427 302],90,5,29976,4.403055229142185,20.0,20.0
16808,1,6808,[127 187 483 427 302],833,3,29979,4.402849170215891,20.0,20.0
16809,1,6809,[127 187 483 302 211],666,5,29984,4.402936857562408,20.0,20.0
16810,1,6810,[127 187 483 302 211],343,5,29989,4.403024519160182,20.0,20.0
16811,1,6811,[ 82 174  56 151   7],64,3,29992,4.402818555490311,0.0,20.0
16812,1,6812,[127 187 483 302 211],90,5,29997,4.402906208718626,20.0,20.0
16813,1,6813,[176   4 222 268 655],334,3,30000,4.40270032286469,0.0,0.0
16814,1,6814,[258 302  28 202 427],666,4,30004,4.402641232575202,0.0,0.0
16815,1,6815,[423 302 127  96 111],537,2,30006,4.402288732394366,0.0,20.0
16816,1,6816,[127 187 483 302 427],13,5,30011,4.402376411911398,20.0,20.0
16817,1,6817,[258  96 265 237 195],666,1,30012,4.401877383396891,0.0,0.0
16818,1,6818,[182 318  12  89 427],194,3,30015,4.401671799384074,40.0,0.0
16819,1,6819,[127 187 483 302 427],666,5,30020,4.4017595307917885,20.0,20.0
16820,1,6820,[127 187 483 302 427],458,5,30025,4.40184723647559,20.0,20.0
16821,1,6821,[127 187 483 427 302],458,5,30030,4.401934916446789,20.0,20.0
16822,1,6822,[127 187 483 427 302],474,5,30035,4.402022570716693,20.0,20.0
16823,1,6823,[194 172 238 313 276],308,4,30039,4.401963657678781,0.0,0.0
16824,1,6824,[127 187 483 427 302],343,5,30044,4.402051282051282,20.0,20.0
16825,1,6825,[127 187 483 427 302],6,5,30049,4.402138880750074,20.0,20.0
16826,1,6826,[127 187 483 427 302],833,3,30052,4.401933499340853,20.0,20.0
16827,1,6827,[127 187 483 302 211],474,5,30057,4.4020210896309315,20.0,20.0
16828,1,6828,[ 11 483 153 515  98],90,5,30062,4.40210865426856,20.0,20.0
16829,1,6829,[127 187 483 302 211],210,5,30067,4.4021961932650076,20.0,20.0
16830,1,6830,[127 187 483 302 211],328,5,30072,4.402283706631533,20.0,20.0
16831,1,6831,[200 269 302 211 568],343,3,30075,4.402078454332552,0.0,0.0
16832,1,6832,[127 187 483 302 211],474,5,30080,4.402165959315089,20.0,20.0
16833,1,6833,[ 82 186 181 271 597],13,2,30082,4.401814457126134,0.0,0.0
16834,1,6834,[127 187 483 302 211],537,5,30087,4.401901975128018,20.0,20.0
16835,1,6835,[ 71 318  70 202 483],804,5,30092,4.401989467524868,40.0,0.0
16836,1,6836,[127 187 483 302 211],339,5,30097,4.402076934327922,20.0,20.0
16837,1,6837,[127 187 483 302 211],13,5,30102,4.402164375548406,20.0,20.0
16838,1,6838,[127 187 483 302 211],524,5,30107,4.402251791197544,20.0,20.0
16839,1,6839,[127 187 483 302 211],339,5,30112,4.40233918128655,20.0,20.0
16840,1,6840,[127 187 483 302 211],210,5,30117,4.402426545826634,20.0,20.0
16841,1,6841,[127 187 483 302 211],524,5,30122,4.4025138848289975,20.0,20.0
16842,1,6842,[144 197  79  56 222],883,4,30126,4.402455063568611,0.0,0.0
16843,1,6843,[127 187 483 302 211],339,5,30131,4.4025423728813555,20.0,20.0
16844,1,6844,[127 187 483 302 211],524,5,30136,4.402629656683711,20.0,20.0
16845,1,6845,[127 187 483 302 211],6,5,30141,4.402716914986853,20.0,20.0
16846,1,6846,[127 187 483 302 211],666,5,30146,4.402804147801957,20.0,20.0
16847,1,6847,[186 100 181  64 182],92,5,30151,4.402891355140187,0.0,20.0
16848,1,6848,[385 117   9  56 328],328,4,30155,4.4028325302963935,0.0,0.0
16849,1,6849,[127 187 483 302 211],833,3,30158,4.402627737226277,20.0,20.0
16850,1,6850,[127 187 483 302 211],13,5,30163,4.402714932126697,20.0,20.0
16851,1,6851,[127 187 483 302 211],833,3,30166,4.4025102159953295,20.0,20.0
16852,1,6852,[127 187 483 302 211],833,3,30169,4.40230555960893,20.0,20.0
16853,1,6853,[175 273  96 161  95],524,2,30171,4.401955062737088,0.0,0.0
16854,1,6854,[ 89 289 181 172 195],474,4,30175,4.401896425966448,0.0,0.0
16855,1,6855,[127 187 483 302 211],339,5,30180,4.401983663943991,20.0,20.0
16856,1,6856,[127 187 483 302 211],6,5,30185,4.402070876476594,20.0,20.0
16857,1,6857,[127 187 483 302 211],524,5,30190,4.402158063575387,20.0,20.0
16858,1,6858,[127 187 483 302 211],328,5,30195,4.4022452252514945,20.0,20.0
16859,1,6859,[127 187 483 302 211],90,5,30200,4.402332361516035,20.0,20.0
16860,1,6860,[127 187 483 302 211],207,5,30205,4.402419472380119,20.0,20.0
16861,1,6861,[186  79 222 385  56],650,3,30208,4.402215097639172,0.0,0.0
16862,1,6862,[127 187 483 302 211],207,5,30213,4.402302200203993,20.0,20.0
16863,1,6863,[174 568 135 168 185],650,3,30216,4.4020979020979025,0.0,20.0
16864,1,6864,[ 97 168 237  50  64],346,5,30221,4.402184996358339,0.0,20.0
16865,1,6865,[273 118 405  12 300],548,5,30226,4.402272065249053,20.0,0.0
16866,1,6866,[289 546   8 121 357],82,3,30229,4.402067860783457,20.0,0.0
16867,1,6867,[127 187 483 302 211],210,5,30234,4.402154921374491,20.0,20.0
16868,1,6868,[182 202 496  82 211],659,4,30238,4.402096375018198,0.0,0.0
16869,1,6869,[127 187 483 302 211],210,5,30243,4.402183406113537,20.0,20.0
16870,1,6870,[127 187 483 302 211],666,5,30248,4.4022704118760005,20.0,20.0
16871,1,6871,[127 187 483 302 211],6,5,30253,4.402357392316647,20.0,20.0
16872,1,6872,[127 187 483 302 211],343,5,30258,4.40244434744653,20.0,20.0
16873,1,6873,[127 187 483 302 211],90,5,30263,4.402531277276695,20.0,20.0
16874,1,6874,[127 187 483 302 211],339,5,30268,4.402618181818182,20.0,20.0
16875,1,6875,[127 187 483 302 211],207,5,30273,4.402705061082025,20.0,20.0
16876,1,6876,[127 187 483 302 211],666,5,30278,4.402791915079249,20.0,20.0
16877,1,6877,[127 187 483 302 211],13,5,30283,4.402878743820878,20.0,20.0
16878,1,6878,[127 187 483 302 211],13,5,30288,4.402965547317924,20.0,20.0
16879,1,6879,[127 187 483 302 211],13,5,30293,4.403052325581395,20.0,20.0
16880,1,6880,[127 187 483 302 211],474,5,30298,4.403139078622293,20.0,20.0
16881,1,6881,[515 195 132  22  98],406,3,30301,4.402935193257774,0.0,20.0
16882,1,6882,[127 187 483 302 211],328,5,30306,4.403021938108383,20.0,20.0
16883,1,6883,[127 187 483 302 211],524,5,30311,4.403108657757118,20.0,20.0
16884,1,6884,[127 187 483 302 211],13,5,30316,4.4031953522149605,20.0,20.0
16885,1,6885,[127 187 483 302 211],343,5,30321,4.403282021492884,20.0,20.0
16886,1,6886,[127 187 483 302 211],13,5,30326,4.4033686656018585,20.0,20.0
16887,1,6887,[127 187 483 302 211],339,5,30331,4.403455284552845,20.0,20.0
16888,1,6888,[127 187 483 302 211],339,5,30336,4.4035418783568,20.0,20.0
16889,1,6889,[385 183 161 546 100],295,4,30340,4.403483309143686,0.0,20.0
16890,1,6890,[111 183  28   7 197],234,3,30343,4.403279640110289,0.0,0.0
16891,1,6891,[273 121  79 200 132],666,2,30345,4.402930934416715,0.0,0.0
16892,1,6892,[127 187 483 302 211],328,5,30350,4.403017554040331,20.0,20.0
16893,1,6893,[127 187 483 302 211],343,5,30355,4.403104148534958,20.0,20.0
16894,1,6894,[282 174 144 127 143],207,4,30359,4.403045685279188,0.0,40.0
16895,1,6895,[127 187 483 302 211],13,5,30364,4.403132250580047,20.0,20.0
16896,1,6896,[ 98 172  15 286  28],194,3,30367,4.402928809627374,0.0,20.0
16897,1,6897,[127 187 483 302 211],210,5,30372,4.403015366772978,20.0,20.0
16898,1,6898,[127 187 483 302 211],537,5,30377,4.403101898825917,20.0,20.0
16899,1,6899,[127 187 483 302 211],666,5,30382,4.403188405797102,20.0,20.0
16900,1,6900,[234 194 196 118  64],454,2,30384,4.402840168091581,0.0,0.0
16901,1,6901,[127 187 483 302 211],537,5,30389,4.402926687916546,20.0,20.0
16902,1,6902,[127 187 483 302 211],6,5,30394,4.4030131826742,20.0,20.0
16903,1,6903,[127 187 483 302 211],328,5,30399,4.403099652375435,20.0,20.0
16904,1,6904,[127 187 483 302 211],339,5,30404,4.403186097031137,20.0,20.0
16905,1,6905,[127 187 483 302 211],537,5,30409,4.403272516652186,20.0,20.0
16906,1,6906,[127 187 483 302 211],474,5,30414,4.403358911249457,20.0,20.0
16907,1,6907,[143 132  22   1 204],454,3,30417,4.403155761436016,0.0,0.0
16908,1,6908,[127 187 483 302 211],474,5,30422,4.403242147922999,20.0,20.0
16909,1,6909,[127 187 483 302 211],833,3,30425,4.403039073806078,20.0,20.0
16910,1,6910,[127 187 483 302 211],339,5,30430,4.4031254521776875,20.0,20.0
16911,1,6911,[127 187 483 302 211],210,5,30435,4.403211805555555,20.0,20.0
16912,1,6912,[127 187 483 302 211],524,5,30440,4.403298133950528,20.0,20.0
16913,1,6913,[127 187 483 302 211],90,5,30445,4.403384437373445,20.0,20.0
16914,1,6914,[127 187 483 302 211],6,5,30450,4.403470715835141,20.0,20.0
16915,1,6915,[127 187 483 302 211],90,5,30455,4.403556969346443,20.0,20.0
16916,1,6916,[385 405  12  22 655],474,5,30460,4.403643197918172,20.0,0.0
16917,1,6917,[127 187 483 302 211],666,5,30465,4.403729401561145,20.0,20.0
16918,1,6918,[127 187 483 302 211],328,5,30470,4.403815580286168,20.0,20.0
16919,1,6919,[127 187 483 302 211],474,5,30475,4.403901734104046,20.0,20.0
16920,1,6920,[127 187 483 302 211],537,5,30480,4.403987863025574,20.0,20.0
16921,1,6921,[127 187 483 302 211],13,5,30485,4.404073967061543,20.0,20.0
16922,1,6922,[127 187 483 302 211],537,5,30490,4.404160046222736,20.0,20.0
16923,1,6923,[127 187 483 302 211],13,5,30495,4.404246100519931,20.0,20.0
16924,1,6924,[127 187 483 302 211],328,5,30500,4.404332129963899,20.0,20.0
16925,1,6925,[127 187 483 302 211],328,5,30505,4.404418134565406,20.0,20.0
16926,1,6926,[237  79  50 678 151],664,3,30508,4.404215389057312,0.0,20.0
16927,1,6927,[ 28 427 132 191 496],694,5,30513,4.404301385681293,0.0,0.0
16928,1,6928,[143  28  22   7 182],881,4,30517,4.404243036513205,0.0,0.0
16929,1,6929,[127 187 483 302 211],343,5,30522,4.404329004329004,20.0,20.0
16930,1,6930,[127 187 483 302 211],524,5,30527,4.404414947338046,20.0,20.0
16931,1,6931,[127 187 483 302 211],537,5,30532,4.404500865551068,20.0,20.0
16932,1,6932,[127 187 483 302 211],328,5,30537,4.404586758978797,20.0,20.0
16933,1,6933,[127 187 483 302 211],6,5,30542,4.4046726276319585,20.0,20.0
16934,1,6934,[127 187 483 302 211],207,5,30547,4.404758471521269,20.0,20.0
16935,1,6935,[127 187 483 302 211],524,5,30552,4.404844290657439,20.0,20.0
16936,1,6936,[127 117 196  88 197],308,2,30554,4.4044976214501945,0.0,20.0
16937,1,6937,[127 187 483 302 211],524,5,30559,4.404583453444797,20.0,20.0
16938,1,6938,[127 187 483 302 211],13,5,30564,4.404669260700389,20.0,20.0
16939,1,6939,[127 187 483 302 211],207,5,30569,4.404755043227666,20.0,20.0
16940,1,6940,[127 187 483 302 211],328,5,30574,4.404840801037315,20.0,20.0
16941,1,6941,[127 187 483 302 211],207,5,30579,4.404926534140017,20.0,20.0
16942,1,6942,[127 187 483 302 211],13,5,30584,4.40501224254645,20.0,20.0
16943,1,6943,[127 187 483 302 211],339,5,30589,4.405097926267281,20.0,20.0
16944,1,6944,[127 187 483 302 211],524,5,30594,4.405183585313175,20.0,20.0
16945,1,6945,[127 187 483 302 211],343,5,30599,4.405269219694788,20.0,20.0
16946,1,6946,[127 187 483 302 211],13,5,30604,4.405354829422772,20.0,20.0
16947,1,6947,[127 187 483 302 211],524,5,30609,4.405440414507772,20.0,20.0
16948,1,6948,[127 187 483 302 211],524,5,30614,4.405525974960426,20.0,20.0
16949,1,6949,[127 187 483 302 211],6,5,30619,4.405611510791367,20.0,20.0
16950,1,6950,[127 187 483 302 211],90,5,30624,4.405697022011221,20.0,20.0
16951,1,6951,[127 187 483 302 211],474,5,30629,4.40578250863061,20.0,20.0
16952,1,6952,[127 187 483 302 211],90,5,30634,4.405867970660147,20.0,20.0
16953,1,6953,[127 187 483 302 211],210,5,30639,4.40595340811044,20.0,20.0
16954,1,6954,[127 187 483 302 211],524,5,30644,4.406038820992092,20.0,20.0
16955,1,6955,[515  71 318 282  98],334,4,30648,4.40598044853364,20.0,20.0
16956,1,6956,[100 151  12  98  50],234,3,30651,4.405778352738249,20.0,60.0
16957,1,6957,[172 127 435  95 174],59,4,30655,4.405720034492671,0.0,40.0
16958,1,6958,[273  15 282 471 222],479,4,30659,4.405661733007616,0.0,0.0
16959,1,6959,[127 187 483 302 211],537,5,30664,4.405747126436782,20.0,20.0
16960,1,6960,[222 127 603 245 174],749,4,30668,4.40568883781066,20.0,40.0
16961,1,6961,[127 187 483 302 211],833,3,30671,4.405486929043378,20.0,20.0
16962,1,6962,[127 187 483 302 211],207,5,30676,4.405572310785581,20.0,20.0
16963,1,6963,[127 187 483 302 211],666,5,30681,4.405657668006892,20.0,20.0
16964,1,6964,[135 180 257 597  82],92,2,30683,4.405312275664034,0.0,0.0
16965,1,6965,[127 187 483 302 211],90,5,30688,4.4053976457077235,20.0,20.0
16966,1,6966,[127 187 483 302 211],474,5,30693,4.405482991244438,20.0,20.0
16967,1,6967,[127 187 483 302 211],13,5,30698,4.40556831228473,20.0,20.0
16968,1,6968,[127 187 483 302 211],13,5,30703,4.4056536088391445,20.0,20.0
16969,1,6969,[127 187 483 302 211],210,5,30708,4.4057388809182205,20.0,20.0
16970,1,6970,[496 515 185  11 313],308,2,30710,4.405393774207431,0.0,0.0
16971,1,6971,[  4   9 196 216 211],533,4,30714,4.405335628227195,0.0,0.0
16972,1,6972,[127 187 483 302 211],524,5,30719,4.405420909221282,20.0,20.0
16973,1,6973,[127 187 483 302 211],13,5,30724,4.405506165758531,20.0,20.0
16974,1,6974,[127 187 483 302 211],207,5,30729,4.405591397849462,20.0,20.0
16975,1,6975,[216 357 655 153 238],479,4,30733,4.405533256880734,20.0,0.0
16976,1,6976,[111 302 211 276 180],474,5,30738,4.405618460656442,0.0,0.0
16977,1,6977,[127 187 483 302 211],833,3,30741,4.405417024935511,20.0,20.0
16978,1,6978,[127 187 483 302 211],90,5,30746,4.40550222094856,20.0,20.0
16979,1,6979,[127 187 483 302 211],524,5,30751,4.405587392550143,20.0,20.0
16980,1,6980,[127 187 483 302 211],474,5,30756,4.405672539750752,20.0,20.0
16981,1,6981,[127 187 483 302 211],537,5,30761,4.4057576625608705,20.0,20.0
16982,1,6982,[127 187 483 302 211],13,5,30766,4.4058427609909785,20.0,20.0
16983,1,6983,[127 187 483 302 211],833,3,30769,4.405641466208476,20.0,20.0
16984,1,6984,[127 187 483 302 211],666,5,30774,4.405726556907659,20.0,20.0
16985,1,6985,[127 187 483 302 211],833,3,30777,4.4055253363870595,20.0,20.0
16986,1,6986,[588 176 238  50 471],308,4,30781,4.405467296407614,0.0,20.0
16987,1,6987,[127 187 483 302 211],90,5,30786,4.405552375500859,20.0,20.0
16988,1,6988,[333  98 132 403 357],653,2,30788,4.405208184289598,20.0,20.0
16989,1,6989,[127 187 483 302 211],6,5,30793,4.4052932761087265,20.0,20.0
16990,1,6990,[127 187 483 302 211],537,5,30798,4.405378343584609,20.0,20.0
16991,1,6991,[127 187 483 302 211],328,5,30803,4.405463386727689,20.0,20.0
16992,1,6992,[127 187 483 302 211],6,5,30808,4.405548405548406,20.0,20.0
16993,1,6993,[127 187 483 302 211],524,5,30813,4.405633400057192,20.0,20.0
16994,1,6994,[286 288 200   7 276],13,1,30814,4.405146533238027,0.0,0.0
16995,1,6995,[ 11 748 275  79 127],883,4,30818,4.405088622069754,0.0,20.0
16996,1,6996,[ 56  98 423 197 191],234,4,30822,4.405030727454624,0.0,20.0
16997,1,6997,[210  50 197 275 237],318,4,30826,4.404972849385539,0.0,20.0
16998,1,6998,[  1 228 483  70 185],479,5,30831,4.405057865409344,20.0,0.0
16999,1,6999,[127 187 483 302 211],666,5,30836,4.405142857142857,20.0,20.0
17000,1,7000,[127 187 483 302 211],210,5,30841,4.405227824596486,20.0,20.0
17001,1,7001,[127 187 483 302 211],328,5,30846,4.405312767780634,20.0,20.0
17002,1,7002,[127 187 483 302 211],207,5,30851,4.405397686705697,20.0,20.0
17003,1,7003,[127 187 483 302 211],537,5,30856,4.405482581382067,20.0,20.0
17004,1,7004,[127 187 483 302 211],833,3,30859,4.4052819414703785,20.0,20.0
17005,1,7005,[238 117  89 132 210],892,5,30864,4.405366828432772,0.0,0.0
17006,1,7006,[ 50 403 118 211 181],901,3,30867,4.40516626230912,0.0,20.0
17007,1,7007,[ 82 143 603 179   1],536,4,30871,4.405108447488584,20.0,0.0
17008,1,7008,[127 187 483 302 211],339,5,30876,4.405193322870595,20.0,20.0
17009,1,7009,[127 187 483 302 211],537,5,30881,4.40527817403709,20.0,20.0
17010,1,7010,[127 187 483 302 211],343,5,30886,4.405363000998431,20.0,20.0
17011,1,7011,[127 187 483 302 211],474,5,30891,4.405447803764974,20.0,20.0
17012,1,7012,[181 191 216 215 125],653,2,30893,4.405104805361471,0.0,0.0
17013,1,7013,[127 187 483 302 211],666,5,30898,4.405189620758483,20.0,20.0
17014,1,7014,[127 187 483 302 211],666,5,30903,4.40527441197434,20.0,20.0
17015,1,7015,[127 187 483 302 211],328,5,30908,4.405359179019384,20.0,20.0
17016,1,7016,[127 187 483 302 211],524,5,30913,4.405443921903948,20.0,20.0
17017,1,7017,[313  64 173  89 483],234,3,30916,4.405243659162155,20.0,0.0
17018,1,7018,[127 187 483 302 211],537,5,30921,4.405328394358171,20.0,20.0
17019,1,7019,[127  96   7 508 385],774,1,30922,4.404843304843305,0.0,20.0
17020,1,7020,[127 187 483 302 211],210,5,30927,4.4049280729240845,20.0,20.0
17021,1,7021,[127 187 483 302 211],343,5,30932,4.405012816861293,20.0,20.0
17022,1,7022,[127 187 483 302 211],524,5,30937,4.4050975366652425,20.0,20.0
17023,1,7023,[127 187 483 302 211],6,5,30942,4.405182232346242,20.0,20.0
17024,1,7024,[127 187 483 302 211],328,5,30947,4.40526690391459,20.0,20.0
17025,1,7025,[318  71 175   7 211],234,1,30948,4.4047822374039285,20.0,0.0
17026,1,7026,[127 187 483 302 211],328,5,30953,4.40486694179593,20.0,20.0
17027,1,7027,[483 546 471 282 125],194,1,30954,4.404382470119522,20.0,0.0
17028,1,7028,[ 89 168 143 100 427],234,2,30956,4.404040404040404,0.0,20.0
17029,1,7029,[127 187 483 302 211],524,5,30961,4.404125177809388,20.0,20.0
17030,1,7030,[127 187 483 302 211],666,5,30966,4.404209927464088,20.0,20.0
17031,1,7031,[127 187 483 302 211],210,5,30971,4.40429465301479,20.0,20.0
17032,1,7032,[127 187 483 302 211],537,5,30976,4.404379354471776,20.0,20.0
17033,1,7033,[187 174 245 294 196],749,3,30979,4.404179698606767,0.0,20.0
17034,1,7034,[127 187 483 302 211],537,5,30984,4.404264392324094,20.0,20.0
17035,1,7035,[127 187 483 302 211],343,5,30989,4.404349061967027,20.0,20.0
17036,1,7036,[127 187 483 302 211],328,5,30994,4.404433707545829,20.0,20.0
17037,1,7037,[275 245 172 235 216],334,1,30995,4.403949985791418,0.0,0.0
17038,1,7038,[127 187 483 302 211],339,5,31000,4.404034664014775,20.0,20.0
17039,1,7039,[127 187 483 302 211],210,5,31005,4.404119318181818,20.0,20.0
17040,1,7040,[127 187 483 302 211],6,5,31010,4.404203948302798,20.0,20.0
17041,1,7041,[173 186 181 175 172],378,4,31014,4.404146549275774,0.0,0.0
17042,1,7042,[127 187 483 302 211],524,5,31019,4.4042311514979415,20.0,20.0
17043,1,7043,[211 222 496  82  12],234,1,31020,4.403747870528109,20.0,0.0
17044,1,7044,[127 187 483 302 211],328,5,31025,4.403832505322924,20.0,20.0
17045,1,7045,[127 187 483 302 211],13,5,31030,4.403917116094238,20.0,20.0
17046,1,7046,[127 187 483 302 211],833,3,31033,4.40371789413935,20.0,20.0
17047,1,7047,[151 174 100 118 655],664,3,31036,4.4035187287173665,0.0,40.0
17048,1,7048,[127 187 483 302 211],343,5,31041,4.403603347992623,20.0,20.0
17049,1,7049,[  4  50 180 423 215],385,1,31042,4.403120567375886,0.0,20.0
17050,1,7050,[127 187 483 302 211],90,5,31047,4.403205219117855,20.0,20.0
17051,1,7051,[405 121 215 187 176],537,1,31048,4.402722631877482,0.0,0.0
17052,1,7052,[127 187 483 302 211],833,3,31051,4.402523748759394,20.0,20.0
17053,1,7053,[127 187 483 302 211],474,5,31056,4.402608449106889,20.0,20.0
17054,1,7054,[144 435 211  64 216],234,1,31057,4.4021261516654855,0.0,0.0
17055,1,7055,[127 187 483 302 211],90,5,31062,4.4022108843537415,20.0,20.0
17056,1,7056,[127 187 483 302 211],6,5,31067,4.402295593028199,20.0,20.0
17057,1,7057,[ 15 405 151  96  25],533,3,31070,4.402096911306319,0.0,0.0
17058,1,7058,[127 187 483 302 211],339,5,31075,4.4021816121263635,20.0,20.0
17059,1,7059,[127 187 483 302 211],207,5,31080,4.402266288951841,20.0,20.0
17060,1,7060,[127 187 483 302 211],328,5,31085,4.402350941792947,20.0,20.0
17061,1,7061,[127 187 483 302 211],328,5,31090,4.40243557065987,20.0,20.0
17062,1,7062,[322 216 121 194 742],308,2,31092,4.4020954268724335,0.0,0.0
17063,1,7063,[127 187 483 302 211],343,5,31097,4.4021800679501695,20.0,20.0
17064,1,7064,[127 187 483 302 211],524,5,31102,4.402264685067233,20.0,20.0
17065,1,7065,[286  89 294 265 273],102,1,31103,4.401783187093122,0.0,0.0
17066,1,7066,[127 187 483 302 211],90,5,31108,4.40186783642281,20.0,20.0
17067,1,7067,[127 187 483 302 211],833,3,31111,4.401669496321449,20.0,20.0
17068,1,7068,[127 187 483 302 211],13,5,31116,4.401754137784693,20.0,20.0
17069,1,7069,[127 187 483 302 211],339,5,31121,4.401838755304102,20.0,20.0
17070,1,7070,[200  89 204 216 210],694,5,31126,4.401923348889832,0.0,0.0
17071,1,7071,[127 187 483 302 211],343,5,31131,4.402007918552036,20.0,20.0
17072,1,7072,[127 187 483 302 211],474,5,31136,4.402092464300862,20.0,20.0
17073,1,7073,[127 187 483 302 211],13,5,31141,4.4021769861464515,20.0,20.0
17074,1,7074,[127 187 483 302 211],339,5,31146,4.40226148409894,20.0,20.0
17075,1,7075,[127 187 483 302 211],524,5,31151,4.402345958168457,20.0,20.0
17076,1,7076,[174 191 194  69  70],85,5,31156,4.4024304083651264,0.0,20.0
17077,1,7077,[127 187 483 302 211],328,5,31161,4.402514834699067,20.0,20.0
17078,1,7078,[127 187 483 302 211],833,3,31164,4.402316711399915,20.0,20.0
17079,1,7079,[127 187 483 302 211],207,5,31169,4.402401129943502,20.0,20.0
17080,1,7080,[127 187 483 302 211],474,5,31174,4.402485524643412,20.0,20.0
17081,1,7081,[127 187 483 302 211],90,5,31179,4.402569895509743,20.0,20.0
17082,1,7082,[127 187 483 302 211],207,5,31184,4.4026542425525905,20.0,20.0
17083,1,7083,[127 187 483 302 211],524,5,31189,4.402738565782044,20.0,20.0
17084,1,7084,[127 187 483 302 211],6,5,31194,4.402822865208186,20.0,20.0
17085,1,7085,[127 187 483 302 211],90,5,31199,4.402907140841095,20.0,20.0
17086,1,7086,[127 187 483 302 211],210,5,31204,4.402991392690843,20.0,20.0
17087,1,7087,[176 185 289 181 300],537,1,31205,4.402511286681715,0.0,0.0
17088,1,7088,[127 187 483 302 211],90,5,31210,4.402595570602342,20.0,20.0
17089,1,7089,[127 187 483 302 211],90,5,31215,4.402679830747532,20.0,20.0
17090,1,7090,[127 187 483 302 211],6,5,31220,4.402764067127345,20.0,20.0
17091,1,7091,[127 187 483 302 211],210,5,31225,4.402848279751833,20.0,20.0
17092,1,7092,[127  97 182  25 168],95,3,31228,4.402650500493444,0.0,20.0
17093,1,7093,[127 187 483 302 211],833,3,31231,4.402452776994643,20.0,20.0
17094,1,7094,[ 88 546 144 385   7],102,0,31231,4.401832276250881,0.0,0.0
17095,1,7095,[200 222 181  89 185],313,3,31234,4.4016347237880495,0.0,0.0
17096,1,7096,[403 187 273  12 588],387,3,31237,4.401437226997323,20.0,0.0
17097,1,7097,[127 187 483 302 211],833,3,31240,4.401239785855171,20.0,20.0
17098,1,7098,[127 187 483 302 211],207,5,31245,4.4013241301591775,20.0,20.0
17099,1,7099,[ 70  15 117 210 175],234,0,31245,4.400704225352112,0.0,0.0
17100,1,7100,[127 187 483 302 211],537,5,31250,4.400788621320941,20.0,20.0
17101,1,7101,[127 187 483 302 211],833,3,31253,4.400591382709096,20.0,20.0
17102,1,7102,[127 187 483 302 211],6,5,31258,4.40067577080107,20.0,20.0
17103,1,7103,[127 187 483 302 211],474,5,31263,4.400760135135135,20.0,20.0
17104,1,7104,[127 187 483 302 211],328,5,31268,4.400844475721323,20.0,20.0
17105,1,7105,[127 187 483 302 211],474,5,31273,4.400928792569659,20.0,20.0
17106,1,7106,[168   9 183  69 568],379,5,31278,4.401013085690165,0.0,0.0
17107,1,7107,[127 187 483 302 211],833,3,31281,4.400815981992122,20.0,20.0
17108,1,7108,[127 187 483 302 211],339,5,31286,4.400900267266845,20.0,20.0
17109,1,7109,[127 187 483 302 211],666,5,31291,4.40098452883263,20.0,20.0
17110,1,7110,[127 187 483 302 211],210,5,31296,4.401068766699479,20.0,20.0
17111,1,7111,[127 187 483 302 211],524,5,31301,4.401152980877391,20.0,20.0
17112,1,7112,[235 496 143 515 135],290,3,31304,4.400955996063546,0.0,0.0
17113,1,7113,[127 187 483 302 211],339,5,31309,4.401040202417768,20.0,20.0
17114,1,7114,[ 22 234 427 143 196],13,4,31313,4.40098383696416,0.0,0.0
17115,1,7115,[127 187 483 302 211],339,5,31318,4.401068015739179,20.0,20.0
17116,1,7116,[127 187 483 302 211],13,5,31323,4.4011521708585075,20.0,20.0
17117,1,7117,[294 228 405  11 435],102,1,31324,4.400674346726609,0.0,0.0
17118,1,7118,[127 187 483 302 211],339,5,31329,4.400758533501897,20.0,20.0
17119,1,7119,[268 323 202  70 234],537,2,31331,4.400421348314607,0.0,0.0
17120,1,7120,[127 187 483 302 211],13,5,31336,4.40050554697374,20.0,20.0
17121,1,7121,[127 187 483 302 211],524,5,31341,4.400589721988205,20.0,20.0
17122,1,7122,[127 187 483 302 211],343,5,31346,4.400673873367963,20.0,20.0
17123,1,7123,[168 273   7  11 185],7,3,31349,4.400477259966311,0.0,0.0
17124,1,7124,[175   4  79 211 183],308,5,31354,4.400561403508772,0.0,0.0
17125,1,7125,[127 187 483 302 211],207,5,31359,4.4006455234353075,20.0,20.0
17126,1,7126,[127 187 483 302 211],210,5,31364,4.400729619755858,20.0,20.0
17127,1,7127,[238 273 603  71 678],387,3,31367,4.400533108866442,20.0,0.0
17128,1,7128,[127 187 483 302 211],666,5,31372,4.400617197362884,20.0,20.0
17129,1,7129,[127 187 483 302 211],13,5,31377,4.40070126227209,20.0,20.0
17130,1,7130,[127 187 483 302 211],90,5,31382,4.400785303603983,20.0,20.0
17131,1,7131,[127 187 483 302 211],13,5,31387,4.40086932136848,20.0,20.0
17132,1,7132,[127 187 483 302 211],537,5,31392,4.400953315575494,20.0,20.0
17133,1,7133,[127 187 483 302 211],207,5,31397,4.401037286234931,20.0,20.0
17134,1,7134,[121 118 135 181  25],881,4,31401,4.400981079187106,0.0,0.0
17135,1,7135,[127 187 483 302 211],833,3,31404,4.4007847533632285,20.0,20.0
17136,1,7136,[265 210 135  89 118],59,5,31409,4.400868712344122,0.0,0.0
17137,1,7137,[127 187 483 302 211],343,5,31414,4.400952647800504,20.0,20.0
17138,1,7138,[127 187 483 302 211],13,5,31419,4.401036559742261,20.0,20.0
17139,1,7139,[258 496 215 181 132],215,3,31422,4.400840336134454,0.0,0.0
17140,1,7140,[127 187 483 302 211],537,5,31427,4.400924240302479,20.0,20.0
17141,1,7141,[127 187 483 302 211],339,5,31432,4.401008120974517,20.0,20.0
17142,1,7142,[127 187 483 302 211],666,5,31437,4.401091978160437,20.0,20.0
17143,1,7143,[471 135 176 475   1],374,4,31441,4.4010358342665175,0.0,0.0
17144,1,7144,[175   7 186 245 269],10,4,31445,4.400979706088173,0.0,0.0
17145,1,7145,[127 187 483 302 211],537,5,31450,4.4010635320458995,20.0,20.0
17146,1,7146,[127 187 483 302 211],537,5,31455,4.401147334545963,20.0,20.0
17147,1,7147,[127 187 483 302 211],6,5,31460,4.401231113598209,20.0,20.0
17148,1,7148,[127 187 483 302 211],339,5,31465,4.401314869212477,20.0,20.0
17149,1,7149,[127 187 483 302 211],90,5,31470,4.4013986013986015,20.0,20.0
17150,1,7150,[127 187 483 302 211],328,5,31475,4.4014823101664104,20.0,20.0
17151,1,7151,[127 187 483 302 211],207,5,31480,4.401565995525727,20.0,20.0
17152,1,7152,[127 187 483 302 211],6,5,31485,4.401649657486369,20.0,20.0
17153,1,7153,[127 187 483 302 211],343,5,31490,4.40173329605815,20.0,20.0
17154,1,7154,[265  28  15 174 175],447,3,31493,4.401537386443047,0.0,20.0
17155,1,7155,[127 187 483 302 211],207,5,31498,4.401621017328116,20.0,20.0
17156,1,7156,[ 98 135 742 196 121],533,4,31502,4.40156490149504,0.0,20.0
17157,1,7157,[127 187 483 302 211],474,5,31507,4.4016485051690415,20.0,20.0
17158,1,7158,[318 182 483  12 276],59,5,31512,4.4017320854868,60.0,0.0
17159,1,7159,[127 187 483 302 211],343,5,31517,4.401815642458101,20.0,20.0
17160,1,7160,[127 187 483 302 211],833,3,31520,4.401619885490853,20.0,20.0
17161,1,7161,[127 187 483 302 211],343,5,31525,4.40170343479475,20.0,20.0
17162,1,7162,[323 161  88 191 568],454,4,31529,4.4016473544604215,0.0,0.0
17163,1,7163,[ 11 211 228 210 258],749,5,31534,4.4017308766052485,0.0,0.0
17164,1,7164,[216  88 234 121 180],881,3,31537,4.401535240753663,0.0,0.0
17165,1,7165,[176  12 168 215 125],234,0,31537,4.400921015908456,20.0,0.0
17166,1,7166,[127 187 483 302 211],90,5,31542,4.401004604437003,20.0,20.0
17167,1,7167,[127 187 483 302 211],474,5,31547,4.401088169642857,20.0,20.0
17168,1,7168,[172  12   9 125 423],234,1,31548,4.400613753661599,20.0,0.0
17169,1,7169,[127 187 483 302 211],833,3,31551,4.400418410041841,20.0,20.0
17170,1,7170,[127 187 483 302 427],458,5,31556,4.400502022033189,20.0,20.0
17171,1,7171,[127 187 483 302 427],6,5,31561,4.40058561070831,20.0,20.0
17172,1,7172,[127 187 483 302 427],13,5,31566,4.400669176076955,20.0,20.0
17173,1,7173,[127 187 483 302 427],664,5,31571,4.400752718148871,20.0,20.0
17174,1,7174,[127 187 483 302 427],328,4,31575,4.400696864111498,20.0,20.0
17175,1,7175,[127 187 483 302 211],474,5,31580,4.400780379041248,20.0,20.0
17176,1,7176,[117  11 168 313 202],92,4,31584,4.400724536714504,0.0,0.0
17177,1,7177,[ 28 471  98 238 100],537,2,31586,4.400390080802452,0.0,40.0
17178,1,7178,[ 96  98 179 597 200],774,2,31588,4.400055718066583,0.0,20.0
17179,1,7179,[127 187 483 302 211],343,5,31593,4.4001392757660165,20.0,20.0
17180,1,7180,[127 187 483 302 211],6,5,31598,4.400222810193567,20.0,20.0
17181,1,7181,[127 187 483 302 211],339,5,31603,4.400306321358953,20.0,20.0
17182,1,7182,[127 187 483 302 211],210,5,31608,4.400389809271892,20.0,20.0
17183,1,7183,[202  69 655 172 174],42,4,31612,4.400334075723831,0.0,20.0
17184,1,7184,[127 187 483 302 211],339,5,31617,4.400417536534447,20.0,20.0
17185,1,7185,[204 258 210 294 216],659,5,31622,4.400500974116337,0.0,0.0
17186,1,7186,[ 82 257 288 228 161],455,4,31626,4.400445248365104,0.0,0.0
17187,1,7187,[127 187 483 302 211],833,3,31629,4.400250417362271,20.0,20.0
17188,1,7188,[127 187 483 302 211],328,5,31634,4.400333843371818,20.0,20.0
17189,1,7189,[127 187 483 302 211],474,5,31639,4.400417246175244,20.0,20.0
17190,1,7190,[127 187 483 302 211],666,5,31644,4.400500625782228,20.0,20.0
17191,1,7191,[127 187 483 302 211],666,5,31649,4.4005839822024475,20.0,20.0
17192,1,7192,[ 64 197 288 508 175],343,4,31653,4.400528291394411,0.0,0.0
17193,1,7193,[127 187 483 302 211],474,5,31658,4.400611620795107,20.0,20.0
17194,1,7194,[127 187 483 302 211],6,5,31663,4.400694927032662,20.0,20.0
17195,1,7195,[127 187 483 302 211],524,5,31668,4.400778210116732,20.0,20.0
17196,1,7196,[127 187 483 302 211],328,5,31673,4.400861470056968,20.0,20.0
17197,1,7197,[ 96 191 238 228  98],804,5,31678,4.400944706863018,0.0,20.0
17198,1,7198,[127 187 483 302 211],343,5,31683,4.40102792054452,20.0,20.0
17199,1,7199,[127 187 483 302 211],6,5,31688,4.401111111111111,20.0,20.0
17200,1,7200,[195 475  71 174 748],92,4,31692,4.401055408970977,0.0,20.0
17201,1,7201,[655 186 143 173   9],406,1,31693,4.400583171341294,0.0,0.0
17202,1,7202,[127 187 483 302 211],6,5,31698,4.400666389004582,20.0,20.0
17203,1,7203,[127 187 483 302 211],328,5,31703,4.400749583564687,20.0,20.0
17204,1,7204,[  1 202 135 180  82],343,5,31708,4.400832755031228,0.0,0.0
17205,1,7205,[127 187 483 302 211],666,5,31713,4.400915903413821,20.0,20.0
17206,1,7206,[127 187 483 302 211],210,5,31718,4.400999028722076,20.0,20.0
17207,1,7207,[588 222  69 271 168],13,3,31721,4.4008046614872365,0.0,0.0
17208,1,7208,[127 187 483 302 211],6,5,31726,4.400887779164933,20.0,20.0
17209,1,7209,[127 187 483 302 211],328,5,31731,4.400970873786408,20.0,20.0
17210,1,7210,[176 174 403 678  88],92,3,31734,4.400776591318818,0.0,20.0
17211,1,7211,[ 96 655  89 215 202],95,4,31738,4.400721020521353,0.0,0.0
17212,1,7212,[127 187 483 302 211],328,5,31743,4.40080410370165,20.0,20.0
17213,1,7213,[127 187 483 302 211],537,5,31748,4.400887163848073,20.0,20.0
17214,1,7214,[ 95 180 135 211 748],749,3,31751,4.400693000693001,0.0,0.0
17215,1,7215,[127 187 483 302 211],537,5,31756,4.400776053215077,20.0,20.0
17216,1,7216,[127 187 483 302 211],210,5,31761,4.400859082721352,20.0,20.0
17217,1,7217,[174  11 117 275 153],406,3,31764,4.400665004156276,0.0,20.0
17218,1,7218,[127 187 483 302 211],524,5,31769,4.400748026042388,20.0,20.0
17219,1,7219,[183 273 180  15 174],92,4,31773,4.400692520775623,0.0,20.0
17220,1,7220,[180 127 265  69 588],59,4,31777,4.400637030882149,0.0,20.0
17221,1,7221,[423 237 258 161  95],13,5,31782,4.400720022154528,0.0,0.0
17222,1,7222,[127 187 483 302 211],474,5,31787,4.400802990447183,20.0,20.0
17223,1,7223,[288 117  70 678 200],28,3,31790,4.400609080841639,0.0,0.0
17224,1,7224,[127 187 483 302 211],210,5,31795,4.4006920415224915,20.0,20.0
17225,1,7225,[127 187 483 302 211],6,5,31800,4.4007749792416275,20.0,20.0
17226,1,7226,[204 196 423  50 181],59,5,31805,4.4008578940085785,0.0,20.0
17227,1,7227,[127 187 483 302 211],6,5,31810,4.400940785832872,20.0,20.0
17228,1,7228,[127 187 483 302 211],666,5,31815,4.401023654724028,20.0,20.0
17229,1,7229,[127 187 483 302 211],13,5,31820,4.401106500691563,20.0,20.0
17230,1,7230,[328 483 471 125 237],294,4,31824,4.4010510302862675,20.0,0.0
17231,1,7231,[127 187 483 302 211],207,5,31829,4.401133849557522,20.0,20.0
17232,1,7232,[127 187 483 302 211],537,5,31834,4.4012166459283835,20.0,20.0
17233,1,7233,[127 187 483 302 211],339,5,31839,4.40129941940835,20.0,20.0
17234,1,7234,[127 187 483 302 211],524,5,31844,4.401382170006911,20.0,20.0
17235,1,7235,[357  70 300 268 187],234,2,31846,4.401050304035379,20.0,0.0
17236,1,7236,[127 187 483 302 211],524,5,31851,4.401133066187647,20.0,20.0
17237,1,7237,[127 187 483 302 211],833,3,31854,4.400939486045869,20.0,20.0
17238,1,7238,[127 187 483 302 211],343,5,31859,4.401022240640972,20.0,20.0
17239,1,7239,[127 187 483 302 211],537,5,31864,4.40110497237569,20.0,20.0
17240,1,7240,[127 187 483 302 211],474,5,31869,4.401187681259494,20.0,20.0
17241,1,7241,[127 187 483 302 211],207,5,31874,4.4012703673018505,20.0,20.0
17242,1,7242,[127 187 483 302 211],524,5,31879,4.401353030512219,20.0,20.0
17243,1,7243,[127 187 483 302 211],343,5,31884,4.401435670900055,20.0,20.0
17244,1,7244,[127 187 483 302 211],328,5,31889,4.4015182884748105,20.0,20.0
17245,1,7245,[168  97 427 265 276],533,2,31891,4.401186861716809,0.0,0.0
17246,1,7246,[144 187 234 655 175],194,3,31894,4.400993514557748,0.0,0.0
17247,1,7247,[127 187 483 302 211],474,5,31899,4.4010761589403975,20.0,20.0
17248,1,7248,[127 187 483 302 211],210,5,31904,4.401158780521452,20.0,20.0
17249,1,7249,[603 286 273 204  98],387,3,31907,4.40096551724138,20.0,20.0
17250,1,7250,[127 187 483 302 211],328,5,31912,4.401048131292235,20.0,20.0
17251,1,7251,[127 187 483 302 211],537,5,31917,4.401130722559294,20.0,20.0
17252,1,7252,[423 496 172 238 176],666,3,31920,4.40093754308562,0.0,0.0
17253,1,7253,[ 97 471  88 258 257],343,4,31924,4.400882271850014,0.0,0.0
17254,1,7254,[127 187 483 302 211],13,5,31929,4.400964851826327,20.0,20.0
17255,1,7255,[127 187 483 302 211],210,5,31934,4.401047409040793,20.0,20.0
17256,1,7256,[ 22 183 144  70 273],328,4,31938,4.400992145514675,0.0,0.0
17257,1,7257,[127 187 483 302 211],343,5,31943,4.401074676219344,20.0,20.0
17258,1,7258,[ 64 276  69 216  82],308,3,31946,4.400881664141067,0.0,0.0
17259,1,7259,[127 187 483 302 211],666,5,31951,4.400964187327824,20.0,20.0
17260,1,7260,[127 187 483 302 211],474,5,31956,4.401046687784052,20.0,20.0
17261,1,7261,[127 187 483 302 211],524,5,31961,4.401129165519141,20.0,20.0
17262,1,7262,[173 181  82 195 328],207,0,31961,4.400523199779705,0.0,0.0
17263,1,7263,[127 187 483 302 211],666,5,31966,4.4006057268722465,20.0,20.0
17264,1,7264,[172 216 151  70  98],374,3,31969,4.40041293874742,0.0,20.0
17265,1,7265,[127 187 483 302 211],537,5,31974,4.400495458298926,20.0,20.0
17266,1,7266,[127 187 483 302 211],474,5,31979,4.400577955139672,20.0,20.0
17267,1,7267,[127 187 483 302 211],6,5,31984,4.400660429279031,20.0,20.0
17268,1,7268,[127 187 483 302 211],343,5,31989,4.400742880726372,20.0,20.0
17269,1,7269,[127 187 483 302 211],343,5,31994,4.400825309491059,20.0,20.0
17270,1,7270,[127 187 483 302 211],666,5,31999,4.400907715582451,20.0,20.0
17271,1,7271,[127 187 483 302 211],833,3,32002,4.40071507150715,20.0,20.0
17272,1,7272,[127 187 483 302 211],343,5,32007,4.400797470094871,20.0,20.0
17273,1,7273,[127 187 483 302 211],666,5,32012,4.400879846026945,20.0,20.0
17274,1,7274,[127 187 483 302 211],207,5,32017,4.400962199312715,20.0,20.0
17275,1,7275,[127 187 483 302 211],207,5,32022,4.401044529961517,20.0,20.0
17276,1,7276,[127 187 483 302 211],13,5,32027,4.401126837982686,20.0,20.0
17277,1,7277,[300 135 238 215 313],380,1,32028,4.400659521846661,0.0,0.0
17278,1,7278,[127 187 483 302 211],833,3,32031,4.400467097128726,20.0,20.0
17279,1,7279,[403 322 313   1 216],92,3,32034,4.400274725274725,0.0,0.0
17280,1,7280,[127 187 483 302 211],666,5,32039,4.400357093805796,20.0,20.0
17281,1,7281,[127 187 483 302 211],210,5,32044,4.400439439714364,20.0,20.0
17282,1,7282,[127 187 483 302 211],524,5,32049,4.400521763009749,20.0,20.0
17283,1,7283,[127 187 483 302 211],524,5,32054,4.400604063701263,20.0,20.0
17284,1,7284,[127 187 483 302 211],6,5,32059,4.400686341798216,20.0,20.0
17285,1,7285,[127 187 483 302 211],210,5,32064,4.400768597309909,20.0,20.0
17286,1,7286,[127 187 483 302 211],207,5,32069,4.400850830245643,20.0,20.0
17287,1,7287,[127 187 483 302 211],343,5,32074,4.400933040614709,20.0,20.0
17288,1,7288,[127 187 483 302 211],328,5,32079,4.401015228426396,20.0,20.0
17289,1,7289,[127 187 483 302 211],474,5,32084,4.401097393689986,20.0,20.0
17290,1,7290,[127 187 483 302 211],328,5,32089,4.401179536414758,20.0,20.0
17291,1,7291,[597 475  12 483 235],213,4,32093,4.401124520021942,40.0,0.0
17292,1,7292,[127 187 483 302 211],207,5,32098,4.4012066365007545,20.0,20.0
17293,1,7293,[127 187 483 302 211],210,5,32103,4.401288730463395,20.0,20.0
17294,1,7294,[173 143  28 181 265],374,2,32105,4.400959561343386,0.0,0.0
17295,1,7295,[127 187 483 302 211],474,5,32110,4.401041666666667,20.0,20.0
17296,1,7296,[127 187 483 302 211],666,5,32115,4.40112374948609,20.0,20.0
17297,1,7297,[127 187 483 302 211],328,5,32120,4.401205809810907,20.0,20.0
17298,1,7298,[127 187 483 302 211],474,5,32125,4.401287847650363,20.0,20.0
17299,1,7299,[238 182 172  82 301],666,3,32128,4.401095890410959,0.0,0.0
17300,1,7300,[200 234 183 144 117],455,3,32131,4.400903985755376,0.0,0.0
17301,1,7301,[127 187 483 302 211],537,5,32136,4.400986031224322,20.0,20.0
17302,1,7302,[127 187 483 302 211],210,5,32141,4.401068054224291,20.0,20.0
17303,1,7303,[127 187 483 302 211],833,3,32144,4.400876232201534,20.0,20.0
17304,1,7304,[127 187 483 302 211],833,3,32147,4.400684462696783,20.0,20.0
17305,1,7305,[127 187 483 302 211],537,5,32152,4.400766493293184,20.0,20.0
17306,1,7306,[127 187 483 302 211],207,5,32157,4.400848501436978,20.0,20.0
17307,1,7307,[127 187 483 302 211],339,5,32162,4.4009304871373836,20.0,20.0
17308,1,7308,[427 132 200 655  98],474,4,32166,4.400875632781502,0.0,20.0
17309,1,7309,[127 187 483 302 211],328,5,32171,4.400957592339261,20.0,20.0
17310,1,7310,[127 187 483 302 211],343,5,32176,4.401039529476132,20.0,20.0
17311,1,7311,[127 187 483 302 211],833,3,32179,4.400847921225383,20.0,20.0
17312,1,7312,[127 187 483 302 211],13,5,32184,4.400929850950362,20.0,20.0
17313,1,7313,[127 187 483 302 211],474,5,32189,4.401011758271808,20.0,20.0
17314,1,7314,[127 187 483 302 211],328,5,32194,4.401093643198906,20.0,20.0
17315,1,7315,[127 187 483 302 211],524,5,32199,4.401175505740842,20.0,20.0
17316,1,7316,[151 215 153 546  88],536,3,32202,4.400984009840099,0.0,0.0
17317,1,7317,[127 187 483 302 211],833,3,32205,4.400792566274938,20.0,20.0
17318,1,7318,[127 187 483 302 211],210,5,32210,4.400874436398415,20.0,20.0
17319,1,7319,[127 187 483 302 211],474,5,32215,4.400956284153006,20.0,20.0
17320,1,7320,[186  89 211 318  12],343,4,32219,4.400901516186313,40.0,0.0
17321,1,7321,[127 187 483 302 211],210,5,32224,4.400983337885823,20.0,20.0
17322,1,7322,[127 187 483 302 211],474,5,32229,4.401065137238836,20.0,20.0
17323,1,7323,[127 187 483 302 211],13,5,32234,4.401146914254506,20.0,20.0
17324,1,7324,[228  79 435  56 603],843,1,32235,4.400682593856655,20.0,0.0
17325,1,7325,[127 187 483 302 211],474,5,32240,4.400764400764401,20.0,20.0
17326,1,7326,[127 187 483 302 211],207,5,32245,4.400846185341886,20.0,20.0
17327,1,7327,[127 187 483 302 211],13,5,32250,4.4009279475982535,20.0,20.0
17328,1,7328,[127 187 483 302 211],343,5,32255,4.401009687542639,20.0,20.0
17329,1,7329,[276 210 176   4 742],59,4,32259,4.400954979536153,0.0,0.0
17330,1,7330,[127 187 483 302 211],474,5,32264,4.401036693493384,20.0,20.0
17331,1,7331,[318 132 313 228 135],92,3,32267,4.400845608292417,20.0,0.0
17332,1,7332,[127 187 483 302 211],6,5,32272,4.400927314877949,20.0,20.0
17333,1,7333,[ 95 286 204 144 191],95,4,32276,4.400872647941096,0.0,0.0
17334,1,7334,[313 235   9 568 237],64,5,32281,4.40095432856169,0.0,0.0
17335,1,7335,[127 187 483 302 211],207,5,32286,4.40103598691385,20.0,20.0
17336,1,7336,[127 187 483 302 211],207,5,32291,4.401117623006678,20.0,20.0
17337,1,7337,[127 187 483 302 211],210,5,32296,4.401199236849278,20.0,20.0
17338,1,7338,[127 187 483 302 211],90,5,32301,4.4012808284507425,20.0,20.0
17339,1,7339,[187 323  11  88   9],13,2,32303,4.400953678474115,0.0,0.0
17340,1,7340,[127 187 483 302 211],666,5,32308,4.401035281296826,20.0,20.0
17341,1,7341,[127 187 483 302 211],13,5,32313,4.401116861890493,20.0,20.0
17342,1,7342,[127 187 483 302 211],666,5,32318,4.401198420264198,20.0,20.0
17343,1,7343,[127 187 483 302 211],90,5,32323,4.4012799564270155,20.0,20.0
17344,1,7344,[235 603 173 132 196],537,2,32325,4.400953029271613,20.0,0.0
17345,1,7345,[ 50 403  69 185 546],328,3,32328,4.40076231962973,0.0,20.0
17346,1,7346,[127 187 483 302 211],537,5,32333,4.40084388185654,20.0,20.0
17347,1,7347,[127 187 483 302 211],339,5,32338,4.400925421883506,20.0,20.0
17348,1,7348,[127 187 483 302 211],207,5,32343,4.401006939719689,20.0,20.0
17349,1,7349,[127 187 483 302 211],13,5,32348,4.40108843537415,20.0,20.0
17350,1,7350,[228 194 173  70  11],64,5,32353,4.401169908855938,0.0,0.0
17351,1,7351,[127 187 483 302 211],339,5,32358,4.401251360174102,20.0,20.0
17352,1,7352,[127 187 483 302 211],474,5,32363,4.401332789337685,20.0,20.0
17353,1,7353,[127 187 483 302 211],339,5,32368,4.4014141963557245,20.0,20.0
17354,1,7354,[127 187 483 302 211],328,5,32373,4.401495581237254,20.0,20.0
17355,1,7355,[127 187 483 302 211],833,3,32376,4.4013050570962475,20.0,20.0
17356,1,7356,[127 187 483 302 211],343,5,32381,4.401386434688052,20.0,20.0
17357,1,7357,[127 187 483 302 211],339,5,32386,4.401467790160369,20.0,20.0
17358,1,7358,[234 318 228 132 288],200,5,32391,4.4015491235222175,20.0,0.0
17359,1,7359,[127 187 483 302 211],343,5,32396,4.401630434782609,20.0,20.0
17360,1,7360,[127 187 483 302 211],474,5,32401,4.40171172395055,20.0,20.0
17361,1,7361,[127 187 483 302 211],6,5,32406,4.401792991035045,20.0,20.0
17362,1,7362,[175  88 121 257 294],95,4,32410,4.401738421838925,0.0,0.0
17363,1,7363,[127 187 483 302 211],524,5,32415,4.401819663226507,20.0,20.0
17364,1,7364,[257 423 172 202 211],308,5,32420,4.401900882552614,0.0,0.0
17365,1,7365,[215 496 483 222 144],804,5,32425,4.401982079826229,20.0,0.0
17366,1,7366,[403 273 204 132 211],59,4,32429,4.4019275145921,0.0,0.0
17367,1,7367,[127 187 483 302 211],339,5,32434,4.402008686210641,20.0,20.0
17368,1,7368,[127 187 483 302 211],474,5,32439,4.402089835798616,20.0,20.0
17369,1,7369,[238 333 210 132 172],653,2,32441,4.401763907734057,0.0,0.0
17370,1,7370,[127 187 483 302 211],339,5,32446,4.401845068511735,20.0,20.0
17371,1,7371,[127 187 483 302 211],524,5,32451,4.401926207270754,20.0,20.0
17372,1,7372,[127 187 483 302 211],6,5,32456,4.402007324020073,20.0,20.0
17373,1,7373,[127 187 483 302 211],474,5,32461,4.402088418768646,20.0,20.0
17374,1,7374,[127 187 483 302 211],524,5,32466,4.402169491525424,20.0,20.0
17375,1,7375,[127 187 483 302 211],537,5,32471,4.402250542299349,20.0,20.0
17376,1,7376,[172 300 168 515 216],666,2,32473,4.401924901721567,0.0,0.0
17377,1,7377,[127 187 483 302 211],666,5,32478,4.402005963675793,20.0,20.0
17378,1,7378,[127 187 483 302 211],343,5,32483,4.402087003659032,20.0,20.0
17379,1,7379,[127 187 483 302 211],13,5,32488,4.402168021680216,20.0,20.0
17380,1,7380,[127 187 483 302 211],90,5,32493,4.4022490177482725,20.0,20.0
17381,1,7381,[127 187 483 302 211],207,5,32498,4.402329991872121,20.0,20.0
17382,1,7382,[127 187 483 302 211],833,3,32501,4.402140051469592,20.0,20.0
17383,1,7383,[127 187 483 302 211],90,5,32506,4.402221018418201,20.0,20.0
17384,1,7384,[276 471  71 210 313],308,3,32509,4.402031144211239,0.0,0.0
17385,1,7385,[127 187 483 302 211],343,5,32514,4.402112103980504,20.0,20.0
17386,1,7386,[ 56   9 197 125 234],194,3,32517,4.401922295925274,0.0,0.0
17387,1,7387,[127 187 483 302 211],328,5,32522,4.402003248511099,20.0,20.0
17388,1,7388,[286 302   8 300 202],454,3,32525,4.401813506563811,0.0,0.0
17389,1,7389,[127 187 483 302 211],524,5,32530,4.401894451962111,20.0,20.0
17390,1,7390,[204  69 151  50  56],387,2,32532,4.401569476390204,0.0,20.0
17391,1,7391,[127 187 483 302 211],207,5,32537,4.401650432900433,20.0,20.0
17392,1,7392,[127 187 483 302 211],207,5,32542,4.401731367509806,20.0,20.0
17393,1,7393,[127 187 483 302 211],474,5,32547,4.401812280227211,20.0,20.0
17394,1,7394,[127 187 483 302 211],666,5,32552,4.401893171061528,20.0,20.0
17395,1,7395,[211 322  56  89 228],234,0,32552,4.401297998918334,0.0,0.0
17396,1,7396,[597 161 222 234 289],533,2,32554,4.400973367581452,0.0,0.0
17397,1,7397,[127 187 483 302 211],90,5,32559,4.401054339010543,20.0,20.0
17398,1,7398,[ 25 237  56 151 282],548,3,32562,4.4008649817542915,0.0,0.0
17399,1,7399,[127 187 483 302 211],343,5,32567,4.400945945945946,20.0,20.0
17400,1,7400,[127 187 483 302 211],833,3,32570,4.400756654506147,20.0,20.0
17401,1,7401,[127 187 483 302 211],13,5,32575,4.400837611456363,20.0,20.0
17402,1,7402,[127 187 483 302 211],343,5,32580,4.4009185465351885,20.0,20.0
17403,1,7403,[127 187 483 302 211],537,5,32585,4.400999459751485,20.0,20.0
17404,1,7404,[182 183 603 174 204],91,5,32590,4.401080351114112,20.0,20.0
17405,1,7405,[127 187 483 302 211],6,5,32595,4.40116122063192,20.0,20.0
17406,1,7406,[127 187 483 302 211],537,5,32600,4.401242068313757,20.0,20.0
17407,1,7407,[127 187 483 302 211],90,5,32605,4.401322894168467,20.0,20.0
17408,1,7408,[127 187 483 302 211],6,5,32610,4.401403698204886,20.0,20.0
17409,1,7409,[127 187 483 302 211],328,5,32615,4.401484480431849,20.0,20.0
17410,1,7410,[127 187 483 302 211],343,5,32620,4.401565240858184,20.0,20.0
17411,1,7411,[127 187 483 302 211],474,5,32625,4.401645979492715,20.0,20.0
17412,1,7412,[127 187 483 302 211],537,5,32630,4.4017266963442605,20.0,20.0
17413,1,7413,[127 187 483 302 211],13,5,32635,4.4018073914216345,20.0,20.0
17414,1,7414,[127 187 483 302 211],13,5,32640,4.401888064733648,20.0,20.0
17415,1,7415,[127 187 483 302 211],210,5,32645,4.401968716289105,20.0,20.0
17416,1,7416,[127 187 483 302 211],210,5,32650,4.402049346096804,20.0,20.0
17417,1,7417,[127 187 483 302 211],666,5,32655,4.402129954165543,20.0,20.0
17418,1,7418,[127 187 483 302 211],328,5,32660,4.402210540504111,20.0,20.0
17419,1,7419,[238 655 125 222 174],881,4,32664,4.4021563342318055,0.0,20.0
17420,1,7420,[127 187 483 302 211],833,3,32667,4.401967389839644,20.0,20.0
17421,1,7421,[127 187 483 302 211],13,5,32672,4.40204796550795,20.0,20.0
17422,1,7422,[215  50  28 275 483],328,4,32676,4.401993803044591,20.0,20.0
17423,1,7423,[127 187 483 302 211],474,5,32681,4.402074353448276,20.0,20.0
17424,1,7424,[195  50 132  98 187],346,3,32684,4.4018855218855215,0.0,40.0
17425,1,7425,[127 187 483 302 211],343,5,32689,4.401966065176407,20.0,20.0
17426,1,7426,[127 187 483 302 211],328,5,32694,4.402046586777972,20.0,20.0
17427,1,7427,[127 187 483 302 211],328,5,32699,4.402127086698977,20.0,20.0
17428,1,7428,[127 187 483 302 211],207,5,32704,4.402207564948176,20.0,20.0
17429,1,7429,[238  97  28 215 483],454,3,32707,4.402018842530283,20.0,0.0
17430,1,7430,[173 111 546 275 210],95,3,32710,4.401830170905665,0.0,0.0
17431,1,7431,[127 187 483 302 211],13,5,32715,4.4019106566200215,20.0,20.0
17432,1,7432,[127 187 483 302 211],13,5,32720,4.4019911206780575,20.0,20.0
17433,1,7433,[127 187 483 302 211],13,5,32725,4.402071563088512,20.0,20.0
17434,1,7434,[127 187 483 302 211],339,5,32730,4.402151983860121,20.0,20.0
17435,1,7435,[127 187 483 302 211],13,5,32735,4.402232383001614,20.0,20.0
17436,1,7436,[127 187 483 302 211],207,5,32740,4.402312760521716,20.0,20.0
17437,1,7437,[127 187 483 302 211],537,5,32745,4.402393116429147,20.0,20.0
17438,1,7438,[127 187 483 302 211],524,5,32750,4.402473450732625,20.0,20.0
17439,1,7439,[127 187 483 302 211],524,5,32755,4.40255376344086,20.0,20.0
17440,1,7440,[127 187 483 302 211],6,5,32760,4.402634054562559,20.0,20.0
17441,1,7441,[127 187 483 302 211],537,5,32765,4.402714324106423,20.0,20.0
17442,1,7442,[127 187 483 302 211],13,5,32770,4.40279457208115,20.0,20.0
17443,1,7443,[127 187 483 302 211],343,5,32775,4.402874798495432,20.0,20.0
17444,1,7444,[127 187 483 302 211],833,3,32778,4.402686366689053,20.0,20.0
17445,1,7445,[475 186   8 273  98],92,5,32783,4.402766586086489,0.0,20.0
17446,1,7446,[222 435 302  22 483],13,4,32787,4.402712501678528,20.0,0.0
17447,1,7447,[333 423 132 176 357],13,2,32789,4.402389903329753,20.0,0.0
17448,1,7448,[127 187 483 302 211],6,5,32794,4.402470130218822,20.0,20.0
17449,1,7449,[234 185 176 268 318],234,2,32796,4.402147651006711,20.0,0.0
17450,1,7450,[127 187 483 302 211],210,5,32801,4.402227888873977,20.0,20.0
17451,1,7451,[127 187 483 302 211],339,5,32806,4.4023081052066555,20.0,20.0
17452,1,7452,[268 191  12 211 174],7,4,32810,4.40225412585536,20.0,20.0
17453,1,7453,[127 187 483 302 211],13,5,32815,4.402334317145157,20.0,20.0
17454,1,7454,[  8  11 423 475 175],474,5,32820,4.402414486921529,0.0,0.0
17455,1,7455,[127 187 483 302 211],13,5,32825,4.402494635193133,20.0,20.0
17456,1,7456,[127 187 483 302 211],210,5,32830,4.40257476196862,20.0,20.0
17457,1,7457,[127 187 483 302 211],210,5,32835,4.402654867256637,20.0,20.0
17458,1,7458,[127 187 483 302 211],328,5,32840,4.402734951065827,20.0,20.0
17459,1,7459,[127 187 483 302 211],328,5,32845,4.402815013404826,20.0,20.0
17460,1,7460,[127 187 483 302 211],90,5,32850,4.402895054282268,20.0,20.0
17461,1,7461,[127 187 483 302 211],833,3,32853,4.402707049048512,20.0,20.0
17462,1,7462,[127 187 483 302 211],207,5,32858,4.402787082942516,20.0,20.0
17463,1,7463,[588 215 125 117 403],194,1,32859,4.402331189710611,0.0,0.0
17464,1,7464,[182 186 508 183  28],406,3,32862,4.402143335565975,0.0,0.0
17465,1,7465,[127 187 483 302 211],90,5,32867,4.402223412804715,20.0,20.0
17466,1,7466,[ 69 273 118 183 161],308,1,32868,4.401767778224187,0.0,0.0
17467,1,7467,[127 187 483 302 211],13,5,32873,4.401847884306374,20.0,20.0
17468,1,7468,[127 187 483 302 211],343,5,32878,4.401927968938279,20.0,20.0
17469,1,7469,[121  50 294 161   9],13,3,32881,4.401740294511379,0.0,20.0
17470,1,7470,[127 187 483 302 211],537,5,32886,4.401820372105474,20.0,20.0
17471,1,7471,[127 187 483 302 211],474,5,32891,4.401900428265525,20.0,20.0
17472,1,7472,[196 276 100  98 655],13,5,32896,4.401980463000134,0.0,40.0
17473,1,7473,[127 187 483 302 211],343,5,32901,4.402060476317902,20.0,20.0
17474,1,7474,[127 187 483 302 211],833,3,32904,4.401872909698997,20.0,20.0
17475,1,7475,[245 168 597  89  96],119,5,32909,4.401952915997859,0.0,0.0
17476,1,7476,[127 187 483 302 211],474,5,32914,4.4020329008960815,20.0,20.0
17477,1,7477,[127 187 483 302 211],328,5,32919,4.4021128644022465,20.0,20.0
17478,1,7478,[127 187 483 302 211],474,5,32924,4.402192806524936,20.0,20.0
17479,1,7479,[168 603  70 211 286],7,4,32928,4.402139037433155,20.0,0.0
17480,1,7480,[127 187 483 302 211],339,5,32933,4.402218954685202,20.0,20.0
17481,1,7481,[127 187 483 302 211],833,3,32936,4.402031542368351,20.0,20.0
17482,1,7482,[127 546 168 603 144],7,5,32941,4.402111452625952,20.0,20.0
17483,1,7483,[127 187 483 302 211],210,5,32946,4.402191341528594,20.0,20.0
17484,1,7484,[288 403  97 180 655],843,1,32947,4.401736806947228,0.0,0.0
17485,1,7485,[655 187  70 216 210],7,4,32951,4.401683141864814,0.0,0.0
17486,1,7486,[127 187 483 302 211],13,5,32956,4.40176305596367,20.0,20.0
17487,1,7487,[127 187 483 302 211],537,5,32961,4.401842948717949,20.0,20.0
17488,1,7488,[127 187 483 302 211],13,5,32966,4.4019228201362,20.0,20.0
17489,1,7489,[127 187 483 302 211],6,5,32971,4.4020026702269694,20.0,20.0
17490,1,7490,[127 187 483 302 211],207,5,32976,4.402082498998799,20.0,20.0
17491,1,7491,[127 187 483 302 211],90,5,32981,4.402162306460224,20.0,20.0
17492,1,7492,[161 276  89  50  88],374,2,32983,4.401841718937675,0.0,20.0
17493,1,7493,[127 187 483 302 211],343,5,32988,4.401921537229784,20.0,20.0
17494,1,7494,[151 357 118 257 603],213,5,32993,4.402001334222815,40.0,0.0
17495,1,7495,[127 187 483 302 211],474,5,32998,4.402081109925294,20.0,20.0
17496,1,7496,[288 173 568  89 508],387,3,33001,4.401894090969721,0.0,0.0
17497,1,7497,[357  82 423 215 100],233,5,33006,4.401973859695919,20.0,20.0
17498,1,7498,[127 187 483 302 211],6,5,33011,4.40205360714762,20.0,20.0
17499,1,7499,[ 88  56 132  15 210],474,5,33016,4.4021333333333335,0.0,0.0
17500,1,7500,[237  69  15 423 222],454,3,33019,4.401946407145714,0.0,0.0
17501,1,7501,[483 153 385 546 258],479,3,33022,4.4017595307917885,20.0,0.0
17502,1,7502,[127 187 483 302 211],474,5,33027,4.401839264294282,20.0,20.0
17503,1,7503,[127 187 483 302 211],6,5,33032,4.401918976545843,20.0,20.0
17504,1,7504,[127 187 483 302 211],474,5,33037,4.401998667554963,20.0,20.0
17505,1,7505,[127 187 483 302 211],13,5,33042,4.402078337330136,20.0,20.0
17506,1,7506,[127 187 483 302 211],524,5,33047,4.402157985879845,20.0,20.0
17507,1,7507,[127 187 483 302 211],833,3,33050,4.401971230687267,20.0,20.0
17508,1,7508,[127 187 483 302 211],210,5,33055,4.40205087228659,20.0,20.0
17509,1,7509,[127 187 483 302 211],328,5,33060,4.402130492676432,20.0,20.0
17510,1,7510,[127 187 483 302 211],207,5,33065,4.402210091865264,20.0,20.0
17511,1,7511,[127 187 483 302 211],474,5,33070,4.402289669861555,20.0,20.0
17512,1,7512,[127 187 483 302 211],207,5,33075,4.402369226673765,20.0,20.0
17513,1,7513,[127 187 483 302 211],207,5,33080,4.402448762310354,20.0,20.0
17514,1,7514,[ 69 265 197 176 238],379,5,33085,4.4025282767797735,0.0,0.0
17515,1,7515,[127 187 483 302 211],13,5,33090,4.402607770090474,20.0,20.0
17516,1,7516,[273 323 195  79 210],883,5,33095,4.402687242250898,0.0,0.0
17517,1,7517,[127 187 483 302 211],328,5,33100,4.402766693269487,20.0,20.0
17518,1,7518,[ 50  97 742 588 211],313,4,33104,4.402713126745578,0.0,20.0
17519,1,7519,[127 187 483 302 211],90,5,33109,4.40279255319149,20.0,20.0
17520,1,7520,[258 186 180 385  82],788,2,33111,4.402473075388911,0.0,0.0
17521,1,7521,[127 187 483 302 211],666,5,33116,4.40255251262962,20.0,20.0
17522,1,7522,[ 82   1 234  88 216],533,4,33120,4.402499003057291,0.0,0.0
17523,1,7523,[127 187 483 302 211],210,5,33125,4.40257841573631,20.0,20.0
17524,1,7524,[273 121   9 357 678],308,2,33127,4.402259136212624,20.0,0.0
17525,1,7525,[127 187 483 302 211],90,5,33132,4.402338559659846,20.0,20.0
17526,1,7526,[127 187 483 302 211],328,5,33137,4.4024179620034545,20.0,20.0
17527,1,7527,[127 187 483 302 211],833,3,33140,4.402231668437832,20.0,20.0
17528,1,7528,[127 187 483 302 211],13,5,33145,4.402311063886306,20.0,20.0
17529,1,7529,[127 187 483 302 211],833,3,33148,4.402124833997344,20.0,20.0
17530,1,7530,[127 187 483 302 211],833,3,33151,4.401938653565264,20.0,20.0
17531,1,7531,[127 187 483 302 211],537,5,33156,4.402018056293149,20.0,20.0
17532,1,7532,[127 187 483 302 211],6,5,33161,4.402097437939732,20.0,20.0
17533,1,7533,[127 187 483 302 211],13,5,33166,4.4021767985134055,20.0,20.0
17534,1,7534,[127 187 483 302 211],474,5,33171,4.402256138022562,20.0,20.0
17535,1,7535,[127 187 483 302 211],666,5,33176,4.402335456475583,20.0,20.0
17536,1,7536,[127 187 483 302 211],328,5,33181,4.402414753880854,20.0,20.0
17537,1,7537,[172 173 597  28  82],882,5,33186,4.40249403024675,0.0,0.0
17538,1,7538,[127 187 483 302 211],474,5,33191,4.402573285581642,20.0,20.0
17539,1,7539,[127 197 143 235 471],648,3,33194,4.402387267904509,0.0,20.0
17540,1,7540,[127 187 483 302 211],833,3,33197,4.4022012995623925,20.0,20.0
17541,1,7541,[127 187 483 302 211],474,5,33202,4.402280562185097,20.0,20.0
17542,1,7542,[182  11 195 151 211],653,1,33203,4.40182951080472,0.0,0.0
17543,1,7543,[211 144 194 655  50],343,5,33208,4.401908801696712,0.0,20.0
17544,1,7544,[127 187 483 302 211],833,3,33211,4.401722995361166,20.0,20.0
17545,1,7545,[174 423 210 181   7],527,4,33215,4.401669758812616,0.0,20.0
17546,1,7546,[300  89 273 357 228],892,4,33219,4.401616536372068,20.0,0.0
17547,1,7547,[127 187 483 302 211],666,5,33224,4.4016958134605195,20.0,20.0
17548,1,7548,[127 187 483 302 211],524,5,33229,4.401775069545635,20.0,20.0
17549,1,7549,[127 187 483 302 211],833,3,33232,4.40158940397351,20.0,20.0
17550,1,7550,[127 187 483 302 211],90,5,33237,4.401668653158522,20.0,20.0
17551,1,7551,[127 187 483 302 211],207,5,33242,4.4017478813559325,20.0,20.0
17552,1,7552,[403 195 135  22 168],313,2,33244,4.401429895405799,0.0,0.0
17553,1,7553,[127 187 483 302 211],13,5,33249,4.401509134233518,20.0,20.0
17554,1,7554,[118 515  28 202 168],308,2,33251,4.4011912640635344,0.0,0.0
17555,1,7555,[127 187 483 302 211],343,5,33256,4.401270513499206,20.0,20.0
17556,1,7556,[127 187 483 302 211],339,5,33261,4.401349741961096,20.0,20.0
17557,1,7557,[117  97 153  12 197],194,2,33263,4.40103201905266,20.0,0.0
17558,1,7558,[127 187 483 302 211],833,3,33266,4.400846672840323,20.0,20.0
17559,1,7559,[ 22  50 427 196 357],271,5,33271,4.400925925925926,20.0,20.0
17560,1,7560,[127 187 483 302 211],210,5,33276,4.4010051580478775,20.0,20.0
17561,1,7561,[179  98   8  88  79],308,4,33280,4.400952129066384,0.0,20.0
17562,1,7562,[127 187 483 302 211],666,5,33285,4.401031336771123,20.0,20.0
17563,1,7563,[127 187 483 302 211],537,5,33290,4.401110523532522,20.0,20.0
17564,1,7564,[127 187 483 302 211],524,5,33295,4.4011896893588895,20.0,20.0
17565,1,7565,[127 187 483 302 211],339,5,33300,4.401268834258525,20.0,20.0
17566,1,7566,[ 50  82 403 318 196],311,5,33305,4.401347958239725,20.0,20.0
17567,1,7567,[127 187 483 302 211],343,5,33310,4.401427061310782,20.0,20.0
17568,1,7568,[127 187 483 302 211],474,5,33315,4.401506143479984,20.0,20.0
17569,1,7569,[127 187 483 302 211],666,5,33320,4.401585204755614,20.0,20.0
17570,1,7570,[127 187 483 302 211],207,5,33325,4.401664245145952,20.0,20.0
17571,1,7571,[127 187 483 302 211],6,5,33330,4.401743264659271,20.0,20.0
17572,1,7572,[127 187 483 302 211],524,5,33335,4.401822263303843,20.0,20.0
17573,1,7573,[127 187 483 302 211],343,5,33340,4.401901241087932,20.0,20.0
17574,1,7574,[127 187 483 302 211],833,3,33343,4.401716171617162,20.0,20.0
17575,1,7575,[127 187 483 302 211],6,5,33348,4.4017951425554385,20.0,20.0
17576,1,7576,[127 187 483 302 211],537,5,33353,4.401874092648805,20.0,20.0
17577,1,7577,[143  97 127 196  28],194,2,33355,4.40155713908683,0.0,20.0
17578,1,7578,[127 187 483 302 211],13,5,33360,4.401636099749307,20.0,20.0
17579,1,7579,[135 222 435 258 151],380,2,33362,4.40131926121372,0.0,0.0
17580,1,7580,[175 191 204 318   9],334,5,33367,4.401398232423163,20.0,0.0
17581,1,7581,[127 187 483 302 211],833,3,33370,4.4012134001582695,20.0,20.0
17582,1,7582,[127 187 483 302 211],524,5,33375,4.401292364499539,20.0,20.0
17583,1,7583,[127 187 483 302 211],343,5,33380,4.401371308016878,20.0,20.0
17584,1,7584,[127 187 483 302 211],537,5,33385,4.401450230718523,20.0,20.0
17585,1,7585,[216 215 318 546 597],13,1,33386,4.401001845504878,20.0,0.0
17586,1,7586,[603 194 435 496 135],524,2,33388,4.400685382891789,20.0,0.0
17587,1,7587,[100 597 475 202  97],308,3,33391,4.400500790722193,0.0,20.0
17588,1,7588,[127 187 483 302 211],833,3,33394,4.4003162471998944,20.0,20.0
17589,1,7589,[483  28 215 194  22],263,4,33398,4.40026350461133,20.0,0.0
17590,1,7590,[127 187 483 302 211],524,5,33403,4.400342510868133,20.0,20.0
17591,1,7591,[215   8  64 186  50],311,4,33407,4.400289778714436,0.0,20.0
17592,1,7592,[127 187 483 302 211],90,5,33412,4.400368760700645,20.0,20.0
17593,1,7593,[168 180  71 173 234],899,3,33415,4.400184356070582,0.0,0.0
17594,1,7594,[228 186 174 210 313],254,4,33419,4.400131665569454,0.0,20.0
17595,1,7595,[172  15  11   9 258],145,3,33422,4.399947340705634,0.0,0.0
17596,1,7596,[168 483  69 151 475],833,3,33425,4.399763064367513,20.0,0.0
17597,1,7597,[268 603 568 194 118],7,3,33428,4.39957883653593,20.0,0.0
17598,1,7598,[117 118 282  25 357],271,1,33429,4.399131464666404,20.0,0.0
17599,1,7599,[127 187 483 302 211],474,5,33434,4.399210526315789,20.0,20.0
17600,1,7600,[603 322 182  25 288],308,4,33438,4.399158005525589,20.0,0.0
17601,1,7601,[175 191 282 234  82],85,3,33441,4.398973954222573,0.0,0.0
17602,1,7602,[127 187 483 302 211],13,5,33446,4.3990530053926085,20.0,20.0
17603,1,7603,[127 187 483 302 211],6,5,33451,4.399132035770647,20.0,20.0
17604,1,7604,[127 187 483 302 211],537,5,33456,4.399211045364892,20.0,20.0
17605,1,7605,[127 187 483 302 211],90,5,33461,4.399290034183539,20.0,20.0
17606,1,7606,[127 187 483 302 211],339,5,33466,4.399369002234784,20.0,20.0
17607,1,7607,[168 111   9 282 195],474,4,33470,4.39931650893796,0.0,0.0
17608,1,7608,[153 313 176 301  79],13,2,33472,4.3990011828098305,0.0,0.0
17609,1,7609,[127 187 483 302 211],343,5,33477,4.399080157687254,20.0,20.0
17610,1,7610,[127 187 483 302 211],6,5,33482,4.399159111811851,20.0,20.0
17611,1,7611,[127 187 483 302 211],339,5,33487,4.399238045191803,20.0,20.0
17612,1,7612,[127 187 483 302 211],537,5,33492,4.399316957835282,20.0,20.0
17613,1,7613,[127 187 483 302 211],537,5,33497,4.3993958497504595,20.0,20.0
17614,1,7614,[405 423 313 100 174],85,3,33500,4.399212081418254,0.0,40.0
17615,1,7615,[183  97 385 186  71],64,3,33503,4.399028361344538,0.0,0.0
17616,1,7616,[127 187 483 302 211],210,5,33508,4.399107260076145,20.0,20.0
17617,1,7617,[127 187 483 302 211],343,5,33513,4.399186138093988,20.0,20.0
17618,1,7618,[127 187 483 302 211],666,5,33518,4.399264995406221,20.0,20.0
17619,1,7619,[127 187 483 302 211],210,5,33523,4.399343832020997,20.0,20.0
17620,1,7620,[127 187 483 302 211],537,5,33528,4.399422647946464,20.0,20.0
17621,1,7621,[ 22 357 568 144 546],788,3,33531,4.399239044870113,20.0,0.0
17622,1,7622,[204 228 100 405 222],524,1,33532,4.398793126065853,0.0,20.0
17623,1,7623,[127 187 483 302 211],343,5,33537,4.398871983210913,20.0,20.0
17624,1,7624,[127 187 483 302 211],524,5,33542,4.398950819672131,20.0,20.0
17625,1,7625,[ 15 294 423 275 271],537,1,33543,4.398505114083399,0.0,0.0
17626,1,7626,[127 187 483 302 211],6,5,33548,4.398583977972991,20.0,20.0
17627,1,7627,[ 82 322 118  50 282],804,5,33553,4.398662821185107,0.0,20.0
17628,1,7628,[127 187 483 302 211],524,5,33558,4.39874164372788,20.0,20.0
17629,1,7629,[127 187 483 302 211],13,5,33563,4.398820445609436,20.0,20.0
17630,1,7630,[211 196 215 258 655],474,5,33568,4.398899226837898,0.0,0.0
17631,1,7631,[127 187 483 302 211],328,5,33573,4.398977987421383,20.0,20.0
17632,1,7632,[127 187 483 302 211],90,5,33578,4.3990567273680075,20.0,20.0
17633,1,7633,[127 187 483 302 211],833,3,33581,4.398873460833115,20.0,20.0
17634,1,7634,[127 187 483 302 211],207,5,33586,4.3989521938441385,20.0,20.0
17635,1,7635,[121   8  79 183 237],458,4,33590,4.398899947616553,0.0,0.0
17636,1,7636,[127 187 483 302 211],90,5,33595,4.398978656540526,20.0,20.0
17637,1,7637,[127 187 483 302 211],524,5,33600,4.399057344854674,20.0,20.0
17638,1,7638,[127 187 483 302 211],524,5,33605,4.39913601256709,20.0,20.0
17639,1,7639,[235   9 257 180 313],144,4,33609,4.399083769633508,0.0,0.0
17640,1,7640,[127 187 483 302 211],339,5,33614,4.399162413296689,20.0,20.0
17641,1,7641,[269 191 238 196 546],207,3,33617,4.398979324784088,0.0,0.0
17642,1,7642,[403  97  50 471 588],95,3,33620,4.398796284181604,0.0,20.0
17643,1,7643,[176  69 118 215 195],804,5,33625,4.39887493458922,0.0,0.0
17644,1,7644,[ 82  88 196 258 471],234,0,33625,4.398299542184434,0.0,0.0
17645,1,7645,[127 187 483 302 211],328,5,33630,4.39837823698666,20.0,20.0
17646,1,7646,[127 187 483 302 211],474,5,33635,4.398456911207009,20.0,20.0
17647,1,7647,[127 187 483 302 211],474,5,33640,4.398535564853557,20.0,20.0
17648,1,7648,[423 318 176 302 257],666,3,33643,4.398352725846516,20.0,0.0
17649,1,7649,[127 187 483 302 211],343,5,33648,4.39843137254902,20.0,20.0
17650,1,7650,[127 187 483 302 211],207,5,33653,4.398509998692981,20.0,20.0
17651,1,7651,[127 187 483 302 211],343,5,33658,4.398588604286461,20.0,20.0
17652,1,7652,[127 187 483 302 211],13,5,33663,4.398667189337515,20.0,20.0
17653,1,7653,[127 187 483 302 211],90,5,33668,4.398745753854194,20.0,20.0
17654,1,7654,[265 204 197  25 238],194,4,33672,4.398693664271718,0.0,0.0
17655,1,7655,[ 88 182 597 183 186],374,4,33676,4.398641588296761,0.0,0.0
17656,1,7656,[127 187 483 302 211],474,5,33681,4.3987201253754735,20.0,20.0
17657,1,7657,[127 187 483 302 211],537,5,33686,4.398798641943066,20.0,20.0
17658,1,7658,[100 195 496  71 173],804,5,33691,4.398877138007573,0.0,20.0
17659,1,7659,[127 187 483 302 211],6,5,33696,4.398955613577024,20.0,20.0
17660,1,7660,[127 187 483 302 211],328,5,33701,4.399034068659444,20.0,20.0
17661,1,7661,[127 187 483 302 211],474,5,33706,4.399112503262856,20.0,20.0
17662,1,7662,[423   4 176 294 121],387,0,33706,4.398538431423725,0.0,0.0
17663,1,7663,[127 187 483 302 211],524,5,33711,4.398616910229645,20.0,20.0
17664,1,7664,[127 187 483 302 211],6,5,33716,4.398695368558382,20.0,20.0
17665,1,7665,[127 187 483 302 211],474,5,33721,4.39877380641795,20.0,20.0
17666,1,7666,[127 187 483 302 211],210,5,33726,4.398852223816355,20.0,20.0
17667,1,7667,[127 187 483 302 211],210,5,33731,4.398930620761607,20.0,20.0
17668,1,7668,[127 187 483 302 211],328,5,33736,4.399008997261703,20.0,20.0
17669,1,7669,[127 187 483 302 211],474,5,33741,4.399087353324641,20.0,20.0
17670,1,7670,[ 79 496 117 202   8],479,3,33744,4.39890496675792,0.0,0.0
17671,1,7671,[276 173 176 191 483],77,3,33747,4.398722627737226,20.0,0.0
17672,1,7672,[127 187 483 302 211],666,5,33752,4.39880099048612,20.0,20.0
17673,1,7673,[127 187 483 302 211],328,5,33757,4.3988793328120925,20.0,20.0
17674,1,7674,[127 187 483 302 211],524,5,33762,4.398957654723127,20.0,20.0
17675,1,7675,[ 11 204 174   4 496],666,3,33765,4.398775403856175,0.0,20.0
17676,1,7676,[127 187 483 302 211],343,5,33770,4.398853718900612,20.0,20.0
17677,1,7677,[127 187 483 302 211],210,5,33775,4.398932013545194,20.0,20.0
17678,1,7678,[ 96 210 118 183   7],643,4,33779,4.398880062508139,0.0,0.0
17679,1,7679,[127 187 483 302 211],537,5,33784,4.398958333333334,20.0,20.0
17680,1,7680,[127 187 483 302 211],524,5,33789,4.3990365837781535,20.0,20.0
17681,1,7681,[127 187 483 302 211],524,5,33794,4.399114813850559,20.0,20.0
17682,1,7682,[127 187 483 302 211],666,5,33799,4.399193023558506,20.0,20.0
17683,1,7683,[127 187 483 302 211],207,5,33804,4.399271212909943,20.0,20.0
17684,1,7684,[194 403 385 196  15],59,4,33808,4.39921925829538,0.0,0.0
17685,1,7685,[127 187 483 302 211],666,5,33813,4.399297423887588,20.0,20.0
17686,1,7686,[127 187 483 302 211],210,5,33818,4.399375569142708,20.0,20.0
17687,1,7687,[127 187 483 302 211],474,5,33823,4.399453694068678,20.0,20.0
17688,1,7688,[127 187 483 302 211],537,5,33828,4.399531798673429,20.0,20.0
17689,1,7689,[127 187 483 302 211],13,5,33833,4.3996098829648895,20.0,20.0
17690,1,7690,[127 187 483 302 211],90,5,33838,4.399687946950982,20.0,20.0
17691,1,7691,[127 187 483 302 211],210,5,33843,4.399765990639626,20.0,20.0
17692,1,7692,[127 187 483 302 211],90,5,33848,4.399844014038736,20.0,20.0
17693,1,7693,[127 187 483 302 211],328,5,33853,4.399922017156226,20.0,20.0
17694,1,7694,[483 228 216  97  89],381,5,33858,4.4,20.0,0.0
17695,1,7695,[168 181  25 161 245],92,3,33861,4.399818087318088,0.0,0.0
17696,1,7696,[127 187 483 302 211],524,5,33866,4.399896063401325,20.0,20.0
17697,1,7697,[127 187 483 302 211],207,5,33871,4.399974019225773,20.0,20.0
17698,1,7698,[471 117 234 135 238],308,2,33873,4.39966229380439,0.0,0.0
17699,1,7699,[127 187 483 302 211],90,5,33878,4.39974025974026,20.0,20.0
17700,1,7700,[127 187 483 302 211],524,5,33883,4.3998182054278665,20.0,20.0
17701,1,7701,[127 187 483 302 211],537,5,33888,4.3998961308750975,20.0,20.0
17702,1,7702,[127 187 483 302 211],524,5,33893,4.399974036089835,20.0,20.0
17703,1,7703,[210 435 202 121  82],290,4,33897,4.399922118380062,0.0,0.0
17704,1,7704,[127 187 483 302 211],90,5,33902,4.4,20.0,20.0
17705,1,7705,[127 187 483 302 211],328,5,33907,4.400077861406696,20.0,20.0
17706,1,7706,[197   1 143 132 275],454,2,33909,4.399766446087972,0.0,0.0
17707,1,7707,[127 187 483 302 211],210,5,33914,4.3998443175921125,20.0,20.0
17708,1,7708,[127 187 483 302 211],90,5,33919,4.399922168893501,20.0,20.0
17709,1,7709,[202 742  95 228 234],804,4,33923,4.399870298313878,0.0,0.0
17710,1,7710,[322 748 357 161 237],749,2,33925,4.399559071456361,20.0,0.0
17711,1,7711,[127 187 483 302 211],833,3,33928,4.399377593360996,20.0,20.0
17712,1,7712,[127 187 483 302 211],524,5,33933,4.399455464799689,20.0,20.0
17713,1,7713,[127 187 483 302 211],833,3,33936,4.399274047186933,20.0,20.0
17714,1,7714,[127 187 483 302 211],13,5,33941,4.399351911860013,20.0,20.0
17715,1,7715,[127 187 483 302 211],474,5,33946,4.3994297563504405,20.0,20.0
17716,1,7716,[127 187 483 302 211],6,5,33951,4.399507580666062,20.0,20.0
17717,1,7717,[127 187 483 302 211],6,5,33956,4.399585384814719,20.0,20.0
17718,1,7718,[127 187 483 302 211],524,5,33961,4.399663168804249,20.0,20.0
17719,1,7719,[127 187 483 302 211],210,5,33966,4.399740932642487,20.0,20.0
17720,1,7720,[ 96 234  79 258 268],92,5,33971,4.399818676337262,0.0,0.0
17721,1,7721,[127 187 483 302 211],524,5,33976,4.3998963998964,20.0,20.0
17722,1,7722,[127 187 483 302 211],339,5,33981,4.399974103327723,20.0,20.0
17723,1,7723,[127 187 483 302 211],833,3,33984,4.399792853443811,20.0,20.0
17724,1,7724,[234  15 257 118 265],881,3,33987,4.399611650485437,0.0,0.0
17725,1,7725,[200  89 216 174 258],145,5,33992,4.399689360600569,0.0,20.0
17726,1,7726,[127 187 483 302 211],210,5,33997,4.399767050601786,20.0,20.0
17727,1,7727,[127 187 483 302 211],666,5,34002,4.399844720496894,20.0,20.0
17728,1,7728,[127 187 483 302 211],90,5,34007,4.399922370293699,20.0,20.0
17729,1,7729,[127 187 483 302 211],90,5,34012,4.4,20.0,20.0
17730,1,7730,[257 423 322 100 427],474,4,34016,4.399948260250937,0.0,20.0
17731,1,7731,[127 187 483 302 211],343,5,34021,4.400025866528712,20.0,20.0
17732,1,7732,[483 173 174 286  98],524,4,34025,4.399974136816242,20.0,40.0
17733,1,7733,[127 187 483 302 211],90,5,34030,4.400051719679338,20.0,20.0
17734,1,7734,[100 151  82 174  79],308,5,34035,4.400129282482224,0.0,40.0
17735,1,7735,[127 187 483 302 211],537,5,34040,4.4002068252326785,20.0,20.0
17736,1,7736,[127 187 483 302 211],207,5,34045,4.400284347938477,20.0,20.0
17737,1,7737,[127 187 483 302 211],666,5,34050,4.400361850607392,20.0,20.0
17738,1,7738,[127 187 483 302 211],524,5,34055,4.400439333247189,20.0,20.0
17739,1,7739,[127 187 483 302 211],474,5,34060,4.4005167958656335,20.0,20.0
17740,1,7740,[127 187 483 302 211],343,5,34065,4.4005942384704815,20.0,20.0
17741,1,7741,[127 187 483 302 211],207,5,34070,4.400671661069491,20.0,20.0
17742,1,7742,[127 187 483 302 211],537,5,34075,4.400749063670412,20.0,20.0
17743,1,7743,[127 187 483 302 211],833,3,34078,4.400568181818182,20.0,20.0
17744,1,7744,[127 187 483 302 211],833,3,34081,4.4003873466752745,20.0,20.0
17745,1,7745,[127 187 483 302 211],343,5,34086,4.400464756003099,20.0,20.0
17746,1,7746,[127 187 483 302 211],833,3,34089,4.40028398089583,20.0,20.0
17747,1,7747,[127 187 483 302 211],90,5,34094,4.40036138358286,20.0,20.0
17748,1,7748,[127 187 483 302 211],666,5,34099,4.4004387662924245,20.0,20.0
17749,1,7749,[195  96  25 187  97],881,2,34101,4.400129032258064,0.0,0.0
17750,1,7750,[202 204  71 678  69],387,0,34101,4.399561346922978,0.0,0.0
17751,1,7751,[127 187 483 302 211],833,3,34104,4.3993808049535605,20.0,20.0
17752,1,7752,[127 187 483 302 211],474,5,34109,4.399458274216433,20.0,20.0
17753,1,7753,[127 187 483 302 211],343,5,34114,4.39953572349755,20.0,20.0
17754,1,7754,[127 187 483 302 211],207,5,34119,4.399613152804642,20.0,20.0
17755,1,7755,[127 187 483 302 211],833,3,34122,4.399432697266632,20.0,20.0
17756,1,7756,[127 187 483 302 211],339,5,34127,4.399510119891711,20.0,20.0
17757,1,7757,[127 187 483 302 211],339,5,34132,4.39958752255736,20.0,20.0
17758,1,7758,[127 187 483 302 211],666,5,34137,4.3996649052712975,20.0,20.0
17759,1,7759,[597 568  15 216  97],59,4,34141,4.399613402061855,0.0,0.0
17760,1,7760,[127 187 483 302 211],666,5,34146,4.399690761499807,20.0,20.0
17761,1,7761,[  1 125 175  22 210],378,4,34150,4.399639268229838,0.0,0.0
17762,1,7762,[127 187 483 302 211],6,5,34155,4.399716604405513,20.0,20.0
17763,1,7763,[200 175  28 435 191],343,4,34159,4.399665121071613,0.0,0.0
17764,1,7764,[127 187 483 302 211],474,5,34164,4.399742433998712,20.0,20.0
17765,1,7765,[127 187 483 302 211],343,5,34169,4.399819727015195,20.0,20.0
17766,1,7766,[144 333 135 117   8],13,3,34172,4.399639500450625,0.0,0.0
17767,1,7767,[ 70   7 187 588 215],406,2,34174,4.3993305870236865,0.0,0.0
17768,1,7768,[127 187 483 302 211],524,5,34179,4.399407903205046,20.0,20.0
17769,1,7769,[127 187 483 302 211],90,5,34184,4.399485199485199,20.0,20.0
17770,1,7770,[678 121 258   1 405],634,3,34187,4.3993051087376145,0.0,0.0
17771,1,7771,[127 187 483 302 211],474,5,34192,4.399382398353063,20.0,20.0
17772,1,7772,[127 187 483 302 211],343,5,34197,4.399459668081822,20.0,20.0
17773,1,7773,[127 187 483 302 211],666,5,34202,4.399536917931567,20.0,20.0
17774,1,7774,[127 187 483 302 211],343,5,34207,4.3996141479099675,20.0,20.0
17775,1,7775,[127 187 483 302 211],328,5,34212,4.3996913580246915,20.0,20.0
17776,1,7776,[127 187 483 302 211],343,5,34217,4.3997685482834,20.0,20.0
17777,1,7777,[127 187 483 302 211],90,5,34222,4.399845718693752,20.0,20.0
17778,1,7778,[127 187 483 302 211],537,5,34227,4.399922869263402,20.0,20.0
17779,1,7779,[127 187 483 302 211],207,5,34232,4.4,20.0,20.0
17780,1,7780,[127 187 483 302 211],210,5,34237,4.400077110911194,20.0,20.0
17781,1,7781,[ 71 275 294 222 748],328,2,34239,4.3997686969930605,0.0,0.0
17782,1,7782,[127 187 483 302 211],210,5,34244,4.3998458178080435,20.0,20.0
17783,1,7783,[282 179 153  71 748],899,4,34248,4.399794450154163,0.0,0.0
17784,1,7784,[185 271  71  22 181],13,3,34251,4.399614643545279,0.0,0.0
17785,1,7785,[275 210 276 515 144],13,2,34253,4.399306447469818,0.0,0.0
17786,1,7786,[ 79  88 196 174 515],343,5,34258,4.399383588031334,0.0,20.0
17787,1,7787,[258  82 121 111 275],119,3,34261,4.399203903441191,0.0,0.0
17788,1,7788,[127 187 483 302 211],474,5,34266,4.39928103736038,20.0,20.0
17789,1,7789,[127 187 483 302 211],328,5,34271,4.399358151476251,20.0,20.0
17790,1,7790,[ 98  70   9 121 318],328,5,34276,4.399435245796432,20.0,20.0
17791,1,7791,[127 187 483 302 211],13,5,34281,4.399512320328542,20.0,20.0
17792,1,7792,[202 322 568 302 271],537,1,34282,4.39907609393045,0.0,0.0
17793,1,7793,[127 187 483 302 211],328,5,34287,4.399153194765204,20.0,20.0
17794,1,7794,[ 95 385  69 269 174],524,3,34290,4.398973701090442,0.0,20.0
17795,1,7795,[127 187 483 302 211],343,5,34295,4.3990507952796305,20.0,20.0
17796,1,7796,[ 56 265 655 216  89],234,0,34295,4.39848659740926,0.0,0.0
17797,1,7797,[127 187 483 302 211],13,5,34300,4.3985637342908435,20.0,20.0
17798,1,7798,[ 79 211 238 200 245],749,4,34304,4.398512629824337,0.0,0.0
17799,1,7799,[568 153 117 483 475],374,3,34307,4.398333333333333,20.0,0.0
17800,1,7800,[235 496 135 276 302],378,3,34310,4.398154082809896,0.0,0.0
17801,1,7801,[127 187 483 302 211],6,5,34315,4.398231222763394,20.0,20.0
17802,1,7802,[127 187 483 302 211],524,5,34320,4.398308342945021,20.0,20.0
17803,1,7803,[132 483 234 127   4],326,2,34322,4.398001025115326,20.0,20.0
17804,1,7804,[127 187 483 302 211],207,5,34327,4.398078155028828,20.0,20.0
17805,1,7805,[127 187 483 302 211],207,5,34332,4.39815526518063,20.0,20.0
17806,1,7806,[204 742 176 180 385],346,5,34337,4.398232355578327,0.0,0.0
17807,1,7807,[471 195 132 235  89],788,2,34339,4.397925204918033,0.0,0.0
17808,1,7808,[127 187 483 302 211],13,5,34344,4.398002305032654,20.0,20.0
17809,1,7809,[127 187 483 302 211],537,5,34349,4.398079385403329,20.0,20.0
17810,1,7810,[185 289 271 127 385],13,1,34350,4.3976443477147615,0.0,20.0
17811,1,7811,[127 187 483 302 211],328,5,34355,4.397721454173067,20.0,20.0
17812,1,7812,[127 187 483 302 211],343,5,34360,4.397798540893382,20.0,20.0
17813,1,7813,[127 187 483 302 211],474,5,34365,4.397875607883287,20.0,20.0
17814,1,7814,[151 173 405 216 515],537,2,34367,4.397568777991043,0.0,0.0
17815,1,7815,[174 234  28 117 322],92,3,34370,4.397389969293757,0.0,20.0
17816,1,7816,[111 228 282 172 323],374,2,34372,4.397083280030702,0.0,0.0
17817,1,7817,[127 187 483 302 211],474,5,34377,4.397160399079048,20.0,20.0
17818,1,7818,[ 97 174  69 496 187],59,5,34382,4.3972374984013305,0.0,20.0
17819,1,7819,[301 423  28 405 215],537,0,34382,4.396675191815857,0.0,0.0
17820,1,7820,[127 187 483 302 211],537,5,34387,4.396752333461194,20.0,20.0
17821,1,7821,[127 187 483 302 211],833,3,34390,4.396573766300179,20.0,20.0
17822,1,7822,[127 187 483 302 211],537,5,34395,4.396650901188802,20.0,20.0
17823,1,7823,[127 187 483 302 211],537,5,34400,4.396728016359918,20.0,20.0
17824,1,7824,[127 187 483 302 211],6,5,34405,4.396805111821086,20.0,20.0
17825,1,7825,[127 187 483 302 211],474,5,34410,4.396882187579862,20.0,20.0
17826,1,7826,[127 187 483 302 211],537,5,34415,4.396959243643797,20.0,20.0
17827,1,7827,[127 187 483 302 211],537,5,34420,4.39703628002044,20.0,20.0
17828,1,7828,[127 187 483 302 211],13,5,34425,4.397113296717333,20.0,20.0
17829,1,7829,[127 187 483 302 211],90,5,34430,4.3971902937420175,20.0,20.0
17830,1,7830,[127 187 483 302 211],524,5,34435,4.39726727110203,20.0,20.0
17831,1,7831,[127 187 483 302 211],210,5,34440,4.397344228804903,20.0,20.0
17832,1,7832,[127 187 483 302 211],666,5,34445,4.397421166858164,20.0,20.0
17833,1,7833,[127 187 483 302 211],524,5,34450,4.397498085269339,20.0,20.0
17834,1,7834,[127 187 483 302 211],328,5,34455,4.3975749840459475,20.0,20.0
17835,1,7835,[127 187 483 302 211],343,5,34460,4.397651863195508,20.0,20.0
17836,1,7836,[127 187 483 302 211],833,3,34463,4.397473523031772,20.0,20.0
17837,1,7837,[403 132  56 588 301],234,1,34464,4.397040061240112,0.0,0.0
17838,1,7838,[127 187 483 302 211],90,5,34469,4.397116979206531,20.0,20.0
17839,1,7839,[127 187 483 302 211],6,5,34474,4.39719387755102,20.0,20.0
17840,1,7840,[127 187 483 302 211],210,5,34479,4.397270756281086,20.0,20.0
17841,1,7841,[275  12   9 318 294],378,4,34483,4.397220096914053,40.0,0.0
17842,1,7842,[127 187 483 302 211],343,5,34488,4.3972969526966725,20.0,20.0
17843,1,7843,[127 187 483 302 211],474,5,34493,4.397373788883223,20.0,20.0
17844,1,7844,[127 187 483 302 211],833,3,34496,4.397195666029318,20.0,20.0
17845,1,7845,[127 187 483 302 211],343,5,34501,4.397272495539128,20.0,20.0
17846,1,7846,[127 187 483 302 211],524,5,34506,4.397349305467057,20.0,20.0
17847,1,7847,[127 187 483 302 211],524,5,34511,4.397426095820591,20.0,20.0
17848,1,7848,[127 187 483 302 211],13,5,34516,4.397502866607211,20.0,20.0
17849,1,7849,[127 187 483 302 211],6,5,34521,4.397579617834395,20.0,20.0
17850,1,7850,[127 187 483 302 211],474,5,34526,4.397656349509616,20.0,20.0
17851,1,7851,[ 98 288 546 121 211],343,2,34528,4.397350993377484,0.0,20.0
17852,1,7852,[127 187 483 302 211],833,3,34531,4.397173054883484,20.0,20.0
17853,1,7853,[127 187 483 302 211],537,5,34536,4.3972498090145145,20.0,20.0
17854,1,7854,[228 294 483  82  97],95,2,34538,4.396944621260344,20.0,0.0
17855,1,7855,[127 187 483 302 211],833,3,34541,4.396766802443992,20.0,20.0
17856,1,7856,[742 289 183 168 238],334,3,34544,4.396589028891435,0.0,0.0
17857,1,7857,[286  50 546 210 265],234,1,34545,4.396156782896411,0.0,20.0
17858,1,7858,[127 187 483 302 211],90,5,34550,4.396233617508589,20.0,20.0
17859,1,7859,[121 143 183 176   4],64,3,34553,4.396055979643766,0.0,0.0
17860,1,7860,[127 187 483 302 211],474,5,34558,4.396132807530848,20.0,20.0
17861,1,7861,[228  98 215 222 161],650,3,34561,4.395955227677436,0.0,20.0
17862,1,7862,[127 187 483 302 211],339,5,34566,4.396032048836322,20.0,20.0
17863,1,7863,[111 597 546 118 127],83,2,34568,4.395727365208545,0.0,20.0
17864,1,7864,[127 187 483 302 211],13,5,34573,4.395804195804196,20.0,20.0
17865,1,7865,[127 187 483 302 211],328,5,34578,4.395881006864989,20.0,20.0
17866,1,7866,[127 187 483 302 211],474,5,34583,4.395957798398373,20.0,20.0
17867,1,7867,[127 187 483 302 211],210,5,34588,4.3960345704117945,20.0,20.0
17868,1,7868,[127 187 483 302 211],343,5,34593,4.396111322912695,20.0,20.0
17869,1,7869,[127 187 483 302 211],339,5,34598,4.396188055908513,20.0,20.0
17870,1,7870,[127 187 483 302 211],537,5,34603,4.396264769406683,20.0,20.0
17871,1,7871,[127 187 483 302 211],833,3,34606,4.396087398373984,20.0,20.0
17872,1,7872,[127 187 483 302 211],474,5,34611,4.396164105169567,20.0,20.0
17873,1,7873,[127 187 483 302 211],90,5,34616,4.396240792481585,20.0,20.0
17874,1,7874,[161 121 195 174 748],899,5,34621,4.39631746031746,0.0,20.0
17875,1,7875,[127 187 483 302 211],666,5,34626,4.3963941086846114,20.0,20.0
17876,1,7876,[127 187 483 302 211],207,5,34631,4.3964707375904535,20.0,20.0
17877,1,7877,[127 187 483 302 211],90,5,34636,4.396547347042397,20.0,20.0
17878,1,7878,[127 187 483 302 211],524,5,34641,4.396623937047849,20.0,20.0
17879,1,7879,[127 187 483 302 211],833,3,34644,4.396446700507614,20.0,20.0
17880,1,7880,[127 187 483 302 211],207,5,34649,4.396523283847228,20.0,20.0
17881,1,7881,[127 187 483 302 211],13,5,34654,4.396599847754377,20.0,20.0
17882,1,7882,[197  82 127  79 204],263,5,34659,4.396676392236458,0.0,20.0
17883,1,7883,[127 187 483 302 211],210,5,34664,4.396752917300862,20.0,20.0
17884,1,7884,[127 187 483 302 211],207,5,34669,4.396829422954978,20.0,20.0
17885,1,7885,[121 175  88 197 179],650,2,34671,4.396525488206949,0.0,0.0
17886,1,7886,[127 187 483 302 211],666,5,34676,4.396602003296564,20.0,20.0
17887,1,7887,[127 187 483 302 211],474,5,34681,4.396678498985802,20.0,20.0
17888,1,7888,[127 187 483 302 211],524,5,34686,4.396754975282038,20.0,20.0
17889,1,7889,[127 187 483 302 211],210,5,34691,4.3968314321926485,20.0,20.0
17890,1,7890,[127 187 483 302 211],343,5,34696,4.396907869725003,20.0,20.0
17891,1,7891,[127 187 483 302 211],343,5,34701,4.396984287886467,20.0,20.0
17892,1,7892,[597 161 210 237 313],308,1,34702,4.396553908526543,0.0,0.0
17893,1,7893,[127 187 483 302 211],833,3,34705,4.396376995186217,20.0,20.0
17894,1,7894,[215 182 483 135 265],524,3,34708,4.396200126662444,20.0,0.0
17895,1,7895,[127 187 483 302 211],524,5,34713,4.3962765957446805,20.0,20.0
17896,1,7896,[127 187 483 302 211],210,5,34718,4.396353045460302,20.0,20.0
17897,1,7897,[215 143 403 111  71],378,4,34722,4.39630286148392,0.0,0.0
17898,1,7898,[127 187 483 302 211],207,5,34727,4.396379288517534,20.0,20.0
17899,1,7899,[127 187 483 302 211],666,5,34732,4.396455696202532,20.0,20.0
17900,1,7900,[127 187 483 302 211],474,5,34737,4.39653208454626,20.0,20.0
17901,1,7901,[127 187 483 302 211],474,5,34742,4.396608453556062,20.0,20.0
17902,1,7902,[127 187 483 302 211],90,5,34747,4.3966848032392765,20.0,20.0
17903,1,7903,[127 187 483 302 211],210,5,34752,4.396761133603239,20.0,20.0
17904,1,7904,[127 187 483 302 211],474,5,34757,4.396837444655281,20.0,20.0
17905,1,7905,[127 187 483 302 211],343,5,34762,4.396913736402732,20.0,20.0
17906,1,7906,[ 22 742 183 496 403],313,2,34764,4.396610598204123,0.0,0.0
17907,1,7907,[127 187 483 302 211],13,5,34769,4.396686899342438,20.0,20.0
17908,1,7908,[127 187 483 302 211],524,5,34774,4.396763181185991,20.0,20.0
17909,1,7909,[127 187 483 302 211],524,5,34779,4.396839443742099,20.0,20.0
17910,1,7910,[127 187 483 302 211],13,5,34784,4.396915687018076,20.0,20.0
17911,1,7911,[127 187 483 302 211],339,5,34789,4.396991911021233,20.0,20.0
17912,1,7912,[ 71 172 125 181 282],804,5,34794,4.397068115758878,0.0,0.0
17913,1,7913,[127 187 483 302 211],537,5,34799,4.397144301238312,20.0,20.0
17914,1,7914,[127 187 483 302 211],13,5,34804,4.397220467466835,20.0,20.0
17915,1,7915,[ 22  56 143 194 179],311,3,34807,4.397043961596766,0.0,0.0
17916,1,7916,[172  70 235 200 118],13,2,34809,4.396741189844638,0.0,0.0
17917,1,7917,[144 181  95  88 202],815,4,34813,4.396691083606972,0.0,0.0
17918,1,7918,[127 187 483 302 211],833,3,34816,4.396514711453467,20.0,20.0
17919,1,7919,[127 187 483 302 211],6,5,34821,4.396590909090909,20.0,20.0
17920,1,7920,[127 187 483 302 211],537,5,34826,4.396667087488954,20.0,20.0
17921,1,7921,[496 282 245 204 151],653,2,34828,4.396364554405453,0.0,0.0
17922,1,7922,[127 187 483 302 211],210,5,34833,4.3964407421431275,20.0,20.0
17923,1,7923,[127 187 483 302 211],343,5,34838,4.3965169106511865,20.0,20.0
17924,1,7924,[127 187 483 302 211],6,5,34843,4.396593059936908,20.0,20.0
17925,1,7925,[127 187 483 302 211],328,5,34848,4.39666919000757,20.0,20.0
17926,1,7926,[186 204 742 748 222],328,2,34850,4.396366847483285,0.0,0.0
17927,1,7927,[127 187 483 302 211],6,5,34855,4.3964429868819375,20.0,20.0
17928,1,7928,[127 187 483 302 211],343,5,34860,4.396519107075293,20.0,20.0
17929,1,7929,[127 187 483 302 211],339,5,34865,4.396595208070618,20.0,20.0
17930,1,7930,[186 200  95 144 183],308,4,34869,4.396545202370445,0.0,0.0
17931,1,7931,[82 12 96  1  8],387,5,34874,4.396621280887544,20.0,0.0
17932,1,7932,[127 187 483 302 211],328,5,34879,4.396697340224379,20.0,20.0
17933,1,7933,[127 187 483 302 211],833,3,34882,4.396521300731031,20.0,20.0
17934,1,7934,[127 187 483 302 211],474,5,34887,4.396597353497165,20.0,20.0
17935,1,7935,[127 187 483 302 211],474,5,34892,4.396673387096774,20.0,20.0
17936,1,7936,[185 496 655  25 423],95,3,34895,4.396497417160136,0.0,0.0
17937,1,7937,[127 187 483 302 211],343,5,34900,4.396573444192492,20.0,20.0
17938,1,7938,[143 655 180 215 194],537,1,34901,4.3961456102783725,0.0,0.0
17939,1,7939,[678 182 180 196  28],339,4,34905,4.396095717884131,0.0,0.0
17940,1,7940,[127 187 483 302 211],343,5,34910,4.396171766780003,20.0,20.0
17941,1,7941,[127 187 483 302 211],210,5,34915,4.396247796524805,20.0,20.0
17942,1,7942,[127 187 483 302 211],207,5,34920,4.396323807125771,20.0,20.0
17943,1,7943,[183 228 403 174  50],738,4,34924,4.396273917421953,0.0,40.0
17944,1,7944,[127 187 483 302 211],537,5,34929,4.396349905601007,20.0,20.0
17945,1,7945,[597  71 237 568 202],95,3,34932,4.396174175685879,0.0,0.0
17946,1,7946,[151 211 186  15  70],234,0,34932,4.395620989052473,0.0,0.0
17947,1,7947,[127 187 483 302 211],474,5,34937,4.395697030699547,20.0,20.0
17948,1,7948,[161  70 276  98   9],308,3,34940,4.395521449238898,0.0,20.0
17949,1,7949,[127 187 483 302 211],666,5,34945,4.395597484276729,20.0,20.0
17950,1,7950,[175 144 182 238 288],833,3,34948,4.39542195950195,0.0,0.0
17951,1,7951,[127 187 483 302 211],90,5,34953,4.395497987927565,20.0,20.0
17952,1,7952,[508  79 282 655 515],326,3,34956,4.395322519803847,0.0,0.0
17953,1,7953,[127 187 483 302 211],524,5,34961,4.3953985416142825,20.0,20.0
17954,1,7954,[127 187 483 302 211],207,5,34966,4.395474544311754,20.0,20.0
17955,1,7955,[151  98 483 132 210],524,2,34968,4.395173453996984,20.0,20.0
17956,1,7956,[127 187 483 302 211],207,5,34973,4.3952494658791,20.0,20.0
17957,1,7957,[568 245 125 273  11],378,2,34975,4.394948479517467,0.0,0.0
17958,1,7958,[127 187 483 302 211],339,5,34980,4.395024500565397,20.0,20.0
17959,1,7959,[127 187 483 302 211],343,5,34985,4.3951005025125625,20.0,20.0
17960,1,7960,[127 187 483 302 211],474,5,34990,4.39517648536616,20.0,20.0
17961,1,7961,[ 28 168 135 202 121],343,4,34994,4.395126852549611,0.0,0.0
17962,1,7962,[127 187 483 302 211],537,5,34999,4.395202813010172,20.0,20.0
17963,1,7963,[ 79 228 197 210   7],537,2,35001,4.3949020592667,0.0,0.0
17964,1,7964,[300 179 271 423 603],843,2,35003,4.394601381042059,20.0,0.0
17965,1,7965,[271  56 195 173  69],506,5,35008,4.394677378860155,0.0,0.0
17966,1,7966,[127 187 483 302 211],537,5,35013,4.3947533576001,20.0,20.0
17967,1,7967,[216 258 187 222 234],474,5,35018,4.394829317269076,0.0,0.0
17968,1,7968,[127 187 483 302 211],6,5,35023,4.394905257874263,20.0,20.0
17969,1,7969,[210 265  28 191  88],815,4,35027,4.394855708908406,0.0,0.0
17970,1,7970,[127 187 483 302 211],90,5,35032,4.394931627148413,20.0,20.0
17971,1,7971,[210   1 234 257 222],804,5,35037,4.395007526342198,0.0,0.0
17972,1,7972,[127 187 483 302 211],474,5,35042,4.395083406496927,20.0,20.0
17973,1,7973,[127 187 483 302 211],13,5,35047,4.395159267619764,20.0,20.0
17974,1,7974,[127 187 483 302 211],339,5,35052,4.395235109717868,20.0,20.0
17975,1,7975,[127 187 483 302 211],328,5,35057,4.395310932798395,20.0,20.0
17976,1,7976,[127 187 483 302 211],833,3,35060,4.395136016046132,20.0,20.0
17977,1,7977,[127 187 483 302 211],13,5,35065,4.395211832539483,20.0,20.0
17978,1,7978,[127 187 483 302 211],13,5,35070,4.395287630028825,20.0,20.0
17979,1,7979,[ 15 194 234 186 508],543,2,35072,4.394987468671679,0.0,0.0
17980,1,7980,[127 187 483 302 211],13,5,35077,4.395063275278787,20.0,20.0
17981,1,7981,[127 187 483 302 211],13,5,35082,4.395139062891506,20.0,20.0
17982,1,7982,[174   1   9 196 215],311,5,35087,4.395214831516974,0.0,20.0
17983,1,7983,[286 276  15 300   4],533,3,35090,4.395040080160321,0.0,0.0
17984,1,7984,[127 187 483 302 211],6,5,35095,4.395115842204133,20.0,20.0
17985,1,7985,[127 187 483 302 211],537,5,35100,4.39519158527423,20.0,20.0
17986,1,7986,[118 215 181 222 196],881,3,35103,4.395016902466508,0.0,0.0
17987,1,7987,[127 187 483 302 211],207,5,35108,4.395092638958437,20.0,20.0
17988,1,7988,[127 187 483 302 211],339,5,35113,4.395168356490174,20.0,20.0
17989,1,7989,[ 50   1 211  95 117],271,3,35116,4.394993742177722,0.0,20.0
17990,1,7990,[127 187 483 302 211],13,5,35121,4.395069453134776,20.0,20.0
17991,1,7991,[127 187 483 302 211],90,5,35126,4.395145145145145,20.0,20.0
17992,1,7992,[ 89  28 237 257 195],6,2,35128,4.394845489803578,0.0,0.0
17993,1,7993,[127 187 483 302 211],210,5,35133,4.39492119089317,20.0,20.0
17994,1,7994,[127 187 483 302 211],90,5,35138,4.3949968730456535,20.0,20.0
17995,1,7995,[127 187 483 302 211],210,5,35143,4.395072536268134,20.0,20.0
17996,1,7996,[127 187 483 302 211],6,5,35148,4.395148180567713,20.0,20.0
17997,1,7997,[127 187 483 302 211],474,5,35153,4.395223805951487,20.0,20.0
17998,1,7998,[515 286 196 153   9],343,5,35158,4.395299412426553,0.0,0.0
17999,1,7999,[678 125 161 132 185],749,3,35161,4.395125,0.0,0.0
18000,1,8000,[127 187 483 302 211],537,5,35166,4.395200599925009,20.0,20.0
18001,1,8001,[127 187 483 302 211],524,5,35171,4.395276180954761,20.0,20.0
18002,1,8002,[237 603 496  70 471],533,4,35175,4.395226789953767,20.0,0.0
18003,1,8003,[161 181 228 174 257],479,4,35179,4.395177411294353,0.0,20.0
18004,1,8004,[127 187 483 302 211],833,3,35182,4.395003123048095,20.0,20.0
18005,1,8005,[127 187 483 302 211],328,5,35187,4.395078690981764,20.0,20.0
18006,1,8006,[127 187 483 302 211],207,5,35192,4.3951542400399655,20.0,20.0
18007,1,8007,[127 187 483 302 211],343,5,35197,4.39522977022977,20.0,20.0
18008,1,8008,[176 405 742 210  25],749,4,35201,4.395180422025222,0.0,0.0
18009,1,8009,[127 187 483 302 211],537,5,35206,4.395255930087391,20.0,20.0
18010,1,8010,[127 187 483 302 211],537,5,35211,4.395331419298465,20.0,20.0
18011,1,8011,[127 187 483 302 211],207,5,35216,4.395406889665502,20.0,20.0
18012,1,8012,[127 187 483 302 211],343,5,35221,4.3954823411955575,20.0,20.0
18013,1,8013,[127 187 483 302 211],207,5,35226,4.395557773895683,20.0,20.0
18014,1,8014,[127 187 483 302 211],339,5,35231,4.395633187772925,20.0,20.0
18015,1,8015,[127 187 483 302 211],343,5,35236,4.395708582834331,20.0,20.0
18016,1,8016,[127 187 483 302 211],537,5,35241,4.39578395908694,20.0,20.0
18017,1,8017,[127 187 483 302 211],6,5,35246,4.39585931653779,20.0,20.0
18018,1,8018,[127 187 483 302 211],537,5,35251,4.395934655193915,20.0,20.0
18019,1,8019,[127 187 483 302 211],328,5,35256,4.396009975062344,20.0,20.0
18020,1,8020,[127 187 483 302 211],207,5,35261,4.396085276150106,20.0,20.0
18021,1,8021,[127 187 483 302 211],207,5,35266,4.396160558464223,20.0,20.0
18022,1,8022,[127 187 483 302 211],210,5,35271,4.396235822011716,20.0,20.0
18023,1,8023,[127 187 483 302 211],537,5,35276,4.396311066799601,20.0,20.0
18024,1,8024,[282 180 515 257  98],121,3,35279,4.39613707165109,0.0,20.0
18025,1,8025,[127 187 483 302 211],343,5,35284,4.396212309992524,20.0,20.0
18026,1,8026,[127 187 483 302 211],343,5,35289,4.396287529587641,20.0,20.0
18027,1,8027,[258 215 132   1 435],380,3,35292,4.39611360239163,0.0,0.0
18028,1,8028,[127 187 483 302 211],524,5,35297,4.396188815543654,20.0,20.0
18029,1,8029,[127 187 483 302 211],13,5,35302,4.39626400996264,20.0,20.0
18030,1,8030,[257  12 210  64 187],474,4,35306,4.3962146681608765,20.0,0.0
18031,1,8031,[ 71 191 216 269   1],378,5,35311,4.39628984063745,0.0,0.0
18032,1,8032,[127 187 483 302 211],207,5,35316,4.396364994398108,20.0,20.0
18033,1,8033,[196 496 333 144 204],653,2,35318,4.396066716455066,0.0,0.0
18034,1,8034,[286 313 143  95 678],454,2,35320,4.39576851275669,0.0,0.0
18035,1,8035,[127 187 483 302 211],666,5,35325,4.395843703334992,20.0,20.0
18036,1,8036,[127 187 483 302 211],6,5,35330,4.39591887520219,20.0,20.0
18037,1,8037,[195 143 300  71 121],840,2,35332,4.395620801194327,0.0,0.0
18038,1,8038,[127 187 483 302 211],537,5,35337,4.395695982087324,20.0,20.0
18039,1,8039,[127 187 483 302 211],210,5,35342,4.395771144278607,20.0,20.0
18040,1,8040,[127 187 483 302 211],833,3,35345,4.395597562492227,20.0,20.0
18041,1,8041,[127 187 483 302 211],210,5,35350,4.395672718229296,20.0,20.0
18042,1,8042,[127 187 483 302 211],524,5,35355,4.3957478552778815,20.0,20.0
18043,1,8043,[127 187 483 302 211],537,5,35360,4.395822973644953,20.0,20.0
18044,1,8044,[423 191 265 269 125],64,4,35364,4.395773772529521,0.0,0.0
18045,1,8045,[127 187 483 302 211],328,5,35369,4.395848869003231,20.0,20.0
18046,1,8046,[127 187 483 302 211],207,5,35374,4.395923946812477,20.0,20.0
18047,1,8047,[127 187 483 302 211],13,5,35379,4.395999005964215,20.0,20.0
18048,1,8048,[127 187 483 302 211],666,5,35384,4.396074046465399,20.0,20.0
18049,1,8049,[117 211  70  89  71],454,1,35385,4.395652173913043,0.0,0.0
18050,1,8050,[127 187 483 302 211],537,5,35390,4.3957272388523165,20.0,20.0
18051,1,8051,[597 313 215 471 655],144,5,35395,4.395802285146547,0.0,0.0
18052,1,8052,[127 187 483 302 211],90,5,35400,4.395877312802682,20.0,20.0
18053,1,8053,[127 187 483 302 211],328,5,35405,4.3959523218276635,20.0,20.0
18054,1,8054,[127 187 483 302 211],666,5,35410,4.39602731222843,20.0,20.0
18055,1,8055,[191  50 111 100  22],234,4,35414,4.3959781529294935,0.0,40.0
18056,1,8056,[127 187 483 302 211],833,3,35417,4.395804890157627,20.0,20.0
18057,1,8057,[238 127  69 271 191],738,4,35421,4.395755770662696,0.0,20.0
18058,1,8058,[127 187 483 302 211],328,5,35426,4.39583074823179,20.0,20.0
18059,1,8059,[127 187 483 302 211],833,3,35429,4.395657568238214,20.0,20.0
18060,1,8060,[127 187 483 302 211],833,3,35432,4.395484431212008,20.0,20.0
18061,1,8061,[127 187 483 302 211],207,5,35437,4.395559414537336,20.0,20.0
18062,1,8062,[127 187 483 302 211],6,5,35442,4.395634379263302,20.0,20.0
18063,1,8063,[127 187 483 302 211],13,5,35447,4.395709325396825,20.0,20.0
18064,1,8064,[127 187 483 302 211],666,5,35452,4.395784252944823,20.0,20.0
18065,1,8065,[127 187 483 302 211],328,5,35457,4.395859161914208,20.0,20.0
18066,1,8066,[127 187 483 302 211],90,5,35462,4.395934052311888,20.0,20.0
18067,1,8067,[127 187 483 302 211],524,5,35467,4.39600892414477,20.0,20.0
18068,1,8068,[127 187 483 302 211],537,5,35472,4.396083777419754,20.0,20.0
18069,1,8069,[127 187 483 302 211],207,5,35477,4.396158612143743,20.0,20.0
18070,1,8070,[127 187 483 302 211],90,5,35482,4.396233428323628,20.0,20.0
18071,1,8071,[127 187 483 302 211],90,5,35487,4.396308225966303,20.0,20.0
18072,1,8072,[127 187 483 302 211],537,5,35492,4.396383005078658,20.0,20.0
18073,1,8073,[127 187 483 302 211],207,5,35497,4.3964577656675745,20.0,20.0
18074,1,8074,[127 187 483 302 211],666,5,35502,4.396532507739938,20.0,20.0
18075,1,8075,[127 187 483 302 211],90,5,35507,4.396607231302625,20.0,20.0
18076,1,8076,[435 185 132 183 118],788,3,35510,4.396434319673146,0.0,0.0
18077,1,8077,[127 187 483 302 211],474,5,35515,4.396509036890319,20.0,20.0
18078,1,8078,[435  15 234 210  70],452,3,35518,4.396336180220325,0.0,0.0
18079,1,8079,[127 187 483 302 211],6,5,35523,4.396410891089109,20.0,20.0
18080,1,8080,[127 187 483 302 211],537,5,35528,4.396485583467393,20.0,20.0
18081,1,8081,[196 568   9  71 603],13,3,35531,4.396312793862905,20.0,0.0
18082,1,8082,[322 276 546 301 289],13,1,35532,4.395892614128417,0.0,0.0
18083,1,8083,[127 187 483 302 211],90,5,35537,4.395967342899555,20.0,20.0
18084,1,8084,[127 187 483 302 211],13,5,35542,4.39604205318491,20.0,20.0
18085,1,8085,[127 187 483 302 211],210,5,35547,4.396116744991343,20.0,20.0
18086,1,8086,[127 187 483 302 211],90,5,35552,4.396191418325708,20.0,20.0
18087,1,8087,[127 187 483 302 211],524,5,35557,4.396266073194856,20.0,20.0
18088,1,8088,[127 187 483 302 211],833,3,35560,4.396093460254667,20.0,20.0
18089,1,8089,[127 187 483 302 211],6,5,35565,4.396168108776267,20.0,20.0
18090,1,8090,[127 187 483 302 211],339,5,35570,4.396242738845631,20.0,20.0
18091,1,8091,[127 187 483 302 211],328,5,35575,4.3963173504696,20.0,20.0
18092,1,8092,[175 273 508 191  71],92,5,35580,4.3963919436550105,0.0,0.0
18093,1,8093,[  8   9   7 515 168],474,4,35584,4.396342970101309,0.0,0.0
18094,1,8094,[127 187 483 302 211],207,5,35589,4.3964175416924025,20.0,20.0
18095,1,8095,[127 187 483 302 211],666,5,35594,4.39649209486166,20.0,20.0
18096,1,8096,[186  50 204 127  97],848,4,35598,4.396443127084106,0.0,40.0
18097,1,8097,[288 423 235 125 144],378,3,35601,4.396270684119536,0.0,0.0
18098,1,8098,[194 211 151  88 318],648,3,35604,4.396098283738733,20.0,0.0
18099,1,8099,[127 187 483 302 211],537,5,35609,4.396172839506173,20.0,20.0
18100,1,8100,[  9 245  98  12 603],533,4,35613,4.396123935316628,40.0,20.0
18101,1,8101,[427  89 132  96   4],7,5,35618,4.3961984695137,0.0,0.0
18102,1,8102,[127 187 483 302 211],210,5,35623,4.396272985314082,20.0,20.0
18103,1,8103,[127 187 483 302 211],207,5,35628,4.396347482724581,20.0,20.0
18104,1,8104,[127 187 483 302 211],328,5,35633,4.396421961752005,20.0,20.0
18105,1,8105,[127 187 483 302 211],207,5,35638,4.396496422403158,20.0,20.0
18106,1,8106,[127 187 483 302 211],6,5,35643,4.39657086468484,20.0,20.0
18107,1,8107,[  1 269 483 275 187],312,5,35648,4.396645288603848,20.0,0.0
18108,1,8108,[127 187 483 302 211],666,5,35653,4.396719694166975,20.0,20.0
18109,1,8109,[127 187 483 302 211],210,5,35658,4.396794081381011,20.0,20.0
18110,1,8110,[127 187 483 302 211],90,5,35663,4.396868450252743,20.0,20.0
18111,1,8111,[127 187 483 302 211],6,5,35668,4.396942800788954,20.0,20.0
18112,1,8112,[111 265 174 294 678],537,0,35668,4.396400838160976,0.0,20.0
18113,1,8113,[127 187 483 302 211],339,5,35673,4.396475228000986,20.0,20.0
18114,1,8114,[127 187 483 302 211],666,5,35678,4.396549599507086,20.0,20.0
18115,1,8115,[127 187 483 302 211],833,3,35681,4.396377525874815,20.0,20.0
18116,1,8116,[216  56  12  89 132],537,2,35683,4.3960822964149315,20.0,0.0
18117,1,8117,[127 187 483 302 211],833,3,35686,4.395910322739591,20.0,20.0
18118,1,8118,[127 187 483 302 211],343,5,35691,4.3959847271831505,20.0,20.0
18119,1,8119,[  1 403 269 174 191],64,5,35696,4.396059113300493,0.0,20.0
18120,1,8120,[127 187 483 302 211],833,3,35699,4.395887206009112,20.0,20.0
18121,1,8121,[127 187 483 302 211],6,5,35704,4.395961585816301,20.0,20.0
18122,1,8122,[127 187 483 302 211],6,5,35709,4.396035947310107,20.0,20.0
18123,1,8123,[127 187 483 302 211],207,5,35714,4.396110290497292,20.0,20.0
18124,1,8124,[127 187 483 302 211],6,5,35719,4.396184615384615,20.0,20.0
18125,1,8125,[127 187 483 302 211],339,5,35724,4.396258921978833,20.0,20.0
18126,1,8126,[127 187 483 302 211],537,5,35729,4.3963332102866985,20.0,20.0
18127,1,8127,[127 187 483 302 211],13,5,35734,4.39640748031496,20.0,20.0
18128,1,8128,[127 187 483 302 211],343,5,35739,4.396481732070366,20.0,20.0
18129,1,8129,[127 187 483 302 211],666,5,35744,4.3965559655596556,20.0,20.0
18130,1,8130,[127 187 483 302 211],210,5,35749,4.396630180789571,20.0,20.0
18131,1,8131,[127 187 483 302 211],343,5,35754,4.396704377766847,20.0,20.0
18132,1,8132,[ 64   7 515 301  70],184,3,35757,4.396532644780524,0.0,0.0
18133,1,8133,[127 187 483 302 211],328,5,35762,4.3966068355052865,20.0,20.0
18134,1,8134,[385 237 118 144 172],804,5,35767,4.396681007990166,0.0,0.0
18135,1,8135,[127 187 483 302 211],537,5,35772,4.396755162241888,20.0,20.0
18136,1,8136,[127 187 483 302 211],833,3,35775,4.396583507435173,20.0,20.0
18137,1,8137,[127 187 483 302 211],13,5,35780,4.396657655443598,20.0,20.0
18138,1,8138,[127 187 483 302 211],666,5,35785,4.396731785231601,20.0,20.0
18139,1,8139,[127 187 483 302 211],537,5,35790,4.396805896805897,20.0,20.0
18140,1,8140,[127 187 483 302 211],343,5,35795,4.396879990173197,20.0,20.0
18141,1,8141,[127 187 483 302 211],6,5,35800,4.3969540653402115,20.0,20.0
18142,1,8142,[127 187 483 302 211],343,5,35805,4.397028122313643,20.0,20.0
18143,1,8143,[294 546 403 288 515],7,3,35808,4.3968565815324165,0.0,0.0
18144,1,8144,[127 187 483 302 211],6,5,35813,4.396930632289748,20.0,20.0
18145,1,8145,[127 187 483 302 211],666,5,35818,4.397004664866192,20.0,20.0
18146,1,8146,[127 187 483 302 211],210,5,35823,4.397078679268442,20.0,20.0
18147,1,8147,[127 187 483 302 211],207,5,35828,4.397152675503191,20.0,20.0
18148,1,8148,[ 95 197  79 216  88],543,4,35832,4.397103939133636,0.0,0.0
18149,1,8149,[127 187 483 302 211],537,5,35837,4.397177914110429,20.0,20.0
18150,1,8150,[127 187 483 302 211],13,5,35842,4.397251870936081,20.0,20.0
18151,1,8151,[127 187 483 302 211],13,5,35847,4.397325809617272,20.0,20.0
18152,1,8152,[435 265  69 222 235],295,5,35852,4.397399730160677,0.0,0.0
18153,1,8153,[678 357 603 135 197],339,4,35856,4.397350993377484,40.0,0.0
18154,1,8154,[127 187 483 302 211],474,5,35861,4.397424892703863,20.0,20.0
18155,1,8155,[127 187 483 302 211],90,5,35866,4.3974987739087785,20.0,20.0
18156,1,8156,[127 187 483 302 211],207,5,35871,4.3975726369988966,20.0,20.0
18157,1,8157,[127 187 483 302 211],833,3,35874,4.397401323853885,20.0,20.0
18158,1,8158,[ 82 471  70 179 403],524,5,35879,4.397475180781958,0.0,0.0
18159,1,8159,[181 568  25 161 127],897,3,35882,4.397303921568628,0.0,20.0
18160,1,8160,[127 187 483 302 211],537,5,35887,4.397377772331822,20.0,20.0
18161,1,8161,[127 187 483 302 211],207,5,35892,4.397451604998775,20.0,20.0
18162,1,8162,[127 187 483 302 211],13,5,35897,4.397525419576136,20.0,20.0
18163,1,8163,[300 333 234 269 216],85,1,35898,4.397109260166585,0.0,0.0
18164,1,8164,[127 187 483 302 211],474,5,35903,4.397183098591549,20.0,20.0
18165,1,8165,[127 187 483 302 211],210,5,35908,4.3972569189321575,20.0,20.0
18166,1,8166,[127 187 483 302 211],6,5,35913,4.397330721195053,20.0,20.0
18167,1,8167,[127 187 483 302 211],833,3,35916,4.397159647404505,20.0,20.0
18168,1,8168,[127 187 483 302 211],328,5,35921,4.397233443505937,20.0,20.0
18169,1,8169,[546 172 195 385 187],308,4,35925,4.39718482252142,0.0,0.0
18170,1,8170,[127 187 483 302 211],207,5,35930,4.3972585974788885,20.0,20.0
18171,1,8171,[127 187 483 302 211],328,5,35935,4.397332354380812,20.0,20.0
18172,1,8172,[172  88 161 423 185],194,2,35937,4.397039030955585,0.0,0.0
18173,1,8173,[127 187 483 302 211],13,5,35942,4.397112796672376,20.0,20.0
18174,1,8174,[127 187 483 302 211],524,5,35947,4.3971865443425076,20.0,20.0
18175,1,8175,[127 187 483 302 211],90,5,35952,4.397260273972603,20.0,20.0
18176,1,8176,[127 187 483 302 211],833,3,35955,4.397089397089397,20.0,20.0
18177,1,8177,[127 187 483 302 211],328,5,35960,4.397163120567376,20.0,20.0
18178,1,8178,[435 282 161  28  96],533,5,35965,4.397236826017851,0.0,0.0
18179,1,8179,[127 187 483 302 211],833,3,35968,4.397066014669926,20.0,20.0
18180,1,8180,[127 187 483 302 211],339,5,35973,4.397139713971397,20.0,20.0
18181,1,8181,[127 187 483 302 211],13,5,35978,4.397213395257883,20.0,20.0
18182,1,8182,[127 187 483 302 211],537,5,35983,4.397287058535989,20.0,20.0
18183,1,8183,[127 187 483 302 211],207,5,35988,4.397360703812317,20.0,20.0
18184,1,8184,[515 197 216 423 100],308,2,35990,4.397067806963959,0.0,20.0
18185,1,8185,[127 187 483 302 211],474,5,35995,4.397141461031029,20.0,20.0
18186,1,8186,[ 50 508  25 318   8],378,5,36000,4.397215097105167,20.0,20.0
18187,1,8187,[127 187 483 302 211],474,5,36005,4.397288715192965,20.0,20.0
18188,1,8188,[127 187 483 302 211],90,5,36010,4.397362315301014,20.0,20.0
18189,1,8189,[127 187 483 302 211],207,5,36015,4.397435897435898,20.0,20.0
18190,1,8190,[127 187 483 302 211],328,5,36020,4.3975094616042,20.0,20.0
18191,1,8191,[300 216 294 228 742],653,2,36022,4.397216796875,0.0,0.0
18192,1,8192,[  9 276 179  82  64],13,2,36024,4.396924203588429,0.0,0.0
18193,1,8193,[127 187 483 302 211],6,5,36029,4.396997803270686,20.0,20.0
18194,1,8194,[127 187 483 302 211],474,5,36034,4.3970713849908485,20.0,20.0
18195,1,8195,[127 187 483 302 211],537,5,36039,4.39714494875549,20.0,20.0
18196,1,8196,[483   9  50 588 168],308,4,36043,4.397096498719043,20.0,20.0
18197,1,8197,[127 187 483 302 211],666,5,36048,4.39717004147353,20.0,20.0
18198,1,8198,[127 187 483 302 211],524,5,36053,4.397243566288572,20.0,20.0
18199,1,8199,[127 187 483 302 211],474,5,36058,4.397317073170732,20.0,20.0
18200,1,8200,[127 187 483 302 211],90,5,36063,4.39739056212657,20.0,20.0
18201,1,8201,[173 435 127  50  89],890,5,36068,4.397464033162644,0.0,40.0
18202,1,8202,[127 187 483 302 211],666,5,36073,4.397537486285505,20.0,20.0
18203,1,8203,[127 187 483 302 211],343,5,36078,4.397610921501706,20.0,20.0
18204,1,8204,[187 357 655 328 294],144,4,36082,4.397562461913467,20.0,0.0
18205,1,8205,[127 187 483 302 211],207,5,36087,4.397635876188155,20.0,20.0
18206,1,8206,[127 187 483 302 211],210,5,36092,4.397709272572195,20.0,20.0
18207,1,8207,[127 187 483 302 211],207,5,36097,4.3977826510721245,20.0,20.0
18208,1,8208,[127 187 483 302 211],13,5,36102,4.397856011694482,20.0,20.0
18209,1,8209,[127 187 483 302 211],474,5,36107,4.397929354445798,20.0,20.0
18210,1,8210,[127 187 483 302 211],474,5,36112,4.398002679332603,20.0,20.0
18211,1,8211,[127 187 483 302 211],210,5,36117,4.398075986361422,20.0,20.0
18212,1,8212,[127 187 483 302 211],6,5,36122,4.39814927553878,20.0,20.0
18213,1,8213,[127 187 483 302 211],343,5,36127,4.398222546871196,20.0,20.0
18214,1,8214,[ 50 144 435  25 111],398,4,36131,4.398174071819842,0.0,20.0
18215,1,8215,[127 187 483 302 211],6,5,36136,4.398247322297955,20.0,20.0
18216,1,8216,[127 187 483 302 211],524,5,36141,4.398320554947061,20.0,20.0
18217,1,8217,[127 187 483 302 211],666,5,36146,4.3983937697736675,20.0,20.0
18218,1,8218,[211 258 288  69 197],537,3,36149,4.39822362817861,0.0,0.0
18219,1,8219,[127 187 483 302 211],537,5,36154,4.3982968369829685,20.0,20.0
18220,1,8220,[127 187 483 302 211],90,5,36159,4.398370027977132,20.0,20.0
18221,1,8221,[127 187 483 302 211],210,5,36164,4.398443201167599,20.0,20.0
18222,1,8222,[127 187 483 302 211],833,3,36167,4.398273136324942,20.0,20.0
18223,1,8223,[127 187 483 302 211],6,5,36172,4.398346303501945,20.0,20.0
18224,1,8224,[127 187 483 302 211],537,5,36177,4.398419452887538,20.0,20.0
18225,1,8225,[  9 235  15 215 194],59,3,36180,4.398249452954048,0.0,0.0
18226,1,8226,[294 153 135 143 597],95,2,36182,4.397957943357238,0.0,0.0
18227,1,8227,[127 187 483 302 211],13,5,36187,4.398031113271755,20.0,20.0
18228,1,8228,[265 179 191 135 151],536,3,36190,4.397861222505772,0.0,0.0
18229,1,8229,[127 187 483 302 211],339,5,36195,4.397934386391252,20.0,20.0
18230,1,8230,[127 187 483 302 211],210,5,36200,4.398007532499089,20.0,20.0
18231,1,8231,[127 187 483 302 211],6,5,36205,4.398080660835763,20.0,20.0
18232,1,8232,[127 187 483 302 211],474,5,36210,4.398153771407749,20.0,20.0
18233,1,8233,[127 187 483 302 211],537,5,36215,4.39822686422152,20.0,20.0
18234,1,8234,[603  97 175 257 168],666,4,36219,4.398178506375228,20.0,0.0
18235,1,8235,[ 22 191 176  56 546],533,2,36221,4.397887323943662,0.0,0.0
18236,1,8236,[127 187 483 302 211],339,5,36226,4.397960422483914,20.0,20.0
18237,1,8237,[127 187 483 302 211],474,5,36231,4.398033503277494,20.0,20.0
18238,1,8238,[127 187 483 302 211],537,5,36236,4.398106566330865,20.0,20.0
18239,1,8239,[127 187 483 302 211],537,5,36241,4.398179611650486,20.0,20.0
18240,1,8240,[127 187 483 302 211],13,5,36246,4.39825263924281,20.0,20.0
18241,1,8241,[127 187 483 302 211],474,5,36251,4.398325649114293,20.0,20.0
18242,1,8242,[127 187 483 302 211],537,5,36256,4.398398641271382,20.0,20.0
18243,1,8243,[ 95   8 568  12 471],92,3,36259,4.398229015041242,20.0,0.0
18244,1,8244,[127 187 483 302 211],524,5,36264,4.398302001212857,20.0,20.0
18245,1,8245,[127 187 483 302 211],90,5,36269,4.39837496968227,20.0,20.0
18246,1,8246,[127 187 483 302 211],474,5,36274,4.398447920455923,20.0,20.0
18247,1,8247,[127 187 483 302 211],13,5,36279,4.398520853540252,20.0,20.0
18248,1,8248,[127 187 483 302 211],13,5,36284,4.39859376894169,20.0,20.0
18249,1,8249,[385 100 210 121  28],311,4,36288,4.398545454545455,0.0,20.0
18250,1,8250,[127 187 483 302 211],474,5,36293,4.398618349290995,20.0,20.0
18251,1,8251,[191  89  56 515 179],308,4,36297,4.398570043625788,0.0,0.0
18252,1,8252,[127 187 483 302 211],666,5,36302,4.398642917726887,20.0,20.0
18253,1,8253,[127 187 483 302 211],13,5,36307,4.3987157741701,20.0,20.0
18254,1,8254,[127 187 483 302 211],833,3,36310,4.39854633555421,20.0,20.0
18255,1,8255,[168 211  69 174  56],804,4,36314,4.398498062015504,0.0,20.0
18256,1,8256,[127 187 483 302 211],6,5,36319,4.398570909531307,20.0,20.0
18257,1,8257,[127 187 483 302 211],524,5,36324,4.398643739404214,20.0,20.0
18258,1,8258,[127 187 483 302 211],474,5,36329,4.398716551640635,20.0,20.0
18259,1,8259,[127 187 483 302 211],474,5,36334,4.398789346246973,20.0,20.0
18260,1,8260,[153  22 194  71  69],298,4,36338,4.398741072509382,0.0,0.0
18261,1,8261,[228 238 496 161 174],749,3,36341,4.398571774388768,0.0,20.0
18262,1,8262,[127 187 483 302 211],537,5,36346,4.398644560087136,20.0,20.0
18263,1,8263,[127 187 483 302 211],537,5,36351,4.3987173281703775,20.0,20.0
18264,1,8264,[127 187 483 302 211],210,5,36356,4.398790078644888,20.0,20.0
18265,1,8265,[127 187 483 302 211],13,5,36361,4.398862811517058,20.0,20.0
18266,1,8266,[127 187 483 302 211],833,3,36364,4.3986936010644735,20.0,20.0
18267,1,8267,[187 181 228 174 204],650,4,36368,4.398645379777455,0.0,20.0
18268,1,8268,[127 187 483 302 211],537,5,36373,4.398718103761035,20.0,20.0
18269,1,8269,[127 187 483 302 211],833,3,36376,4.3985489721886335,20.0,20.0
18270,1,8270,[127 187 483 302 211],524,5,36381,4.398621690243018,20.0,20.0
18271,1,8271,[  1 257  22 181  64],455,5,36386,4.398694390715668,0.0,0.0
18272,1,8272,[234 182 118  88 191],454,3,36389,4.398525323340989,0.0,0.0
18273,1,8273,[ 79 257 143 282 200],334,4,36393,4.398477157360406,0.0,0.0
18274,1,8274,[127 187 483 302 211],90,5,36398,4.398549848942598,20.0,20.0
18275,1,8275,[127 187 483 302 211],339,5,36403,4.39862252295795,20.0,20.0
18276,1,8276,[127 187 483 302 211],833,3,36406,4.398453545970763,20.0,20.0
18277,1,8277,[215 194 603 187   4],650,2,36408,4.398163807683015,20.0,0.0
18278,1,8278,[318  98 288  96 135],378,3,36411,4.397994926923541,20.0,20.0
18279,1,8279,[127 187 483 302 211],13,5,36416,4.398067632850242,20.0,20.0
18280,1,8280,[127 187 483 302 211],474,5,36421,4.3981403212172445,20.0,20.0
18281,1,8281,[127 187 483 302 211],833,3,36424,4.39797150446752,20.0,20.0
18282,1,8282,[127 187 483 302 211],13,5,36429,4.398044186888808,20.0,20.0
18283,1,8283,[127 187 483 302 211],524,5,36434,4.398116851762434,20.0,20.0
18284,1,8284,[127 187 483 302 211],339,5,36439,4.39818949909475,20.0,20.0
18285,1,8285,[127 187 483 302 211],339,5,36444,4.3982621288921075,20.0,20.0
18286,1,8286,[127 187 483 302 211],210,5,36449,4.398334741160855,20.0,20.0
18287,1,8287,[127 187 483 302 211],13,5,36454,4.398407335907336,20.0,20.0
18288,1,8288,[127 187 483 302 211],666,5,36459,4.398479913137893,20.0,20.0
18289,1,8289,[127 187 483 302 211],537,5,36464,4.398552472858866,20.0,20.0
18290,1,8290,[204 194 196 276 197],189,4,36468,4.398504402364009,0.0,0.0
18291,1,8291,[127 187 483 302 211],666,5,36473,4.398576941630488,20.0,20.0
18292,1,8292,[127 187 483 302 211],90,5,36478,4.39864946340287,20.0,20.0
18293,1,8293,[127 187 483 302 211],6,5,36483,4.398721967687485,20.0,20.0
18294,1,8294,[ 64 179 161  71  22],308,4,36487,4.398673899939722,0.0,0.0
18295,1,8295,[127 187 483 302 211],833,3,36490,4.398505303760849,20.0,20.0
18296,1,8296,[127 187 483 302 211],13,5,36495,4.398577799204531,20.0,20.0
18297,1,8297,[127 187 483 302 211],6,5,36500,4.398650277175223,20.0,20.0
18298,1,8298,[172 161 143 496 176],290,5,36505,4.398722737679239,0.0,0.0
18299,1,8299,[127 187 483 302 211],666,5,36510,4.3987951807228916,20.0,20.0
18300,1,8300,[197  64 191 301 135],524,3,36513,4.3986266714853635,0.0,0.0
18301,1,8301,[ 82  71  28 215  56],13,4,36517,4.398578655745603,0.0,0.0
18302,1,8302,[127 187 483 302 211],343,5,36522,4.3986510899674816,20.0,20.0
18303,1,8303,[127 187 483 302 211],90,5,36527,4.398723506743738,20.0,20.0
18304,1,8304,[127 187 483 302 211],524,5,36532,4.398795906080674,20.0,20.0
18305,1,8305,[127 187 483 302 211],210,5,36537,4.398868287984589,20.0,20.0
18306,1,8306,[204  79 435  97 483],458,4,36541,4.398820272059709,20.0,0.0
18307,1,8307,[211 100 197 143 301],524,4,36545,4.398772267693789,0.0,20.0
18308,1,8308,[127 187 483 302 211],207,5,36550,4.398844626308822,20.0,20.0
18309,1,8309,[179  96 127 273 195],749,5,36555,4.398916967509026,0.0,20.0
18310,1,8310,[127 187 483 302 211],90,5,36560,4.398989291300686,20.0,20.0
18311,1,8311,[127 187 483 302 211],339,5,36565,4.399061597690086,20.0,20.0
18312,1,8312,[127 187 483 302 211],13,5,36570,4.399133886683508,20.0,20.0
18313,1,8313,[127 187 483 302 211],343,5,36575,4.399206158287226,20.0,20.0
18314,1,8314,[127 187 483 302 211],343,5,36580,4.399278412507517,20.0,20.0
18315,1,8315,[127 187 483 302 211],524,5,36585,4.39935064935065,20.0,20.0
18316,1,8316,[127 187 483 302 211],833,3,36588,4.399182397499098,20.0,20.0
18317,1,8317,[127 187 483 302 211],328,5,36593,4.39925462851647,20.0,20.0
18318,1,8318,[127 187 483 302 211],524,5,36598,4.39932684216853,20.0,20.0
18319,1,8319,[127 187 483 302 211],90,5,36603,4.399399038461539,20.0,20.0
18320,1,8320,[187 195 237 282  89],666,2,36605,4.399110683812042,0.0,0.0
18321,1,8321,[125   8  22 204 194],311,5,36610,4.399182888728671,0.0,0.0
18322,1,8322,[127 187 483 302 211],13,5,36615,4.399255076294605,20.0,20.0
18323,1,8323,[127 187 483 302 211],6,5,36620,4.399327246516098,20.0,20.0
18324,1,8324,[515 143   9  28 423],6,2,36622,4.399039039039039,0.0,0.0
18325,1,8325,[127 187 483 302 211],90,5,36627,4.399111217871727,20.0,20.0
18326,1,8326,[127 187 483 302 211],474,5,36632,4.39918337936832,20.0,20.0
18327,1,8327,[127 187 483 302 211],537,5,36637,4.3992555235350626,20.0,20.0
18328,1,8328,[435 286  25 204 194],378,5,36642,4.399327650378197,0.0,0.0
18329,1,8329,[127 187 483 302 211],13,5,36647,4.399399759903962,20.0,20.0
18330,1,8330,[127 187 483 302 211],328,5,36652,4.399471852118594,20.0,20.0
18331,1,8331,[127 187 483 302 211],90,5,36657,4.399543927028325,20.0,20.0
18332,1,8332,[127 187 483 302 211],339,5,36662,4.399615984639386,20.0,20.0
18333,1,8333,[127 187 483 302 211],537,5,36667,4.399688024958003,20.0,20.0
18334,1,8334,[127 187 483 302 211],13,5,36672,4.3997600479904015,20.0,20.0
18335,1,8335,[127 187 483 302 211],833,3,36675,4.399592130518234,20.0,20.0
18336,1,8336,[127 187 483 302 211],524,5,36680,4.399664147774979,20.0,20.0
18337,1,8337,[127 187 483 302 211],833,3,36683,4.399496282082034,20.0,20.0
18338,1,8338,[ 70  64 427 118 265],374,4,36687,4.399448375104929,0.0,0.0
18339,1,8339,[127 187 483 302 211],474,5,36692,4.399520383693045,20.0,20.0
18340,1,8340,[191 483 174 286 215],13,3,36695,4.3993525956120365,20.0,20.0
18341,1,8341,[127 187 483 302 211],339,5,36700,4.399424598417646,20.0,20.0
18342,1,8342,[127 187 483 302 211],666,5,36705,4.399496583962604,20.0,20.0
18343,1,8343,[127 187 483 302 211],343,5,36710,4.399568552253116,20.0,20.0
18344,1,8344,[127 187 483 302 211],90,5,36715,4.3996405032953865,20.0,20.0
18345,1,8345,[127 187 483 302 211],524,5,36720,4.399712437095615,20.0,20.0
18346,1,8346,[127 187 483 302 211],328,5,36725,4.399784353659998,20.0,20.0
18347,1,8347,[127 187 483 302 211],339,5,36730,4.399856252994729,20.0,20.0
18348,1,8348,[127 187 483 302 211],666,5,36735,4.399928135106001,20.0,20.0
18349,1,8349,[127 187 483 302 211],207,5,36740,4.4,20.0,20.0
18350,1,8350,[200 186 588 678 100],881,1,36741,4.399592863130164,0.0,20.0
18351,1,8351,[127 187 483 302 211],6,5,36746,4.399664750957855,20.0,20.0
18352,1,8352,[127 187 483 302 211],537,5,36751,4.399736621573087,20.0,20.0
18353,1,8353,[127 187 483 302 211],328,5,36756,4.399808474982045,20.0,20.0
18354,1,8354,[127 187 483 302 211],474,5,36761,4.399880311190904,20.0,20.0
18355,1,8355,[127 187 483 302 211],207,5,36766,4.39995213020584,20.0,20.0
18356,1,8356,[127 187 483 302 211],328,5,36771,4.400023932033026,20.0,20.0
18357,1,8357,[127 187 483 302 211],537,5,36776,4.400095716678631,20.0,20.0
18358,1,8358,[127 187 483 302 211],666,5,36781,4.400167484148821,20.0,20.0
18359,1,8359,[127 187 483 302 211],339,5,36786,4.400239234449761,20.0,20.0
18360,1,8360,[194 276 289 175   9],90,3,36789,4.400071761750986,0.0,0.0
18361,1,8361,[508 603 127 174  96],474,4,36793,4.400023917723033,20.0,40.0
18362,1,8362,[127 187 483 302 211],537,5,36798,4.40009565945235,20.0,20.0
18363,1,8363,[127 187 483 302 211],328,5,36803,4.400167384026782,20.0,20.0
18364,1,8364,[127 187 483 302 211],343,5,36808,4.40023909145248,20.0,20.0
18365,1,8365,[127 187 483 302 211],524,5,36813,4.400310781735596,20.0,20.0
18366,1,8366,[127 187 483 302 211],833,3,36816,4.400143420580854,20.0,20.0
18367,1,8367,[181 222 405 173 125],334,3,36819,4.399976099426386,0.0,0.0
18368,1,8368,[568 423 385  79 197],308,4,36823,4.399928306846697,0.0,0.0
18369,1,8369,[127 187 483 302 211],343,5,36828,4.4,20.0,20.0
18370,1,8370,[204  22 328 143 161],804,4,36832,4.399952215983753,0.0,0.0
18371,1,8371,[127 187 483 302 211],90,5,36837,4.4000238891543235,20.0,20.0
18372,1,8372,[318  98 302  82 742],543,3,36840,4.3998566821927625,20.0,20.0
18373,1,8373,[127 187 483 302 211],210,5,36845,4.39992834965369,20.0,20.0
18374,1,8374,[127 187 483 302 211],666,5,36850,4.4,20.0,20.0
18375,1,8375,[127 187 483 302 211],210,5,36855,4.400071633237823,20.0,20.0
18376,1,8376,[127 187 483 302 211],666,5,36860,4.400143249373284,20.0,20.0
18377,1,8377,[289 215 174  69 195],378,3,36863,4.399976127954166,0.0,20.0
18378,1,8378,[179 257 322 127 117],881,5,36868,4.400047738393603,0.0,20.0
18379,1,8379,[275 483 357 508 200],13,1,36869,4.39964200477327,40.0,0.0
18380,1,8380,[127 187 483 302 211],210,5,36874,4.399713637990693,20.0,20.0
18381,1,8381,[127 187 483 302 211],666,5,36879,4.3997852541159626,20.0,20.0
18382,1,8382,[237 483  97 301  22],788,3,36882,4.39961827508052,20.0,0.0
18383,1,8383,[ 28 125 175 515 222],406,1,36883,4.399212786259542,0.0,0.0
18384,1,8384,[127 187 483 302 211],6,5,36888,4.399284436493739,20.0,20.0
18385,1,8385,[127 187 483 302 211],833,3,36891,4.399117576913904,20.0,20.0
18386,1,8386,[257 210 196 403 423],290,4,36895,4.3990699892691065,0.0,0.0
18387,1,8387,[127 187 483 302 211],666,5,36900,4.399141630901288,20.0,20.0
18388,1,8388,[ 82 546 181 286 175],158,3,36903,4.398974848015258,0.0,0.0
18389,1,8389,[127 187 483 302 211],833,3,36906,4.39880810488677,20.0,20.0
18390,1,8390,[ 96 603  15 161 483],452,4,36910,4.398760576808486,40.0,0.0
18391,1,8391,[118 328 275  11 211],13,2,36912,4.398474737845567,0.0,0.0
18392,1,8392,[127 187 483 302 211],666,5,36917,4.39854640772072,20.0,20.0
18393,1,8393,[ 70 289 269 568 185],13,0,36917,4.398022396950203,0.0,0.0
18394,1,8394,[ 69  70   8 265 515],207,2,36919,4.397736748064324,0.0,0.0
18395,1,8395,[ 71 185  89 435 268],6,4,36923,4.3976893758932825,0.0,0.0
18396,1,8396,[127 187 483 302 211],328,5,36928,4.3977611051566035,20.0,20.0
18397,1,8397,[127 187 483 302 211],537,5,36933,4.397832817337461,20.0,20.0
18398,1,8398,[127 187 483 302 211],474,5,36938,4.397904512441958,20.0,20.0
18399,1,8399,[187  15 235  28 423],271,3,36941,4.397738095238095,0.0,0.0
18400,1,8400,[168 173 265  97  15],42,2,36943,4.397452684204262,0.0,0.0
18401,1,8401,[127 187 483 302 211],328,5,36948,4.397524398952631,20.0,20.0
18402,1,8402,[ 69 172 100  79 222],13,3,36951,4.397358086397715,0.0,20.0
18403,1,8403,[127 187 483 302 211],833,3,36954,4.39719181342218,20.0,20.0
18404,1,8404,[127 187 483 302 211],328,5,36959,4.397263533610946,20.0,20.0
18405,1,8405,[238 176 216 288 228],650,4,36963,4.397216274089936,0.0,0.0
18406,1,8406,[127 187 483 302 211],210,5,36968,4.397287974307125,20.0,20.0
18407,1,8407,[168 117 268  89 276],643,3,36971,4.397121788772598,0.0,0.0
18408,1,8408,[127 187 483 302 211],6,5,36976,4.397193483172791,20.0,20.0
18409,1,8409,[127 187 483 302 211],328,5,36981,4.397265160523187,20.0,20.0
18410,1,8410,[127 187 483 302 211],666,5,36986,4.3973368208298655,20.0,20.0
18411,1,8411,[127 187 483 302 211],833,3,36989,4.39717070851165,20.0,20.0
18412,1,8412,[127 187 483 302 211],666,5,36994,4.397242363009628,20.0,20.0
18413,1,8413,[127 187 483 302 211],207,5,36999,4.397314000475398,20.0,20.0
18414,1,8414,[127 187 483 302 211],343,5,37004,4.397385620915033,20.0,20.0
18415,1,8415,[127 187 483 302 211],833,3,37007,4.39721958174905,20.0,20.0
18416,1,8416,[127 187 483 302 211],537,5,37012,4.397291196388262,20.0,20.0
18417,1,8417,[127 187 483 302 211],207,5,37017,4.39736279401283,20.0,20.0
18418,1,8418,[127 187 483 302 211],6,5,37022,4.397434374628816,20.0,20.0
18419,1,8419,[127 187 483 302 211],328,5,37027,4.39750593824228,20.0,20.0
18420,1,8420,[127 496 204  64 153],666,4,37031,4.397458734117088,0.0,20.0
18421,1,8421,[127 187 483 302 211],339,5,37036,4.397530277843742,20.0,20.0
18422,1,8422,[127 187 483 302 211],207,5,37041,4.39760180458269,20.0,20.0
18423,1,8423,[300 268 176 318 496],234,2,37043,4.397317188983855,20.0,0.0
18424,1,8424,[127 187 483 302 211],666,5,37048,4.397388724035609,20.0,20.0
18425,1,8425,[127 187 483 302 211],13,5,37053,4.397460242107762,20.0,20.0
18426,1,8426,[ 70  88 174 161  97],374,4,37057,4.397413077014359,0.0,20.0
18427,1,8427,[127 187 483 302 211],207,5,37062,4.397484575225439,20.0,20.0
18428,1,8428,[127 187 483 302 211],833,3,37065,4.3973187804009966,20.0,20.0
18429,1,8429,[204 286 176  71 118],881,4,37069,4.3972716488730725,0.0,0.0
18430,1,8430,[127 187 483 302 211],343,5,37074,4.397343138417744,20.0,20.0
18431,1,8431,[ 56 313  98 176  22],59,5,37079,4.397414611005693,0.0,20.0
18432,1,8432,[127 187 483 302 211],537,5,37084,4.3974860666429505,20.0,20.0
18433,1,8433,[127 187 483 302 211],474,5,37089,4.397557505335547,20.0,20.0
18434,1,8434,[127 187 483 302 211],524,5,37094,4.397628927089508,20.0,20.0
18435,1,8435,[127 187 483 302 211],6,5,37099,4.397700331910858,20.0,20.0
18436,1,8436,[127 187 483 302 211],537,5,37104,4.397771719805618,20.0,20.0
18437,1,8437,[127 187 483 302 211],474,5,37109,4.397843090779806,20.0,20.0
18438,1,8438,[127 187 483 302 211],328,5,37114,4.397914444839436,20.0,20.0
18439,1,8439,[268 175 185 318 276],537,5,37119,4.3979857819905215,20.0,0.0
18440,1,8440,[127 187 483 302 211],833,3,37122,4.397820163487738,20.0,20.0
18441,1,8441,[127 187 483 302 211],210,5,37127,4.39789149490642,20.0,20.0
18442,1,8442,[127 187 483 302 211],328,5,37132,4.397962809427929,20.0,20.0
18443,1,8443,[127 187 483 302 211],524,5,37137,4.398034107058266,20.0,20.0
18444,1,8444,[403 546  64 111  11],749,3,37140,4.397868561278863,0.0,0.0
18445,1,8445,[127 187 483 302 211],207,5,37145,4.39793985318494,20.0,20.0
18446,1,8446,[127 187 483 302 211],833,3,37148,4.397774357760151,20.0,20.0
18447,1,8447,[127 187 483 302 211],537,5,37153,4.397845643939394,20.0,20.0
18448,1,8448,[127 187 483 302 211],833,3,37156,4.397680198840099,20.0,20.0
18449,1,8449,[127 187 483 302 211],6,5,37161,4.397751479289941,20.0,20.0
18450,1,8450,[211 117 313 180 182],474,5,37166,4.397822742870666,0.0,0.0
18451,1,8451,[127 187 483 302 211],833,3,37169,4.3976573592049215,20.0,20.0
18452,1,8452,[483  50 427 121 302],380,4,37173,4.39761031586419,20.0,20.0
18453,1,8453,[127 187 483 302 211],210,5,37178,4.397681570854034,20.0,20.0
18454,1,8454,[127 187 483 302 211],207,5,37183,4.397752808988764,20.0,20.0
18455,1,8455,[127 187 483 302 211],666,5,37188,4.397824030274362,20.0,20.0
18456,1,8456,[  1  82 258 237 215],92,4,37192,4.397776989476173,0.0,0.0
18457,1,8457,[127 187 483 302 211],537,5,37197,4.397848191061716,20.0,20.0
18458,1,8458,[127 187 483 302 211],343,5,37202,4.3979193758127435,20.0,20.0
18459,1,8459,[127 187 483 302 211],90,5,37207,4.397990543735225,20.0,20.0
18460,1,8460,[127 187 483 302 211],343,5,37212,4.398061694835126,20.0,20.0
18461,1,8461,[ 98 237  50 100  95],13,5,37217,4.398132829118412,0.0,60.0
18462,1,8462,[127 187 483 302 211],6,5,37222,4.398203946591043,20.0,20.0
18463,1,8463,[127 187 483 302 211],833,3,37225,4.398038752362949,20.0,20.0
18464,1,8464,[127 187 483 302 211],666,5,37230,4.398109864146486,20.0,20.0
18465,1,8465,[127 187 483 302 211],833,3,37233,4.397944720056698,20.0,20.0
18466,1,8466,[127 187 483 302 211],474,5,37238,4.398015826148577,20.0,20.0
18467,1,8467,[127 187 483 302 211],537,5,37243,4.398086915446386,20.0,20.0
18468,1,8468,[276 603 423 257 427],385,2,37245,4.397803754870705,20.0,0.0
18469,1,8469,[127 187 483 302 211],6,5,37250,4.397874852420307,20.0,20.0
18470,1,8470,[127 187 483 302 211],524,5,37255,4.397945933183804,20.0,20.0
18471,1,8471,[127 187 483 302 211],833,3,37258,4.397780925401322,20.0,20.0
18472,1,8472,[127 187 483 302 211],474,5,37263,4.397852000472088,20.0,20.0
18473,1,8473,[127 187 483 302 211],328,5,37268,4.397923058767996,20.0,20.0
18474,1,8474,[127 187 483 302 211],90,5,37273,4.397994100294985,20.0,20.0
18475,1,8475,[127 187 483 302 211],343,5,37278,4.39806512505899,20.0,20.0
18476,1,8476,[127 187 483 302 211],343,5,37283,4.398136133065943,20.0,20.0
18477,1,8477,[204  98  50 234 471],144,4,37287,4.398089171974522,0.0,40.0
18478,1,8478,[655 245  11   9 282],92,5,37292,4.398160160396273,0.0,0.0
18479,1,8479,[127 187 483 302 211],6,5,37297,4.3982311320754715,20.0,20.0
18480,1,8480,[228 100 435  98  50],13,5,37302,4.39830208701804,0.0,60.0
18481,1,8481,[127 187 483 302 211],833,3,37305,4.398137231784957,20.0,20.0
18482,1,8482,[ 56 385 282 588 655],311,5,37310,4.398208181068019,0.0,0.0
18483,1,8483,[603  96 385 215 508],524,2,37312,4.397925506836398,20.0,0.0
18484,1,8484,[496 508 125   4   1],653,1,37313,4.397525044195639,0.0,0.0
18485,1,8485,[ 98   8 121  50 546],95,4,37317,4.397478199387226,0.0,40.0
18486,1,8486,[127 187 483 302 211],90,5,37322,4.3975491928832335,20.0,20.0
18487,1,8487,[127 187 483 302 211],90,5,37327,4.3976201696512724,20.0,20.0
18488,1,8488,[127 187 483 302 211],13,5,37332,4.397691129697256,20.0,20.0
18489,1,8489,[127 187 483 302 211],90,5,37337,4.39776207302709,20.0,20.0
18490,1,8490,[127 187 483 302 211],666,5,37342,4.397832999646685,20.0,20.0
18491,1,8491,[127 187 483 302 211],6,5,37347,4.397903909561941,20.0,20.0
18492,1,8492,[127 187 483 302 211],90,5,37352,4.397974802778759,20.0,20.0
18493,1,8493,[127 187 483 302 211],537,5,37357,4.398045679303038,20.0,20.0
18494,1,8494,[174 215 275 483 179],694,4,37361,4.397998822836963,20.0,20.0
18495,1,8495,[127 187 483 302 211],474,5,37366,4.398069679849341,20.0,20.0
18496,1,8496,[127 187 483 302 211],90,5,37371,4.398140520183595,20.0,20.0
18497,1,8497,[127 187 483 302 211],6,5,37376,4.3982113438456105,20.0,20.0
18498,1,8498,[ 12 175 153  64 168],64,4,37380,4.398164489939993,20.0,0.0
18499,1,8499,[127 187 483 302 211],343,5,37385,4.398235294117647,20.0,20.0
18500,1,8500,[127 187 483 302 211],339,5,37390,4.398306081637455,20.0,20.0
18501,1,8501,[435 273 265 191 258],387,4,37394,4.398259233121618,0.0,0.0
18502,1,8502,[127 187 483 302 211],207,5,37399,4.398330001176055,20.0,20.0
18503,1,8503,[202  28 121 161 748],479,3,37402,4.3981655691439325,0.0,0.0
18504,1,8504,[357 222 117  95 173],479,4,37406,4.398118753674309,20.0,0.0
18505,1,8505,[127 187 483 302 211],207,5,37411,4.39818951328474,20.0,20.0
18506,1,8506,[294 173 238   8 211],125,3,37414,4.398025155754085,0.0,0.0
18507,1,8507,[127 187 483 302 211],207,5,37419,4.398095909732017,20.0,20.0
18508,1,8508,[127 187 483 302 211],537,5,37424,4.398166647079563,20.0,20.0
18509,1,8509,[127 187 483 302 211],207,5,37429,4.398237367802585,20.0,20.0
18510,1,8510,[127 187 483 302 211],13,5,37434,4.398308071906944,20.0,20.0
18511,1,8511,[127 187 483 302 211],833,3,37437,4.398143796992481,20.0,20.0
18512,1,8512,[  1 195 357 568 121],899,4,37441,4.39809702807471,20.0,0.0
18513,1,8513,[127 187 483 302 211],833,3,37444,4.397932816537468,20.0,20.0
18514,1,8514,[127 187 483 302 211],210,5,37449,4.398003523194363,20.0,20.0
18515,1,8515,[127 187 483 302 211],328,5,37454,4.398074213245655,20.0,20.0
18516,1,8516,[127 187 483 302 211],343,5,37459,4.398144886697194,20.0,20.0
18517,1,8517,[294 111  89 257 121],447,3,37462,4.397980746654144,0.0,0.0
18518,1,8518,[127 187 483 302 211],343,5,37467,4.398051414485268,20.0,20.0
18519,1,8519,[127 187 483 302 211],90,5,37472,4.3981220657277,20.0,20.0
18520,1,8520,[127 187 483 302 211],210,5,37477,4.398192700387279,20.0,20.0
18521,1,8521,[127 187 483 302 211],474,5,37482,4.3982633184698425,20.0,20.0
18522,1,8522,[127 187 483 302 211],210,5,37487,4.398333919981227,20.0,20.0
18523,1,8523,[  4 181 176 235  50],334,2,37489,4.398052557484749,0.0,20.0
18524,1,8524,[ 98 328 174 183 403],313,4,37493,4.39800586510264,0.0,40.0
18525,1,8525,[127 187 483 302 211],833,3,37496,4.397841895378841,20.0,20.0
18526,1,8526,[127 187 483 302 211],833,3,37499,4.397677964113991,20.0,20.0
18527,1,8527,[127 187 483 302 211],13,5,37504,4.397748592870544,20.0,20.0
18528,1,8528,[127 187 483 302 211],343,5,37509,4.397819205065072,20.0,20.0
18529,1,8529,[127 187 483 302 211],666,5,37514,4.3978898007034,20.0,20.0
18530,1,8530,[135 286 265 121 515],271,4,37518,4.397843160239128,0.0,0.0
18531,1,8531,[127 187 483 302 211],210,5,37523,4.397913736521332,20.0,20.0
18532,1,8532,[286  71 127 215  95],233,4,37527,4.397867104183757,0.0,20.0
18533,1,8533,[127 187 483 302 211],207,5,37532,4.397937661120225,20.0,20.0
18534,1,8534,[127 187 483 302 211],207,5,37537,4.39800820152314,20.0,20.0
18535,1,8535,[127 187 483 302 211],339,5,37542,4.398078725398313,20.0,20.0
18536,1,8536,[127 187 483 302 211],524,5,37547,4.398149232751552,20.0,20.0
18537,1,8537,[127 187 483 302 211],210,5,37552,4.398219723588663,20.0,20.0
18538,1,8538,[195 300  89 603 357],409,4,37556,4.398173088183628,40.0,0.0
18539,1,8539,[127 187 483 302 211],13,5,37561,4.39824355971897,20.0,20.0
18540,1,8540,[174  89 132  50 153],60,4,37565,4.398196932443508,0.0,40.0
18541,1,8541,[127 187 483 302 211],537,5,37570,4.3982673846874265,20.0,20.0
18542,1,8542,[191 121 100 282 405],455,3,37573,4.3981037106402905,0.0,20.0
18543,1,8543,[127 187 483 302 211],339,5,37578,4.39817415730337,20.0,20.0
18544,1,8544,[127 187 483 302 211],210,5,37583,4.398244587478057,20.0,20.0
18545,1,8545,[127 187 483 302 211],537,5,37588,4.398315001170138,20.0,20.0
18546,1,8546,[183 172 194  50 385],59,4,37592,4.3982683982683985,0.0,20.0
18547,1,8547,[127 187 483 302 211],328,5,37597,4.398338792700047,20.0,20.0
18548,1,8548,[  8 127 496 357 194],311,5,37602,4.398409170663236,20.0,20.0
18549,1,8549,[127 187 483 302 211],90,5,37607,4.398479532163742,20.0,20.0
18550,1,8550,[403 546 471 121 271],92,3,37610,4.398315986434335,0.0,0.0
18551,1,8551,[127 187 483 302 211],537,5,37615,4.398386342376052,20.0,20.0
18552,1,8552,[127 187 483 302 211],666,5,37620,4.398456681866012,20.0,20.0
18553,1,8553,[210 196 228 176 265],892,4,37624,4.3984101005377605,0.0,0.0
18554,1,8554,[ 22 588 204 196  12],59,4,37628,4.398363530099357,20.0,0.0
18555,1,8555,[ 22 196  96 588   7],295,4,37632,4.3983169705469845,0.0,0.0
18556,1,8556,[100  79 234 496 288],452,3,37635,4.398153558490125,0.0,20.0
18557,1,8557,[127 187 483 302 211],207,5,37640,4.398223884085066,20.0,20.0
18558,1,8558,[483 288  56 172 181],804,3,37643,4.3980605210889125,20.0,0.0
18559,1,8559,[127 187 483 302 211],90,5,37648,4.398130841121495,20.0,20.0
18560,1,8560,[127 187 483 302 211],833,3,37651,4.397967527158042,20.0,20.0
18561,1,8561,[127 187 483 302 211],13,5,37656,4.398037841625788,20.0,20.0
18562,1,8562,[127 187 483 302 211],328,5,37661,4.3981081396706765,20.0,20.0
18563,1,8563,[127 187 483 302 211],328,5,37666,4.398178421298459,20.0,20.0
18564,1,8564,[127 187 483 302 211],537,5,37671,4.398248686514886,20.0,20.0
18565,1,8565,[127 187 483 302 211],666,5,37676,4.398318935325706,20.0,20.0
18566,1,8566,[127 187 483 302 211],210,5,37681,4.3983891677366636,20.0,20.0
18567,1,8567,[127 187 483 302 211],13,5,37686,4.398459383753502,20.0,20.0
18568,1,8568,[168 211 121  97  88],95,4,37690,4.3984128836503675,0.0,0.0
18569,1,8569,[127 187 483 302 211],833,3,37693,4.398249708284714,20.0,20.0
18570,1,8570,[127 187 483 302 211],343,5,37698,4.3983199159958,20.0,20.0
18571,1,8571,[127 187 483 302 211],343,5,37703,4.398390107326178,20.0,20.0
18572,1,8572,[127 187 483 302 211],833,3,37706,4.398226991718185,20.0,20.0
18573,1,8573,[127 187 483 302 211],524,5,37711,4.398297177513412,20.0,20.0
18574,1,8574,[127 187 483 302 211],474,5,37716,4.398367346938776,20.0,20.0
18575,1,8575,[127 187 483 302 211],13,5,37721,4.3984375,20.0,20.0
18576,1,8576,[127 187 483 302 211],339,5,37726,4.39850763670281,20.0,20.0
18577,1,8577,[127 187 483 302 211],666,5,37731,4.3985777570529265,20.0,20.0
18578,1,8578,[127 187 483 302 211],90,5,37736,4.398647861056067,20.0,20.0
18579,1,8579,[127 187 483 302 211],524,5,37741,4.398717948717949,20.0,20.0
18580,1,8580,[127 187 483 302 211],524,5,37746,4.398788020044284,20.0,20.0
18581,1,8581,[127 187 483 302 211],537,5,37751,4.398858075040783,20.0,20.0
18582,1,8582,[127 187 483 302 211],343,5,37756,4.398928113713154,20.0,20.0
18583,1,8583,[127 187 483 302 211],13,5,37761,4.398998136067101,20.0,20.0
18584,1,8584,[172 597 496 275  15],452,5,37766,4.399068142108328,0.0,0.0
18585,1,8585,[ 95   8  88 300 175],506,4,37770,4.399021663172607,0.0,0.0
18586,1,8586,[127 187 483 302 211],833,3,37773,4.398858739955747,20.0,20.0
18587,1,8587,[127 187 483 302 211],6,5,37778,4.3989287377736375,20.0,20.0
18588,1,8588,[127 187 483 302 211],207,5,37783,4.398998719292118,20.0,20.0
18589,1,8589,[268  12 471 328 405],537,1,37784,4.39860302677532,20.0,0.0
18590,1,8590,[ 70 385 288 282 202],643,1,37785,4.39820742637644,0.0,0.0
18591,1,8591,[435 496   4  82  88],339,5,37790,4.398277467411545,0.0,0.0
18592,1,8592,[127 187 483 302 211],537,5,37795,4.398347492144769,20.0,20.0
18593,1,8593,[127 187 483 302 211],13,5,37800,4.398417500581801,20.0,20.0
18594,1,8594,[127 187 483 302 211],343,5,37805,4.39848749272833,20.0,20.0
18595,1,8595,[127 187 483 302 211],210,5,37810,4.398557468590042,20.0,20.0
18596,1,8596,[127 187 483 302 211],833,3,37813,4.398394788879842,20.0,20.0
18597,1,8597,[127 187 483 302 211],666,5,37818,4.398464759246337,20.0,20.0
18598,1,8598,[127 187 483 302 211],474,5,37823,4.39853471333876,20.0,20.0
18599,1,8599,[216 655 245  82 173],579,2,37825,4.398255813953488,0.0,0.0
18600,1,8600,[127 187 483 302 211],6,5,37830,4.39832577607255,20.0,20.0
18601,1,8601,[127 187 483 302 211],524,5,37835,4.398395721925134,20.0,20.0
18602,1,8602,[127 187 483 302 211],524,5,37840,4.398465651516912,20.0,20.0
18603,1,8603,[174 603 234  56 100],271,4,37844,4.398419339841934,20.0,40.0
18604,1,8604,[127 187 483 302 211],13,5,37849,4.3984892504357935,20.0,20.0
18605,1,8605,[127 187 483 302 211],833,3,37852,4.398326748779921,20.0,20.0
18606,1,8606,[127 187 483 302 211],524,5,37857,4.398396653886372,20.0,20.0
18607,1,8607,[127 187 483 302 211],524,5,37862,4.3984665427509295,20.0,20.0
18608,1,8608,[ 79 655  28 127 678],339,4,37866,4.398420257869671,0.0,20.0
18609,1,8609,[127 187 483 302 211],90,5,37871,4.3984901277584205,20.0,20.0
18610,1,8610,[127 187 483 302 211],13,5,37876,4.398559981419115,20.0,20.0
18611,1,8611,[405 222 176 196 655],474,5,37881,4.398629818857408,0.0,0.0
18612,1,8612,[127 187 483 302 211],328,5,37886,4.39869964007895,20.0,20.0
18613,1,8613,[127 187 483 302 211],328,5,37891,4.398769445089389,20.0,20.0
18614,1,8614,[127 187 483 302 211],666,5,37896,4.39883923389437,20.0,20.0
18615,1,8615,[153 176 121  28   9],60,4,37900,4.3987929433611885,0.0,0.0
18616,1,8616,[127 187 483 302 211],666,5,37905,4.398862713241267,20.0,20.0
18617,1,8617,[568  64 603  50  96],13,4,37909,4.398816430726387,20.0,20.0
18618,1,8618,[127 187 483 302 211],474,5,37914,4.398886181691611,20.0,20.0
18619,1,8619,[127 187 483 302 211],328,5,37919,4.398955916473318,20.0,20.0
18620,1,8620,[127 187 483 302 211],666,5,37924,4.3990256350771375,20.0,20.0
18621,1,8621,[127 187 483 302 211],474,5,37929,4.399095337508698,20.0,20.0
18622,1,8622,[200 655  98  25 197],899,4,37933,4.3990490548532994,0.0,20.0
18623,1,8623,[127 187 483 302 211],666,5,37938,4.399118738404453,20.0,20.0
18624,1,8624,[127 187 483 302 211],328,5,37943,4.399188405797101,20.0,20.0
18625,1,8625,[127 187 483 302 211],666,5,37948,4.399258057036866,20.0,20.0
18626,1,8626,[127 187 483 302 211],13,5,37953,4.399327692129361,20.0,20.0
18627,1,8627,[127 187 483 302 211],537,5,37958,4.399397311080204,20.0,20.0
18628,1,8628,[127 187 483 302 211],833,3,37961,4.399235137327616,20.0,20.0
18629,1,8629,[210 175 118 471 286],666,3,37964,4.399073001158748,0.0,0.0
18630,1,8630,[127 187 483 302 211],537,5,37969,4.399142625419998,20.0,20.0
18631,1,8631,[568 546  95 121 132],804,3,37972,4.398980537534754,0.0,0.0
18632,1,8632,[176 385 322 211 151],804,4,37976,4.398934321788486,0.0,0.0
18633,1,8633,[127 187 483 302 211],524,5,37981,4.399003937919852,20.0,20.0
18634,1,8634,[127 187 483 302 211],210,5,37986,4.399073537927041,20.0,20.0
18635,1,8635,[125  22 471 435 257],533,5,37991,4.399143121815656,0.0,0.0
18636,1,8636,[127 187 483 302 211],210,5,37996,4.399212689591293,20.0,20.0
18637,1,8637,[127 187 483 302 211],666,5,38001,4.3992822412595505,20.0,20.0
18638,1,8638,[127 187 483 302 211],90,5,38006,4.3993517768260215,20.0,20.0
18639,1,8639,[  4 288 135 423 275],378,2,38008,4.399074074074074,0.0,0.0
18640,1,8640,[222 153  28 204 202],447,3,38011,4.398912162944104,0.0,0.0
18641,1,8641,[195  70 258  98   7],144,4,38015,4.39886600323999,0.0,20.0
18642,1,8642,[200 405 475 268 271],13,1,38016,4.398472752516487,0.0,0.0
18643,1,8643,[127 187 483 302 211],328,5,38021,4.398542341508561,20.0,20.0
18644,1,8644,[176 144 121  89 135],64,2,38023,4.398264893001735,0.0,0.0
18645,1,8645,[127 187 483 302 211],339,5,38028,4.398334489937543,20.0,20.0
18646,1,8646,[127 187 483 302 211],833,3,38031,4.398172776685556,20.0,20.0
18647,1,8647,[  9 173 282   8 245],334,4,38035,4.398126734505088,0.0,0.0
18648,1,8648,[200 257 228   7  82],334,5,38040,4.398196323274367,0.0,0.0
18649,1,8649,[127 187 483 302 211],833,3,38043,4.398034682080925,20.0,20.0
18650,1,8650,[127 187 483 302 211],210,5,38048,4.398104265402844,20.0,20.0
18651,1,8651,[127 187 483 302 211],207,5,38053,4.398173832639852,20.0,20.0
18652,1,8652,[127 187 483 302 211],474,5,38058,4.398243383797527,20.0,20.0
18653,1,8653,[127 187 483 302 211],474,5,38063,4.398312918881442,20.0,20.0
18654,1,8654,[333  98  97 151 300],64,1,38064,4.39792027729636,0.0,20.0
18655,1,8655,[127 187 483 302 211],328,5,38069,4.397989833641405,20.0,20.0
18656,1,8656,[275 132 435  70 603],524,3,38072,4.3978283470024255,20.0,0.0
18657,1,8657,[127 187 483 302 211],13,5,38077,4.397897897897898,20.0,20.0
18658,1,8658,[168 742 176  50 211],290,2,38079,4.39762097239866,0.0,20.0
18659,1,8659,[127 187 483 302 211],524,5,38084,4.397690531177829,20.0,20.0
18660,1,8660,[127 187 483 302 211],13,5,38089,4.397760073894469,20.0,20.0
18661,1,8661,[127 187 483 302 211],207,5,38094,4.397829600554145,20.0,20.0
18662,1,8662,[127 187 483 302 211],13,5,38099,4.397899111162415,20.0,20.0
18663,1,8663,[127 187 483 302 211],666,5,38104,4.397968605724839,20.0,20.0
18664,1,8664,[174 186 143 204   8],406,3,38107,4.3978072706289675,0.0,20.0
18665,1,8665,[127 187 483 302 211],537,5,38112,4.39787675975075,20.0,20.0
18666,1,8666,[127 187 483 302 211],833,3,38115,4.397715472481828,20.0,20.0
18667,1,8667,[127 187 483 302 211],328,5,38120,4.39778495616059,20.0,20.0
18668,1,8668,[127 187 483 302 211],339,5,38125,4.397854423808974,20.0,20.0
18669,1,8669,[127 187 483 302 211],833,3,38128,4.397693194925028,20.0,20.0
18670,1,8670,[127 187 483 302 211],90,5,38133,4.397762657132972,20.0,20.0
18671,1,8671,[127 187 483 302 211],207,5,38138,4.397832103321033,20.0,20.0
18672,1,8672,[ 11  98 118 276 186],308,3,38141,4.397670932779891,0.0,20.0
18673,1,8673,[127 187 483 302 211],6,5,38146,4.39774037353009,20.0,20.0
18674,1,8674,[127 187 483 302 211],474,5,38151,4.3978097982708935,20.0,20.0
18675,1,8675,[127 187 483 302 211],474,5,38156,4.397879207007838,20.0,20.0
18676,1,8676,[117 300 427 143 273],234,1,38157,4.3974876109254355,0.0,0.0
18677,1,8677,[471 181 117 187 385],653,4,38161,4.397441806867942,0.0,0.0
18678,1,8678,[ 70  64 496 318 237],883,2,38163,4.397165572070515,20.0,0.0
18679,1,8679,[127 187 483 302 211],13,5,38168,4.397235023041475,20.0,20.0
18680,1,8680,[405   8 174   9 258],488,3,38171,4.397074069807626,0.0,20.0
18681,1,8681,[127 187 483 302 211],524,5,38176,4.397143515319051,20.0,20.0
18682,1,8682,[127 187 483 302 211],339,5,38181,4.397212944834735,20.0,20.0
18683,1,8683,[127 187 483 302 211],474,5,38186,4.3972823583602025,20.0,20.0
18684,1,8684,[127 187 483 302 211],666,5,38191,4.397351755900979,20.0,20.0
18685,1,8685,[182 202 135 144   7],378,3,38194,4.397190881878886,0.0,0.0
18686,1,8686,[151 222  98 546  79],899,3,38197,4.39703004489467,0.0,20.0
18687,1,8687,[127 187 483 302 211],13,5,38202,4.3970994475138125,20.0,20.0
18688,1,8688,[127 187 483 302 211],207,5,38207,4.397168834158131,20.0,20.0
18689,1,8689,[127 187 483 302 211],207,5,38212,4.397238204833141,20.0,20.0
18690,1,8690,[127 187 483 302 211],343,5,38217,4.397307559544356,20.0,20.0
18691,1,8691,[127 187 483 302 211],537,5,38222,4.397376898297285,20.0,20.0
18692,1,8692,[127 187 483 302 211],207,5,38227,4.397446221097435,20.0,20.0
18693,1,8693,[127 187 483 302 211],524,5,38232,4.39751552795031,20.0,20.0
18694,1,8694,[127 187 483 302 211],328,5,38237,4.397584818861414,20.0,20.0
18695,1,8695,[127 187 483 302 211],210,5,38242,4.3976540938362465,20.0,20.0
18696,1,8696,[127 187 483 302 211],339,5,38247,4.397723352880304,20.0,20.0
18697,1,8697,[127 187 483 302 211],207,5,38252,4.39779259599908,20.0,20.0
18698,1,8698,[127 187 483 302 211],833,3,38255,4.39763191171399,20.0,20.0
18699,1,8699,[  1 403  89  98 125],311,5,38260,4.397701149425288,0.0,20.0
18700,1,8700,[127 187 483 302 211],13,5,38265,4.397770371221698,20.0,20.0
18701,1,8701,[127 187 483 302 211],90,5,38270,4.39783957710871,20.0,20.0
18702,1,8702,[127 187 483 302 211],343,5,38275,4.397908767091807,20.0,20.0
18703,1,8703,[127 187 483 302 211],339,5,38280,4.397977941176471,20.0,20.0
18704,1,8704,[127 187 483 302 211],90,5,38285,4.3980470993681795,20.0,20.0
18705,1,8705,[127 187 483 302 211],210,5,38290,4.39811624167241,20.0,20.0
18706,1,8706,[127 187 483 302 211],343,5,38295,4.398185368094636,20.0,20.0
18707,1,8707,[127 187 483 302 211],328,5,38300,4.398254478640331,20.0,20.0
18708,1,8708,[127 187 483 302 211],666,5,38305,4.398323573314961,20.0,20.0
18709,1,8709,[127 187 483 302 211],666,5,38310,4.398392652123995,20.0,20.0
18710,1,8710,[127 187 483 302 211],13,5,38315,4.398461715072896,20.0,20.0
18711,1,8711,[127 187 483 302 211],6,5,38320,4.398530762167126,20.0,20.0
18712,1,8712,[197 195 357 515  15],543,4,38324,4.398485022380351,20.0,0.0
18713,1,8713,[127 288 435 197 191],13,3,38327,4.398324535230663,0.0,20.0
18714,1,8714,[121 300 313 132 603],669,4,38331,4.398278829604131,20.0,0.0
18715,1,8715,[127 187 483 302 211],90,5,38336,4.398347865993575,20.0,20.0
18716,1,8716,[127 187 483 302 211],537,5,38341,4.398416886543536,20.0,20.0
18717,1,8717,[265 176 175 153  70],648,3,38344,4.39825648084423,0.0,0.0
18718,1,8718,[127 187 483 302 211],666,5,38349,4.398325496043125,20.0,20.0
18719,1,8719,[127 187 483 302 211],339,5,38354,4.398394495412844,20.0,20.0
18720,1,8720,[127 187 483 302 211],666,5,38359,4.398463478958835,20.0,20.0
18721,1,8721,[127 187 483 302 211],207,5,38364,4.39853244668654,20.0,20.0
18722,1,8722,[127 187 483 302 211],833,3,38367,4.398372119683595,20.0,20.0
18723,1,8723,[127 187 483 302 211],833,3,38370,4.398211829436039,20.0,20.0
18724,1,8724,[127 187 483 302 211],666,5,38375,4.3982808022922635,20.0,20.0
18725,1,8725,[127 187 483 302 211],833,3,38378,4.398120559248223,20.0,20.0
18726,1,8726,[127 187 483 302 211],343,5,38383,4.3981895267560445,20.0,20.0
18727,1,8727,[127 187 483 302 211],524,5,38388,4.398258478460129,20.0,20.0
18728,1,8728,[127 187 483 302 211],666,5,38393,4.398327414365907,20.0,20.0
18729,1,8729,[ 98 143 202 179 546],7,3,38396,4.398167239404353,0.0,20.0
18730,1,8730,[385 191  71 216   1],843,0,38396,4.397663497881113,0.0,0.0
18731,1,8731,[127 187 483 302 211],90,5,38401,4.397732478240953,20.0,20.0
18732,1,8732,[127 187 483 302 211],6,5,38406,4.397801442803161,20.0,20.0
18733,1,8733,[127 187 483 302 211],537,5,38411,4.3978703915731625,20.0,20.0
18734,1,8734,[127 187 483 302 211],537,5,38416,4.397939324556383,20.0,20.0
18735,1,8735,[127 187 483 302 211],339,5,38421,4.398008241758242,20.0,20.0
18736,1,8736,[127 187 483 302 211],666,5,38426,4.398077143184159,20.0,20.0
18737,1,8737,[127 187 483 302 211],6,5,38431,4.398146028839552,20.0,20.0
18738,1,8738,[179 195   7  96 678],387,4,38435,4.398100469161231,0.0,0.0
18739,1,8739,[235  22 196  28 423],271,4,38439,4.398054919908467,0.0,0.0
18740,1,8740,[172  50 176 222 228],290,5,38444,4.39812378446402,0.0,20.0
18741,1,8741,[385 568 435 185 286],90,5,38449,4.398192633264699,0.0,0.0
18742,1,8742,[127 187 483 302 211],474,5,38454,4.39826146631591,20.0,20.0
18743,1,8743,[127 187 483 302 211],343,5,38459,4.398330283623056,20.0,20.0
18744,1,8744,[127 187 483 302 211],474,5,38464,4.398399085191538,20.0,20.0
18745,1,8745,[286  69 234 333 187],85,4,38468,4.398353533043677,0.0,0.0
18746,1,8746,[127 187 483 302 211],90,5,38473,4.398422316222705,20.0,20.0
18747,1,8747,[ 50  15 174  56 294],374,2,38475,4.398148148148148,0.0,40.0
18748,1,8748,[127 187 483 302 211],524,5,38480,4.398216939078752,20.0,20.0
18749,1,8749,[127 187 483 302 211],524,5,38485,4.398285714285715,20.0,20.0
18750,1,8750,[127 187 483 302 211],833,3,38488,4.398125928465318,20.0,20.0
18751,1,8751,[127 187 483 302 211],524,5,38493,4.398194698354661,20.0,20.0
18752,1,8752,[127 187 483 302 211],207,5,38498,4.398263452530561,20.0,20.0
18753,1,8753,[127 187 483 302 211],210,5,38503,4.398332190998401,20.0,20.0
18754,1,8754,[127 187 483 302 211],13,5,38508,4.398400913763564,20.0,20.0
18755,1,8755,[127 187 483 302 211],343,5,38513,4.39846962083143,20.0,20.0
18756,1,8756,[127 187 483 302 211],343,5,38518,4.398538312207377,20.0,20.0
18757,1,8757,[127 187 483 302 211],833,3,38521,4.398378625256908,20.0,20.0
18758,1,8758,[127 187 483 302 211],524,5,38526,4.398447311336911,20.0,20.0
18759,1,8759,[127 187 483 302 211],474,5,38531,4.39851598173516,20.0,20.0
18760,1,8760,[127 187 483 302 211],6,5,38536,4.398584636457025,20.0,20.0
18761,1,8761,[127 187 483 302 211],339,5,38541,4.398653275507875,20.0,20.0
18762,1,8762,[127 187 483 302 211],343,5,38546,4.398721898893073,20.0,20.0
18763,1,8763,[127 187 483 302 211],339,5,38551,4.398790506617983,20.0,20.0
18764,1,8764,[127 187 483 302 211],474,5,38556,4.398859098687963,20.0,20.0
18765,1,8765,[127 187 483 302 211],339,5,38561,4.398927675108373,20.0,20.0
18766,1,8766,[405 318 121 597 294],374,3,38564,4.398768107676514,20.0,0.0
18767,1,8767,[568 333 258 135 288],533,3,38567,4.398608576642336,0.0,0.0
18768,1,8768,[403  82 234  11  69],543,4,38571,4.398563120082107,0.0,0.0
18769,1,8769,[127 187 483 302 211],833,3,38574,4.398403648802737,20.0,20.0
18770,1,8770,[127 187 483 302 211],339,5,38579,4.398472238057234,20.0,20.0
18771,1,8771,[588 435 655 423 117],537,0,38579,4.39797081623347,0.0,0.0
18772,1,8772,[127 187 483 302 211],207,5,38584,4.398039439188419,20.0,20.0
18773,1,8773,[195 210 204  79 588],313,5,38589,4.398108046501026,0.0,0.0
18774,1,8774,[187  95 132 475 191],537,3,38592,4.397948717948718,0.0,0.0
18775,1,8775,[127 187 483 302 211],666,5,38597,4.398017319963537,20.0,20.0
18776,1,8776,[127 187 483 302 211],6,5,38602,4.3980859063461315,20.0,20.0
18777,1,8777,[127 187 483 302 211],474,5,38607,4.398154477101846,20.0,20.0
18778,1,8778,[127 187 483 302 211],524,5,38612,4.398223032236018,20.0,20.0
18779,1,8779,[127 187 483 302 211],13,5,38617,4.398291571753987,20.0,20.0
18780,1,8780,[127 187 483 302 211],524,5,38622,4.398360095661086,20.0,20.0
18781,1,8781,[ 88 173  12  50  69],234,2,38624,4.398086996128445,20.0,20.0
18782,1,8782,[127 187 483 302 211],343,5,38629,4.398155527724012,20.0,20.0
18783,1,8783,[127 187 483 302 211],537,5,38634,4.398224043715847,20.0,20.0
18784,1,8784,[175 187 323 302 211],537,4,38638,4.398178713716562,0.0,0.0
18785,1,8785,[127 187 483 302 211],90,5,38643,4.398247211472798,20.0,20.0
18786,1,8786,[127 187 483 302 211],666,5,38648,4.398315693638329,20.0,20.0
18787,1,8787,[127 187 483 302 211],537,5,38653,4.398384160218479,20.0,20.0
18788,1,8788,[127 187 483 302 211],328,5,38658,4.398452611218569,20.0,20.0
18789,1,8789,[127 187 483 302 211],537,5,38663,4.398521046643913,20.0,20.0
18790,1,8790,[302 268 515 276 655],13,4,38667,4.398475713798203,0.0,0.0
18791,1,8791,[127 187 483 302 211],90,5,38672,4.398544131028207,20.0,20.0
18792,1,8792,[175 228  22 423 257],95,5,38677,4.398612532696463,0.0,0.0
18793,1,8793,[127 187 483 302 211],833,3,38680,4.398453491016602,20.0,20.0
18794,1,8794,[127 187 483 302 211],833,3,38683,4.3982944855031265,20.0,20.0
18795,1,8795,[273  89 186 132 568],13,3,38686,4.398135516143702,0.0,0.0
18796,1,8796,[ 69 496 210  97 678],387,1,38687,4.397749232692964,0.0,0.0
18797,1,8797,[127 187 483 302 211],207,5,38692,4.3978176858376905,20.0,20.0
18798,1,8798,[597 127 289 273 288],13,1,38693,4.397431526309808,0.0,20.0
18799,1,8799,[127 187 483 302 211],524,5,38698,4.3975,20.0,20.0
18800,1,8800,[127 187 483 302 211],6,5,38703,4.397568458129758,20.0,20.0
18801,1,8801,[127 187 483 302 211],207,5,38708,4.397636900704385,20.0,20.0
18802,1,8802,[276 568  71 196 427],13,4,38712,4.397591730092014,0.0,0.0
18803,1,8803,[ 25 174 173 211 168],934,4,38716,4.397546569741027,0.0,20.0
18804,1,8804,[127 187 483 302 211],207,5,38721,4.397614991482112,20.0,20.0
18805,1,8805,[ 69 111 515 215 175],59,5,38726,4.397683397683398,0.0,0.0
18806,1,8806,[127 187 483 302 211],343,5,38731,4.397751788350176,20.0,20.0
18807,1,8807,[127 187 483 302 211],13,5,38736,4.397820163487738,20.0,20.0
18808,1,8808,[127 187 483 302 211],13,5,38741,4.397888523101374,20.0,20.0
18809,1,8809,[127  89 318 153 100],892,5,38746,4.397956867196368,20.0,40.0
18810,1,8810,[127 187 483 302 211],339,5,38751,4.398025195778005,20.0,20.0
18811,1,8811,[403 294  79 235  22],378,4,38755,4.397980027235588,0.0,0.0
18812,1,8812,[ 88  12 127 181 168],892,5,38760,4.398048337682968,20.0,20.0
18813,1,8813,[313 268  70 568 301],537,3,38763,4.39788972089857,0.0,0.0
18814,1,8814,[183 546  70 300 194],64,3,38766,4.397731140102099,0.0,0.0
18815,1,8815,[ 50 181 403  28 357],833,1,38767,4.397345735027224,20.0,20.0
18816,1,8816,[127 187 483 302 211],833,3,38770,4.397187251899739,20.0,20.0
18817,1,8817,[127 187 483 302 211],207,5,38775,4.397255613517805,20.0,20.0
18818,1,8818,[265  22 202 508  89],774,1,38776,4.396870393468647,0.0,0.0
18819,1,8819,[127 187 483 302 211],6,5,38781,4.396938775510204,20.0,20.0
18820,1,8820,[127 187 483 302 211],833,3,38784,4.39678041038431,20.0,20.0
18821,1,8821,[127 187 483 302 211],207,5,38789,4.396848787123101,20.0,20.0
18822,1,8822,[127 187 483 302 211],328,5,38794,4.396917148362235,20.0,20.0
18823,1,8823,[127 187 483 302 211],6,5,38799,4.396985494106981,20.0,20.0
18824,1,8824,[127 187 483 302 211],328,5,38804,4.397053824362606,20.0,20.0
18825,1,8825,[127 187 483 302 211],207,5,38809,4.3971221391343756,20.0,20.0
18826,1,8826,[127 187 483 302 211],328,5,38814,4.397190438427552,20.0,20.0
18827,1,8827,[678 182 655 742   4],881,2,38816,4.396918894426824,0.0,0.0
18828,1,8828,[127 187 483 302 211],328,5,38821,4.396987201268547,20.0,20.0
18829,1,8829,[127 187 483 302 211],666,5,38826,4.3970554926387315,20.0,20.0
18830,1,8830,[127 187 483 302 211],524,5,38831,4.397123768542634,20.0,20.0
18831,1,8831,[127 187 483 302 211],207,5,38836,4.397192028985507,20.0,20.0
18832,1,8832,[127 187 483 302 211],90,5,38841,4.397260273972603,20.0,20.0
18833,1,8833,[127 187 483 302 211],210,5,38846,4.397328503509169,20.0,20.0
18834,1,8834,[ 64 496 153 195 282],804,5,38851,4.3973967176004525,0.0,0.0
18835,1,8835,[ 89 195 222 215  71],648,3,38854,4.397238569488456,0.0,0.0
18836,1,8836,[127 187 483 302 211],207,5,38859,4.397306778318434,20.0,20.0
18837,1,8837,[127 187 483 302 211],833,3,38862,4.39714867617108,20.0,20.0
18838,1,8838,[127 187 483 302 211],207,5,38867,4.397216879737527,20.0,20.0
18839,1,8839,[127 187 483 302 211],833,3,38870,4.397058823529412,20.0,20.0
18840,1,8840,[127 187 483 302 211],328,5,38875,4.3971270218301095,20.0,20.0
18841,1,8841,[ 25 127 161  50  28],455,4,38879,4.397082108120335,0.0,40.0
18842,1,8842,[127 187 483 302 211],537,5,38884,4.397150288363678,20.0,20.0
18843,1,8843,[127 187 483 302 211],343,5,38889,4.397218453188603,20.0,20.0
18844,1,8844,[127 187 483 302 211],537,5,38894,4.397286602600339,20.0,20.0
18845,1,8845,[127 187 483 302 211],328,5,38899,4.397354736604115,20.0,20.0
18846,1,8846,[127 187 483 302 211],343,5,38904,4.397422855205154,20.0,20.0
18847,1,8847,[127 187 483 302 211],13,5,38909,4.39749095840868,20.0,20.0
18848,1,8848,[127 187 483 302 211],339,5,38914,4.397559046219912,20.0,20.0
18849,1,8849,[195 125 333 143   1],298,4,38918,4.397514124293785,0.0,0.0
18850,1,8850,[127 187 483 302 211],210,5,38923,4.397582194102362,20.0,20.0
18851,1,8851,[301 182 216  97 475],537,2,38925,4.397311342069589,0.0,0.0
18852,1,8852,[127 187 483 302 211],6,5,38930,4.397379419405851,20.0,20.0
18853,1,8853,[127 187 483 302 211],339,5,38935,4.397447481364355,20.0,20.0
18854,1,8854,[127 187 483 302 211],343,5,38940,4.39751552795031,20.0,20.0
18855,1,8855,[144 655 176 181 196],843,1,38941,4.397131887985546,0.0,0.0
18856,1,8856,[127 187 483 302 211],6,5,38946,4.397199954837982,20.0,20.0
18857,1,8857,[127 187 483 302 211],328,5,38951,4.397268006321969,20.0,20.0
18858,1,8858,[127 187 483 302 211],833,3,38954,4.397110283327689,20.0,20.0
18859,1,8859,[127 187 483 302 211],210,5,38959,4.397178329571106,20.0,20.0
18860,1,8860,[202 423 475 301 268],13,3,38962,4.397020652296581,0.0,0.0
18861,1,8861,[ 11 655   7 181 288],102,0,38962,4.39652448657188,0.0,0.0
18862,1,8862,[127 187 483 302 211],343,5,38967,4.396592575877243,20.0,20.0
18863,1,8863,[194 153 286  70 173],883,2,38969,4.396322202166065,0.0,0.0
18864,1,8864,[257 742 132 245  11],666,2,38971,4.396051889452905,0.0,0.0
18865,1,8865,[210 135 172 180  89],239,5,38976,4.396120009023234,0.0,0.0
18866,1,8866,[294 357 135 655 175],379,4,38980,4.396075335513703,20.0,0.0
18867,1,8867,[127 187 483 302 211],833,3,38983,4.395917907081642,20.0,20.0
18868,1,8868,[127 187 483 302 211],524,5,38988,4.395986018716879,20.0,20.0
18869,1,8869,[127 187 483 302 211],328,5,38993,4.396054114994363,20.0,20.0
18870,1,8870,[222 125 265 161 748],64,2,38995,4.395784015330853,0.0,0.0
18871,1,8871,[127 187 483 302 211],90,5,39000,4.3958521190261495,20.0,20.0
18872,1,8872,[237 294  22 286  28],328,4,39004,4.395807505916826,0.0,0.0
18873,1,8873,[143   8 172 222 655],64,5,39009,4.395875591615956,0.0,0.0
18874,1,8874,[127 187 483 302 211],339,5,39014,4.395943661971831,20.0,20.0
18875,1,8875,[127 187 483 302 211],343,5,39019,4.396011716989635,20.0,20.0
18876,1,8876,[127 187 483 302 211],339,5,39024,4.396079756674553,20.0,20.0
18877,1,8877,[127 187 483 302 211],207,5,39029,4.396147781031764,20.0,20.0
18878,1,8878,[ 22 111 678  89  56],537,2,39031,4.395877914179525,0.0,0.0
18879,1,8879,[127 187 483 302 211],474,5,39036,4.395945945945946,20.0,20.0
18880,1,8880,[127 187 483 302 211],339,5,39041,4.396013962391622,20.0,20.0
18881,1,8881,[127 187 483 302 211],328,5,39046,4.39608196352173,20.0,20.0
18882,1,8882,[127 187 483 302 211],524,5,39051,4.396149949341439,20.0,20.0
18883,1,8883,[127 187 483 302 211],833,3,39054,4.395992796037821,20.0,20.0
18884,1,8884,[127 187 483 302 211],524,5,39059,4.396060776589758,20.0,20.0
18885,1,8885,[127 187 483 302 211],666,5,39064,4.396128741841098,20.0,20.0
18886,1,8886,[127 187 483 302 211],339,5,39069,4.396196691797007,20.0,20.0
18887,1,8887,[  9 357 508 183 132],184,5,39074,4.396264626462647,20.0,0.0
18888,1,8888,[127 187 483 302 211],207,5,39079,4.396332545843177,20.0,20.0
18889,1,8889,[127 187 483 302 211],90,5,39084,4.396400449943757,20.0,20.0
18890,1,8890,[127 187 483 302 211],6,5,39089,4.396468338769542,20.0,20.0
18891,1,8891,[127 187 483 302 211],13,5,39094,4.396536212325686,20.0,20.0
18892,1,8892,[127 187 483 302 211],90,5,39099,4.3966040706173395,20.0,20.0
18893,1,8893,[127 187 483 302 211],343,5,39104,4.3966719136496515,20.0,20.0
18894,1,8894,[127 187 483 302 211],833,3,39107,4.396514896008994,20.0,20.0
18895,1,8895,[127 187 483 302 211],666,5,39112,4.3965827338129495,20.0,20.0
18896,1,8896,[ 11 172  95 186 288],387,1,39113,4.396200966617961,0.0,0.0
18897,1,8897,[127 187 483 302 211],666,5,39118,4.396268824454934,20.0,20.0
18898,1,8898,[127 187 483 302 211],474,5,39123,4.396336667041241,20.0,20.0
18899,1,8899,[ 69   1 118 748 508],447,2,39125,4.396067415730337,0.0,0.0
18900,1,8900,[127 187 483 302 211],210,5,39130,4.396135265700483,20.0,20.0
18901,1,8901,[127 187 483 302 211],524,5,39135,4.39620310042687,20.0,20.0
18902,1,8902,[127 187 483 302 211],666,5,39140,4.3962709199146355,20.0,20.0
18903,1,8903,[127 187 483 302 211],328,5,39145,4.3963387241689125,20.0,20.0
18904,1,8904,[127 187 483 302 211],537,5,39150,4.396406513194834,20.0,20.0
18905,1,8905,[127 187 483 302 211],13,5,39155,4.39647428699753,20.0,20.0
18906,1,8906,[ 98 385 286 180 202],653,3,39158,4.3963175030874595,0.0,20.0
18907,1,8907,[588 202  56 194  82],13,4,39162,4.396273013022003,0.0,0.0
18908,1,8908,[435 655  15  12 181],537,0,39162,4.395779548770906,20.0,0.0
18909,1,8909,[238 216  97 228 174],7,5,39167,4.395847362514029,0.0,20.0
18910,1,8910,[127 187 483 302 211],343,5,39172,4.39591516103692,20.0,20.0
18911,1,8911,[276 475 471  98 174],537,2,39174,4.395646319569121,0.0,40.0
18912,1,8912,[127 187 483 302 211],90,5,39179,4.3957141254347585,20.0,20.0
18913,1,8913,[127 187 483 302 211],13,5,39184,4.395781916087054,20.0,20.0
18914,1,8914,[127 187 483 302 211],207,5,39189,4.395849691531128,20.0,20.0
18915,1,8915,[222  22 153  56 143],234,1,39190,4.395468820098699,0.0,0.0
18916,1,8916,[215 328 289 172  79],537,0,39190,4.394975888751822,0.0,0.0
18917,1,8917,[127 187 483 302 211],328,5,39195,4.395043731778426,20.0,20.0
18918,1,8918,[127 187 483 302 211],210,5,39200,4.395111559591882,20.0,20.0
18919,1,8919,[127 187 483 302 211],339,5,39205,4.395179372197309,20.0,20.0
18920,1,8920,[127 187 483 302 211],666,5,39210,4.395247169599821,20.0,20.0
18921,1,8921,[127 187 483 302 211],210,5,39215,4.3953149518045285,20.0,20.0
18922,1,8922,[127 187 483 302 211],328,5,39220,4.395382718816541,20.0,20.0
18923,1,8923,[234 144  88 269 257],934,3,39223,4.395226355894218,0.0,0.0
18924,1,8924,[127 187 483 302 211],833,3,39226,4.3950700280112045,20.0,20.0
18925,1,8925,[127 187 483 302 211],666,5,39231,4.395137799686309,20.0,20.0
18926,1,8926,[127 187 483 302 211],90,5,39236,4.3952055561778876,20.0,20.0
18927,1,8927,[127 187 483 302 211],13,5,39241,4.395273297491039,20.0,20.0
18928,1,8928,[568 423 471 405  12],524,3,39244,4.395117034382349,20.0,0.0
18929,1,8929,[127 187 483 302 211],343,5,39249,4.39518477043673,20.0,20.0
18930,1,8930,[127 187 483 302 211],328,5,39254,4.395252491322361,20.0,20.0
18931,1,8931,[127 187 483 302 211],90,5,39259,4.395320197044335,20.0,20.0
18932,1,8932,[127 187 483 302 211],13,5,39264,4.395387887607747,20.0,20.0
18933,1,8933,[597 568 496 237  28],7,4,39268,4.395343631072308,0.0,0.0
18934,1,8934,[127 187 483 302 211],207,5,39273,4.39541130386122,20.0,20.0
18935,1,8935,[127 187 483 302 211],90,5,39278,4.395478961504029,20.0,20.0
18936,1,8936,[127 187 483 302 211],210,5,39283,4.395546604005818,20.0,20.0
18937,1,8937,[127 187 483 302 211],210,5,39288,4.395614231371671,20.0,20.0
18938,1,8938,[ 28 183  98 748  56],207,3,39291,4.395458104933438,0.0,20.0
18939,1,8939,[ 95 435 216  28 318],648,3,39294,4.3953020134228185,20.0,0.0
18940,1,8940,[328   4 423 300 273],234,2,39296,4.395034112515378,0.0,0.0
18941,1,8941,[127 187 483 302 211],524,5,39301,4.395101766942519,20.0,20.0
18942,1,8942,[483  96 185 181  88],326,3,39304,4.394945767639495,20.0,0.0
18943,1,8943,[127 187 483 302 211],6,5,39309,4.395013416815742,20.0,20.0
18944,1,8944,[127 187 483 302 211],13,5,39314,4.3950810508664055,20.0,20.0
18945,1,8945,[127 187 483 302 211],833,3,39317,4.394925106192712,20.0,20.0
18946,1,8946,[127 187 483 302 211],6,5,39322,4.39499273499497,20.0,20.0
18947,1,8947,[196 655 197 127 181],85,4,39326,4.394948591864104,0.0,20.0
18948,1,8948,[127 187 483 302 211],666,5,39331,4.395016202927701,20.0,20.0
18949,1,8949,[127 187 483 302 211],524,5,39336,4.395083798882681,20.0,20.0
18950,1,8950,[127 187 483 302 211],6,5,39341,4.3951513797341075,20.0,20.0
18951,1,8951,[111  71 191 127  50],334,3,39344,4.394995531724755,0.0,40.0
18952,1,8952,[127 187 483 302 211],339,5,39349,4.395063107338323,20.0,20.0
18953,1,8953,[333 678 228 216 269],13,1,39350,4.394683940138486,0.0,0.0
18954,1,8954,[127 187 483 302 211],210,5,39355,4.394751535455053,20.0,20.0
18955,1,8955,[127 187 483 302 211],13,5,39360,4.394819115676642,20.0,20.0
18956,1,8956,[127 187 483 302 211],524,5,39365,4.394886680808306,20.0,20.0
18957,1,8957,[127 187 483 302 211],833,3,39368,4.394730966733646,20.0,20.0
18958,1,8958,[ 70 216 313  64 127],659,5,39373,4.394798526621274,0.0,20.0
18959,1,8959,[127 187 483 302 211],207,5,39378,4.394866071428571,20.0,20.0
18960,1,8960,[655 151 100 180   7],378,3,39381,4.394710411784399,0.0,20.0
18961,1,8961,[127 187 483 302 211],90,5,39386,4.394777951350145,20.0,20.0
18962,1,8962,[471 568  69 258 100],343,4,39390,4.3947339060582395,0.0,20.0
18963,1,8963,[127 187 483 302 211],833,3,39393,4.394578313253012,20.0,20.0
18964,1,8964,[127 187 483 302 211],328,5,39398,4.394645844952594,20.0,20.0
18965,1,8965,[211  64  88 275 603],533,5,39403,4.394713361588222,20.0,0.0
18966,1,8966,[127 187 483 302 211],210,5,39408,4.3947808631649385,20.0,20.0
18967,1,8967,[127 187 483 302 211],343,5,39413,4.394848349687779,20.0,20.0
18968,1,8968,[127 187 483 302 211],210,5,39418,4.39491582116178,20.0,20.0
18969,1,8969,[127 187 483 302 211],207,5,39423,4.394983277591973,20.0,20.0
18970,1,8970,[300 546 515 121 322],294,4,39427,4.394939248690224,0.0,0.0
18971,1,8971,[568 235 405 143 318],290,2,39429,4.3946723138653585,20.0,0.0
18972,1,8972,[  4 245 282 186 294],653,2,39431,4.394405438537836,0.0,0.0
18973,1,8973,[191  11  71   9  50],13,2,39433,4.394138622687764,0.0,20.0
18974,1,8974,[204 546 597 183  64],788,2,39435,4.393871866295265,0.0,0.0
18975,1,8975,[127 187 483 302 211],210,5,39440,4.393939393939394,20.0,20.0
18976,1,8976,[127 187 483 302 211],328,5,39445,4.394006906538933,20.0,20.0
18977,1,8977,[127 187 483 302 211],343,5,39450,4.394074404098909,20.0,20.0
18978,1,8978,[168 181 423 234 405],474,4,39454,4.394030515647622,0.0,0.0
18979,1,8979,[127 187 483 302 211],210,5,39459,4.394097995545657,20.0,20.0
18980,1,8980,[127 187 483 302 211],210,5,39464,4.394165460416435,20.0,20.0
18981,1,8981,[127 187 483 302 211],90,5,39469,4.394232910264974,20.0,20.0
18982,1,8982,[127 187 483 302 211],6,5,39474,4.394300345096293,20.0,20.0
18983,1,8983,[204 127 197  97  56],804,3,39477,4.394145146927872,0.0,20.0
18984,1,8984,[127 187 483 302 211],666,5,39482,4.394212576516416,20.0,20.0
18985,1,8985,[127 187 483 302 211],474,5,39487,4.394279991097262,20.0,20.0
18986,1,8986,[127 187 483 302 211],666,5,39492,4.39434739067542,20.0,20.0
18987,1,8987,[127 187 483 302 211],833,3,39495,4.394192256341789,20.0,20.0
18988,1,8988,[127 187 483 302 211],343,5,39500,4.39425965068417,20.0,20.0
18989,1,8989,[678 185 173 328 294],804,5,39505,4.39432703003337,0.0,0.0
18990,1,8990,[127 187 483 302 211],833,3,39508,4.394171949727506,20.0,20.0
18991,1,8991,[127 187 483 302 211],343,5,39513,4.394239323843417,20.0,20.0
18992,1,8992,[127 187 483 302 211],339,5,39518,4.394306682975648,20.0,20.0
18993,1,8993,[127 187 483 302 211],328,5,39523,4.394374027129198,20.0,20.0
18994,1,8994,[ 96 197 125 403 288],378,2,39525,4.394107837687605,0.0,0.0
18995,1,8995,[127 187 483 302 211],6,5,39530,4.394175188972877,20.0,20.0
18996,1,8996,[127 187 483 302 211],210,5,39535,4.394242525286207,20.0,20.0
18997,1,8997,[172 204 175 238  71],85,4,39539,4.394198710824628,0.0,0.0
18998,1,8998,[127 187 483 302 211],339,5,39544,4.39426602955884,20.0,20.0
18999,1,8999,[127 187 483 302 211],328,5,39549,4.394333333333333,20.0,20.0
19000,1,9000,[127 187 483 302 211],343,5,39554,4.3944006221530945,20.0,20.0
19001,1,9001,[127 187 483 302 211],343,5,39559,4.394467896023106,20.0,20.0
19002,1,9002,[127 187 483 302 211],666,5,39564,4.3945351549483505,20.0,20.0
19003,1,9003,[127 187 483 302 211],328,5,39569,4.394602398933807,20.0,20.0
19004,1,9004,[127 187 483 302 211],833,3,39572,4.394447529150472,20.0,20.0
19005,1,9005,[186 508 301 204  89],85,3,39575,4.3942926937597155,0.0,0.0
19006,1,9006,[100 143 294  79 318],378,4,39579,4.394248917508604,20.0,20.0
19007,1,9007,[127 187 483 302 211],339,5,39584,4.394316163410302,20.0,20.0
19008,1,9008,[127 187 483 302 211],339,5,39589,4.394383394383395,20.0,20.0
19009,1,9009,[127 187 483 302 211],90,5,39594,4.394450610432853,20.0,20.0
19010,1,9010,[127 187 483 302 211],13,5,39599,4.394517811563644,20.0,20.0
19011,1,9011,[496 132 143 273 269],537,1,39600,4.394141145139813,0.0,0.0
19012,1,9012,[127 187 483 302 211],13,5,39605,4.394208365693998,20.0,20.0
19013,1,9013,[127 187 483 302 211],210,5,39610,4.394275571333481,20.0,20.0
19014,1,9014,[127 187 483 302 211],210,5,39615,4.394342762063228,20.0,20.0
19015,1,9015,[423 118  56 269 182],524,5,39620,4.394409937888199,0.0,0.0
19016,1,9016,[127 187 483 302 211],537,5,39625,4.394477098813352,20.0,20.0
19017,1,9017,[742 186 238  56 197],648,2,39627,4.394211576846307,0.0,0.0
19018,1,9018,[268   1 289 568 405],13,1,39628,4.393835236722475,0.0,0.0
19019,1,9019,[127 187 483 302 211],207,5,39633,4.39390243902439,20.0,20.0
19020,1,9020,[313 127 191 204 496],659,5,39638,4.393969626427225,0.0,20.0
19021,1,9021,[127 187 483 302 211],210,5,39643,4.394036798935934,20.0,20.0
19022,1,9022,[127 187 483 302 211],90,5,39648,4.394103956555469,20.0,20.0
19023,1,9023,[127 187 483 302 211],524,5,39653,4.39417109929078,20.0,20.0
19024,1,9024,[127 187 483 302 211],328,5,39658,4.394238227146815,20.0,20.0
19025,1,9025,[127 187 483 302 211],339,5,39663,4.3943053401285175,20.0,20.0
19026,1,9026,[127 187 483 302 211],524,5,39668,4.394372438240833,20.0,20.0
19027,1,9027,[127 187 483 302 211],6,5,39673,4.394439521488702,20.0,20.0
19028,1,9028,[127 187 483 302 211],537,5,39678,4.3945065898770626,20.0,20.0
19029,1,9029,[127 187 483 302 211],328,5,39683,4.394573643410853,20.0,20.0
19030,1,9030,[200 168 288  88 427],650,3,39686,4.394419222677445,0.0,0.0
19031,1,9031,[182 125 245 181  50],334,2,39688,4.394154118689105,0.0,20.0
19032,1,9032,[127 187 483 302 211],210,5,39693,4.394221188973763,20.0,20.0
19033,1,9033,[127 187 483 302 211],666,5,39698,4.394288244410006,20.0,20.0
19034,1,9034,[127 187 483 302 211],343,5,39703,4.394355285002767,20.0,20.0
19035,1,9035,[508 275  98  69  88],13,3,39706,4.394200973882249,0.0,20.0
19036,1,9036,[ 50 546 742 515 282],458,2,39708,4.393936040721479,0.0,20.0
19037,1,9037,[127 187 483 302 211],524,5,39713,4.394003098030538,20.0,20.0
19038,1,9038,[127 187 483 302 211],524,5,39718,4.394070140502268,20.0,20.0
19039,1,9039,[127 187 483 302 211],6,5,39723,4.394137168141593,20.0,20.0
19040,1,9040,[588 483  28 271 143],479,2,39725,4.3938723592522955,20.0,0.0
19041,1,9041,[127 187 483 302 211],328,5,39730,4.393939393939394,20.0,20.0
19042,1,9042,[127 187 483 302 211],537,5,39735,4.39400641380073,20.0,20.0
19043,1,9043,[127 187 483 302 211],339,5,39740,4.394073418841221,20.0,20.0
19044,1,9044,[127 187 483 302 211],474,5,39745,4.394140409065782,20.0,20.0
19045,1,9045,[127 187 483 302 211],537,5,39750,4.394207384479328,20.0,20.0
19046,1,9046,[282 222 215 121   1],378,4,39754,4.394163811208135,0.0,0.0
19047,1,9047,[127 187 483 302 211],210,5,39759,4.394230769230769,20.0,20.0
19048,1,9048,[127 187 483 302 211],524,5,39764,4.3942977124544145,20.0,20.0
19049,1,9049,[127 187 483 302 211],833,3,39767,4.39414364640884,20.0,20.0
19050,1,9050,[127 187 483 302 211],13,5,39772,4.394210584465805,20.0,20.0
19051,1,9051,[127 187 483 302 211],537,5,39777,4.394277507733098,20.0,20.0
19052,1,9052,[127 187 483 302 211],207,5,39782,4.3943444162156196,20.0,20.0
19053,1,9053,[127 187 483 302 211],343,5,39787,4.394411309918268,20.0,20.0
19054,1,9054,[127 187 483 302 211],210,5,39792,4.394478188845942,20.0,20.0
19055,1,9055,[483  89  50 238 127],95,3,39795,4.394324204946996,20.0,40.0
19056,1,9056,[127 187 483 302 211],537,5,39800,4.394391078723639,20.0,20.0
19057,1,9057,[127 187 483 302 211],210,5,39805,4.394457937734599,20.0,20.0
19058,1,9058,[127 187 483 302 211],6,5,39810,4.394524781984766,20.0,20.0
19059,1,9059,[127 187 483 302 211],13,5,39815,4.394591611479028,20.0,20.0
19060,1,9060,[127 187 483 302 211],210,5,39820,4.394658426222271,20.0,20.0
19061,1,9061,[135 204 742 100 183],650,4,39824,4.394614875303465,0.0,20.0
19062,1,9062,[ 56 228  89 183  96],311,5,39829,4.394681672735297,0.0,0.0
19063,1,9063,[127 187 483 302 211],666,5,39834,4.394748455428067,20.0,20.0
19064,1,9064,[127 187 483 302 211],328,5,39839,4.394815223386652,20.0,20.0
19065,1,9065,[127 187 483 302 211],474,5,39844,4.3948819766159275,20.0,20.0
19066,1,9066,[127 187 483 302 211],207,5,39849,4.394948715120767,20.0,20.0
19067,1,9067,[127 187 483 302 211],343,5,39854,4.395015438906043,20.0,20.0
19068,1,9068,[127 187 483 302 211],6,5,39859,4.395082147976623,20.0,20.0
19069,1,9069,[127 187 483 302 211],13,5,39864,4.395148842337376,20.0,20.0
19070,1,9070,[127 187 483 302 211],90,5,39869,4.3952155219931655,20.0,20.0
19071,1,9071,[127 187 483 302 211],343,5,39874,4.395282186948854,20.0,20.0
19072,1,9072,[127 187 483 302 211],474,5,39879,4.395348837209302,20.0,20.0
19073,1,9073,[ 98  88 187  95 117],543,3,39882,4.395195062816839,0.0,20.0
19074,1,9074,[127 187 483 302 211],524,5,39887,4.395261707988981,20.0,20.0
19075,1,9075,[127 187 483 302 211],207,5,39892,4.395328338475099,20.0,20.0
19076,1,9076,[127 187 483 302 211],207,5,39897,4.395394954280048,20.0,20.0
19077,1,9077,[127 187 483 302 211],90,5,39902,4.39546155540868,20.0,20.0
19078,1,9078,[127 187 483 302 211],833,3,39905,4.395307853287807,20.0,20.0
19079,1,9079,[127 187 483 302 211],833,3,39908,4.395154185022027,20.0,20.0
19080,1,9080,[127 187 483 302 211],666,5,39913,4.3952207906618215,20.0,20.0
19081,1,9081,[127 187 483 302 211],343,5,39918,4.3952873816340015,20.0,20.0
19082,1,9082,[127 187 483 302 211],6,5,39923,4.395353957943411,20.0,20.0
19083,1,9083,[153 603 175 301 276],234,1,39924,4.394980184940555,20.0,0.0
19084,1,9084,[127 187 483 302 211],210,5,39929,4.395046780407265,20.0,20.0
19085,1,9085,[546 294 216 202 127],648,3,39932,4.39489324235087,0.0,20.0
19086,1,9086,[127 187 483 302 211],90,5,39937,4.394959832728073,20.0,20.0
19087,1,9087,[127 187 483 302 211],537,5,39942,4.395026408450704,20.0,20.0
19088,1,9088,[111 403 200 271   1],13,1,39943,4.394652877104192,0.0,0.0
19089,1,9089,[127 187 483 302 211],666,5,39948,4.3947194719471945,20.0,20.0
19090,1,9090,[127 187 483 302 211],474,5,39953,4.394786052139478,20.0,20.0
19091,1,9091,[127 187 483 302 211],524,5,39958,4.394852617685878,20.0,20.0
19092,1,9092,[127 187 483 302 211],207,5,39963,4.394919168591224,20.0,20.0
19093,1,9093,[127 187 483 302 211],90,5,39968,4.394985704860347,20.0,20.0
19094,1,9094,[127 187 483 302 211],339,5,39973,4.395052226498076,20.0,20.0
19095,1,9095,[127 187 483 302 211],339,5,39978,4.395118733509235,20.0,20.0
19096,1,9096,[127 187 483 302 211],474,5,39983,4.395185225898648,20.0,20.0
19097,1,9097,[127 187 483 302 211],343,5,39988,4.3952517036711365,20.0,20.0
19098,1,9098,[127 187 483 302 211],537,5,39993,4.39531816683152,20.0,20.0
19099,1,9099,[127 187 483 302 211],474,5,39998,4.395384615384615,20.0,20.0
19100,1,9100,[127 187 483 302 211],833,3,40001,4.395231293264477,20.0,20.0
19101,1,9101,[127 187 483 302 211],6,5,40006,4.395297736761151,20.0,20.0
19102,1,9102,[127 187 483 302 211],6,5,40011,4.3953641656596725,20.0,20.0
19103,1,9103,[ 71 405 237 228  50],533,3,40014,4.395210896309314,0.0,20.0
19104,1,9104,[ 70 228 475 435 185],64,5,40019,4.395277320153761,0.0,0.0
19105,1,9105,[132 323 234   4 515],537,1,40020,4.3949044585987265,0.0,0.0
19106,1,9106,[546 288  11  98 234],92,3,40023,4.394751290216317,0.0,20.0
19107,1,9107,[127 187 483 302 211],474,5,40028,4.39481774264383,20.0,20.0
19108,1,9108,[127 187 483 302 211],343,5,40033,4.394884180480843,20.0,20.0
19109,1,9109,[127 187 483 302 211],6,5,40038,4.394950603732163,20.0,20.0
19110,1,9110,[127 187 483 302 211],207,5,40043,4.39501701240259,20.0,20.0
19111,1,9111,[328 655 132  64 275],119,5,40048,4.395083406496927,0.0,0.0
19112,1,9112,[127 187 483 302 211],13,5,40053,4.395149786019972,20.0,20.0
19113,1,9113,[183 200 423 228 403],13,3,40056,4.394996708360764,0.0,0.0
19114,1,9114,[597  56 269  97  98],650,2,40058,4.394733955019199,0.0,20.0
19115,1,9115,[127 187 483 302 211],6,5,40063,4.394800351031154,20.0,20.0
19116,1,9116,[127 187 483 302 211],537,5,40068,4.394866732477789,20.0,20.0
19117,1,9117,[127 187 483 302 211],666,5,40073,4.394933099363896,20.0,20.0
19118,1,9118,[127 187 483 302 211],339,5,40078,4.3949994516942645,20.0,20.0
19119,1,9119,[127 187 483 302 211],524,5,40083,4.395065789473684,20.0,20.0
19120,1,9120,[127 187 483 302 211],13,5,40088,4.39513211270694,20.0,20.0
19121,1,9121,[748 176  97 197  28],313,3,40091,4.394979171234379,0.0,0.0
19122,1,9122,[127 187 483 302 211],666,5,40096,4.395045489422339,20.0,20.0
19123,1,9123,[ 11 153 187 289  25],406,1,40097,4.3946733888645335,0.0,0.0
19124,1,9124,[127  95 568 313 245],455,4,40101,4.394630136986302,0.0,20.0
19125,1,9125,[127 187 483 302 211],343,5,40106,4.3946964716195485,20.0,20.0
19126,1,9126,[127 187 483 302 211],474,5,40111,4.394762791716884,20.0,20.0
19127,1,9127,[127 187 483 302 211],210,5,40116,4.394829097283085,20.0,20.0
19128,1,9128,[127 187 483 302 211],524,5,40121,4.394895388322927,20.0,20.0
19129,1,9129,[127 187 483 302 211],339,5,40126,4.394961664841183,20.0,20.0
19130,1,9130,[127 187 483 302 211],339,5,40131,4.395027926842624,20.0,20.0
19131,1,9131,[127 187 483 302 211],339,5,40136,4.395094174332019,20.0,20.0
19132,1,9132,[127 187 483 302 211],328,5,40141,4.395160407314136,20.0,20.0
19133,1,9133,[127 187 483 302 211],666,5,40146,4.395226625793738,20.0,20.0
19134,1,9134,[127 187 483 302 211],13,5,40151,4.395292829775588,20.0,20.0
19135,1,9135,[127 187 483 302 211],833,3,40154,4.395140105078809,20.0,20.0
19136,1,9136,[127 187 483 302 211],339,5,40159,4.395206304038525,20.0,20.0
19137,1,9137,[127 187 483 302 211],524,5,40164,4.395272488509521,20.0,20.0
19138,1,9138,[127 187 483 302 211],474,5,40169,4.395338658496553,20.0,20.0
19139,1,9139,[127 187 483 302 211],207,5,40174,4.395404814004376,20.0,20.0
19140,1,9140,[127 187 483 302 211],343,5,40179,4.395470955037742,20.0,20.0
19141,1,9141,[216  22 286  82  56],328,4,40183,4.395427696346532,0.0,0.0
19142,1,9142,[179 286 257   4 385],318,3,40186,4.395275073826971,0.0,0.0
19143,1,9143,[127 187 483 302 211],6,5,40191,4.395341207349081,20.0,20.0
19144,1,9144,[127 187 483 302 211],524,5,40196,4.395407326407873,20.0,20.0
19145,1,9145,[100 318 144 183 238],207,1,40197,4.395036081347037,20.0,20.0
19146,1,9146,[127 187 483 302 211],328,5,40202,4.395102219306876,20.0,20.0
19147,1,9147,[179 210 403 471 121],653,3,40205,4.394949715784871,0.0,0.0
19148,1,9148,[127 187 483 302 211],833,3,40208,4.394797245600612,20.0,20.0
19149,1,9149,[127 187 483 302 211],833,3,40211,4.39464480874317,20.0,20.0
19150,1,9150,[118 748 235  15 322],634,2,40213,4.394383127527046,0.0,0.0
19151,1,9151,[127 187 483 302 211],6,5,40218,4.394449300699301,20.0,20.0
19152,1,9152,[235 172 144 655  70],795,1,40219,4.394078444225936,0.0,0.0
19153,1,9153,[127 187 483 302 211],833,3,40222,4.393926152501638,20.0,20.0
19154,1,9154,[127 187 483 302 211],13,5,40227,4.39399235390497,20.0,20.0
19155,1,9155,[127 187 483 302 211],13,5,40232,4.3940585408475314,20.0,20.0
19156,1,9156,[127 187 483 302 211],833,3,40235,4.393906301190346,20.0,20.0
19157,1,9157,[127 187 483 302 211],537,5,40240,4.393972483074907,20.0,20.0
19158,1,9158,[427 603 161   7 172],334,3,40243,4.39382028605743,20.0,0.0
19159,1,9159,[127 187 483 302 211],6,5,40248,4.393886462882096,20.0,20.0
19160,1,9160,[127 187 483 302 211],474,5,40253,4.393952625259251,20.0,20.0
19161,1,9161,[127 187 483 302 211],666,5,40258,4.3940187731936255,20.0,20.0
19162,1,9162,[127 187 483 302 211],210,5,40263,4.394084906689948,20.0,20.0
19163,1,9163,[127 187 483 302 211],6,5,40268,4.394151025752946,20.0,20.0
19164,1,9164,[127 187 483 302 211],328,5,40273,4.394217130387343,20.0,20.0
19165,1,9165,[322 286 423 655 195],13,2,40275,4.393955924067205,0.0,0.0
19166,1,9166,[127 187 483 302 211],207,5,40280,4.394022035562343,20.0,20.0
19167,1,9167,[127 187 483 302 211],6,5,40285,4.394088132635253,20.0,20.0
19168,1,9168,[475 197 202  64  56],82,3,40288,4.393936088995528,0.0,0.0
19169,1,9169,[655 173  96 215  22],144,5,40293,4.3940021810250816,0.0,0.0
19170,1,9170,[ 98 588 222  64 483],290,5,40298,4.3940682586413695,20.0,20.0
19171,1,9171,[222 483 265 127 135],479,5,40303,4.394134321849106,20.0,20.0
19172,1,9172,[127 187 483 302 211],207,5,40308,4.394200370653003,20.0,20.0
19173,1,9173,[127 187 483 302 211],833,3,40311,4.39404839764552,20.0,20.0
19174,1,9174,[127 187 483 302 211],328,5,40316,4.394114441416893,20.0,20.0
19175,1,9175,[127 187 483 302 211],666,5,40321,4.394180470793374,20.0,20.0
19176,1,9176,[174 144 588 183 176],892,5,40326,4.394246485779666,0.0,20.0
19177,1,9177,[127 187 483 302 211],339,5,40331,4.394312486380475,20.0,20.0
19178,1,9178,[127 187 483 302 211],13,5,40336,4.3943784726005015,20.0,20.0
19179,1,9179,[597 238 111 302 257],378,2,40338,4.394117647058824,0.0,0.0
19180,1,9180,[127 187 483 302 211],339,5,40343,4.394183640126348,20.0,20.0
19181,1,9181,[127 187 483 302 211],343,5,40348,4.394249618819429,20.0,20.0
19182,1,9182,[135 742 313 174 515],207,4,40352,4.394206686268104,0.0,20.0
19183,1,9183,[127 187 483 302 211],13,5,40357,4.394272648083624,20.0,20.0
19184,1,9184,[127 187 483 302 211],537,5,40362,4.3943385955362,20.0,20.0
19185,1,9185,[127 187 483 302 211],13,5,40367,4.394404528630525,20.0,20.0
19186,1,9186,[127 187 483 302 211],6,5,40372,4.394470447371286,20.0,20.0
19187,1,9187,[127 187 483 302 211],474,5,40377,4.394536351763169,20.0,20.0
19188,1,9188,[318 202  79  97  82],125,4,40381,4.394493416040919,20.0,0.0
19189,1,9189,[127 187 483 302 211],524,5,40386,4.394559303590859,20.0,20.0
19190,1,9190,[127 187 483 302 211],90,5,40391,4.394625176803395,20.0,20.0
19191,1,9191,[127 187 483 302 211],207,5,40396,4.394691035683203,20.0,20.0
19192,1,9192,[127 187 483 302 211],343,5,40401,4.3947568802349615,20.0,20.0
19193,1,9193,[ 28   1 174 742 276],308,4,40405,4.394713943876441,0.0,20.0
19194,1,9194,[127 187 483 302 211],210,5,40410,4.394779771615008,20.0,20.0
19195,1,9195,[127 187 483 302 211],6,5,40415,4.394845585036973,20.0,20.0
19196,1,9196,[127 187 483 302 211],474,5,40420,4.394911384147004,20.0,20.0
19197,1,9197,[216 174 286 200 655],479,3,40423,4.394759730376169,0.0,20.0
19198,1,9198,[742  98 276 275  97],533,3,40426,4.394608109577128,0.0,20.0
19199,1,9199,[127 187 483 302 211],339,5,40431,4.394673913043478,20.0,20.0
19200,1,9200,[127 187 483 302 211],339,5,40436,4.394739702206282,20.0,20.0
19201,1,9201,[200 144  98 237 234],666,2,40438,4.394479460986742,0.0,20.0
19202,1,9202,[127 187 483 302 211],524,5,40443,4.394545256981419,20.0,20.0
19203,1,9203,[127 187 483 302 211],210,5,40448,4.3946110386788355,20.0,20.0
19204,1,9204,[151 180 273 471 197],537,2,40450,4.394350896252037,0.0,0.0
19205,1,9205,[127 187 483 302 211],666,5,40455,4.3944166847708015,20.0,20.0
19206,1,9206,[127 187 483 302 211],207,5,40460,4.3944824589985885,20.0,20.0
19207,1,9207,[483 174 181  22  97],194,3,40463,4.394331016507385,20.0,20.0
19208,1,9208,[ 82 121 183 187 125],59,4,40467,4.394288196329677,0.0,0.0
19209,1,9209,[127 187 483 302 211],343,5,40472,4.394353963083605,20.0,20.0
19210,1,9210,[127 187 483 302 211],207,5,40477,4.394419715557485,20.0,20.0
19211,1,9211,[127 187 483 302 211],666,5,40482,4.39448545375597,20.0,20.0
19212,1,9212,[423 471 181  28 269],666,2,40484,4.394225550852057,0.0,0.0
19213,1,9213,[127 187 483 302 211],339,5,40489,4.394291295854135,20.0,20.0
19214,1,9214,[127 187 483 302 211],328,5,40494,4.394357026587087,20.0,20.0
19215,1,9215,[127 187 483 302 211],343,5,40499,4.394422743055555,20.0,20.0
19216,1,9216,[127 187 483 302 211],328,5,40504,4.3944884452641855,20.0,20.0
19217,1,9217,[127 187 483 302 211],537,5,40509,4.394554133217618,20.0,20.0
19218,1,9218,[435 288 423  79 135],666,2,40511,4.394294392016488,0.0,0.0
19219,1,9219,[127 187 483 302 211],207,5,40516,4.394360086767896,20.0,20.0
19220,1,9220,[ 97 265  50  82  64],339,4,40520,4.394317319162781,0.0,20.0
19221,1,9221,[289 515 483 228 275],13,2,40522,4.394057688137064,20.0,0.0
19222,1,9222,[211   1  22 100  98],650,3,40525,4.393906538002819,0.0,40.0
19223,1,9223,[127 187 483 302 211],666,5,40530,4.393972246313964,20.0,20.0
19224,1,9224,[127 187 483 302 211],537,5,40535,4.394037940379404,20.0,20.0
19225,1,9225,[127 187 483 302 211],6,5,40540,4.394103620203772,20.0,20.0
19226,1,9226,[127 187 483 302 211],343,5,40545,4.3941692857916985,20.0,20.0
19227,1,9227,[180 508 471  12 286],207,1,40546,4.393801473775466,20.0,0.0
19228,1,9228,[127 187 483 302 211],474,5,40551,4.3938671578719255,20.0,20.0
19229,1,9229,[196 174 515 357  28],263,4,40555,4.393824485373782,20.0,20.0
19230,1,9230,[127 187 483 302 211],474,5,40560,4.393890152746182,20.0,20.0
19231,1,9231,[127 187 483 302 211],90,5,40565,4.393955805892547,20.0,20.0
19232,1,9232,[143 153 237  28 125],92,3,40568,4.393804830499296,0.0,0.0
19233,1,9233,[127 187 483 302 211],328,5,40573,4.3938704786658,20.0,20.0
19234,1,9234,[ 96 127 174  28 191],406,4,40577,4.393827828911749,0.0,40.0
19235,1,9235,[ 15 185 100 127 215],749,4,40581,4.3937851883932435,0.0,40.0
19236,1,9236,[127 187 483 302 211],524,5,40586,4.393850817364945,20.0,20.0
19237,1,9237,[121 318 194 117 187],474,5,40591,4.393916432128166,20.0,0.0
19238,1,9238,[127 187 483 302 211],537,5,40596,4.3939820326875205,20.0,20.0
19239,1,9239,[127 187 483 302 211],207,5,40601,4.394047619047619,20.0,20.0
19240,1,9240,[127 187 483 302 211],343,5,40606,4.394113191213072,20.0,20.0
19241,1,9241,[127 187 483 302 211],666,5,40611,4.394178749188487,20.0,20.0
19242,1,9242,[ 82 121   7 117 234],840,2,40613,4.393919723033647,0.0,0.0
19243,1,9243,[127 187 483 302 211],328,5,40618,4.393985287754219,20.0,20.0
19244,1,9244,[127 187 483 302 211],13,5,40623,4.394050838290968,20.0,20.0
19245,1,9245,[127 187 483 302 211],90,5,40628,4.394116374648497,20.0,20.0
19246,1,9246,[127 187 483 302 211],6,5,40633,4.394181896831404,20.0,20.0
19247,1,9247,[127 187 483 302 211],666,5,40638,4.3942474048442905,20.0,20.0
19248,1,9248,[172  15  25 117 471],533,5,40643,4.394312898691751,0.0,0.0
19249,1,9249,[127 187 483 302 211],13,5,40648,4.394378378378378,20.0,20.0
19250,1,9250,[127 187 483 302 211],328,5,40653,4.394443843908767,20.0,20.0
19251,1,9251,[228 568  64 294 202],42,5,40658,4.394509295287506,0.0,0.0
19252,1,9252,[127 187 483 302 211],6,5,40663,4.394574732519183,20.0,20.0
19253,1,9253,[127 187 483 302 211],207,5,40668,4.394640155608386,20.0,20.0
19254,1,9254,[127   1  15 194 202],59,3,40671,4.3944894651539705,0.0,20.0
19255,1,9255,[127 187 483 302 211],339,5,40676,4.3945548833189285,20.0,20.0
19256,1,9256,[237 323 275 294  69],474,2,40678,4.394296208274819,0.0,0.0
19257,1,9257,[127 187 483 302 211],90,5,40683,4.394361633182113,20.0,20.0
19258,1,9258,[127 187 483 302 211],328,5,40688,4.394427043957231,20.0,20.0
19259,1,9259,[204 168 322 127 238],537,3,40691,4.394276457883369,0.0,20.0
19260,1,9260,[127 187 483 302 211],328,5,40696,4.394341863729619,20.0,20.0
19261,1,9261,[127 187 483 302 211],339,5,40701,4.3944072554523865,20.0,20.0
19262,1,9262,[127 187 483 302 211],13,5,40706,4.394472633056245,20.0,20.0
19263,1,9263,[172 289 173 515 180],392,5,40711,4.394537996545768,0.0,0.0
19264,1,9264,[173 403  50  25 385],234,1,40712,4.3941716135995685,0.0,20.0
19265,1,9265,[127 187 483 302 211],210,5,40717,4.3942369954673,20.0,20.0
19266,1,9266,[127 187 483 302 211],524,5,40722,4.3943023632243445,20.0,20.0
19267,1,9267,[127 187 483 302 211],13,5,40727,4.39436771687527,20.0,20.0
19268,1,9268,[127 187 483 302 211],474,5,40732,4.394433056424641,20.0,20.0
19269,1,9269,[127 187 483 302 211],474,5,40737,4.394498381877023,20.0,20.0
19270,1,9270,[127 187 483 302 211],6,5,40742,4.394563693236975,20.0,20.0
19271,1,9271,[183 100  89 496 546],87,4,40746,4.394521138912856,0.0,20.0
19272,1,9272,[235 195  69 143 144],313,3,40749,4.3943707538013586,0.0,0.0
19273,1,9273,[127 187 483 302 211],474,5,40754,4.394436057795989,20.0,20.0
19274,1,9274,[127 187 483 302 211],13,5,40759,4.394501347708895,20.0,20.0
19275,1,9275,[127 187 483 302 211],328,5,40764,4.394566623544631,20.0,20.0
19276,1,9276,[127 187 483 302 211],90,5,40769,4.39463188530775,20.0,20.0
19277,1,9277,[127 187 483 302 211],833,3,40772,4.394481569303729,20.0,20.0
19278,1,9278,[127 187 483 302 211],328,5,40777,4.3945468261666125,20.0,20.0
19279,1,9279,[127 187 483 302 211],343,5,40782,4.394612068965517,20.0,20.0
19280,1,9280,[127 187 483 302 211],339,5,40787,4.394677297704988,20.0,20.0
19281,1,9281,[258 196 269 403 423],650,2,40789,4.394419306184012,0.0,0.0
19282,1,9282,[127 187 483 302 211],339,5,40794,4.394484541635247,20.0,20.0
19283,1,9283,[127 187 483 302 211],6,5,40799,4.394549763033176,20.0,20.0
19284,1,9284,[187 174 200 176 228],13,3,40802,4.39439956919763,0.0,20.0
19285,1,9285,[ 56 182 194 403 228],749,3,40805,4.394249407710532,0.0,0.0
19286,1,9286,[127 187 483 302 211],537,5,40810,4.394314633358458,20.0,20.0
19287,1,9287,[127 187 483 302 211],328,5,40815,4.39437984496124,20.0,20.0
19288,1,9288,[182 313 269 195 234],64,5,40820,4.394445042523415,0.0,0.0
19289,1,9289,[234  25 195 271 313],650,3,40823,4.394294940796556,0.0,0.0
19290,1,9290,[127 187 483 302 211],474,5,40828,4.394360133462491,20.0,20.0
19291,1,9291,[127 187 483 302 211],13,5,40833,4.394425312096427,20.0,20.0
19292,1,9292,[127 187 483 302 211],6,5,40838,4.394490476702894,20.0,20.0
19293,1,9293,[222 135 121 318 172],92,4,40842,4.394448030987734,20.0,0.0
19294,1,9294,[127 187 483 302 211],6,5,40847,4.394513179128563,20.0,20.0
19295,1,9295,[127 187 483 302 211],537,5,40852,4.394578313253012,20.0,20.0
19296,1,9296,[127 187 483 302 211],524,5,40857,4.3946434333656015,20.0,20.0
19297,1,9297,[127 187 483 302 211],537,5,40862,4.394708539470854,20.0,20.0
19298,1,9298,[127 187 483 302 211],13,5,40867,4.394773631573288,20.0,20.0
19299,1,9299,[127 187 483 302 211],13,5,40872,4.394838709677419,20.0,20.0
19300,1,9300,[127 187 483 302 211],666,5,40877,4.394903773787765,20.0,20.0
19301,1,9301,[127 187 483 302 211],207,5,40882,4.394968823908837,20.0,20.0
19302,1,9302,[210 186  56  25 187],533,3,40885,4.3948188756315165,0.0,0.0
19303,1,9303,[176 234  15 333 258],488,5,40890,4.394883920894239,0.0,0.0
19304,1,9304,[127 187 483 302 211],474,5,40895,4.394948952176249,20.0,20.0
19305,1,9305,[127 187 483 302 211],13,5,40900,4.395013969482054,20.0,20.0
19306,1,9306,[127 187 483 302 211],328,5,40905,4.39507897281616,20.0,20.0
19307,1,9307,[282  79 313 180 132],653,3,40908,4.394929093253116,0.0,0.0
19308,1,9308,[127 187 483 302 211],210,5,40913,4.394994091739177,20.0,20.0
19309,1,9309,[127 187 483 302 211],666,5,40918,4.395059076262084,20.0,20.0
19310,1,9310,[127 187 483 302 211],474,5,40923,4.395124046826335,20.0,20.0
19311,1,9311,[127 187 483 302 211],666,5,40928,4.3951890034364265,20.0,20.0
19312,1,9312,[127 187 483 302 211],13,5,40933,4.395253946096854,20.0,20.0
19313,1,9313,[  1 211 328  22 655],234,1,40934,4.394889413785699,0.0,0.0
19314,1,9314,[127 187 483 302 211],474,5,40939,4.394954374664519,20.0,20.0
19315,1,9315,[385 655 238 215 151],474,4,40943,4.394911979390296,0.0,0.0
19316,1,9316,[ 79 234 135 275 132],64,5,40948,4.394976923902544,0.0,0.0
19317,1,9317,[127 187 483 302 211],339,5,40953,4.39504185447521,20.0,20.0
19318,1,9318,[127 187 483 302 211],207,5,40958,4.39510677111278,20.0,20.0
19319,1,9319,[127 187 483 302 211],339,5,40963,4.395171673819743,20.0,20.0
19320,1,9320,[127 187 483 302 211],339,5,40968,4.395236562600579,20.0,20.0
19321,1,9321,[ 97 515 153 301 187],184,2,40970,4.394979618107702,0.0,0.0
19322,1,9322,[127 187 483 302 211],537,5,40975,4.395044513568593,20.0,20.0
19323,1,9323,[127 187 483 302 211],524,5,40980,4.395109395109395,20.0,20.0
19324,1,9324,[127 187 483 302 211],90,5,40985,4.395174262734584,20.0,20.0
19325,1,9325,[187 144 117 135 258],788,4,40989,4.395131889341625,0.0,0.0
19326,1,9326,[127 187 483 302 211],90,5,40994,4.395196740645438,20.0,20.0
19327,1,9327,[176 183 172 483 168],95,3,40997,4.3950471698113205,20.0,0.0
19328,1,9328,[194 186 111 286 322],537,1,40998,4.39468324579269,0.0,0.0
19329,1,9329,[127 187 483 302 211],339,5,41003,4.394748124330118,20.0,20.0
19330,1,9330,[333 180 215  95 182],85,4,41007,4.394705819311971,0.0,0.0
19331,1,9331,[127 187 483 302 211],90,5,41012,4.394770681525932,20.0,20.0
19332,1,9332,[127 187 483 302 211],13,5,41017,4.394835529840352,20.0,20.0
19333,1,9333,[127 187 483 302 211],207,5,41022,4.394900364259696,20.0,20.0
19334,1,9334,[173 121 191 322  82],92,2,41024,4.394643813604714,0.0,0.0
19335,1,9335,[127 187 483 302 211],210,5,41029,4.394708654670095,20.0,20.0
19336,1,9336,[127 187 483 302 211],666,5,41034,4.394773481846418,20.0,20.0
19337,1,9337,[127 187 483 302 211],339,5,41039,4.394838295138145,20.0,20.0
19338,1,9338,[127 187 483 302 211],328,5,41044,4.394903094549738,20.0,20.0
19339,1,9339,[127 187 483 302 211],207,5,41049,4.3949678800856535,20.0,20.0
19340,1,9340,[127 187 483 302 211],90,5,41054,4.3950326517503475,20.0,20.0
19341,1,9341,[127 187 483 302 211],343,5,41059,4.395097409548277,20.0,20.0
19342,1,9342,[127 187 483 302 211],6,5,41064,4.395162153483891,20.0,20.0
19343,1,9343,[179 273 322 174 276],90,4,41068,4.395119863013699,0.0,20.0
19344,1,9344,[127 187 483 302 211],833,3,41071,4.3949705724986625,20.0,20.0
19345,1,9345,[127 187 483 302 211],328,5,41076,4.395035309223197,20.0,20.0
19346,1,9346,[127 187 483 302 211],328,5,41081,4.3951000320958595,20.0,20.0
19347,1,9347,[127 187 483 302 211],343,5,41086,4.3951647411210955,20.0,20.0
19348,1,9348,[127 187 483 302 211],207,5,41091,4.395229436303348,20.0,20.0
19349,1,9349,[127 187 483 302 211],666,5,41096,4.395294117647059,20.0,20.0
19350,1,9350,[127 187 483 302 211],833,3,41099,4.395144904288311,20.0,20.0
19351,1,9351,[127 187 483 302 211],537,5,41104,4.395209580838324,20.0,20.0
19352,1,9352,[195 357 423 508 172],387,4,41108,4.39516732599166,20.0,0.0
19353,1,9353,[127 187 483 302 211],666,5,41113,4.3952319863160145,20.0,20.0
19354,1,9354,[127 187 483 302 211],207,5,41118,4.395296632816676,20.0,20.0
19355,1,9355,[357  28 111   7 403],95,4,41122,4.395254382214621,20.0,0.0
19356,1,9356,[127 187 483 302 211],666,5,41127,4.395319012504007,20.0,20.0
19357,1,9357,[174 257 197 186   7],659,2,41129,4.3950630476597565,0.0,20.0
19358,1,9358,[127 187 483 302 211],328,5,41134,4.395127684581686,20.0,20.0
19359,1,9359,[127 187 483 302 211],207,5,41139,4.395192307692308,20.0,20.0
19360,1,9360,[127 187 483 302 211],6,5,41144,4.395256916996048,20.0,20.0
19361,1,9361,[127 187 483 302 211],833,3,41147,4.395107882930998,20.0,20.0
19362,1,9362,[ 79 515  70 180 196],892,5,41152,4.395172487450603,0.0,0.0
19363,1,9363,[127 187 483 302 211],339,5,41157,4.395237078171721,20.0,20.0
19364,1,9364,[127 187 483 302 211],13,5,41162,4.3953016550987725,20.0,20.0
19365,1,9365,[127 187 483 302 211],6,5,41167,4.395366218236173,20.0,20.0
19366,1,9366,[127 187 483 302 211],6,5,41172,4.395430767588342,20.0,20.0
19367,1,9367,[ 50  88 100 194 183],398,4,41176,4.39538855678907,0.0,40.0
19368,1,9368,[127 187 483 302 211],524,5,41181,4.395453089977585,20.0,20.0
19369,1,9369,[127 187 483 302 211],328,5,41186,4.395517609391676,20.0,20.0
19370,1,9370,[127 187 483 302 211],210,5,41191,4.395582115035749,20.0,20.0
19371,1,9371,[127 187 483 302 211],90,5,41196,4.395646606914212,20.0,20.0
19372,1,9372,[603  95 328 210 151],804,3,41199,4.395497706177318,20.0,0.0
19373,1,9373,[127 187 483 302 211],207,5,41204,4.395562193300619,20.0,20.0
19374,1,9374,[127 187 483 302 211],207,5,41209,4.395626666666667,20.0,20.0
19375,1,9375,[127 187 483 302 211],343,5,41214,4.395691126279863,20.0,20.0
19376,1,9376,[127 187 483 302 211],90,5,41219,4.395755572144609,20.0,20.0
19377,1,9377,[127 187 483 302 211],474,5,41224,4.3958200042653015,20.0,20.0
19378,1,9378,[127 187 483 302 211],474,5,41229,4.395884422646337,20.0,20.0
19379,1,9379,[196   7 151   1 175],738,5,41234,4.395948827292111,0.0,0.0
19380,1,9380,[127 187 483 302 211],524,5,41239,4.396013218207014,20.0,20.0
19381,1,9381,[216 175 135 174  22],543,3,41242,4.3958644212321465,0.0,20.0
19382,1,9382,[127 187 483 302 211],833,3,41245,4.395715655973569,20.0,20.0
19383,1,9383,[496 508 176  22 196],59,5,41250,4.395780051150895,0.0,0.0
19384,1,9384,[202 182  82 168 176],897,3,41253,4.395631326584976,0.0,0.0
19385,1,9385,[127 187 483 302 211],537,5,41258,4.395695717025357,20.0,20.0
19386,1,9386,[127 187 483 302 211],90,5,41263,4.395760093746671,20.0,20.0
19387,1,9387,[127 187 483 302 211],524,5,41268,4.395824456753302,20.0,20.0
19388,1,9388,[127 187 483 302 211],666,5,41273,4.395888806049633,20.0,20.0
19389,1,9389,[127 187 483 302 211],328,5,41278,4.395953141640042,20.0,20.0
19390,1,9390,[483 496 121 294 211],538,3,41281,4.395804493664147,20.0,0.0
19391,1,9391,[127 187 483 302 211],666,5,41286,4.395868824531516,20.0,20.0
19392,1,9392,[127 187 483 302 211],343,5,41291,4.395933141701267,20.0,20.0
19393,1,9393,[127 187 483 302 211],207,5,41296,4.395997445177773,20.0,20.0
19394,1,9394,[127 187 483 302 211],13,5,41301,4.396061734965407,20.0,20.0
19395,1,9395,[127 187 483 302 211],328,5,41306,4.39612601106854,20.0,20.0
19396,1,9396,[127 187 483 302 211],6,5,41311,4.3961902734915395,20.0,20.0
19397,1,9397,[127 187 483 302 211],343,5,41316,4.396254522238774,20.0,20.0
19398,1,9398,[546 176 245 435 328],533,2,41318,4.395999574422811,0.0,0.0
19399,1,9399,[127 187 483 302 211],210,5,41323,4.396063829787234,20.0,20.0
19400,1,9400,[  4 194 435 182 161],524,5,41328,4.396128071481757,0.0,0.0
19401,1,9401,[427 603 210 194 174],271,5,41333,4.3961922995107425,20.0,20.0
19402,1,9402,[300   8  11 678 603],13,2,41335,4.3959374667659254,20.0,0.0
19403,1,9403,[127 187 483 302 211],13,5,41340,4.396001701403658,20.0,20.0
19404,1,9404,[127 187 483 302 211],13,5,41345,4.396065922381712,20.0,20.0
19405,1,9405,[118 294  15 588 222],194,3,41348,4.395917499468425,0.0,0.0
19406,1,9406,[127 187 483 302 211],210,5,41353,4.395981715743595,20.0,20.0
19407,1,9407,[127 187 483 302 211],339,5,41358,4.396045918367347,20.0,20.0
19408,1,9408,[127 187 483 302 211],6,5,41363,4.3961101073440325,20.0,20.0
19409,1,9409,[127 187 483 302 211],328,5,41368,4.396174282678002,20.0,20.0
19410,1,9410,[127 187 483 302 211],666,5,41373,4.396238444373606,20.0,20.0
19411,1,9411,[127 187 483 302 211],13,5,41378,4.396302592435189,20.0,20.0
19412,1,9412,[127 187 483 302 211],666,5,41383,4.3963667268670985,20.0,20.0
19413,1,9413,[127 187 483 302 211],343,5,41388,4.3964308476736775,20.0,20.0
19414,1,9414,[127 187 483 302 211],207,5,41393,4.396494954859267,20.0,20.0
19415,1,9415,[151  22 161  28  89],479,4,41397,4.396452846219201,0.0,0.0
19416,1,9416,[127 187 483 302 211],328,5,41402,4.3965169374535416,20.0,20.0
19417,1,9417,[127 187 483 302 211],474,5,41407,4.396581015077511,20.0,20.0
19418,1,9418,[168  28  22  11  70],82,3,41410,4.396432742329334,0.0,0.0
19419,1,9419,[127 187 483 302 211],833,3,41413,4.396284501061571,20.0,20.0
19420,1,9420,[118 172  88 222  64],290,5,41418,4.396348582952977,0.0,0.0
19421,1,9421,[127 187 483 302 211],524,5,41423,4.396412651241775,20.0,20.0
19422,1,9422,[127 187 483 302 211],328,5,41428,4.396476705932293,20.0,20.0
19423,1,9423,[ 95 357 200 313 117],13,2,41430,4.3962224108658745,20.0,0.0
19424,1,9424,[127 187 483 302 211],210,5,41435,4.3962864721485415,20.0,20.0
19425,1,9425,[127 187 483 302 211],328,5,41440,4.396350519838744,20.0,20.0
19426,1,9426,[127 187 483 302 211],474,5,41445,4.396414553940808,20.0,20.0
19427,1,9427,[235  69 423 273 172],774,1,41446,4.396054306321595,0.0,0.0
19428,1,9428,[215 258 172 385  79],650,2,41448,4.395800190900413,0.0,0.0
19429,1,9429,[127 187 483 302 211],6,5,41453,4.395864262990456,20.0,20.0
19430,1,9430,[151 265 294 748 125],200,3,41456,4.39571625490404,0.0,0.0
19431,1,9431,[127 187 483 302 211],343,5,41461,4.39578032230704,20.0,20.0
19432,1,9432,[127 187 483 302 211],90,5,41466,4.395844376126365,20.0,20.0
19433,1,9433,[127 187 483 302 211],6,5,41471,4.395908416366335,20.0,20.0
19434,1,9434,[127 187 483 302 211],90,5,41476,4.395972443031266,20.0,20.0
19435,1,9435,[ 96  98 179 144  97],458,3,41479,4.395824501907588,0.0,20.0
19436,1,9436,[127 187 483 302 211],833,3,41482,4.395676592137332,20.0,20.0
19437,1,9437,[282 151   9 275 678],334,4,41486,4.395634668361941,0.0,0.0
19438,1,9438,[181 289 191 276 286],232,4,41490,4.395592753469647,0.0,0.0
19439,1,9439,[127 187 483 302 211],474,5,41495,4.395656779661017,20.0,20.0
19440,1,9440,[127 187 483 302 211],6,5,41500,4.3957207922889525,20.0,20.0
19441,1,9441,[127 187 483 302 211],328,5,41505,4.395784791357763,20.0,20.0
19442,1,9442,[127 187 483 302 211],343,5,41510,4.395848776871757,20.0,20.0
19443,1,9443,[127 187 483 302 211],13,5,41515,4.395912748835239,20.0,20.0
19444,1,9444,[282   8 273 195   4],207,3,41518,4.3957649550026465,0.0,0.0
19445,1,9445,[127 187 483 302 211],524,5,41523,4.395828922295151,20.0,20.0
19446,1,9446,[127 187 483 302 211],474,5,41528,4.3958928760453055,20.0,20.0
19447,1,9447,[175 211 202  22 187],749,3,41531,4.395745131244708,0.0,0.0
19448,1,9448,[127 187 483 302 211],207,5,41536,4.395809080325961,20.0,20.0
19449,1,9449,[127 187 483 302 211],474,5,41541,4.395873015873016,20.0,20.0
19450,1,9450,[385   7  22 200 176],328,4,41545,4.39583112898106,0.0,0.0
19451,1,9451,[475  79 258 471 273],207,3,41548,4.39568345323741,0.0,0.0
19452,1,9452,[127 187 483 302 211],328,5,41553,4.39574738178356,20.0,20.0
19453,1,9453,[127 187 483 302 211],537,5,41558,4.395811296805585,20.0,20.0
19454,1,9454,[127 187 483 302 211],524,5,41563,4.395875198307774,20.0,20.0
19455,1,9455,[127 187 483 302 211],343,5,41568,4.395939086294416,20.0,20.0
19456,1,9456,[127 187 483 302 211],6,5,41573,4.3960029607698,20.0,20.0
19457,1,9457,[313 322 222 204  64],119,5,41578,4.396066821738211,0.0,0.0
19458,1,9458,[127 187 483 302 211],833,3,41581,4.395919230362618,20.0,20.0
19459,1,9459,[127 187 483 302 211],537,5,41586,4.395983086680761,20.0,20.0
19460,1,9460,[127 187 483 302 211],343,5,41591,4.396046929500053,20.0,20.0
19461,1,9461,[127 187 483 302 211],6,5,41596,4.396110758824773,20.0,20.0
19462,1,9462,[ 64  70 357   1 496],804,5,41601,4.396174574659199,20.0,0.0
19463,1,9463,[127 187 483 302 211],343,5,41606,4.396238377007608,20.0,20.0
19464,1,9464,[216 238 111  64 125],899,3,41609,4.39609086106709,0.0,0.0
19465,1,9465,[127 187 483 302 211],339,5,41614,4.396154658778787,20.0,20.0
19466,1,9466,[127 187 483 302 211],537,5,41619,4.39621844301257,20.0,20.0
19467,1,9467,[127 187 483 302 211],666,5,41624,4.396282213772708,20.0,20.0
19468,1,9468,[127 187 483 302 211],833,3,41627,4.396134755518006,20.0,20.0
19469,1,9469,[127 187 483 302 211],537,5,41632,4.396198521647308,20.0,20.0
19470,1,9470,[127 187 483 302 211],90,5,41637,4.396262274311055,20.0,20.0
19471,1,9471,[127 187 483 302 211],343,5,41642,4.396326013513513,20.0,20.0
19472,1,9472,[127 187 483 302 211],207,5,41647,4.396389739258947,20.0,20.0
19473,1,9473,[127 187 483 302 211],339,5,41652,4.396453451551615,20.0,20.0
19474,1,9474,[127 187 483 302 211],343,5,41657,4.396517150395779,20.0,20.0
19475,1,9475,[173 234 121 215  82],804,5,41662,4.396580835795694,0.0,0.0
19476,1,9476,[127 187 483 302 211],833,3,41665,4.396433470507545,20.0,20.0
19477,1,9477,[127 187 483 302 211],537,5,41670,4.396497151297742,20.0,20.0
19478,1,9478,[127 187 483 302 211],343,5,41675,4.396560818651756,20.0,20.0
19479,1,9479,[135 175  95 471 678],92,3,41678,4.396413502109705,0.0,0.0
19480,1,9480,[588 289  11 288 216],378,3,41681,4.396266216643814,0.0,0.0
19481,1,9481,[127 187 483 302 211],474,5,41686,4.396329888209238,20.0,20.0
19482,1,9482,[127 187 483 302 211],666,5,41691,4.396393546346093,20.0,20.0
19483,1,9483,[127 187 483 302 211],537,5,41696,4.396457191058625,20.0,20.0
19484,1,9484,[127 187 483 302 211],524,5,41701,4.39652082235108,20.0,20.0
19485,1,9485,[127 187 483 302 211],90,5,41706,4.396584440227704,20.0,20.0
19486,1,9486,[127 187 483 302 211],524,5,41711,4.396648044692737,20.0,20.0
19487,1,9487,[ 95  79 546  98  64],64,4,41715,4.396606239460371,0.0,20.0
19488,1,9488,[127 187 483 302 211],524,5,41720,4.396669828222152,20.0,20.0
19489,1,9489,[127 187 483 302 211],210,5,41725,4.396733403582719,20.0,20.0
19490,1,9490,[127 187 483 302 211],474,5,41730,4.396796965546307,20.0,20.0
19491,1,9491,[127 187 483 302 211],343,5,41735,4.396860514117151,20.0,20.0
19492,1,9492,[127 187 483 302 211],328,5,41740,4.396924049299484,20.0,20.0
19493,1,9493,[127 187 483 302 211],210,5,41745,4.396987571097536,20.0,20.0
19494,1,9494,[127 187 483 302 211],524,5,41750,4.397051079515535,20.0,20.0
19495,1,9495,[127 187 483 302 211],666,5,41755,4.397114574557708,20.0,20.0
19496,1,9496,[127 187 483 302 211],339,5,41760,4.397178056228283,20.0,20.0
19497,1,9497,[161 135  12 471 742],308,3,41763,4.397030953885029,20.0,0.0
19498,1,9498,[200  22 197  71   8],13,4,41767,4.396989156753342,0.0,0.0
19499,1,9499,[187  69 215   1  70],308,3,41770,4.396842105263158,0.0,0.0
19500,1,9500,[127 187 483 302 211],328,5,41775,4.396905588885381,20.0,20.0
19501,1,9501,[153 196 546  89 222],13,3,41778,4.396758577141655,0.0,0.0
19502,1,9502,[127 187 483 302 211],6,5,41783,4.396822056192781,20.0,20.0
19503,1,9503,[127 187 483 302 211],474,5,41788,4.396885521885522,20.0,20.0
19504,1,9504,[127 187 483 302 211],666,5,41793,4.396948974224093,20.0,20.0
19505,1,9505,[ 95 161 168   4 235],64,3,41796,4.396802019776983,0.0,0.0
19506,1,9506,[257 180  15 173 328],479,4,41800,4.396760281897549,0.0,0.0
19507,1,9507,[127 187 483 302 211],666,5,41805,4.3968237273874635,20.0,20.0
19508,1,9508,[127 187 483 302 211],666,5,41810,4.396887159533074,20.0,20.0
19509,1,9509,[127 187 483 302 211],210,5,41815,4.396950578338591,20.0,20.0
19510,1,9510,[127 187 483 302 211],207,5,41820,4.397013983808222,20.0,20.0
19511,1,9511,[127 187 483 302 211],833,3,41823,4.396867115222876,20.0,20.0
19512,1,9512,[127 187 483 302 211],207,5,41828,4.396930516135814,20.0,20.0
19513,1,9513,[127 187 483 302 211],474,5,41833,4.3969939037208325,20.0,20.0
19514,1,9514,[127 187 483 302 211],328,5,41838,4.3970572779821335,20.0,20.0
19515,1,9515,[ 50 515  98 496 174],64,5,41843,4.3971206389239175,0.0,60.0
19516,1,9516,[127 187 483 302 211],339,5,41848,4.397183986550384,20.0,20.0
19517,1,9517,[127 187 483 302 211],210,5,41853,4.397247320865728,20.0,20.0
19518,1,9518,[294 471 435 196 197],144,5,41858,4.397310641874147,0.0,0.0
19519,1,9519,[200   8 143 496 161],234,3,41861,4.397163865546219,0.0,0.0
19520,1,9520,[127 187 483 302 211],90,5,41866,4.397227182018695,20.0,20.0
19521,1,9521,[127 187 483 302 211],537,5,41871,4.397290485192187,20.0,20.0
19522,1,9522,[127 187 483 302 211],328,5,41876,4.397353775070881,20.0,20.0
19523,1,9523,[127 187 483 302 211],207,5,41881,4.397417051658967,20.0,20.0
19524,1,9524,[127 187 483 302 211],343,5,41886,4.39748031496063,20.0,20.0
19525,1,9525,[127 187 483 302 211],339,5,41891,4.3975435649800545,20.0,20.0
19526,1,9526,[127 187 483 302 211],537,5,41896,4.397606801721423,20.0,20.0
19527,1,9527,[127 187 483 302 211],474,5,41901,4.3976700251889165,20.0,20.0
19528,1,9528,[318 385 258 195  56],85,3,41904,4.397523349774373,20.0,0.0
19529,1,9529,[127 187 483 302 211],524,5,41909,4.3975865687303255,20.0,20.0
19530,1,9530,[127 187 483 302 211],13,5,41914,4.397649774420312,20.0,20.0
19531,1,9531,[121  50 168 237 403],653,2,41916,4.397398237515737,0.0,20.0
19532,1,9532,[475 286 678 655 181],213,4,41920,4.397356550928354,0.0,0.0
19533,1,9533,[117 546   7 268  89],92,4,41924,4.397314873085798,0.0,0.0
19534,1,9534,[127 187 483 302 211],833,3,41927,4.397168327215522,20.0,20.0
19535,1,9535,[288 172 182   1   4],374,3,41930,4.397021812080537,0.0,0.0
19536,1,9536,[ 82 202 435 265 568],804,4,41934,4.396980182447311,0.0,0.0
19537,1,9537,[127 187 483 302 211],339,5,41939,4.397043405326064,20.0,20.0
19538,1,9538,[127 187 483 302 211],524,5,41944,4.3971066149491564,20.0,20.0
19539,1,9539,[127 187 483 302 211],339,5,41949,4.3971698113207545,20.0,20.0
19540,1,9540,[127 187 483 302 211],833,3,41952,4.3970233728120744,20.0,20.0
19541,1,9541,[127 187 483 302 211],13,5,41957,4.397086564661497,20.0,20.0
19542,1,9542,[127 187 483 302 211],339,5,41962,4.397149743267317,20.0,20.0
19543,1,9543,[127 187 483 302 211],537,5,41967,4.397212908633697,20.0,20.0
19544,1,9544,[273 496 174 204  97],897,4,41971,4.3971712938711365,0.0,20.0
19545,1,9545,[204 603 185 118 483],189,4,41975,4.397129687827363,40.0,0.0
19546,1,9546,[435  56 508 405 100],833,3,41978,4.396983345553577,0.0,20.0
19547,1,9547,[172 234 301  95 269],378,4,41982,4.39694176790951,0.0,0.0
19548,1,9548,[127 187 483 302 211],343,5,41987,4.39700492198136,20.0,20.0
19549,1,9549,[127 187 483 302 211],207,5,41992,4.397068062827225,20.0,20.0
19550,1,9550,[182 403 127 234 204],313,4,41996,4.39702648937284,0.0,20.0
19551,1,9551,[127 187 483 302 211],6,5,42001,4.397089614740368,20.0,20.0
19552,1,9552,[127 187 483 302 211],13,5,42006,4.397152726892076,20.0,20.0
19553,1,9553,[ 69 211  28 655 423],788,4,42010,4.397111157630312,0.0,0.0
19554,1,9554,[127 187 483 302 211],833,3,42013,4.396964939822083,20.0,20.0
19555,1,9555,[127 187 483 302 211],90,5,42018,4.3970280452071995,20.0,20.0
19556,1,9556,[127 187 483 302 211],207,5,42023,4.397091137386209,20.0,20.0
19557,1,9557,[127 187 483 302 211],537,5,42028,4.397154216363256,20.0,20.0
19558,1,9558,[182 194 357 496 216],215,4,42032,4.397112668689194,20.0,0.0
19559,1,9559,[238 173  95 185 125],648,2,42034,4.396861924686193,0.0,0.0
19560,1,9560,[125 282   4  95 215],378,3,42037,4.396715824704529,0.0,0.0
19561,1,9561,[127 187 483 302 211],666,5,42042,4.396778916544656,20.0,20.0
19562,1,9562,[127 187 483 302 211],13,5,42047,4.396841995189794,20.0,20.0
19563,1,9563,[127 187 483 302 211],537,5,42052,4.396905060644082,20.0,20.0
19564,1,9564,[127 187 483 302 211],328,5,42057,4.396968112911657,20.0,20.0
19565,1,9565,[238 655 200 121 515],308,3,42060,4.396822078193602,0.0,0.0
19566,1,9566,[111 508 176 318 302],605,4,42064,4.3967805999790945,20.0,0.0
19567,1,9567,[127 187 483 302 211],833,3,42067,4.396634615384615,20.0,20.0
19568,1,9568,[127 187 483 302 211],474,5,42072,4.396697669557947,20.0,20.0
19569,1,9569,[127 187 483 302 211],524,5,42077,4.396760710553814,20.0,20.0
19570,1,9570,[151 238  97 403 294],479,2,42079,4.39651029150559,0.0,0.0
19571,1,9571,[ 98 423 117 294 211],774,1,42080,4.3961554534057665,0.0,20.0
19572,1,9572,[180 403 300  50  95],479,3,42083,4.396009610362478,0.0,20.0
19573,1,9573,[127 187 483 302 211],207,5,42088,4.396072696887403,20.0,20.0
19574,1,9574,[127 187 483 302 211],90,5,42093,4.396135770234987,20.0,20.0
19575,1,9575,[127 187 483 302 211],537,5,42098,4.396198830409356,20.0,20.0
19576,1,9576,[475 322 282 294 196],119,4,42102,4.396157460582646,0.0,0.0
19577,1,9577,[385  56  12 173 176],64,5,42107,4.3962205053247025,20.0,0.0
19578,1,9578,[127 187 483 302 211],13,5,42112,4.396283536903644,20.0,20.0
19579,1,9579,[127 187 483 302 211],328,5,42117,4.396346555323591,20.0,20.0
19580,1,9580,[127 187 483 302 211],666,5,42122,4.3964095605886655,20.0,20.0
19581,1,9581,[127 187 483 302 211],537,5,42127,4.396472552702985,20.0,20.0
19582,1,9582,[127 187 483 302 211],90,5,42132,4.396535531670667,20.0,20.0
19583,1,9583,[100 183 313  11 235],308,3,42135,4.396389816360601,0.0,20.0
19584,1,9584,[678  64 235 183  97],804,5,42140,4.396452790818988,0.0,0.0
19585,1,9585,[127 187 483 302 211],833,3,42143,4.39630711454204,20.0,20.0
19586,1,9586,[127 187 483 302 211],666,5,42148,4.396370084489413,20.0,20.0
19587,1,9587,[127 187 483 302 211],13,5,42153,4.396433041301627,20.0,20.0
19588,1,9588,[234   8  97   9 200],881,1,42154,4.396078840337887,0.0,0.0
19589,1,9589,[127 187 483 302 211],833,3,42157,4.395933263816476,20.0,20.0
19590,1,9590,[127 187 483 302 211],210,5,42162,4.395996246481076,20.0,20.0
19591,1,9591,[127 187 483 302 211],833,3,42165,4.395850708924104,20.0,20.0
19592,1,9592,[127 187 483 302 211],474,5,42170,4.395913687063484,20.0,20.0
19593,1,9593,[127 187 483 302 211],666,5,42175,4.395976652074213,20.0,20.0
19594,1,9594,[282 235 210  95 186],271,3,42178,4.395831162063574,0.0,0.0
19595,1,9595,[127 187 483 302 211],13,5,42183,4.395894122551063,20.0,20.0
19596,1,9596,[286 100 322 121 328],486,1,42184,4.39554027300198,0.0,20.0
19597,1,9597,[127 187 483 302 211],537,5,42189,4.395603250677224,20.0,20.0
19598,1,9598,[127 187 483 302 211],328,5,42194,4.3956662152307535,20.0,20.0
19599,1,9599,[127 187 483 302 211],474,5,42199,4.3957291666666665,20.0,20.0
19600,1,9600,[194 173 127 423  50],13,4,42203,4.395687949171961,0.0,40.0
19601,1,9601,[127 187 483 302 211],343,5,42208,4.3957508852322436,20.0,20.0
19602,1,9602,[127 187 483 302 211],13,5,42213,4.3958138081849425,20.0,20.0
19603,1,9603,[127 187 483 302 211],339,5,42218,4.3958767180341525,20.0,20.0
19604,1,9604,[546 222 318 423 234],524,4,42222,4.39583550234253,20.0,0.0
19605,1,9605,[127 187 483 302 211],90,5,42227,4.395898396835311,20.0,20.0
19606,1,9606,[127 187 483 302 211],13,5,42232,4.395961278234621,20.0,20.0
19607,1,9607,[127 187 483 302 211],343,5,42237,4.396024146544546,20.0,20.0
19608,1,9608,[127 187 483 302 211],833,3,42240,4.395878863565407,20.0,20.0
19609,1,9609,[127 187 483 302 211],537,5,42245,4.395941727367326,20.0,20.0
19610,1,9610,[127 187 483 302 211],833,3,42248,4.395796483196338,20.0,20.0
19611,1,9611,[127 187 483 302 211],13,5,42253,4.395859342488556,20.0,20.0
19612,1,9612,[127 187 483 302 211],537,5,42258,4.395922188702798,20.0,20.0
19613,1,9613,[127 187 483 302 211],13,5,42263,4.3959850218431455,20.0,20.0
19614,1,9614,[127 187 483 302 211],328,5,42268,4.396047841913677,20.0,20.0
19615,1,9615,[127 187 483 302 211],343,5,42273,4.396110648918469,20.0,20.0
19616,1,9616,[127 187 483 302 211],666,5,42278,4.396173442861599,20.0,20.0
19617,1,9617,[127 187 483 302 211],666,5,42283,4.396236223747141,20.0,20.0
19618,1,9618,[127 187 483 302 211],833,3,42286,4.396091069757771,20.0,20.0
19619,1,9619,[127 187 483 302 211],207,5,42291,4.3961538461538465,20.0,20.0
19620,1,9620,[127 187 483 302 211],328,5,42296,4.396216609500052,20.0,20.0
19621,1,9621,[ 56 276 357  22 111],234,2,42298,4.395967574308876,20.0,0.0
19622,1,9622,[257  79 282  50  12],447,3,42301,4.39582250857321,20.0,20.0
19623,1,9623,[127 187 483 302 211],328,5,42306,4.3958852867830425,20.0,20.0
19624,1,9624,[127 187 483 302 211],13,5,42311,4.395948051948052,20.0,20.0
19625,1,9625,[127 187 483 302 211],474,5,42316,4.396010804072304,20.0,20.0
19626,1,9626,[127 187 483 302 211],474,5,42321,4.396073543159863,20.0,20.0
19627,1,9627,[127 187 483 302 211],537,5,42326,4.39613626921479,20.0,20.0
19628,1,9628,[127 187 483 302 211],207,5,42331,4.396198982241146,20.0,20.0
19629,1,9629,[127 187 483 302 211],343,5,42336,4.396261682242991,20.0,20.0
19630,1,9630,[ 97 194 385   4 215],653,1,42337,4.39590904371301,0.0,0.0
19631,1,9631,[210 322 405 216 183],804,5,42342,4.395971760797342,0.0,0.0
19632,1,9632,[215 235 655  56 294],328,2,42344,4.395723035399149,0.0,0.0
19633,1,9633,[127 187 483 302 211],90,5,42349,4.395785758771019,20.0,20.0
19634,1,9634,[127 187 483 302 211],210,5,42354,4.395848469122989,20.0,20.0
19635,1,9635,[127 187 483 302 211],833,3,42357,4.395703611457036,20.0,20.0
19636,1,9636,[127 187 483 302 211],90,5,42362,4.395766317318667,20.0,20.0
19637,1,9637,[127 187 483 302 211],666,5,42367,4.395829010168085,20.0,20.0
19638,1,9638,[568 183 313 135  98],738,4,42371,4.3957879448075525,0.0,20.0
19639,1,9639,[496 222 435 313 100],537,3,42374,4.395643153526971,0.0,20.0
19640,1,9640,[127 187 483 302 211],339,5,42379,4.395705839643191,20.0,20.0
19641,1,9641,[127 187 483 302 211],343,5,42384,4.39576851275669,20.0,20.0
19642,1,9642,[127 187 483 302 211],13,5,42389,4.395831172871513,20.0,20.0
19643,1,9643,[127 187 483 302 211],328,5,42394,4.395893819991705,20.0,20.0
19644,1,9644,[127 187 483 302 211],328,5,42399,4.395956454121307,20.0,20.0
19645,1,9645,[127 187 483 302 211],524,5,42404,4.396019075264358,20.0,20.0
19646,1,9646,[127 187 483 302 211],474,5,42409,4.396081683424899,20.0,20.0
19647,1,9647,[568 496 275 238 588],899,3,42412,4.3959369817578775,0.0,0.0
19648,1,9648,[127 187 483 302 211],537,5,42417,4.395999585449269,20.0,20.0
19649,1,9649,[127 187 483 302 211],6,5,42422,4.396062176165803,20.0,20.0
19650,1,9650,[127 187 483 302 211],6,5,42427,4.396124753911511,20.0,20.0
19651,1,9651,[423 318 496 234 273],7,4,42431,4.396083713220058,20.0,0.0
19652,1,9652,[175 238  89   1 258],313,4,42435,4.396042681031804,0.0,0.0
19653,1,9653,[127 187 483 302 211],537,5,42440,4.396105241350735,20.0,20.0
19654,1,9654,[127 187 483 302 211],537,5,42445,4.396167788710513,20.0,20.0
19655,1,9655,[173  25 191 235 175],650,3,42448,4.396023198011599,0.0,0.0
19656,1,9656,[127 187 483 302 211],537,5,42453,4.396085740913327,20.0,20.0
19657,1,9657,[127 187 483 302 211],524,5,42458,4.396148270863533,20.0,20.0
19658,1,9658,[127 187 483 302 211],210,5,42463,4.396210787866239,20.0,20.0
19659,1,9659,[127 187 483 302 211],210,5,42468,4.396273291925466,20.0,20.0
19660,1,9660,[127 187 483 302 211],207,5,42473,4.396335783045234,20.0,20.0
19661,1,9661,[127 187 483 302 211],207,5,42478,4.396398261229559,20.0,20.0
19662,1,9662,[132 143 546 403 222],339,4,42482,4.396357238952707,0.0,0.0
19663,1,9663,[328 100 196 475 423],533,4,42486,4.396316225165563,0.0,20.0
19664,1,9664,[273 568 210 204 127],7,4,42490,4.396275219865494,0.0,20.0
19665,1,9665,[127 187 483 302 211],474,5,42495,4.396337678460584,20.0,20.0
19666,1,9666,[127 187 483 302 211],6,5,42500,4.396400124133651,20.0,20.0
19667,1,9667,[597  50 176 197 191],833,1,42501,4.396048820852296,0.0,20.0
19668,1,9668,[127 187 483 302 211],6,5,42506,4.396111283483297,20.0,20.0
19669,1,9669,[127 187 483 302 211],210,5,42511,4.39617373319545,20.0,20.0
19670,1,9670,[127 187 483 302 211],6,5,42516,4.396236169992762,20.0,20.0
19671,1,9671,[127 187 483 302 211],524,5,42521,4.396298593879239,20.0,20.0
19672,1,9672,[127 187 483 302 211],90,5,42526,4.3963610048588855,20.0,20.0
19673,1,9673,[276   7  70  98 515],59,4,42530,4.3963200330783545,0.0,20.0
19674,1,9674,[127 187 483 302 211],537,5,42535,4.396382428940568,20.0,20.0
19675,1,9675,[127 187 483 302 211],6,5,42540,4.396444811905746,20.0,20.0
19676,1,9676,[127 187 483 302 211],474,5,42545,4.396507181977886,20.0,20.0
19677,1,9677,[257 286   7 161 132],650,2,42547,4.396259557759867,0.0,0.0
19678,1,9678,[127 187 483 302 211],474,5,42552,4.396321934084099,20.0,20.0
19679,1,9679,[127 187 483 302 211],90,5,42557,4.396384297520661,20.0,20.0
19680,1,9680,[127 187 483 302 211],90,5,42562,4.396446648073546,20.0,20.0
19681,1,9681,[286 471 546  69 179],271,3,42565,4.396302416856021,0.0,0.0
19682,1,9682,[127 187 483 302 211],833,3,42568,4.396158215429103,20.0,20.0
19683,1,9683,[294  50  28 127 269],537,2,42570,4.395910780669145,0.0,40.0
19684,1,9684,[427 175   7 269 515],13,2,42572,4.395663397005679,0.0,0.0
19685,1,9685,[ 11  56 180  82 176],7,2,42574,4.395416064422879,0.0,0.0
19686,1,9686,[127 187 483 302 211],833,3,42577,4.395272014039434,20.0,20.0
19687,1,9687,[127 187 483 302 211],328,5,42582,4.395334434351775,20.0,20.0
19688,1,9688,[127 187 483 302 211],474,5,42587,4.395396841779338,20.0,20.0
19689,1,9689,[127 187 483 302 211],207,5,42592,4.39545923632611,20.0,20.0
19690,1,9690,[127 187 483 302 211],207,5,42597,4.395521617996079,20.0,20.0
19691,1,9691,[127 187 483 302 211],666,5,42602,4.395583986793231,20.0,20.0
19692,1,9692,[127 187 483 302 211],524,5,42607,4.395646342721552,20.0,20.0
19693,1,9693,[153 271 151 269 135],650,3,42610,4.39550237260161,0.0,0.0
19694,1,9694,[127 187 483 302 211],537,5,42615,4.39556472408458,20.0,20.0
19695,1,9695,[127 187 483 302 211],537,5,42620,4.395627062706271,20.0,20.0
19696,1,9696,[127 187 483 302 211],90,5,42625,4.395689388470661,20.0,20.0
19697,1,9697,[127 187 483 302 211],6,5,42630,4.395751701381728,20.0,20.0
19698,1,9698,[127 187 483 302 211],833,3,42633,4.395607794618002,20.0,20.0
19699,1,9699,[603 210  22  89 289],524,2,42635,4.395360824742268,20.0,0.0
19700,1,9700,[127 187 483 302 211],524,5,42640,4.395423152252345,20.0,20.0
19701,1,9701,[127 187 483 302 211],13,5,42645,4.395485466914038,20.0,20.0
19702,1,9702,[127 187 483 302 211],666,5,42650,4.39554776873132,20.0,20.0
19703,1,9703,[127 187 483 302 211],666,5,42655,4.395610057708161,20.0,20.0
19704,1,9704,[127 187 483 302 211],666,5,42660,4.395672333848531,20.0,20.0
19705,1,9705,[127 187 483 302 211],666,5,42665,4.395734597156398,20.0,20.0
19706,1,9706,[127 187 483 302 211],207,5,42670,4.395796847635727,20.0,20.0
19707,1,9707,[127 187 483 302 211],207,5,42675,4.395859085290482,20.0,20.0
19708,1,9708,[ 82  22 172  25  71],897,4,42679,4.3958183129055515,0.0,0.0
19709,1,9709,[237 496 294 228 286],7,4,42683,4.39577754891864,0.0,0.0
19710,1,9710,[323   1 742 228 216],881,3,42686,4.395633817320564,0.0,0.0
19711,1,9711,[127 187 483 302 211],210,5,42691,4.395696046128501,20.0,20.0
19712,1,9712,[127 187 483 302 211],833,3,42694,4.395552352517245,20.0,20.0
19713,1,9713,[127 187 483 302 211],474,5,42699,4.3956145768993204,20.0,20.0
19714,1,9714,[127 187 483 302 211],537,5,42704,4.395676788471436,20.0,20.0
19715,1,9715,[483 161 118 143 153],194,2,42706,4.395430218196789,20.0,0.0
19716,1,9716,[127 187 483 302 211],666,5,42711,4.395492435937018,20.0,20.0
19717,1,9717,[127 187 483 302 211],833,3,42714,4.395348837209302,20.0,20.0
19718,1,9718,[127 187 483 302 211],339,5,42719,4.395411050519601,20.0,20.0
19719,1,9719,[127 187 483 302 211],90,5,42724,4.395473251028807,20.0,20.0
19720,1,9720,[127 187 483 302 211],210,5,42729,4.39553543874087,20.0,20.0
19721,1,9721,[127 187 483 302 211],524,5,42734,4.395597613659741,20.0,20.0
19722,1,9722,[ 79 427 275 435 182],13,3,42737,4.395454077959478,0.0,0.0
19723,1,9723,[265 144 194 187 300],313,5,42742,4.395516248457425,0.0,0.0
19724,1,9724,[127 187 483 302 211],6,5,42747,4.395578406169665,20.0,20.0
19725,1,9725,[357 471 742 258 179],899,4,42751,4.3955377339091095,20.0,0.0
19726,1,9726,[127 187 483 302 211],6,5,42756,4.395599876632055,20.0,20.0
19727,1,9727,[289 269 172 655  64],537,0,42756,4.395148026315789,0.0,0.0
19728,1,9728,[127 187 483 302 211],339,5,42761,4.39521019632028,20.0,20.0
19729,1,9729,[127 187 483 302 211],524,5,42766,4.395272353545735,20.0,20.0
19730,1,9730,[127 187 483 302 211],207,5,42771,4.395334497996095,20.0,20.0
19731,1,9731,[258 174   8 200   4],455,4,42775,4.395293875873407,0.0,20.0
19732,1,9732,[127 187 483 302 211],343,5,42780,4.395356005342649,20.0,20.0
19733,1,9733,[216  89 111 197 172],234,1,42781,4.395007191288268,0.0,0.0
19734,1,9734,[127 187 483 302 211],833,3,42784,4.394863893168978,20.0,20.0
19735,1,9735,[127 187 483 302 211],833,3,42787,4.394720624486442,20.0,20.0
19736,1,9736,[127 187 483 302 211],343,5,42792,4.394782787306152,20.0,20.0
19737,1,9737,[127 187 483 302 211],207,5,42797,4.3948449373588,20.0,20.0
19738,1,9738,[603 300  28 235 186],537,2,42799,4.394599034808502,20.0,0.0
19739,1,9739,[127 187 483 302 211],339,5,42804,4.394661190965093,20.0,20.0
19740,1,9740,[127 187 483 302 211],339,5,42809,4.394723334359922,20.0,20.0
19741,1,9741,[127 187 483 302 211],537,5,42814,4.394785464996921,20.0,20.0
19742,1,9742,[127 187 483 302 211],524,5,42819,4.394847582880017,20.0,20.0
19743,1,9743,[ 69 475 117 546 257],308,2,42821,4.394601806239737,0.0,0.0
19744,1,9744,[127 187 483 302 211],207,5,42826,4.394663930220626,20.0,20.0
19745,1,9745,[127 187 483 302 211],474,5,42831,4.394726041452904,20.0,20.0
19746,1,9746,[127 187 483 302 211],207,5,42836,4.394788139940495,20.0,20.0
19747,1,9747,[127 187 483 302 211],328,5,42841,4.39485022568732,20.0,20.0
19748,1,9748,[127 187 483 302 211],90,5,42846,4.394912298697302,20.0,20.0
19749,1,9749,[127 187 483 302 211],90,5,42851,4.394974358974359,20.0,20.0
19750,1,9750,[ 56 235 568 117 202],343,3,42854,4.394831299353912,0.0,0.0
19751,1,9751,[276 121   1 173 127],210,5,42859,4.394893355209188,0.0,20.0
19752,1,9752,[318 153 174 546 405],64,2,42861,4.394647800676715,20.0,20.0
19753,1,9753,[175 174 187 302 185],666,4,42865,4.394607340578224,0.0,20.0
19754,1,9754,[127 187 483 302 211],833,3,42868,4.39446437724244,20.0,20.0
19755,1,9755,[127 187 483 302 211],537,5,42873,4.394526445264453,20.0,20.0
19756,1,9756,[ 98  28 161 471 197],474,4,42877,4.394486010044071,0.0,20.0
19757,1,9757,[127 187 483 302 211],343,5,42882,4.39454806312769,20.0,20.0
19758,1,9758,[127 187 483 302 211],90,5,42887,4.394610103494211,20.0,20.0
19759,1,9759,[98  7 71 15 97],95,5,42892,4.394672131147541,0.0,20.0
19760,1,9760,[127 187 483 302 211],90,5,42897,4.394734146091589,20.0,20.0
19761,1,9761,[127 187 483 302 211],13,5,42902,4.39479614833026,20.0,20.0
19762,1,9762,[127 187 483 302 211],474,5,42907,4.394858137867459,20.0,20.0
19763,1,9763,[127 187 483 302 211],339,5,42912,4.394920114707087,20.0,20.0
19764,1,9764,[127 187 483 302 211],474,5,42917,4.3949820788530465,20.0,20.0
19765,1,9765,[ 25 181 216  88  28],308,3,42920,4.394839238173254,0.0,0.0
19766,1,9766,[127 187 483 302 211],666,5,42925,4.394901197911334,20.0,20.0
19767,1,9767,[127 187 483 302 211],524,5,42930,4.394963144963145,20.0,20.0
19768,1,9768,[127 187 483 302 211],13,5,42935,4.395025079332583,20.0,20.0
19769,1,9769,[127 187 483 302 211],90,5,42940,4.395087001023541,20.0,20.0
19770,1,9770,[127 187 483 302 211],207,5,42945,4.395148910039914,20.0,20.0
19771,1,9771,[127 187 483 302 211],207,5,42950,4.395210806385592,20.0,20.0
19772,1,9772,[194 210 508  96 427],474,4,42954,4.395170367338586,0.0,0.0
19773,1,9773,[127 187 483 302 427],664,5,42959,4.395232248823409,20.0,20.0
19774,1,9774,[127 187 483 302 427],13,5,42964,4.395294117647059,20.0,20.0
19775,1,9775,[127 187 483 302 427],474,5,42969,4.3953559738134205,20.0,20.0
19776,1,9776,[127 187 483 302 427],666,5,42974,4.395417817326378,20.0,20.0
19777,1,9777,[127 187 483 302 427],474,5,42979,4.395479648189814,20.0,20.0
19778,1,9778,[135 405 357 318 179],7,4,42983,4.395439206462829,40.0,0.0
19779,1,9779,[127 187 483 302 427],474,5,42988,4.395501022494887,20.0,20.0
19780,1,9780,[127 187 483 427 302],328,4,42992,4.39546058685206,20.0,20.0
19781,1,9781,[288 117 186   9 269],343,3,42995,4.395317930893478,0.0,0.0
19782,1,9782,[151 238  71 174  25],406,1,42996,4.394970867831954,0.0,20.0
19783,1,9783,[238 183 742 403  79],653,1,42997,4.394623875715454,0.0,0.0
19784,1,9784,[127 187 483 302 211],339,5,43002,4.394685743484926,20.0,20.0
19785,1,9785,[127 187 483 302 211],524,5,43007,4.39474759861026,20.0,20.0
19786,1,9786,[175   8 173  95  69],125,4,43011,4.39470726473894,0.0,0.0
19787,1,9787,[127 187 483 302 211],210,5,43016,4.394769105026563,20.0,20.0
19788,1,9788,[172 210 318 215 588],406,4,43020,4.394728777198897,20.0,0.0
19789,1,9789,[435 568 135 132 216],59,5,43025,4.394790602655771,0.0,0.0
19790,1,9790,[127 187 483 302 211],6,5,43030,4.394852415483608,20.0,20.0
19791,1,9791,[151 300 288   8 496],64,3,43033,4.394709967320262,0.0,0.0
19792,1,9792,[127 187 483 302 211],210,5,43038,4.394771775758195,20.0,20.0
19793,1,9793,[127 187 483 302 211],210,5,43043,4.394833571574433,20.0,20.0
19794,1,9794,[127 187 483 302 211],524,5,43048,4.394895354772843,20.0,20.0
19795,1,9795,[174 121 202 301 546],13,3,43051,4.394752960391997,0.0,20.0
19796,1,9796,[234 168  82  56 508],85,3,43054,4.394610595080127,0.0,0.0
19797,1,9797,[228 268 204 258 125],234,0,43054,4.394162073892631,0.0,0.0
19798,1,9798,[127 187 483 302 211],328,5,43059,4.394223900398,20.0,20.0
19799,1,9799,[127 187 483 302 211],6,5,43064,4.394285714285714,20.0,20.0
19800,1,9800,[127 187 483 302 211],90,5,43069,4.3943475155596365,20.0,20.0
19801,1,9801,[127 187 483 302 211],6,5,43074,4.394409304223628,20.0,20.0
19802,1,9802,[127 187 483 302 211],524,5,43079,4.394471080281546,20.0,20.0
19803,1,9803,[405  28 228 144  22],738,3,43082,4.394328845369237,0.0,0.0
19804,1,9804,[127 187 483 302 211],210,5,43087,4.394390617032126,20.0,20.0
19805,1,9805,[127 187 483 302 211],207,5,43092,4.394452376096267,20.0,20.0
19806,1,9806,[127 187 483 302 211],90,5,43097,4.394514122565514,20.0,20.0
19807,1,9807,[282 276 748 185 222],311,4,43101,4.394473898858075,0.0,0.0
19808,1,9808,[127 187 483 302 211],207,5,43106,4.394535630543379,20.0,20.0
19809,1,9809,[127 187 483 302 211],13,5,43111,4.394597349643221,20.0,20.0
19810,1,9810,[127 187 483 302 211],210,5,43116,4.394659056161451,20.0,20.0
19811,1,9811,[127 187 483 302 211],524,5,43121,4.394720750101916,20.0,20.0
19812,1,9812,[127 187 483 302 211],833,3,43124,4.394578620197697,20.0,20.0
19813,1,9813,[127 187 483 302 211],328,5,43129,4.394640309761565,20.0,20.0
19814,1,9814,[144 603 194 100 175],234,3,43132,4.394498217014774,20.0,20.0
19815,1,9815,[127 187 483 302 211],6,5,43137,4.394559902200489,20.0,20.0
19816,1,9816,[ 11 215 546  15  95],378,3,43140,4.394417846592646,0.0,0.0
19817,1,9817,[127 187 483 302 211],474,5,43145,4.394479527398656,20.0,20.0
19818,1,9818,[127 187 483 302 211],524,5,43150,4.394541195641104,20.0,20.0
19819,1,9819,[175  79 179  15 195],474,5,43155,4.394602851323829,0.0,0.0
19820,1,9820,[127 187 483 302 211],328,5,43160,4.394664494450667,20.0,20.0
19821,1,9821,[127 187 483 302 211],339,5,43165,4.3947261250254535,20.0,20.0
19822,1,9822,[127 187 483 302 211],343,5,43170,4.394787743052021,20.0,20.0
19823,1,9823,[127 187 483 302 211],6,5,43175,4.394849348534202,20.0,20.0
19824,1,9824,[471 180 179 288 176],537,2,43177,4.394605597964377,0.0,0.0
19825,1,9825,[127 187 483 302 211],210,5,43182,4.394667209444331,20.0,20.0
19826,1,9826,[127 187 483 302 211],524,5,43187,4.394728808385062,20.0,20.0
19827,1,9827,[127 187 483 302 211],13,5,43192,4.394790394790395,20.0,20.0
19828,1,9828,[228 427 322 269 176],13,2,43194,4.394546749414997,0.0,0.0
19829,1,9829,[568  22 318 132 475],64,5,43199,4.394608341810783,20.0,0.0
19830,1,9830,[127 187 483 302 211],207,5,43204,4.39466992167633,20.0,20.0
19831,1,9831,[127 187 483 302 211],339,5,43209,4.394731489015459,20.0,20.0
19832,1,9832,[127 187 483 302 211],207,5,43214,4.394793043831994,20.0,20.0
19833,1,9833,[127 187 483 302 211],474,5,43219,4.394854586129754,20.0,20.0
19834,1,9834,[127 187 483 302 211],537,5,43224,4.394916115912557,20.0,20.0
19835,1,9835,[127 187 483 302 211],13,5,43229,4.394977633184221,20.0,20.0
19836,1,9836,[127 187 483 302 211],343,5,43234,4.395039137948562,20.0,20.0
19837,1,9837,[127 187 483 302 211],339,5,43239,4.3951006302093925,20.0,20.0
19838,1,9838,[496 143 127 597 235],897,4,43243,4.395060473625368,0.0,20.0
19839,1,9839,[127 187 483 302 211],207,5,43248,4.3951219512195125,20.0,20.0
19840,1,9840,[127 187 483 302 211],537,5,43253,4.39518341631948,20.0,20.0
19841,1,9841,[ 28 258 186 294 228],774,1,43254,4.394838447470026,0.0,0.0
19842,1,9842,[117  56 655 173  69],334,3,43257,4.394696738799147,0.0,0.0
19843,1,9843,[180 174 127 151 210],95,4,43261,4.394656643640796,0.0,40.0
19844,1,9844,[127 187 483 302 211],13,5,43266,4.39471813103098,20.0,20.0
19845,1,9845,[127 187 483 302 211],537,5,43271,4.394779605931343,20.0,20.0
19846,1,9846,[127 187 483 302 211],13,5,43276,4.394841068345689,20.0,20.0
19847,1,9847,[127 187 483 302 211],90,5,43281,4.3949025182778225,20.0,20.0
19848,1,9848,[127 187 483 302 211],210,5,43286,4.394963955731546,20.0,20.0
19849,1,9849,[127 187 483 302 211],328,5,43291,4.39502538071066,20.0,20.0
19850,1,9850,[127 187 483 302 211],343,5,43296,4.395086793218963,20.0,20.0
19851,1,9851,[ 28 180 173 496 405],85,3,43299,4.3949451887941535,0.0,0.0
19852,1,9852,[127 187 483 302 211],343,5,43304,4.3950065969755405,20.0,20.0
19853,1,9853,[127 187 483 302 211],6,5,43309,4.395067992693322,20.0,20.0
19854,1,9854,[127 187 483 302 211],474,5,43314,4.395129375951294,20.0,20.0
19855,1,9855,[127 187 483 302 211],666,5,43319,4.395190746753247,20.0,20.0
19856,1,9856,[127 187 483 302 211],833,3,43322,4.395049203611647,20.0,20.0
19857,1,9857,[127 187 483 302 211],6,5,43327,4.395110570095354,20.0,20.0
19858,1,9858,[127 187 483 302 211],339,5,43332,4.395171924130237,20.0,20.0
19859,1,9859,[127 187 483 302 211],328,5,43337,4.395233265720081,20.0,20.0
19860,1,9860,[294 174 271   8   7],144,3,43340,4.39509177568198,0.0,20.0
19861,1,9861,[127 187 483 302 211],537,5,43345,4.395153112958832,20.0,20.0
19862,1,9862,[127 187 483 302 211],339,5,43350,4.39521443779783,20.0,20.0
19863,1,9863,[127 187 483 302 211],207,5,43355,4.3952757502027575,20.0,20.0
19864,1,9864,[127 187 483 302 211],339,5,43360,4.395337050177395,20.0,20.0
19865,1,9865,[127 187 483 302 211],13,5,43365,4.395398337725522,20.0,20.0
19866,1,9866,[127 187 483 302 211],343,5,43370,4.395459612850917,20.0,20.0
19867,1,9867,[173 144  11 186 182],346,3,43373,4.39531820024321,0.0,0.0
19868,1,9868,[127 257 182 118 216],881,4,43377,4.395278143682237,0.0,20.0
19869,1,9869,[127 187 483 302 211],833,3,43380,4.395136778115502,20.0,20.0
19870,1,9870,[127 187 483 302 211],90,5,43385,4.395198054908318,20.0,20.0
19871,1,9871,[174   9 588  28 235],406,4,43389,4.395158022690437,0.0,20.0
19872,1,9872,[127 187 483 302 211],339,5,43394,4.395219284918465,20.0,20.0
19873,1,9873,[127 187 483 302 211],6,5,43399,4.395280534737695,20.0,20.0
19874,1,9874,[127 187 483 302 211],343,5,43404,4.395341772151899,20.0,20.0
19875,1,9875,[385 202 423 210  88],738,4,43408,4.395301741595787,0.0,0.0
19876,1,9876,[127 187 483 302 211],207,5,43413,4.395362964462894,20.0,20.0
19877,1,9877,[127 187 483 302 211],474,5,43418,4.395424174934197,20.0,20.0
19878,1,9878,[127 187 483 302 211],524,5,43423,4.395485373013463,20.0,20.0
19879,1,9879,[568 194 603 435  25],650,3,43426,4.395344129554656,20.0,0.0
19880,1,9880,[323 234  79 183  50],200,4,43430,4.395304119016294,0.0,20.0
19881,1,9881,[127 187 483 302 211],537,5,43435,4.3953653106658575,20.0,20.0
19882,1,9882,[127 187 483 302 211],537,5,43440,4.395426489932206,20.0,20.0
19883,1,9883,[127 187 483 302 211],666,5,43445,4.3954876568191015,20.0,20.0
19884,1,9884,[127 187 483 302 211],833,3,43448,4.395346484572585,20.0,20.0
19885,1,9885,[127 187 483 302 211],13,5,43453,4.395407647177827,20.0,20.0
19886,1,9886,[127 187 483 302 211],207,5,43458,4.395468797410741,20.0,20.0
19887,1,9887,[ 69  82 234   7  56],7,4,43462,4.395428802588997,0.0,0.0
19888,1,9888,[127 187 483 302 211],537,5,43467,4.3954899383153,20.0,20.0
19889,1,9889,[127 187 483 302 211],207,5,43472,4.395551061678463,20.0,20.0
19890,1,9890,[127 187 483 302 211],833,3,43475,4.3954099686583765,20.0,20.0
19891,1,9891,[127 187 483 302 211],207,5,43480,4.395471087747675,20.0,20.0
19892,1,9892,[127 187 483 302 211],474,5,43485,4.395532194480946,20.0,20.0
19893,1,9893,[127 187 483 302 211],90,5,43490,4.395593288861937,20.0,20.0
19894,1,9894,[127 187 483 302 211],328,5,43495,4.395654370894391,20.0,20.0
19895,1,9895,[127 187 483 302 211],474,5,43500,4.3957154405820535,20.0,20.0
19896,1,9896,[127 187 483 302 211],524,5,43505,4.395776497928665,20.0,20.0
19897,1,9897,[127 187 483 302 211],6,5,43510,4.395837542937968,20.0,20.0
19898,1,9898,[127 187 483 302 211],328,5,43515,4.395898575613699,20.0,20.0
19899,1,9899,[228  22 294 234   7],7,4,43519,4.395858585858586,0.0,0.0
19900,1,9900,[127 187 483 302 211],13,5,43524,4.395919604080396,20.0,20.0
19901,1,9901,[173   8 127 318  96],455,4,43528,4.395879620278731,20.0,20.0
19902,1,9902,[127 187 483 302 211],537,5,43533,4.395940624053317,20.0,20.0
19903,1,9903,[127 187 483 302 211],328,5,43538,4.396001615508886,20.0,20.0
19904,1,9904,[238 268  96 176 222],92,5,43543,4.396062594649167,0.0,0.0
19905,1,9905,[127 187 483 302 211],833,3,43546,4.395921663638199,20.0,20.0
19906,1,9906,[127 187 483 302 211],328,5,43551,4.395982638538407,20.0,20.0
19907,1,9907,[127 187 483 302 211],207,5,43556,4.396043601130399,20.0,20.0
19908,1,9908,[127 187 483 302 211],537,5,43561,4.396104551417903,20.0,20.0
19909,1,9909,[318 294 515 187  96],234,3,43564,4.395963673057517,20.0,0.0
19910,1,9910,[127 187 483 302 211],474,5,43569,4.396024619110079,20.0,20.0
19911,1,9911,[  7  69 294  98 403],92,4,43573,4.395984665052461,0.0,20.0
19912,1,9912,[121 288 282 496  89],479,3,43576,4.395843841420357,0.0,0.0
19913,1,9913,[127 187 483 302 211],328,5,43581,4.395904781117611,20.0,20.0
19914,1,9914,[127 187 483 302 211],13,5,43586,4.395965708522441,20.0,20.0
19915,1,9915,[127 187 483 302 211],13,5,43591,4.396026623638564,20.0,20.0
19916,1,9916,[127 187 483 302 211],13,5,43596,4.396087526469699,20.0,20.0
19917,1,9917,[127 187 483 302 211],524,5,43601,4.39614841701956,20.0,20.0
19918,1,9918,[127 187 483 302 211],474,5,43606,4.396209295291864,20.0,20.0
19919,1,9919,[127 187 483 302 211],6,5,43611,4.396270161290323,20.0,20.0
19920,1,9920,[127 187 483 302 211],524,5,43616,4.396331015018648,20.0,20.0
19921,1,9921,[127 187 483 302 211],6,5,43621,4.396391856480548,20.0,20.0
19922,1,9922,[ 98 222 179 168  71],897,3,43624,4.396251133729719,0.0,20.0
19923,1,9923,[ 95 318 655 265 294],13,3,43627,4.396110439338976,20.0,0.0
19924,1,9924,[168  79  22 216 172],92,3,43630,4.395969773299748,0.0,0.0
19925,1,9925,[ 64 200 271 228 483],749,5,43635,4.396030626637114,20.0,0.0
19926,1,9926,[127 187 483 302 211],207,5,43640,4.396091467714315,20.0,20.0
19927,1,9927,[127 187 483 302 211],524,5,43645,4.396152296535052,20.0,20.0
19928,1,9928,[127 187 483 302 211],328,5,43650,4.396213113103031,20.0,20.0
19929,1,9929,[ 56   9 168 245 174],10,5,43655,4.396273917421953,0.0,20.0
19930,1,9930,[238 143 742 216 196],881,3,43658,4.396133319907361,0.0,0.0
19931,1,9931,[258 143  71 403 182],334,2,43660,4.395892066049134,0.0,0.0
19932,1,9932,[ 22 588 176  89 265],537,1,43661,4.395550186247861,0.0,0.0
19933,1,9933,[127 187 483 302 211],210,5,43666,4.395611032816589,20.0,20.0
19934,1,9934,[127 187 483 302 211],524,5,43671,4.395671867136387,20.0,20.0
19935,1,9935,[ 69   1 515 265  56],145,4,43675,4.395632045088567,0.0,0.0
19936,1,9936,[127 187 483 302 211],210,5,43680,4.3956928650498135,20.0,20.0
19937,1,9937,[127 187 483 302 211],328,5,43685,4.395753672771181,20.0,20.0
19938,1,9938,[127 187 483 302 211],339,5,43690,4.395814468256364,20.0,20.0
19939,1,9939,[127 187 483 302 211],339,5,43695,4.395875251509055,20.0,20.0
19940,1,9940,[176 182 144 245 257],378,4,43699,4.395835429031284,0.0,0.0
19941,1,9941,[127 187 483 302 211],537,5,43704,4.395896197948099,20.0,20.0
19942,1,9942,[173   7 483 568 222],339,4,43708,4.3958563813738305,20.0,0.0
19943,1,9943,[127 187 483 302 211],6,5,43713,4.395917135961383,20.0,20.0
19944,1,9944,[127 187 483 302 211],210,5,43718,4.39597787833082,20.0,20.0
19945,1,9945,[127 187 483 302 211],524,5,43723,4.396038608485823,20.0,20.0
19946,1,9946,[127 187 483 302 211],666,5,43728,4.39609932643008,20.0,20.0
19947,1,9947,[127 187 483 302 211],90,5,43733,4.39616003216727,20.0,20.0
19948,1,9948,[127 187 483 302 211],207,5,43738,4.396220725701076,20.0,20.0
19949,1,9949,[127 187 483 302 211],833,3,43741,4.396080402010051,20.0,20.0
19950,1,9950,[127 187 483 302 211],474,5,43746,4.396141091347603,20.0,20.0
19951,1,9951,[127 187 483 302 211],833,3,43749,4.396000803858521,20.0,20.0
19952,1,9952,[127 187 483 302 211],328,5,43754,4.396061488998292,20.0,20.0
19953,1,9953,[127 187 483 302 211],6,5,43759,4.396122161944946,20.0,20.0
19954,1,9954,[127 187 483 302 211],537,5,43764,4.396182822702159,20.0,20.0
19955,1,9955,[127 187 483 302 211],833,3,43767,4.396042587384492,20.0,20.0
19956,1,9956,[301 228 143 237 100],334,3,43770,4.39590238023501,0.0,20.0
19957,1,9957,[127 187 483 302 211],13,5,43775,4.39596304478811,20.0,20.0
19958,1,9958,[127 187 483 302 211],524,5,43780,4.396023697158349,20.0,20.0
19959,1,9959,[127 187 483 302 211],6,5,43785,4.396084337349397,20.0,20.0
19960,1,9960,[127 187 483 302 211],524,5,43790,4.396144965364924,20.0,20.0
19961,1,9961,[127 187 483 302 211],13,5,43795,4.3962055812085925,20.0,20.0
19962,1,9962,[ 56 176   8   9 185],328,4,43799,4.396165813509987,0.0,0.0
19963,1,9963,[127 187 483 302 211],207,5,43804,4.39622641509434,20.0,20.0
19964,1,9964,[127 187 483 302 211],343,5,43809,4.396287004515806,20.0,20.0
19965,1,9965,[127 187 483 302 211],474,5,43814,4.396347581778046,20.0,20.0
19966,1,9966,[127 187 483 302 211],833,3,43817,4.3962074846995085,20.0,20.0
19967,1,9967,[183 288 168 403 135],59,5,43822,4.396268057784912,0.0,0.0
19968,1,9968,[127 187 483 302 211],537,5,43827,4.396328618718026,20.0,20.0
19969,1,9969,[ 71 496  69  89  28],334,1,43828,4.395987963891675,0.0,0.0
19970,1,9970,[127 187 483 302 211],90,5,43833,4.396048540768228,20.0,20.0
19971,1,9971,[127 187 483 302 211],207,5,43838,4.396109105495387,20.0,20.0
19972,1,9972,[127 187 483 302 211],90,5,43843,4.396169658076808,20.0,20.0
19973,1,9973,[127 187 483 302 211],6,5,43848,4.396230198516142,20.0,20.0
19974,1,9974,[127 187 483 302 211],343,5,43853,4.396290726817043,20.0,20.0
19975,1,9975,[127 187 483 302 211],666,5,43858,4.39635124298316,20.0,20.0
19976,1,9976,[127 187 483 302 211],524,5,43863,4.396411747018142,20.0,20.0
19977,1,9977,[127 187 483 302 211],13,5,43868,4.396472238925637,20.0,20.0
19978,1,9978,[127 187 483 302 211],537,5,43873,4.396532718709289,20.0,20.0
19979,1,9979,[127 187 483 302 211],210,5,43878,4.396593186372746,20.0,20.0
19980,1,9980,[216 127 161  11  82],234,1,43879,4.396252880472899,0.0,20.0
19981,1,9981,[258 180   4 301 151],378,1,43880,4.395912642756962,0.0,0.0
19982,1,9982,[127 187 483 302 211],207,5,43885,4.395973154362416,20.0,20.0
19983,1,9983,[127 187 483 302 211],210,5,43890,4.396033653846154,20.0,20.0
19984,1,9984,[127 187 483 302 211],90,5,43895,4.396094141211818,20.0,20.0
19985,1,9985,[127 187 483 302 211],90,5,43900,4.396154616463048,20.0,20.0
19986,1,9986,[127 187 483 302 211],328,5,43905,4.3962150796034845,20.0,20.0
19987,1,9987,[265   1 200  97  50],326,3,43908,4.396075290348418,0.0,20.0
19988,1,9988,[127 187 483 302 211],524,5,43913,4.396135749324257,20.0,20.0
19989,1,9989,[127 187 483 302 211],210,5,43918,4.396196196196196,20.0,20.0
19990,1,9990,[127 187 483 302 211],13,5,43923,4.396256630967871,20.0,20.0
19991,1,9991,[127 187 483 302 211],537,5,43928,4.396317053642914,20.0,20.0
19992,1,9992,[127 187 483 302 211],13,5,43933,4.396377464224957,20.0,20.0
19993,1,9993,[127 187 483 302 211],833,3,43936,4.396237742645587,20.0,20.0
19994,1,9994,[294 121 132 216 135],882,5,43941,4.396298149074537,0.0,0.0
19995,1,9995,[127 187 483 302 211],6,5,43946,4.396358543417367,20.0,20.0
19996,1,9996,[127 187 483 302 211],537,5,43951,4.396418925677703,20.0,20.0
19997,1,9997,[127 187 483 302 211],13,5,43956,4.396479295859172,20.0,20.0
19998,1,9998,[127 187 483 302 211],833,3,43959,4.396339633963397,20.0,20.0
19999,1,9999,[127 187 483 302 211],328,5,43964,4.3964,20.0,20.0
20000,2,0,[678 118  69  71 197],454,3,3,3.0,0.0,0.0
20001,2,1,[118  69 197 678  71],82,3,6,3.0,0.0,0.0
20002,2,2,[  4 174  71 151 144],64,1,7,2.3333333333333335,0.0,20.0
20003,2,3,[ 69 197 174 118  71],380,3,10,2.5,0.0,20.0
20004,2,4,[ 69 174 197  71 118],694,5,15,3.0,0.0,20.0
20005,2,5,[ 69 174 197  71 118],82,4,19,3.1666666666666665,0.0,20.0
20006,2,6,[ 69 174 197  71 118],82,4,23,3.2857142857142856,0.0,20.0
20007,2,7,[ 69 174 197  71 118],648,2,25,3.125,0.0,20.0
20008,2,8,[603 508   8 143 111],474,4,29,3.2222222222222223,20.0,0.0
20009,2,9,[603 174 111 143   8],474,5,34,3.4,20.0,20.0
20010,2,10,[ 28 265 471 204  64],313,4,38,3.4545454545454546,0.0,0.0
20011,2,11,[471 204 265 111  64],271,4,42,3.5,0.0,0.0
20012,2,12,[204 265 111  64   8],452,2,44,3.3846153846153846,0.0,0.0
20013,2,13,[ 64   8 174 143 603],90,5,49,3.5,20.0,20.0
20014,2,14,[ 50  96 288 179 322],13,2,51,3.4,0.0,20.0
20015,2,15,[603  64  96   8 143],7,4,55,3.4375,20.0,0.0
20016,2,16,[603  64  96   8 174],326,4,59,3.4705882352941178,20.0,20.0
20017,2,17,[603  64   8 174  50],387,4,63,3.5,20.0,40.0
20018,2,18,[603   8 174  50  69],474,5,68,3.5789473684210527,20.0,40.0
20019,2,19,[603   8 174  50  69],271,5,73,3.65,20.0,40.0
20020,2,20,[603   8 174  50  69],313,4,77,3.6666666666666665,20.0,40.0
20021,2,21,[603 174  50   8  69],308,4,81,3.6818181818181817,20.0,40.0
20022,2,22,[603 174  50   8  64],883,5,86,3.739130434782609,20.0,40.0
20023,2,23,[ 25 175  96 322 197],804,5,91,3.7916666666666665,0.0,0.0
20024,2,24,[265 187 185 268 191],334,4,95,3.8,0.0,0.0
20025,2,25,[ 50 185 268 187 174],239,4,99,3.8076923076923075,0.0,40.0
20026,2,26,[ 50 191  25 175 185],804,5,104,3.8518518518518516,0.0,20.0
20027,2,27,[ 50 191  25 175 185],339,5,109,3.892857142857143,0.0,20.0
20028,2,28,[ 50 191  25 175 185],749,4,113,3.896551724137931,0.0,20.0
20029,2,29,[ 50 191  25 185 603],234,3,116,3.8666666666666667,20.0,20.0
20030,2,30,[ 50 191 603 174 187],379,5,121,3.903225806451613,20.0,40.0
20031,2,31,[597 176 125 271 183],144,4,125,3.90625,0.0,0.0
20032,2,32,[187 125 176 597 183],897,5,130,3.9393939393939394,0.0,0.0
20033,2,33,[187 125 176 597 183],59,3,133,3.911764705882353,0.0,0.0
20034,2,34,[186 176 515 238 196],308,3,136,3.8857142857142857,0.0,0.0
20035,2,35,[282 100 275   9 235],486,3,139,3.861111111111111,0.0,20.0
20036,2,36,[187 603 174 183 176],64,4,143,3.864864864864865,20.0,20.0
20037,2,37,[183  22 238 161 322],13,3,146,3.8421052631578947,0.0,0.0
20038,2,38,[ 22 186  50 191 100],749,4,150,3.8461538461538463,0.0,40.0
20039,2,39,[237 496 185 508  64],60,5,155,3.875,0.0,0.0
20040,2,40,[ 22 496 174  50 191],313,4,159,3.8780487804878048,0.0,40.0
20041,2,41,[  9 237 176 187 183],115,4,163,3.880952380952381,0.0,0.0
20042,2,42,[ 50   9 275 187 191],694,5,168,3.9069767441860463,0.0,20.0
20043,2,43,[ 50   9 275 187 191],13,2,170,3.8636363636363638,0.0,20.0
20044,2,44,[ 50 496 187 186 174],64,5,175,3.888888888888889,0.0,40.0
20045,2,45,[ 50 496 187 186 174],780,5,180,3.9130434782608696,0.0,40.0
20046,2,46,[ 50 496 187 186 174],311,4,184,3.9148936170212765,0.0,40.0
20047,2,47,[  9  64  89   1 185],380,3,187,3.8958333333333335,0.0,0.0
20048,2,48,[187  50  89   1 183],648,4,191,3.8979591836734695,0.0,20.0
20049,2,49,[ 50  89   1 183 496],379,5,196,3.92,0.0,20.0
20050,2,50,[ 50  89   1 183 496],339,5,201,3.9411764705882355,0.0,20.0
20051,2,51,[ 50  89   1 183 496],387,4,205,3.9423076923076925,0.0,20.0
20052,2,52,[ 50  89   1 183 174],378,5,210,3.9622641509433962,0.0,40.0
20053,2,53,[ 50  89   1 183 174],738,5,215,3.9814814814814814,0.0,40.0
20054,2,54,[ 50  89   1 183 174],77,5,220,4.0,0.0,40.0
20055,2,55,[ 50  89   1 183 174],830,5,225,4.017857142857143,0.0,40.0
20056,2,56,[ 50  89   1 183 174],95,4,229,4.017543859649122,0.0,40.0
20057,2,57,[ 50   1 183 174 161],92,4,233,4.017241379310345,0.0,40.0
20058,2,58,[  1 183 174 176  50],378,5,238,4.033898305084746,0.0,40.0
20059,2,59,[  1 183 174 176  50],537,1,239,3.9833333333333334,0.0,40.0
20060,2,60,[ 50 174 183 603 187],313,5,244,4.0,20.0,40.0
20061,2,61,[ 50 174 183 603 187],59,5,249,4.016129032258065,20.0,40.0
20062,2,62,[ 50 174 183 603 187],694,5,254,4.031746031746032,20.0,40.0
20063,2,63,[ 50 174 183 603 187],643,5,259,4.046875,20.0,40.0
20064,2,64,[ 50 174 183 603 187],379,5,264,4.061538461538461,20.0,40.0
20065,2,65,[ 50 174 183 603 187],749,4,268,4.0606060606060606,20.0,40.0
20066,2,66,[ 50 174 183 603   1],339,5,273,4.074626865671642,20.0,40.0
20067,2,67,[ 50 174 183 603   1],669,3,276,4.0588235294117645,20.0,40.0
20068,2,68,[ 50 603 174   1 183],815,4,280,4.057971014492754,20.0,40.0
20069,2,69,[ 50 174   1 183   8],298,4,284,4.057142857142857,0.0,40.0
20070,2,70,[ 50 174   1   8 603],398,4,288,4.056338028169014,20.0,40.0
20071,2,71,[ 50 174   1 603  89],537,3,291,4.041666666666667,20.0,40.0
20072,2,72,[ 50 174 603  89 191],664,4,295,4.041095890410959,20.0,40.0
20073,2,73,[ 50 174 603  89 187],666,3,298,4.027027027027027,20.0,40.0
20074,2,74,[ 50 603  89 174 187],804,5,303,4.04,20.0,40.0
20075,2,75,[ 50 603  89 174 187],387,5,308,4.052631578947368,20.0,40.0
20076,2,76,[ 50  89 603 174 187],387,5,313,4.064935064935065,20.0,40.0
20077,2,77,[ 64 151 238 181 176],653,2,315,4.038461538461538,0.0,0.0
20078,2,78,[ 88 288  79 172 100],479,3,318,4.025316455696203,0.0,20.0
20079,2,79,[172  88  79 181  50],184,3,321,4.0125,0.0,20.0
20080,2,80,[172 181  50  89 603],145,5,326,4.0246913580246915,20.0,20.0
20081,2,81,[172 181  50  89 603],843,1,327,3.9878048780487805,20.0,20.0
20082,2,82,[ 50  89 174 187 603],686,5,332,4.0,20.0,40.0
20083,2,83,[ 50  89 187 174 603],650,4,336,4.0,20.0,40.0
20084,2,84,[ 50  89 174 603   1],387,5,341,4.011764705882353,20.0,40.0
20085,2,85,[ 50  89 174 603   1],664,5,346,4.023255813953488,20.0,40.0
20086,2,86,[ 50  89 174 603   1],883,4,350,4.022988505747127,20.0,40.0
20087,2,87,[168 195 546 483 318],313,4,354,4.0227272727272725,40.0,0.0
20088,2,88,[546 195 318 483  50],13,2,356,4.0,40.0,20.0
20089,2,89,[483  50  89 174 603],385,3,359,3.988888888888889,40.0,40.0
20090,2,90,[483  89  50 603 174],840,5,364,4.0,40.0,40.0
20091,2,91,[483  89  50 603 174],339,5,369,4.010869565217392,40.0,40.0
20092,2,92,[483  89  50 603 174],848,5,374,4.021505376344086,40.0,40.0
20093,2,93,[483  89  50 603 174],899,5,379,4.031914893617022,40.0,40.0
20094,2,94,[483  89  50 603 174],749,5,384,4.042105263157895,40.0,40.0
20095,2,95,[483  89  50 603 174],60,5,389,4.052083333333333,40.0,40.0
20096,2,96,[265 405 210  50 235],738,3,392,4.041237113402062,0.0,20.0
20097,2,97,[175 186 173 237 168],6,4,396,4.040816326530612,0.0,0.0
20098,2,98,[173 483 210  89  50],892,5,401,4.05050505050505,20.0,20.0
20099,2,99,[173 483 210  89  50],479,5,406,4.06,20.0,20.0
20100,2,100,[173 483 210  89  50],892,5,411,4.069306930693069,20.0,20.0
20101,2,101,[173 483 210  89  50],7,5,416,4.078431372549019,20.0,20.0
20102,2,102,[173 483 210  89  50],454,2,418,4.058252427184466,20.0,20.0
20103,2,103,[210  50  89 603 483],13,4,422,4.0576923076923075,40.0,20.0
20104,2,104,[ 50  89 483 603 174],899,5,427,4.066666666666666,40.0,40.0
20105,2,105,[ 50  89 483 603 174],454,3,430,4.056603773584905,40.0,40.0
20106,2,106,[ 50 603  89 174 183],749,5,435,4.065420560747664,20.0,40.0
20107,2,107,[ 50 603  89 174 183],848,4,439,4.064814814814815,20.0,40.0
20108,2,108,[ 50 603  89 174 483],239,5,444,4.073394495412844,40.0,40.0
20109,2,109,[ 50 603  89 174 483],659,4,448,4.072727272727272,40.0,40.0
20110,2,110,[ 50 603  89 174 483],474,5,453,4.081081081081081,40.0,40.0
20111,2,111,[ 50 603  89 174 483],454,3,456,4.071428571428571,40.0,40.0
20112,2,112,[ 50 603 174  89 187],643,4,460,4.070796460176991,20.0,40.0
20113,2,113,[ 50 603 174  89 187],59,5,465,4.078947368421052,20.0,40.0
20114,2,114,[ 50 603 174  89 187],776,5,470,4.086956521739131,20.0,40.0
20115,2,115,[ 50 603 174  89 187],650,4,474,4.086206896551724,20.0,40.0
20116,2,116,[ 50 603 174  89 496],815,4,478,4.085470085470085,20.0,40.0
20117,2,117,[ 50 603 174  89 496],659,4,482,4.084745762711864,20.0,40.0
20118,2,118,[ 50 603 174 496  89],312,5,487,4.092436974789916,20.0,40.0
20119,2,119,[ 50 603 174 496  89],409,5,492,4.1,20.0,40.0
20120,2,120,[ 50 603 174 496  89],666,3,495,4.090909090909091,20.0,40.0
20121,2,121,[603  50 496 174  89],334,4,499,4.090163934426229,20.0,40.0
20122,2,122,[603  50 174  89 185],848,4,503,4.0894308943089435,20.0,40.0
20123,2,123,[603  50 174  89 183],537,3,506,4.080645161290323,20.0,40.0
20124,2,124,[603  50 174  89   1],97,5,511,4.088,20.0,40.0
20125,2,125,[603  50 174  89   1],897,5,516,4.095238095238095,20.0,40.0
20126,2,126,[603  50  89 174   1],738,5,521,4.102362204724409,20.0,40.0
20127,2,127,[603  50  89 174   1],313,5,526,4.109375,20.0,40.0
20128,2,128,[603  50  89 174   1],537,3,529,4.10077519379845,20.0,40.0
20129,2,129,[603  50  89 174 187],7,5,534,4.107692307692307,20.0,40.0
20130,2,130,[603  50  89 174 187],326,4,538,4.106870229007634,20.0,40.0
20131,2,131,[194 143 202 204   8],6,2,540,4.090909090909091,0.0,0.0
20132,2,132,[194 603  50  89 174],239,5,545,4.097744360902255,20.0,40.0
20133,2,133,[194 603  50  89 174],13,5,550,4.104477611940299,20.0,40.0
20134,2,134,[194 603  50  89 174],899,5,555,4.111111111111111,20.0,40.0
20135,2,135,[194 603  50  89 174],776,5,560,4.117647058823529,20.0,40.0
20136,2,136,[405  70 200 483  64],60,5,565,4.124087591240876,20.0,0.0
20137,2,137,[435  50 181 603 276],474,5,570,4.130434782608695,20.0,20.0
20138,2,138,[195 216 161 153 257],804,5,575,4.136690647482014,0.0,0.0
20139,2,139,[276 153 435 194 200],385,1,576,4.114285714285714,0.0,0.0
20140,2,140,[ 70 257 153 216 603],308,4,580,4.113475177304965,20.0,0.0
20141,2,141,[ 70 257 153 603  50],659,3,583,4.105633802816901,20.0,20.0
20142,2,142,[153  70 603  50  89],643,3,586,4.0979020979020975,20.0,20.0
20143,2,143,[153 603  50  89 174],648,5,591,4.104166666666667,20.0,40.0
20144,2,144,[202 181 135  69   8],271,5,596,4.110344827586207,0.0,0.0
20145,2,145,[135 153 603  50  89],666,4,600,4.109589041095891,20.0,20.0
20146,2,146,[135 153 603  50  89],64,2,602,4.095238095238095,20.0,20.0
20147,2,147,[135 603  50 174  89],840,5,607,4.101351351351352,20.0,40.0
20148,2,148,[  1 515 265 161 153],804,5,612,4.10738255033557,0.0,0.0
20149,2,149,[135 603  50 174  89],385,2,614,4.093333333333334,20.0,40.0
20150,2,150,[603  50  89 174 153],452,5,619,4.099337748344371,20.0,40.0
20151,2,151,[603  50  89 174 153],234,2,621,4.0855263157894735,20.0,40.0
20152,2,152,[603  50 174  89   8],385,3,624,4.078431372549019,20.0,40.0
20153,2,153,[603  50  89 174   8],326,5,629,4.084415584415584,20.0,40.0
20154,2,154,[603  50  89   8 174],379,5,634,4.090322580645161,20.0,40.0
20155,2,155,[603  50  89   8 174],883,5,639,4.096153846153846,20.0,40.0
20156,2,156,[100 234 588 275 215],85,2,641,4.082802547770701,0.0,20.0
20157,2,157,[ 79  11 173  70 403],102,0,641,4.056962025316456,0.0,0.0
20158,2,158,[215 234 603  50   8],385,2,643,4.044025157232705,20.0,20.0
20159,2,159,[257 175 357  28 179],379,5,648,4.05,20.0,0.0
20160,2,160,[ 50  56 215  97   4],387,2,650,4.037267080745342,0.0,20.0
20161,2,161,[ 12 191 276 423 153],90,5,655,4.04320987654321,20.0,0.0
20162,2,162,[357  12  56 423 603],465,4,659,4.042944785276074,60.0,0.0
20163,2,163,[ 12 357  56 603  50],60,5,664,4.048780487804878,60.0,20.0
20164,2,164,[ 12 357  56 603  50],7,5,669,4.054545454545455,60.0,20.0
20165,2,165,[ 12 357  56 603  50],234,3,672,4.048192771084337,60.0,20.0
20166,2,166,[357 603  50   8  89],409,4,676,4.047904191616767,40.0,20.0
20167,2,167,[357 603  50  89 174],890,5,681,4.053571428571429,40.0,40.0
20168,2,168,[183 202 237 176 216],694,5,686,4.059171597633136,0.0,0.0
20169,2,169,[357 603  50  89 174],474,5,691,4.064705882352941,40.0,40.0
20170,2,170,[357 603  50  89 174],308,5,696,4.0701754385964914,40.0,40.0
20171,2,171,[357 603  50  89 174],379,5,701,4.075581395348837,40.0,40.0
20172,2,172,[357 603  50  89 174],379,5,706,4.08092485549133,40.0,40.0
20173,2,173,[357 603  50  89 174],659,4,710,4.080459770114943,40.0,40.0
20174,2,174,[357 603  89  50 174],537,4,714,4.08,40.0,40.0
20175,2,175,[357 603  89  50 174],848,5,719,4.0852272727272725,40.0,40.0
20176,2,176,[597  69 173 237 235],59,2,721,4.073446327683616,0.0,0.0
20177,2,177,[357 603  89  50 174],815,4,725,4.073033707865169,40.0,40.0
20178,2,178,[357 603  89  50 174],666,3,728,4.067039106145251,40.0,40.0
20179,2,179,[357 603  89  50 174],815,4,732,4.066666666666666,40.0,40.0
20180,2,180,[127  69 423 195 471],144,5,737,4.071823204419889,0.0,20.0
20181,2,181,[ 70  25 603 318 265],13,2,739,4.06043956043956,40.0,0.0
20182,2,182,[127 357 603  89  50],694,5,744,4.065573770491803,40.0,40.0
20183,2,183,[127 357 603  89  50],843,1,745,4.048913043478261,40.0,40.0
20184,2,184,[357 603  89  50 174],312,5,750,4.054054054054054,40.0,40.0
20185,2,185,[245 215 483 182  28],804,5,755,4.059139784946237,20.0,0.0
20186,2,186,[245 182 357 603  89],90,3,758,4.053475935828877,40.0,0.0
20187,2,187,[357 603  89  50 174],409,5,763,4.058510638297872,40.0,40.0
20188,2,188,[357 603  89  50 174],537,4,767,4.058201058201059,40.0,40.0
20189,2,189,[ 95 235 127  64 286],184,4,771,4.057894736842106,0.0,20.0
20190,2,190,[ 95 286 357 603  89],537,3,774,4.052356020942408,40.0,0.0
20191,2,191,[357 603  89  50 174],379,5,779,4.057291666666667,40.0,40.0
20192,2,192,[357 603  89  50 174],59,5,784,4.062176165803109,40.0,40.0
20193,2,193,[357 603  89  50 174],648,4,788,4.061855670103093,40.0,40.0
20194,2,194,[603 357  89  50 174],97,5,793,4.066666666666666,40.0,40.0
20195,2,195,[603 357  89  50 174],233,3,796,4.061224489795919,40.0,40.0
20196,2,196,[183 111 175 215  22],13,5,801,4.065989847715736,0.0,0.0
20197,2,197,[603 357  89  50 174],840,5,806,4.070707070707071,40.0,40.0
20198,2,198,[603 357  89  50 174],804,5,811,4.075376884422111,40.0,40.0
20199,2,199,[357 603  89  50 174],474,5,816,4.08,40.0,40.0
20200,2,200,[357 603  89  50 174],749,5,821,4.08457711442786,40.0,40.0
20201,2,201,[357 603  89  50 174],666,3,824,4.079207920792079,40.0,40.0
20202,2,202,[357 603  89  50 174],840,5,829,4.083743842364532,40.0,40.0
20203,2,203,[357 603  89  50 174],313,5,834,4.088235294117647,40.0,40.0
20204,2,204,[357 603  89  50 174],13,4,838,4.087804878048781,40.0,40.0
20205,2,205,[603 357  89  50 174],454,3,841,4.08252427184466,40.0,40.0
20206,2,206,[603  89  50 357 174],686,5,846,4.086956521739131,40.0,40.0
20207,2,207,[603  89 357  50 174],379,5,851,4.091346153846154,40.0,40.0
20208,2,208,[603  89 357  50 174],474,5,856,4.095693779904306,40.0,40.0
20209,2,209,[282 238 185 357 216],666,3,859,4.09047619047619,20.0,0.0
20210,2,210,[603  89 357  50 174],899,5,864,4.0947867298578196,40.0,40.0
20211,2,211,[603  89 357  50 174],312,5,869,4.099056603773585,40.0,40.0
20212,2,212,[603  89 357  50 174],339,5,874,4.103286384976526,40.0,40.0
20213,2,213,[603  89 357  50 174],409,5,879,4.107476635514018,40.0,40.0
20214,2,214,[603  89 357  50 174],97,5,884,4.111627906976744,40.0,40.0
20215,2,215,[603  89 357  50 174],643,4,888,4.111111111111111,40.0,40.0
20216,2,216,[603 357  89  50 174],474,5,893,4.11520737327189,40.0,40.0
20217,2,217,[603 357  89  50 174],379,5,898,4.1192660550458715,40.0,40.0
20218,2,218,[603 357  89  50 174],694,5,903,4.123287671232877,40.0,40.0
20219,2,219,[118 194  50 471  25],882,3,906,4.118181818181818,0.0,20.0
20220,2,220,[603 357  89  50 174],387,5,911,4.122171945701357,40.0,40.0
20221,2,221,[603 357  89  50 174],840,5,916,4.126126126126126,40.0,40.0
20222,2,222,[603 357  89  50 174],409,5,921,4.130044843049327,40.0,40.0
20223,2,223,[603 357  89  50 174],271,4,925,4.129464285714286,40.0,40.0
20224,2,224,[603 357  89  50 174],738,5,930,4.133333333333334,40.0,40.0
20225,2,225,[603 357  89  50 174],13,4,934,4.132743362831858,40.0,40.0
20226,2,226,[603 357  89  50 174],13,4,938,4.13215859030837,40.0,40.0
20227,2,227,[603  89  50 174 357],666,3,941,4.12719298245614,40.0,40.0
20228,2,228,[603  89  50 357 174],271,4,945,4.126637554585153,40.0,40.0
20229,2,229,[603  50  89 357 174],659,4,949,4.126086956521739,40.0,40.0
20230,2,230,[603  89 357  50 174],659,4,953,4.125541125541125,40.0,40.0
20231,2,231,[603  89 357 174  50],650,5,958,4.129310344827586,40.0,40.0
20232,2,232,[603 357  89 174  50],339,5,963,4.133047210300429,40.0,40.0
20233,2,233,[603 357  89 174  50],308,5,968,4.136752136752137,40.0,40.0
20234,2,234,[603 357  89 174  50],387,5,973,4.140425531914894,40.0,40.0
20235,2,235,[603 357  89 174  50],387,5,978,4.1440677966101696,40.0,40.0
20236,2,236,[603 357  89 174  50],13,4,982,4.143459915611814,40.0,40.0
20237,2,237,[235 191 322 357  95],308,3,985,4.138655462184874,20.0,0.0
20238,2,238,[603  89 357 174  50],749,5,990,4.142259414225942,40.0,40.0
20239,2,239,[603  89 357 174  50],271,4,994,4.141666666666667,40.0,40.0
20240,2,240,[603  89 357 174  50],890,5,999,4.145228215767635,40.0,40.0
20241,2,241,[603 357  89 174  50],848,5,1004,4.148760330578512,40.0,40.0
20242,2,242,[215 328  22 269 186],537,1,1005,4.135802469135802,0.0,0.0
20243,2,243,[603 357  89 174  50],650,5,1010,4.139344262295082,40.0,40.0
20244,2,244,[603 357  89 174  50],339,5,1015,4.142857142857143,40.0,40.0
20245,2,245,[603 357  89 174  50],694,5,1020,4.146341463414634,40.0,40.0
20246,2,246,[603 357  89 174  50],409,5,1025,4.149797570850202,40.0,40.0
20247,2,247,[603 357  89 174  50],59,5,1030,4.153225806451613,40.0,40.0
20248,2,248,[603 357  89 174  50],840,5,1035,4.156626506024097,40.0,40.0
20249,2,249,[603 357  89 174  50],387,5,1040,4.16,40.0,40.0
20250,2,250,[603 357  89 174  50],659,4,1044,4.159362549800797,40.0,40.0
20251,2,251,[603 357  89 174  50],890,5,1049,4.162698412698413,40.0,40.0
20252,2,252,[603 357  89 174  50],666,3,1052,4.158102766798419,40.0,40.0
20253,2,253,[603 357  89 174  50],840,5,1057,4.161417322834645,40.0,40.0
20254,2,254,[603 357  89 174  50],666,3,1060,4.1568627450980395,40.0,40.0
20255,2,255,[603 357  89 174  50],648,4,1064,4.15625,40.0,40.0
20256,2,256,[603  89 357 174  50],234,3,1067,4.151750972762646,40.0,40.0
20257,2,257,[603 357  89 174  50],13,4,1071,4.151162790697675,40.0,40.0
20258,2,258,[603  89 357 174  50],749,5,1076,4.154440154440154,40.0,40.0
20259,2,259,[603  89 357 174  50],848,5,1081,4.157692307692308,40.0,40.0
20260,2,260,[603  89 357 174  50],643,4,1085,4.157088122605364,40.0,40.0
20261,2,261,[603  89 357 174  50],385,3,1088,4.152671755725191,40.0,40.0
20262,2,262,[603  89 357  50 174],537,4,1092,4.152091254752852,40.0,40.0
20263,2,263,[ 97 197 286 183 603],59,4,1096,4.151515151515151,20.0,0.0
20264,2,264,[603 357  89  50 174],233,3,1099,4.1471698113207545,40.0,40.0
20265,2,265,[603 357  89  50 174],694,5,1104,4.150375939849624,40.0,40.0
20266,2,266,[603 357  89  50 174],643,4,1108,4.149812734082397,40.0,40.0
20267,2,267,[603 357  89  50 174],379,5,1113,4.152985074626866,40.0,40.0
20268,2,268,[603 357  89  50 174],60,5,1118,4.156133828996283,40.0,40.0
20269,2,269,[603 357  89  50 174],815,4,1122,4.155555555555556,40.0,40.0
20270,2,270,[603 357  89  50 174],97,5,1127,4.158671586715867,40.0,40.0
20271,2,271,[603 357  89  50 174],233,3,1130,4.154411764705882,40.0,40.0
20272,2,272,[603 357  89 174  50],233,3,1133,4.1501831501831505,40.0,40.0
20273,2,273,[603 357 174  89  50],650,5,1138,4.153284671532846,40.0,40.0
20274,2,274,[258 204 588 313 423],378,5,1143,4.156363636363636,0.0,0.0
20275,2,275,[ 69 603 496 197 186],848,3,1146,4.1521739130434785,20.0,0.0
20276,2,276,[385  95   9  89 111],64,4,1150,4.1516245487364625,0.0,0.0
20277,2,277,[258 385 313 603 357],738,5,1155,4.154676258992806,40.0,0.0
20278,2,278,[183 202   7 100 258],653,1,1156,4.14336917562724,0.0,20.0
20279,2,279,[313 385 603 357 174],59,5,1161,4.146428571428571,40.0,20.0
20280,2,280,[313 385 603 357 174],234,3,1164,4.142348754448399,40.0,20.0
20281,2,281,[313 603 357 174  89],537,4,1168,4.141843971631205,40.0,20.0
20282,2,282,[313 603 357  89 174],13,4,1172,4.141342756183746,40.0,20.0
20283,2,283,[603  70 197 228 403],59,4,1176,4.140845070422535,20.0,0.0
20284,2,284,[228 313 603 357  89],537,4,1180,4.140350877192983,40.0,0.0
20285,2,285,[313 603 357  89 174],308,4,1184,4.13986013986014,40.0,20.0
20286,2,286,[ 69 385 200  11 265],537,0,1184,4.125435540069686,0.0,0.0
20287,2,287,[603 357  89 174  50],804,5,1189,4.128472222222222,40.0,40.0
20288,2,288,[603 357  89 174  50],385,3,1192,4.124567474048443,40.0,40.0
20289,2,289,[603 357  89 174  50],899,5,1197,4.127586206896551,40.0,40.0
20290,2,290,[603 357  89 174  50],339,5,1202,4.130584192439863,40.0,40.0
20291,2,291,[603 357  89 174  50],659,4,1206,4.13013698630137,40.0,40.0
20292,2,292,[603 357  89 174 313],537,4,1210,4.129692832764505,40.0,20.0
20293,2,293,[172  98 300  25 121],85,2,1212,4.122448979591836,0.0,20.0
20294,2,294,[ 98 603 357 313  89],13,4,1216,4.122033898305085,40.0,20.0
20295,2,295,[ 98 603 357 313  89],13,4,1220,4.121621621621622,40.0,20.0
20296,2,296,[168 313 222  12 357],234,2,1222,4.114478114478114,40.0,0.0
20297,2,297,[202 117 405  88 210],653,2,1224,4.10738255033557,0.0,0.0
20298,2,298,[117  98 603 313 357],474,5,1229,4.110367892976589,40.0,20.0
20299,2,299,[117  98 603 313 357],533,4,1233,4.11,40.0,20.0
20300,2,300,[117  98 603 313 357],650,5,1238,4.112956810631229,40.0,20.0
20301,2,301,[117  98 603 313 357],234,4,1242,4.112582781456954,40.0,20.0
20302,2,302,[ 98 603 313 357  89],59,5,1247,4.115511551155116,40.0,20.0
20303,2,303,[ 98 603 313 357  89],90,5,1252,4.118421052631579,40.0,20.0
20304,2,304,[ 98 603 313 357  89],271,4,1256,4.118032786885246,40.0,20.0
20305,2,305,[ 98 603 313 357  89],659,5,1261,4.120915032679738,40.0,20.0
20306,2,306,[ 98 603 313 357  89],13,4,1265,4.120521172638436,40.0,20.0
20307,2,307,[ 98 603 313 357  89],271,4,1269,4.12012987012987,40.0,20.0
20308,2,308,[ 98 603 313 357  89],543,4,1273,4.119741100323624,40.0,20.0
20309,2,309,[ 98 603 313 357  89],90,5,1278,4.122580645161291,40.0,20.0
20310,2,310,[ 98 603 313 357  89],650,5,1283,4.12540192926045,40.0,20.0
20311,2,311,[ 98 603 313 357  89],890,5,1288,4.128205128205129,40.0,20.0
20312,2,312,[168 172 269 135 197],883,4,1292,4.127795527156549,0.0,0.0
20313,2,313,[ 98 603 313 357  89],454,2,1294,4.1210191082802545,40.0,20.0
20314,2,314,[603  98 313 357  89],454,2,1296,4.114285714285714,40.0,20.0
20315,2,315,[603 313  98 357 174],59,5,1301,4.117088607594937,40.0,40.0
20316,2,316,[603 313  98 357 174],308,3,1304,4.113564668769716,40.0,40.0
20317,2,317,[603 313 357 174  89],271,4,1308,4.113207547169812,40.0,20.0
20318,2,318,[238 275 435 183 173],648,4,1312,4.112852664576803,0.0,0.0
20319,2,319,[603 313 357 174 210],537,3,1315,4.109375,40.0,20.0
20320,2,320,[210 323 173 195 181],125,4,1319,4.109034267912772,0.0,0.0
20321,2,321,[603 313 357 186  50],650,5,1324,4.111801242236025,40.0,20.0
20322,2,322,[603 313 186 357  50],738,5,1329,4.114551083591332,40.0,20.0
20323,2,323,[143  96 483 182 202],840,4,1333,4.114197530864198,20.0,0.0
20324,2,324,[603 313 186 357 483],474,5,1338,4.116923076923077,60.0,0.0
20325,2,325,[603 313 186 357 483],308,3,1341,4.113496932515337,60.0,0.0
20326,2,326,[183 210 204   7 194],579,2,1343,4.107033639143731,0.0,0.0
20327,2,327,[186 435 185 403 144],833,2,1345,4.100609756097561,0.0,0.0
20328,2,328,[603 313 357  50 174],13,4,1349,4.100303951367781,40.0,40.0
20329,2,329,[603 313 357  50 174],669,4,1353,4.1,40.0,40.0
20330,2,330,[603 313 357  50  89],474,5,1358,4.102719033232629,40.0,20.0
20331,2,331,[603 313 357  50  89],890,5,1363,4.105421686746988,40.0,20.0
20332,2,332,[603 313 357  50  89],474,5,1368,4.108108108108108,40.0,20.0
20333,2,333,[603 313 357  50  89],659,4,1372,4.107784431137724,40.0,20.0
20334,2,334,[603 313 357  50  89],59,5,1377,4.11044776119403,40.0,20.0
20335,2,335,[603 313 357  50  89],474,5,1382,4.113095238095238,40.0,20.0
20336,2,336,[603 313 357  50  89],890,5,1387,4.115727002967359,40.0,20.0
20337,2,337,[603 313 357  50  89],234,4,1391,4.115384615384615,40.0,20.0
20338,2,338,[180 286  82 215 282],788,3,1394,4.112094395280236,0.0,0.0
20339,2,339,[273 118 144 748 597],102,0,1394,4.1,0.0,0.0
20340,2,340,[180 603 313 357  50],533,3,1397,4.096774193548387,40.0,20.0
20341,2,341,[603 313 357  50  89],271,4,1401,4.0964912280701755,40.0,20.0
20342,2,342,[603 313 357  50 174],234,4,1405,4.096209912536443,40.0,40.0
20343,2,343,[603 313 357  50  89],454,3,1408,4.093023255813954,40.0,20.0
20344,2,344,[ 89 508  64  97 181],387,3,1411,4.089855072463768,0.0,0.0
20345,2,345,[603 313 357  50 181],890,5,1416,4.092485549132948,40.0,20.0
20346,2,346,[603 313 181 357  50],454,3,1419,4.089337175792507,40.0,20.0
20347,2,347,[182  82 187 210  88],194,1,1420,4.080459770114943,0.0,0.0
20348,2,348,[603 313  50 357 174],454,4,1424,4.080229226361031,40.0,40.0
20349,2,349,[318 173  96 288 435],59,5,1429,4.082857142857143,20.0,0.0
20350,2,350,[603 313  50 357 174],14,3,1432,4.07977207977208,40.0,40.0
20351,2,351,[144 211 183 257 118],298,4,1436,4.079545454545454,0.0,0.0
20352,2,352,[135   4 176 273 286],387,2,1438,4.073654390934844,0.0,0.0
20353,2,353,[211 603 313  50 174],738,4,1442,4.073446327683616,20.0,40.0
20354,2,354,[603 313  50 174   8],454,5,1447,4.076056338028169,20.0,40.0
20355,2,355,[603 313  50   8 174],454,5,1452,4.078651685393258,20.0,40.0
20356,2,356,[603 313  50   8 174],308,4,1456,4.078431372549019,20.0,40.0
20357,2,357,[603 313  50   8 174],533,4,1460,4.078212290502793,20.0,40.0
20358,2,358,[603 313  50 174 357],454,4,1464,4.077994428969359,40.0,40.0
20359,2,359,[603 313  50 174  89],890,5,1469,4.080555555555556,20.0,40.0
20360,2,360,[603 313  50 174  89],334,5,1474,4.083102493074792,20.0,40.0
20361,2,361,[603 313  50 174  89],145,5,1479,4.085635359116022,20.0,40.0
20362,2,362,[603 313  50 174  89],234,3,1482,4.082644628099174,20.0,40.0
20363,2,363,[ 22 176 742 183 194],59,3,1485,4.079670329670329,0.0,0.0
20364,2,364,[603 313  50 174  89],271,4,1489,4.079452054794521,20.0,40.0
20365,2,365,[603 313  50 174 357],454,4,1493,4.079234972677596,40.0,40.0
20366,2,366,[603 313  50 174 135],883,4,1497,4.079019073569483,20.0,40.0
20367,2,367,[603 313  50 135 174],474,5,1502,4.081521739130435,20.0,40.0
20368,2,368,[603 313 135  50 174],91,5,1507,4.084010840108401,20.0,40.0
20369,2,369,[603 135 313  50 174],815,3,1510,4.081081081081081,20.0,40.0
20370,2,370,[603 313  50 174   1],883,3,1513,4.078167115902965,20.0,40.0
20371,2,371,[603  50 313 174 175],474,5,1518,4.080645161290323,20.0,40.0
20372,2,372,[603 313  50 175 174],64,4,1522,4.080428954423592,20.0,40.0
20373,2,373,[603 313 175  50 174],14,4,1526,4.080213903743315,20.0,40.0
20374,2,374,[603 175  50 313 174],738,5,1531,4.082666666666666,20.0,40.0
20375,2,375,[603 175  50 313 174],650,5,1536,4.085106382978723,20.0,40.0
20376,2,376,[603 175  50 313 174],59,5,1541,4.087533156498674,20.0,40.0
20377,2,377,[603 175  50 313 174],234,3,1544,4.084656084656085,20.0,40.0
20378,2,378,[603  50 313 174  98],233,4,1548,4.084432717678101,20.0,60.0
20379,2,379,[603  50 313 174  98],233,4,1552,4.08421052631579,20.0,60.0
20380,2,380,[603 313  50 174  98],59,5,1557,4.086614173228346,20.0,60.0
20381,2,381,[546 185 216 143   7],648,4,1561,4.0863874345549736,0.0,0.0
20382,2,382,[204 180 175   4 195],659,4,1565,4.0861618798955615,0.0,0.0
20383,2,383,[180 275 127 282 100],406,3,1568,4.083333333333333,0.0,40.0
20384,2,384,[603 313  50  98 174],780,3,1571,4.080519480519481,20.0,60.0
20385,2,385,[603 313  50 174 175],59,5,1576,4.082901554404145,20.0,40.0
20386,2,386,[603 313  50 175 174],883,4,1580,4.082687338501292,20.0,40.0
20387,2,387,[603  50 175 313 174],669,4,1584,4.082474226804123,20.0,40.0
20388,2,388,[603 175  50 313 174],537,4,1588,4.082262210796915,20.0,40.0
20389,2,389,[ 98 288 121 294  96],102,1,1589,4.074358974358974,0.0,20.0
20390,2,390,[603 175  50 313 174],59,5,1594,4.076726342710997,20.0,40.0
20391,2,391,[  7 210  97 186  88],659,2,1596,4.071428571428571,0.0,0.0
20392,2,392,[483 185 187 204   4],385,3,1599,4.068702290076335,20.0,0.0
20393,2,393,[603 175  50 313 174],659,4,1603,4.068527918781726,20.0,40.0
20394,2,394,[186 471 182 235  89],13,3,1606,4.065822784810127,0.0,0.0
20395,2,395,[603 175 313  50 174],64,4,1610,4.065656565656566,20.0,40.0
20396,2,396,[603 175 313  50 174],308,4,1614,4.065491183879093,20.0,40.0
20397,2,397,[568 175 180 385 282],788,2,1616,4.060301507537688,0.0,0.0
20398,2,398,[603  50 313 175 174],659,4,1620,4.06015037593985,20.0,40.0
20399,2,399,[603  50 175 313 174],883,4,1624,4.06,20.0,40.0
20400,2,400,[603 175  50 174 313],308,4,1628,4.059850374064838,20.0,40.0
20401,2,401,[603 175  50 174 313],59,5,1633,4.062189054726368,20.0,40.0
20402,2,402,[603 175  50 174 313],189,4,1637,4.062034739454094,20.0,40.0
20403,2,403,[603 175  50 174  89],659,4,1641,4.061881188118812,20.0,40.0
20404,2,404,[603 175  50 174  89],64,3,1644,4.059259259259259,20.0,40.0
20405,2,405,[603 175  50 174  89],648,4,1648,4.059113300492611,20.0,40.0
20406,2,406,[603  50 175 174  89],60,5,1653,4.061425061425061,20.0,40.0
20407,2,407,[603  50 175 174  89],60,5,1658,4.063725490196078,20.0,40.0
20408,2,408,[197 125 301 194  69],6,2,1660,4.058679706601467,0.0,0.0
20409,2,409,[603 175  50 174  89],815,3,1663,4.056097560975609,20.0,40.0
20410,2,410,[603  50 174  89 175],804,5,1668,4.0583941605839415,20.0,40.0
20411,2,411,[603  50 174 175  89],239,5,1673,4.060679611650485,20.0,40.0
20412,2,412,[603  50 174 175  89],379,5,1678,4.062953995157385,20.0,40.0
20413,2,413,[603  50 174 175  89],409,5,1683,4.065217391304348,20.0,40.0
20414,2,414,[151 471 211 196 423],882,5,1688,4.067469879518073,0.0,0.0
20415,2,415,[603  50 174 175  89],326,4,1692,4.0673076923076925,20.0,40.0
20416,2,416,[603  50 174  89 357],385,3,1695,4.0647482014388485,40.0,40.0
20417,2,417,[603  50 174  89 357],7,5,1700,4.0669856459330145,40.0,40.0
20418,2,418,[603  50 174  89 357],815,4,1704,4.066825775656325,40.0,40.0
20419,2,419,[603  50 174  89 357],97,5,1709,4.069047619047619,40.0,40.0
20420,2,420,[603  50 174  89 357],738,5,1714,4.07125890736342,40.0,40.0
20421,2,421,[603  50 174  89 357],234,3,1717,4.068720379146919,40.0,40.0
20422,2,422,[603  50 174  89 357],659,4,1721,4.06855791962175,40.0,40.0
20423,2,423,[435 496 202 216 475],648,4,1725,4.068396226415095,0.0,0.0
20424,2,424,[603  50 174  89 357],60,5,1730,4.070588235294117,40.0,40.0
20425,2,425,[603  50 174  89 357],97,5,1735,4.072769953051643,40.0,40.0
20426,2,426,[603  50 174  89 357],387,5,1740,4.074941451990632,40.0,40.0
20427,2,427,[603  50 174  89 357],387,5,1745,4.077102803738318,40.0,40.0
20428,2,428,[603  50 174  89 357],313,5,1750,4.0792540792540795,40.0,40.0
20429,2,429,[603  50 174  89 357],233,3,1753,4.076744186046511,40.0,40.0
20430,2,430,[603  50 174 357  89],843,2,1755,4.071925754060325,40.0,40.0
20431,2,431,[515 228 313  11  95],455,4,1759,4.0717592592592595,0.0,0.0
20432,2,432,[603 174  50  89 357],13,4,1763,4.071593533487298,40.0,40.0
20433,2,433,[ 11 603 271  98   4],64,2,1765,4.066820276497696,20.0,20.0
20434,2,434,[603 174  50  89 313],738,5,1770,4.068965517241379,20.0,40.0
20435,2,435,[603 174  50  89 313],13,5,1775,4.071100917431193,20.0,40.0
20436,2,436,[603 174  50  89 313],13,5,1780,4.073226544622425,20.0,40.0
20437,2,437,[603 174  50  89 313],537,4,1784,4.073059360730594,20.0,40.0
20438,2,438,[603  50 174  89 313],234,3,1787,4.070615034168565,20.0,40.0
20439,2,439,[471 200 191 228  98],343,4,1791,4.070454545454545,0.0,20.0
20440,2,440,[603  50 174 313  89],59,5,1796,4.072562358276644,20.0,40.0
20441,2,441,[603  50 174 313  89],308,4,1800,4.072398190045249,20.0,40.0
20442,2,442,[603  50 174  89  98],13,5,1805,4.074492099322799,20.0,60.0
20443,2,443,[603  50 174  98  89],897,5,1810,4.076576576576577,20.0,60.0
20444,2,444,[603  50 174  98  89],271,4,1814,4.076404494382023,20.0,60.0
20445,2,445,[603  50 174  98  89],897,5,1819,4.07847533632287,20.0,60.0
20446,2,446,[603  50  98 174  89],643,3,1822,4.076062639821029,20.0,60.0
20447,2,447,[603  50 174 191  89],97,5,1827,4.078125,20.0,40.0
20448,2,448,[603  50 174 191  89],776,5,1832,4.080178173719377,20.0,40.0
20449,2,449,[603  50 174 191  89],474,5,1837,4.082222222222223,20.0,40.0
20450,2,450,[603  50 191 174  89],339,5,1842,4.0842572062084255,20.0,40.0
20451,2,451,[603 191  50 174  89],452,5,1847,4.086283185840708,20.0,40.0
20452,2,452,[603 191  50 174  89],480,5,1852,4.088300220750551,20.0,40.0
20453,2,453,[603 191  50 174  89],524,4,1856,4.0881057268722465,20.0,40.0
20454,2,454,[603 191  50 174  89],738,5,1861,4.09010989010989,20.0,40.0
20455,2,455,[603 191  50 174  89],97,5,1866,4.092105263157895,20.0,40.0
20456,2,456,[603 191  50 174  89],524,4,1870,4.091903719912473,20.0,40.0
20457,2,457,[313 135  64 111 121],145,3,1873,4.0895196506550215,0.0,0.0
20458,2,458,[603 191  50 174  89],64,3,1876,4.087145969498911,20.0,40.0
20459,2,459,[603 191  50 174  89],387,5,1881,4.089130434782609,20.0,40.0
20460,2,460,[588   8   4 322  11],13,3,1884,4.086767895878525,0.0,0.0
20461,2,461,[603 191  50 174  89],650,5,1889,4.088744588744588,20.0,40.0
20462,2,462,[  8  98 117 597 125],92,4,1893,4.088552915766739,0.0,20.0
20463,2,463,[176 127 186 195 187],59,5,1898,4.0905172413793105,0.0,20.0
20464,2,464,[603 191  50 174  89],537,4,1902,4.090322580645161,20.0,40.0
20465,2,465,[603 191  50 174  89],312,5,1907,4.092274678111588,20.0,40.0
20466,2,466,[603 191  50 174  89],666,3,1910,4.089935760171306,20.0,40.0
20467,2,467,[603 191  50 174  89],385,2,1912,4.085470085470085,20.0,40.0
20468,2,468,[603 191  50 174  89],686,5,1917,4.087420042643923,20.0,40.0
20469,2,469,[603 191  50 174  89],409,5,1922,4.089361702127659,20.0,40.0
20470,2,470,[603 191  50 174  89],553,5,1927,4.091295116772824,20.0,40.0
20471,2,471,[603 191  50 174  89],480,5,1932,4.093220338983051,20.0,40.0
20472,2,472,[603 191  50 174  89],749,5,1937,4.0951374207188165,20.0,40.0
20473,2,473,[603 191  50 174  89],694,5,1942,4.09704641350211,20.0,40.0
20474,2,474,[603 191  50 174  89],686,5,1947,4.098947368421053,20.0,40.0
20475,2,475,[603 191  50 174  89],7,5,1952,4.100840336134453,20.0,40.0
20476,2,476,[603 191  50 174  89],339,5,1957,4.10272536687631,20.0,40.0
20477,2,477,[603 191  50 174  89],848,5,1962,4.104602510460251,20.0,40.0
20478,2,478,[603 191  50 174  89],7,5,1967,4.106471816283925,20.0,40.0
20479,2,479,[603 191  50 174  89],506,5,1972,4.108333333333333,20.0,40.0
20480,2,480,[603 191  50 174  89],97,5,1977,4.11018711018711,20.0,40.0
20481,2,481,[603 191  50 174  89],312,5,1982,4.1120331950207465,20.0,40.0
20482,2,482,[603 191  50 174  89],189,5,1987,4.113871635610766,20.0,40.0
20483,2,483,[603 191  50 174  89],694,5,1992,4.115702479338843,20.0,40.0
20484,2,484,[603 191  50 174  89],648,5,1997,4.117525773195876,20.0,40.0
20485,2,485,[603 191  50 174  89],385,2,1999,4.113168724279835,20.0,40.0
20486,2,486,[603 191  50 174  89],506,5,2004,4.114989733059549,20.0,40.0
20487,2,487,[603 191  50 174  89],738,5,2009,4.116803278688525,20.0,40.0
20488,2,488,[  9  25 385 168   1],59,4,2013,4.116564417177914,0.0,0.0
20489,2,489,[603 191  50 174  89],480,5,2018,4.118367346938776,20.0,40.0
20490,2,490,[603 191  50 174  89],738,5,2023,4.120162932790224,20.0,40.0
20491,2,491,[603 191  50 174  89],271,4,2027,4.119918699186992,20.0,40.0
20492,2,492,[603 191  50 174  89],64,3,2030,4.117647058823529,20.0,40.0
20493,2,493,[603 191  50 174  89],537,4,2034,4.117408906882591,20.0,40.0
20494,2,494,[603 191  50 174  89],480,5,2039,4.119191919191919,20.0,40.0
20495,2,495,[603 191  50 174  89],334,5,2044,4.120967741935484,20.0,40.0
20496,2,496,[603 191  50 174  89],804,5,2049,4.122736418511066,20.0,40.0
20497,2,497,[603 191  50 174  89],804,5,2054,4.124497991967871,20.0,40.0
20498,2,498,[603 191  50 174  89],749,5,2059,4.12625250501002,20.0,40.0
20499,2,499,[603 191  50 174  89],308,5,2064,4.128,20.0,40.0
20500,2,500,[603 191  50 174  89],97,5,2069,4.129740518962076,20.0,40.0
20501,2,501,[603 191  50 174  89],59,5,2074,4.131474103585657,20.0,40.0
20502,2,502,[603 191  50 174  89],271,4,2078,4.131212723658051,20.0,40.0
20503,2,503,[603 191  50 174  89],480,5,2083,4.132936507936508,20.0,40.0
20504,2,504,[603 191  50 174  89],843,2,2085,4.128712871287129,20.0,40.0
20505,2,505,[603 191  50 174  89],537,4,2089,4.128458498023716,20.0,40.0
20506,2,506,[357 234  71  56 185],488,4,2093,4.128205128205129,20.0,0.0
20507,2,507,[ 71 168 185 181 204],374,3,2096,4.125984251968504,0.0,0.0
20508,2,508,[603 191  50 174  89],334,5,2101,4.12770137524558,20.0,40.0
20509,2,509,[187 211  95 132 118],749,2,2103,4.123529411764705,0.0,0.0
20510,2,510,[132 603 191  50 174],815,4,2107,4.123287671232877,20.0,40.0
20511,2,511,[132 603 191  50 174],536,5,2112,4.125,20.0,40.0
20512,2,512,[271 742 161 245 118],749,3,2115,4.12280701754386,0.0,0.0
20513,2,513,[132 603 191  50 174],804,5,2120,4.124513618677042,20.0,40.0
20514,2,514,[132 603 191  50 174],840,5,2125,4.12621359223301,20.0,40.0
20515,2,515,[132 603 191  50 174],749,5,2130,4.127906976744186,20.0,40.0
20516,2,516,[132 603 191  50 174],13,4,2134,4.127659574468085,20.0,40.0
20517,2,517,[132 603 191  50 174],308,4,2138,4.127413127413128,20.0,40.0
20518,2,518,[603 191  50 174 132],398,5,2143,4.129094412331407,20.0,40.0
20519,2,519,[603 191  50 132 174],7,5,2148,4.130769230769231,20.0,40.0
20520,2,520,[603 191 132  50 174],650,5,2153,4.132437619961612,20.0,40.0
20521,2,521,[ 64  79 161 204 117],83,5,2158,4.134099616858237,0.0,0.0
20522,2,522,[603 191 132  50 174],666,3,2161,4.131931166347992,20.0,40.0
20523,2,523,[603 191 132  50 174],452,4,2165,4.1316793893129775,20.0,40.0
20524,2,524,[603 191  50 174  89],815,4,2169,4.131428571428572,20.0,40.0
20525,2,525,[603 191  50 174  89],749,5,2174,4.133079847908745,20.0,40.0
20526,2,526,[603 191  50 174  89],848,5,2179,4.1347248576850095,20.0,40.0
20527,2,527,[603 191  50 174  89],308,5,2184,4.136363636363637,20.0,40.0
20528,2,528,[603 191  50 174  89],506,5,2189,4.137996219281663,20.0,40.0
20529,2,529,[603 191  50 174  89],537,4,2193,4.137735849056604,20.0,40.0
20530,2,530,[603 191  50 174  89],694,5,2198,4.139359698681733,20.0,40.0
20531,2,531,[603 191  50 174  89],271,4,2202,4.139097744360902,20.0,40.0
20532,2,532,[603 191  50 174  89],385,2,2204,4.135084427767355,20.0,40.0
20533,2,533,[603 191  50 174  89],474,5,2209,4.1367041198501875,20.0,40.0
20534,2,534,[603 191  50 174  89],553,5,2214,4.138317757009346,20.0,40.0
20535,2,535,[603 191  50 174  89],189,5,2219,4.139925373134329,20.0,40.0
20536,2,536,[603 191  50 174  89],664,4,2223,4.139664804469274,20.0,40.0
20537,2,537,[603 191  50 174  89],474,5,2228,4.141263940520446,20.0,40.0
20538,2,538,[603 191  50 174  89],452,5,2233,4.142857142857143,20.0,40.0
20539,2,539,[603 191  50 174  89],409,5,2238,4.144444444444445,20.0,40.0
20540,2,540,[603 191  50 174  89],409,5,2243,4.146025878003697,20.0,40.0
20541,2,541,[603 191  50 174  89],840,5,2248,4.14760147601476,20.0,40.0
20542,2,542,[222 258 174  88 196],537,1,2249,4.141804788213628,0.0,20.0
20543,2,543,[603 191  50 174  89],7,5,2254,4.143382352941177,20.0,40.0
20544,2,544,[603 191  50 174  89],480,5,2259,4.144954128440367,20.0,40.0
20545,2,545,[603 191  50 174  89],271,4,2263,4.144688644688645,20.0,40.0
20546,2,546,[603 191  50 174  89],537,4,2267,4.144424131627057,20.0,40.0
20547,2,547,[603 191  50 174  89],59,5,2272,4.145985401459854,20.0,40.0
20548,2,548,[603 191  50 174  89],648,5,2277,4.147540983606557,20.0,40.0
20549,2,549,[603 191  50 174  89],339,5,2282,4.149090909090909,20.0,40.0
20550,2,550,[603 191  50 174  89],686,5,2287,4.150635208711433,20.0,40.0
20551,2,551,[603 191  50 174  89],334,5,2292,4.1521739130434785,20.0,40.0
20552,2,552,[603 191  50 174  89],59,5,2297,4.15370705244123,20.0,40.0
20553,2,553,[603 191  50 174  89],553,5,2302,4.155234657039712,20.0,40.0
20554,2,554,[603 191  50 174  89],659,4,2306,4.154954954954955,20.0,40.0
20555,2,555,[603 191  50 174  89],666,3,2309,4.152877697841727,20.0,40.0
20556,2,556,[603 191  50 174  89],234,3,2312,4.1508078994614,20.0,40.0
20557,2,557,[603 191  50 174  89],553,5,2317,4.152329749103942,20.0,40.0
20558,2,558,[483  82  89 180 515],7,3,2320,4.150268336314848,20.0,0.0
20559,2,559,[603 191  50 174  89],664,4,2324,4.15,20.0,40.0
20560,2,560,[204 183 385 234 121],455,4,2328,4.149732620320855,0.0,0.0
20561,2,561,[603 191  50 174  89],233,3,2331,4.147686832740214,20.0,40.0
20562,2,562,[603 191  50 174  89],313,5,2336,4.149200710479573,20.0,40.0
20563,2,563,[603 191  50 174  89],694,5,2341,4.150709219858156,20.0,40.0
20564,2,564,[603 191  50 174  89],387,5,2346,4.152212389380531,20.0,40.0
20565,2,565,[603 191  50 174  89],843,2,2348,4.148409893992933,20.0,40.0
20566,2,566,[603 191  50 174  89],189,5,2353,4.149911816578483,20.0,40.0
20567,2,567,[204 216 161 597 286],653,4,2357,4.149647887323944,0.0,0.0
20568,2,568,[603 191  50 174  89],480,5,2362,4.151142355008787,20.0,40.0
20569,2,569,[603 191  50 174  89],13,4,2366,4.150877192982456,20.0,40.0
20570,2,570,[568 196 423 172 742],374,2,2368,4.147110332749562,0.0,0.0
20571,2,571,[245  89 435 235 194],102,1,2369,4.141608391608392,0.0,0.0
20572,2,572,[603 191  50 174  89],334,5,2374,4.143106457242583,20.0,40.0
20573,2,573,[603 191  50 174  89],454,4,2378,4.142857142857143,20.0,40.0
20574,2,574,[603 191  50 174  89],271,4,2382,4.142608695652174,20.0,40.0
20575,2,575,[603 191  50 174  89],648,5,2387,4.144097222222222,20.0,40.0
20576,2,576,[603 191  50 174  89],454,4,2391,4.143847487001733,20.0,40.0
20577,2,577,[603 191  50 174  89],648,5,2396,4.145328719723183,20.0,40.0
20578,2,578,[603 191  50 174  89],776,5,2401,4.146804835924007,20.0,40.0
20579,2,579,[603 191  50 174  89],233,3,2404,4.144827586206897,20.0,40.0
20580,2,580,[603 191  50 174 185],48,5,2409,4.146299483648881,20.0,40.0
20581,2,581,[603 191  50 174 185],452,5,2414,4.147766323024055,20.0,40.0
20582,2,582,[603 191  50 185 174],339,5,2419,4.149228130360206,20.0,40.0
20583,2,583,[273  25 185 269 288],13,0,2419,4.142123287671233,0.0,0.0
20584,2,584,[603 191  50 174  89],189,5,2424,4.143589743589744,20.0,40.0
20585,2,585,[603 191  50 174  89],659,4,2428,4.143344709897611,20.0,40.0
20586,2,586,[603 191  50 174  89],233,3,2431,4.141396933560477,20.0,40.0
20587,2,587,[603 191  50 174  89],313,5,2436,4.142857142857143,20.0,40.0
20588,2,588,[603 191  50 174  89],650,5,2441,4.144312393887946,20.0,40.0
20589,2,589,[603 191  50 174  89],843,2,2443,4.140677966101695,20.0,40.0
20590,2,590,[238 144 143 496  97],194,3,2446,4.138747884940778,0.0,0.0
20591,2,591,[603 191  50 174  89],738,5,2451,4.140202702702703,20.0,40.0
20592,2,592,[603 191  50 174  89],776,5,2456,4.141652613827993,20.0,40.0
20593,2,593,[603 191  50 174  89],840,5,2461,4.143097643097643,20.0,40.0
20594,2,594,[603 191  50 174  89],233,3,2464,4.141176470588236,20.0,40.0
20595,2,595,[228   7 678 496 196],334,3,2467,4.139261744966443,0.0,0.0
20596,2,596,[603 191 174  50  89],334,5,2472,4.14070351758794,20.0,40.0
20597,2,597,[603 191 174  50  89],409,5,2477,4.142140468227424,20.0,40.0
20598,2,598,[ 71 235 174 172 187],897,4,2481,4.141903171953255,0.0,20.0
20599,2,599,[603 191 174  50  89],776,5,2486,4.1433333333333335,20.0,40.0
20600,2,600,[603 191 174  50  89],334,5,2491,4.144758735440932,20.0,40.0
20601,2,601,[603 191 174  50  89],664,4,2495,4.144518272425249,20.0,40.0
20602,2,602,[603 191 174  50  89],843,2,2497,4.140961857379768,20.0,40.0
20603,2,603,[603 191 174  50  89],648,5,2502,4.142384105960265,20.0,40.0
20604,2,604,[603 191 174  50  89],474,5,2507,4.143801652892562,20.0,40.0
20605,2,605,[603 191 174  50  89],537,4,2511,4.143564356435643,20.0,40.0
20606,2,606,[603 191 174  50  89],776,5,2516,4.14497528830313,20.0,40.0
20607,2,607,[603 191 174  50  89],738,5,2521,4.146381578947368,20.0,40.0
20608,2,608,[603 191 174  50  89],840,5,2526,4.147783251231527,20.0,40.0
20609,2,609,[603 191 174  50  89],334,5,2531,4.149180327868852,20.0,40.0
20610,2,610,[288 121 135 257  96],378,3,2534,4.147299509001637,0.0,0.0
20611,2,611,[603 191 174  50  89],686,5,2539,4.148692810457517,20.0,40.0
20612,2,612,[603 191 174  50  89],553,5,2544,4.150081566068516,20.0,40.0
20613,2,613,[603 191 174  50  89],738,5,2549,4.151465798045603,20.0,40.0
20614,2,614,[603 191 174  50  89],339,5,2554,4.152845528455285,20.0,40.0
20615,2,615,[603 191 174  50  89],334,5,2559,4.154220779220779,20.0,40.0
20616,2,616,[603 191 174  50  89],271,4,2563,4.153970826580227,20.0,40.0
20617,2,617,[603 191 174  50  89],848,5,2568,4.155339805825243,20.0,40.0
20618,2,618,[603 191 174  50  89],840,5,2573,4.156704361873991,20.0,40.0
20619,2,619,[603 191 174  50  89],738,5,2578,4.158064516129032,20.0,40.0
20620,2,620,[175 196 403 546 183],653,0,2578,4.151368760064412,0.0,0.0
20621,2,621,[603 191 174  50  89],387,5,2583,4.152733118971061,20.0,40.0
20622,2,622,[603 191 174  50  89],815,4,2587,4.152487961476726,20.0,40.0
20623,2,623,[603 191 174  50  89],694,5,2592,4.153846153846154,20.0,40.0
20624,2,624,[603 191 174  50  89],312,5,2597,4.1552,20.0,40.0
20625,2,625,[603 191 174  50  89],64,3,2600,4.15335463258786,20.0,40.0
20626,2,626,[603 191 174  50  89],387,5,2605,4.154704944178628,20.0,40.0
20627,2,627,[603 191 174  50  89],843,2,2607,4.151273885350318,20.0,40.0
20628,2,628,[ 79 483 132 318 286],200,5,2612,4.152623211446741,40.0,0.0
20629,2,629,[603 191 174  50  89],312,5,2617,4.153968253968254,20.0,40.0
20630,2,630,[  7 258  56  64 282],145,5,2622,4.155309033280507,0.0,0.0
20631,2,631,[603 191 174  50  89],738,5,2627,4.156645569620253,20.0,40.0
20632,2,632,[603 191 174  50  89],409,5,2632,4.1579778830963665,20.0,40.0
20633,2,633,[603 191 174  50  89],233,3,2635,4.15615141955836,20.0,40.0
20634,2,634,[603 191 174  50  89],815,4,2639,4.1559055118110235,20.0,40.0
20635,2,635,[603 191 174  50  89],804,5,2644,4.1572327044025155,20.0,40.0
20636,2,636,[603 191 174  50  89],848,5,2649,4.158555729984301,20.0,40.0
20637,2,637,[603 191 174  50  89],334,5,2654,4.15987460815047,20.0,40.0
20638,2,638,[603 191 174  50  89],13,4,2658,4.15962441314554,20.0,40.0
20639,2,639,[603 191 174  50  89],664,4,2662,4.159375,20.0,40.0
20640,2,640,[603 191 174  50  89],233,3,2665,4.157566302652106,20.0,40.0
20641,2,641,[302 546 117 210 496],605,2,2667,4.154205607476635,0.0,0.0
20642,2,642,[282  98  88 655 234],95,4,2671,4.153965785381026,0.0,20.0
20643,2,643,[655 302 603 191 174],13,4,2675,4.153726708074534,20.0,20.0
20644,2,644,[655 302 603 191 174],537,3,2678,4.151937984496124,20.0,20.0
20645,2,645,[183  50 215 403 135],749,5,2683,4.1532507739938085,0.0,20.0
20646,2,646,[153  50 196 588  64],85,3,2686,4.151468315301391,0.0,20.0
20647,2,647,[302 603 191 174  50],271,5,2691,4.152777777777778,20.0,40.0
20648,2,648,[302 603 191 174  50],48,5,2696,4.154083204930663,20.0,40.0
20649,2,649,[302 603 191 174  50],454,5,2701,4.155384615384615,20.0,40.0
20650,2,650,[ 98 179 153 273 144],10,5,2706,4.15668202764977,0.0,20.0
20651,2,651,[ 70 200 216 235 508],334,1,2707,4.151840490797546,0.0,0.0
20652,2,652,[302 603 191 174  50],666,3,2710,4.150076569678407,20.0,40.0
20653,2,653,[748 183 234 195 180],311,5,2715,4.151376146788991,0.0,0.0
20654,2,654,[302 603 191 174  50],474,5,2720,4.152671755725191,20.0,40.0
20655,2,655,[  1 423 483  64  95],380,3,2723,4.150914634146342,20.0,0.0
20656,2,656,[ 71 496 286 174  28],533,5,2728,4.15220700152207,0.0,20.0
20657,2,657,[546 597   7 216 475],13,0,2728,4.145896656534954,0.0,0.0
20658,2,658,[302 603 191 174  50],271,5,2733,4.147192716236722,20.0,40.0
20659,2,659,[302 603 191 174  50],13,4,2737,4.1469696969696965,20.0,40.0
20660,2,660,[ 82  28 176 202 403],374,3,2740,4.145234493192133,0.0,0.0
20661,2,661,[302 603 191 174  50],271,5,2745,4.146525679758308,20.0,40.0
20662,2,662,[302 603 191 174  50],14,5,2750,4.1478129713423835,20.0,40.0
20663,2,663,[302 603 191 174  50],537,4,2754,4.147590361445783,20.0,40.0
20664,2,664,[302 603 191 174  50],339,5,2759,4.148872180451128,20.0,40.0
20665,2,665,[515 173 385  96 135],60,5,2764,4.15015015015015,0.0,0.0
20666,2,666,[302 603 191 174  50],669,3,2767,4.148425787106447,20.0,40.0
20667,2,667,[302 603 191 174  50],524,4,2771,4.1482035928143715,20.0,40.0
20668,2,668,[302 603 191 174  50],537,4,2775,4.147982062780269,20.0,40.0
20669,2,669,[302 603 191  50 174],48,5,2780,4.149253731343284,20.0,40.0
20670,2,670,[302 603 191  50 174],13,4,2784,4.14903129657228,20.0,40.0
20671,2,671,[183 271  97 302 216],13,3,2787,4.147321428571429,0.0,0.0
20672,2,672,[185 181 275 318 180],537,4,2791,4.147102526002972,20.0,0.0
20673,2,673,[302 603 191  50 174],458,3,2794,4.14540059347181,20.0,40.0
20674,2,674,[302 603 191  50 174],524,4,2798,4.145185185185185,20.0,40.0
20675,2,675,[302 603 191  50 174],334,5,2803,4.146449704142012,20.0,40.0
20676,2,676,[202 405   4 333 275],537,1,2804,4.141802067946824,0.0,0.0
20677,2,677,[302 603 191  50 174],14,5,2809,4.14306784660767,20.0,40.0
20678,2,678,[302 603 191  50 174],334,5,2814,4.144329896907217,20.0,40.0
20679,2,679,[302 603 191  50 174],10,5,2819,4.145588235294118,20.0,40.0
20680,2,680,[172 204 475 271 405],119,5,2824,4.146842878120411,0.0,0.0
20681,2,681,[100 228 597 313  64],653,5,2829,4.148093841642229,0.0,20.0
20682,2,682,[ 71 175 161 546 204],749,2,2831,4.144948755490483,0.0,0.0
20683,2,683,[302 603 191  50 174],458,3,2834,4.143274853801169,20.0,40.0
20684,2,684,[302 603 191  50 174],458,3,2837,4.141605839416059,20.0,40.0
20685,2,685,[ 71  96 173 273 515],59,3,2840,4.139941690962099,0.0,0.0
20686,2,686,[302 603 191  50 174],669,3,2843,4.138282387190684,20.0,40.0
20687,2,687,[302 603 191  50 174],524,4,2847,4.138081395348837,20.0,40.0
20688,2,688,[302 603 191  50 174],480,5,2852,4.13933236574746,20.0,40.0
20689,2,689,[ 11 185 202 496 234],749,5,2857,4.1405797101449275,0.0,0.0
20690,2,690,[302 603 191  50 174],480,5,2862,4.141823444283647,20.0,40.0
20691,2,691,[302 603 191  50 174],664,4,2866,4.141618497109826,20.0,40.0
20692,2,692,[302 603 191  50 174],524,4,2870,4.141414141414141,20.0,40.0
20693,2,693,[302 603 191  50 174],474,5,2875,4.142651296829971,20.0,40.0
20694,2,694,[302 603 191  50 174],480,5,2880,4.143884892086331,20.0,40.0
20695,2,695,[302 603 191  50 174],474,5,2885,4.1451149425287355,20.0,40.0
20696,2,696,[ 56 403  89  28   9],308,4,2889,4.144906743185079,0.0,0.0
20697,2,697,[302 603 191  50 174],480,5,2894,4.1461318051575935,20.0,40.0
20698,2,698,[302 603 191  50 174],13,4,2898,4.145922746781116,20.0,40.0
20699,2,699,[301 187   4 289 135],234,4,2902,4.145714285714286,0.0,0.0
20700,2,700,[132 496 423   1  69],254,4,2906,4.1455064194008555,0.0,0.0
20701,2,701,[403  79 172 471 118],479,3,2909,4.143874643874644,0.0,0.0
20702,2,702,[289 302 603 191  50],271,5,2914,4.145092460881934,20.0,20.0
20703,2,703,[289 302 603 191  50],474,4,2918,4.144886363636363,20.0,20.0
20704,2,704,[302 603 191  50 174],14,5,2923,4.146099290780142,20.0,40.0
20705,2,705,[118 202 121 423 176],666,2,2925,4.143059490084986,0.0,0.0
20706,2,706,[302 603 191  50 174],524,4,2929,4.142857142857143,20.0,40.0
20707,2,707,[302 603 191  50 174],48,5,2934,4.1440677966101696,20.0,40.0
20708,2,708,[302 603 191  50 174],537,4,2938,4.143864598025388,20.0,40.0
20709,2,709,[302 603 191  50 174],14,5,2943,4.145070422535211,20.0,40.0
20710,2,710,[176 655 742 268 678],387,0,2943,4.139240506329114,0.0,0.0
20711,2,711,[302 603 191  50 174],271,5,2948,4.140449438202247,20.0,40.0
20712,2,712,[302 603 191  50 174],669,3,2951,4.138849929873773,20.0,40.0
20713,2,713,[265  82 153 186 127],326,3,2954,4.137254901960785,0.0,20.0
20714,2,714,[302 603 191  50 174],48,5,2959,4.138461538461539,20.0,40.0
20715,2,715,[302 603 191  50 174],666,3,2962,4.136871508379889,20.0,40.0
20716,2,716,[302 603 191  50 174],10,5,2967,4.138075313807532,20.0,40.0
20717,2,717,[302 603 191  50 174],454,5,2972,4.139275766016713,20.0,40.0
20718,2,718,[ 82 135 172 427 195],932,4,2976,4.1390820584144645,0.0,0.0
20719,2,719,[427 302 603 191 195],669,3,2979,4.1375,20.0,0.0
20720,2,720,[302 427 603 191  50],48,5,2984,4.1386962552011095,20.0,20.0
20721,2,721,[302 427 603 191  50],339,5,2989,4.139889196675901,20.0,20.0
20722,2,722,[302 427 603 191  50],458,4,2993,4.139695712309821,20.0,20.0
20723,2,723,[302 427 603 191  50],666,4,2997,4.139502762430939,20.0,20.0
20724,2,724,[302 427 603 191  50],669,4,3001,4.139310344827586,20.0,20.0
20725,2,725,[273  97 318 168  88],479,4,3005,4.139118457300276,20.0,0.0
20726,2,726,[302 427 603 191  50],474,5,3010,4.140302613480055,20.0,20.0
20727,2,727,[204   1 144  82  98],379,5,3015,4.141483516483516,0.0,20.0
20728,2,728,[100  98 191   1 515],232,4,3019,4.141289437585734,0.0,40.0
20729,2,729,[286 235 179 204  97],378,4,3023,4.141095890410959,0.0,0.0
20730,2,730,[302 427 603 191  50],13,4,3027,4.140902872777017,20.0,20.0
20731,2,731,[318  88 196  22 187],343,5,3032,4.14207650273224,20.0,0.0
20732,2,732,[302 427 603 191  50],474,5,3037,4.14324693042292,20.0,20.0
20733,2,733,[302 427 603 191  50],458,4,3041,4.143051771117166,20.0,20.0
20734,2,734,[302 427 603 191  50],669,4,3045,4.142857142857143,20.0,20.0
20735,2,735,[302 427 603 191  50],664,4,3049,4.142663043478261,20.0,20.0
20736,2,736,[302 427 603  50 191],48,5,3054,4.1438263229308,20.0,20.0
20737,2,737,[302 427 603  50 191],334,5,3059,4.144986449864499,20.0,20.0
20738,2,738,[302 427 603  50 191],334,5,3064,4.146143437077131,20.0,20.0
20739,2,739,[302 427 603  50 191],666,4,3068,4.145945945945946,20.0,20.0
20740,2,740,[423 210 176  79 318],234,2,3070,4.143049932523617,20.0,0.0
20741,2,741,[  9   4 294 185  56],194,5,3075,4.144204851752021,0.0,0.0
20742,2,742,[427 302 603  56  50],454,4,3079,4.144010767160162,20.0,20.0
20743,2,743,[427 302 603  50 191],339,5,3084,4.145161290322581,20.0,20.0
20744,2,744,[427 302 603  50 191],537,5,3089,4.146308724832215,20.0,20.0
20745,2,745,[194 405  79 385 191],95,4,3093,4.146112600536193,0.0,0.0
20746,2,746,[427 302 603  50 191],13,4,3097,4.145917001338688,20.0,20.0
20747,2,747,[748 294 200 546  71],479,1,3098,4.141711229946524,0.0,0.0
20748,2,748,[302 427 603  50 191],48,5,3103,4.142857142857143,20.0,20.0
20749,2,749,[302 427 603  50 191],48,5,3108,4.144,20.0,20.0
20750,2,750,[302 427 603  50 191],271,5,3113,4.145139813581891,20.0,20.0
20751,2,751,[302 427 603  50 191],271,5,3118,4.1462765957446805,20.0,20.0
20752,2,752,[195 234  98 183 181],59,5,3123,4.147410358565737,0.0,20.0
20753,2,753,[100 195 483 135 333],13,3,3126,4.1458885941644565,20.0,20.0
20754,2,754,[302 427 603  50 191],537,5,3131,4.147019867549669,20.0,20.0
20755,2,755,[385 144 202 238 313],653,2,3133,4.144179894179894,0.0,0.0
20756,2,756,[427 403 121  64 181],87,4,3137,4.143989431968296,0.0,0.0
20757,2,757,[427 302 603  50 191],334,5,3142,4.145118733509235,20.0,20.0
20758,2,758,[427 302 603  50 191],458,4,3146,4.144927536231884,20.0,20.0
20759,2,759,[427 302 603  50 191],334,5,3151,4.146052631578947,20.0,20.0
20760,2,760,[ 56 143 286 196 127],537,2,3153,4.14323258869908,0.0,20.0
20761,2,761,[427 302 603 191  50],664,4,3157,4.1430446194225725,20.0,20.0
20762,2,762,[427 302 603  50 191],664,4,3161,4.142857142857143,20.0,20.0
20763,2,763,[427 302 603  50 174],14,5,3166,4.143979057591623,20.0,40.0
20764,2,764,[427 302 603  50 174],13,5,3171,4.145098039215687,20.0,40.0
20765,2,765,[ 22 588 403   1 385],479,2,3173,4.142297650130549,0.0,0.0
20766,2,766,[427 302 603  50 174],537,4,3177,4.1421121251629724,20.0,40.0
20767,2,767,[427 302 603  50 174],334,5,3182,4.143229166666667,20.0,40.0
20768,2,768,[427 302 603  50 174],474,5,3187,4.144343302990897,20.0,40.0
20769,2,769,[427 302 603  50 174],664,5,3192,4.1454545454545455,20.0,40.0
20770,2,770,[427 302 603  50 174],745,3,3195,4.143968871595331,20.0,40.0
20771,2,771,[427 302 603  50 174],745,3,3198,4.142487046632124,20.0,40.0
20772,2,772,[427 302 603  50 191],664,4,3202,4.142302716688228,20.0,20.0
20773,2,773,[427 302 603  50 180],537,5,3207,4.1434108527131785,20.0,20.0
20774,2,774,[  1 191 181  11 294],406,4,3211,4.143225806451613,0.0,0.0
20775,2,775,[174 144 182 172 588],64,4,3215,4.143041237113402,0.0,20.0
20776,2,776,[427 302 603 180  50],339,5,3220,4.1441441441441444,20.0,20.0
20777,2,777,[427 302 603 180  50],339,5,3225,4.145244215938304,20.0,20.0
20778,2,778,[204  70 471 186 175],378,3,3228,4.14377406931964,0.0,0.0
20779,2,779,[427 302 603 180  50],664,5,3233,4.144871794871795,20.0,20.0
20780,2,780,[427 302 603 180  50],537,5,3238,4.145966709346991,20.0,20.0
20781,2,781,[172 238  12 588 194],64,5,3243,4.147058823529412,20.0,0.0
20782,2,782,[427 483 597 180 496],533,3,3246,4.145593869731801,20.0,0.0
20783,2,783,[427 302 603  50 483],537,5,3251,4.146683673469388,40.0,20.0
20784,2,784,[423   1 403 210 161],643,3,3254,4.145222929936306,0.0,0.0
20785,2,785,[427 302 603  50 483],537,5,3259,4.146310432569974,40.0,20.0
20786,2,786,[427 302 603 483  50],745,3,3262,4.144853875476493,40.0,20.0
20787,2,787,[ 28 194 235  79 275],82,1,3263,4.1408629441624365,0.0,0.0
20788,2,788,[ 56 234  11  88  97],339,5,3268,4.141951837769328,0.0,0.0
20789,2,789,[302 427 603  50 174],474,5,3273,4.143037974683544,20.0,40.0
20790,2,790,[302 427 603  50 174],370,4,3277,4.142857142857143,20.0,40.0
20791,2,791,[302 427 603  50 174],666,3,3280,4.141414141414141,20.0,40.0
20792,2,792,[302 427 603  50 191],271,5,3285,4.14249684741488,20.0,20.0
20793,2,793,[302 427 603  50 191],666,4,3289,4.142317380352645,20.0,20.0
20794,2,794,[302 427 603  50 191],48,5,3294,4.143396226415095,20.0,20.0
20795,2,795,[302 427 603  50 191],458,4,3298,4.14321608040201,20.0,20.0
20796,2,796,[286 403   8 186 200],7,5,3303,4.144291091593476,0.0,0.0
20797,2,797,[302 427 603  50 191],334,5,3308,4.145363408521304,20.0,20.0
20798,2,798,[302 427 603  50 191],474,5,3313,4.146433041301627,20.0,20.0
20799,2,799,[302 427 603  50 191],339,5,3318,4.1475,20.0,20.0
20800,2,800,[302 427 603  50 191],454,5,3323,4.1485642946317105,20.0,20.0
20801,2,801,[ 96   7 435  50 197],235,5,3328,4.149625935162095,0.0,20.0
20802,2,802,[302 427 603  50 191],454,5,3333,4.1506849315068495,20.0,20.0
20803,2,803,[204 127  96 546 100],524,4,3337,4.150497512437811,0.0,40.0
20804,2,804,[427 302 603  50 191],14,5,3342,4.151552795031056,20.0,20.0
20805,2,805,[427 302 603  50 191],334,5,3347,4.152605459057072,20.0,20.0
20806,2,806,[427 302 603  50 191],339,5,3352,4.1536555142503095,20.0,20.0
20807,2,807,[427 302 603  50 191],537,5,3357,4.15470297029703,20.0,20.0
20808,2,808,[427 302 603  50 191],458,4,3361,4.15451174289246,20.0,20.0
20809,2,809,[427 302 603 191  50],271,5,3366,4.155555555555556,20.0,20.0
20810,2,810,[427 302 603 191  50],474,5,3371,4.156596794081381,20.0,20.0
20811,2,811,[427 302 603 191  50],669,4,3375,4.156403940886699,20.0,20.0
20812,2,812,[427 302 603  50 191],458,4,3379,4.1562115621156215,20.0,20.0
20813,2,813,[427 302 603 191  50],48,5,3384,4.157248157248158,20.0,20.0
20814,2,814,[427 302 603 191  50],339,5,3389,4.1582822085889575,20.0,20.0
20815,2,815,[427 302 603 191  50],48,5,3394,4.159313725490196,20.0,20.0
20816,2,816,[427 302 603 191  50],666,4,3398,4.159118727050184,20.0,20.0
20817,2,817,[427 302 603 191  50],14,5,3403,4.1601466992665035,20.0,20.0
20818,2,818,[427 302 603 191  50],474,5,3408,4.1611721611721615,20.0,20.0
20819,2,819,[427 302 603 191  50],339,5,3413,4.162195121951219,20.0,20.0
20820,2,820,[427 302 603 191  50],474,5,3418,4.163215590742996,20.0,20.0
20821,2,821,[427 302 603 191  50],537,5,3423,4.164233576642336,20.0,20.0
20822,2,822,[427 302 603 191  50],664,4,3427,4.164034021871203,20.0,20.0
20823,2,823,[121   9 405 187  88],749,1,3428,4.160194174757281,0.0,0.0
20824,2,824,[318 471 385 655 200],313,4,3432,4.16,20.0,0.0
20825,2,825,[302 427 603 191  50],339,5,3437,4.161016949152542,20.0,20.0
20826,2,826,[302 427 603 191  50],666,4,3441,4.1608222490931075,20.0,20.0
20827,2,827,[302 427 603 191  50],458,4,3445,4.1606280193236715,20.0,20.0
20828,2,828,[302 427 603 191  50],339,5,3450,4.161640530759952,20.0,20.0
20829,2,829,[302 427 603 191  50],13,4,3454,4.16144578313253,20.0,20.0
20830,2,830,[302 427 603 191  50],537,5,3459,4.162454873646209,20.0,20.0
20831,2,831,[302 427 603 191  50],458,4,3463,4.162259615384615,20.0,20.0
20832,2,832,[302 427 603 191  50],14,5,3468,4.163265306122449,20.0,20.0
20833,2,833,[302 427 603 191  50],334,5,3473,4.164268585131895,20.0,20.0
20834,2,834,[ 25 161 508 405 282],455,2,3475,4.161676646706587,0.0,0.0
20835,2,835,[302 427 603 191  50],458,4,3479,4.161483253588517,20.0,20.0
20836,2,836,[302 427 603 191  50],454,5,3484,4.1624850657108725,20.0,20.0
20837,2,837,[302 427 603 191  50],474,5,3489,4.163484486873508,20.0,20.0
20838,2,838,[  9 181  56 215 483],85,5,3494,4.164481525625745,20.0,0.0
20839,2,839,[302 427 603 191  50],48,5,3499,4.16547619047619,20.0,20.0
20840,2,840,[302 427 603 191  50],666,4,3503,4.165279429250892,20.0,20.0
20841,2,841,[302 427 603 191  50],458,4,3507,4.165083135391924,20.0,20.0
20842,2,842,[302 427 603 191  98],14,4,3511,4.164887307236062,20.0,20.0
20843,2,843,[302 427 603 191 174],14,5,3516,4.165876777251185,20.0,20.0
20844,2,844,[302 427 603 191 174],458,4,3520,4.165680473372781,20.0,20.0
20845,2,845,[302 427 603 191  50],474,5,3525,4.166666666666667,20.0,20.0
20846,2,846,[302 427 603 191  50],666,4,3529,4.1664698937426214,20.0,20.0
20847,2,847,[202 568 121  79 275],538,3,3532,4.165094339622642,0.0,0.0
20848,2,848,[302 427 603 191 174],537,4,3536,4.16489988221437,20.0,20.0
20849,2,849,[423 196 183 748  56],92,3,3539,4.1635294117647055,0.0,0.0
20850,2,850,[228 100   7  89 323],650,4,3543,4.163337250293772,0.0,20.0
20851,2,851,[427 302 603 191  50],271,5,3548,4.164319248826291,20.0,20.0
20852,2,852,[427 302 603 191  50],666,4,3552,4.164126611957796,20.0,20.0
20853,2,853,[427 302 603 191 174],14,5,3557,4.165105386416862,20.0,20.0
20854,2,854,[427 302 603 191 174],537,4,3561,4.1649122807017545,20.0,20.0
20855,2,855,[  8  64 173  98   1],387,4,3565,4.164719626168225,0.0,20.0
20856,2,856,[427 302 603 191  50],537,5,3570,4.165694282380397,20.0,20.0
20857,2,857,[186  97   1 182  82],788,0,3570,4.160839160839161,0.0,0.0
20858,2,858,[427 302 603 191  50],14,5,3575,4.161816065192084,20.0,20.0
20859,2,859,[427 302 603 191  50],334,5,3580,4.162790697674419,20.0,20.0
20860,2,860,[427 302 603 191  50],339,5,3585,4.16376306620209,20.0,20.0
20861,2,861,[427 302 603 191  50],334,5,3590,4.164733178654292,20.0,20.0
20862,2,862,[427 302 603 191  50],48,5,3595,4.165701042873696,20.0,20.0
20863,2,863,[427 302 603 191  50],537,5,3600,4.166666666666667,20.0,20.0
20864,2,864,[427 302 603 191  50],13,4,3604,4.166473988439306,20.0,20.0
20865,2,865,[276 471 175 200  79],92,4,3608,4.166281755196305,0.0,0.0
20866,2,866,[302 427 603 191  50],664,4,3612,4.166089965397924,20.0,20.0
20867,2,867,[302 427 603 191  50],669,4,3616,4.1658986175115205,20.0,20.0
20868,2,868,[302 427 603 191  50],48,5,3621,4.166858457997699,20.0,20.0
20869,2,869,[302 427 603 191  50],537,5,3626,4.167816091954023,20.0,20.0
20870,2,870,[  7 196 100 191 125],334,4,3630,4.167623421354764,0.0,20.0
20871,2,871,[302 427 603 191  50],271,5,3635,4.168577981651376,20.0,20.0
20872,2,872,[302 427 603 191  50],13,4,3639,4.168384879725086,20.0,20.0
20873,2,873,[302 427 603 191  50],339,5,3644,4.169336384439359,20.0,20.0
20874,2,874,[302 427 603 191  50],13,4,3648,4.169142857142857,20.0,20.0
20875,2,875,[302 427 603 191  50],271,5,3653,4.170091324200913,20.0,20.0
20876,2,876,[302 427 603 191  50],334,5,3658,4.1710376282782216,20.0,20.0
20877,2,877,[427 268 313 161 333],85,3,3661,4.169703872437358,0.0,0.0
20878,2,878,[302 427 603 191  50],669,4,3665,4.169510807736064,20.0,20.0
20879,2,879,[302 427 603 191  50],339,5,3670,4.170454545454546,20.0,20.0
20880,2,880,[302 427 603 191  50],13,4,3674,4.170261066969353,20.0,20.0
20881,2,881,[302 427 603  50 191],13,4,3678,4.170068027210885,20.0,20.0
20882,2,882,[302 427 603  50 191],454,5,3683,4.171007927519819,20.0,20.0
20883,2,883,[302 427 603  50 191],474,5,3688,4.171945701357466,20.0,20.0
20884,2,884,[258 276 100 435  22],13,5,3693,4.172881355932203,0.0,20.0
20885,2,885,[302 427 603  50 191],334,5,3698,4.173814898419865,20.0,20.0
20886,2,886,[302 427 603  50 191],666,4,3702,4.173618940248027,20.0,20.0
20887,2,887,[302 427 603  50 191],669,4,3706,4.173423423423423,20.0,20.0
20888,2,888,[302 427 603  50 191],454,5,3711,4.174353205849269,20.0,20.0
20889,2,889,[191 172   7  22 245],554,3,3714,4.1730337078651685,0.0,0.0
20890,2,890,[302 427 603  50 191],537,5,3719,4.1739618406285075,20.0,20.0
20891,2,891,[302 427 603  50 191],669,4,3723,4.173766816143497,20.0,20.0
20892,2,892,[302 427 603  50  89],339,5,3728,4.1746920492721165,20.0,20.0
20893,2,893,[302 427 603  50  89],664,5,3733,4.175615212527965,20.0,20.0
20894,2,894,[302 427 603  50  89],666,4,3737,4.175418994413408,20.0,20.0
20895,2,895,[302 427 603  50  89],474,5,3742,4.176339285714286,20.0,20.0
20896,2,896,[302 427 603  50  89],666,4,3746,4.176142697881828,20.0,20.0
20897,2,897,[302 427 603  50  89],537,5,3751,4.17706013363029,20.0,20.0
20898,2,898,[302 427 603  50  89],664,5,3756,4.17797552836485,20.0,20.0
20899,2,899,[258  25 405  15  12],533,4,3760,4.177777777777778,20.0,0.0
20900,2,900,[302  15 427 603  50],474,5,3765,4.1786903440621535,20.0,20.0
20901,2,901,[288 181   7  25 318],387,2,3767,4.176274944567628,20.0,0.0
20902,2,902,[302  15 427 603  50],537,4,3771,4.176079734219269,20.0,20.0
20903,2,903,[186 655 181 423 322],329,3,3774,4.174778761061947,0.0,0.0
20904,2,904,[302 427 603  50  89],537,5,3779,4.175690607734807,20.0,20.0
20905,2,905,[204 515 132 168 143],60,4,3783,4.175496688741722,0.0,0.0
20906,2,906,[302 427 603 132  50],537,4,3787,4.175303197353914,20.0,20.0
20907,2,907,[302 427 603  50  89],537,5,3792,4.176211453744493,20.0,20.0
20908,2,908,[302 427 603  50  89],339,5,3797,4.177117711771177,20.0,20.0
20909,2,909,[302 427 603  50  89],664,5,3802,4.178021978021978,20.0,20.0
20910,2,910,[ 95 187  56 197 191],59,4,3806,4.177826564215148,0.0,0.0
20911,2,911,[302 427 603  50  89],271,4,3810,4.177631578947368,20.0,20.0
20912,2,912,[215 127 174 175 268],7,4,3814,4.1774370208105145,0.0,40.0
20913,2,913,[302 427 603  50  89],666,4,3818,4.177242888402626,20.0,20.0
20914,2,914,[302 427 603  50  89],271,4,3822,4.177049180327868,20.0,20.0
20915,2,915,[302 427 603  50 174],13,5,3827,4.177947598253275,20.0,40.0
20916,2,916,[318 118   8 265 180],328,3,3830,4.176663031624864,20.0,0.0
20917,2,917,[302 427 603  50 174],454,5,3835,4.17755991285403,20.0,40.0
20918,2,918,[  7 234 186 194 276],881,2,3837,4.17519042437432,0.0,0.0
20919,2,919,[302 427 603  50 174],339,5,3842,4.176086956521739,20.0,40.0
20920,2,920,[302 427 603  50 174],745,3,3845,4.174809989142236,20.0,40.0
20921,2,921,[197 268 196 588 222],234,1,3846,4.171366594360086,0.0,0.0
20922,2,922,[302 427 603 197  50],537,5,3851,4.172264355362947,20.0,20.0
20923,2,923,[302 427 603 197  50],454,5,3856,4.1731601731601735,20.0,20.0
20924,2,924,[302 427 603 197  50],454,5,3861,4.1740540540540545,20.0,20.0
20925,2,925,[100 211 678 121 132],454,2,3863,4.17170626349892,0.0,20.0
20926,2,926,[302 427 603 197  50],339,5,3868,4.17259978425027,20.0,20.0
20927,2,927,[302 427 603 197  50],334,5,3873,4.173491379310345,20.0,20.0
20928,2,928,[302 427 603 197  50],454,5,3878,4.174381054897739,20.0,20.0
20929,2,929,[302 427 603 197  50],339,5,3883,4.175268817204301,20.0,20.0
20930,2,930,[132  22 183  56 385],897,3,3886,4.174006444683136,0.0,0.0
20931,2,931,[181 204 186 174 173],102,3,3889,4.17274678111588,0.0,20.0
20932,2,932,[302 427 603 197  50],13,5,3894,4.173633440514469,20.0,20.0
20933,2,933,[ 95  79  28 515 238],334,3,3897,4.17237687366167,0.0,0.0
20934,2,934,[302 427 603 197  50],339,5,3902,4.173262032085561,20.0,20.0
20935,2,935,[174 273 135 132 603],64,3,3905,4.172008547008547,20.0,20.0
20936,2,936,[302 427 603 197  50],474,5,3910,4.172892209178229,20.0,20.0
20937,2,937,[302 427 603 197  50],454,5,3915,4.173773987206823,20.0,20.0
20938,2,938,[302 427 603 197  50],537,5,3920,4.174653887113951,20.0,20.0
20939,2,939,[302 427 603 197  50],666,4,3924,4.174468085106383,20.0,20.0
20940,2,940,[302 427 603 197  50],339,5,3929,4.175345377258236,20.0,20.0
20941,2,941,[282 405  11  64 216],406,2,3931,4.173036093418259,0.0,0.0
20942,2,942,[302 427 603 197  50],271,5,3936,4.173913043478261,20.0,20.0
20943,2,943,[302 427 603 197  50],537,5,3941,4.174788135593221,20.0,20.0
20944,2,944,[302 427 603 197  50],537,5,3946,4.175661375661376,20.0,20.0
20945,2,945,[ 71 174 403 191 182],524,4,3950,4.175475687103594,0.0,20.0
20946,2,946,[234 471 172 273 405],479,5,3955,4.176346356916579,0.0,0.0
20947,2,947,[  8  70 117 300 313],90,3,3958,4.175105485232067,0.0,0.0
20948,2,948,[ 79 427 603 210 185],843,0,3958,4.170706006322445,20.0,0.0
20949,2,949,[302 427 603 197  50],339,5,3963,4.171578947368421,20.0,20.0
20950,2,950,[302 427 603 197  50],339,5,3968,4.172450052576235,20.0,20.0
20951,2,951,[302 427 603 197  50],339,5,3973,4.173319327731092,20.0,20.0
20952,2,952,[302 427 603 197  50],454,5,3978,4.1741867785939135,20.0,20.0
20953,2,953,[302 427 603 197  50],13,5,3983,4.1750524109014675,20.0,20.0
20954,2,954,[748 238 385 403 185],524,3,3986,4.173821989528796,0.0,0.0
20955,2,955,[302 427 197 603  50],454,5,3991,4.174686192468619,20.0,20.0
20956,2,956,[302 427 197 603  50],666,4,3995,4.174503657262278,20.0,20.0
20957,2,957,[302 427 197 603  50],339,5,4000,4.175365344467641,20.0,20.0
20958,2,958,[302 427 197 603  50],334,5,4005,4.1762252346193955,20.0,20.0
20959,2,959,[302 427 197 603  50],474,5,4010,4.177083333333333,20.0,20.0
20960,2,960,[302 427 197 603  50],664,5,4015,4.177939646201873,20.0,20.0
20961,2,961,[302 427 197 603  50],13,5,4020,4.1787941787941785,20.0,20.0
20962,2,962,[  1  69 269 742 111],145,3,4023,4.177570093457944,0.0,0.0
20963,2,963,[302 427 197 603  50],537,5,4028,4.178423236514523,20.0,20.0
20964,2,964,[302 427 197 603  50],13,5,4033,4.179274611398964,20.0,20.0
20965,2,965,[302 427 197 603  50],474,5,4038,4.180124223602484,20.0,20.0
20966,2,966,[302 427 197 603  50],339,5,4043,4.180972078593588,20.0,20.0
20967,2,967,[302 427 197 603  50],537,5,4048,4.181818181818182,20.0,20.0
20968,2,968,[302 427 197 603  50],13,5,4053,4.182662538699691,20.0,20.0
20969,2,969,[191 182  25 180 228],313,3,4056,4.181443298969072,0.0,0.0
20970,2,970,[135  22 197  95 234],804,3,4059,4.1802265705458295,0.0,0.0
20971,2,971,[302 427 197 603 180],666,5,4064,4.181069958847736,20.0,0.0
20972,2,972,[483  71 748 161 174],313,4,4068,4.180883864337102,20.0,20.0
20973,2,973,[302 427 197 603 180],537,5,4073,4.181724845995893,20.0,0.0
20974,2,974,[546 282 175  82  11],378,3,4076,4.180512820512821,0.0,0.0
20975,2,975,[302 427 197 603 180],13,5,4081,4.181352459016393,20.0,0.0
20976,2,976,[265 603 508 100  12],334,3,4084,4.18014329580348,40.0,20.0
20977,2,977,[  7 546 403 276  96],92,4,4088,4.179959100204499,0.0,0.0
20978,2,978,[ 88  12  28 515 357],339,5,4093,4.180796731358529,40.0,0.0
20979,2,979,[302 427 197 603 180],664,5,4098,4.181632653061224,20.0,0.0
20980,2,980,[302 427 197 603 180],664,5,4103,4.1824668705402654,20.0,0.0
20981,2,981,[302 427 197 603 180],664,5,4108,4.183299389002037,20.0,0.0
20982,2,982,[302 427 197 603 180],537,5,4113,4.1841302136317395,20.0,0.0
20983,2,983,[265  56 183 181 245],488,4,4117,4.183943089430894,0.0,0.0
20984,2,984,[302 427 197 603 180],664,5,4122,4.184771573604061,20.0,0.0
20985,2,985,[405 197 174 161  56],318,2,4124,4.182555780933063,0.0,20.0
20986,2,986,[194   4 186 515 508],59,4,4128,4.182370820668693,0.0,0.0
20987,2,987,[161 180 153 403 183],308,4,4132,4.182186234817814,0.0,0.0
20988,2,988,[302 427 197 603 180],383,5,4137,4.183013144590496,20.0,0.0
20989,2,989,[302 427 197 603 180],537,5,4142,4.183838383838384,20.0,0.0
20990,2,990,[302 427 197 603 180],664,5,4147,4.184661957618567,20.0,0.0
20991,2,991,[132 204 496 471 161],95,3,4150,4.183467741935484,0.0,0.0
20992,2,992,[302 427 197 603 180],271,5,4155,4.18429003021148,20.0,0.0
20993,2,993,[302 427 197 603 180],90,5,4160,4.185110663983903,20.0,0.0
20994,2,994,[302 427 197 603 180],13,5,4165,4.185929648241206,20.0,0.0
20995,2,995,[302 427 197 603 180],90,5,4170,4.186746987951807,20.0,0.0
20996,2,996,[603 588 195  79 238],64,4,4174,4.186559679037111,20.0,0.0
20997,2,997,[302 427 197 603 180],664,5,4179,4.187374749498998,20.0,0.0
20998,2,998,[282 173   1 276 423],42,4,4183,4.187187187187187,0.0,0.0
20999,2,999,[302 427 197 603 180],474,5,4188,4.188,20.0,0.0
21000,2,1000,[135 181   1 168 204],374,3,4191,4.186813186813187,0.0,0.0
21001,2,1001,[176 174 427 318 180],308,5,4196,4.187624750499002,20.0,20.0
21002,2,1002,[210 313 318 603 175],13,3,4199,4.186440677966102,40.0,0.0
21003,2,1003,[302 427 197 603 180],271,5,4204,4.187250996015936,20.0,0.0
21004,2,1004,[302 427 197 603 180],474,5,4209,4.188059701492537,20.0,0.0
21005,2,1005,[302 427 197 603 180],383,5,4214,4.188866799204772,20.0,0.0
21006,2,1006,[302 427 197 603 180],537,5,4219,4.189672293942404,20.0,0.0
21007,2,1007,[302 427 197 180 603],474,5,4224,4.190476190476191,20.0,0.0
21008,2,1008,[204 288   1   8 235],213,2,4226,4.1883052527254705,0.0,0.0
21009,2,1009,[302 427 197 180 603],664,5,4231,4.189108910891089,20.0,0.0
21010,2,1010,[302 427 197 180 603],90,5,4236,4.189910979228487,20.0,0.0
21011,2,1011,[302 427 197 180 603],339,5,4241,4.190711462450593,20.0,0.0
21012,2,1012,[302 427 197 180 603],664,5,4246,4.191510365251728,20.0,0.0
21013,2,1013,[302 427 197 180 603],339,5,4251,4.1923076923076925,20.0,0.0
21014,2,1014,[302 427 197 180 603],474,5,4256,4.1931034482758625,20.0,0.0
21015,2,1015,[302 427 197 180 603],383,5,4261,4.193897637795276,20.0,0.0
21016,2,1016,[302 427 197 180 603],271,5,4266,4.1946902654867255,20.0,0.0
21017,2,1017,[237 125 180   8  79],92,5,4271,4.195481335952849,0.0,0.0
21018,2,1018,[302 427 197 180 603],664,5,4276,4.196270853778214,20.0,0.0
21019,2,1019,[302 427 197 180 603],13,5,4281,4.197058823529412,20.0,0.0
21020,2,1020,[302 427 197 180 603],383,5,4286,4.197845249755142,20.0,0.0
21021,2,1021,[302 427 197 180 603],339,5,4291,4.198630136986301,20.0,0.0
21022,2,1022,[302 427 197 180 603],339,5,4296,4.19941348973607,20.0,0.0
21023,2,1023,[ 89 200 269 196 176],537,1,4297,4.1962890625,0.0,0.0
21024,2,1024,[302 427 197 180 603],13,5,4302,4.1970731707317075,20.0,0.0
21025,2,1025,[282   1 185 258  88],145,4,4306,4.196881091617934,0.0,0.0
21026,2,1026,[302 427 197 180 603],664,5,4311,4.197663096397274,20.0,0.0
21027,2,1027,[302 427 197 180 603],339,5,4316,4.198443579766537,20.0,0.0
21028,2,1028,[475 197 127 318 174],207,4,4320,4.198250728862973,20.0,40.0
21029,2,1029,[276 144 204 234 508],378,5,4325,4.199029126213592,0.0,0.0
21030,2,1030,[302 427 197 180 603],666,5,4330,4.19980601357905,20.0,0.0
21031,2,1031,[286 135  64 172 234],95,3,4333,4.198643410852713,0.0,0.0
21032,2,1032,[302 427 197 180 603],666,5,4338,4.199419167473378,20.0,0.0
21033,2,1033,[302 427 197 180 603],537,5,4343,4.200193423597679,20.0,0.0
21034,2,1034,[515 168 294 191 471],271,2,4345,4.1980676328502415,0.0,0.0
21035,2,1035,[302 427 197 180 603],271,5,4350,4.198841698841699,20.0,0.0
21036,2,1036,[302 427 197 180 603],339,5,4355,4.199614271938284,20.0,0.0
21037,2,1037,[302 427 197 180 603],474,5,4360,4.200385356454721,20.0,0.0
21038,2,1038,[ 95 181 385 121   1],290,5,4365,4.201154956689124,0.0,0.0
21039,2,1039,[216 121 273 117  50],328,3,4368,4.2,0.0,20.0
21040,2,1040,[302 427 197 180 603],537,5,4373,4.200768491834774,20.0,0.0
21041,2,1041,[302 427 197 180 603],271,5,4378,4.201535508637236,20.0,0.0
21042,2,1042,[302 427 197 180 603],664,5,4383,4.202301054650048,20.0,0.0
21043,2,1043,[302 427 197 180 603],474,5,4388,4.203065134099617,20.0,0.0
21044,2,1044,[ 22  89 742  50 195],387,4,4392,4.202870813397129,0.0,20.0
21045,2,1045,[ 69  98 179 234  56],738,4,4396,4.202676864244742,0.0,20.0
21046,2,1046,[302 427 197 180 603],339,5,4401,4.203438395415473,20.0,0.0
21047,2,1047,[117 183 174 357  97],650,4,4405,4.20324427480916,20.0,20.0
21048,2,1048,[143 496 357 483  98],840,5,4410,4.204003813155386,40.0,20.0
21049,2,1049,[302 427 197 180 603],90,5,4415,4.204761904761905,20.0,0.0
21050,2,1050,[302 427 197 180 603],664,5,4420,4.205518553758325,20.0,0.0
21051,2,1051,[302 427 197 180 603],90,5,4425,4.2062737642585555,20.0,0.0
21052,2,1052,[185  70 265 515 121],271,3,4428,4.205128205128205,0.0,0.0
21053,2,1053,[302 427 197 180 603],90,5,4433,4.205882352941177,20.0,0.0
21054,2,1054,[302 427 197 180 603],383,5,4438,4.206635071090047,20.0,0.0
21055,2,1055,[302 427 197 180 603],664,5,4443,4.207386363636363,20.0,0.0
21056,2,1056,[302 427 197 180 603],474,5,4448,4.208136234626301,20.0,0.0
21057,2,1057,[302 427 197 180 603],90,5,4453,4.208884688090738,20.0,0.0
21058,2,1058,[423 132 179 173  22],537,2,4455,4.206798866855524,0.0,0.0
21059,2,1059,[302 427 197 180 603],271,5,4460,4.2075471698113205,20.0,0.0
21060,2,1060,[302 427 197 180 603],666,5,4465,4.208294062205467,20.0,0.0
21061,2,1061,[302 427 197 180 603],339,5,4470,4.209039548022599,20.0,0.0
21062,2,1062,[302 427 197 180 603],339,5,4475,4.209783631232361,20.0,0.0
21063,2,1063,[302 427 197 180 603],474,5,4480,4.2105263157894735,20.0,0.0
21064,2,1064,[423 427 179  89  88],474,5,4485,4.211267605633803,0.0,0.0
21065,2,1065,[302 427 197 180 603],537,5,4490,4.2120075046904315,20.0,0.0
21066,2,1066,[302 427 197 180 603],537,5,4495,4.212746016869728,20.0,0.0
21067,2,1067,[302 427 197 180 603],90,5,4500,4.213483146067416,20.0,0.0
21068,2,1068,[302 427 197 180 603],271,5,4505,4.21421889616464,20.0,0.0
21069,2,1069,[302 427 197 180 603],474,5,4510,4.214953271028038,20.0,0.0
21070,2,1070,[ 28  64 228 183  89],374,4,4514,4.214752567693744,0.0,0.0
21071,2,1071,[302 427 197 180 603],13,5,4519,4.215485074626866,20.0,0.0
21072,2,1072,[302 427 197 180 603],271,5,4524,4.216216216216216,20.0,0.0
21073,2,1073,[423  12 202 143 603],454,3,4527,4.215083798882682,40.0,0.0
21074,2,1074,[187 471 197  50 276],343,5,4532,4.2158139534883725,0.0,20.0
21075,2,1075,[302 427 197 180 603],90,5,4537,4.216542750929368,20.0,0.0
21076,2,1076,[  9 269  50  89 215],233,3,4540,4.215413184772516,0.0,20.0
21077,2,1077,[508 174   1 204 276],406,5,4545,4.216141001855288,0.0,20.0
21078,2,1078,[302 427 197 180 603],383,5,4550,4.216867469879518,20.0,0.0
21079,2,1079,[302 427 197 180 603],474,5,4555,4.217592592592593,20.0,0.0
21080,2,1080,[132 197 191  97 215],95,4,4559,4.217391304347826,0.0,0.0
21081,2,1081,[180 515  95 237  56],92,4,4563,4.217190388170056,0.0,0.0
21082,2,1082,[302 427 197 180 603],13,5,4568,4.217913204062788,20.0,0.0
21083,2,1083,[302 427 197 180 603],383,5,4573,4.218634686346864,20.0,0.0
21084,2,1084,[ 50 483 302 200 222],210,5,4578,4.219354838709678,20.0,20.0
21085,2,1085,[302 427 197 180 603],666,5,4583,4.220073664825046,20.0,0.0
21086,2,1086,[302 427 197 180 603],537,5,4588,4.220791168353266,20.0,0.0
21087,2,1087,[385 222 143 228 125],653,2,4590,4.21875,0.0,0.0
21088,2,1088,[302 427 197 180 603],90,5,4595,4.219467401285583,20.0,0.0
21089,2,1089,[302 427 197 180 603],271,5,4600,4.220183486238532,20.0,0.0
21090,2,1090,[302 427 197 180 603],90,5,4605,4.22089825847846,20.0,0.0
21091,2,1091,[302 427 197 180 603],339,5,4610,4.221611721611722,20.0,0.0
21092,2,1092,[302 427 197 180 603],271,5,4615,4.222323879231473,20.0,0.0
21093,2,1093,[302 427 197 180 603],383,5,4620,4.223034734917733,20.0,0.0
21094,2,1094,[302 427 197 180 603],339,5,4625,4.223744292237443,20.0,0.0
21095,2,1095,[302 427 197 180 603],666,5,4630,4.224452554744525,20.0,0.0
21096,2,1096,[302 427 197 180 603],383,5,4635,4.2251595259799455,20.0,0.0
21097,2,1097,[ 96  56 471  28 742],378,4,4639,4.2249544626593805,0.0,0.0
21098,2,1098,[ 89 196 132  12 435],343,4,4643,4.2247497725204735,20.0,0.0
21099,2,1099,[185 597 180  82 269],7,2,4645,4.222727272727273,0.0,0.0
21100,2,1100,[302 427 197 180 603],383,5,4650,4.223433242506812,20.0,0.0
21101,2,1101,[216 515 183 275 245],334,3,4653,4.222323049001815,0.0,0.0
21102,2,1102,[302 427 197 180 603],339,5,4658,4.2230281051677245,20.0,0.0
21103,2,1103,[302 427 197 180 603],271,5,4663,4.223731884057971,20.0,0.0
21104,2,1104,[302 427 197 180 603],383,5,4668,4.224434389140272,20.0,0.0
21105,2,1105,[215 180 117 153 496],479,2,4670,4.22242314647378,0.0,0.0
21106,2,1106,[302 427 197 180 603],90,5,4675,4.22312556458898,20.0,0.0
21107,2,1107,[121 273  69 204 234],92,5,4680,4.223826714801444,0.0,0.0
21108,2,1108,[302 427 197 180 603],271,5,4685,4.224526600541028,20.0,0.0
21109,2,1109,[302 427 197 180 603],537,5,4690,4.225225225225225,20.0,0.0
21110,2,1110,[655 195   9  12  64],234,1,4691,4.222322232223222,20.0,0.0
21111,2,1111,[204 191 121 258  69],454,5,4696,4.223021582733813,0.0,0.0
21112,2,1112,[302 294   9 403 427],13,2,4698,4.2210242587601075,0.0,0.0
21113,2,1113,[302 427 197 180 603],90,5,4703,4.221723518850988,20.0,0.0
21114,2,1114,[302 427 197 180 603],339,5,4708,4.222421524663677,20.0,0.0
21115,2,1115,[302 427 197 180 603],537,5,4713,4.223118279569892,20.0,0.0
21116,2,1116,[302 427 197 180 603],383,5,4718,4.2238137869292744,20.0,0.0
21117,2,1117,[302 427 197 180 603],666,5,4723,4.224508050089446,20.0,0.0
21118,2,1118,[216 475 196   9 288],334,3,4726,4.223413762287757,0.0,0.0
21119,2,1119,[181 603   7 153 161],60,4,4730,4.223214285714286,20.0,0.0
21120,2,1120,[202 143 597 211 238],653,1,4731,4.220338983050848,0.0,0.0
21121,2,1121,[546 655 197 300 168],64,2,4733,4.218360071301248,0.0,0.0
21122,2,1122,[216 200 508 328 187],13,1,4734,4.215494211932324,0.0,0.0
21123,2,1123,[301 268   7 183 197],13,3,4737,4.2144128113879,0.0,0.0
21124,2,1124,[302 427 180 197 603],664,5,4742,4.215111111111111,20.0,0.0
21125,2,1125,[302 427 180 197 603],666,5,4747,4.215808170515098,20.0,0.0
21126,2,1126,[302 427 180 197 603],271,5,4752,4.216503992901508,20.0,0.0
21127,2,1127,[302 427 180 197 603],13,5,4757,4.217198581560283,20.0,0.0
21128,2,1128,[302 427 180 197 603],474,5,4762,4.217891939769708,20.0,0.0
21129,2,1129,[302 427 180 197 603],271,5,4767,4.21858407079646,20.0,0.0
21130,2,1130,[302 427 180 197 603],271,5,4772,4.219274977895668,20.0,0.0
21131,2,1131,[302 427 180 197 603],339,5,4777,4.219964664310954,20.0,0.0
21132,2,1132,[302 427 180 197 603],13,5,4782,4.220653133274492,20.0,0.0
21133,2,1133,[  4  71 286 288 176],455,1,4783,4.2178130511463845,0.0,0.0
21134,2,1134,[302 427 180 197 603],537,5,4788,4.2185022026431716,20.0,0.0
21135,2,1135,[423 172 176  28 111],666,1,4789,4.215669014084507,0.0,0.0
21136,2,1136,[ 79 237 135 257 318],378,4,4793,4.215479331574318,20.0,0.0
21137,2,1137,[302 427 180 197 603],271,5,4798,4.216168717047451,20.0,0.0
21138,2,1138,[ 96 318 175  15 357],406,5,4803,4.216856892010536,40.0,0.0
21139,2,1139,[ 89 179 135  22 423],479,3,4806,4.21578947368421,0.0,0.0
21140,2,1140,[302 427 180 197 603],339,5,4811,4.216476774758983,20.0,0.0
21141,2,1141,[302 427 180 197 603],664,5,4816,4.217162872154115,20.0,0.0
21142,2,1142,[302 427 180 197 603],664,5,4821,4.217847769028872,20.0,0.0
21143,2,1143,[302 427 180 197 603],474,5,4826,4.218531468531468,20.0,0.0
21144,2,1144,[302 427 180 197 603],271,5,4831,4.2192139737991265,20.0,0.0
21145,2,1145,[302 427 180 197 603],271,5,4836,4.219895287958115,20.0,0.0
21146,2,1146,[168 588 118  89 153],479,3,4839,4.218831734960768,0.0,0.0
21147,2,1147,[302 427 180 197 603],90,5,4844,4.219512195121951,20.0,0.0
21148,2,1148,[302 427 180 197 603],664,5,4849,4.220191470844212,20.0,0.0
21149,2,1149,[423 181 546 161  97],455,4,4853,4.22,0.0,0.0
21150,2,1150,[302 427 180 197 603],664,5,4858,4.220677671589922,20.0,0.0
21151,2,1151,[173  28 174 168 678],334,3,4861,4.219618055555555,0.0,20.0
21152,2,1152,[302 427 180 197 603],666,5,4866,4.220294882914137,20.0,0.0
21153,2,1153,[211 678 153 185 496],488,3,4869,4.219237435008665,0.0,0.0
21154,2,1154,[302 427 180 197 603],339,5,4874,4.21991341991342,20.0,0.0
21155,2,1155,[302 427 180 197 603],271,5,4879,4.220588235294118,20.0,0.0
21156,2,1156,[302 427 180 197 603],383,5,4884,4.221261884183233,20.0,0.0
21157,2,1157,[302 427 180 197 603],271,5,4889,4.221934369602764,20.0,0.0
21158,2,1158,[302 427 180 197 603],537,5,4894,4.22260569456428,20.0,0.0
21159,2,1159,[302 427 180 197 603],474,5,4899,4.223275862068966,20.0,0.0
21160,2,1160,[182  82  96  56 234],897,4,4903,4.223083548664944,0.0,0.0
21161,2,1161,[ 22 173   7 183 172],295,4,4907,4.22289156626506,0.0,0.0
21162,2,1162,[302 427 180 197 603],90,5,4912,4.2235597592433365,20.0,0.0
21163,2,1163,[302 427 180 197 603],537,5,4917,4.224226804123711,20.0,0.0
21164,2,1164,[302 427 180 197 603],537,5,4922,4.224892703862661,20.0,0.0
21165,2,1165,[168 265 588  82  11],13,3,4925,4.223842195540309,0.0,0.0
21166,2,1166,[300 273 515 187 132],666,3,4928,4.222793487574979,0.0,0.0
21167,2,1167,[302 427 180 197 603],537,5,4933,4.223458904109589,20.0,0.0
21168,2,1168,[302 427 180 197 603],90,5,4938,4.224123182207014,20.0,0.0
21169,2,1169,[302 427 180 197 603],474,5,4943,4.224786324786325,20.0,0.0
21170,2,1170,[302 427 180 197 603],537,5,4948,4.225448334756618,20.0,0.0
21171,2,1171,[176 194 127 183 385],313,5,4953,4.226109215017065,0.0,20.0
21172,2,1172,[ 64 194  25 237 322],207,4,4957,4.225916453537937,0.0,0.0
21173,2,1173,[302 427 180 197 603],90,5,4962,4.226575809199319,20.0,0.0
21174,2,1174,[168  64   4 435 313],308,4,4966,4.226382978723405,0.0,0.0
21175,2,1175,[302 427 180 197 603],474,5,4971,4.2270408163265305,20.0,0.0
21176,2,1176,[ 11 276 742 288  56],59,4,4975,4.226847918436704,0.0,0.0
21177,2,1177,[302 427 180 197 603],383,5,4980,4.227504244482173,20.0,0.0
21178,2,1178,[427 496  22 180  12],7,5,4985,4.228159457167091,20.0,0.0
21179,2,1179,[302 427 180 197 603],664,5,4990,4.228813559322034,20.0,0.0
21180,2,1180,[ 56 153 234 257 182],308,4,4994,4.228619813717189,0.0,0.0
21181,2,1181,[  8 215 175 186 143],840,5,4999,4.229272419627749,0.0,0.0
21182,2,1182,[176 127 568 179 403],308,5,5004,4.229923922231615,0.0,20.0
21183,2,1183,[302 427 180 197 603],666,5,5009,4.230574324324325,20.0,0.0
21184,2,1184,[302 427 180 197 603],474,5,5014,4.231223628691983,20.0,0.0
21185,2,1185,[302 427 180 197 603],664,5,5019,4.2318718381112985,20.0,0.0
21186,2,1186,[302 427 180 197 603],339,5,5024,4.2325189553496205,20.0,0.0
21187,2,1187,[302 427 180 197 603],474,5,5029,4.233164983164984,20.0,0.0
21188,2,1188,[302 427 180 197 603],339,5,5034,4.23380992430614,20.0,0.0
21189,2,1189,[175 483 385 121 132],59,5,5039,4.234453781512605,20.0,0.0
21190,2,1190,[238  79 200  28 143],379,5,5044,4.2350965575146935,0.0,0.0
21191,2,1191,[603 127  82  96   4],804,4,5048,4.23489932885906,20.0,20.0
21192,2,1192,[302 427 180 197 603],13,5,5053,4.235540653813914,20.0,0.0
21193,2,1193,[403 144 100 228 210],234,1,5054,4.232830820770519,0.0,20.0
21194,2,1194,[302 427 180 197 603],339,5,5059,4.23347280334728,20.0,0.0
21195,2,1195,[302 427 180 197 603],13,5,5064,4.234113712374582,20.0,0.0
21196,2,1196,[302 427 180 197 603],537,5,5069,4.234753550543024,20.0,0.0
21197,2,1197,[546 405 211   7 202],666,4,5073,4.234557595993322,0.0,0.0
21198,2,1198,[302 427 180 197 603],90,5,5078,4.235195996663887,20.0,0.0
21199,2,1199,[ 98  22 483 195 289],524,2,5080,4.233333333333333,20.0,20.0
21200,2,1200,[302 427 180 197 603],474,5,5085,4.233971690258119,20.0,0.0
21201,2,1201,[302 427 180 197 603],383,5,5090,4.234608985024958,20.0,0.0
21202,2,1202,[302 427 180 197 603],666,5,5095,4.235245220282627,20.0,0.0
21203,2,1203,[302 427 180 197 603],666,5,5100,4.235880398671096,20.0,0.0
21204,2,1204,[302 427 180 197 603],90,5,5105,4.236514522821577,20.0,0.0
21205,2,1205,[302 427 180 197 603],664,5,5110,4.237147595356551,20.0,0.0
21206,2,1206,[302 427 180 197 603],537,5,5115,4.237779618889809,20.0,0.0
21207,2,1207,[ 25  98 288 603 181],234,2,5117,4.235927152317881,20.0,20.0
21208,2,1208,[ 70 234 357  98  69],210,5,5122,4.236559139784946,20.0,20.0
21209,2,1209,[405   9  97 195   8],328,2,5124,4.234710743801653,0.0,0.0
21210,2,1210,[302 427 180 197 603],90,5,5129,4.235342691990091,20.0,0.0
21211,2,1211,[182 204 257 176 185],804,5,5134,4.235973597359736,0.0,0.0
21212,2,1212,[483 117 197 187 127],650,3,5137,4.234954657873042,20.0,20.0
21213,2,1213,[302 427 180 197 603],339,5,5142,4.235584843492586,20.0,0.0
21214,2,1214,[302 427 180 197 603],13,5,5147,4.236213991769548,20.0,0.0
21215,2,1215,[302 427 180 197 603],666,5,5152,4.2368421052631575,20.0,0.0
21216,2,1216,[302 427 180 197 603],339,5,5157,4.2374691865242395,20.0,0.0
21217,2,1217,[302 427 180 197 603],90,5,5162,4.238095238095238,20.0,0.0
21218,2,1218,[302 427 180 197 603],339,5,5167,4.238720262510254,20.0,0.0
21219,2,1219,[302 427 180 197 603],664,5,5172,4.239344262295082,20.0,0.0
21220,2,1220,[302 427 180 197 603],90,5,5177,4.23996723996724,20.0,0.0
21221,2,1221,[302 427 180 197 603],383,5,5182,4.240589198036006,20.0,0.0
21222,2,1222,[302 427 180 197 603],90,5,5187,4.241210139002453,20.0,0.0
21223,2,1223,[302 427 180 197 603],537,5,5192,4.241830065359477,20.0,0.0
21224,2,1224,[302 427 180 197 603],383,5,5197,4.2424489795918365,20.0,0.0
21225,2,1225,[302 427 180 197 603],474,5,5202,4.243066884176183,20.0,0.0
21226,2,1226,[568  50 195 237 515],524,3,5205,4.2420537897310515,0.0,20.0
21227,2,1227,[302 427 180 197 603],339,5,5210,4.242671009771987,20.0,0.0
21228,2,1228,[302 427 180 197 603],339,5,5215,4.243287225386493,20.0,0.0
21229,2,1229,[302 427 180 197 603],339,5,5220,4.2439024390243905,20.0,0.0
21230,2,1230,[302 427 180 197 603],90,5,5225,4.244516653127539,20.0,0.0
21231,2,1231,[427 186  89 275 204],409,5,5230,4.24512987012987,0.0,0.0
21232,2,1232,[245 187 135 173 185],334,4,5234,4.244931062449311,0.0,0.0
21233,2,1233,[302 427 180 197 603],666,5,5239,4.245542949756888,20.0,0.0
21234,2,1234,[302 427 180 197 603],271,5,5244,4.246153846153846,20.0,0.0
21235,2,1235,[ 50  56 144 127 323],488,3,5247,4.245145631067961,0.0,40.0
21236,2,1236,[302 427 180 197 603],271,5,5252,4.2457558609539205,20.0,0.0
21237,2,1237,[302 427 180 197 603],666,5,5257,4.246365105008078,20.0,0.0
21238,2,1238,[ 50 180 197   8 258],313,3,5260,4.245359160613398,0.0,20.0
21239,2,1239,[471 196 151 546  89],95,3,5263,4.244354838709677,0.0,0.0
21240,2,1240,[ 12 427 216 318 603],234,3,5266,4.243352135374698,60.0,0.0
21241,2,1241,[302 427 180 197 603],271,5,5271,4.243961352657005,20.0,0.0
21242,2,1242,[302 427 180 197 603],271,5,5276,4.2445695897023334,20.0,0.0
21243,2,1243,[302 427 180 197 603],13,5,5281,4.245176848874598,20.0,0.0
21244,2,1244,[302 427 180 197 603],339,5,5286,4.2457831325301205,20.0,0.0
21245,2,1245,[302 427 180 197 603],383,5,5291,4.246388443017657,20.0,0.0
21246,2,1246,[302 427 180 197 603],90,5,5296,4.246992782678428,20.0,0.0
21247,2,1247,[302 427 180 197 603],664,5,5301,4.247596153846154,20.0,0.0
21248,2,1248,[302 427 180 197 603],90,5,5306,4.248198558847077,20.0,0.0
21249,2,1249,[302 427 180 197 603],666,5,5311,4.2488,20.0,0.0
21250,2,1250,[302 427 180 197 603],13,5,5316,4.249400479616307,20.0,0.0
21251,2,1251,[302 427 180 197 603],666,5,5321,4.25,20.0,0.0
21252,2,1252,[322  98 405 174 179],537,1,5322,4.247406225059857,0.0,40.0
21253,2,1253,[181  22 475 143 313],64,5,5327,4.248006379585327,0.0,0.0
21254,2,1254,[ 79 117  22 191  28],536,5,5332,4.248605577689243,0.0,0.0
21255,2,1255,[302 427 180 197 603],90,5,5337,4.249203821656051,20.0,0.0
21256,2,1256,[302 427 180 197 603],271,5,5342,4.249801113762928,20.0,0.0
21257,2,1257,[302 427 180 197 603],13,5,5347,4.250397456279809,20.0,0.0
21258,2,1258,[302 427 180 197 603],666,5,5352,4.25099285146942,20.0,0.0
21259,2,1259,[302 427 180 197 603],13,5,5357,4.251587301587302,20.0,0.0
21260,2,1260,[302 427 180 197 603],90,5,5362,4.25218080888184,20.0,0.0
21261,2,1261,[302 427 180 197 603],339,5,5367,4.252773375594295,20.0,0.0
21262,2,1262,[302 427 180 197 603],90,5,5372,4.253365003958828,20.0,0.0
21263,2,1263,[302 161  98 678 496],474,4,5376,4.253164556962025,0.0,20.0
21264,2,1264,[302 427 180 197 603],13,5,5381,4.253754940711462,20.0,0.0
21265,2,1265,[302 427 180 197 603],383,5,5386,4.25434439178515,20.0,0.0
21266,2,1266,[318 496 328  82 153],653,3,5389,4.253354380426203,20.0,0.0
21267,2,1267,[121   9  12 742 271],334,2,5391,4.2515772870662465,20.0,0.0
21268,2,1268,[183 143 180 313  70],378,4,5395,4.251379038613081,0.0,0.0
21269,2,1269,[568 318  89 174 435],90,5,5400,4.251968503937008,20.0,20.0
21270,2,1270,[302 427 197 180 603],271,5,5405,4.25255704169945,20.0,0.0
21271,2,1271,[302 427 197 180 603],271,5,5410,4.25314465408805,20.0,0.0
21272,2,1272,[302 427 197 180 603],537,5,5415,4.253731343283582,20.0,0.0
21273,2,1273,[742 111 282 288  95],374,4,5419,4.25353218210361,0.0,0.0
21274,2,1274,[302 427 197 180 603],666,5,5424,4.254117647058823,20.0,0.0
21275,2,1275,[302 427 197 180 603],383,5,5429,4.254702194357367,20.0,0.0
21276,2,1276,[ 11 302 200  97 234],328,3,5432,4.253719655442443,0.0,0.0
21277,2,1277,[  8 125 197 181 117],144,5,5437,4.254303599374022,0.0,0.0
21278,2,1278,[127 405 196 258 423],334,4,5441,4.254104769351056,0.0,20.0
21279,2,1279,[173 568  56 153 742],749,4,5445,4.25390625,0.0,0.0
21280,2,1280,[403 181 515 276 196],13,3,5448,4.252927400468384,0.0,0.0
21281,2,1281,[403 183 186 151 132],234,2,5450,4.251170046801872,0.0,0.0
21282,2,1282,[678 191 216 183   4],92,3,5453,4.250194855806703,0.0,0.0
21283,2,1283,[302 427 197 180 603],383,5,5458,4.250778816199377,20.0,0.0
21284,2,1284,[173   7 234  28 186],738,5,5463,4.25136186770428,0.0,0.0
21285,2,1285,[302 427 197 180 603],383,5,5468,4.25194401244168,20.0,0.0
21286,2,1286,[302 427 197 180 603],90,5,5473,4.252525252525253,20.0,0.0
21287,2,1287,[302 427 197 180 603],664,5,5478,4.253105590062112,20.0,0.0
21288,2,1288,[302 427 197 180 603],271,5,5483,4.253685027152832,20.0,0.0
21289,2,1289,[302 427 197 180 603],271,5,5488,4.254263565891473,20.0,0.0
21290,2,1290,[282  50 435 748 132],474,4,5492,4.254066615027111,0.0,20.0
21291,2,1291,[302 427 197 180 603],666,5,5497,4.254643962848297,20.0,0.0
21292,2,1292,[302 427 197 180 603],537,5,5502,4.255220417633411,20.0,0.0
21293,2,1293,[302 427 197 180 603],13,5,5507,4.255795981452859,20.0,0.0
21294,2,1294,[302 427 197 180 603],339,5,5512,4.256370656370656,20.0,0.0
21295,2,1295,[174  50 655   7 117],184,1,5513,4.253858024691358,0.0,40.0
21296,2,1296,[302 427 197 180 603],664,5,5518,4.254433307633,20.0,0.0
21297,2,1297,[302 427 197 180 603],474,5,5523,4.2550077041602465,20.0,0.0
21298,2,1298,[  7 323  98  79  22],328,4,5527,4.254811393379523,0.0,20.0
21299,2,1299,[302 427 197 180 603],13,5,5532,4.2553846153846155,20.0,0.0
21300,2,1300,[302 427 197 180 603],383,5,5537,4.255956956187548,20.0,0.0
21301,2,1301,[302 427 197 180 603],13,5,5542,4.256528417818741,20.0,0.0
21302,2,1302,[ 69 211 235 172 174],194,3,5545,4.255564082885648,0.0,20.0
21303,2,1303,[302 427 197 180 603],664,5,5550,4.256134969325154,20.0,0.0
21304,2,1304,[302 427 197 180 603],666,5,5555,4.256704980842912,20.0,0.0
21305,2,1305,[302 427 197 180 603],666,5,5560,4.257274119448699,20.0,0.0
21306,2,1306,[191 385 423 228 176],398,4,5564,4.25707727620505,0.0,0.0
21307,2,1307,[302 427 197 180 603],339,5,5569,4.257645259938838,20.0,0.0
21308,2,1308,[496  25 216 211  88],125,2,5571,4.255920550038197,0.0,0.0
21309,2,1309,[ 98 135  11 200 603],308,4,5575,4.255725190839694,20.0,20.0
21310,2,1310,[328  98 191 258 175],90,2,5577,4.254004576659039,0.0,20.0
21311,2,1311,[302 427 197 180 603],339,5,5582,4.254573170731708,20.0,0.0
21312,2,1312,[302 427 197 180 603],339,5,5587,4.255140898705255,20.0,0.0
21313,2,1313,[302 427 197 180 603],474,5,5592,4.255707762557078,20.0,0.0
21314,2,1314,[289  79 125 357 435],234,2,5594,4.253992395437263,20.0,0.0
21315,2,1315,[302 427 197 180 603],90,5,5599,4.254559270516717,20.0,0.0
21316,2,1316,[197   1  98 194 100],10,5,5604,4.255125284738041,0.0,40.0
21317,2,1317,[196 655 181 125 294],749,4,5608,4.254931714719271,0.0,0.0
21318,2,1318,[302 427 197 180 603],13,5,5613,4.255496588324489,20.0,0.0
21319,2,1319,[302 427 197 180 603],271,5,5618,4.256060606060606,20.0,0.0
21320,2,1320,[  7 181 603 135  95],308,5,5623,4.256623769871309,20.0,0.0
21321,2,1321,[302 427 197 180 603],664,5,5628,4.257186081694402,20.0,0.0
21322,2,1322,[302 427 197 180 603],339,5,5633,4.2577475434618295,20.0,0.0
21323,2,1323,[302 427 197 180 603],664,5,5638,4.258308157099698,20.0,0.0
21324,2,1324,[238 135 161 172  64],194,3,5641,4.2573584905660375,0.0,0.0
21325,2,1325,[ 95 204 405 172 216],479,4,5645,4.257164404223228,0.0,0.0
21326,2,1326,[302 427 197 180 603],339,5,5650,4.257724189902035,20.0,0.0
21327,2,1327,[302 427 197 180 603],537,5,5655,4.258283132530121,20.0,0.0
21328,2,1328,[302 427 197 180 603],666,5,5660,4.258841234010534,20.0,0.0
21329,2,1329,[302 427 197 180 603],537,5,5665,4.2593984962406015,20.0,0.0
21330,2,1330,[302 427 197 180 603],474,5,5670,4.259954921111946,20.0,0.0
21331,2,1331,[286 181 172 216 195],537,0,5670,4.256756756756757,0.0,0.0
21332,2,1332,[172 515 195 161 121],313,5,5675,4.2573143285821455,0.0,0.0
21333,2,1333,[211 181 588 182 228],95,2,5677,4.255622188905547,0.0,0.0
21334,2,1334,[302 427 197 180 603],666,5,5682,4.2561797752808985,20.0,0.0
21335,2,1335,[  7 273 234 427 144],308,2,5684,4.254491017964072,0.0,0.0
21336,2,1336,[302 427 197 180 603],537,5,5689,4.255048616305161,20.0,0.0
21337,2,1337,[603 273 210 222 204],524,0,5689,4.25186846038864,20.0,0.0
21338,2,1338,[302 427 197 180 603],13,5,5694,4.252427184466019,20.0,0.0
21339,2,1339,[475 357  79 161 546],13,1,5695,4.25,20.0,0.0
21340,2,1340,[302 427 197 180 603],13,5,5700,4.250559284116331,20.0,0.0
21341,2,1341,[302 427 197 180 603],383,5,5705,4.251117734724292,20.0,0.0
21342,2,1342,[302 427 197 180 603],664,5,5710,4.251675353685778,20.0,0.0
21343,2,1343,[302 427 197 180 603],271,5,5715,4.252232142857143,20.0,0.0
21344,2,1344,[302 427 197 180 603],383,5,5720,4.25278810408922,20.0,0.0
21345,2,1345,[117 179 180  28 588],537,2,5722,4.25111441307578,0.0,0.0
21346,2,1346,[  7 204 127 175 187],158,5,5727,4.251670378619154,0.0,20.0
21347,2,1347,[302 427 197 180 603],666,5,5732,4.252225519287834,20.0,0.0
21348,2,1348,[302 427 197 180 603],90,5,5737,4.252779836916234,20.0,0.0
21349,2,1349,[302 427 197 180 603],474,5,5742,4.253333333333333,20.0,0.0
21350,2,1350,[302 427 197 180 603],664,5,5747,4.253886010362694,20.0,0.0
21351,2,1351,[302 427 197 180 603],339,5,5752,4.254437869822485,20.0,0.0
21352,2,1352,[302 427 197 180 603],666,5,5757,4.254988913525499,20.0,0.0
21353,2,1353,[302 427 197 180 603],664,5,5762,4.255539143279173,20.0,0.0
21354,2,1354,[302 427 197 180 603],271,5,5767,4.256088560885609,20.0,0.0
21355,2,1355,[302 427 197 180 603],90,5,5772,4.256637168141593,20.0,0.0
21356,2,1356,[ 69 333 195  79 748],64,3,5775,4.255711127487104,0.0,0.0
21357,2,1357,[302 427 197 180 603],383,5,5780,4.256259204712813,20.0,0.0
21358,2,1358,[302 427 197 180 603],664,5,5785,4.256806475349522,20.0,0.0
21359,2,1359,[180 125 282  64 323],378,2,5787,4.255147058823529,0.0,0.0
21360,2,1360,[302 427 197 180 603],664,5,5792,4.255694342395298,20.0,0.0
21361,2,1361,[302 427 197 180 603],339,5,5797,4.256240822320118,20.0,0.0
21362,2,1362,[302 427 197 180 603],537,5,5802,4.256786500366838,20.0,0.0
21363,2,1363,[427 276 153  28 168],406,2,5804,4.255131964809384,0.0,0.0
21364,2,1364,[302 427 197 180 603],339,5,5809,4.255677655677656,20.0,0.0
21365,2,1365,[302 427 197 180 603],383,5,5814,4.256222547584187,20.0,0.0
21366,2,1366,[302 427 197 180 603],13,5,5819,4.25676664228237,20.0,0.0
21367,2,1367,[302 427 197 180 603],537,5,5824,4.257309941520468,20.0,0.0
21368,2,1368,[302 427 197 180 603],664,5,5829,4.257852447041636,20.0,0.0
21369,2,1369,[302 427 197 180 603],664,5,5834,4.258394160583942,20.0,0.0
21370,2,1370,[302 427 197 180 603],664,5,5839,4.258935083880379,20.0,0.0
21371,2,1371,[302 427 197 180 603],537,5,5844,4.259475218658892,20.0,0.0
21372,2,1372,[302 427 197 180 603],271,5,5849,4.260014566642389,20.0,0.0
21373,2,1373,[ 56 385 125 748 121],648,2,5851,4.258369723435226,0.0,0.0
21374,2,1374,[302 427 197 180 603],13,5,5856,4.258909090909091,20.0,0.0
21375,2,1375,[302 427 197 180 603],271,5,5861,4.259447674418604,20.0,0.0
21376,2,1376,[302 427 197 180 603],664,5,5866,4.25998547567175,20.0,0.0
21377,2,1377,[ 69  25 275 215 153],90,3,5869,4.2590711175616836,0.0,0.0
21378,2,1378,[302 427 197 180 603],537,5,5874,4.259608411892676,20.0,0.0
21379,2,1379,[403 546 175  96 121],60,4,5878,4.259420289855073,0.0,0.0
21380,2,1380,[302 427 197 180 603],383,5,5883,4.2599565532223025,20.0,0.0
21381,2,1381,[302 427 197 180 603],339,5,5888,4.260492040520984,20.0,0.0
21382,2,1382,[ 82 475 168 515 132],64,4,5892,4.260303687635575,0.0,0.0
21383,2,1383,[302 427 197 180 603],537,5,5897,4.260838150289017,20.0,0.0
21384,2,1384,[742  69 195 179 228],653,4,5901,4.260649819494585,0.0,0.0
21385,2,1385,[302 427 197 180 603],664,5,5906,4.261183261183261,20.0,0.0
21386,2,1386,[ 89 405  11 403  12],92,4,5910,4.260994953136265,20.0,0.0
21387,2,1387,[302 427 197 180 603],474,5,5915,4.261527377521614,20.0,0.0
21388,2,1388,[100 191  70  89 132],840,4,5919,4.2613390928725705,0.0,20.0
21389,2,1389,[302 427 197 180 603],537,5,5924,4.261870503597122,20.0,0.0
21390,2,1390,[121 328 245 117  25],396,3,5927,4.2609633357296905,0.0,0.0
21391,2,1391,[302 427 197 180 603],383,5,5932,4.261494252873563,20.0,0.0
21392,2,1392,[197 318 118 258 313],455,4,5936,4.261306532663316,20.0,0.0
21393,2,1393,[168 228 403 215 268],234,0,5936,4.258249641319942,0.0,0.0
21394,2,1394,[302 427 197 180 603],664,5,5941,4.258781362007168,20.0,0.0
21395,2,1395,[302 427 197 180 603],90,5,5946,4.259312320916905,20.0,0.0
21396,2,1396,[302 427 197 180 603],664,5,5951,4.25984251968504,20.0,0.0
21397,2,1397,[302 427 197 180 603],664,5,5956,4.260371959942775,20.0,0.0
21398,2,1398,[302 427 197 180 603],537,5,5961,4.2609006433166545,20.0,0.0
21399,2,1399,[302 427 197 180 603],271,5,5966,4.261428571428572,20.0,0.0
21400,2,1400,[302 427 197 180 603],474,5,5971,4.261955745895789,20.0,0.0
21401,2,1401,[125  64  56 172 118],374,4,5975,4.261768901569187,0.0,0.0
21402,2,1402,[153  22 228 100 195],64,4,5979,4.261582323592302,0.0,20.0
21403,2,1403,[144  97 180 132 655],326,4,5983,4.261396011396012,0.0,0.0
21404,2,1404,[302 427 197 180 603],474,5,5988,4.261921708185054,20.0,0.0
21405,2,1405,[302 427 197 180 603],13,5,5993,4.262446657183499,20.0,0.0
21406,2,1406,[302 427 197 180 603],666,5,5998,4.262970859985785,20.0,0.0
21407,2,1407,[302 427 197 180 603],664,5,6003,4.263494318181818,20.0,0.0
21408,2,1408,[181 144 117  95 121],313,4,6007,4.263307310149042,0.0,0.0
21409,2,1409,[678  98  12 235 200],334,3,6010,4.26241134751773,20.0,20.0
21410,2,1410,[302 427 197 180 603],271,5,6015,4.26293408929837,20.0,0.0
21411,2,1411,[302 427 197 180 603],90,5,6020,4.263456090651558,20.0,0.0
21412,2,1412,[ 50 357  15 286  96],234,2,6022,4.261854210898797,20.0,20.0
21413,2,1413,[302 427 197 180 603],90,5,6027,4.262376237623762,20.0,0.0
21414,2,1414,[ 96 289 204 125 117],406,3,6030,4.261484098939929,0.0,0.0
21415,2,1415,[127 294  71 135  70],479,3,6033,4.260593220338983,0.0,20.0
21416,2,1416,[302 427 197 180 603],339,5,6038,4.2611150317572335,20.0,0.0
21417,2,1417,[302 427 197 180 603],339,5,6043,4.26163610719323,20.0,0.0
21418,2,1418,[302 427 197 180 603],339,5,6048,4.26215644820296,20.0,0.0
21419,2,1419,[302 427 197 180 603],537,5,6053,4.262676056338028,20.0,0.0
21420,2,1420,[302 427 197 180 603],271,5,6058,4.263194933145672,20.0,0.0
21421,2,1421,[302 427 197 180 603],13,5,6063,4.263713080168777,20.0,0.0
21422,2,1422,[302 427 197 180 603],666,5,6068,4.264230498945889,20.0,0.0
21423,2,1423,[258 435 132 318 228],7,5,6073,4.264747191011236,20.0,0.0
21424,2,1424,[ 50  79 195 276  82],374,3,6076,4.263859649122807,0.0,20.0
21425,2,1425,[302 427 197 180 603],13,5,6081,4.26437587657784,20.0,0.0
21426,2,1426,[302 427 197 180 603],271,5,6086,4.264891380518571,20.0,0.0
21427,2,1427,[302 427 197 180 603],383,5,6091,4.265406162464986,20.0,0.0
21428,2,1428,[302 427 197 180 603],537,5,6096,4.26592022393282,20.0,0.0
21429,2,1429,[127 195 204 655   7],774,1,6097,4.263636363636364,0.0,20.0
21430,2,1430,[302 427 197 180 603],383,5,6102,4.264150943396227,20.0,0.0
21431,2,1431,[302 427 197 180 603],666,5,6107,4.264664804469274,20.0,0.0
21432,2,1432,[197  79 135 200 603],339,5,6112,4.265177948360083,20.0,0.0
21433,2,1433,[302 427 197 180 603],271,5,6117,4.2656903765690375,20.0,0.0
21434,2,1434,[191 197 403 568   4],533,3,6120,4.264808362369338,0.0,0.0
21435,2,1435,[302 427 197 180 603],474,5,6125,4.265320334261839,20.0,0.0
21436,2,1436,[302 427 197 180 603],13,5,6130,4.265831593597773,20.0,0.0
21437,2,1437,[302 427 197 180 603],90,5,6135,4.266342141863699,20.0,0.0
21438,2,1438,[302 427 197 180 603],90,5,6140,4.266851980542043,20.0,0.0
21439,2,1439,[302 427 197 180 603],474,5,6145,4.267361111111111,20.0,0.0
21440,2,1440,[302 427 197 180 603],537,5,6150,4.267869535045108,20.0,0.0
21441,2,1441,[302 427 197 180 603],664,5,6155,4.268377253814147,20.0,0.0
21442,2,1442,[302 427 197 180 603],271,5,6160,4.2688842688842685,20.0,0.0
21443,2,1443,[269 435 403  11 423],13,2,6162,4.267313019390581,0.0,0.0
21444,2,1444,[161 182  11   9  50],308,4,6166,4.267128027681661,0.0,20.0
21445,2,1445,[ 64 268 435 385 237],85,3,6169,4.2662517289073305,0.0,0.0
21446,2,1446,[302 427 197 180 603],537,5,6174,4.266758811333794,20.0,0.0
21447,2,1447,[ 88 258  25 175  69],313,2,6176,4.265193370165746,0.0,0.0
21448,2,1448,[302 427 197 180 603],271,5,6181,4.265700483091788,20.0,0.0
21449,2,1449,[302 427 197 180 603],339,5,6186,4.266206896551724,20.0,0.0
21450,2,1450,[515  89 121 603 195],13,3,6189,4.2653342522398345,20.0,0.0
21451,2,1451,[302 427 197 180 603],13,5,6194,4.265840220385675,20.0,0.0
21452,2,1452,[302 427 197 180 603],537,5,6199,4.266345492085341,20.0,0.0
21453,2,1453,[302 427 197 180 603],537,5,6204,4.266850068775791,20.0,0.0
21454,2,1454,[302 427 197 180 603],474,5,6209,4.267353951890034,20.0,0.0
21455,2,1455,[302 427 197 180 603],537,5,6214,4.267857142857143,20.0,0.0
21456,2,1456,[302 427 197 180 603],13,5,6219,4.268359643102265,20.0,0.0
21457,2,1457,[300 185 179  69   1],843,1,6220,4.266117969821673,0.0,0.0
21458,2,1458,[302 427 197 180 603],474,5,6225,4.2666209732693625,20.0,0.0
21459,2,1459,[302 427 197 180 603],13,5,6230,4.267123287671233,20.0,0.0
21460,2,1460,[302 427 197 180 603],339,5,6235,4.2676249144421625,20.0,0.0
21461,2,1461,[302 427 197 180 603],537,5,6240,4.26812585499316,20.0,0.0
21462,2,1462,[194 222   7 655 211],804,5,6245,4.268626110731374,0.0,0.0
21463,2,1463,[191 174  79 182   4],795,4,6249,4.26844262295082,0.0,20.0
21464,2,1464,[302 427 197 180 603],13,5,6254,4.268941979522184,20.0,0.0
21465,2,1465,[302 427 197 180 603],90,5,6259,4.269440654843111,20.0,0.0
21466,2,1466,[276  28 100 174 286],59,4,6263,4.269256987048398,0.0,40.0
21467,2,1467,[168 181  22 216 174],279,2,6265,4.267711171662126,0.0,20.0
21468,2,1468,[ 11 121 202  64 173],537,1,6266,4.265486725663717,0.0,0.0
21469,2,1469,[ 79  98 245 100 197],378,3,6269,4.264625850340136,0.0,40.0
21470,2,1470,[302 427 197 180 603],664,5,6274,4.26512576478586,20.0,0.0
21471,2,1471,[302 427 197 180 603],664,5,6279,4.265625,20.0,0.0
21472,2,1472,[302 427 197 180 603],90,5,6284,4.26612355736592,20.0,0.0
21473,2,1473,[302 427 197 180 603],474,5,6289,4.266621438263229,20.0,0.0
21474,2,1474,[302 427 197 180 603],271,5,6294,4.267118644067796,20.0,0.0
21475,2,1475,[302 427 197 180 603],383,5,6299,4.267615176151762,20.0,0.0
21476,2,1476,[302 427 197 180 603],474,5,6304,4.268111035883548,20.0,0.0
21477,2,1477,[302 427 197 180 603],666,5,6309,4.2686062246278755,20.0,0.0
21478,2,1478,[302 427 197 180 603],666,5,6314,4.269100743745774,20.0,0.0
21479,2,1479,[302 427 197 180 603],383,5,6319,4.269594594594595,20.0,0.0
21480,2,1480,[176 168 603 302 238],334,4,6323,4.269412559081702,20.0,0.0
21481,2,1481,[302 427 197 180 603],90,5,6328,4.269905533063428,20.0,0.0
21482,2,1482,[197 172 405 168 228],13,4,6332,4.269723533378287,0.0,0.0
21483,2,1483,[118 173 286 302  82],102,0,6332,4.2668463611859835,0.0,0.0
21484,2,1484,[ 82  28 427 276 172],59,5,6337,4.267340067340068,0.0,0.0
21485,2,1485,[302 427 197 180 603],666,5,6342,4.267833109017497,20.0,0.0
21486,2,1486,[ 50 153 313 168 258],85,4,6346,4.267652992602556,0.0,20.0
21487,2,1487,[302 427 197 180 603],90,5,6351,4.268145161290323,20.0,0.0
21488,2,1488,[197 118 168 187 742],308,3,6354,4.267293485560779,0.0,0.0
21489,2,1489,[302 427 197 180 603],664,5,6359,4.267785234899329,20.0,0.0
21490,2,1490,[302 427 197 180 603],666,5,6364,4.2682763246143525,20.0,0.0
21491,2,1491,[403 179 568   9 125],194,2,6366,4.266756032171582,0.0,0.0
21492,2,1492,[302 427 197 180 603],474,5,6371,4.267247153382452,20.0,0.0
21493,2,1493,[302 427 197 180 603],474,5,6376,4.267737617135207,20.0,0.0
21494,2,1494,[302 427 197 180 603],537,5,6381,4.268227424749164,20.0,0.0
21495,2,1495,[100  69 183 168 258],940,1,6382,4.266042780748663,0.0,20.0
21496,2,1496,[302 427 197 180 603],383,5,6387,4.266533066132265,20.0,0.0
21497,2,1497,[222 127  64 144  79],328,4,6391,4.266355140186916,0.0,20.0
21498,2,1498,[302 427 197 180 603],383,5,6396,4.266844563042028,20.0,0.0
21499,2,1499,[302 427 197 180 603],339,5,6401,4.267333333333333,20.0,0.0
21500,2,1500,[302 427 197 180 603],13,5,6406,4.26782145236509,20.0,0.0
21501,2,1501,[302 427 197 180 603],664,5,6411,4.2683089214380825,20.0,0.0
21502,2,1502,[302 427 197 180 603],339,5,6416,4.268795741849634,20.0,0.0
21503,2,1503,[302 427 197 180 603],90,5,6421,4.269281914893617,20.0,0.0
21504,2,1504,[302 427 197 180 603],339,5,6426,4.269767441860465,20.0,0.0
21505,2,1505,[302 427 197 180 603],537,5,6431,4.270252324037185,20.0,0.0
21506,2,1506,[302 427 197 180 603],666,5,6436,4.2707365627073655,20.0,0.0
21507,2,1507,[258 228 185  11 234],28,5,6441,4.271220159151194,0.0,0.0
21508,2,1508,[302 427 197 180 603],339,5,6446,4.271703114645461,20.0,0.0
21509,2,1509,[357 132 175   7 151],60,5,6451,4.272185430463576,20.0,0.0
21510,2,1510,[302 427 197 180 603],13,5,6456,4.272667107875579,20.0,0.0
21511,2,1511,[302 427 197 180 603],664,5,6461,4.273148148148148,20.0,0.0
21512,2,1512,[245 268 144 282  28],92,4,6465,4.272967614011897,0.0,0.0
21513,2,1513,[427  88 174 508 210],533,5,6470,4.273447820343461,0.0,20.0
21514,2,1514,[302 427 197 180 603],666,5,6475,4.273927392739274,20.0,0.0
21515,2,1515,[302 427 197 180 603],90,5,6480,4.274406332453826,20.0,0.0
21516,2,1516,[302 427 197 180 603],666,5,6485,4.274884640738299,20.0,0.0
21517,2,1517,[186 475   7   1 228],648,3,6488,4.274044795783926,0.0,0.0
21518,2,1518,[302 427 197 180 603],13,5,6493,4.2745227123107306,20.0,0.0
21519,2,1519,[302 427 197 180 603],90,5,6498,4.275,20.0,0.0
21520,2,1520,[ 97   9 118 216 405],184,2,6500,4.273504273504273,0.0,0.0
21521,2,1521,[403 173 435 323 200],648,4,6504,4.273324572930354,0.0,0.0
21522,2,1522,[302 427 197 180 603],90,5,6509,4.273801707156927,20.0,0.0
21523,2,1523,[302 427 197 180 603],537,5,6514,4.274278215223097,20.0,0.0
21524,2,1524,[302 427 197 180 603],537,5,6519,4.274754098360655,20.0,0.0
21525,2,1525,[302 427 197 180 603],383,5,6524,4.275229357798165,20.0,0.0
21526,2,1526,[197  50 588  64 143],194,3,6527,4.274394237066143,0.0,20.0
21527,2,1527,[175 125  50 655 181],334,4,6531,4.274214659685864,0.0,20.0
21528,2,1528,[200 655  70 271  96],537,1,6532,4.272073250490517,0.0,0.0
21529,2,1529,[302 427 197 180 603],664,5,6537,4.272549019607843,20.0,0.0
21530,2,1530,[302 427 197 180 603],271,5,6542,4.2730241672109734,20.0,0.0
21531,2,1531,[302 427 197 180 603],666,5,6547,4.273498694516971,20.0,0.0
21532,2,1532,[204 195  89 174 211],350,4,6551,4.273320287018917,0.0,20.0
21533,2,1533,[185 211 132 515   9],234,2,6553,4.271838331160365,0.0,0.0
21534,2,1534,[181 202 228 175 186],738,5,6558,4.2723127035830615,0.0,0.0
21535,2,1535,[302 427 197 180 603],13,5,6563,4.272786458333333,20.0,0.0
21536,2,1536,[289 173 405 204 265],374,3,6566,4.2719583604424205,0.0,0.0
21537,2,1537,[302 427 197 180 603],13,5,6571,4.272431729518856,20.0,0.0
21538,2,1538,[475 294 215 117 265],308,1,6572,4.270305393112411,0.0,0.0
21539,2,1539,[302 427 197 180 603],383,5,6577,4.270779220779221,20.0,0.0
21540,2,1540,[302 427 197 180 603],90,5,6582,4.27125243348475,20.0,0.0
21541,2,1541,[228 197 328 423 179],537,2,6584,4.269779507133593,0.0,0.0
21542,2,1542,[302 427 197 180 603],537,5,6589,4.270252754374595,20.0,0.0
21543,2,1543,[143 318  79 403 234],479,3,6592,4.269430051813472,20.0,0.0
21544,2,1544,[302 427 197 180 603],537,5,6597,4.269902912621359,20.0,0.0
21545,2,1545,[ 69 204 288 237 181],92,4,6601,4.269728331177231,0.0,0.0
21546,2,1546,[302 427 197 180 603],664,5,6606,4.270200387847447,20.0,0.0
21547,2,1547,[302 427 197 180 603],474,5,6611,4.270671834625323,20.0,0.0
21548,2,1548,[302 427 197 180 603],474,5,6616,4.27114267269206,20.0,0.0
21549,2,1549,[ 82  79  97 385  50],538,4,6620,4.2709677419354835,0.0,20.0
21550,2,1550,[333 234 179 196 121],85,3,6623,4.270148291424888,0.0,0.0
21551,2,1551,[302 427 197 180 603],13,5,6628,4.270618556701031,20.0,0.0
21552,2,1552,[302 427 197 180 603],90,5,6633,4.271088216355441,20.0,0.0
21553,2,1553,[302 427 197 180 603],666,5,6638,4.271557271557271,20.0,0.0
21554,2,1554,[302 427 197 180 603],474,5,6643,4.272025723472669,20.0,0.0
21555,2,1555,[302 427 197 180 603],666,5,6648,4.272493573264781,20.0,0.0
21556,2,1556,[603  56 265 185 168],313,3,6651,4.271676300578035,20.0,0.0
21557,2,1557,[302 427 197 180 603],666,5,6656,4.2721437740693196,20.0,0.0
21558,2,1558,[302 427 197 180 603],339,5,6661,4.272610647851186,20.0,0.0
21559,2,1559,[302 427 197 180 603],537,5,6666,4.273076923076923,20.0,0.0
21560,2,1560,[302 427 197 180 603],383,5,6671,4.273542600896861,20.0,0.0
21561,2,1561,[302 427 197 180 603],271,5,6676,4.274007682458387,20.0,0.0
21562,2,1562,[302 427 197 180 603],271,5,6681,4.27447216890595,20.0,0.0
21563,2,1563,[302 427 197 180 603],383,5,6686,4.274936061381074,20.0,0.0
21564,2,1564,[302 427 197 180 603],537,5,6691,4.275399361022364,20.0,0.0
21565,2,1565,[235 322 222 185  79],537,1,6692,4.27330779054917,0.0,0.0
21566,2,1566,[ 11 588 300 294 182],537,1,6693,4.271218889597958,0.0,0.0
21567,2,1567,[302 427 197 180 603],13,5,6698,4.271683673469388,20.0,0.0
21568,2,1568,[132 546 483 161   4],749,3,6701,4.27087316762269,20.0,0.0
21569,2,1569,[302 427 197 180 603],383,5,6706,4.271337579617835,20.0,0.0
21570,2,1570,[302 427 197 180 603],13,5,6711,4.271801400381922,20.0,0.0
21571,2,1571,[302 427 197 180 603],474,5,6716,4.272264631043257,20.0,0.0
21572,2,1572,[ 79 100  64  12 265],308,4,6720,4.272091544818817,20.0,20.0
21573,2,1573,[302 427 197 180 603],90,5,6725,4.2725540025412965,20.0,0.0
21574,2,1574,[302 427 197 180 603],474,5,6730,4.273015873015873,20.0,0.0
21575,2,1575,[302 427 197 180 603],339,5,6735,4.273477157360406,20.0,0.0
21576,2,1576,[238 235 197 176 200],738,3,6738,4.272669625871909,0.0,0.0
21577,2,1577,[302 427 197 180 603],13,5,6743,4.273130544993663,20.0,0.0
21578,2,1578,[121 273 515 678  56],213,5,6748,4.27359088030399,0.0,0.0
21579,2,1579,[302 427 197 180 603],13,5,6753,4.2740506329113925,20.0,0.0
21580,2,1580,[ 95 176   7 195 196],59,4,6757,4.2738772928526245,0.0,0.0
21581,2,1581,[  7 172 153 187 132],788,3,6760,4.27307206068268,0.0,0.0
21582,2,1582,[302 427 197 180 603],537,5,6765,4.273531269740998,20.0,0.0
21583,2,1583,[302 427 197 180 603],90,5,6770,4.273989898989899,20.0,0.0
21584,2,1584,[302 427 197 180 603],90,5,6775,4.274447949526814,20.0,0.0
21585,2,1585,[302 427 197 180 603],339,5,6780,4.274905422446406,20.0,0.0
21586,2,1586,[357 546 302  28 174],271,4,6784,4.274732199117833,20.0,20.0
21587,2,1587,[302 427 197 180 603],537,5,6789,4.275188916876575,20.0,0.0
21588,2,1588,[302 427 197 180 603],271,5,6794,4.275645059786029,20.0,0.0
21589,2,1589,[302 427 197 180 603],537,5,6799,4.276100628930817,20.0,0.0
21590,2,1590,[385 194 568  50 191],308,5,6804,4.2765556253928345,0.0,20.0
21591,2,1591,[269 185 603 238 265],13,2,6806,4.275125628140704,20.0,0.0
21592,2,1592,[111 125 423 245 597],92,2,6808,4.273697426239799,0.0,0.0
21593,2,1593,[ 69 173 238 143 588],312,3,6811,4.272898368883312,0.0,0.0
21594,2,1594,[302 427 197 180 603],664,5,6816,4.273354231974921,20.0,0.0
21595,2,1595,[302 427 197 180 603],664,5,6821,4.273809523809524,20.0,0.0
21596,2,1596,[302 427 197 180 603],474,5,6826,4.2742642454602375,20.0,0.0
21597,2,1597,[302 427 197 180 603],664,5,6831,4.274718397997497,20.0,0.0
21598,2,1598,[302 427 197 180 603],13,5,6836,4.275171982489056,20.0,0.0
21599,2,1599,[302 427 197 180 603],339,5,6841,4.275625,20.0,0.0
21600,2,1600,[143 294  64 181   4],881,3,6844,4.274828232354778,0.0,0.0
21601,2,1601,[302 427 197 180 603],383,5,6849,4.275280898876405,20.0,0.0
21602,2,1602,[302 427 197 180 603],664,5,6854,4.2757330006238305,20.0,0.0
21603,2,1603,[222  71   9  69  96],13,3,6857,4.274937655860349,0.0,0.0
21604,2,1604,[175 258 300 151  22],378,4,6861,4.274766355140187,0.0,0.0
21605,2,1605,[302 427 197 180 603],474,5,6866,4.275217932752179,20.0,0.0
21606,2,1606,[302 427 197 180 603],13,5,6871,4.2756689483509644,20.0,0.0
21607,2,1607,[211 210 357 568  64],188,5,6876,4.276119402985074,20.0,0.0
21608,2,1608,[748  98 144 143 318],804,4,6880,4.2759477936606585,20.0,20.0
21609,2,1609,[302 427 197 180 603],90,5,6885,4.27639751552795,20.0,0.0
21610,2,1610,[302 427 197 180 603],537,5,6890,4.2768466790813155,20.0,0.0
21611,2,1611,[ 56  89  11 211 385],804,4,6894,4.276674937965261,0.0,0.0
21612,2,1612,[121   4 276 174  98],538,2,6896,4.2752634841909485,0.0,40.0
21613,2,1613,[302 427 197 180 603],90,5,6901,4.2757125154894675,20.0,0.0
21614,2,1614,[ 69 185 302 385  50],666,2,6903,4.274303405572756,0.0,20.0
21615,2,1615,[302 427 197 180 603],90,5,6908,4.274752475247524,20.0,0.0
21616,2,1616,[302 427 197 180 603],339,5,6913,4.275200989486704,20.0,0.0
21617,2,1617,[302 427 197 180 603],537,5,6918,4.275648949320148,20.0,0.0
21618,2,1618,[302 427 197 180 603],339,5,6923,4.27609635577517,20.0,0.0
21619,2,1619,[302 427 197 180 603],537,5,6928,4.276543209876543,20.0,0.0
21620,2,1620,[302 427 197 180 603],383,5,6933,4.276989512646514,20.0,0.0
21621,2,1621,[302 427 197 180 603],271,5,6938,4.277435265104809,20.0,0.0
21622,2,1622,[603 117 143 204 175],650,5,6943,4.277880468268639,20.0,0.0
21623,2,1623,[228 234  88 603 748],883,5,6948,4.278325123152709,20.0,0.0
21624,2,1624,[  7  56 176 237 282],115,4,6952,4.278153846153846,0.0,0.0
21625,2,1625,[302 427 197 180 603],90,5,6957,4.27859778597786,20.0,0.0
21626,2,1626,[269 179 181 678  69],7,2,6959,4.27719729563614,0.0,0.0
21627,2,1627,[302 427 197 180 603],474,5,6964,4.277641277641278,20.0,0.0
21628,2,1628,[748 194 597 228 100],328,1,6965,4.275629220380601,0.0,20.0
21629,2,1629,[302 427 197 180 603],13,5,6970,4.276073619631902,20.0,0.0
21630,2,1630,[210  70 603 121 282],271,3,6973,4.275291232372777,20.0,0.0
21631,2,1631,[302 427 197 180 603],90,5,6978,4.275735294117647,20.0,0.0
21632,2,1632,[302 427 197 180 603],666,5,6983,4.276178812002449,20.0,0.0
21633,2,1633,[302 427 197 180 603],666,5,6988,4.276621787025704,20.0,0.0
21634,2,1634,[302 427 197 180 603],339,5,6993,4.277064220183486,20.0,0.0
21635,2,1635,[302 427 197 180 603],13,5,6998,4.277506112469438,20.0,0.0
21636,2,1636,[302 427 197 180 603],664,5,7003,4.277947464874771,20.0,0.0
21637,2,1637,[302 427 197 180 603],664,5,7008,4.278388278388278,20.0,0.0
21638,2,1638,[302 427 197 180 603],537,5,7013,4.278828553996339,20.0,0.0
21639,2,1639,[ 25  82 568 176   4],343,3,7016,4.278048780487805,0.0,0.0
21640,2,1640,[125  28 222 118  89],648,4,7020,4.2778793418647165,0.0,0.0
21641,2,1641,[302 427 197 180 603],666,5,7025,4.278319123020706,20.0,0.0
21642,2,1642,[302 427 197 180 603],537,5,7030,4.278758368837493,20.0,0.0
21643,2,1643,[302 427 197 180 603],90,5,7035,4.279197080291971,20.0,0.0
21644,2,1644,[302 427 197 180 603],664,5,7040,4.279635258358662,20.0,0.0
21645,2,1645,[275 186  64 181 121],271,4,7044,4.279465370595383,0.0,0.0
21646,2,1646,[161 125 228 385 423],295,5,7049,4.279902853673345,0.0,0.0
21647,2,1647,[302 427 197 180 603],90,5,7054,4.280339805825243,20.0,0.0
21648,2,1648,[302 427 197 180 603],339,5,7059,4.28077622801698,20.0,0.0
21649,2,1649,[302 427 197 180 603],666,5,7064,4.281212121212121,20.0,0.0
21650,2,1650,[302 427 197 180 603],664,5,7069,4.281647486371896,20.0,0.0
21651,2,1651,[302 427 197 180 603],537,5,7074,4.282082324455206,20.0,0.0
21652,2,1652,[597 172 515  64  98],899,3,7077,4.281306715063521,0.0,20.0
21653,2,1653,[302 427 197 180 603],13,5,7082,4.28174123337364,20.0,0.0
21654,2,1654,[294 117  15 302 269],378,3,7085,4.280966767371601,0.0,0.0
21655,2,1655,[302 427 197 180 603],13,5,7090,4.281400966183575,20.0,0.0
21656,2,1656,[173 191 176 215 172],95,4,7094,4.281231140615571,0.0,0.0
21657,2,1657,[302 427 197 180 603],13,5,7099,4.281664656212304,20.0,0.0
21658,2,1658,[302 427 197 180 603],537,5,7104,4.282097649186257,20.0,0.0
21659,2,1659,[ 12 235 181  98 176],64,5,7109,4.282530120481928,20.0,20.0
21660,2,1660,[302 427 197 180 603],339,5,7114,4.282962071041541,20.0,0.0
21661,2,1661,[302 427 197 180 603],271,5,7119,4.283393501805054,20.0,0.0
21662,2,1662,[302 427 197 180 603],90,5,7124,4.283824413710162,20.0,0.0
21663,2,1663,[265   4 471  56 180],666,4,7128,4.283653846153846,0.0,0.0
21664,2,1664,[ 22 191 100 235 185],184,3,7131,4.282882882882883,0.0,20.0
21665,2,1665,[302 427 197 180 603],537,5,7136,4.283313325330132,20.0,0.0
21666,2,1666,[302 427 197 180 603],664,5,7141,4.28374325134973,20.0,0.0
21667,2,1667,[302 427 197 180 603],537,5,7146,4.284172661870503,20.0,0.0
21668,2,1668,[302 427 197 180 603],537,5,7151,4.2846015578190535,20.0,0.0
21669,2,1669,[  8 210 238 275 183],158,4,7155,4.2844311377245505,0.0,0.0
21670,2,1670,[135 151 197 186  89],374,3,7158,4.283662477558348,0.0,0.0
21671,2,1671,[302 427 197 180 603],664,5,7163,4.284090909090909,20.0,0.0
21672,2,1672,[  7 237 168 127  28],7,5,7168,4.2845188284518825,0.0,20.0
21673,2,1673,[313 195 269 508 357],13,1,7169,4.282556750298686,20.0,0.0
21674,2,1674,[333 483 135 357  89],537,4,7173,4.282388059701493,40.0,0.0
21675,2,1675,[427 176 191 135 180],339,5,7178,4.282816229116945,0.0,0.0
21676,2,1676,[234 187 121  28 181],85,4,7182,4.282647584973167,0.0,0.0
21677,2,1677,[302 427 197 180 603],666,5,7187,4.283075089392134,20.0,0.0
21678,2,1678,[302 427 197 180 603],90,5,7192,4.283502084574152,20.0,0.0
21679,2,1679,[302 427 197 180 603],339,5,7197,4.2839285714285715,20.0,0.0
21680,2,1680,[302 427 197 180 603],271,5,7202,4.284354550862582,20.0,0.0
21681,2,1681,[302 427 197 180 603],664,5,7207,4.284780023781213,20.0,0.0
21682,2,1682,[196 135 568  96 276],455,5,7212,4.285204991087344,0.0,0.0
21683,2,1683,[302 427 197 180 603],664,5,7217,4.28562945368171,20.0,0.0
21684,2,1684,[302 427 197 180 603],537,5,7222,4.286053412462908,20.0,0.0
21685,2,1685,[302 427 197 180 603],537,5,7227,4.286476868327402,20.0,0.0
21686,2,1686,[302 427 197 180 603],339,5,7232,4.286899822169532,20.0,0.0
21687,2,1687,[302 427 197 180 603],664,5,7237,4.287322274881516,20.0,0.0
21688,2,1688,[302 427 197 180 603],383,5,7242,4.287744227353463,20.0,0.0
21689,2,1689,[302 427 197 180 603],339,5,7247,4.288165680473373,20.0,0.0
21690,2,1690,[ 98 185 235 194  64],833,2,7249,4.286812536960379,0.0,20.0
21691,2,1691,[144 173 186 271   4],650,2,7251,4.285460992907802,0.0,0.0
21692,2,1692,[655 313   4 275 100],474,4,7255,4.285292380389841,0.0,20.0
21693,2,1693,[302 427 197 180 603],90,5,7260,4.285714285714286,20.0,0.0
21694,2,1694,[302 427 197 180 603],271,5,7265,4.286135693215339,20.0,0.0
21695,2,1695,[302 427 197 180 603],383,5,7270,4.286556603773585,20.0,0.0
21696,2,1696,[302 427 197 180 603],383,5,7275,4.286977018267531,20.0,0.0
21697,2,1697,[276 228 135 202 121],374,4,7279,4.286808009422851,0.0,0.0
21698,2,1698,[302 427 197 180 603],339,5,7284,4.287227781047675,20.0,0.0
21699,2,1699,[302 427 197 180 603],90,5,7289,4.28764705882353,20.0,0.0
21700,2,1700,[238   1 515 174 357],271,4,7293,4.287477954144621,20.0,20.0
21701,2,1701,[168 121 234 597  97],804,4,7297,4.287309048178614,0.0,0.0
21702,2,1702,[568  50  25 286 508],85,2,7299,4.285965942454492,0.0,20.0
21703,2,1703,[302 427 197 180 603],13,5,7304,4.286384976525822,20.0,0.0
21704,2,1704,[121  12 172 176 471],378,4,7308,4.286217008797654,20.0,0.0
21705,2,1705,[302 427 197 180 603],13,5,7313,4.286635404454866,20.0,0.0
21706,2,1706,[302 427 197 180 603],666,5,7318,4.2870533099004104,20.0,0.0
21707,2,1707,[ 96 173 111 423 385],454,2,7320,4.285714285714286,0.0,0.0
21708,2,1708,[302 427 197 180 603],383,5,7325,4.286132241076653,20.0,0.0
21709,2,1709,[ 12  98 597  96 127],533,4,7329,4.2859649122807015,20.0,40.0
21710,2,1710,[302 427 197 180 603],13,5,7334,4.286382232612508,20.0,0.0
21711,2,1711,[302 427 197 180 603],666,5,7339,4.286799065420561,20.0,0.0
21712,2,1712,[302 427 197 180 603],90,5,7344,4.287215411558669,20.0,0.0
21713,2,1713,[302 427 197 180 603],13,5,7349,4.287631271878646,20.0,0.0
21714,2,1714,[143  82 125  22 427],334,3,7352,4.2868804664723035,0.0,0.0
21715,2,1715,[ 82   1 151 111  12],669,5,7357,4.287296037296037,20.0,0.0
21716,2,1716,[ 22 237 215 185  95],749,3,7360,4.286546301688992,0.0,0.0
21717,2,1717,[302 427 197 180 603],474,5,7365,4.286961583236321,20.0,0.0
21718,2,1718,[302 427 197 180 603],13,5,7370,4.28737638161722,20.0,0.0
21719,2,1719,[302 427 197 180 603],664,5,7375,4.287790697674419,20.0,0.0
21720,2,1720,[302 427 197 180 603],339,5,7380,4.288204532248693,20.0,0.0
21721,2,1721,[302 427 197 180 603],537,5,7385,4.288617886178862,20.0,0.0
21722,2,1722,[302 427 197 180 603],90,5,7390,4.289030760301799,20.0,0.0
21723,2,1723,[302 427 197 180 603],13,5,7395,4.289443155452436,20.0,0.0
21724,2,1724,[302 427 197 180 603],90,5,7400,4.2898550724637685,20.0,0.0
21725,2,1725,[111 174  71 318 597],554,5,7405,4.29026651216686,20.0,20.0
21726,2,1726,[302 427 197 180 603],339,5,7410,4.290677475390851,20.0,0.0
21727,2,1727,[302 427 197 180 603],13,5,7415,4.291087962962963,20.0,0.0
21728,2,1728,[302 427 197 180 603],666,5,7420,4.291497975708502,20.0,0.0
21729,2,1729,[302 427 197 180 603],271,5,7425,4.291907514450867,20.0,0.0
21730,2,1730,[568  89  28 289 357],881,4,7429,4.291738879260543,20.0,0.0
21731,2,1731,[302 427 197 180 603],339,5,7434,4.2921478060046185,20.0,0.0
21732,2,1732,[191 496  56  71 235],82,3,7437,4.291402192729371,0.0,0.0
21733,2,1733,[302 427 197 180 603],339,5,7442,4.291810841983852,20.0,0.0
21734,2,1734,[302 427 197 180 603],13,5,7447,4.292219020172911,20.0,0.0
21735,2,1735,[302 427 197 180 603],474,5,7452,4.292626728110599,20.0,0.0
21736,2,1736,[302 427 197 180 603],383,5,7457,4.293033966609096,20.0,0.0
21737,2,1737,[302 427 197 180 603],666,5,7462,4.293440736478711,20.0,0.0
21738,2,1738,[302 427 197 180 603],474,5,7467,4.29384703852789,20.0,0.0
21739,2,1739,[237 265 183 546 200],447,3,7470,4.293103448275862,0.0,0.0
21740,2,1740,[302 427 197 180 603],271,5,7475,4.29350947731189,20.0,0.0
21741,2,1741,[423   4 194 323 546],13,3,7478,4.29276693455798,0.0,0.0
21742,2,1742,[302 427 197 180 603],537,5,7483,4.293172690763052,20.0,0.0
21743,2,1743,[302 427 197 180 603],90,5,7488,4.293577981651376,20.0,0.0
21744,2,1744,[302 427 197 180 603],666,5,7493,4.293982808022923,20.0,0.0
21745,2,1745,[ 56   7 144 132 508],13,3,7496,4.293241695303551,0.0,0.0
21746,2,1746,[216  79 276 173  70],210,5,7501,4.293646250715512,0.0,0.0
21747,2,1747,[655 176 237  56 300],378,5,7506,4.294050343249428,0.0,0.0
21748,2,1748,[302 427 197 180 603],90,5,7511,4.294453973699257,20.0,0.0
21749,2,1749,[302 427 197 180 603],474,5,7516,4.2948571428571425,20.0,0.0
21750,2,1750,[302 427 197 180 603],13,5,7521,4.295259851513421,20.0,0.0
21751,2,1751,[302 427 197 180 603],90,5,7526,4.295662100456621,20.0,0.0
21752,2,1752,[302 427 197 180 603],271,5,7531,4.296063890473474,20.0,0.0
21753,2,1753,[302 427 197 180 603],90,5,7536,4.296465222348917,20.0,0.0
21754,2,1754,[ 12  88 127 187 269],343,5,7541,4.296866096866097,20.0,20.0
21755,2,1755,[302 427 197 180 603],271,5,7546,4.2972665148063784,20.0,0.0
21756,2,1756,[172 265  71 238  12],59,4,7550,4.297097324985772,20.0,0.0
21757,2,1757,[302 427 197 180 603],666,5,7555,4.297497155858931,20.0,0.0
21758,2,1758,[302 427 197 180 603],383,5,7560,4.297896532120523,20.0,0.0
21759,2,1759,[302 427 197 180 603],90,5,7565,4.298295454545454,20.0,0.0
21760,2,1760,[302 427 197 180 603],474,5,7570,4.298693923906871,20.0,0.0
21761,2,1761,[117 268 121 204  25],537,1,7571,4.296821793416572,0.0,0.0
21762,2,1762,[168 111 427 185 742],833,2,7573,4.295519001701645,0.0,0.0
21763,2,1763,[194   1   7 302  95],537,2,7575,4.29421768707483,0.0,0.0
21764,2,1764,[302 427 197 180 603],271,5,7580,4.294617563739377,20.0,0.0
21765,2,1765,[ 96 121 197 357 435],537,2,7582,4.293318233295583,20.0,0.0
21766,2,1766,[302 427 197 180 603],13,5,7587,4.293718166383702,20.0,0.0
21767,2,1767,[302 427 197 180 603],537,5,7592,4.294117647058823,20.0,0.0
21768,2,1768,[302 427 197 180 603],664,5,7597,4.294516676088185,20.0,0.0
21769,2,1769,[302 427 197 180 603],666,5,7602,4.294915254237288,20.0,0.0
21770,2,1770,[302 427 197 180 603],474,5,7607,4.295313382269904,20.0,0.0
21771,2,1771,[179 235 568 202  88],92,1,7608,4.293453724604966,0.0,0.0
21772,2,1772,[302 427 197 180 603],474,5,7613,4.29385222786238,20.0,0.0
21773,2,1773,[302 427 197 180 603],537,5,7618,4.294250281848929,20.0,0.0
21774,2,1774,[302 427 197 180 603],664,5,7623,4.2946478873239435,20.0,0.0
21775,2,1775,[302 427 197 180 603],271,5,7628,4.295045045045045,20.0,0.0
21776,2,1776,[302 427 197 180 603],339,5,7633,4.295441755768149,20.0,0.0
21777,2,1777,[195 121 200 179 318],774,1,7634,4.293588301462317,20.0,0.0
21778,2,1778,[302 427 197 180 603],664,5,7639,4.29398538504778,20.0,0.0
21779,2,1779,[302 427 197 180 603],664,5,7644,4.29438202247191,20.0,0.0
21780,2,1780,[222 403 204 655 678],339,2,7646,4.293093767546322,0.0,0.0
21781,2,1781,[286 385 423 234 427],13,3,7649,4.292368125701459,0.0,0.0
21782,2,1782,[302 427 197 180 603],90,5,7654,4.292765002804263,20.0,0.0
21783,2,1783,[302 427 197 180 603],664,5,7659,4.293161434977579,20.0,0.0
21784,2,1784,[302 427 197 180 603],474,5,7664,4.2935574229691875,20.0,0.0
21785,2,1785,[302 427 197 180 603],537,5,7669,4.293952967525196,20.0,0.0
21786,2,1786,[302 427 197 180 603],537,5,7674,4.294348069390039,20.0,0.0
21787,2,1787,[302 427 197 180 603],339,5,7679,4.2947427293064875,20.0,0.0
21788,2,1788,[302 427 197 180 603],383,5,7684,4.295136948015651,20.0,0.0
21789,2,1789,[302 427 197 180 603],666,5,7689,4.295530726256983,20.0,0.0
21790,2,1790,[302 427 197 180 603],666,5,7694,4.295924064768286,20.0,0.0
21791,2,1791,[302 427 197 180 603],90,5,7699,4.296316964285714,20.0,0.0
21792,2,1792,[302 427 197 180 603],90,5,7704,4.296709425543781,20.0,0.0
21793,2,1793,[302 427 197 180 603],537,5,7709,4.297101449275362,20.0,0.0
21794,2,1794,[302 427 197 180 603],664,5,7714,4.297493036211699,20.0,0.0
21795,2,1795,[302 427 197 180 603],271,5,7719,4.297884187082405,20.0,0.0
21796,2,1796,[ 89   1 597  82 211],882,5,7724,4.2982749026154705,0.0,0.0
21797,2,1797,[302 427 197 180 603],339,5,7729,4.298665183537263,20.0,0.0
21798,2,1798,[302 427 197 180 603],537,5,7734,4.29905503057254,20.0,0.0
21799,2,1799,[173   7 194 182 153],843,1,7735,4.2972222222222225,0.0,0.0
21800,2,1800,[258 238  28  56 496],59,4,7739,4.29705719044975,0.0,0.0
21801,2,1801,[302 427 197 180 603],664,5,7744,4.297447280799112,20.0,0.0
21802,2,1802,[302 427 197 180 603],474,5,7749,4.29783693843594,20.0,0.0
21803,2,1803,[302 427 197 180 603],271,5,7754,4.298226164079822,20.0,0.0
21804,2,1804,[302 427 197 180 603],383,5,7759,4.298614958448754,20.0,0.0
21805,2,1805,[302 427 197 180 603],339,5,7764,4.299003322259137,20.0,0.0
21806,2,1806,[234  70 435 322 185],804,4,7768,4.298837852794687,0.0,0.0
21807,2,1807,[302 427 197 180 603],271,5,7773,4.299225663716814,20.0,0.0
21808,2,1808,[302 427 197 180 603],474,5,7778,4.299613045881703,20.0,0.0
21809,2,1809,[302 427 197 180 603],537,5,7783,4.3,20.0,0.0
21810,2,1810,[ 79 423 194 678 294],474,3,7786,4.299282164549973,0.0,0.0
21811,2,1811,[302 427 197 180 603],339,5,7791,4.299668874172186,20.0,0.0
21812,2,1812,[302 427 197 180 603],13,5,7796,4.300055157198014,20.0,0.0
21813,2,1813,[121 328 215  11  28],554,5,7801,4.300441014332966,0.0,0.0
21814,2,1814,[302 427 197 180 603],537,5,7806,4.3008264462809915,20.0,0.0
21815,2,1815,[302 427 197 180 603],383,5,7811,4.301211453744493,20.0,0.0
21816,2,1816,[302 427 197 180 603],537,5,7816,4.301596037424326,20.0,0.0
21817,2,1817,[302 427 197 180 603],383,5,7821,4.301980198019802,20.0,0.0
21818,2,1818,[302 427 197 180 603],383,5,7826,4.302363936228697,20.0,0.0
21819,2,1819,[302 427 197 180 603],13,5,7831,4.302747252747253,20.0,0.0
21820,2,1820,[302 427 197 180 603],90,5,7836,4.303130148270181,20.0,0.0
21821,2,1821,[302 427 197 180 603],474,5,7841,4.303512623490669,20.0,0.0
21822,2,1822,[302 427 197 180 603],383,5,7846,4.303894679100384,20.0,0.0
21823,2,1823,[ 89 197 237  50  11],13,4,7850,4.303728070175438,0.0,20.0
21824,2,1824,[302 427 197 180 603],383,5,7855,4.304109589041096,20.0,0.0
21825,2,1825,[302 427 197 180 603],271,5,7860,4.304490690032859,20.0,0.0
21826,2,1826,[302 427 197 180 603],13,5,7865,4.304871373836891,20.0,0.0
21827,2,1827,[302 427 197 180 603],383,5,7870,4.305251641137856,20.0,0.0
21828,2,1828,[302 427 197 180 603],90,5,7875,4.305631492618917,20.0,0.0
21829,2,1829,[302 427 197 180 603],90,5,7880,4.306010928961749,20.0,0.0
21830,2,1830,[302 427 197 180 603],666,5,7885,4.3063899508465315,20.0,0.0
21831,2,1831,[302 427 197 180 603],666,5,7890,4.306768558951965,20.0,0.0
21832,2,1832,[302 427 197 180 603],339,5,7895,4.307146753955265,20.0,0.0
21833,2,1833,[302 427 197 180 603],666,5,7900,4.30752453653217,20.0,0.0
21834,2,1834,[302 427 197 180 603],664,5,7905,4.307901907356948,20.0,0.0
21835,2,1835,[302 427 197 180 603],664,5,7910,4.308278867102397,20.0,0.0
21836,2,1836,[471 161  97 318 357],234,2,7912,4.307022318998367,40.0,0.0
21837,2,1837,[302 427 197 180 603],474,5,7917,4.307399347116431,20.0,0.0
21838,2,1838,[268 197 151 588   1],189,5,7922,4.307775965198477,0.0,0.0
21839,2,1839,[302 427 197 180 603],13,5,7927,4.308152173913044,20.0,0.0
21840,2,1840,[302 427 197 180 603],339,5,7932,4.308527973927213,20.0,0.0
21841,2,1841,[222 238  64 483 273],13,2,7934,4.307274701411509,20.0,0.0
21842,2,1842,[302 427 197 180 603],474,5,7939,4.307650569723277,20.0,0.0
21843,2,1843,[ 79 117  28  22 496],378,3,7942,4.306941431670282,0.0,0.0
21844,2,1844,[302 427 197 180 603],383,5,7947,4.307317073170732,20.0,0.0
21845,2,1845,[302 427 197 180 603],666,5,7952,4.3076923076923075,20.0,0.0
21846,2,1846,[302 427 197 180 603],339,5,7957,4.308067135896048,20.0,0.0
21847,2,1847,[302 427 197 180 603],339,5,7962,4.308441558441558,20.0,0.0
21848,2,1848,[302 427 197 180 603],666,5,7967,4.30881557598702,20.0,0.0
21849,2,1849,[427   4 151 655 174],334,4,7971,4.308648648648648,0.0,20.0
21850,2,1850,[597 568 182 118 483],788,1,7972,4.306861156131821,20.0,0.0
21851,2,1851,[ 70   8 300 588 234],64,4,7976,4.306695464362851,0.0,0.0
21852,2,1852,[215  96 200 655 174],643,3,7979,4.3059902860226655,0.0,20.0
21853,2,1853,[153 195 168 118 197],374,3,7982,4.305285868392665,0.0,0.0
21854,2,1854,[597 678  25 235 257],141,3,7985,4.304582210242588,0.0,0.0
21855,2,1855,[183 202   8 435  12],64,5,7990,4.304956896551724,20.0,0.0
21856,2,1856,[182 275  64 286 100],318,4,7994,4.30479267635972,0.0,20.0
21857,2,1857,[302 427 197 180 603],664,5,7999,4.305166846071044,20.0,0.0
21858,2,1858,[268 125 100 135  15],234,2,8001,4.303926842388381,0.0,20.0
21859,2,1859,[302 427 197 180 603],664,5,8006,4.3043010752688176,20.0,0.0
21860,2,1860,[302 427 197 180 603],666,5,8011,4.304674905964535,20.0,0.0
21861,2,1861,[302 427 197 180 603],271,5,8016,4.305048335123523,20.0,0.0
21862,2,1862,[302 427 197 180 603],13,5,8021,4.3054213633923775,20.0,0.0
21863,2,1863,[302 427 197 180 603],13,5,8026,4.305793991416309,20.0,0.0
21864,2,1864,[302 427 197 180 603],664,5,8031,4.306166219839142,20.0,0.0
21865,2,1865,[302 427 197 180 603],664,5,8036,4.306538049303323,20.0,0.0
21866,2,1866,[302 427 197 180 603],339,5,8041,4.30690948044992,20.0,0.0
21867,2,1867,[302 427 197 180 603],664,5,8046,4.30728051391863,20.0,0.0
21868,2,1868,[302 427 197 180 603],90,5,8051,4.3076511503477795,20.0,0.0
21869,2,1869,[302 427 197 180 603],666,5,8056,4.308021390374331,20.0,0.0
21870,2,1870,[302 427 197 180 603],474,5,8061,4.308391234633886,20.0,0.0
21871,2,1871,[302 427 197 180 603],13,5,8066,4.308760683760684,20.0,0.0
21872,2,1872,[302 427 197 180 603],339,5,8071,4.309129738387614,20.0,0.0
21873,2,1873,[302 427 197 180 603],339,5,8076,4.309498399146212,20.0,0.0
21874,2,1874,[ 22 238  79 333 215],313,4,8080,4.309333333333333,0.0,0.0
21875,2,1875,[302 427 197 180 603],13,5,8085,4.309701492537314,20.0,0.0
21876,2,1876,[302 427 197 180 603],90,5,8090,4.310069259456579,20.0,0.0
21877,2,1877,[  1 179 185 568 187],379,5,8095,4.310436634717785,0.0,0.0
21878,2,1878,[302 427 197 180 603],666,5,8100,4.310803618946248,20.0,0.0
21879,2,1879,[302 427 197 180 603],271,5,8105,4.3111702127659575,20.0,0.0
21880,2,1880,[ 96   4 435 175 546],378,3,8108,4.310473152578416,0.0,0.0
21881,2,1881,[302 427 197 180 603],339,5,8113,4.310839532412327,20.0,0.0
21882,2,1882,[546 258 286 313 118],200,4,8117,4.310674455655868,0.0,0.0
21883,2,1883,[  1 234 173 132 153],643,5,8122,4.31104033970276,0.0,0.0
21884,2,1884,[302 427 197 180 603],537,5,8127,4.311405835543766,20.0,0.0
21885,2,1885,[302 427 197 180 603],383,5,8132,4.311770943796395,20.0,0.0
21886,2,1886,[302 427 197 180 603],666,5,8137,4.312135665076841,20.0,0.0
21887,2,1887,[302 427 197 180 603],537,5,8142,4.3125,20.0,0.0
21888,2,1888,[302 427 197 180 603],339,5,8147,4.31286394917946,20.0,0.0
21889,2,1889,[302 427 197 180 603],383,5,8152,4.313227513227513,20.0,0.0
21890,2,1890,[742 179 216 508 276],59,4,8156,4.313061872025384,0.0,0.0
21891,2,1891,[302 427 197 180 603],666,5,8161,4.313424947145878,20.0,0.0
21892,2,1892,[302 427 197 180 603],474,5,8166,4.31378763866878,20.0,0.0
21893,2,1893,[302 427 197 180 603],537,5,8171,4.31414994720169,20.0,0.0
21894,2,1894,[302 427 197 180 603],90,5,8176,4.314511873350924,20.0,0.0
21895,2,1895,[302 427 197 180 603],474,5,8181,4.314873417721519,20.0,0.0
21896,2,1896,[302 427 197 180 603],383,5,8186,4.315234580917238,20.0,0.0
21897,2,1897,[302 427 197 180 603],383,5,8191,4.315595363540569,20.0,0.0
21898,2,1898,[302 427 197 180 603],271,5,8196,4.315955766192733,20.0,0.0
21899,2,1899,[302 427 197 180 603],666,5,8201,4.316315789473684,20.0,0.0
21900,2,1900,[515  97 183 222 127],488,5,8206,4.316675433982114,0.0,20.0
21901,2,1901,[204  28   9 210 121],59,5,8211,4.317034700315458,0.0,0.0
21902,2,1902,[302 427 197 180 603],474,5,8216,4.31739358906989,20.0,0.0
21903,2,1903,[216 742  88 191 238],95,5,8221,4.317752100840337,0.0,0.0
21904,2,1904,[302 427 197 180 603],537,5,8226,4.318110236220472,20.0,0.0
21905,2,1905,[302 427 197 180 603],271,5,8231,4.318467995802728,20.0,0.0
21906,2,1906,[302 427 197 180 603],474,5,8236,4.31882538017829,20.0,0.0
21907,2,1907,[228 235 175 118 215],313,3,8239,4.318134171907757,0.0,0.0
21908,2,1908,[ 89  95 197 180  97],738,5,8244,4.318491356731273,0.0,0.0
21909,2,1909,[302 427 197 180 603],339,5,8249,4.318848167539267,20.0,0.0
21910,2,1910,[302 427 197 180 603],13,5,8254,4.319204604918891,20.0,0.0
21911,2,1911,[302 427 197 180 603],666,5,8259,4.319560669456067,20.0,0.0
21912,2,1912,[328 132 237 322  89],334,2,8261,4.3183481442760066,0.0,0.0
21913,2,1913,[175  98  97 603 238],738,5,8266,4.318704284221526,20.0,20.0
21914,2,1914,[302 427 197 180 603],666,5,8271,4.319060052219321,20.0,0.0
21915,2,1915,[302 427 197 180 603],474,5,8276,4.319415448851775,20.0,0.0
21916,2,1916,[302 427 197 180 603],13,5,8281,4.319770474700052,20.0,0.0
21917,2,1917,[302 427 197 180 603],537,5,8286,4.320125130344109,20.0,0.0
21918,2,1918,[302 427 197 180 603],271,5,8291,4.320479416362689,20.0,0.0
21919,2,1919,[302 427 197 180 603],90,5,8296,4.320833333333334,20.0,0.0
21920,2,1920,[ 97  95 265 187 234],543,3,8299,4.320145757418011,0.0,0.0
21921,2,1921,[302 427 197 180 603],664,5,8304,4.320499479708637,20.0,0.0
21922,2,1922,[302 427 197 180 603],13,5,8309,4.3208528341133645,20.0,0.0
21923,2,1923,[  8 423  12 238 175],13,4,8313,4.320686070686071,20.0,0.0
21924,2,1924,[302 427 197 180 603],339,5,8318,4.321038961038961,20.0,0.0
21925,2,1925,[302 427 197 180 603],13,5,8323,4.321391484942887,20.0,0.0
21926,2,1926,[302 427 197 180 603],271,5,8328,4.321743642968345,20.0,0.0
21927,2,1927,[302 427 197 180 603],664,5,8333,4.3220954356846475,20.0,0.0
21928,2,1928,[302 427 197 180 603],664,5,8338,4.322446863659928,20.0,0.0
21929,2,1929,[302 427 197 180 603],474,5,8343,4.32279792746114,20.0,0.0
21930,2,1930,[ 25 210 269  70 258],579,2,8345,4.321595028482651,0.0,0.0
21931,2,1931,[302 427 197 180 603],271,5,8350,4.321946169772256,20.0,0.0
21932,2,1932,[302 427 197 180 603],537,5,8355,4.322296947749612,20.0,0.0
21933,2,1933,[302 427 197 180 603],271,5,8360,4.322647362978284,20.0,0.0
21934,2,1934,[302 427 197 180 603],537,5,8365,4.322997416020672,20.0,0.0
21935,2,1935,[302 427 197 180 603],666,5,8370,4.323347107438017,20.0,0.0
21936,2,1936,[302 427 197 180 603],90,5,8375,4.323696437790398,20.0,0.0
21937,2,1937,[186  11 151 385  98],474,4,8379,4.323529411764706,0.0,20.0
21938,2,1938,[302 427 197 180 603],13,5,8384,4.323878287777204,20.0,0.0
21939,2,1939,[302 427 197 180 603],474,5,8389,4.324226804123711,20.0,0.0
21940,2,1940,[302 427 197 180 603],13,5,8394,4.324574961360123,20.0,0.0
21941,2,1941,[302 427 197 180 603],664,5,8399,4.324922760041194,20.0,0.0
21942,2,1942,[302 427 197 180 603],666,5,8404,4.325270200720535,20.0,0.0
21943,2,1943,[302 427 197 180 603],383,5,8409,4.325617283950617,20.0,0.0
21944,2,1944,[302 427 197 180 603],339,5,8414,4.325964010282776,20.0,0.0
21945,2,1945,[302 427 197 180 603],383,5,8419,4.3263103802672145,20.0,0.0
21946,2,1946,[237 471  50 546  71],308,2,8421,4.325115562403698,0.0,20.0
21947,2,1947,[302 427 197 180 603],271,5,8426,4.325462012320329,20.0,0.0
21948,2,1948,[302 427 197 180 603],666,5,8431,4.325808106721396,20.0,0.0
21949,2,1949,[302 427 197 180 603],474,5,8436,4.326153846153846,20.0,0.0
21950,2,1950,[302 427 197 180 603],271,5,8441,4.326499231163506,20.0,0.0
21951,2,1951,[742 196 265 191  22],95,4,8445,4.326331967213115,0.0,0.0
21952,2,1952,[515 258   8 238 187],64,4,8449,4.326164874551972,0.0,0.0
21953,2,1953,[302 427 197 180 603],537,5,8454,4.326509723643808,20.0,0.0
21954,2,1954,[  4  12  64 185 151],474,4,8458,4.326342710997443,20.0,0.0
21955,2,1955,[302 427 197 180 603],13,5,8463,4.326687116564417,20.0,0.0
21956,2,1956,[ 11 196 197 435  96],474,5,8468,4.327031170158405,0.0,0.0
21957,2,1957,[302 427 197 180 603],537,5,8473,4.327374872318693,20.0,0.0
21958,2,1958,[302 427 197 180 603],13,5,8478,4.327718223583461,20.0,0.0
21959,2,1959,[302 427 197 180 603],664,5,8483,4.328061224489796,20.0,0.0
21960,2,1960,[302 427 197 180 603],13,5,8488,4.328403875573687,20.0,0.0
21961,2,1961,[302 427 197 180 603],664,5,8493,4.32874617737003,20.0,0.0
21962,2,1962,[302 111 183 196 176],378,4,8497,4.3285787060621495,0.0,0.0
21963,2,1963,[  1   7 328 161 435],378,4,8501,4.3284114052953155,0.0,0.0
21964,2,1964,[302 427 197 180 603],383,5,8506,4.328753180661578,20.0,0.0
21965,2,1965,[302 427 197 180 603],666,5,8511,4.329094608341811,20.0,0.0
21966,2,1966,[302 427 197 180 603],664,5,8516,4.329435688866294,20.0,0.0
21967,2,1967,[546  22 121 153 405],95,3,8519,4.328760162601626,0.0,0.0
21968,2,1968,[302 427 197 180 603],383,5,8524,4.329101066531234,20.0,0.0
21969,2,1969,[ 11 423  95 588 121],387,0,8524,4.326903553299492,0.0,0.0
21970,2,1970,[405 423  98 211 215],85,4,8528,4.32673769660071,0.0,20.0
21971,2,1971,[222 423 215  11 173],92,3,8531,4.32606490872211,0.0,0.0
21972,2,1972,[302 427 197 180 603],383,5,8536,4.326406487582362,20.0,0.0
21973,2,1973,[302 427 197 180 603],537,5,8541,4.326747720364741,20.0,0.0
21974,2,1974,[302 427 197 180 603],339,5,8546,4.327088607594937,20.0,0.0
21975,2,1975,[302 427 197 180 603],666,5,8551,4.327429149797571,20.0,0.0
21976,2,1976,[191 172  70 276 742],271,3,8554,4.326757713707638,0.0,0.0
21977,2,1977,[302 427 197 180 603],537,5,8559,4.327098078867543,20.0,0.0
21978,2,1978,[302 427 197 180 603],666,5,8564,4.32743810005053,20.0,0.0
21979,2,1979,[435 318   9 135 143],233,5,8569,4.3277777777777775,20.0,0.0
21980,2,1980,[302 427 197 180 603],339,5,8574,4.32811711256941,20.0,0.0
21981,2,1981,[265 423 403 210 153],346,3,8577,4.3274470232088795,0.0,0.0
21982,2,1982,[302 427 197 180 603],271,5,8582,4.327786182551689,20.0,0.0
21983,2,1983,[302 427 197 180 603],271,5,8587,4.328125,20.0,0.0
21984,2,1984,[405  98 235   4 313],378,3,8590,4.327455919395466,0.0,20.0
21985,2,1985,[302 427 197 180 603],537,5,8595,4.327794561933535,20.0,0.0
21986,2,1986,[302 427 197 180 603],666,5,8600,4.3281328636134875,20.0,0.0
21987,2,1987,[302 427 197 180 603],339,5,8605,4.328470824949698,20.0,0.0
21988,2,1988,[302 427 197 180 603],383,5,8610,4.328808446455505,20.0,0.0
21989,2,1989,[302 427 197 180 603],664,5,8615,4.3291457286432165,20.0,0.0
21990,2,1990,[ 96 483 238   1 191],59,4,8619,4.32898041185334,20.0,0.0
21991,2,1991,[302 427 197 180 603],537,5,8624,4.329317269076305,20.0,0.0
21992,2,1992,[405 121  97 238 496],189,3,8627,4.328650275965881,0.0,0.0
21993,2,1993,[302 427 197 180 603],474,5,8632,4.328986960882648,20.0,0.0
21994,2,1994,[483 568 289 211 181],194,2,8634,4.3278195488721805,20.0,0.0
21995,2,1995,[ 89 204 357 328 144],653,4,8638,4.3276553106212425,20.0,0.0
21996,2,1996,[302 427 197 180 603],271,5,8643,4.327991987981973,20.0,0.0
21997,2,1997,[302 427 197 180 603],666,5,8648,4.328328328328328,20.0,0.0
21998,2,1998,[546 228 210 238   1],653,3,8651,4.327663831915958,0.0,0.0
21999,2,1999,[313 172 258 603 385],59,4,8655,4.3275,20.0,0.0
22000,2,2000,[471 187 475 333 143],533,4,8659,4.327336331834083,0.0,0.0
22001,2,2001,[302 427 197 180 603],90,5,8664,4.327672327672327,20.0,0.0
22002,2,2002,[302 427 197 180 603],664,5,8669,4.328007988017973,20.0,0.0
22003,2,2003,[483 294 496 194   9],648,3,8672,4.327345309381237,20.0,0.0
22004,2,2004,[302 427 197 180 603],383,5,8677,4.327680798004987,20.0,0.0
22005,2,2005,[174 153 275 183 143],694,5,8682,4.328015952143569,0.0,20.0
22006,2,2006,[302 427 197 180 603],90,5,8687,4.328350772296961,20.0,0.0
22007,2,2007,[302 427 197 180 603],271,5,8692,4.328685258964144,20.0,0.0
22008,2,2008,[302 427 197 180 603],339,5,8697,4.329019412643106,20.0,0.0
22009,2,2009,[302 427 197 180 603],474,5,8702,4.329353233830846,20.0,0.0
22010,2,2010,[302 427 197 180 603],13,5,8707,4.3296867230233715,20.0,0.0
22011,2,2011,[302 427 197 180 603],13,5,8712,4.330019880715706,20.0,0.0
22012,2,2012,[302 427 197 180 603],474,5,8717,4.330352707401888,20.0,0.0
22013,2,2013,[211 475 238 289 323],474,3,8720,4.329692154915591,0.0,0.0
22014,2,2014,[172  89 180 132 191],537,3,8723,4.329032258064516,0.0,0.0
22015,2,2015,[215 187 357  56 176],659,5,8728,4.329365079365079,20.0,0.0
22016,2,2016,[302 427 197 180 603],664,5,8733,4.329697570649479,20.0,0.0
22017,2,2017,[302 427 197 180 603],13,5,8738,4.330029732408325,20.0,0.0
22018,2,2018,[302 427 197 180 603],13,5,8743,4.330361565131253,20.0,0.0
22019,2,2019,[302 427 197 180 603],383,5,8748,4.330693069306931,20.0,0.0
22020,2,2020,[302 427 197 180 603],339,5,8753,4.331024245423058,20.0,0.0
22021,2,2021,[385 175 216 183 172],194,0,8753,4.3288822947576655,0.0,0.0
22022,2,2022,[302 427 197 180 603],383,5,8758,4.329214038556599,20.0,0.0
22023,2,2023,[302 427 197 180 603],383,5,8763,4.329545454545454,20.0,0.0
22024,2,2024,[322 191 186  22  71],524,2,8765,4.328395061728395,0.0,0.0
22025,2,2025,[302 427 197 180 603],90,5,8770,4.328726554787759,20.0,0.0
22026,2,2026,[597 288 568 313 294],119,4,8774,4.3285643808584116,0.0,0.0
22027,2,2027,[302 427 197 180 603],474,5,8779,4.3288954635108485,20.0,0.0
22028,2,2028,[187 211 204 333   7],537,3,8782,4.328240512567767,0.0,0.0
22029,2,2029,[302 427 197 180 603],537,5,8787,4.328571428571428,20.0,0.0
22030,2,2030,[588 204 187 603 196],59,4,8791,4.328409650418513,20.0,0.0
22031,2,2031,[302 427 197 180 603],271,5,8796,4.328740157480315,20.0,0.0
22032,2,2032,[302 427 197 180 603],666,5,8801,4.329070339399902,20.0,0.0
22033,2,2033,[302 427 197 180 603],537,5,8806,4.329400196656834,20.0,0.0
22034,2,2034,[182 568 234 211 174],538,3,8809,4.328746928746929,0.0,20.0
22035,2,2035,[302 427 197 180 603],537,5,8814,4.329076620825147,20.0,0.0
22036,2,2036,[302 427 197 180 603],664,5,8819,4.329405989199803,20.0,0.0
22037,2,2037,[302 427 197 180 603],13,5,8824,4.329735034347399,20.0,0.0
22038,2,2038,[302 427 197 180 603],474,5,8829,4.330063756743502,20.0,0.0
22039,2,2039,[302 427 197 180 603],339,5,8834,4.330392156862745,20.0,0.0
22040,2,2040,[302 427 197 180 603],90,5,8839,4.330720235178834,20.0,0.0
22041,2,2041,[302 427 197 180 603],664,5,8844,4.331047992164544,20.0,0.0
22042,2,2042,[302 427 197 180 603],90,5,8849,4.331375428291728,20.0,0.0
22043,2,2043,[302 427 197 180 603],339,5,8854,4.3317025440313115,20.0,0.0
22044,2,2044,[302 427 197 180 603],537,5,8859,4.3320293398533005,20.0,0.0
22045,2,2045,[302 427 197 180 603],13,5,8864,4.332355816226784,20.0,0.0
22046,2,2046,[302 427 197 180 603],474,5,8869,4.332681973619931,20.0,0.0
22047,2,2047,[ 56 275 328 515 300],116,2,8871,4.33154296875,0.0,0.0
22048,2,2048,[302 427 197 180 603],664,5,8876,4.331869204489995,20.0,0.0
22049,2,2049,[302 427 197 180 603],664,5,8881,4.332195121951219,20.0,0.0
22050,2,2050,[172 185  89 496 258],64,3,8884,4.331545587518284,0.0,0.0
22051,2,2051,[302 427 197 180 603],664,5,8889,4.331871345029239,20.0,0.0
22052,2,2052,[302 427 197 180 603],666,5,8894,4.3321967851924015,20.0,0.0
22053,2,2053,[179 300 496 322  69],334,1,8895,4.330574488802337,0.0,0.0
22054,2,2054,[302 427 197 180 603],271,5,8900,4.330900243309002,20.0,0.0
22055,2,2055,[302 427 197 180 603],537,5,8905,4.331225680933852,20.0,0.0
22056,2,2056,[302 427 197 180 603],474,5,8910,4.331550802139038,20.0,0.0
22057,2,2057,[  8 153  79  50 215],479,4,8914,4.331389698736637,0.0,20.0
22058,2,2058,[302 427 197 180 603],537,5,8919,4.331714424477902,20.0,0.0
22059,2,2059,[302 427 197 180 603],339,5,8924,4.332038834951456,20.0,0.0
22060,2,2060,[322 144 568 471 234],313,4,8928,4.331877729257642,0.0,0.0
22061,2,2061,[302 427 197 180 603],666,5,8933,4.332201745877788,20.0,0.0
22062,2,2062,[302 427 197 180 603],271,5,8938,4.332525448376151,20.0,0.0
22063,2,2063,[302 427 197 180 603],664,5,8943,4.332848837209302,20.0,0.0
22064,2,2064,[302 427 197 180 603],271,5,8948,4.333171912832929,20.0,0.0
22065,2,2065,[302 427 197 180 603],13,5,8953,4.333494675701839,20.0,0.0
22066,2,2066,[  9 195 179 405 153],64,3,8956,4.33284954039671,0.0,0.0
22067,2,2067,[ 69 258 111  64 168],537,2,8958,4.3317214700193425,0.0,0.0
22068,2,2068,[302 427 197 180 603],13,5,8963,4.332044465925568,20.0,0.0
22069,2,2069,[302 427 197 180 603],271,5,8968,4.332367149758454,20.0,0.0
22070,2,2070,[302 427 197 180 603],271,5,8973,4.332689521970063,20.0,0.0
22071,2,2071,[168 174 603   7 655],666,4,8977,4.332528957528957,20.0,20.0
22072,2,2072,[302 427 197 180 603],537,5,8982,4.332850940665702,20.0,0.0
22073,2,2073,[302 427 197 180 603],537,5,8987,4.333172613307618,20.0,0.0
22074,2,2074,[357 403 197 182 313],234,3,8990,4.332530120481928,20.0,0.0
22075,2,2075,[546   9 265 121  69],374,4,8994,4.332369942196531,0.0,0.0
22076,2,2076,[276 655 275 597 197],378,3,8997,4.331728454501685,0.0,0.0
22077,2,2077,[302 427 180 197 603],664,5,9002,4.332050048123195,20.0,0.0
22078,2,2078,[245 161  28 228 183],200,4,9006,4.331890331890332,0.0,0.0
22079,2,2079,[302 427 180 197 603],13,5,9011,4.3322115384615385,20.0,0.0
22080,2,2080,[161 216 174  71 215],648,2,9013,4.331090821720327,0.0,20.0
22081,2,2081,[302 427 180 197 603],90,5,9018,4.3314121037463975,20.0,0.0
22082,2,2082,[302 427 180 197 603],339,5,9023,4.331733077292367,20.0,0.0
22083,2,2083,[302 427 180 197 603],664,5,9028,4.332053742802303,20.0,0.0
22084,2,2084,[ 79  71 211 265  56],13,4,9032,4.33189448441247,0.0,0.0
22085,2,2085,[118 276 161 151 385],374,4,9036,4.331735378715244,0.0,0.0
22086,2,2086,[302 427 180 197 603],537,5,9041,4.3320555821753715,20.0,0.0
22087,2,2087,[302 427 180 197 603],383,5,9046,4.332375478927203,20.0,0.0
22088,2,2088,[333  71 508 313 405],334,2,9048,4.331258975586405,0.0,0.0
22089,2,2089,[302 427 180 197 603],339,5,9053,4.331578947368421,20.0,0.0
22090,2,2090,[288 546 403  97 117],343,2,9055,4.3304638928742225,0.0,0.0
22091,2,2091,[302 427 180 197 603],666,5,9060,4.330783938814531,20.0,0.0
22092,2,2092,[302 427 180 197 603],90,5,9065,4.331103678929765,20.0,0.0
22093,2,2093,[302 427 180 197 603],271,5,9070,4.3314231136580705,20.0,0.0
22094,2,2094,[195 286 187 127 186],653,5,9075,4.3317422434367545,0.0,20.0
22095,2,2095,[172 186 483 153 328],749,5,9080,4.3320610687022905,20.0,0.0
22096,2,2096,[ 70  64 496 318 302],474,5,9085,4.332379589890319,20.0,0.0
22097,2,2097,[275 132 125 238  98],378,3,9088,4.331744518589132,0.0,20.0
22098,2,2098,[302 427 180 197 603],13,5,9093,4.33206288708909,20.0,0.0
22099,2,2099,[  4 182  56 235 313],650,1,9094,4.33047619047619,0.0,0.0
22100,2,2100,[302 427 180 197 603],13,5,9099,4.330794859590671,20.0,0.0
22101,2,2101,[302 427 180 197 603],474,5,9104,4.331113225499524,20.0,0.0
22102,2,2102,[143 172  11 237 175],749,3,9107,4.330480266286258,0.0,0.0
22103,2,2103,[181 328 385  11 271],537,0,9107,4.3284220532319395,0.0,0.0
22104,2,2104,[302 427 180 197 603],474,5,9112,4.328741092636579,20.0,0.0
22105,2,2105,[117 313  28 222 180],234,2,9114,4.327635327635328,0.0,0.0
22106,2,2106,[ 79 435 271  70 273],102,0,9114,4.325581395348837,0.0,0.0
22107,2,2107,[302 427 197 180 603],13,5,9119,4.325901328273245,20.0,0.0
22108,2,2108,[471 237 174 588 204],13,4,9123,4.32574679943101,0.0,20.0
22109,2,2109,[302 427 197 180 603],339,5,9128,4.3260663507109,20.0,0.0
22110,2,2110,[302 427 197 180 603],271,5,9133,4.326385599242065,20.0,0.0
22111,2,2111,[151 196 216  69  96],90,3,9136,4.325757575757576,0.0,0.0
22112,2,2112,[515 183 172 286  69],328,5,9141,4.326076668244203,0.0,0.0
22113,2,2113,[183  95 185 121  25],374,5,9146,4.32639545884579,0.0,0.0
22114,2,2114,[302 427 197 180 603],13,5,9151,4.326713947990544,20.0,0.0
22115,2,2115,[302 427 197 180 603],664,5,9156,4.32703213610586,20.0,0.0
22116,2,2116,[ 12 275 234 132  96],279,1,9157,4.325460557392536,20.0,0.0
22117,2,2117,[  4 132 181 265 121],279,3,9160,4.324834749763928,0.0,0.0
22118,2,2118,[302 427 197 180 603],383,5,9165,4.325153374233129,20.0,0.0
22119,2,2119,[191 597 496 144  97],308,1,9166,4.323584905660377,0.0,0.0
22120,2,2120,[302 427 197 180 603],383,5,9171,4.323903818953324,20.0,0.0
22121,2,2121,[302 427 197 180 603],271,5,9176,4.324222431668238,20.0,0.0
22122,2,2122,[302 427 197 180 603],664,5,9181,4.324540744229863,20.0,0.0
22123,2,2123,[302 427 197 180 603],664,5,9186,4.324858757062147,20.0,0.0
22124,2,2124,[302 427 197 180 603],271,5,9191,4.325176470588235,20.0,0.0
22125,2,2125,[302 427 197 180 603],537,5,9196,4.32549388523048,20.0,0.0
22126,2,2126,[175 196 357 210 282],474,5,9201,4.325811001410437,20.0,0.0
22127,2,2127,[302 427 197 180 603],666,5,9206,4.326127819548872,20.0,0.0
22128,2,2128,[276 475  56 185  98],6,4,9210,4.325974635979333,0.0,20.0
22129,2,2129,[302 427 197 180 603],271,5,9215,4.326291079812207,20.0,0.0
22130,2,2130,[194 568 195 187 172],7,5,9220,4.326607226654153,0.0,0.0
22131,2,2131,[  4 204 195  89 333],537,1,9221,4.325046904315197,0.0,0.0
22132,2,2132,[204  22 286  28 508],339,4,9225,4.324894514767933,0.0,0.0
22133,2,2133,[ 97  98 204 135 588],326,2,9227,4.323805060918463,0.0,20.0
22134,2,2134,[302 427 197 180 603],664,5,9232,4.324121779859484,20.0,0.0
22135,2,2135,[302 427 197 180 603],339,5,9237,4.324438202247191,20.0,0.0
22136,2,2136,[302 427 197 180 603],90,5,9242,4.324754328497894,20.0,0.0
22137,2,2137,[302 427 197 180 603],90,5,9247,4.3250701590271285,20.0,0.0
22138,2,2138,[302 427 197 180 603],13,5,9252,4.32538569424965,20.0,0.0
22139,2,2139,[302 427 197 180 603],271,5,9257,4.325700934579439,20.0,0.0
22140,2,2140,[302 427 197 180 603],90,5,9262,4.326015880429706,20.0,0.0
22141,2,2141,[302 427 197 180 603],13,5,9267,4.326330532212885,20.0,0.0
22142,2,2142,[302 427 197 180 603],474,5,9272,4.326644890340644,20.0,0.0
22143,2,2143,[318  96  69 210 144],308,3,9275,4.326026119402985,20.0,0.0
22144,2,2144,[302 427 197 180 603],664,5,9280,4.326340326340326,20.0,0.0
22145,2,2145,[ 25 181 216  79 121],804,5,9285,4.326654240447344,0.0,0.0
22146,2,2146,[ 98 288 515 294 211],650,3,9288,4.326036329762459,0.0,20.0
22147,2,2147,[302 427 197 180 603],666,5,9293,4.32635009310987,20.0,0.0
22148,2,2148,[302 427 197 180 603],537,5,9298,4.326663564448581,20.0,0.0
22149,2,2149,[302 427 197 180 603],383,5,9303,4.326976744186046,20.0,0.0
22150,2,2150,[302 427 197 180 603],383,5,9308,4.327289632728963,20.0,0.0
22151,2,2151,[302 427 197 180 603],90,5,9313,4.327602230483271,20.0,0.0
22152,2,2152,[181 173 153   9 294],13,2,9315,4.326521133302369,0.0,0.0
22153,2,2153,[ 11 144 132  56 135],234,2,9317,4.325441039925719,0.0,0.0
22154,2,2154,[182  79 174 180 546],13,3,9320,4.324825986078887,0.0,20.0
22155,2,2155,[181 333 275  88 300],13,2,9322,4.323747680890538,0.0,0.0
22156,2,2156,[302 427 197 180 603],13,5,9327,4.324061196105703,20.0,0.0
22157,2,2157,[302 427 197 180 603],339,5,9332,4.324374420759963,20.0,0.0
22158,2,2158,[  4 300 210 333 187],871,3,9335,4.323761000463177,0.0,0.0
22159,2,2159,[302 427 197 180 603],271,5,9340,4.324074074074074,20.0,0.0
22160,2,2160,[ 64 313 180 318 357],474,5,9345,4.32438685793614,40.0,0.0
22161,2,2161,[302 427 197 180 603],664,5,9350,4.324699352451434,20.0,0.0
22162,2,2162,[302 427 197 180 603],271,5,9355,4.3250115580212665,20.0,0.0
22163,2,2163,[286 435  22 742 357],454,1,9356,4.323475046210721,20.0,0.0
22164,2,2164,[235 405  97 176  56],374,4,9360,4.323325635103926,0.0,0.0
22165,2,2165,[302 427 197 180 603],474,5,9365,4.323638042474608,20.0,0.0
22166,2,2166,[568 322  71 228 427],374,4,9369,4.32348869404707,0.0,0.0
22167,2,2167,[196 257 427  79  28],298,5,9374,4.32380073800738,0.0,0.0
22168,2,2168,[  8  22 117   7  11],840,2,9376,4.322729368372522,0.0,0.0
22169,2,2169,[302 427 197 180 603],666,5,9381,4.323041474654378,20.0,0.0
22170,2,2170,[302 427 197 180 603],664,5,9386,4.323353293413174,20.0,0.0
22171,2,2171,[302 427 197 180 603],537,5,9391,4.32366482504604,20.0,0.0
22172,2,2172,[302 427 197 180 603],13,5,9396,4.323976069949379,20.0,0.0
22173,2,2173,[302 427 197 180 603],90,5,9401,4.324287028518859,20.0,0.0
22174,2,2174,[302 427 197 180 603],90,5,9406,4.324597701149425,20.0,0.0
22175,2,2175,[302 427 197 180 603],537,5,9411,4.324908088235294,20.0,0.0
22176,2,2176,[302 427 197 180 603],666,5,9416,4.3252181901699585,20.0,0.0
22177,2,2177,[ 88  82 427  95 237],13,4,9420,4.325068870523416,0.0,0.0
22178,2,2178,[302 427 197 180 603],90,5,9425,4.325378614043139,20.0,0.0
22179,2,2179,[302 427 197 180 603],664,5,9430,4.325688073394495,20.0,0.0
22180,2,2180,[302 427 197 180 603],13,5,9435,4.325997248968363,20.0,0.0
22181,2,2181,[143 183  50 200 742],804,3,9438,4.325389550870761,0.0,20.0
22182,2,2182,[302 427 197 180 603],271,5,9443,4.325698579935868,20.0,0.0
22183,2,2183,[302 427 197 180 603],271,5,9448,4.326007326007326,20.0,0.0
22184,2,2184,[302 427 197 180 603],664,5,9453,4.326315789473684,20.0,0.0
22185,2,2185,[302 427 197 180 603],664,5,9458,4.326623970722781,20.0,0.0
22186,2,2186,[294  89  22   8 282],474,4,9462,4.326474622770919,0.0,0.0
22187,2,2187,[183 174 200 427 515],474,4,9466,4.326325411334552,0.0,20.0
22188,2,2188,[268 748 176 235 435],13,3,9469,4.325719506624029,0.0,0.0
22189,2,2189,[302 427 197 180 603],339,5,9474,4.326027397260274,20.0,0.0
22190,2,2190,[302 427 197 180 603],664,5,9479,4.326335006846189,20.0,0.0
22191,2,2191,[175 174  22 322  79],409,3,9482,4.325729927007299,0.0,20.0
22192,2,2192,[302 427 197 180 603],271,5,9487,4.326037391700867,20.0,0.0
22193,2,2193,[ 82  50 210 313 197],334,4,9491,4.325888787602552,0.0,20.0
22194,2,2194,[302 427 197 180 603],664,5,9496,4.32619589977221,20.0,0.0
22195,2,2195,[302 427 197 180 603],666,5,9501,4.326502732240437,20.0,0.0
22196,2,2196,[302 427 197 180 603],339,5,9506,4.326809285389167,20.0,0.0
22197,2,2197,[135 234 153 211 286],488,3,9509,4.326205641492265,0.0,0.0
22198,2,2198,[302 427 197 180 603],383,5,9514,4.326512050932242,20.0,0.0
22199,2,2199,[302 427 197 180 603],664,5,9519,4.326818181818182,20.0,0.0
22200,2,2200,[515  22 435 191  98],840,4,9523,4.326669695592912,0.0,20.0
22201,2,2201,[216 282 742 222 180],653,1,9524,4.325158946412352,0.0,0.0
22202,2,2202,[302 427 197 180 603],339,5,9529,4.32546527462551,20.0,0.0
22203,2,2203,[302 427 197 180 603],271,5,9534,4.325771324863884,20.0,0.0
22204,2,2204,[265 127  88 403 588],311,5,9539,4.326077097505669,0.0,20.0
22205,2,2205,[235 111 197 238  50],82,3,9542,4.325475974614688,0.0,20.0
22206,2,2206,[742 496  56 182 301],650,1,9543,4.323969188944268,0.0,0.0
22207,2,2207,[302 427 197 180 603],664,5,9548,4.324275362318841,20.0,0.0
22208,2,2208,[302 427 197 180 603],664,5,9553,4.324581258488004,20.0,0.0
22209,2,2209,[302 427 197 180 603],90,5,9558,4.324886877828054,20.0,0.0
22210,2,2210,[238  69   8 222 125],406,2,9560,4.323835368611488,0.0,0.0
22211,2,2211,[302 427 197 180 603],13,5,9565,4.324141048824593,20.0,0.0
22212,2,2212,[302 427 197 180 603],383,5,9570,4.324446452779033,20.0,0.0
22213,2,2213,[496 288 423 257  98],308,3,9573,4.323848238482385,0.0,20.0
22214,2,2214,[302 427 197 180 603],537,5,9578,4.324153498871332,20.0,0.0
22215,2,2215,[302 427 197 180 603],271,5,9583,4.324458483754513,20.0,0.0
22216,2,2216,[302 427 197 180 603],666,5,9588,4.324763193504736,20.0,0.0
22217,2,2217,[302 427 197 180 603],666,5,9593,4.325067628494139,20.0,0.0
22218,2,2218,[302 427 197 180 603],271,5,9598,4.325371789094187,20.0,0.0
22219,2,2219,[302 427 197 180 603],383,5,9603,4.325675675675676,20.0,0.0
22220,2,2220,[245 546 294 191 508],533,3,9606,4.325078793336335,0.0,0.0
22221,2,2221,[173 191 180 121  71],882,5,9611,4.325382538253826,0.0,0.0
22222,2,2222,[302 427 197 180 603],537,5,9616,4.325686009896536,20.0,0.0
22223,2,2223,[302 427 197 180 603],90,5,9621,4.325989208633094,20.0,0.0
22224,2,2224,[175 132 143   9 496],6,4,9625,4.325842696629214,0.0,0.0
22225,2,2225,[302 427 197 180 603],90,5,9630,4.3261455525606465,20.0,0.0
22226,2,2226,[302 427 197 180 603],383,5,9635,4.326448136506511,20.0,0.0
22227,2,2227,[210 427  56 222 483],194,3,9638,4.325852782764811,20.0,0.0
22228,2,2228,[302 427 197 180 603],664,5,9643,4.326155226558995,20.0,0.0
22229,2,2229,[302 427 197 180 603],664,5,9648,4.326457399103139,20.0,0.0
22230,2,2230,[302 427 197 180 603],90,5,9653,4.3267593007619904,20.0,0.0
22231,2,2231,[294 435  69  64 265],91,4,9657,4.326612903225806,0.0,0.0
22232,2,2232,[216 228   7 568 195],374,3,9660,4.326018808777429,0.0,0.0
22233,2,2233,[302 427 197 180 603],339,5,9665,4.326320501342883,20.0,0.0
22234,2,2234,[302 427 197 180 603],474,5,9670,4.32662192393736,20.0,0.0
22235,2,2235,[302 427 197 180 603],666,5,9675,4.326923076923077,20.0,0.0
22236,2,2236,[302 427 197 180 603],271,5,9680,4.3272239606616,20.0,0.0
22237,2,2237,[302 427 197 180 603],664,5,9685,4.327524575513852,20.0,0.0
22238,2,2238,[302 427 197 180 603],383,5,9690,4.327824921840107,20.0,0.0
22239,2,2239,[302 427 197 180 603],666,5,9695,4.328125,20.0,0.0
22240,2,2240,[302 427 197 180 603],90,5,9700,4.328424810352521,20.0,0.0
22241,2,2241,[215 210 100 228 313],537,2,9702,4.327386262265834,0.0,20.0
22242,2,2242,[302 427 197 180 603],474,5,9707,4.327686134641105,20.0,0.0
22243,2,2243,[302 427 197 180 603],13,5,9712,4.327985739750446,20.0,0.0
22244,2,2244,[302 427 197 180 603],537,5,9717,4.328285077951002,20.0,0.0
22245,2,2245,[302 427 197 180 603],666,5,9722,4.328584149599288,20.0,0.0
22246,2,2246,[302 427 197 180 603],90,5,9727,4.32888295505118,20.0,0.0
22247,2,2247,[302 427 197 180 603],383,5,9732,4.329181494661921,20.0,0.0
22248,2,2248,[302 427 197 180 603],339,5,9737,4.329479768786127,20.0,0.0
22249,2,2249,[302 427 197 180 603],383,5,9742,4.329777777777778,20.0,0.0
22250,2,2250,[423  88 182 200  95],881,2,9744,4.328742780986229,0.0,0.0
22251,2,2251,[742 174  50 273 175],387,4,9748,4.328596802841918,0.0,40.0
22252,2,2252,[568  79 238 423 234],897,5,9753,4.328894806924101,0.0,0.0
22253,2,2253,[ 12 181   9 322  28],119,4,9757,4.328748890860692,20.0,0.0
22254,2,2254,[302 427 197 180 603],537,5,9762,4.329046563192905,20.0,0.0
22255,2,2255,[202 100 273 405 211],59,3,9765,4.32845744680851,0.0,20.0
22256,2,2256,[302 427 197 180 603],339,5,9770,4.328754984492689,20.0,0.0
22257,2,2257,[187 282 135 100  98],328,3,9773,4.3281665190434015,0.0,40.0
22258,2,2258,[302 427 197 180 603],13,5,9778,4.32846392208942,20.0,0.0
22259,2,2259,[302 427 197 180 603],537,5,9783,4.328761061946903,20.0,0.0
22260,2,2260,[143 117 127 286 194],6,2,9785,4.3277310924369745,0.0,20.0
22261,2,2261,[302 427 197 180 603],666,5,9790,4.328028293545535,20.0,0.0
22262,2,2262,[302 427 197 180 603],664,5,9795,4.32832523199293,20.0,0.0
22263,2,2263,[302 427 197 180 603],271,5,9800,4.328621908127208,20.0,0.0
22264,2,2264,[302 427 197 180 603],90,5,9805,4.328918322295806,20.0,0.0
22265,2,2265,[302 427 197 180 603],90,5,9810,4.329214474845543,20.0,0.0
22266,2,2266,[176 180 385  15 194],308,4,9814,4.329069254521394,0.0,0.0
22267,2,2267,[117 568   9 118 403],543,2,9816,4.328042328042328,0.0,0.0
22268,2,2268,[235  11 121  50 127],82,3,9819,4.327457029528427,0.0,40.0
22269,2,2269,[302 427 197 180 603],90,5,9824,4.327753303964758,20.0,0.0
22270,2,2270,[302 427 197 180 603],13,5,9829,4.328049317481286,20.0,0.0
22271,2,2271,[257  64 258 175  25],666,3,9832,4.327464788732394,0.0,0.0
22272,2,2272,[742 100  79 483 215],59,4,9836,4.327320721513418,20.0,20.0
22273,2,2273,[302 427 197 180 603],666,5,9841,4.327616534740545,20.0,0.0
22274,2,2274,[302 427 197 180 603],13,5,9846,4.327912087912088,20.0,0.0
22275,2,2275,[302 427 197 180 603],383,5,9851,4.328207381370826,20.0,0.0
22276,2,2276,[215 121 588 385   4],378,4,9855,4.32806324110672,0.0,0.0
22277,2,2277,[302 427 197 180 603],90,5,9860,4.3283582089552235,20.0,0.0
22278,2,2278,[302 427 197 180 603],90,5,9865,4.328652917946468,20.0,0.0
22279,2,2279,[302 427 197 180 603],339,5,9870,4.328947368421052,20.0,0.0
22280,2,2280,[222  96 196  89  71],479,4,9874,4.328803156510302,0.0,0.0
22281,2,2281,[143   9 234  64 194],234,3,9877,4.328220858895706,0.0,0.0
22282,2,2282,[302 427 197 180 603],474,5,9882,4.328515111695138,20.0,0.0
22283,2,2283,[302 427 197 180 603],537,5,9887,4.328809106830122,20.0,0.0
22284,2,2284,[ 98 483 405 185 288],7,4,9891,4.328665207877462,20.0,20.0
22285,2,2285,[302 427 197 180 603],90,5,9896,4.328958880139982,20.0,0.0
22286,2,2286,[302 427 197 180 603],339,5,9901,4.329252295583734,20.0,0.0
22287,2,2287,[302 427 197 180 603],664,5,9906,4.329545454545454,20.0,0.0
22288,2,2288,[144 210 118  12 151],7,4,9910,4.329401485364788,20.0,0.0
22289,2,2289,[328  71 175 289 508],85,2,9912,4.328384279475983,0.0,0.0
22290,2,2290,[302 427 197 180 603],666,5,9917,4.328677433435181,20.0,0.0
22291,2,2291,[357   1  25 135  71],882,4,9921,4.3285340314136125,20.0,0.0
22292,2,2292,[302 427 197 180 603],664,5,9926,4.328826864369821,20.0,0.0
22293,2,2293,[302 427 197 180 603],664,5,9931,4.329119442022668,20.0,0.0
22294,2,2294,[302 427 197 180 603],90,5,9936,4.329411764705882,20.0,0.0
22295,2,2295,[302 427 197 180 603],90,5,9941,4.329703832752613,20.0,0.0
22296,2,2296,[302 427 197 180 603],271,5,9946,4.329995646495429,20.0,0.0
22297,2,2297,[435  71 318  12 144],64,3,9949,4.329416884247172,40.0,0.0
22298,2,2298,[302 427 197 180 603],537,5,9954,4.329708568943019,20.0,0.0
22299,2,2299,[135 276 175 172 603],59,5,9959,4.33,20.0,0.0
22300,2,2300,[302 427 197 180 603],664,5,9964,4.330291177748805,20.0,0.0
22301,2,2301,[302 427 197 180 603],271,5,9969,4.330582102519548,20.0,0.0
22302,2,2302,[  4 197  96 483 313],474,5,9974,4.3308727746417714,20.0,0.0
22303,2,2303,[100 286 196 197 588],664,4,9978,4.330729166666667,0.0,20.0
22304,2,2304,[302 427 197 180 603],13,5,9983,4.331019522776573,20.0,0.0
22305,2,2305,[302 427 197 180 603],90,5,9988,4.331309627059844,20.0,0.0
22306,2,2306,[302 427 197 180 603],90,5,9993,4.331599479843953,20.0,0.0
22307,2,2307,[302 427 197 180 603],271,5,9998,4.331889081455806,20.0,0.0
22308,2,2308,[238  28 234 288  97],308,2,10000,4.3308791684712,0.0,0.0
22309,2,2309,[302 427 197 180 603],13,5,10005,4.3311688311688314,20.0,0.0
22310,2,2310,[302 427 197 180 603],271,5,10010,4.331458243184769,20.0,0.0
22311,2,2311,[302 427 197 180 603],474,5,10015,4.3317474048442905,20.0,0.0
22312,2,2312,[196 117  70 216 121],233,4,10019,4.331603977518374,0.0,0.0
22313,2,2313,[302 427 197 180 603],664,5,10024,4.331892826274848,20.0,0.0
22314,2,2314,[302 427 197 180 603],90,5,10029,4.332181425485961,20.0,0.0
22315,2,2315,[302 427 197 180 603],666,5,10034,4.332469775474957,20.0,0.0
22316,2,2316,[197 121 237 678 294],537,1,10035,4.331031506258093,0.0,0.0
22317,2,2317,[302 427 197 180 603],537,5,10040,4.331320103537532,20.0,0.0
22318,2,2318,[302 427 197 180 603],271,5,10045,4.331608451918931,20.0,0.0
22319,2,2319,[302 427 197 180 603],666,5,10050,4.331896551724138,20.0,0.0
22320,2,2320,[222 121 403  97 435],788,1,10051,4.330461008186127,0.0,0.0
22321,2,2321,[ 71 257 216 496  69],334,1,10052,4.329026701119725,0.0,0.0
22322,2,2322,[302 125 268 286   9],486,2,10054,4.328024106758502,0.0,0.0
22323,2,2323,[302 427 197 180 603],537,5,10059,4.328313253012048,20.0,0.0
22324,2,2324,[300 135  28   4 151],379,4,10063,4.328172043010753,0.0,0.0
22325,2,2325,[302 427 197 180 603],13,5,10068,4.328460877042132,20.0,0.0
22326,2,2326,[302 427 197 180 603],271,5,10073,4.328749462827675,20.0,0.0
22327,2,2327,[302 427 197 180 603],537,5,10078,4.329037800687285,20.0,0.0
22328,2,2328,[181 117  71 215  50],650,3,10081,4.328467153284672,0.0,20.0
22329,2,2329,[302 427 197 180 603],666,5,10086,4.328755364806867,20.0,0.0
22330,2,2330,[302 427 197 180 603],271,5,10091,4.329043329043329,20.0,0.0
22331,2,2331,[194  28   9 655  98],339,5,10096,4.329331046312179,0.0,20.0
22332,2,2332,[234 175   7 187 200],7,5,10101,4.32961851693099,0.0,0.0
22333,2,2333,[302 427 197 180 603],13,5,10106,4.329905741216796,20.0,0.0
22334,2,2334,[483 508 132   4   9],339,5,10111,4.330192719486082,20.0,0.0
22335,2,2335,[302 427 197 180 603],13,5,10116,4.330479452054795,20.0,0.0
22336,2,2336,[302 427 197 180 603],271,5,10121,4.33076593923834,20.0,0.0
22337,2,2337,[ 22  70 211   9 483],7,4,10125,4.330624465355005,20.0,0.0
22338,2,2338,[302 427 197 180 603],666,5,10130,4.330910645575032,20.0,0.0
22339,2,2339,[196 515  89 127   7],666,4,10134,4.3307692307692305,0.0,20.0
22340,2,2340,[302 427 197 180 603],271,5,10139,4.33105510465613,20.0,0.0
22341,2,2341,[ 22 211  71  97 176],380,2,10141,4.330059777967549,0.0,0.0
22342,2,2342,[235 195 597   8 471],328,0,10141,4.3282116944088775,0.0,0.0
22343,2,2343,[302 427 197 180 603],474,5,10146,4.328498293515358,20.0,0.0
22344,2,2344,[302 427 197 180 603],666,5,10151,4.328784648187633,20.0,0.0
22345,2,2345,[302 427 197 180 603],383,5,10156,4.329070758738278,20.0,0.0
22346,2,2346,[302 427 197 180 603],271,5,10161,4.329356625479336,20.0,0.0
22347,2,2347,[302 427 197 180 603],666,5,10166,4.329642248722317,20.0,0.0
22348,2,2348,[302 427 197 180 603],90,5,10171,4.329927628778203,20.0,0.0
22349,2,2349,[117 210 179 204  25],271,3,10174,4.32936170212766,0.0,0.0
22350,2,2350,[302 427 197 180 603],271,5,10179,4.329646958740962,20.0,0.0
22351,2,2351,[302 427 197 180 603],474,5,10184,4.329931972789115,20.0,0.0
22352,2,2352,[302 427 197 180 603],90,5,10189,4.330216744581385,20.0,0.0
22353,2,2353,[302 427 197 180 603],271,5,10194,4.330501274426508,20.0,0.0
22354,2,2354,[302 427 197 180 603],666,5,10199,4.3307855626326965,20.0,0.0
22355,2,2355,[302 427 197 180 603],339,5,10204,4.33106960950764,20.0,0.0
22356,2,2356,[302 427 197 180 603],13,5,10209,4.331353415358507,20.0,0.0
22357,2,2357,[302 427 197 180 603],664,5,10214,4.331636980491942,20.0,0.0
22358,2,2358,[302 427 197 180 603],537,5,10219,4.331920305214074,20.0,0.0
22359,2,2359,[333 132 546 111 313],13,3,10222,4.331355932203389,0.0,0.0
22360,2,2360,[211  95 195 194 183],64,5,10227,4.331639135959339,0.0,0.0
22361,2,2361,[302 427 197 180 603],664,5,10232,4.331922099915326,20.0,0.0
22362,2,2362,[405 181 435 161 423],378,4,10236,4.331781633516716,0.0,0.0
22363,2,2363,[191 183 132 385 151],200,4,10240,4.331641285956007,0.0,0.0
22364,2,2364,[  4 194 423 125 357],653,1,10241,4.330232558139535,20.0,0.0
22365,2,2365,[302 427 197 180 603],664,5,10246,4.330515638207946,20.0,0.0
22366,2,2366,[302 427 197 180 603],90,5,10251,4.330798479087452,20.0,0.0
22367,2,2367,[302 427 197 180 603],537,5,10256,4.331081081081081,20.0,0.0
22368,2,2368,[302 427 197 180 603],666,5,10261,4.3313634444913465,20.0,0.0
22369,2,2369,[275 210  70 196 125],378,4,10265,4.331223628691983,0.0,0.0
22370,2,2370,[302 427 197 180 603],666,5,10270,4.331505693800084,20.0,0.0
22371,2,2371,[302 427 197 180 603],271,5,10275,4.331787521079258,20.0,0.0
22372,2,2372,[168 172 403 135 143],533,3,10278,4.331226295828066,0.0,0.0
22373,2,2373,[302 427 197 180 603],13,5,10283,4.33150800336984,20.0,0.0
22374,2,2374,[302 427 197 180 603],474,5,10288,4.331789473684211,20.0,0.0
22375,2,2375,[302 427 197 180 603],474,5,10293,4.332070707070707,20.0,0.0
22376,2,2376,[302 427 197 180 603],339,5,10298,4.332351703828355,20.0,0.0
22377,2,2377,[302 427 197 180 603],90,5,10303,4.332632464255677,20.0,0.0
22378,2,2378,[302 427 197 180 603],339,5,10308,4.332912988650693,20.0,0.0
22379,2,2379,[182   4 258 181  11],387,3,10311,4.33235294117647,0.0,0.0
22380,2,2380,[302 427 197 180 603],383,5,10316,4.332633347333053,20.0,0.0
22381,2,2381,[302 427 197 180 603],13,5,10321,4.332913518052057,20.0,0.0
22382,2,2382,[282 191  97 318 496],474,5,10326,4.333193453629878,20.0,0.0
22383,2,2383,[302 427 197 180 603],339,5,10331,4.333473154362416,20.0,0.0
22384,2,2384,[135  11   4 186 172],387,2,10333,4.332494758909853,0.0,0.0
22385,2,2385,[302 427 197 180 603],90,5,10338,4.332774518021794,20.0,0.0
22386,2,2386,[302 427 197 180 603],537,5,10343,4.333054042731462,20.0,0.0
22387,2,2387,[302 427 197 180 603],537,5,10348,4.333333333333333,20.0,0.0
22388,2,2388,[258  12   7 427 204],334,5,10353,4.33361239012139,20.0,0.0
22389,2,2389,[265 182   1 202 234],271,3,10356,4.3330543933054395,0.0,0.0
22390,2,2390,[302 427 197 180 603],666,5,10361,4.333333333333333,20.0,0.0
22391,2,2391,[302 427 197 180 603],666,5,10366,4.333612040133779,20.0,0.0
22392,2,2392,[228  71 132  22 151],406,1,10367,4.332218972001671,0.0,0.0
22393,2,2393,[302 427 197 180 603],339,5,10372,4.33249791144528,20.0,0.0
22394,2,2394,[197 135 271  69 483],650,3,10375,4.3319415448851775,20.0,0.0
22395,2,2395,[302 427 197 180 603],90,5,10380,4.332220367278798,20.0,0.0
22396,2,2396,[302 427 197 180 603],339,5,10385,4.33249895702962,20.0,0.0
22397,2,2397,[302 427 197 180 603],271,5,10390,4.33277731442869,20.0,0.0
22398,2,2398,[ 69 748 117 176 151],313,3,10393,4.332221759066278,0.0,0.0
22399,2,2399,[302 427 197 180 603],383,5,10398,4.3325,20.0,0.0
22400,2,2400,[ 88 294  50 183 173],474,4,10402,4.332361516034985,0.0,20.0
22401,2,2401,[302 427 197 180 603],271,5,10407,4.332639467110741,20.0,0.0
22402,2,2402,[153 257 202 144 515],343,4,10411,4.332501040366209,0.0,0.0
22403,2,2403,[302 427 197 180 603],537,5,10416,4.332778702163061,20.0,0.0
22404,2,2404,[302 427 197 180 603],271,5,10421,4.333056133056133,20.0,0.0
22405,2,2405,[302 427 197 180 603],90,5,10426,4.333333333333333,20.0,0.0
22406,2,2406,[302 427 197 180 603],383,5,10431,4.333610303282094,20.0,0.0
22407,2,2407,[302 427 197 180 603],90,5,10436,4.333887043189368,20.0,0.0
22408,2,2408,[168   7 200 515  25],7,3,10439,4.333333333333333,0.0,0.0
22409,2,2409,[302 427 197 180 603],666,5,10444,4.333609958506224,20.0,0.0
22410,2,2410,[302 427 197 180 603],271,5,10449,4.333886354209872,20.0,0.0
22411,2,2411,[302 427 197 180 603],339,5,10454,4.334162520729685,20.0,0.0
22412,2,2412,[161  89 127 186 258],774,1,10455,4.3327807708247,0.0,20.0
22413,2,2413,[302 427 197 180 603],383,5,10460,4.333057166528583,20.0,0.0
22414,2,2414,[302 427 197 180 603],13,5,10465,4.333333333333333,20.0,0.0
22415,2,2415,[ 82 175  97 100 168],840,3,10468,4.332781456953643,0.0,20.0
22416,2,2416,[323 546 483 118  15],374,2,10470,4.331816301199835,20.0,0.0
22417,2,2417,[302 427 197 180 603],666,5,10475,4.3320926385442515,20.0,0.0
22418,2,2418,[302 427 197 180 603],90,5,10480,4.332368747416288,20.0,0.0
22419,2,2419,[302 427 197 180 603],339,5,10485,4.332644628099174,20.0,0.0
22420,2,2420,[179 181 302 385 508],207,3,10488,4.332094175960347,0.0,0.0
22421,2,2421,[302 427 197 180 603],13,5,10493,4.332369942196531,20.0,0.0
22422,2,2422,[  1 475 237 186 180],92,5,10498,4.332645480808915,0.0,0.0
22423,2,2423,[302 427 197 180 603],537,5,10503,4.332920792079208,20.0,0.0
22424,2,2424,[302 427 197 180 603],271,5,10508,4.33319587628866,20.0,0.0
22425,2,2425,[302 427 197 180 603],383,5,10513,4.3334707337180545,20.0,0.0
22426,2,2426,[302 427 197 180 603],474,5,10518,4.333745364647713,20.0,0.0
22427,2,2427,[302 427 197 180 603],666,5,10523,4.3340197693574956,20.0,0.0
22428,2,2428,[302 427 197 180 603],271,5,10528,4.334293948126801,20.0,0.0
22429,2,2429,[302 427 197 180 603],383,5,10533,4.334567901234568,20.0,0.0
22430,2,2430,[302 427 197 180 603],271,5,10538,4.334841628959276,20.0,0.0
22431,2,2431,[302 427 197 180 603],383,5,10543,4.335115131578948,20.0,0.0
22432,2,2432,[200  69  98 496 483],95,3,10546,4.334566378956022,20.0,20.0
22433,2,2433,[179  11  56 238  64],474,5,10551,4.334839769926048,0.0,0.0
22434,2,2434,[483 183 385 210 194],295,4,10555,4.3347022587268995,20.0,0.0
22435,2,2435,[302 427 197 180 603],666,5,10560,4.334975369458128,20.0,0.0
22436,2,2436,[302 427 197 180 603],664,5,10565,4.335248256052523,20.0,0.0
22437,2,2437,[302 427 197 180 603],383,5,10570,4.33552091878589,20.0,0.0
22438,2,2438,[748 245 135 174  25],313,2,10572,4.334563345633456,0.0,20.0
22439,2,2439,[302 427 197 180 603],383,5,10577,4.3348360655737705,20.0,0.0
22440,2,2440,[302 427 197 180 603],537,5,10582,4.335108562064727,20.0,0.0
22441,2,2441,[302 427 197 180 603],90,5,10587,4.335380835380835,20.0,0.0
22442,2,2442,[302 427 197 180 603],90,5,10592,4.3356528857961525,20.0,0.0
22443,2,2443,[302 427 197 180 603],383,5,10597,4.335924713584288,20.0,0.0
22444,2,2444,[302 427 197 180 603],666,5,10602,4.336196319018405,20.0,0.0
22445,2,2445,[302 427 197 180 603],13,5,10607,4.336467702371218,20.0,0.0
22446,2,2446,[302 427 197 180 603],537,5,10612,4.336738863914998,20.0,0.0
22447,2,2447,[483 168 300  96  25],892,5,10617,4.3370098039215685,20.0,0.0
22448,2,2448,[302 427 197 180 603],474,5,10622,4.3372805226623115,20.0,0.0
22449,2,2449,[302 427 197 180 603],271,5,10627,4.3375510204081635,20.0,0.0
22450,2,2450,[302 427 197 180 603],383,5,10632,4.33782129742962,20.0,0.0
22451,2,2451,[302 427 197 180 603],664,5,10637,4.338091353996737,20.0,0.0
22452,2,2452,[302 427 197 180 603],666,5,10642,4.3383611903791275,20.0,0.0
22453,2,2453,[302 427 197 180 603],90,5,10647,4.338630806845965,20.0,0.0
22454,2,2454,[  7 143 210 515  12],643,5,10652,4.338900203665988,20.0,0.0
22455,2,2455,[  8 288 174 180 175],308,5,10657,4.339169381107492,0.0,20.0
22456,2,2456,[300 216 153 357 185],210,5,10662,4.339438339438339,20.0,0.0
22457,2,2457,[302 427 197 180 603],664,5,10667,4.339707078925956,20.0,0.0
22458,2,2458,[302 427 197 180 603],666,5,10672,4.339975599837333,20.0,0.0
22459,2,2459,[302 427 197 180 603],664,5,10677,4.340243902439024,20.0,0.0
22460,2,2460,[302 427 197 180 603],383,5,10682,4.340511986997155,20.0,0.0
22461,2,2461,[302 427 197 180 603],474,5,10687,4.340779853777417,20.0,0.0
22462,2,2462,[183 385 197 153 191],932,4,10691,4.34064149411287,0.0,0.0
22463,2,2463,[  9 172 313 385 286],59,4,10695,4.340503246753247,0.0,0.0
22464,2,2464,[302 427 197 180 603],339,5,10700,4.340770791075051,20.0,0.0
22465,2,2465,[302 427 197 180 603],383,5,10705,4.341038118410381,20.0,0.0
22466,2,2466,[302 427 197 180 603],383,5,10710,4.341305229023105,20.0,0.0
22467,2,2467,[302 427 197 180 603],537,5,10715,4.341572123176661,20.0,0.0
22468,2,2468,[257  71 265 289  64],455,3,10718,4.341028756581612,0.0,0.0
22469,2,2469,[100 186 181 238  56],666,3,10721,4.340485829959515,0.0,20.0
22470,2,2470,[288 245  11 118 273],102,0,10721,4.338729259409146,0.0,0.0
22471,2,2471,[302 427 197 180 603],90,5,10726,4.338996763754046,20.0,0.0
22472,2,2472,[172 111 405  50   9],59,4,10730,4.338859684593611,0.0,20.0
22473,2,2473,[302 427 197 180 603],666,5,10735,4.339126919967664,20.0,0.0
22474,2,2474,[302 427 197 180 603],271,5,10740,4.33939393939394,20.0,0.0
22475,2,2475,[ 69  79 172 216 197],650,3,10743,4.338852988691438,0.0,0.0
22476,2,2476,[302 427 197 180 603],664,5,10748,4.339119903108599,20.0,0.0
22477,2,2477,[302 427 197 180 603],666,5,10753,4.339386602098466,20.0,0.0
22478,2,2478,[302 427 197 180 603],664,5,10758,4.339653085921743,20.0,0.0
22479,2,2479,[302 427 197 180 603],13,5,10763,4.33991935483871,20.0,0.0
22480,2,2480,[357 216 168 318 118],271,3,10766,4.33937928254736,40.0,0.0
22481,2,2481,[ 50 748  64 211 216],749,4,10770,4.339242546333602,0.0,20.0
22482,2,2482,[302 176 282 405 313],144,4,10774,4.339105920257753,0.0,0.0
22483,2,2483,[302 427 197 180 603],271,5,10779,4.3393719806763285,20.0,0.0
22484,2,2484,[302 427 197 180 603],13,5,10784,4.339637826961771,20.0,0.0
22485,2,2485,[302 427 197 180 603],537,5,10789,4.339903459372486,20.0,0.0
22486,2,2486,[  1 118 135 202 174],533,4,10793,4.339766787293929,0.0,20.0
22487,2,2487,[302 427 197 180 603],339,5,10798,4.340032154340836,20.0,0.0
22488,2,2488,[302 427 197 180 603],474,5,10803,4.340297308155886,20.0,0.0
22489,2,2489,[302 427 197 180 603],90,5,10808,4.340562248995984,20.0,0.0
22490,2,2490,[  9  88 100 176 275],533,4,10812,4.340425531914893,0.0,20.0
22491,2,2491,[302 427 197 180 603],383,5,10817,4.340690208667737,20.0,0.0
22492,2,2492,[302 427 197 180 603],339,5,10822,4.340954673084637,20.0,0.0
22493,2,2493,[302 427 197 180 603],13,5,10827,4.3412189254210105,20.0,0.0
22494,2,2494,[302 427 197 180 603],271,5,10832,4.3414829659318634,20.0,0.0
22495,2,2495,[100 216 153 173 276],374,4,10836,4.341346153846154,0.0,20.0
22496,2,2496,[180 182 174   8  70],90,4,10840,4.3412094513416095,0.0,20.0
22497,2,2497,[302 427 197 180 603],90,5,10845,4.341473178542834,20.0,0.0
22498,2,2498,[302 427 197 180 603],339,5,10850,4.341736694677871,20.0,0.0
22499,2,2499,[302 427 197 180 603],13,5,10855,4.342,20.0,0.0
22500,2,2500,[302 427 197 180 603],666,5,10860,4.342263094762095,20.0,0.0
22501,2,2501,[302 427 197 180 603],537,5,10865,4.342525979216627,20.0,0.0
22502,2,2502,[302 427 197 180 603],271,5,10870,4.342788653615661,20.0,0.0
22503,2,2503,[302 427 197 180 603],666,5,10875,4.343051118210862,20.0,0.0
22504,2,2504,[228 195 121  69 237],60,5,10880,4.343313373253493,0.0,0.0
22505,2,2505,[302 427 197 180 603],339,5,10885,4.343575418994414,20.0,0.0
22506,2,2506,[302 427 197 180 603],537,5,10890,4.343837255684084,20.0,0.0
22507,2,2507,[302 427 197 180 603],271,5,10895,4.344098883572568,20.0,0.0
22508,2,2508,[302 427 197 180 603],383,5,10900,4.344360302909526,20.0,0.0
22509,2,2509,[302 427 197 180 603],383,5,10905,4.344621513944223,20.0,0.0
22510,2,2510,[302 427 197 180 603],339,5,10910,4.344882516925527,20.0,0.0
22511,2,2511,[302 427 197 180 603],13,5,10915,4.345143312101911,20.0,0.0
22512,2,2512,[302 427 197 180 603],664,5,10920,4.345403899721449,20.0,0.0
22513,2,2513,[302 427 197 180 603],339,5,10925,4.345664280031822,20.0,0.0
22514,2,2514,[328  98  89 196  96],234,1,10926,4.344333996023857,0.0,20.0
22515,2,2515,[302 427 197 180 603],666,5,10931,4.344594594594595,20.0,0.0
22516,2,2516,[173  11 273 215 546],643,2,10933,4.343663090981327,0.0,0.0
22517,2,2517,[302 427 197 180 603],13,5,10938,4.343923749007149,20.0,0.0
22518,2,2518,[302 427 197 180 603],339,5,10943,4.344184200079397,20.0,0.0
22519,2,2519,[302 427 197 180 603],664,5,10948,4.344444444444444,20.0,0.0
22520,2,2520,[302 427 197 180 603],339,5,10953,4.344704482348274,20.0,0.0
22521,2,2521,[302 427 197 180 603],339,5,10958,4.344964314036479,20.0,0.0
22522,2,2522,[172 186 300 168 655],537,2,10960,4.344034879112168,0.0,0.0
22523,2,2523,[333 435 191  95 216],881,4,10964,4.3438985736925515,0.0,0.0
22524,2,2524,[302 427 197 180 603],664,5,10969,4.3441584158415845,20.0,0.0
22525,2,2525,[302 427 197 180 603],666,5,10974,4.344418052256532,20.0,0.0
22526,2,2526,[302 427 197 180 603],339,5,10979,4.344677483181639,20.0,0.0
22527,2,2527,[302 427 197 180 603],13,5,10984,4.344936708860759,20.0,0.0
22528,2,2528,[302 427 197 180 603],90,5,10989,4.345195729537367,20.0,0.0
22529,2,2529,[333 301 216  79 257],334,3,10992,4.344664031620553,0.0,0.0
22530,2,2530,[180 483 151  71 197],6,4,10996,4.344527854602924,20.0,0.0
22531,2,2531,[302 427 197 180 603],339,5,11001,4.3447867298578196,20.0,0.0
22532,2,2532,[302 427 197 180 603],90,5,11006,4.34504540071062,20.0,0.0
22533,2,2533,[302 427 197 180 603],383,5,11011,4.345303867403315,20.0,0.0
22534,2,2534,[210 238 161 194 215],643,2,11013,4.344378698224852,0.0,0.0
22535,2,2535,[302 427 197 180 603],13,5,11018,4.344637223974764,20.0,0.0
22536,2,2536,[302 427 197 180 603],537,5,11023,4.344895545920378,20.0,0.0
22537,2,2537,[302 427 197 180 603],664,5,11028,4.3451536643026,20.0,0.0
22538,2,2538,[302 427 197 180 603],339,5,11033,4.345411579361953,20.0,0.0
22539,2,2539,[302 427 197 180 603],339,5,11038,4.345669291338583,20.0,0.0
22540,2,2540,[195 185  70 405 742],804,5,11043,4.345926800472255,0.0,0.0
22541,2,2541,[302 427 197 180 603],666,5,11048,4.34618410700236,20.0,0.0
22542,2,2542,[302 427 197 180 603],666,5,11053,4.346441211167912,20.0,0.0
22543,2,2543,[302 427 197 180 603],13,5,11058,4.346698113207547,20.0,0.0
22544,2,2544,[302 427 197 180 603],537,5,11063,4.346954813359528,20.0,0.0
22545,2,2545,[357 483 423 302 515],13,3,11066,4.346425765907306,40.0,0.0
22546,2,2546,[748  56 496 197 265],313,3,11069,4.345897133883,0.0,0.0
22547,2,2547,[302 427 197 180 603],13,5,11074,4.346153846153846,20.0,0.0
22548,2,2548,[302 427 197 180 603],90,5,11079,4.346410357002746,20.0,0.0
22549,2,2549,[403  82 603 196 313],815,4,11083,4.346274509803922,20.0,0.0
22550,2,2550,[302 427 197 180 603],474,5,11088,4.346530772246178,20.0,0.0
22551,2,2551,[302 427 197 180 603],664,5,11093,4.346786833855799,20.0,0.0
22552,2,2552,[302 427 197 180 603],90,5,11098,4.347042694868782,20.0,0.0
22553,2,2553,[302 427 197 180 603],271,5,11103,4.347298355520752,20.0,0.0
22554,2,2554,[302 427 197 180 603],90,5,11108,4.3475538160469664,20.0,0.0
22555,2,2555,[153  79 294 176 234],788,2,11110,4.346635367762128,0.0,0.0
22556,2,2556,[302 427 197 180 603],474,5,11115,4.346890887759093,20.0,0.0
22557,2,2557,[302 427 197 180 603],537,5,11120,4.347146207974981,20.0,0.0
22558,2,2558,[302 427 197 180 603],383,5,11125,4.347401328644001,20.0,0.0
22559,2,2559,[302 427 197 180 603],664,5,11130,4.34765625,20.0,0.0
22560,2,2560,[405 282 508 742 173],334,2,11132,4.346739554861382,0.0,0.0
22561,2,2561,[302 427 197 180 603],13,5,11137,4.3469945355191255,20.0,0.0
22562,2,2562,[302 427 197 180 603],537,5,11142,4.347249317206399,20.0,0.0
22563,2,2563,[302 427 197 180 603],13,5,11147,4.347503900156006,20.0,0.0
22564,2,2564,[302 427 197 180 603],13,5,11152,4.34775828460039,20.0,0.0
22565,2,2565,[508   7 435 405 210],59,4,11156,4.347622759158223,0.0,0.0
22566,2,2566,[302 427 197 180 603],13,5,11161,4.347876899104013,20.0,0.0
22567,2,2567,[302 427 197 180 603],474,5,11166,4.348130841121495,20.0,0.0
22568,2,2568,[  7 423 204 546 172],650,3,11169,4.347606072401713,0.0,0.0
22569,2,2569,[172  50  97  88 151],650,2,11171,4.346692607003891,0.0,20.0
22570,2,2570,[385  25 195 194 322],474,5,11176,4.346946713341112,0.0,0.0
22571,2,2571,[180 234 313 183 191],144,5,11181,4.347200622083982,0.0,0.0
22572,2,2572,[265 180 117 475 151],339,3,11184,4.346677030703459,0.0,0.0
22573,2,2573,[302 427 197 180 603],537,5,11189,4.346930846930847,20.0,0.0
22574,2,2574,[302 427 197 180 603],13,5,11194,4.347184466019417,20.0,0.0
22575,2,2575,[172 234  12 204 288],279,0,11194,4.345496894409938,20.0,0.0
22576,2,2576,[302 427 197 180 603],90,5,11199,4.3457508731082655,20.0,0.0
22577,2,2577,[302 427 197 180 603],474,5,11204,4.34600465477114,20.0,0.0
22578,2,2578,[302 427 197 180 603],474,5,11209,4.346258239627763,20.0,0.0
22579,2,2579,[127  56 202  98   4],102,2,11211,4.345348837209302,0.0,40.0
22580,2,2580,[515 423 180 187  97],7,4,11215,4.3452150329329715,0.0,0.0
22581,2,2581,[302 427 197 180 603],13,5,11220,4.345468628969791,20.0,0.0
22582,2,2582,[175 228  50 186 405],537,3,11223,4.344947735191638,0.0,20.0
22583,2,2583,[302 427 197 180 603],474,5,11228,4.345201238390093,20.0,0.0
22584,2,2584,[302 427 197 180 603],90,5,11233,4.345454545454546,20.0,0.0
22585,2,2585,[302 427 197 180 603],90,5,11238,4.345707656612529,20.0,0.0
22586,2,2586,[202 179  25 200 132],271,4,11242,4.345574023965984,0.0,0.0
22587,2,2587,[302 427 197 180 603],271,5,11247,4.345826893353942,20.0,0.0
22588,2,2588,[302 427 197 180 603],666,5,11252,4.34607956740054,20.0,0.0
22589,2,2589,[302 427 197 180 603],664,5,11257,4.346332046332046,20.0,0.0
22590,2,2590,[302 427 197 180 603],90,5,11262,4.346584330374373,20.0,0.0
22591,2,2591,[286 143 216 238  56],318,2,11264,4.345679012345679,0.0,0.0
22592,2,2592,[302 427 197 180 603],474,5,11269,4.345931353644428,20.0,0.0
22593,2,2593,[385 210  64  11 322],804,5,11274,4.346183500385505,0.0,0.0
22594,2,2594,[302 427 197 180 603],537,5,11279,4.346435452793834,20.0,0.0
22595,2,2595,[302 427 197 180 603],271,5,11284,4.3466872110939905,20.0,0.0
22596,2,2596,[302 427 197 180 603],474,5,11289,4.346938775510204,20.0,0.0
22597,2,2597,[228 289   7   9  56],883,5,11294,4.3471901462663585,0.0,0.0
22598,2,2598,[302 427 197 180 603],474,5,11299,4.347441323585994,20.0,0.0
22599,2,2599,[ 82  56 289 238 215],554,4,11303,4.347307692307692,0.0,0.0
22600,2,2600,[475 153 313 180 135],90,4,11307,4.34717416378316,0.0,0.0
22601,2,2601,[302 427 197 180 603],666,5,11312,4.347425057647963,20.0,0.0
22602,2,2602,[302 427 197 180 603],474,5,11317,4.347675758739915,20.0,0.0
22603,2,2603,[275 273 258  71 385],328,3,11320,4.34715821812596,0.0,0.0
22604,2,2604,[302 427 197 180 603],13,5,11325,4.347408829174664,20.0,0.0
22605,2,2605,[302 427 197 180 603],474,5,11330,4.347659247889486,20.0,0.0
22606,2,2606,[302 427 197 180 603],13,5,11335,4.347909474491753,20.0,0.0
22607,2,2607,[302 427 197 180 603],666,5,11340,4.348159509202454,20.0,0.0
22608,2,2608,[302 427 197 180 603],271,5,11345,4.348409352242238,20.0,0.0
22609,2,2609,[302 427 197 180 603],537,5,11350,4.3486590038314175,20.0,0.0
22610,2,2610,[302 427 197 180 603],664,5,11355,4.348908464189965,20.0,0.0
22611,2,2611,[117   4 385  96 678],537,0,11355,4.347243491577335,0.0,0.0
22612,2,2612,[294 215  95 186 195],648,2,11357,4.346345197091466,0.0,0.0
22613,2,2613,[435 135 202 132 179],7,4,11361,4.3462127008416225,0.0,0.0
22614,2,2614,[151 435 427 258 200],666,4,11365,4.346080305927342,0.0,0.0
22615,2,2615,[302 427 197 180 603],90,5,11370,4.3463302752293576,20.0,0.0
22616,2,2616,[204 237 174  11 588],7,4,11374,4.34619793656859,0.0,20.0
22617,2,2617,[172 655 258   9 603],411,5,11379,4.346447669977081,20.0,0.0
22618,2,2618,[302 427 197 180 603],474,5,11384,4.346697212676594,20.0,0.0
22619,2,2619,[302 427 197 180 603],13,5,11389,4.346946564885497,20.0,0.0
22620,2,2620,[302 427 197 180 603],271,5,11394,4.347195726821823,20.0,0.0
22621,2,2621,[302 427 197 180 603],537,5,11399,4.3474446987032795,20.0,0.0
22622,2,2622,[302 427 197 180 603],474,5,11404,4.347693480747236,20.0,0.0
22623,2,2623,[ 71 258 603 180 286],387,3,11407,4.347179878048781,20.0,0.0
22624,2,2624,[211 185  98 153 151],64,3,11410,4.346666666666667,0.0,20.0
22625,2,2625,[302 427 197 180 603],664,5,11415,4.346915460776847,20.0,0.0
22626,2,2626,[302 427 197 180 603],474,5,11420,4.347164065473924,20.0,0.0
22627,2,2627,[475  56 234  88  22],343,4,11424,4.34703196347032,0.0,0.0
22628,2,2628,[483  25 423  12 289],234,3,11427,4.346519589197413,40.0,0.0
22629,2,2629,[302 427 197 180 603],13,5,11432,4.346768060836502,20.0,0.0
22630,2,2630,[228 268 172 168 153],334,4,11436,4.346636259977195,0.0,0.0
22631,2,2631,[168 187 127 228  71],64,4,11440,4.3465045592705165,0.0,20.0
22632,2,2632,[302 427 197 180 603],664,5,11445,4.346752753513103,20.0,0.0
22633,2,2633,[302 427 197 180 603],666,5,11450,4.347000759301443,20.0,0.0
22634,2,2634,[302 427 197 180 603],271,5,11455,4.347248576850095,20.0,0.0
22635,2,2635,[302 427 197 180 603],271,5,11460,4.347496206373293,20.0,0.0
22636,2,2636,[302 427 197 180 603],383,5,11465,4.347743648084945,20.0,0.0
22637,2,2637,[302 427 197 180 603],90,5,11470,4.347990902198635,20.0,0.0
22638,2,2638,[302 427 197 180 603],664,5,11475,4.3482379689276245,20.0,0.0
22639,2,2639,[302 427 197 180 603],13,5,11480,4.348484848484849,20.0,0.0
22640,2,2640,[234 153  69 588 132],64,4,11484,4.348352896630065,0.0,0.0
22641,2,2641,[302 427 197 180 603],666,5,11489,4.3485995457986375,20.0,0.0
22642,2,2642,[118 742 508 678 100],447,2,11491,4.347710934544079,0.0,20.0
22643,2,2643,[435 210 194 195 385],638,3,11494,4.3472012102874436,0.0,0.0
22644,2,2644,[302 427 197 180 603],666,5,11499,4.347448015122874,20.0,0.0
22645,2,2645,[302 427 197 180 603],537,5,11504,4.347694633408919,20.0,0.0
22646,2,2646,[302 427 197 180 603],271,5,11509,4.347941065357008,20.0,0.0
22647,2,2647,[302 427 197 180 603],271,5,11514,4.348187311178248,20.0,0.0
22648,2,2648,[289 174  11 100 197],406,4,11518,4.348055870139675,0.0,40.0
22649,2,2649,[546  69 435   8  64],308,3,11521,4.347547169811321,0.0,0.0
22650,2,2650,[302 427 197 180 603],666,5,11526,4.347793285552622,20.0,0.0
22651,2,2651,[302 427 197 180 603],383,5,11531,4.348039215686274,20.0,0.0
22652,2,2652,[ 11   7  50  15 655],92,4,11535,4.347908028646815,0.0,20.0
22653,2,2653,[302 427 197 180 603],13,5,11540,4.348153730218538,20.0,0.0
22654,2,2654,[302 427 197 180 603],271,5,11545,4.348399246704331,20.0,0.0
22655,2,2655,[302 427 197 180 603],339,5,11550,4.348644578313253,20.0,0.0
22656,2,2656,[210 197 508 211  82],537,3,11553,4.3481369966127215,0.0,0.0
22657,2,2657,[ 70 174 568  97 127],455,4,11557,4.348006019563582,0.0,40.0
22658,2,2658,[185  50 435  12  69],643,4,11561,4.347875141030463,20.0,20.0
22659,2,2659,[302 427 197 180 603],90,5,11566,4.34812030075188,20.0,0.0
22660,2,2660,[302 427 197 180 603],13,5,11571,4.3483652762119505,20.0,0.0
22661,2,2661,[302 427 197 180 603],383,5,11576,4.348610067618332,20.0,0.0
22662,2,2662,[302 427 197 180 603],90,5,11581,4.34885467517837,20.0,0.0
22663,2,2663,[302 427 197 180 603],90,5,11586,4.349099099099099,20.0,0.0
22664,2,2664,[194 216 211   7   9],60,5,11591,4.349343339587242,0.0,0.0
22665,2,2665,[302 427 197 180 603],271,5,11596,4.349587396849213,20.0,0.0
22666,2,2666,[195   9  97 678 483],308,2,11598,4.348706411698537,20.0,0.0
22667,2,2667,[ 88 168  69  98  71],374,3,11601,4.348200899550225,0.0,20.0
22668,2,2668,[ 88 328 475  64 234],92,3,11604,4.347695766204571,0.0,0.0
22669,2,2669,[302 427 197 180 603],666,5,11609,4.347940074906367,20.0,0.0
22670,2,2670,[ 79 191  50 179  97],379,4,11613,4.347809809060277,0.0,20.0
22671,2,2671,[302 427 197 180 603],271,5,11618,4.348053892215569,20.0,0.0
22672,2,2672,[302 427 197 180 603],383,5,11623,4.348297792742237,20.0,0.0
22673,2,2673,[597  97  98 168   7],774,1,11624,4.3470456245325355,0.0,20.0
22674,2,2674,[  9 182 153 135  12],328,2,11626,4.346168224299065,20.0,0.0
22675,2,2675,[655 168  79 151  11],406,1,11627,4.3449177877429,0.0,0.0
22676,2,2676,[302 427 197 180 603],537,5,11632,4.345162495330594,20.0,0.0
22677,2,2677,[302 427 197 180 603],383,5,11637,4.345407020164302,20.0,0.0
22678,2,2678,[143  98  79 222 196],897,4,11641,4.345278088839119,0.0,20.0
22679,2,2679,[  1 546  82  64 508],83,4,11645,4.345149253731344,0.0,0.0
22680,2,2680,[302 427 197 180 603],383,5,11650,4.345393509884372,20.0,0.0
22681,2,2681,[211 180   4 143 215],343,5,11655,4.345637583892618,0.0,0.0
22682,2,2682,[  4 742 176 121  82],648,4,11659,4.345508758852032,0.0,0.0
22683,2,2683,[475 258  79 265  11],64,4,11663,4.345380029806259,0.0,0.0
22684,2,2684,[258 475 403 228 546],13,2,11665,4.344506517690875,0.0,0.0
22685,2,2685,[302 427 197 180 603],13,5,11670,4.344750558451229,20.0,0.0
22686,2,2686,[302 427 197 180 603],383,5,11675,4.344994417566059,20.0,0.0
22687,2,2687,[ 15 180 175  79 515],194,2,11677,4.344122023809524,0.0,0.0
22688,2,2688,[302 427 197 180 603],90,5,11682,4.34436593529193,20.0,0.0
22689,2,2689,[302 427 197 180 603],474,5,11687,4.34460966542751,20.0,0.0
22690,2,2690,[ 12 423 300 222 121],378,4,11691,4.344481605351171,20.0,0.0
22691,2,2691,[302 427 197 180 603],339,5,11696,4.344725111441307,20.0,0.0
22692,2,2692,[302 427 197 180 603],13,5,11701,4.344968436687709,20.0,0.0
22693,2,2693,[302 427 197 180 603],664,5,11706,4.3452115812917596,20.0,0.0
22694,2,2694,[302 427 197 180 603],537,5,11711,4.345454545454546,20.0,0.0
22695,2,2695,[588 135 151 235 333],537,1,11712,4.344213649851632,0.0,0.0
22696,2,2696,[269 187  88  89  97],659,4,11716,4.344086021505376,0.0,0.0
22697,2,2697,[302 427 197 180 603],537,5,11721,4.344329132690882,20.0,0.0
22698,2,2698,[302 427 197 180 603],90,5,11726,4.344572063727306,20.0,0.0
22699,2,2699,[302 427 197 180 603],664,5,11731,4.344814814814815,20.0,0.0
22700,2,2700,[322 269   4 318  64],883,4,11735,4.344687152906331,20.0,0.0
22701,2,2701,[302 427 197 180 603],339,5,11740,4.344929681717247,20.0,0.0
22702,2,2702,[302 427 197 180 603],383,5,11745,4.345172031076582,20.0,0.0
22703,2,2703,[302 427 197 180 603],474,5,11750,4.345414201183432,20.0,0.0
22704,2,2704,[173  79 125 678 222],213,4,11754,4.345286506469501,0.0,0.0
22705,2,2705,[302 427 197 180 603],383,5,11759,4.345528455284553,20.0,0.0
22706,2,2706,[275 257 228 403  88],279,2,11761,4.34466198743997,0.0,0.0
22707,2,2707,[235 182  69 265  56],774,2,11763,4.343796159527327,0.0,0.0
22708,2,2708,[302 427 197 180 603],271,5,11768,4.344038390550018,20.0,0.0
22709,2,2709,[302 427 197 180 603],664,5,11773,4.344280442804428,20.0,0.0
22710,2,2710,[302 427 197 180 603],90,5,11778,4.344522316488381,20.0,0.0
22711,2,2711,[ 22 748 204  71 235],524,0,11778,4.342920353982301,0.0,0.0
22712,2,2712,[302 427 197 180 603],474,5,11783,4.343162550681902,20.0,0.0
22713,2,2713,[302 427 197 180 603],666,5,11788,4.34340456890199,20.0,0.0
22714,2,2714,[302 427 197 180 603],383,5,11793,4.343646408839779,20.0,0.0
22715,2,2715,[ 98 175 168 211   8],326,3,11796,4.343151693667157,0.0,20.0
22716,2,2716,[302 195 471 172 237],474,4,11800,4.343025395656975,0.0,0.0
22717,2,2717,[302 427 197 180 603],339,5,11805,4.343267108167771,20.0,0.0
22718,2,2718,[302 427 197 180 603],664,5,11810,4.343508642883413,20.0,0.0
22719,2,2719,[302 427 197 180 603],90,5,11815,4.34375,20.0,0.0
22720,2,2720,[302 427 197 180 603],383,5,11820,4.343991179713341,20.0,0.0
22721,2,2721,[302 427 197 180 603],666,5,11825,4.344232182218956,20.0,0.0
22722,2,2722,[302 427 197 180 603],537,5,11830,4.344473007712082,20.0,0.0
22723,2,2723,[302 427 197 180 603],13,5,11835,4.344713656387666,20.0,0.0
22724,2,2724,[257 294 234 202 222],92,2,11837,4.343853211009174,0.0,0.0
22725,2,2725,[176  50 588 275 151],843,1,11838,4.3426265590608955,0.0,20.0
22726,2,2726,[302 427 197 180 603],664,5,11843,4.342867620095343,20.0,0.0
22727,2,2727,[ 50  89 174 191 258],7,5,11848,4.343108504398827,0.0,40.0
22728,2,2728,[302 427 197 180 603],271,5,11853,4.343349212165628,20.0,0.0
22729,2,2729,[168 742 210  79 153],92,4,11857,4.343223443223443,0.0,0.0
22730,2,2730,[288 597 301  89  95],378,2,11859,4.342365433906994,0.0,0.0
22731,2,2731,[603 678  25 182 195],804,5,11864,4.342606149341142,20.0,0.0
22732,2,2732,[302 427 197 180 603],271,5,11869,4.342846688620564,20.0,0.0
22733,2,2733,[302 427 197 180 603],666,5,11874,4.343087051938552,20.0,0.0
22734,2,2734,[302 427 197 180 603],664,5,11879,4.343327239488117,20.0,0.0
22735,2,2735,[202 186  82 181  89],64,3,11882,4.3428362573099415,0.0,0.0
22736,2,2736,[302 427 197 180 603],271,5,11887,4.3430763609791745,20.0,0.0
22737,2,2737,[302 427 197 180 603],271,5,11892,4.343316289262235,20.0,0.0
22738,2,2738,[302 427 197 180 603],339,5,11897,4.343556042351223,20.0,0.0
22739,2,2739,[302 427 197 180 603],537,5,11902,4.343795620437956,20.0,0.0
22740,2,2740,[302 427 197 180 603],474,5,11907,4.344035023713973,20.0,0.0
22741,2,2741,[302 427 197 180 603],664,5,11912,4.344274252370533,20.0,0.0
22742,2,2742,[302 427 197 180 603],666,5,11917,4.344513306598615,20.0,0.0
22743,2,2743,[385 471 237 269 187],524,3,11920,4.34402332361516,0.0,0.0
22744,2,2744,[385  50 172 211 210],883,4,11924,4.343897996357013,0.0,20.0
22745,2,2745,[302 427 197 180 603],537,5,11929,4.3441369264384555,20.0,0.0
22746,2,2746,[302 427 197 180 603],666,5,11934,4.344375682562796,20.0,0.0
22747,2,2747,[385  12 515   1  56],234,1,11935,4.34315866084425,20.0,0.0
22748,2,2748,[302 427 197 180 603],271,5,11940,4.3433975991269556,20.0,0.0
22749,2,2749,[302 427 197 180 603],664,5,11945,4.343636363636364,20.0,0.0
22750,2,2750,[302 427 197 180 603],474,5,11950,4.3438749545619775,20.0,0.0
22751,2,2751,[302 427 197 180 603],383,5,11955,4.344113372093023,20.0,0.0
22752,2,2752,[302 427 197 180 603],664,5,11960,4.344351616418453,20.0,0.0
22753,2,2753,[302 427 197 180 603],537,5,11965,4.344589687726943,20.0,0.0
22754,2,2754,[302 427 197 180 603],271,5,11970,4.344827586206897,20.0,0.0
22755,2,2755,[195  12 496 191 405],7,4,11974,4.344702467343977,20.0,0.0
22756,2,2756,[302 427 197 180 603],474,5,11979,4.3449401523394995,20.0,0.0
22757,2,2757,[302 427 197 180 603],13,5,11984,4.345177664974619,20.0,0.0
22758,2,2758,[302 427 197 180 603],339,5,11989,4.345415005436752,20.0,0.0
22759,2,2759,[  1  50  15  25 235],637,4,11993,4.345289855072464,0.0,20.0
22760,2,2760,[173 210 357 186 185],7,5,11998,4.345526982977182,20.0,0.0
22761,2,2761,[655   4 200 568 204],537,0,11998,4.343953656770456,0.0,0.0
22762,2,2762,[302 427 197 180 603],383,5,12003,4.344191096634093,20.0,0.0
22763,2,2763,[302 427 197 180 603],90,5,12008,4.344428364688857,20.0,0.0
22764,2,2764,[ 64 132 187  82 258],653,3,12011,4.343942133815552,0.0,0.0
22765,2,2765,[302 427 197 180 603],271,5,12016,4.344179320318149,20.0,0.0
22766,2,2766,[132  28 197 183 257],653,1,12017,4.342970726418504,0.0,0.0
22767,2,2767,[302 427 197 180 603],90,5,12022,4.343208092485549,20.0,0.0
22768,2,2768,[117 153 385 174 265],387,3,12025,4.342723004694836,0.0,20.0
22769,2,2769,[435 153 175   8 121],378,5,12030,4.342960288808665,0.0,0.0
22770,2,2770,[302 427 197 180 603],13,5,12035,4.34319740166005,20.0,0.0
22771,2,2771,[ 69  50  25 118  56],749,3,12038,4.342712842712842,0.0,20.0
22772,2,2772,[302 427 197 180 603],90,5,12043,4.342949873782906,20.0,0.0
22773,2,2773,[302 427 197 180 603],90,5,12048,4.343186733958183,20.0,0.0
22774,2,2774,[302 427 197 180 603],474,5,12053,4.343423423423423,20.0,0.0
22775,2,2775,[302 427 197 180 603],271,5,12058,4.343659942363113,20.0,0.0
22776,2,2776,[302 427 197 180 603],474,5,12063,4.343896290961469,20.0,0.0
22777,2,2777,[172 568  82 216 403],13,1,12064,4.342692584593233,0.0,0.0
22778,2,2778,[176 195 328   1 483],263,5,12069,4.342929111191076,20.0,0.0
22779,2,2779,[ 11 603 187 357 100],643,5,12074,4.3431654676259,40.0,20.0
22780,2,2780,[435 186  96 176 143],474,5,12079,4.343401654081266,0.0,0.0
22781,2,2781,[302 427 197 180 603],664,5,12084,4.343637670740475,20.0,0.0
22782,2,2782,[302 427 197 180 603],90,5,12089,4.3438735177865615,20.0,0.0
22783,2,2783,[302 427 197 180 603],271,5,12094,4.344109195402299,20.0,0.0
22784,2,2784,[302 427 197 180 603],271,5,12099,4.344344703770197,20.0,0.0
22785,2,2785,[302 427 197 180 603],664,5,12104,4.344580043072505,20.0,0.0
22786,2,2786,[276 269 172 286   9],119,3,12107,4.344097595981342,0.0,0.0
22787,2,2787,[302 427 197 180 603],90,5,12112,4.344332855093257,20.0,0.0
22788,2,2788,[302 427 197 180 603],474,5,12117,4.344567945500179,20.0,0.0
22789,2,2789,[276 282 405  69 202],643,1,12118,4.34336917562724,0.0,0.0
22790,2,2790,[302 427 197 180 603],383,5,12123,4.343604442852024,20.0,0.0
22791,2,2791,[302 427 197 180 603],474,5,12128,4.343839541547278,20.0,0.0
22792,2,2792,[237 318  89 210 121],538,3,12131,4.343358395989975,20.0,0.0
22793,2,2793,[ 12 179 427  79  71],7,5,12136,4.343593414459556,20.0,0.0
22794,2,2794,[151 117 172  22 257],334,3,12139,4.343112701252236,0.0,0.0
22795,2,2795,[302 427 197 180 603],664,5,12144,4.343347639484978,20.0,0.0
22796,2,2796,[302 427 197 180 603],383,5,12149,4.343582409724705,20.0,0.0
22797,2,2797,[302 427 197 180 603],90,5,12154,4.343817012151537,20.0,0.0
22798,2,2798,[302 427 197 180 603],90,5,12159,4.344051446945338,20.0,0.0
22799,2,2799,[302 427 197 180 603],339,5,12164,4.344285714285714,20.0,0.0
22800,2,2800,[302 427 197 180 603],339,5,12169,4.344519814352017,20.0,0.0
22801,2,2801,[302 427 197 180 603],339,5,12174,4.344753747323341,20.0,0.0
22802,2,2802,[302 427 197 180 603],13,5,12179,4.344987513378523,20.0,0.0
22803,2,2803,[302 427 197 180 603],537,5,12184,4.345221112696148,20.0,0.0
22804,2,2804,[302 427 197 180 603],90,5,12189,4.345454545454546,20.0,0.0
22805,2,2805,[168 216  97 403 175],7,5,12194,4.345687811831789,0.0,0.0
22806,2,2806,[174 222 144 173   8],60,4,12198,4.345564659779123,0.0,20.0
22807,2,2807,[302 427 197 180 603],474,5,12203,4.345797720797721,20.0,0.0
22808,2,2808,[302 427 197 180 603],90,5,12208,4.346030615877536,20.0,0.0
22809,2,2809,[302 427 197 180 603],474,5,12213,4.346263345195729,20.0,0.0
22810,2,2810,[234 118 546 322  88],533,3,12216,4.345784418356457,0.0,0.0
22811,2,2811,[302 427 197 180 603],271,5,12221,4.34601706970128,20.0,0.0
22812,2,2812,[302 427 197 180 603],664,5,12226,4.346249555634554,20.0,0.0
22813,2,2813,[195 132 238 211 100],13,3,12229,4.345771144278607,0.0,20.0
22814,2,2814,[302 427 197 180 603],474,5,12234,4.346003552397868,20.0,0.0
22815,2,2815,[185   9 515  56 300],7,4,12238,4.345880681818182,0.0,0.0
22816,2,2816,[302 427 197 180 603],13,5,12243,4.346112886048989,20.0,0.0
22817,2,2817,[322 748 245 483  64],488,2,12245,4.34528034066714,20.0,0.0
22818,2,2818,[302 427 197 180 603],664,5,12250,4.345512593118127,20.0,0.0
22819,2,2819,[182 234 258 197 216],474,5,12255,4.345744680851064,0.0,0.0
22820,2,2820,[302 427 197 180 603],474,5,12260,4.3459766040411205,20.0,0.0
22821,2,2821,[289 302  56 471 273],13,2,12262,4.3451452870304745,0.0,0.0
22822,2,2822,[302 427 197 180 603],339,5,12267,4.345377258235919,20.0,0.0
22823,2,2823,[174  96 180 257   7],881,4,12271,4.345254957507082,0.0,20.0
22824,2,2824,[238  12 168 234  69],474,4,12275,4.345132743362832,20.0,0.0
22825,2,2825,[302 427 197 180 603],13,5,12280,4.345364472753007,20.0,0.0
22826,2,2826,[  1  56 385 273  70],64,4,12284,4.345242306331801,0.0,0.0
22827,2,2827,[194 173  71 204 153],899,4,12288,4.345120226308345,0.0,0.0
22828,2,2828,[302 427 197 180 603],13,5,12293,4.345351714386709,20.0,0.0
22829,2,2829,[282 200 176 234 179],311,4,12297,4.3452296819787986,0.0,0.0
22830,2,2830,[302 427 197 180 603],666,5,12302,4.345460967855881,20.0,0.0
22831,2,2831,[302 427 197 180 603],537,5,12307,4.34569209039548,20.0,0.0
22832,2,2832,[302 427 197 180 603],666,5,12312,4.345923049770561,20.0,0.0
22833,2,2833,[302 427 197 180 603],474,5,12317,4.346153846153846,20.0,0.0
22834,2,2834,[182 496 121  79 191],653,3,12320,4.345679012345679,0.0,0.0
22835,2,2835,[483 180 265 515 257],474,4,12324,4.34555712270804,20.0,0.0
22836,2,2836,[237   9 357 216 471],543,4,12328,4.345435318998943,20.0,0.0
22837,2,2837,[302 427 197 180 603],664,5,12333,4.3456659619450315,20.0,0.0
22838,2,2838,[302 427 197 180 603],383,5,12338,4.345896442409299,20.0,0.0
22839,2,2839,[302 427 197 180 603],339,5,12343,4.34612676056338,20.0,0.0
22840,2,2840,[302 427 197 180 603],666,5,12348,4.346356916578669,20.0,0.0
22841,2,2841,[302 427 197 180 603],537,5,12353,4.3465869106263195,20.0,0.0
22842,2,2842,[302 427 197 180 603],271,5,12358,4.346816742877242,20.0,0.0
22843,2,2843,[200 508 423 186 655],343,4,12362,4.346694796061884,0.0,0.0
22844,2,2844,[161 191 245   9  12],533,4,12366,4.346572934973638,20.0,0.0
22845,2,2845,[302 427 197 180 603],474,5,12371,4.346802529866479,20.0,0.0
22846,2,2846,[302 427 197 180 603],383,5,12376,4.34703196347032,20.0,0.0
22847,2,2847,[302 427 197 180 603],339,5,12381,4.347261235955056,20.0,0.0
22848,2,2848,[302 427 197 180 603],13,5,12386,4.347490347490347,20.0,0.0
22849,2,2849,[194 678 174 273  89],13,3,12389,4.347017543859649,0.0,20.0
22850,2,2850,[302 427 197 180 603],13,5,12394,4.347246580147317,20.0,0.0
22851,2,2851,[302 427 197 180 603],271,5,12399,4.347475455820477,20.0,0.0
22852,2,2852,[191 211  70 328 568],804,5,12404,4.3477041710480195,0.0,0.0
22853,2,2853,[568 515 288 211 322],804,4,12408,4.347582340574632,0.0,0.0
22854,2,2854,[228 435 204 127 222],533,5,12413,4.347810858143608,0.0,20.0
22855,2,2855,[118 496 228  50 144],7,4,12417,4.347689075630252,0.0,20.0
22856,2,2856,[302 427 197 180 603],664,5,12422,4.347917395869794,20.0,0.0
22857,2,2857,[302 427 197 180 603],383,5,12427,4.3481455563331,20.0,0.0
22858,2,2858,[302 427 197 180 603],13,5,12432,4.348373557187828,20.0,0.0
22859,2,2859,[ 28 121 275 423 435],455,5,12437,4.3486013986013985,0.0,0.0
22860,2,2860,[294 194 180 215  28],308,2,12439,4.347780496329954,0.0,0.0
22861,2,2861,[302 427 197 180 603],339,5,12444,4.348008385744235,20.0,0.0
22862,2,2862,[302 427 197 180 603],339,5,12449,4.348236115962277,20.0,0.0
22863,2,2863,[302 427 197 180 603],339,5,12454,4.348463687150838,20.0,0.0
22864,2,2864,[302 427 197 180 603],383,5,12459,4.34869109947644,20.0,0.0
22865,2,2865,[302 427 197 180 603],537,5,12464,4.348918353105374,20.0,0.0
22866,2,2866,[302 427 197 180 603],664,5,12469,4.349145448203697,20.0,0.0
22867,2,2867,[496  50  64 100 216],883,4,12473,4.349023709902371,0.0,40.0
22868,2,2868,[302 427 197 180 603],90,5,12478,4.34925060996863,20.0,0.0
22869,2,2869,[302 427 197 180 603],271,5,12483,4.349477351916376,20.0,0.0
22870,2,2870,[302 427 197 180 603],13,5,12488,4.349703935910832,20.0,0.0
22871,2,2871,[302 427 197 180 603],383,5,12493,4.349930362116992,20.0,0.0
22872,2,2872,[302 427 197 180 603],90,5,12498,4.350156630699617,20.0,0.0
22873,2,2873,[302 427 197 180 603],90,5,12503,4.350382741823243,20.0,0.0
22874,2,2874,[  7 678 475 215 588],13,2,12505,4.349565217391304,0.0,0.0
22875,2,2875,[302 427 197 180 603],537,5,12510,4.349791376912378,20.0,0.0
22876,2,2876,[ 50 161  11 181 172],600,5,12515,4.350017379214459,0.0,20.0
22877,2,2877,[204 228 471 496 245],533,4,12519,4.349895760945101,0.0,0.0
22878,2,2878,[302 427 197 180 603],339,5,12524,4.35012156998958,20.0,0.0
22879,2,2879,[302 427 197 180 603],474,5,12529,4.350347222222222,20.0,0.0
22880,2,2880,[302 427 197 180 603],339,5,12534,4.350572717806317,20.0,0.0
22881,2,2881,[302 427 197 180 603],666,5,12539,4.350798056904927,20.0,0.0
22882,2,2882,[302 427 197 180 603],13,5,12544,4.351023239680888,20.0,0.0
22883,2,2883,[302 427 197 180 603],537,5,12549,4.35124826629681,20.0,0.0
22884,2,2884,[302 427 197 180 603],664,5,12554,4.351473136915078,20.0,0.0
22885,2,2885,[302 427 197 180 603],537,5,12559,4.3516978516978515,20.0,0.0
22886,2,2886,[143  79 132  28   1],234,2,12561,4.350883269830273,0.0,0.0
22887,2,2887,[135 276 175 127 168],6,4,12565,4.350761772853185,0.0,20.0
22888,2,2888,[302 427 197 180 603],271,5,12570,4.350986500519211,20.0,0.0
22889,2,2889,[405   1 196 423 328],749,4,12574,4.3508650519031145,0.0,0.0
22890,2,2890,[302 427 197 180 603],666,5,12579,4.351089588377724,20.0,0.0
22891,2,2891,[143 144 183   8 265],13,4,12583,4.350968188105117,0.0,0.0
22892,2,2892,[222  64 323 132 176],881,3,12586,4.350501209816799,0.0,0.0
22893,2,2893,[187  79 318 143  56],385,2,12588,4.3496890117484455,20.0,0.0
22894,2,2894,[302 427 197 180 603],664,5,12593,4.349913644214162,20.0,0.0
22895,2,2895,[ 56 125 200 204  96],7,5,12598,4.350138121546961,0.0,0.0
22896,2,2896,[302 427 197 180 603],383,5,12603,4.350362443907491,20.0,0.0
22897,2,2897,[302 427 197 180 603],666,5,12608,4.350586611456177,20.0,0.0
22898,2,2898,[302 427 197 180 603],271,5,12613,4.350810624353225,20.0,0.0
22899,2,2899,[302 427 197 180 603],90,5,12618,4.351034482758621,20.0,0.0
22900,2,2900,[302 427 197 180 603],666,5,12623,4.351258186832127,20.0,0.0
22901,2,2901,[302 427 197 180 603],383,5,12628,4.351481736733287,20.0,0.0
22902,2,2902,[ 50   4 168 197   7],10,5,12633,4.351705132621426,0.0,20.0
22903,2,2903,[302 427 197 180 603],339,5,12638,4.351928374655647,20.0,0.0
22904,2,2904,[302 427 197 180 603],537,5,12643,4.352151462994836,20.0,0.0
22905,2,2905,[435 475 151  71 289],82,2,12645,4.351342050929112,0.0,0.0
22906,2,2906,[302 427 197 180 603],383,5,12650,4.3515651874785,20.0,0.0
22907,2,2907,[202 187 568  70 174],308,5,12655,4.351788170563961,0.0,20.0
22908,2,2908,[483 182  64 275 175],90,3,12658,4.351323478858714,20.0,0.0
22909,2,2909,[385 265  89  82 286],666,2,12660,4.350515463917525,0.0,0.0
22910,2,2910,[228  56  70 194 151],804,3,12663,4.350051528684301,0.0,0.0
22911,2,2911,[302 427 197 180 603],474,5,12668,4.350274725274725,20.0,0.0
22912,2,2912,[302 427 197 180 603],13,5,12673,4.350497768623412,20.0,0.0
22913,2,2913,[302 427 197 180 603],90,5,12678,4.350720658888126,20.0,0.0
22914,2,2914,[427 300 273  12 185],90,3,12681,4.350257289879932,20.0,0.0
22915,2,2915,[216 132 276  28 117],194,1,12682,4.3491083676268865,0.0,0.0
22916,2,2916,[302 427 197 180 603],90,5,12687,4.34933150497086,20.0,0.0
22917,2,2917,[302 427 197 180 603],13,5,12692,4.349554489376285,20.0,0.0
22918,2,2918,[302 427 197 180 603],13,5,12697,4.349777321000342,20.0,0.0
22919,2,2919,[302 427 197 180 603],383,5,12702,4.35,20.0,0.0
22920,2,2920,[515  88  69 471 200],234,3,12705,4.349537829510441,0.0,0.0
22921,2,2921,[302 427 197 180 603],383,5,12710,4.349760438056126,20.0,0.0
22922,2,2922,[302 427 197 180 603],90,5,12715,4.349982894286692,20.0,0.0
22923,2,2923,[302 427 197 180 603],339,5,12720,4.350205198358413,20.0,0.0
22924,2,2924,[302 427 197 180 603],537,5,12725,4.35042735042735,20.0,0.0
22925,2,2925,[546 172 204 288 186],13,3,12728,4.3499658236500345,0.0,0.0
22926,2,2926,[153  89 182 655 318],194,2,12730,4.349162965493679,20.0,0.0
22927,2,2927,[302 427 197 180 603],90,5,12735,4.349385245901639,20.0,0.0
22928,2,2928,[187 268 238 100 175],7,4,12739,4.349265961078866,0.0,20.0
22929,2,2929,[302 427 197 180 603],474,5,12744,4.349488054607509,20.0,0.0
22930,2,2930,[302 427 197 180 603],537,5,12749,4.349709996588195,20.0,0.0
22931,2,2931,[302 427 197 180 603],664,5,12754,4.349931787175989,20.0,0.0
22932,2,2932,[678  56  88 183 235],308,3,12757,4.349471530855779,0.0,0.0
22933,2,2933,[302 427 197 180 603],666,5,12762,4.3496932515337425,20.0,0.0
22934,2,2934,[302 427 197 180 603],664,5,12767,4.3499148211243615,20.0,0.0
22935,2,2935,[ 98 588 172 100  97],13,5,12772,4.3501362397820165,0.0,40.0
22936,2,2936,[302 427 197 180 603],339,5,12777,4.3503575076608785,20.0,0.0
22937,2,2937,[302 427 197 180 603],474,5,12782,4.350578624914908,20.0,0.0
22938,2,2938,[302 427 197 180 603],13,5,12787,4.350799591697856,20.0,0.0
22939,2,2939,[302 427 197 180 603],90,5,12792,4.351020408163265,20.0,0.0
22940,2,2940,[302 427 197 180 603],664,5,12797,4.351241074464468,20.0,0.0
22941,2,2941,[275 174 568 100 132],85,2,12799,4.350441876274643,0.0,40.0
22942,2,2942,[185 405 195 191 276],537,3,12802,4.349983010533469,0.0,0.0
22943,2,2943,[302 427 197 180 603],90,5,12807,4.350203804347826,20.0,0.0
22944,2,2944,[302 427 197 180 603],13,5,12812,4.350424448217318,20.0,0.0
22945,2,2945,[210 211  28 121 153],298,4,12816,4.35030549898167,0.0,0.0
22946,2,2946,[403 143 118 228 121],313,2,12818,4.349507974211062,0.0,0.0
22947,2,2947,[302 427 197 180 603],664,5,12823,4.349728629579376,20.0,0.0
22948,2,2948,[302 427 197 180 603],383,5,12828,4.349949135300101,20.0,0.0
22949,2,2949,[302 427 197 180 603],90,5,12833,4.350169491525424,20.0,0.0
22950,2,2950,[385 195 269 435 301],666,3,12836,4.349711962046764,0.0,0.0
22951,2,2951,[302 427 197 180 603],537,5,12841,4.349932249322493,20.0,0.0
22952,2,2952,[678  82 588 187  89],537,2,12843,4.349136471385032,0.0,0.0
22953,2,2953,[216 194 475 204 222],474,5,12848,4.349356804333108,0.0,0.0
22954,2,2954,[302 427 197 180 603],666,5,12853,4.349576988155668,20.0,0.0
22955,2,2955,[288 100  50  69 269],666,2,12855,4.348782138024357,0.0,40.0
22956,2,2956,[302 427 197 180 603],339,5,12860,4.349002367264119,20.0,0.0
22957,2,2957,[117 508 127 185 357],13,1,12861,4.347870182555781,20.0,20.0
22958,2,2958,[286 588   8 678 269],7,3,12864,4.3474146671172695,0.0,0.0
22959,2,2959,[ 56 211 423 275 180],474,4,12868,4.347297297297297,0.0,0.0
22960,2,2960,[ 25 210 235 204 196],378,5,12873,4.347517730496454,0.0,0.0
22961,2,2961,[302 427 197 180 603],666,5,12878,4.347738014854828,20.0,0.0
22962,2,2962,[471 515  50 328 127],548,5,12883,4.347958150523119,0.0,40.0
22963,2,2963,[265 100 655  69  22],308,3,12886,4.347503373819163,0.0,20.0
22964,2,2964,[302 427 197 180 603],537,5,12891,4.347723440134907,20.0,0.0
22965,2,2965,[302 427 197 180 603],537,5,12896,4.34794335805799,20.0,0.0
22966,2,2966,[302 427 197 180 603],474,5,12901,4.348163127738457,20.0,0.0
22967,2,2967,[302 427 197 180 603],664,5,12906,4.348382749326146,20.0,0.0
22968,2,2968,[302 427 197 180 603],90,5,12911,4.3486022229706975,20.0,0.0
22969,2,2969,[302 427 197 180 603],339,5,12916,4.348821548821549,20.0,0.0
22970,2,2970,[289   8 603  98 121],458,2,12918,4.348030966004712,20.0,20.0
22971,2,2971,[151 515 172  79 121],7,4,12922,4.347913862718708,0.0,0.0
22972,2,2972,[302 427 197 180 603],666,5,12927,4.348133198789102,20.0,0.0
22973,2,2973,[100 194 235  12 265],339,3,12930,4.347679892400807,20.0,20.0
22974,2,2974,[302 427 197 180 603],664,5,12935,4.347899159663865,20.0,0.0
22975,2,2975,[235  64   4   7 508],92,4,12939,4.347782258064516,0.0,0.0
22976,2,2976,[197  28 153 180 228],339,5,12944,4.3480013436345315,0.0,0.0
22977,2,2977,[302 427 197 180 603],90,5,12949,4.348220282068502,20.0,0.0
22978,2,2978,[ 97 194 215 174 132],537,0,12949,4.346760657938906,0.0,20.0
22979,2,2979,[215 423  56 204  64],194,3,12952,4.346308724832215,0.0,0.0
22980,2,2980,[245 273  12 174 269],90,3,12955,4.345857094934586,20.0,20.0
22981,2,2981,[302 427 197 180 603],474,5,12960,4.346076458752515,20.0,0.0
22982,2,2982,[195 273 191 276 568],385,0,12960,4.3446195105598395,0.0,0.0
22983,2,2983,[302 427 197 180 603],383,5,12965,4.3448391420911525,20.0,0.0
22984,2,2984,[302 427 197 180 603],339,5,12970,4.345058626465661,20.0,0.0
22985,2,2985,[215 597 183 235  96],650,2,12972,4.344273275284662,0.0,0.0
22986,2,2986,[302 427 197 180 603],13,5,12977,4.344492802142618,20.0,0.0
22987,2,2987,[302 427 197 180 603],90,5,12982,4.3447121820615795,20.0,0.0
22988,2,2988,[302 427 197 180 603],271,5,12987,4.344931415189026,20.0,0.0
22989,2,2989,[182  56 268  70 151],90,3,12990,4.344481605351171,0.0,0.0
22990,2,2990,[228 210 405  64   8],254,4,12994,4.344366432631227,0.0,0.0
22991,2,2991,[302 427 197 180 603],13,5,12999,4.344585561497326,20.0,0.0
22992,2,2992,[742 322  79 294 135],881,4,13003,4.34447043100568,0.0,0.0
22993,2,2993,[302 427 197 180 603],537,5,13008,4.344689378757515,20.0,0.0
22994,2,2994,[357 597 215  89 185],882,5,13013,4.344908180300501,20.0,0.0
22995,2,2995,[  1 195 197 300  22],653,4,13017,4.34479305740988,0.0,0.0
22996,2,2996,[302 427 180 197 603],271,5,13022,4.345011678345012,20.0,0.0
22997,2,2997,[ 50 385 294   4 194],13,3,13025,4.344563042028018,0.0,20.0
22998,2,2998,[302 427 180 197 603],13,5,13030,4.344781593864622,20.0,0.0
22999,2,2999,[289 210 204 333 180],387,2,13032,4.344,0.0,0.0
23000,2,3000,[302 427 180 197 603],666,5,13037,4.344218593802066,20.0,0.0
23001,2,3001,[215 195 117 238  97],95,5,13042,4.344437041972019,0.0,0.0
23002,2,3002,[302 427 180 197 603],13,5,13047,4.344655344655345,20.0,0.0
23003,2,3003,[210 496 318 273 125],64,2,13049,4.34387483355526,20.0,0.0
23004,2,3004,[211 174 235 597 288],882,3,13052,4.34342762063228,0.0,20.0
23005,2,3005,[ 70  12 508   4 655],940,3,13055,4.342980705256155,20.0,0.0
23006,2,3006,[302 427 180 197 603],383,5,13060,4.343199201862321,20.0,0.0
23007,2,3007,[405 132 183  95 210],815,3,13063,4.342752659574468,0.0,0.0
23008,2,3008,[ 88 234 197 655 483],840,5,13068,4.342971086739781,20.0,0.0
23009,2,3009,[302 427 180 197 603],537,5,13073,4.343189368770764,20.0,0.0
23010,2,3010,[302 427 180 197 603],474,5,13078,4.3434075058120225,20.0,0.0
23011,2,3011,[194 144 322  11  22],308,3,13081,4.342961487383798,0.0,0.0
23012,2,3012,[302 427 180 197 603],271,5,13086,4.343179555260537,20.0,0.0
23013,2,3013,[176 194  70 185   9],543,4,13090,4.343065693430657,0.0,0.0
23014,2,3014,[302 427 180 197 603],13,5,13095,4.343283582089552,20.0,0.0
23015,2,3015,[302 427 180 197 603],339,5,13100,4.343501326259947,20.0,0.0
23016,2,3016,[302 427 180 197 603],537,5,13105,4.343718926085516,20.0,0.0
23017,2,3017,[302 427 180 197 603],664,5,13110,4.343936381709741,20.0,0.0
23018,2,3018,[ 82 100 180 385 546],308,4,13114,4.343822457767473,0.0,20.0
23019,2,3019,[302 427 180 197 603],664,5,13119,4.344039735099337,20.0,0.0
23020,2,3020,[ 11 174  15 204  22],378,4,13123,4.343925852366766,0.0,20.0
23021,2,3021,[302 427 180 197 603],383,5,13128,4.344142951687624,20.0,0.0
23022,2,3022,[144 237  79 200 238],313,3,13131,4.343698312934172,0.0,0.0
23023,2,3023,[302 427 180 197 603],339,5,13136,4.343915343915344,20.0,0.0
23024,2,3024,[302 427 180 197 603],666,5,13141,4.344132231404958,20.0,0.0
23025,2,3025,[302 427 180 197 603],383,5,13146,4.344348975545274,20.0,0.0
23026,2,3026,[302 427 180 197 603],90,5,13151,4.344565576478361,20.0,0.0
23027,2,3027,[286 655 515 271 238],13,1,13152,4.343461030383091,0.0,0.0
23028,2,3028,[302 427 180 197 603],537,5,13157,4.343677781446022,20.0,0.0
23029,2,3029,[302 427 180 197 603],271,5,13162,4.343894389438944,20.0,0.0
23030,2,3030,[357  69 597 187 211],774,1,13163,4.342791158033652,20.0,0.0
23031,2,3031,[302 427 180 197 603],271,5,13168,4.3430079155672825,20.0,0.0
23032,2,3032,[ 12 288 603 300  97],13,3,13171,4.3425651170458295,40.0,0.0
23033,2,3033,[ 95 127 202 194  22],271,5,13176,4.342781806196441,0.0,20.0
23034,2,3034,[302 427 180 197 603],474,5,13181,4.342998352553542,20.0,0.0
23035,2,3035,[302 427 180 197 603],271,5,13186,4.343214756258234,20.0,0.0
23036,2,3036,[302 427 180 197 603],474,5,13191,4.343431017451432,20.0,0.0
23037,2,3037,[427 175  11 173 245],334,4,13195,4.34331797235023,0.0,0.0
23038,2,3038,[302 427 180 197 603],90,5,13200,4.343534057255677,20.0,0.0
23039,2,3039,[302 427 180 197 603],90,5,13205,4.34375,20.0,0.0
23040,2,3040,[302 427 180 197 603],13,5,13210,4.3439658007234465,20.0,0.0
23041,2,3041,[302 427 180 197 603],13,5,13215,4.344181459566075,20.0,0.0
23042,2,3042,[302 427 180 197 603],537,5,13220,4.344396976667762,20.0,0.0
23043,2,3043,[302 427 180 197 603],271,5,13225,4.3446123521682,20.0,0.0
23044,2,3044,[204 168 210 269 211],7,4,13229,4.344499178981938,0.0,0.0
23045,2,3045,[655 294  15 288  11],488,2,13231,4.343729481286934,0.0,0.0
23046,2,3046,[234 237 195  28 172],85,3,13234,4.343288480472596,0.0,0.0
23047,2,3047,[228  28   9 276 603],82,3,13237,4.342847769028872,20.0,0.0
23048,2,3048,[  8  69 117  28 302],13,4,13241,4.34273532305674,0.0,0.0
23049,2,3049,[  9  95 483 742 125],334,2,13243,4.341967213114754,20.0,0.0
23050,2,3050,[302 427 180 197 603],474,5,13248,4.342182890855457,20.0,0.0
23051,2,3051,[302 427 180 197 603],90,5,13253,4.342398427260813,20.0,0.0
23052,2,3052,[742 228 678  96 172],387,3,13256,4.3419587291188995,0.0,0.0
23053,2,3053,[302 427 180 197 603],271,5,13261,4.342174197773412,20.0,0.0
23054,2,3054,[302 427 180 197 603],271,5,13266,4.342389525368249,20.0,0.0
23055,2,3055,[423 161 174 135 179],659,2,13268,4.341623036649215,0.0,20.0
23056,2,3056,[302 427 180 197 603],90,5,13273,4.341838403663723,20.0,0.0
23057,2,3057,[302 427 180 197 603],474,5,13278,4.342053629823414,20.0,0.0
23058,2,3058,[302 427 180 197 603],666,5,13283,4.342268715266427,20.0,0.0
23059,2,3059,[483 191 245 187 301],666,4,13287,4.342156862745098,20.0,0.0
23060,2,3060,[302 427 180 197 603],537,5,13292,4.342371773930088,20.0,0.0
23061,2,3061,[302 427 180 197 603],664,5,13297,4.342586544741999,20.0,0.0
23062,2,3062,[568 318 161 174 210],87,5,13302,4.342801175318315,20.0,20.0
23063,2,3063,[210 471 273 179 187],13,1,13303,4.341710182767624,0.0,0.0
23064,2,3064,[302 427 180 197 603],664,5,13308,4.341924959216966,20.0,0.0
23065,2,3065,[678 268 202 100 204],387,1,13309,4.340834964122635,0.0,20.0
23066,2,3066,[302 427 180 197 603],666,5,13314,4.3410498858819695,20.0,0.0
23067,2,3067,[302 427 180 197 603],666,5,13319,4.341264667535854,20.0,0.0
23068,2,3068,[302 427 180 197 603],271,5,13324,4.341479309221245,20.0,0.0
23069,2,3069,[302 427 180 197 603],90,5,13329,4.341693811074919,20.0,0.0
23070,2,3070,[302 427 180 197 603],13,5,13334,4.341908173233475,20.0,0.0
23071,2,3071,[302 427 180 197 603],537,5,13339,4.342122395833333,20.0,0.0
23072,2,3072,[302 427 180 197 603],664,5,13344,4.342336479010739,20.0,0.0
23073,2,3073,[302 427 180 197 603],383,5,13349,4.342550422901756,20.0,0.0
23074,2,3074,[302 427 180 197 603],474,5,13354,4.342764227642276,20.0,0.0
23075,2,3075,[302 427 180 197 603],474,5,13359,4.34297789336801,20.0,0.0
23076,2,3076,[216 294  22 125 161],881,3,13362,4.342541436464089,0.0,0.0
23077,2,3077,[ 69 176 245 222 603],666,2,13364,4.341780376868096,20.0,0.0
23078,2,3078,[153 185 135 234 515],543,4,13368,4.341669373173108,0.0,0.0
23079,2,3079,[302 427 180 197 603],666,5,13373,4.341883116883117,20.0,0.0
23080,2,3080,[121  82 185  22 180],788,4,13377,4.341772151898734,0.0,0.0
23081,2,3081,[302 427 180 197 603],474,5,13382,4.3419857235561325,20.0,0.0
23082,2,3082,[302 427 180 197 603],664,5,13387,4.342199156665585,20.0,0.0
23083,2,3083,[211 173 172  79 215],488,4,13391,4.342088197146563,0.0,0.0
23084,2,3084,[302 427 180 197 603],664,5,13396,4.342301458670988,20.0,0.0
23085,2,3085,[ 79 196 183 215 143],406,1,13397,4.3412184057031755,0.0,0.0
23086,2,3086,[235 423 143  15   9],648,3,13400,4.340783932620667,0.0,0.0
23087,2,3087,[ 25 215 294  89 185],804,5,13405,4.340997409326425,0.0,0.0
23088,2,3088,[294 603 286 313 121],537,2,13407,4.340239559728067,20.0,0.0
23089,2,3089,[302 427 180 197 603],537,5,13412,4.340453074433657,20.0,0.0
23090,2,3090,[202 385   1 191 483],13,2,13414,4.339695891297315,20.0,0.0
23091,2,3091,[302 427 180 197 603],383,5,13419,4.339909443725744,20.0,0.0
23092,2,3092,[423 237   9  50  64],194,2,13421,4.33915292596185,0.0,20.0
23093,2,3093,[194 144 286 174 191],343,5,13426,4.339366515837104,0.0,20.0
23094,2,3094,[302 427 180 197 603],339,5,13431,4.339579967689822,20.0,0.0
23095,2,3095,[ 82 174 222 301 200],234,1,13432,4.338501291989664,0.0,20.0
23096,2,3096,[302 427 180 197 603],383,5,13437,4.338714885372942,20.0,0.0
23097,2,3097,[302 427 180 197 603],664,5,13442,4.338928340865074,20.0,0.0
23098,2,3098,[302 427 180 197 603],90,5,13447,4.339141658599548,20.0,0.0
23099,2,3099,[ 15 204  71  22 135],6,2,13449,4.338387096774194,0.0,0.0
23100,2,3100,[405 234 678 194  71],749,3,13452,4.337955498226378,0.0,0.0
23101,2,3101,[302 427 180 197 603],90,5,13457,4.3381689232753065,20.0,0.0
23102,2,3102,[302 427 180 197 603],666,5,13462,4.338382210763777,20.0,0.0
23103,2,3103,[302 427 180 197 603],474,5,13467,4.338595360824742,20.0,0.0
23104,2,3104,[302 427 180 197 603],13,5,13472,4.338808373590982,20.0,0.0
23105,2,3105,[ 11 191 183 100   9],13,2,13474,4.338055376690277,0.0,20.0
23106,2,3106,[302 427 180 197 603],271,5,13479,4.338268426134535,20.0,0.0
23107,2,3107,[302 427 180 197 603],666,5,13484,4.338481338481339,20.0,0.0
23108,2,3108,[302 427 180 197 603],537,5,13489,4.338694113862979,20.0,0.0
23109,2,3109,[603 405 546 182 322],749,2,13491,4.3379421221864956,20.0,0.0
23110,2,3110,[302 427 180 197 603],90,5,13496,4.338154934104789,20.0,0.0
23111,2,3111,[125 204 153 186 183],7,5,13501,4.338367609254499,0.0,0.0
23112,2,3112,[211 196 204  82 403],59,5,13506,4.338580147767427,0.0,0.0
23113,2,3113,[302 427 180 197 603],537,5,13511,4.338792549775209,20.0,0.0
23114,2,3114,[313 210 143  15  64],92,3,13514,4.338362760834671,0.0,0.0
23115,2,3115,[ 11 204 151 257 475],474,3,13517,4.33793324775353,0.0,0.0
23116,2,3116,[302 427 180 197 603],339,5,13522,4.338145652871351,20.0,0.0
23117,2,3117,[302 427 180 197 603],90,5,13527,4.338357921744708,20.0,0.0
23118,2,3118,[302 427 180 197 603],383,5,13532,4.338570054504649,20.0,0.0
23119,2,3119,[302 427 180 197 603],383,5,13537,4.338782051282052,20.0,0.0
23120,2,3120,[235 111 318 237 143],92,1,13538,4.337712271707786,20.0,0.0
23121,2,3121,[276  89 234 508 546],455,3,13541,4.3372837924407435,0.0,0.0
23122,2,3122,[302 427 180 197 603],383,5,13546,4.337495997438361,20.0,0.0
23123,2,3123,[172 195 197 655 135],378,2,13548,4.336747759282971,0.0,0.0
23124,2,3124,[302 427 180 197 603],383,5,13553,4.33696,20.0,0.0
23125,2,3125,[204 195 385 179 181],7,4,13557,4.336852207293666,0.0,0.0
23126,2,3126,[ 12 276 237  70  88],690,3,13560,4.3364246881995525,20.0,0.0
23127,2,3127,[302 427 180 197 603],271,5,13565,4.336636828644501,20.0,0.0
23128,2,3128,[302 427 180 197 603],13,5,13570,4.3368488334931286,20.0,0.0
23129,2,3129,[302 427 180 197 603],271,5,13575,4.3370607028754,20.0,0.0
23130,2,3130,[302 427 180 197 603],90,5,13580,4.337272436921111,20.0,0.0
23131,2,3131,[302 427 180 197 603],666,5,13585,4.337484035759898,20.0,0.0
23132,2,3132,[302 427 180 197 603],339,5,13590,4.337695499521225,20.0,0.0
23133,2,3133,[302 427 180 197 603],664,5,13595,4.337906828334397,20.0,0.0
23134,2,3134,[302 427 180 197 603],537,5,13600,4.3381180223285485,20.0,0.0
23135,2,3135,[302 427 180 197 603],537,5,13605,4.338329081632653,20.0,0.0
23136,2,3136,[216 100 313 197 191],59,5,13610,4.338540006375518,0.0,20.0
23137,2,3137,[302 427 180 197 603],13,5,13615,4.338750796685787,20.0,0.0
23138,2,3138,[  8 144 161  96 237],207,2,13617,4.33800573431029,0.0,0.0
23139,2,3139,[302 427 180 197 603],664,5,13622,4.338216560509554,20.0,0.0
23140,2,3140,[357 546 427 191 121],650,3,13625,4.337790512575613,20.0,0.0
23141,2,3141,[302 427 180 197 603],271,5,13630,4.338001273074475,20.0,0.0
23142,2,3142,[302 427 180 197 603],339,5,13635,4.3382118994591155,20.0,0.0
23143,2,3143,[302 427 180 197 603],271,5,13640,4.338422391857506,20.0,0.0
23144,2,3144,[ 82 196 132 237 357],7,4,13644,4.338314785373609,20.0,0.0
23145,2,3145,[302 427 180 197 603],474,5,13649,4.338525111252384,20.0,0.0
23146,2,3146,[302 427 180 197 603],666,5,13654,4.338735303463616,20.0,0.0
23147,2,3147,[194 265 182 603 496],313,5,13659,4.338945362134688,20.0,0.0
23148,2,3148,[302 427 180 197 603],383,5,13664,4.339155287392823,20.0,0.0
23149,2,3149,[302 427 180 197 603],537,5,13669,4.33936507936508,20.0,0.0
23150,2,3150,[302 427 180 197 603],474,5,13674,4.3395747381783565,20.0,0.0
23151,2,3151,[302 427 180 197 603],537,5,13679,4.339784263959391,20.0,0.0
23152,2,3152,[202 191 515 288 132],892,5,13684,4.339993656834761,0.0,0.0
23153,2,3153,[186 228 118 568 588],194,2,13686,4.339251743817375,0.0,0.0
23154,2,3154,[302 427 180 197 603],664,5,13691,4.33946117274168,20.0,0.0
23155,2,3155,[273 322 228 385 318],328,1,13692,4.338403041825095,20.0,0.0
23156,2,3156,[302 427 180 197 603],383,5,13697,4.33861260690529,20.0,0.0
23157,2,3157,[302 427 180 197 603],666,5,13702,4.338822039265358,20.0,0.0
23158,2,3158,[289 496 748  15 202],454,2,13704,4.338081671415004,0.0,0.0
23159,2,3159,[322 222 286 276 258],537,2,13706,4.337341772151898,0.0,0.0
23160,2,3160,[496 187  50 127 182],7,5,13711,4.337551407782347,0.0,40.0
23161,2,3161,[302 427 180 197 603],339,5,13716,4.337760910815939,20.0,0.0
23162,2,3162,[302 427 180 197 603],537,5,13721,4.337970281378438,20.0,0.0
23163,2,3163,[294 196 172   1 222],13,2,13723,4.337231352718079,0.0,0.0
23164,2,3164,[302 427 180 197 603],666,5,13728,4.337440758293839,20.0,0.0
23165,2,3165,[302 427 180 197 603],90,5,13733,4.337650031585597,20.0,0.0
23166,2,3166,[302 427 180 197 603],537,5,13738,4.3378591727186615,20.0,0.0
23167,2,3167,[302 427 180 197 603],90,5,13743,4.338068181818182,20.0,0.0
23168,2,3168,[302 427 180 197 603],90,5,13748,4.338277059009151,20.0,0.0
23169,2,3169,[302 427 180 197 603],664,5,13753,4.338485804416404,20.0,0.0
23170,2,3170,[265 288 268 655  56],13,4,13757,4.338379060233365,0.0,0.0
23171,2,3171,[302 427 180 197 603],664,5,13762,4.33858764186633,20.0,0.0
23172,2,3172,[211 568 210  98  69],290,3,13765,4.338165773715726,0.0,20.0
23173,2,3173,[175 185  64 210 271],379,4,13769,4.338059231253938,0.0,0.0
23174,2,3174,[475 121 258 289 153],334,3,13772,4.33763779527559,0.0,0.0
23175,2,3175,[187  71 176 588  95],892,4,13776,4.337531486146096,0.0,0.0
23176,2,3176,[153 269 258 204 173],738,4,13780,4.3374252439408245,0.0,0.0
23177,2,3177,[302 427 180 197 603],90,5,13785,4.33763373190686,20.0,0.0
23178,2,3178,[ 96  98 179 195 173],899,3,13788,4.33721296005033,0.0,20.0
23179,2,3179,[302 427 180 197 603],90,5,13793,4.337421383647799,20.0,0.0
23180,2,3180,[191 257   7  69 222],738,4,13797,4.3373153096510535,0.0,0.0
23181,2,3181,[302 427 180 197 603],339,5,13802,4.33752357008171,20.0,0.0
23182,2,3182,[302 427 180 197 603],90,5,13807,4.337731699654414,20.0,0.0
23183,2,3183,[302 427 180 197 603],537,5,13812,4.3379396984924625,20.0,0.0
23184,2,3184,[302 427 180 197 603],537,5,13817,4.3381475667189955,20.0,0.0
23185,2,3185,[302 427 180 197 603],339,5,13822,4.338355304456999,20.0,0.0
23186,2,3186,[186 191 151 183  98],804,4,13826,4.338249137119548,0.0,20.0
23187,2,3187,[ 82 168 195 496 222],311,5,13831,4.338456712672522,0.0,0.0
23188,2,3188,[ 22 323 125 301 678],455,1,13832,4.337409846346818,0.0,0.0
23189,2,3189,[302 427 180 197 603],664,5,13837,4.337617554858934,20.0,0.0
23190,2,3190,[302 427 180 197 603],537,5,13842,4.3378251331870885,20.0,0.0
23191,2,3191,[302 427 180 197 603],537,5,13847,4.338032581453634,20.0,0.0
23192,2,3192,[302 427 180 197 603],664,5,13852,4.3382398997807705,20.0,0.0
23193,2,3193,[302 427 180 197 603],13,5,13857,4.338447088290545,20.0,0.0
23194,2,3194,[302 427 180 197 603],13,5,13862,4.338654147104851,20.0,0.0
23195,2,3195,[ 96 191 588 151  71],313,4,13866,4.33854818523154,0.0,0.0
23196,2,3196,[302 427 180 197 603],474,5,13871,4.338755082890209,20.0,0.0
23197,2,3197,[161 186 127  11 216],234,1,13872,4.337711069418386,0.0,20.0
23198,2,3198,[302 427 180 197 603],90,5,13877,4.337918099406064,20.0,0.0
23199,2,3199,[302 427 180 197 603],664,5,13882,4.338125,20.0,0.0
23200,2,3200,[302 427 180 197 603],383,5,13887,4.338331771321462,20.0,0.0
23201,2,3201,[168 597   4 318 143],13,2,13889,4.337601499063085,20.0,0.0
23202,2,3202,[302 427 180 197 603],339,5,13894,4.33780830471433,20.0,0.0
23203,2,3203,[302 427 180 197 603],474,5,13899,4.338014981273409,20.0,0.0
23204,2,3204,[173 185  69 151 265],882,5,13904,4.338221528861155,0.0,0.0
23205,2,3205,[302 427 180 197 603],474,5,13909,4.3384279475982535,20.0,0.0
23206,2,3206,[175 161 143  82 471],653,2,13911,4.337698783910197,0.0,0.0
23207,2,3207,[ 70 235  15  88 211],210,4,13915,4.337593516209476,0.0,0.0
23208,2,3208,[195 151  56 234  89],406,4,13919,4.3374883141165474,0.0,0.0
23209,2,3209,[143 515 168 194   4],537,2,13921,4.336760124610592,0.0,0.0
23210,2,3210,[302 427 180 197 603],271,5,13926,4.3369666770476485,20.0,0.0
23211,2,3211,[483 588 357 271 385],479,2,13928,4.336239103362391,40.0,0.0
23212,2,3212,[302 427 180 197 603],90,5,13933,4.336445689386866,20.0,0.0
23213,2,3213,[427   9  96 191 202],13,3,13936,4.336029869321718,0.0,0.0
23214,2,3214,[302 427 180 197 603],537,5,13941,4.336236391912908,20.0,0.0
23215,2,3215,[302 427 180 197 603],537,5,13946,4.336442786069652,20.0,0.0
23216,2,3216,[302 427 180 197 603],271,5,13951,4.336649051911719,20.0,0.0
23217,2,3217,[302 427 180 197 603],271,5,13956,4.336855189558732,20.0,0.0
23218,2,3218,[302 427 180 197 603],339,5,13961,4.337061199130165,20.0,0.0
23219,2,3219,[143 276  82 568 176],385,0,13961,4.335714285714285,0.0,0.0
23220,2,3220,[546   9 286  28 143],13,1,13962,4.334678671220118,0.0,0.0
23221,2,3221,[ 64 508  71 273 234],524,2,13964,4.333954065797641,0.0,0.0
23222,2,3222,[ 98  82  70 405 182],881,3,13967,4.333540179956562,0.0,20.0
23223,2,3223,[258 186 475 153 173],387,3,13970,4.333126550868486,0.0,0.0
23224,2,3224,[197 496 186 151 121],334,2,13972,4.332403100775194,0.0,0.0
23225,2,3225,[302 427 180 197 603],13,5,13977,4.332610043397396,20.0,0.0
23226,2,3226,[302 427 180 197 603],90,5,13982,4.332816857762628,20.0,0.0
23227,2,3227,[546 318 172 185 655],328,4,13986,4.33271375464684,20.0,0.0
23228,2,3228,[302 427 180 197 603],271,5,13991,4.332920408795292,20.0,0.0
23229,2,3229,[302 427 180 197 603],537,5,13996,4.33312693498452,20.0,0.0
23230,2,3230,[302 427 180 197 603],383,5,14001,4.333333333333333,20.0,0.0
23231,2,3231,[302 427 180 197 603],271,5,14006,4.333539603960396,20.0,0.0
23232,2,3232,[ 95 483 191 202 385],650,3,14009,4.333127126507887,20.0,0.0
23233,2,3233,[302 427 180 197 603],271,5,14014,4.333333333333333,20.0,0.0
23234,2,3234,[302 427 180 197 603],664,5,14019,4.333539412673879,20.0,0.0
23235,2,3235,[302 427 180 197 603],339,5,14024,4.333745364647713,20.0,0.0
23236,2,3236,[265 194 175  25  22],378,5,14029,4.333951189372876,0.0,0.0
23237,2,3237,[302 427 180 197 603],271,5,14034,4.334156886967263,20.0,0.0
23238,2,3238,[302 427 180 197 603],339,5,14039,4.334362457548626,20.0,0.0
23239,2,3239,[174 294 200 258 180],447,4,14043,4.33425925925926,0.0,20.0
23240,2,3240,[423 135  15  25 179],452,3,14046,4.333847577908053,0.0,0.0
23241,2,3241,[302 427 180 197 603],339,5,14051,4.334053053670574,20.0,0.0
23242,2,3242,[302 427 180 197 603],666,5,14056,4.3342584027135365,20.0,0.0
23243,2,3243,[568 175  96 111  88],13,4,14060,4.334155363748459,0.0,0.0
23244,2,3244,[125 238 294 742 300],653,1,14061,4.333127889060092,0.0,0.0
23245,2,3245,[302 427 180 197 603],339,5,14066,4.333333333333333,20.0,0.0
23246,2,3246,[302 427 180 197 603],474,5,14071,4.333538651062519,20.0,0.0
23247,2,3247,[302 427 180 197 603],664,5,14076,4.333743842364532,20.0,0.0
23248,2,3248,[302 427 180 197 603],90,5,14081,4.33394890735611,20.0,0.0
23249,2,3249,[ 69 143 245 183  15],653,2,14083,4.333230769230769,0.0,0.0
23250,2,3250,[ 88 568   4 313   9],533,4,14087,4.3331282682251615,0.0,0.0
23251,2,3251,[202 568 265 294 282],194,2,14089,4.3324108241082415,0.0,0.0
23252,2,3252,[423 127 427 515  96],458,4,14093,4.332308638180141,0.0,20.0
23253,2,3253,[302 427 180 197 603],664,5,14098,4.332513829133374,20.0,0.0
23254,2,3254,[204   9 111   1 333],533,5,14103,4.332718894009217,0.0,0.0
23255,2,3255,[286 496 183 200 186],379,5,14108,4.332923832923833,0.0,0.0
23256,2,3256,[302 427 180 197 603],339,5,14113,4.333128645993245,20.0,0.0
23257,2,3257,[302 427 180 197 603],339,5,14118,4.333333333333333,20.0,0.0
23258,2,3258,[ 89  64 185  70 228],311,4,14122,4.333231052470083,0.0,0.0
23259,2,3259,[276 197 118 187 186],298,4,14126,4.333128834355828,0.0,0.0
23260,2,3260,[302 427 180 197 603],474,5,14131,4.333333333333333,20.0,0.0
23261,2,3261,[302 427 180 197 603],339,5,14136,4.333537706928265,20.0,0.0
23262,2,3262,[302 427 180 197 603],666,5,14141,4.333741955255899,20.0,0.0
23263,2,3263,[302 427 180 197 603],339,5,14146,4.333946078431373,20.0,0.0
23264,2,3264,[302 427 180 197 603],664,5,14151,4.334150076569679,20.0,0.0
23265,2,3265,[302 427 180 197 603],383,5,14156,4.334353949785671,20.0,0.0
23266,2,3266,[302 427 180 197 603],339,5,14161,4.334557698194062,20.0,0.0
23267,2,3267,[302 427 180 197 603],383,5,14166,4.334761321909425,20.0,0.0
23268,2,3268,[302 427 180 197 603],666,5,14171,4.334964821046191,20.0,0.0
23269,2,3269,[302 427 180 197 603],271,5,14176,4.335168195718654,20.0,0.0
23270,2,3270,[211 181 186 195 508],385,0,14176,4.333842861510242,0.0,0.0
23271,2,3271,[302 427 180 197 603],271,5,14181,4.334046454767726,20.0,0.0
23272,2,3272,[ 22 405 117 318 234],538,2,14183,4.333333333333333,20.0,0.0
23273,2,3273,[302 427 180 197 603],271,5,14188,4.333536957849725,20.0,0.0
23274,2,3274,[294 568 127  50 197],213,4,14192,4.333435114503817,0.0,40.0
23275,2,3275,[302 427 180 197 603],339,5,14197,4.333638583638583,20.0,0.0
23276,2,3276,[302 427 180 197 603],13,5,14202,4.333841928593226,20.0,0.0
23277,2,3277,[302 427 180 197 603],90,5,14207,4.334045149481391,20.0,0.0
23278,2,3278,[302 427 180 197 603],339,5,14212,4.334248246416591,20.0,0.0
23279,2,3279,[302 427 180 197 603],666,5,14217,4.334451219512195,20.0,0.0
23280,2,3280,[302 427 180 197 603],666,5,14222,4.334654068881439,20.0,0.0
23281,2,3281,[318 135 588 153 302],144,4,14226,4.3345521023766,20.0,0.0
23282,2,3282,[302 427 180 197 603],90,5,14231,4.334754797441365,20.0,0.0
23283,2,3283,[302 427 180 197 603],13,5,14236,4.33495736906212,20.0,0.0
23284,2,3284,[302 427 180 197 603],666,5,14241,4.335159817351598,20.0,0.0
23285,2,3285,[151 515 204 655  97],213,5,14246,4.335362142422398,0.0,0.0
23286,2,3286,[ 56 318 323 276 748],883,5,14251,4.335564344386979,20.0,0.0
23287,2,3287,[302 427 180 197 603],13,5,14256,4.335766423357664,20.0,0.0
23288,2,3288,[302 427 180 197 603],383,5,14261,4.335968379446641,20.0,0.0
23289,2,3289,[403 210 238 496 161],387,2,14263,4.335258358662614,0.0,0.0
23290,2,3290,[289 322 117 282 257],533,4,14267,4.335156487389851,0.0,0.0
23291,2,3291,[302 427 180 197 603],90,5,14272,4.335358444714459,20.0,0.0
23292,2,3292,[302 427 180 197 603],537,5,14277,4.335560279380504,20.0,0.0
23293,2,3293,[302 427 180 197 603],664,5,14282,4.335761991499696,20.0,0.0
23294,2,3294,[471 245 282  64   9],328,3,14285,4.335356600910471,0.0,0.0
23295,2,3295,[302 427 180 197 603],339,5,14290,4.335558252427185,20.0,0.0
23296,2,3296,[323 294 191 176 237],537,1,14291,4.334546557476494,0.0,0.0
23297,2,3297,[302 427 180 197 603],90,5,14296,4.3347483323226195,20.0,0.0
23298,2,3298,[238 210 100 175 288],279,4,14300,4.334646862685663,0.0,20.0
23299,2,3299,[302 427 180 197 603],664,5,14305,4.334848484848485,20.0,0.0
23300,2,3300,[302 427 180 197 603],666,5,14310,4.335049984853075,20.0,0.0
23301,2,3301,[ 15 183 143 568 191],313,3,14313,4.334645669291339,0.0,0.0
23302,2,3302,[143 269 423   9 174],85,4,14317,4.334544353617923,0.0,20.0
23303,2,3303,[302 427 180 197 603],666,5,14322,4.334745762711864,20.0,0.0
23304,2,3304,[302 427 180 197 603],339,5,14327,4.334947049924357,20.0,0.0
23305,2,3305,[302 427 180 197 603],90,5,14332,4.335148215366001,20.0,0.0
23306,2,3306,[588 483 191 405  71],7,4,14336,4.335046870275174,20.0,0.0
23307,2,3307,[302 427 180 197 603],474,5,14341,4.335247883917775,20.0,0.0
23308,2,3308,[144  11 151 194 176],387,0,14341,4.33393774554246,0.0,0.0
23309,2,3309,[302 427 180 197 603],339,5,14346,4.334138972809668,20.0,0.0
23310,2,3310,[172 423  98  97 194],95,5,14351,4.334340078526125,0.0,20.0
23311,2,3311,[302 427 180 197 603],13,5,14356,4.334541062801932,20.0,0.0
23312,2,3312,[  4 204 210 742 211],804,5,14361,4.334741925747057,0.0,0.0
23313,2,3313,[302 427 180 197 603],383,5,14366,4.334942667471334,20.0,0.0
23314,2,3314,[174 234  98 405 748],447,3,14369,4.334539969834087,0.0,40.0
23315,2,3315,[403 135 742 117 435],650,3,14372,4.334137515078408,0.0,0.0
23316,2,3316,[100 180 200 132 288],488,0,14372,4.332830871269219,0.0,20.0
23317,2,3317,[302 427 180 197 603],13,5,14377,4.333031946955997,20.0,0.0
23318,2,3318,[302 427 180 197 603],666,5,14382,4.333232901476348,20.0,0.0
23319,2,3319,[302 427 180 197 603],271,5,14387,4.333433734939759,20.0,0.0
23320,2,3320,[302 427 180 197 603],90,5,14392,4.3336344474555855,20.0,0.0
23321,2,3321,[302 427 180 197 603],13,5,14397,4.333835039133052,20.0,0.0
23322,2,3322,[302 427 180 197 603],90,5,14402,4.334035510081252,20.0,0.0
23323,2,3323,[302 427 180 197 603],383,5,14407,4.334235860409145,20.0,0.0
23324,2,3324,[302 427 180 197 603],13,5,14412,4.334436090225564,20.0,0.0
23325,2,3325,[182 135 258 568 403],378,4,14416,4.334335538184005,0.0,0.0
23326,2,3326,[302 427 180 197 603],90,5,14421,4.33453561767358,20.0,0.0
23327,2,3327,[302 427 180 197 603],90,5,14426,4.334735576923077,20.0,0.0
23328,2,3328,[302 427 180 197 603],664,5,14431,4.334935416040853,20.0,0.0
23329,2,3329,[302 427 180 197 603],537,5,14436,4.335135135135135,20.0,0.0
23330,2,3330,[302 427 180 197 603],383,5,14441,4.33533473431402,20.0,0.0
23331,2,3331,[302 427 180 197 603],13,5,14446,4.335534213685474,20.0,0.0
23332,2,3332,[258  88 195 323  25],474,4,14450,4.335433543354336,0.0,0.0
23333,2,3333,[302 427 180 197 603],383,5,14455,4.335632873425315,20.0,0.0
23334,2,3334,[302 427 180 197 603],537,5,14460,4.335832083958021,20.0,0.0
23335,2,3335,[302 427 180 197 603],13,5,14465,4.336031175059952,20.0,0.0
23336,2,3336,[302 427 180 197 603],13,5,14470,4.336230146838478,20.0,0.0
23337,2,3337,[302 427 180 197 603],90,5,14475,4.336428999400839,20.0,0.0
23338,2,3338,[302 427 180 197 603],664,5,14480,4.336627732854148,20.0,0.0
23339,2,3339,[302 427 180 197 603],271,5,14485,4.336826347305389,20.0,0.0
23340,2,3340,[302 427 180 197 603],339,5,14490,4.337024842861418,20.0,0.0
23341,2,3341,[302 427 180 197 603],474,5,14495,4.337223219628965,20.0,0.0
23342,2,3342,[222 211  25 161 151],843,0,14495,4.335925815136105,0.0,0.0
23343,2,3343,[202  12 475  11 210],308,5,14500,4.336124401913875,20.0,0.0
23344,2,3344,[172 234 215 195 222],454,2,14502,4.33542600896861,0.0,0.0
23345,2,3345,[302 427 180 197 603],271,5,14507,4.335624626419605,20.0,0.0
23346,2,3346,[302 427 180 197 603],664,5,14512,4.335823125186734,20.0,0.0
23347,2,3347,[302 427 180 197 603],666,5,14517,4.336021505376344,20.0,0.0
23348,2,3348,[  8 215   9 435 144],60,4,14521,4.335921170498656,0.0,0.0
23349,2,3349,[328 117 118 191 294],13,1,14522,4.334925373134328,0.0,0.0
23350,2,3350,[302 427 180 197 603],537,5,14527,4.335123843628767,20.0,0.0
23351,2,3351,[302 427 180 197 603],664,5,14532,4.335322195704057,20.0,0.0
23352,2,3352,[302 427 180 197 603],13,5,14537,4.33552042946615,20.0,0.0
23353,2,3353,[302 427 180 197 603],90,5,14542,4.33571854502087,20.0,0.0
23354,2,3354,[176 173  12 258 182],64,4,14546,4.335618479880775,20.0,0.0
23355,2,3355,[302 427 180 197 603],339,5,14551,4.3358164481525625,20.0,0.0
23356,2,3356,[302 427 180 197 603],474,5,14556,4.336014298480786,20.0,0.0
23357,2,3357,[302 427 180 197 603],666,5,14561,4.336212030970816,20.0,0.0
23358,2,3358,[302 427 180 197 603],666,5,14566,4.336409645727895,20.0,0.0
23359,2,3359,[302 427 180 197 603],90,5,14571,4.336607142857143,20.0,0.0
23360,2,3360,[302 427 180 197 603],537,5,14576,4.336804522463552,20.0,0.0
23361,2,3361,[191  69 323  71 100],311,3,14579,4.336406900654373,0.0,20.0
23362,2,3362,[302 427 180 197 603],383,5,14584,4.3366042224204575,20.0,0.0
23363,2,3363,[302 427 180 197 603],383,5,14589,4.33680142687277,20.0,0.0
23364,2,3364,[135 273 151 211 257],308,4,14593,4.336701337295691,0.0,0.0
23365,2,3365,[302 427 180 197 603],383,5,14598,4.336898395721925,20.0,0.0
23366,2,3366,[238 294 300  11 211],488,3,14601,4.336501336501336,0.0,0.0
23367,2,3367,[302 427 180 197 603],90,5,14606,4.3366983372921615,20.0,0.0
23368,2,3368,[132 238 216 471  97],653,0,14606,4.3354111012169785,0.0,0.0
23369,2,3369,[302 427 180 197 603],339,5,14611,4.335608308605341,20.0,0.0
23370,2,3370,[197 483 603 174  96],313,5,14616,4.335805398991397,40.0,20.0
23371,2,3371,[302 427 180 197 603],664,5,14621,4.336002372479241,20.0,0.0
23372,2,3372,[302 427 180 197 603],90,5,14626,4.336199229172843,20.0,0.0
23373,2,3373,[597   8 237   4 185],328,2,14628,4.335506816834617,0.0,0.0
23374,2,3374,[172 405 117 496 151],815,4,14632,4.335407407407407,0.0,0.0
23375,2,3375,[302 427 180 197 603],383,5,14637,4.335604265402844,20.0,0.0
23376,2,3376,[302 427 180 197 603],537,5,14642,4.335801006810779,20.0,0.0
23377,2,3377,[302 427 180 197 603],664,5,14647,4.335997631734754,20.0,0.0
23378,2,3378,[588  22 678 405 276],537,1,14648,4.33501035809411,0.0,0.0
23379,2,3379,[302 427 180 197 603],339,5,14653,4.335207100591716,20.0,0.0
23380,2,3380,[302 427 180 197 603],537,5,14658,4.3354037267080745,20.0,0.0
23381,2,3381,[302 427 180 197 603],666,5,14663,4.335600236546422,20.0,0.0
23382,2,3382,[302 427 180 197 603],339,5,14668,4.335796630209873,20.0,0.0
23383,2,3383,[135 655 515  98 180],840,5,14673,4.335992907801418,0.0,20.0
23384,2,3384,[181 423 151 186  79],234,1,14674,4.3350073855243725,0.0,0.0
23385,2,3385,[302 427 180 197 603],666,5,14679,4.335203780271707,20.0,0.0
23386,2,3386,[302 427 180 197 603],271,5,14684,4.335400059049306,20.0,0.0
23387,2,3387,[ 95 194   4 288 276],378,3,14687,4.335005903187722,0.0,0.0
23388,2,3388,[127 273 655 216  96],308,3,14690,4.334611979935084,0.0,20.0
23389,2,3389,[302 427 180 197 603],383,5,14695,4.334808259587021,20.0,0.0
23390,2,3390,[ 56  64 196   1 215],387,2,14697,4.334119728693601,0.0,0.0
23391,2,3391,[ 56  28  70 121 185],311,4,14701,4.334021226415095,0.0,0.0
23392,2,3392,[196 176 191 302   4],271,4,14705,4.333922782198644,0.0,0.0
23393,2,3393,[216 187 135  97 183],506,5,14710,4.334119033588686,0.0,0.0
23394,2,3394,[597   8 180 125  11],7,3,14713,4.333726067746686,0.0,0.0
23395,2,3395,[302 427 180 197 603],666,5,14718,4.333922261484099,20.0,0.0
23396,2,3396,[ 95  79  88 423  69],749,4,14722,4.333823962319694,0.0,0.0
23397,2,3397,[302 427 180 197 603],271,5,14727,4.3340200117716305,20.0,0.0
23398,2,3398,[302 427 180 197 603],271,5,14732,4.334215945866431,20.0,0.0
23399,2,3399,[302 427 180 197 603],664,5,14737,4.334411764705882,20.0,0.0
23400,2,3400,[302 427 180 197 603],13,5,14742,4.334607468391649,20.0,0.0
23401,2,3401,[302 427 180 197 603],666,5,14747,4.33480305702528,20.0,0.0
23402,2,3402,[200 568 216 228 235],339,2,14749,4.334116955627388,0.0,0.0
23403,2,3403,[302 427 180 197 603],664,5,14754,4.334312573443008,20.0,0.0
23404,2,3404,[185 194 211  12 237],6,4,14758,4.334214390602056,20.0,0.0
23405,2,3405,[302 427 180 197 603],474,5,14763,4.334409864944216,20.0,0.0
23406,2,3406,[302 427 180 197 603],666,5,14768,4.334605224537716,20.0,0.0
23407,2,3407,[302 427 180 197 603],664,5,14773,4.334800469483568,20.0,0.0
23408,2,3408,[302 427 180 197 603],383,5,14778,4.334995599882664,20.0,0.0
23409,2,3409,[202 183 151 228 121],653,2,14780,4.334310850439882,0.0,0.0
23410,2,3410,[211 187 289 238 172],85,3,14783,4.333919671650542,0.0,0.0
23411,2,3411,[302 427 180 197 603],383,5,14788,4.3341148886283705,20.0,0.0
23412,2,3412,[302 427 180 197 603],13,5,14793,4.3343099912100795,20.0,0.0
23413,2,3413,[302 427 180 197 603],537,5,14798,4.3345049794961925,20.0,0.0
23414,2,3414,[302 427 180 197 603],271,5,14803,4.334699853587115,20.0,0.0
23415,2,3415,[185 216 174   4 403],194,3,14806,4.3343091334894615,0.0,20.0
23416,2,3416,[302 427 180 197 603],664,5,14811,4.334503950834065,20.0,0.0
23417,2,3417,[302 427 180 197 603],339,5,14816,4.334698654183733,20.0,0.0
23418,2,3418,[302 427 180 197 603],664,5,14821,4.334893243638491,20.0,0.0
23419,2,3419,[ 25 180 132 202 144],666,3,14824,4.334502923976608,0.0,0.0
23420,2,3420,[302 427 180 197 603],339,5,14829,4.334697456883952,20.0,0.0
23421,2,3421,[302 427 180 197 603],474,5,14834,4.334891876095851,20.0,0.0
23422,2,3422,[197 202 143  96 151],90,3,14837,4.3345018989190764,0.0,0.0
23423,2,3423,[ 28 118 204 235 257],479,3,14840,4.33411214953271,0.0,0.0
23424,2,3424,[301 286  70 153 471],6,1,14841,4.333138686131387,0.0,0.0
23425,2,3425,[302 427 180 197 603],383,5,14846,4.333333333333333,20.0,0.0
23426,2,3426,[301 302 276 127 471],13,3,14849,4.332944266121973,0.0,20.0
23427,2,3427,[302 427 180 197 603],339,5,14854,4.333138856476079,20.0,0.0
23428,2,3428,[286 471 273  25 269],486,3,14857,4.332750072907554,0.0,0.0
23429,2,3429,[302 427 180 197 603],664,5,14862,4.332944606413994,20.0,0.0
23430,2,3430,[302 427 180 197 603],271,5,14867,4.33313902652288,20.0,0.0
23431,2,3431,[302 427 180 197 603],383,5,14872,4.333333333333333,20.0,0.0
23432,2,3432,[302 427 180 197 603],664,5,14877,4.333527526944364,20.0,0.0
23433,2,3433,[302 427 180 197 603],90,5,14882,4.333721607454863,20.0,0.0
23434,2,3434,[179 200  64 153 238],95,3,14885,4.333333333333333,0.0,0.0
23435,2,3435,[215 191 423 222 302],454,4,14889,4.333236321303842,0.0,0.0
23436,2,3436,[302 427 180 197 603],664,5,14894,4.333430317137038,20.0,0.0
23437,2,3437,[403 185  11 210 168],13,1,14895,4.332460732984293,0.0,0.0
23438,2,3438,[ 28  25 568   4 168],374,3,14898,4.33207327711544,0.0,0.0
23439,2,3439,[302 427 180 197 603],339,5,14903,4.332267441860465,20.0,0.0
23440,2,3440,[ 11 289 215 245 182],90,1,14904,4.33129904097646,0.0,0.0
23441,2,3441,[302 427 180 197 603],664,5,14909,4.331493317838466,20.0,0.0
23442,2,3442,[302 427 180 197 603],474,5,14914,4.331687481847227,20.0,0.0
23443,2,3443,[302 427 180 197 603],339,5,14919,4.331881533101045,20.0,0.0
23444,2,3444,[302 427 180 197 603],537,5,14924,4.332075471698113,20.0,0.0
23445,2,3445,[302 427 180 197 603],474,5,14929,4.332269297736506,20.0,0.0
23446,2,3446,[302 427 180 197 603],271,5,14934,4.332463011314187,20.0,0.0
23447,2,3447,[100 215  11 196  64],378,4,14938,4.332366589327147,0.0,20.0
23448,2,3448,[302 427 180 197 603],664,5,14943,4.332560162365903,20.0,0.0
23449,2,3449,[302 427 180 197 603],339,5,14948,4.332753623188406,20.0,0.0
23450,2,3450,[173 161  96 194 185],648,4,14952,4.332657200811359,0.0,0.0
23451,2,3451,[302 427 180 197 603],664,5,14957,4.332850521436848,20.0,0.0
23452,2,3452,[187 202 546   4 318],13,3,14960,4.332464523602664,20.0,0.0
23453,2,3453,[302 427 180 197 603],474,5,14965,4.332657788071801,20.0,0.0
23454,2,3454,[ 98  97 174 100 215],881,3,14968,4.332272069464544,0.0,60.0
23455,2,3455,[302 427 180 197 603],664,5,14973,4.332465277777778,20.0,0.0
23456,2,3456,[302 427 180 197 603],666,5,14978,4.332658374312988,20.0,0.0
23457,2,3457,[302 427 180 197 603],664,5,14983,4.332851359167148,20.0,0.0
23458,2,3458,[302 427 180 197 603],383,5,14988,4.33304423243712,20.0,0.0
23459,2,3459,[302 427 180 197 603],339,5,14993,4.333236994219654,20.0,0.0
23460,2,3460,[121   7 125 185 238],64,3,14996,4.33285177694308,0.0,0.0
23461,2,3461,[302 427 180 197 603],90,5,15001,4.333044482957828,20.0,0.0
23462,2,3462,[302 427 180 197 603],537,5,15006,4.333237077678314,20.0,0.0
23463,2,3463,[302 427 180 197 603],666,5,15011,4.333429561200924,20.0,0.0
23464,2,3464,[222   7  25  96 318],648,2,15013,4.332756132756133,20.0,0.0
23465,2,3465,[216 132  89 289  98],95,2,15015,4.332083092902481,0.0,20.0
23466,2,3466,[302 427 180 197 603],13,5,15020,4.332275742717046,20.0,0.0
23467,2,3467,[302 427 180 197 603],537,5,15025,4.332468281430219,20.0,0.0
23468,2,3468,[161 597 269 403  15],378,4,15029,4.332372441625829,0.0,0.0
23469,2,3469,[483 168 245 117 546],533,3,15032,4.331988472622478,20.0,0.0
23470,2,3470,[302 427 180 197 603],339,5,15037,4.3321809276865455,20.0,0.0
23471,2,3471,[ 96 333  64  56 403],64,4,15041,4.3320852534562215,0.0,0.0
23472,2,3472,[655  56  15 265 117],311,5,15046,4.33227756982436,0.0,0.0
23473,2,3473,[302 427 180 197 603],537,5,15051,4.332469775474957,20.0,0.0
23474,2,3474,[302 427 180 197 603],664,5,15056,4.332661870503597,20.0,0.0
23475,2,3475,[302 427 180 197 603],339,5,15061,4.332853855005753,20.0,0.0
23476,2,3476,[302 427 180 197 603],13,5,15066,4.33304572907679,20.0,0.0
23477,2,3477,[302 427 180 197 603],90,5,15071,4.333237492811961,20.0,0.0
23478,2,3478,[265  88 195  97 176],234,0,15071,4.331991951710261,0.0,0.0
23479,2,3479,[302 427 180 197 603],383,5,15076,4.332183908045977,20.0,0.0
23480,2,3480,[302 427 180 197 603],339,5,15081,4.332375754093651,20.0,0.0
23481,2,3481,[302 427 180 197 603],271,5,15086,4.332567489948306,20.0,0.0
23482,2,3482,[121 135 168 143 222],42,4,15090,4.332472006890612,0.0,0.0
23483,2,3483,[568 508 111  82 185],207,3,15093,4.332089552238806,0.0,0.0
23484,2,3484,[302 427 180 197 603],271,5,15098,4.332281205164993,20.0,0.0
23485,2,3485,[302 427 180 197 603],271,5,15103,4.332472748135399,20.0,0.0
23486,2,3486,[302 427 180 197 603],339,5,15108,4.332664181244623,20.0,0.0
23487,2,3487,[294  25 168 286 235],537,1,15109,4.3317087155963305,0.0,0.0
23488,2,3488,[423  50 237 475 385],455,3,15112,4.331327027801662,0.0,20.0
23489,2,3489,[ 98 186   4 423 289],537,1,15113,4.330372492836676,0.0,20.0
23490,2,3490,[302 427 180 197 603],666,5,15118,4.33056430822114,20.0,0.0
23491,2,3491,[215 228 172 357 127],328,3,15121,4.330183276059564,20.0,20.0
23492,2,3492,[302 427 180 197 603],383,5,15126,4.330375035785857,20.0,0.0
23493,2,3493,[302 427 180 197 603],90,5,15131,4.330566685746994,20.0,0.0
23494,2,3494,[121 204 200 216 423],92,2,15133,4.329899856938484,0.0,0.0
23495,2,3495,[ 98 435 181 294   1],533,5,15138,4.330091533180778,0.0,20.0
23496,2,3496,[302 427 180 197 603],90,5,15143,4.3302830997998285,20.0,0.0
23497,2,3497,[302 427 180 197 603],664,5,15148,4.330474556889651,20.0,0.0
23498,2,3498,[302 427 180 197 603],271,5,15153,4.330665904544156,20.0,0.0
23499,2,3499,[302 427 180 197 603],664,5,15158,4.330857142857143,20.0,0.0
23500,2,3500,[153  56  15 151 100],6,3,15161,4.330477006569551,0.0,20.0
23501,2,3501,[302 427 180 197 603],537,5,15166,4.330668189605939,20.0,0.0
23502,2,3502,[302 427 180 197 603],13,5,15171,4.330859263488438,20.0,0.0
23503,2,3503,[302 427 180 197 603],664,5,15176,4.331050228310502,20.0,0.0
23504,2,3504,[302 427 180 197 603],383,5,15181,4.331241084165478,20.0,0.0
23505,2,3505,[  8  79 179 143 275],378,4,15185,4.331146605818597,0.0,0.0
23506,2,3506,[302 427 180 197 603],90,5,15190,4.331337325349302,20.0,0.0
23507,2,3507,[302 427 180 197 603],339,5,15195,4.331527936145952,20.0,0.0
23508,2,3508,[603 588 144 597 546],13,3,15198,4.331148475349102,20.0,0.0
23509,2,3509,[323 175 143  64  95],125,3,15201,4.3307692307692305,0.0,0.0
23510,2,3510,[403   9 427 655 143],7,4,15205,4.330675021361436,0.0,0.0
23511,2,3511,[302 427 180 197 603],664,5,15210,4.330865603644647,20.0,0.0
23512,2,3512,[302 427 180 197 603],537,5,15215,4.331056077426701,20.0,0.0
23513,2,3513,[302 427 180 197 603],339,5,15220,4.331246442800228,20.0,0.0
23514,2,3514,[194  70 174 515 323],474,4,15224,4.331152204836416,0.0,20.0
23515,2,3515,[302 427 180 197 603],13,5,15229,4.331342434584755,20.0,0.0
23516,2,3516,[302 427 180 197 603],537,5,15234,4.331532556155815,20.0,0.0
23517,2,3517,[302 427 180 197 603],664,5,15239,4.331722569641842,20.0,0.0
23518,2,3518,[302 427 180 197 603],339,5,15244,4.331912475134981,20.0,0.0
23519,2,3519,[302 427 180 197 603],474,5,15249,4.332102272727273,20.0,0.0
23520,2,3520,[403  89 121 483 202],194,1,15250,4.331155921613178,20.0,0.0
23521,2,3521,[202 183 216 174 237],883,4,15254,4.331061896649631,0.0,20.0
23522,2,3522,[302 427 180 197 603],339,5,15259,4.331251774056202,20.0,0.0
23523,2,3523,[300 275 111  25 286],119,5,15264,4.331441543700341,0.0,0.0
23524,2,3524,[302 427 180 197 603],474,5,15269,4.331631205673759,20.0,0.0
23525,2,3525,[568 211  79  89  82],379,5,15274,4.331820760068066,0.0,0.0
23526,2,3526,[322  22 475 471  15],474,4,15278,4.331726679897931,0.0,0.0
23527,2,3527,[302 427 180 197 603],664,5,15283,4.331916099773243,20.0,0.0
23528,2,3528,[ 95  69 197 273  98],234,3,15286,4.33153867951261,0.0,20.0
23529,2,3529,[568 515  22  96 161],87,5,15291,4.331728045325779,0.0,0.0
23530,2,3530,[302 427 180 197 603],666,5,15296,4.331917303879921,20.0,0.0
23531,2,3531,[302 427 180 197 603],339,5,15301,4.332106455266138,20.0,0.0
23532,2,3532,[483 275 357  71 282],95,3,15304,4.331729408434758,40.0,0.0
23533,2,3533,[655 294  64 546 175],213,4,15308,4.331635540464063,0.0,0.0
23534,2,3534,[302 427 180 197 603],383,5,15313,4.331824611032532,20.0,0.0
23535,2,3535,[302 427 180 197 603],537,5,15318,4.332013574660634,20.0,0.0
23536,2,3536,[  1 357 257 100 181],650,3,15321,4.331636980491942,20.0,20.0
23537,2,3537,[302 427 180 197 603],339,5,15326,4.331825890333522,20.0,0.0
23538,2,3538,[175 125 276 132 271],92,3,15329,4.33144956202317,0.0,0.0
23539,2,3539,[ 69 181 143 118 258],313,3,15332,4.331073446327683,0.0,0.0
23540,2,3540,[302 427 180 197 603],537,5,15337,4.331262355266873,20.0,0.0
23541,2,3541,[195  97  88 173 181],188,3,15340,4.330886504799548,0.0,0.0
23542,2,3542,[191   1 603 288 385],64,4,15344,4.3307931131809205,20.0,0.0
23543,2,3543,[302 427 180 197 603],537,5,15349,4.330981941309255,20.0,0.0
23544,2,3544,[302 427 180 197 603],537,5,15354,4.3311706629055005,20.0,0.0
23545,2,3545,[302 427 180 197 603],666,5,15359,4.331359278059786,20.0,0.0
23546,2,3546,[302 427 180 197 603],664,5,15364,4.331547786862137,20.0,0.0
23547,2,3547,[ 89 294   4 194 176],474,4,15368,4.331454340473506,0.0,0.0
23548,2,3548,[302 427 180 197 603],383,5,15373,4.331642716258101,20.0,0.0
23549,2,3549,[302 427 180 197 603],537,5,15378,4.331830985915493,20.0,0.0
23550,2,3550,[302 427 180 197 603],90,5,15383,4.332019149535342,20.0,0.0
23551,2,3551,[172   4  98 200 302],210,5,15388,4.332207207207207,0.0,20.0
23552,2,3552,[302 427 180 197 603],271,5,15393,4.332395159020546,20.0,0.0
23553,2,3553,[302 427 180 197 603],537,5,15398,4.332583005064715,20.0,0.0
23554,2,3554,[302 427 180 197 603],383,5,15403,4.332770745428974,20.0,0.0
23555,2,3555,[603 135 204 173 100],749,4,15407,4.332677165354331,20.0,20.0
23556,2,3556,[118 176  71 423 546],533,3,15410,4.332302502108519,0.0,0.0
23557,2,3557,[302 427 180 197 603],90,5,15415,4.332490163012928,20.0,0.0
23558,2,3558,[302 427 180 197 603],271,5,15420,4.332677718460242,20.0,0.0
23559,2,3559,[  4 508 300 546 568],533,3,15423,4.332303370786517,0.0,0.0
23560,2,3560,[196 294 546  71 423],92,2,15425,4.331648413367032,0.0,0.0
23561,2,3561,[ 56 151 742 228 322],374,4,15429,4.331555306007861,0.0,0.0
23562,2,3562,[302 427 180 197 603],339,5,15434,4.331742913275329,20.0,0.0
23563,2,3563,[302 427 180 197 603],13,5,15439,4.331930415263749,20.0,0.0
23564,2,3564,[302 427 180 197 603],666,5,15444,4.332117812061711,20.0,0.0
23565,2,3565,[496 100 172 121 216],194,2,15446,4.331463825014021,0.0,20.0
23566,2,3566,[ 25 176 568  98  50],313,4,15450,4.331370899915895,0.0,40.0
23567,2,3567,[ 11 132 153 588  28],13,4,15454,4.33127802690583,0.0,0.0
23568,2,3568,[302 427 180 197 603],271,5,15459,4.331465396469599,20.0,0.0
23569,2,3569,[302 427 180 197 603],90,5,15464,4.3316526610644255,20.0,0.0
23570,2,3570,[302 427 180 197 603],666,5,15469,4.331839820778494,20.0,0.0
23571,2,3571,[742 215   7 182 265],804,5,15474,4.332026875699888,0.0,0.0
23572,2,3572,[194 508 161 210 258],378,5,15479,4.332213825916597,0.0,0.0
23573,2,3573,[302 427 180 197 603],13,5,15484,4.332400671516508,20.0,0.0
23574,2,3574,[302 427 180 197 603],537,5,15489,4.332587412587412,20.0,0.0
23575,2,3575,[302 427 180 197 603],474,5,15494,4.332774049217003,20.0,0.0
23576,2,3576,[ 96 173 200 182 273],102,0,15494,4.331562762091138,0.0,0.0
23577,2,3577,[302 427 180 197 603],537,5,15499,4.331749580771381,20.0,0.0
23578,2,3578,[302 427 180 197 603],383,5,15504,4.331936295054485,20.0,0.0
23579,2,3579,[302 427 180 197 603],383,5,15509,4.332122905027933,20.0,0.0
23580,2,3580,[302 427 180 197 603],13,5,15514,4.332309410779112,20.0,0.0
23581,2,3581,[215 258 403 191   4],387,2,15516,4.331658291457287,0.0,0.0
23582,2,3582,[ 11 222 333  79 176],881,5,15521,4.331844822774212,0.0,0.0
23583,2,3583,[100   1 403  69  82],374,4,15525,4.331752232142857,0.0,20.0
23584,2,3584,[302 427 180 197 603],537,5,15530,4.331938633193864,20.0,0.0
23585,2,3585,[172 174 471 196 197],298,5,15535,4.332124930284439,0.0,20.0
23586,2,3586,[302 427 180 197 603],13,5,15540,4.332311123501533,20.0,0.0
23587,2,3587,[191 202  70  50 216],311,5,15545,4.332497212931996,0.0,20.0
23588,2,3588,[302 427 180 197 603],90,5,15550,4.33268319866258,20.0,0.0
23589,2,3589,[302 427 180 197 603],13,5,15555,4.332869080779944,20.0,0.0
23590,2,3590,[302 427 180 197 603],537,5,15560,4.333054859370649,20.0,0.0
23591,2,3591,[302 427 180 197 603],339,5,15565,4.333240534521158,20.0,0.0
23592,2,3592,[302 427 180 197 603],339,5,15570,4.33342610631784,20.0,0.0
23593,2,3593,[302 427 180 197 603],383,5,15575,4.333611574846967,20.0,0.0
23594,2,3594,[302 427 180 197 603],13,5,15580,4.3337969401947145,20.0,0.0
23595,2,3595,[269 423  71 286 496],524,3,15583,4.333426028921023,0.0,0.0
23596,2,3596,[302 427 180 197 603],271,5,15588,4.333611342785654,20.0,0.0
23597,2,3597,[258 172 603 174  12],13,5,15593,4.333796553640911,40.0,20.0
23598,2,3598,[302 427 180 197 603],474,5,15598,4.333981661572659,20.0,0.0
23599,2,3599,[302 427 180 197 603],383,5,15603,4.3341666666666665,20.0,0.0
23600,2,3600,[302 427 180 197 603],383,5,15608,4.334351569008609,20.0,0.0
23601,2,3601,[302 427 180 197 603],537,5,15613,4.3345363686840646,20.0,0.0
23602,2,3602,[302 427 180 197 603],664,5,15618,4.334721065778518,20.0,0.0
23603,2,3603,[302 427 180 197 603],474,5,15623,4.334905660377358,20.0,0.0
23604,2,3604,[403 100 196 568 179],339,3,15626,4.334535367545076,0.0,20.0
23605,2,3605,[ 96 196  64  95 194],308,4,15630,4.334442595673877,0.0,0.0
23606,2,3606,[302 427 180 197 603],271,5,15635,4.334627113945107,20.0,0.0
23607,2,3607,[302 427 180 197 603],271,5,15640,4.334811529933481,20.0,0.0
23608,2,3608,[222 174  69  70 185],311,4,15644,4.334718758658909,0.0,20.0
23609,2,3609,[302 427 180 197 603],537,5,15649,4.334903047091413,20.0,0.0
23610,2,3610,[276 100 288 210  64],234,2,15651,4.334256438659651,0.0,20.0
23611,2,3611,[302 427 180 197 603],666,5,15656,4.3344407530454045,20.0,0.0
23612,2,3612,[ 70 288 179 100 111],374,3,15659,4.33407140880155,0.0,20.0
23613,2,3613,[318 302  15 174 132],537,2,15661,4.333425567238517,20.0,20.0
23614,2,3614,[302 427 180 197 603],271,5,15666,4.333609958506224,20.0,0.0
23615,2,3615,[302 427 180 197 603],537,5,15671,4.333794247787611,20.0,0.0
23616,2,3616,[302 427 180 197 603],474,5,15676,4.333978435167266,20.0,0.0
23617,2,3617,[117 100 423 258 276],378,4,15680,4.333886124930901,0.0,20.0
23618,2,3618,[302 427 180 197 603],664,5,15685,4.334070185134015,20.0,0.0
23619,2,3619,[302 427 180 197 603],383,5,15690,4.334254143646409,20.0,0.0
23620,2,3620,[302 427 180 197 603],537,5,15695,4.334438000552334,20.0,0.0
23621,2,3621,[302 427 180 197 603],666,5,15700,4.334621755935947,20.0,0.0
23622,2,3622,[186 196 435 403 100],892,3,15703,4.334253381175821,0.0,20.0
23623,2,3623,[  4  70 179 161 228],59,3,15706,4.333885209713024,0.0,0.0
23624,2,3624,[357   7 173 237 174],6,3,15709,4.33351724137931,20.0,20.0
23625,2,3625,[302 427 180 197 603],90,5,15714,4.333701047986763,20.0,0.0
23626,2,3626,[405 187 179  88 475],474,5,15719,4.333884753239592,0.0,0.0
23627,2,3627,[302 427 180 197 603],90,5,15724,4.33406835722161,20.0,0.0
23628,2,3628,[302 427 180 197 603],664,5,15729,4.334251860016534,20.0,0.0
23629,2,3629,[175  71 435  50 288],650,3,15732,4.333884297520661,0.0,20.0
23630,2,3630,[302 427 180 197 603],474,5,15737,4.334067749931148,20.0,0.0
23631,2,3631,[302 427 180 197 603],90,5,15742,4.334251101321586,20.0,0.0
23632,2,3632,[302 427 180 197 603],90,5,15747,4.334434351775392,20.0,0.0
23633,2,3633,[302 427 180 197 603],664,5,15752,4.334617501375894,20.0,0.0
23634,2,3634,[302 427 180 197 603],664,5,15757,4.334800550206327,20.0,0.0
23635,2,3635,[302 427 180 197 603],383,5,15762,4.3349834983498345,20.0,0.0
23636,2,3636,[302 427 180 197 603],339,5,15767,4.335166345889469,20.0,0.0
23637,2,3637,[302 427 180 197 603],537,5,15772,4.335349092908191,20.0,0.0
23638,2,3638,[302 427 180 197 603],666,5,15777,4.335531739488871,20.0,0.0
23639,2,3639,[302 427 180 197 603],537,5,15782,4.335714285714285,20.0,0.0
23640,2,3640,[125  11 237 302 215],378,3,15785,4.335347432024169,0.0,0.0
23641,2,3641,[302 427 180 197 603],339,5,15790,4.3355299286106534,20.0,0.0
23642,2,3642,[ 69 435   8 183   9],60,4,15794,4.335437825967609,0.0,0.0
23643,2,3643,[302 427 180 197 603],13,5,15799,4.3356201975850714,20.0,0.0
23644,2,3644,[ 96   9 175 238  11],207,1,15800,4.334705075445816,0.0,0.0
23645,2,3645,[328 294 300 257 172],144,3,15803,4.334339001645639,0.0,0.0
23646,2,3646,[302 427 180 197 603],666,5,15808,4.334521524540718,20.0,0.0
23647,2,3647,[302 427 180 197 603],474,5,15813,4.334703947368421,20.0,0.0
23648,2,3648,[302 427 180 197 603],537,5,15818,4.334886270211017,20.0,0.0
23649,2,3649,[195   1 200 153 257],815,4,15822,4.334794520547945,0.0,0.0
23650,2,3650,[302 427 180 197 603],666,5,15827,4.334976718707203,20.0,0.0
23651,2,3651,[235 161 222 228 200],374,4,15831,4.334884994523549,0.0,0.0
23652,2,3652,[302 427 180 197 603],537,5,15836,4.335067068163154,20.0,0.0
23653,2,3653,[302 427 180 197 603],666,5,15841,4.335249042145594,20.0,0.0
23654,2,3654,[210 200 153 194 111],749,4,15845,4.33515731874145,0.0,0.0
23655,2,3655,[588  71 423 228 204],479,2,15847,4.334518599562363,0.0,0.0
23656,2,3656,[302 427 180 197 603],13,5,15852,4.3347005742411815,20.0,0.0
23657,2,3657,[302 427 180 197 603],474,5,15857,4.3348824494259155,20.0,0.0
23658,2,3658,[302 427 180 197 603],664,5,15862,4.335064225198142,20.0,0.0
23659,2,3659,[302 427 180 197 603],474,5,15867,4.335245901639344,20.0,0.0
23660,2,3660,[302 427 180 197 603],474,5,15872,4.335427478830921,20.0,0.0
23661,2,3661,[483 234 228   7 385],13,3,15875,4.335062807209176,20.0,0.0
23662,2,3662,[302 427 180 197 603],13,5,15880,4.335244335244335,20.0,0.0
23663,2,3663,[302 427 180 197 603],664,5,15885,4.33542576419214,20.0,0.0
23664,2,3664,[302 427 180 197 603],339,5,15890,4.335607094133697,20.0,0.0
23665,2,3665,[302 427 180 197 603],666,5,15895,4.335788325150027,20.0,0.0
23666,2,3666,[127 318 211 202  79],188,4,15899,4.335696754840469,20.0,20.0
23667,2,3667,[302 427 180 197 603],666,5,15904,4.33587786259542,20.0,0.0
23668,2,3668,[302 427 180 197 603],664,5,15909,4.336058871627146,20.0,0.0
23669,2,3669,[302 427 180 197 603],339,5,15914,4.3362397820163485,20.0,0.0
23670,2,3670,[302 427 180 197 603],474,5,15919,4.3364205938436395,20.0,0.0
23671,2,3671,[302 427 180 197 603],90,5,15924,4.336601307189542,20.0,0.0
23672,2,3672,[302 269  95 180   7],524,3,15927,4.336237408113259,0.0,0.0
23673,2,3673,[302 427 180 197 603],537,5,15932,4.336418072945019,20.0,0.0
23674,2,3674,[302 427 180 197 603],666,5,15937,4.336598639455782,20.0,0.0
23675,2,3675,[222   1 271 265 235],650,2,15939,4.335963003264418,0.0,0.0
23676,2,3676,[302 427 180 197 603],383,5,15944,4.336143595322274,20.0,0.0
23677,2,3677,[302 427 180 197 603],339,5,15949,4.336324089178902,20.0,0.0
23678,2,3678,[302 427 180 197 603],13,5,15954,4.336504484914379,20.0,0.0
23679,2,3679,[  1 313  97  71 144],234,1,15955,4.335597826086956,0.0,0.0
23680,2,3680,[302 427 180 197 603],90,5,15960,4.3357783211083945,20.0,0.0
23681,2,3681,[302 427 180 197 603],383,5,15965,4.335958718087996,20.0,0.0
23682,2,3682,[302 427 180 197 603],537,5,15970,4.33613901710562,20.0,0.0
23683,2,3683,[302 427 180 197 603],664,5,15975,4.336319218241043,20.0,0.0
23684,2,3684,[  8 117 435 357  69],454,2,15977,4.335685210312076,20.0,0.0
23685,2,3685,[302 427 180 197 603],271,5,15982,4.335865436787846,20.0,0.0
23686,2,3686,[174  95  70 216 186],95,4,15986,4.3357743422837,0.0,20.0
23687,2,3687,[302 427 180 197 603],339,5,15991,4.335954446854664,20.0,0.0
23688,2,3688,[302 427 180 197 603],537,5,15996,4.336134453781512,20.0,0.0
23689,2,3689,[ 28 176 204   1  95],308,4,16000,4.336043360433604,0.0,0.0
23690,2,3690,[197 181 202 333 168],666,3,16003,4.335681387157952,0.0,0.0
23691,2,3691,[302 427 180 197 603],664,5,16008,4.3358613217768145,20.0,0.0
23692,2,3692,[222 289 323  70 435],328,3,16011,4.335499593826158,0.0,0.0
23693,2,3693,[302 427 180 197 603],666,5,16016,4.335679480238224,20.0,0.0
23694,2,3694,[302 427 180 197 603],474,5,16021,4.335859269282815,20.0,0.0
23695,2,3695,[385 655 237 211 276],13,4,16025,4.3357683982683985,0.0,0.0
23696,2,3696,[302 427 180 197 603],537,5,16030,4.335948065999459,20.0,0.0
23697,2,3697,[210 194  15 228  50],653,3,16033,4.335586803677663,0.0,20.0
23698,2,3698,[273 471 183 288 515],92,4,16037,4.335496080021628,0.0,0.0
23699,2,3699,[237  71 174 182 265],378,5,16042,4.335675675675676,0.0,20.0
23700,2,3700,[ 15 172 100 215 234],533,4,16046,4.335584977033235,0.0,20.0
23701,2,3701,[302 427 180 197 603],664,5,16051,4.335764451647758,20.0,0.0
23702,2,3702,[302 427 180 197 603],90,5,16056,4.335943829327572,20.0,0.0
23703,2,3703,[183 180 385 174 197],452,5,16061,4.336123110151188,0.0,20.0
23704,2,3704,[302 427 180 197 603],664,5,16066,4.336302294197031,20.0,0.0
23705,2,3705,[204 496 174 185  50],897,5,16071,4.336481381543443,0.0,40.0
23706,2,3706,[302 427 180 197 603],271,5,16076,4.336660372268681,20.0,0.0
23707,2,3707,[275 153   7 288 268],7,4,16080,4.336569579288026,0.0,0.0
23708,2,3708,[302 427 180 197 603],339,5,16085,4.336748449716905,20.0,0.0
23709,2,3709,[302 427 180 197 603],90,5,16090,4.336927223719677,20.0,0.0
23710,2,3710,[302 427 180 197 603],13,5,16095,4.337105901374293,20.0,0.0
23711,2,3711,[302 427 180 197 603],271,5,16100,4.337284482758621,20.0,0.0
23712,2,3712,[286  56 202 568 176],102,1,16101,4.336385671963372,0.0,0.0
23713,2,3713,[ 97 286 483 405 276],458,4,16105,4.336295099623048,20.0,0.0
23714,2,3714,[186 228 172 234  25],537,1,16106,4.335397039030956,0.0,0.0
23715,2,3715,[302 427 180 197 603],13,5,16111,4.335575888051668,20.0,0.0
23716,2,3716,[302 427 180 197 603],13,5,16116,4.3357546408393866,20.0,0.0
23717,2,3717,[302 427 180 197 603],666,5,16121,4.335933297471759,20.0,0.0
23718,2,3718,[302 427 180 197 603],537,5,16126,4.336111858026351,20.0,0.0
23719,2,3719,[302 427 180 197 603],90,5,16131,4.336290322580645,20.0,0.0
23720,2,3720,[302 427 180 197 603],13,5,16136,4.33646869121204,20.0,0.0
23721,2,3721,[302 427 180 197 603],13,5,16141,4.33664696399785,20.0,0.0
23722,2,3722,[ 89 655 132 191 276],378,5,16146,4.33682514101531,0.0,0.0
23723,2,3723,[ 79 269 483 111 117],294,5,16151,4.337003222341568,20.0,0.0
23724,2,3724,[302 427 180 197 603],339,5,16156,4.337181208053691,20.0,0.0
23725,2,3725,[302 427 180 197 603],664,5,16161,4.337359098228664,20.0,0.0
23726,2,3726,[302 427 180 197 603],339,5,16166,4.337536892943386,20.0,0.0
23727,2,3727,[302 427 180 197 603],13,5,16171,4.337714592274678,20.0,0.0
23728,2,3728,[357  98   4 286 172],144,5,16176,4.337892196299276,20.0,20.0
23729,2,3729,[153 603  50 196  56],738,5,16181,4.338069705093834,20.0,20.0
23730,2,3730,[302 427 180 197 603],90,5,16186,4.338247118734923,20.0,0.0
23731,2,3731,[174 187 195  96 125],669,1,16187,4.337352625937835,0.0,20.0
23732,2,3732,[302 427 180 197 603],664,5,16192,4.337530136619341,20.0,0.0
23733,2,3733,[302 427 180 197 603],90,5,16197,4.337707552222818,20.0,0.0
23734,2,3734,[302 427 180 197 603],13,5,16202,4.337884872824632,20.0,0.0
23735,2,3735,[168   8 237  69  64],308,3,16205,4.337526766595289,0.0,0.0
23736,2,3736,[302 427 180 197 603],271,5,16210,4.337704040674338,20.0,0.0
23737,2,3737,[215 194 435 216 288],648,4,16214,4.337613697164259,0.0,0.0
23738,2,3738,[  4 742 181 273   1],59,2,16216,4.3369884995988235,0.0,0.0
23739,2,3739,[302 427 180 197 603],664,5,16221,4.337165775401069,20.0,0.0
23740,2,3740,[302 427 180 197 603],666,5,16226,4.337342956428762,20.0,0.0
23741,2,3741,[302 427 180 197 603],13,5,16231,4.337520042757883,20.0,0.0
23742,2,3742,[302 427 180 197 603],13,5,16236,4.337697034464333,20.0,0.0
23743,2,3743,[302  11 153 216  28],334,3,16239,4.337339743589744,0.0,0.0
23744,2,3744,[ 56 275 597 300 294],378,3,16242,4.336982643524699,0.0,0.0
23745,2,3745,[313 328 678 216 111],13,2,16244,4.336358782701549,0.0,0.0
23746,2,3746,[245  69 603 318 132],454,3,16247,4.336002135041366,40.0,0.0
23747,2,3747,[302 427 180 197 603],383,5,16252,4.336179295624333,20.0,0.0
23748,2,3748,[302 427 180 197 603],90,5,16257,4.336356361696453,20.0,0.0
23749,2,3749,[302 427 180 197 603],474,5,16262,4.336533333333334,20.0,0.0
23750,2,3750,[302 427 180 197 603],271,5,16267,4.336710210610504,20.0,0.0
23751,2,3751,[302 427 180 197 603],271,5,16272,4.336886993603412,20.0,0.0
23752,2,3752,[275 174 588  56 181],184,3,16275,4.336530775379696,0.0,20.0
23753,2,3753,[302 427 180 197 603],537,5,16280,4.336707511987214,20.0,0.0
23754,2,3754,[276  79 496 385 121],59,5,16285,4.336884154460719,0.0,0.0
23755,2,3755,[302 427 180 197 603],537,5,16290,4.3370607028754,20.0,0.0
23756,2,3756,[302 427 180 197 603],664,5,16295,4.337237157306362,20.0,0.0
23757,2,3757,[302 427 180 197 603],383,5,16300,4.337413517828632,20.0,0.0
23758,2,3758,[302 427 180 197 603],90,5,16305,4.337589784517159,20.0,0.0
23759,2,3759,[302 427 180 197 603],664,5,16310,4.337765957446808,20.0,0.0
23760,2,3760,[302 427 180 197 603],90,5,16315,4.337942036692369,20.0,0.0
23761,2,3761,[302 427 180 197 603],339,5,16320,4.3381180223285485,20.0,0.0
23762,2,3762,[302 427 180 197 603],271,5,16325,4.338293914429976,20.0,0.0
23763,2,3763,[181 183  22  11 222],488,4,16329,4.338204038257174,0.0,0.0
23764,2,3764,[302 427 180 197 603],383,5,16334,4.338379814077025,20.0,0.0
23765,2,3765,[302 427 180 197 603],537,5,16339,4.338555496548062,20.0,0.0
23766,2,3766,[288 286 187 100 385],474,4,16343,4.338465622511282,0.0,20.0
23767,2,3767,[568  95 318  71  28],804,4,16347,4.338375796178344,20.0,0.0
23768,2,3768,[302 427 180 197 603],474,5,16352,4.338551339877951,20.0,0.0
23769,2,3769,[302 427 180 197 603],664,5,16357,4.338726790450928,20.0,0.0
23770,2,3770,[357 186   9 276 175],59,5,16362,4.3389021479713605,20.0,0.0
23771,2,3771,[ 69 435 222 655  70],474,5,16367,4.339077412513255,0.0,0.0
23772,2,3772,[269 423 235  95  69],537,0,16367,4.337927378743705,0.0,0.0
23773,2,3773,[302 427 180 197 603],537,5,16372,4.338102808691044,20.0,0.0
23774,2,3774,[302 427 180 197 603],474,5,16377,4.338278145695364,20.0,0.0
23775,2,3775,[302 427 180 197 603],271,5,16382,4.338453389830509,20.0,0.0
23776,2,3776,[ 25  50 238 275 132],318,3,16385,4.33809902038655,0.0,20.0
23777,2,3777,[302 427 180 197 603],339,5,16390,4.338274219163579,20.0,0.0
23778,2,3778,[302 427 180 197 603],664,5,16395,4.338449325218312,20.0,0.0
23779,2,3779,[302 427 180 197 603],13,5,16400,4.338624338624339,20.0,0.0
23780,2,3780,[302 427 180 197 603],339,5,16405,4.338799259455171,20.0,0.0
23781,2,3781,[  9  97 276 215 318],343,5,16410,4.3389740877842415,20.0,0.0
23782,2,3782,[238 271 318  88  64],738,3,16413,4.338620142743854,20.0,0.0
23783,2,3783,[117 204   8  82 174],892,4,16417,4.3385306553911205,0.0,20.0
23784,2,3784,[125 200 127  96  89],234,2,16419,4.337912813738441,0.0,20.0
23785,2,3785,[302 427 180 197 603],339,5,16424,4.338087691494981,20.0,0.0
23786,2,3786,[302 427 180 197 603],537,5,16429,4.33826247689464,20.0,0.0
23787,2,3787,[302 427 180 197 603],474,5,16434,4.338437170010559,20.0,0.0
23788,2,3788,[302 427 180 197 603],90,5,16439,4.338611770915809,20.0,0.0
23789,2,3789,[302 427 180 197 603],13,5,16444,4.338786279683378,20.0,0.0
23790,2,3790,[322 210 195 496  71],313,4,16448,4.3386969137430755,0.0,0.0
23791,2,3791,[187 318  96 151 742],308,5,16453,4.338871308016878,20.0,0.0
23792,2,3792,[238 181 546 121 194],643,2,16455,4.338254679673082,0.0,0.0
23793,2,3793,[302 427 180 197 603],474,5,16460,4.3384290985767,20.0,0.0
23794,2,3794,[655 748  15  79 508],92,3,16463,4.338076416337286,0.0,0.0
23795,2,3795,[302 427 180 197 603],383,5,16468,4.338250790305585,20.0,0.0
23796,2,3796,[302 427 180 197 603],537,5,16473,4.338425072425599,20.0,0.0
23797,2,3797,[748 179 282  22  70],311,4,16477,4.338335966298051,0.0,0.0
23798,2,3798,[183 200 194 546 153],643,3,16480,4.337983679915768,0.0,0.0
23799,2,3799,[302 427 180 197 603],664,5,16485,4.338157894736842,20.0,0.0
23800,2,3800,[302 427 180 197 603],271,5,16490,4.338332017890029,20.0,0.0
23801,2,3801,[302 427 180 197 603],383,5,16495,4.338506049447659,20.0,0.0
23802,2,3802,[294  79 176 234 174],406,3,16498,4.338154088877202,0.0,20.0
23803,2,3803,[302 427 180 197 603],383,5,16503,4.3383280757097795,20.0,0.0
23804,2,3804,[286 265 200 194 182],537,1,16504,4.337450722733246,0.0,0.0
23805,2,3805,[302 427 180 197 603],537,5,16509,4.337624802942722,20.0,0.0
23806,2,3806,[302 427 180 197 603],666,5,16514,4.337798791699501,20.0,0.0
23807,2,3807,[302 427 180 197 603],383,5,16519,4.33797268907563,20.0,0.0
23808,2,3808,[ 12 237 181  96 173],538,3,16522,4.337621422945655,20.0,0.0
23809,2,3809,[302 427 180 197 603],537,5,16527,4.337795275590551,20.0,0.0
23810,2,3810,[302 427 180 197 603],666,5,16532,4.337969036998163,20.0,0.0
23811,2,3811,[302 427 180 197 603],666,5,16537,4.338142707240293,20.0,0.0
23812,2,3812,[  4 210 282 204  69],406,3,16540,4.337791765014424,0.0,0.0
23813,2,3813,[302 427 180 197 603],664,5,16545,4.337965390665968,20.0,0.0
23814,2,3814,[176 568 200 144 117],643,3,16548,4.337614678899082,0.0,0.0
23815,2,3815,[153 111 179 185   1],64,4,16552,4.337526205450734,0.0,0.0
23816,2,3816,[215  28 174 265 405],537,0,16552,4.336389834948913,0.0,20.0
23817,2,3817,[302 427 180 197 603],13,5,16557,4.3365636458878996,20.0,0.0
23818,2,3818,[435 194 176 204 175],7,4,16561,4.3364755171510865,0.0,0.0
23819,2,3819,[202 357  28  56 268],13,4,16565,4.3363874345549736,20.0,0.0
23820,2,3820,[302 427 180 197 603],90,5,16570,4.336561109657158,20.0,0.0
23821,2,3821,[144   7 175 435 265],339,3,16573,4.336211407639979,0.0,0.0
23822,2,3822,[191 333 471 151 183],537,1,16574,4.335338739210044,0.0,0.0
23823,2,3823,[302 427 180 197 603],537,5,16579,4.335512552301255,20.0,0.0
23824,2,3824,[302 427 180 197 603],474,5,16584,4.335686274509804,20.0,0.0
23825,2,3825,[235 286 210 228 275],406,2,16586,4.3350757971772085,0.0,0.0
23826,2,3826,[302 427 180 197 603],13,5,16591,4.335249542722759,20.0,0.0
23827,2,3827,[302 427 180 197 603],13,5,16596,4.335423197492163,20.0,0.0
23828,2,3828,[302 427 180 197 603],664,5,16601,4.335596761556542,20.0,0.0
23829,2,3829,[302 427 180 197 603],13,5,16606,4.335770234986946,20.0,0.0
23830,2,3830,[ 69 211 603 191   7],527,5,16611,4.335943617854346,20.0,0.0
23831,2,3831,[302 427 180 197 603],271,5,16616,4.336116910229645,20.0,0.0
23832,2,3832,[302 427 180 197 603],664,5,16621,4.3362901121836686,20.0,0.0
23833,2,3833,[222 427 546   4 288],533,2,16623,4.335680751173709,0.0,0.0
23834,2,3834,[302 427 180 197 603],90,5,16628,4.335853976531943,20.0,0.0
23835,2,3835,[302 427 180 197 603],537,5,16633,4.336027111574557,20.0,0.0
23836,2,3836,[ 88 435 179 238 197],318,4,16637,4.335939536095908,0.0,0.0
23837,2,3837,[302 427 180 197 603],339,5,16642,4.336112558624284,20.0,0.0
23838,2,3838,[302 427 180 197 603],90,5,16647,4.336285491013284,20.0,0.0
23839,2,3839,[302 427 180 197 603],90,5,16652,4.336458333333334,20.0,0.0
23840,2,3840,[302 427 180 197 603],271,5,16657,4.336631085654777,20.0,0.0
23841,2,3841,[289 435  70 323 204],455,2,16659,4.336022904737116,0.0,0.0
23842,2,3842,[496 294 195 483  89],7,4,16663,4.335935467083008,20.0,0.0
23843,2,3843,[302 427 180 197 603],474,5,16668,4.336108220603538,20.0,0.0
23844,2,3844,[168 127  28 483 211],85,5,16673,4.33628088426528,20.0,20.0
23845,2,3845,[302 427 180 197 603],474,5,16678,4.336453458138325,20.0,0.0
23846,2,3846,[302 427 180 197 603],664,5,16683,4.336625942292696,20.0,0.0
23847,2,3847,[302 427 180 197 603],474,5,16688,4.336798336798337,20.0,0.0
23848,2,3848,[302 427 180 197 603],664,5,16693,4.336970641725124,20.0,0.0
23849,2,3849,[302 427 180 197 603],474,5,16698,4.337142857142857,20.0,0.0
23850,2,3850,[302 427 180 197 603],537,5,16703,4.337314983121267,20.0,0.0
23851,2,3851,[302 427 180 197 603],13,5,16708,4.33748701973001,20.0,0.0
23852,2,3852,[302 427 180 197 603],474,5,16713,4.337658967038672,20.0,0.0
23853,2,3853,[302 427 180 197 603],474,5,16718,4.337830825116762,20.0,0.0
23854,2,3854,[302 427 180 197 603],383,5,16723,4.338002594033722,20.0,0.0
23855,2,3855,[302 427 180 197 603],383,5,16728,4.338174273858921,20.0,0.0
23856,2,3856,[302 427 180 197 603],271,5,16733,4.338345864661654,20.0,0.0
23857,2,3857,[  9 176  71  98   4],648,2,16735,4.337739761534474,0.0,20.0
23858,2,3858,[302 427 180 197 603],383,5,16740,4.337911376004146,20.0,0.0
23859,2,3859,[302 427 180 197 603],666,5,16745,4.3380829015544045,20.0,0.0
23860,2,3860,[302 427 180 197 603],90,5,16750,4.338254338254338,20.0,0.0
23861,2,3861,[546   8 176 318 185],328,3,16753,4.3379078197824965,20.0,0.0
23862,2,3862,[235 333 135   8  64],144,3,16756,4.337561480714471,0.0,0.0
23863,2,3863,[302 427 180 197 603],271,5,16761,4.337732919254658,20.0,0.0
23864,2,3864,[ 12 301 238  88   1],13,2,16763,4.33712807244502,20.0,0.0
23865,2,3865,[302 427 180 197 603],271,5,16768,4.337299534402483,20.0,0.0
23866,2,3866,[302 427 180 197 603],666,5,16773,4.337470907680372,20.0,0.0
23867,2,3867,[403 748 175 235 202],64,4,16777,4.337383660806618,0.0,0.0
23868,2,3868,[302 427 180 197 603],271,5,16782,4.337554923752908,20.0,0.0
23869,2,3869,[302 427 180 197 603],664,5,16787,4.337726098191214,20.0,0.0
23870,2,3870,[183  56 483 135 132],10,5,16792,4.3378971841901315,20.0,0.0
23871,2,3871,[302 427 180 197 603],339,5,16797,4.338068181818182,20.0,0.0
23872,2,3872,[ 50  71   9 275  69],334,3,16800,4.337722695584818,0.0,20.0
23873,2,3873,[302 427 180 197 603],474,5,16805,4.337893649974187,20.0,0.0
23874,2,3874,[302 427 180 197 603],537,5,16810,4.338064516129032,20.0,0.0
23875,2,3875,[302 427 180 197 603],666,5,16815,4.338235294117647,20.0,0.0
23876,2,3876,[302 427 180 197 603],383,5,16820,4.338405984008253,20.0,0.0
23877,2,3877,[195 403  89 515 238],313,4,16824,4.338318720990201,0.0,0.0
23878,2,3878,[302 427 180 197 603],271,5,16829,4.338489301366332,20.0,0.0
23879,2,3879,[302 427 180 197 603],383,5,16834,4.338659793814433,20.0,0.0
23880,2,3880,[211 313 100 151 588],234,2,16836,4.338057201752126,0.0,20.0
23881,2,3881,[302 427 180 197 603],383,5,16841,4.3382277176713036,20.0,0.0
23882,2,3882,[302 427 180 197 603],666,5,16846,4.338398145763585,20.0,0.0
23883,2,3883,[302 427 180 197 603],383,5,16851,4.338568486096808,20.0,0.0
23884,2,3884,[302 427 180 197 603],666,5,16856,4.338738738738739,20.0,0.0
23885,2,3885,[302 427 180 197 603],13,5,16861,4.338908903757076,20.0,0.0
23886,2,3886,[302 427 180 197 603],339,5,16866,4.3390789812194495,20.0,0.0
23887,2,3887,[302 427 180 197 603],666,5,16871,4.339248971193416,20.0,0.0
23888,2,3888,[302 427 180 197 603],666,5,16876,4.339418873746465,20.0,0.0
23889,2,3889,[302 427 180 197 603],474,5,16881,4.339588688946016,20.0,0.0
23890,2,3890,[127 385 269 228 153],650,4,16885,4.339501413518375,0.0,20.0
23891,2,3891,[302 427 180 197 603],474,5,16890,4.33967112024666,20.0,0.0
23892,2,3892,[153  50  25 195 187],452,3,16893,4.339326997174416,0.0,20.0
23893,2,3893,[302 427 180 197 603],90,5,16898,4.33949666153056,20.0,0.0
23894,2,3894,[302 427 180 197 603],666,5,16903,4.339666238767651,20.0,0.0
23895,2,3895,[ 82 289 245 403 125],334,2,16905,4.339065708418891,0.0,0.0
23896,2,3896,[302 427 180 197 603],383,5,16910,4.3392353092122145,20.0,0.0
23897,2,3897,[  1 423 323 435 151],537,0,16910,4.338122113904566,0.0,0.0
23898,2,3898,[302 427 180 197 603],474,5,16915,4.338291869710182,20.0,0.0
23899,2,3899,[302 427 180 197 603],537,5,16920,4.338461538461538,20.0,0.0
23900,2,3900,[176  71  50  97  22],892,4,16924,4.338374775698539,0.0,20.0
23901,2,3901,[235 515 655 175 222],102,1,16925,4.337519220912353,0.0,0.0
23902,2,3902,[302 427 180 197 603],664,5,16930,4.337688957212401,20.0,0.0
23903,2,3903,[294 286 180 183 385],194,1,16931,4.336834016393443,0.0,0.0
23904,2,3904,[302 427 197 180 603],664,5,16936,4.337003841229193,20.0,0.0
23905,2,3905,[302 427 197 180 603],664,5,16941,4.337173579109063,20.0,0.0
23906,2,3906,[273 357 435  56 187],387,4,16945,4.337087279242385,20.0,0.0
23907,2,3907,[302 427 197 180 603],90,5,16950,4.337256908904811,20.0,0.0
23908,2,3908,[333 515 197 405 588],64,2,16952,4.336658992069583,0.0,0.0
23909,2,3909,[  8   4 228 194  11],387,2,16954,4.336061381074169,0.0,0.0
23910,2,3910,[121 546 258 117 215],13,3,16957,4.335719764766044,0.0,0.0
23911,2,3911,[143   4 174 289  71],533,3,16960,4.335378323108385,0.0,20.0
23912,2,3912,[302 427 180 197 603],339,5,16965,4.335548172757475,20.0,0.0
23913,2,3913,[302 427 180 197 603],474,5,16970,4.3357179356157385,20.0,0.0
23914,2,3914,[ 97 117 153 168 268],387,2,16972,4.335121328224776,0.0,0.0
23915,2,3915,[181  64 496  25 175],95,4,16976,4.335035750766088,0.0,0.0
23916,2,3916,[302 427 180 197 603],474,5,16981,4.335205514424304,20.0,0.0
23917,2,3917,[302 427 180 197 603],666,5,16986,4.335375191424196,20.0,0.0
23918,2,3918,[100  70 211  96 172],479,4,16990,4.3352896146976265,0.0,20.0
23919,2,3919,[302 427 180 197 603],90,5,16995,4.3354591836734695,20.0,0.0
23920,2,3920,[ 82 144 588 181 496],378,4,16999,4.335373629176231,0.0,0.0
23921,2,3921,[197 268 435 215 508],643,4,17003,4.335288118306986,0.0,0.0
23922,2,3922,[302 427 180 197 603],666,5,17008,4.335457557991333,20.0,0.0
23923,2,3923,[302 427 180 197 603],90,5,17013,4.335626911314985,20.0,0.0
23924,2,3924,[302 427 180 197 603],537,5,17018,4.335796178343949,20.0,0.0
23925,2,3925,[302 427 180 197 603],474,5,17023,4.335965359144167,20.0,0.0
23926,2,3926,[182 100 238 187 117],158,4,17027,4.335879806468042,0.0,20.0
23927,2,3927,[302 427 180 197 603],537,5,17032,4.336048879837067,20.0,0.0
23928,2,3928,[302 427 180 197 603],383,5,17037,4.336217867141766,20.0,0.0
23929,2,3929,[275 357   9 235 143],648,3,17040,4.33587786259542,20.0,0.0
23930,2,3930,[302 427 180 197 603],383,5,17045,4.3360468074281355,20.0,0.0
23931,2,3931,[302 427 180 197 603],664,5,17050,4.336215666327568,20.0,0.0
23932,2,3932,[302 427 180 197 603],271,5,17055,4.336384439359268,20.0,0.0
23933,2,3933,[483  98 268  96 182],234,2,17057,4.335790543975597,20.0,20.0
23934,2,3934,[302 427 180 197 603],271,5,17062,4.335959339263024,20.0,0.0
23935,2,3935,[215 118 237 204 179],524,2,17064,4.335365853658536,0.0,0.0
23936,2,3936,[ 50 117  15 179  12],378,3,17067,4.33502667005334,20.0,20.0
23937,2,3937,[302 427 180 197 603],383,5,17072,4.335195530726257,20.0,0.0
23938,2,3938,[302 427 180 197 603],664,5,17077,4.335364305661336,20.0,0.0
23939,2,3939,[302 427 180 197 603],666,5,17082,4.335532994923858,20.0,0.0
23940,2,3940,[302 427 180 197 603],383,5,17087,4.335701598579041,20.0,0.0
23941,2,3941,[302 427 180 197 603],383,5,17092,4.335870116692035,20.0,0.0
23942,2,3942,[294  50  71 427 173],474,4,17096,4.33578493532843,0.0,20.0
23943,2,3943,[302 427 180 197 603],664,5,17101,4.335953346855984,20.0,0.0
23944,2,3944,[318 238 435 100 313],537,4,17105,4.335868187579214,20.0,20.0
23945,2,3945,[302 427 180 197 603],13,5,17110,4.336036492650786,20.0,0.0
23946,2,3946,[302 427 180 197 603],90,5,17115,4.3362047124398275,20.0,0.0
23947,2,3947,[216 427 228  71 238],7,5,17120,4.336372847011145,0.0,0.0
23948,2,3948,[ 88 286  56 222 238],537,2,17122,4.335781210433021,0.0,0.0
23949,2,3949,[302 427 180 197 603],383,5,17127,4.335949367088608,20.0,0.0
23950,2,3950,[302 427 180 197 603],339,5,17132,4.336117438623133,20.0,0.0
23951,2,3951,[ 56  22 100   9 210],271,4,17136,4.336032388663968,0.0,20.0
23952,2,3952,[302 427 180 197 603],474,5,17141,4.336200354161396,20.0,0.0
23953,2,3953,[302 427 180 197 603],271,5,17146,4.336368234699039,20.0,0.0
23954,2,3954,[ 71  79 204   4 132],524,3,17149,4.336030341340076,0.0,0.0
23955,2,3955,[302 427 180 197 603],90,5,17154,4.336198179979777,20.0,0.0
23956,2,3956,[ 56 127 427  12 286],7,5,17159,4.336365933788223,20.0,20.0
23957,2,3957,[ 98 216 288 588 174],144,4,17163,4.336280949974735,0.0,40.0
23958,2,3958,[302 427 180 197 603],90,5,17168,4.336448598130841,20.0,0.0
23959,2,3959,[181  71 597 483   1],82,4,17172,4.336363636363636,20.0,0.0
23960,2,3960,[302 427 180 197 603],537,5,17177,4.3365311789952035,20.0,0.0
23961,2,3961,[748  56  89 175  64],749,2,17179,4.335941443715296,0.0,0.0
23962,2,3962,[211   8 742  11 180],271,4,17183,4.335856674236689,0.0,0.0
23963,2,3963,[515 174 385 427 180],313,5,17188,4.336024217961655,0.0,20.0
23964,2,3964,[258  79 118  28 271],479,3,17191,4.335687263556116,0.0,0.0
23965,2,3965,[302 427 180 197 603],666,5,17196,4.335854765506808,20.0,0.0
23966,2,3966,[302 427 180 197 603],383,5,17201,4.336022183009831,20.0,0.0
23967,2,3967,[302 427 180 197 603],474,5,17206,4.336189516129032,20.0,0.0
23968,2,3968,[302 427 180 197 603],339,5,17211,4.336356764928193,20.0,0.0
23969,2,3969,[302 427 180 197 603],537,5,17216,4.336523929471033,20.0,0.0
23970,2,3970,[196  11 427 237 111],454,2,17218,4.335935532611433,0.0,0.0
23971,2,3971,[215 175 427 435 172],313,5,17223,4.336102719033232,0.0,0.0
23972,2,3972,[742 318  11 172 135],666,3,17226,4.335766423357664,20.0,0.0
23973,2,3973,[302 427 180 197 603],271,5,17231,4.335933568193256,20.0,0.0
23974,2,3974,[288 385 471 313 174],474,3,17234,4.33559748427673,0.0,20.0
23975,2,3975,[435 135  70  25  96],406,3,17237,4.335261569416499,0.0,0.0
23976,2,3976,[ 70 151  97  69 196],378,3,17240,4.334925823485039,0.0,0.0
23977,2,3977,[302 427 180 197 603],474,5,17245,4.3350930115635995,20.0,0.0
23978,2,3978,[302 427 180 197 603],474,5,17250,4.335260115606936,20.0,0.0
23979,2,3979,[135 276 235 265   1],308,3,17253,4.334924623115578,0.0,0.0
23980,2,3980,[ 56  88 275 238 168],308,5,17258,4.335091685506154,0.0,0.0
23981,2,3981,[302 427 180 197 603],383,5,17263,4.335258663987946,20.0,0.0
23982,2,3982,[302 427 180 197 603],537,5,17268,4.335425558624153,20.0,0.0
23983,2,3983,[182 172 597 135 204],378,3,17271,4.335090361445783,0.0,0.0
23984,2,3984,[302 427 180 197 603],474,5,17276,4.33525721455458,20.0,0.0
23985,2,3985,[302 427 180 197 603],537,5,17281,4.335423983943803,20.0,0.0
23986,2,3986,[302 427 180 197 603],90,5,17286,4.335590669676448,20.0,0.0
23987,2,3987,[302 427 180 197 603],474,5,17291,4.335757271815447,20.0,0.0
23988,2,3988,[302 427 180 197 603],474,5,17296,4.335923790423665,20.0,0.0
23989,2,3989,[302 427 180 197 603],664,5,17301,4.33609022556391,20.0,0.0
23990,2,3990,[202 194 132 265 288],452,1,17302,4.335254322225007,0.0,0.0
23991,2,3991,[302 427 180 197 603],474,5,17307,4.335420841683367,20.0,0.0
23992,2,3992,[302 427 180 197 603],13,5,17312,4.335587277736038,20.0,0.0
23993,2,3993,[302 427 180 197 603],339,5,17317,4.3357536304456685,20.0,0.0
23994,2,3994,[302 427 180 197 603],664,5,17322,4.335919899874844,20.0,0.0
23995,2,3995,[323 273 151 117 597],374,2,17324,4.335335335335335,0.0,0.0
23996,2,3996,[302 427 180 197 603],383,5,17329,4.335501626219664,20.0,0.0
23997,2,3997,[135 182   4 245  69],533,1,17330,4.334667333666833,0.0,0.0
23998,2,3998,[302 427 180 197 603],666,5,17335,4.334833708427107,20.0,0.0
23999,2,3999,[302 427 180 197 603],383,5,17340,4.335,20.0,0.0
24000,2,4000,[ 82 196  12  98 222],343,5,17345,4.335166208447888,20.0,20.0
24001,2,4001,[302 427 180 197 603],664,5,17350,4.335332333833083,20.0,0.0
24002,2,4002,[302 427 180 197 603],90,5,17355,4.335498376217837,20.0,0.0
24003,2,4003,[302 427 180 197 603],271,5,17360,4.335664335664336,20.0,0.0
24004,2,4004,[302 427 180 197 603],474,5,17365,4.335830212234707,20.0,0.0
24005,2,4005,[302 427 180 197 603],383,5,17370,4.335996005991014,20.0,0.0
24006,2,4006,[748   9  56 328 301],13,2,17372,4.335413027202396,0.0,0.0
24007,2,4007,[302 427 180 197 603],666,5,17377,4.335578842315369,20.0,0.0
24008,2,4008,[302 427 180 197 603],90,5,17382,4.33574457470691,20.0,0.0
24009,2,4009,[302 427 180 197 603],13,5,17387,4.335910224438903,20.0,0.0
24010,2,4010,[288  82 471 180 204],378,2,17389,4.335327848416854,0.0,0.0
24011,2,4011,[ 98 121 235 405 588],378,4,17393,4.335244267198405,0.0,20.0
24012,2,4012,[302 427 197 180 603],271,5,17398,4.335409917767256,20.0,0.0
24013,2,4013,[302 427 197 180 603],383,5,17403,4.335575485799701,20.0,0.0
24014,2,4014,[302 427 197 180 603],664,5,17408,4.33574097135741,20.0,0.0
24015,2,4015,[  7 475 435 135 275],455,5,17413,4.335906374501992,0.0,0.0
24016,2,4016,[302 427 197 180 603],90,5,17418,4.336071695294996,20.0,0.0
24017,2,4017,[302 427 197 180 603],339,5,17423,4.33623693379791,20.0,0.0
24018,2,4018,[302 427 197 180 603],383,5,17428,4.336402090072157,20.0,0.0
24019,2,4019,[302 427 197 180 603],13,5,17433,4.336567164179105,20.0,0.0
24020,2,4020,[302 427 197 180 603],666,5,17438,4.336732156180055,20.0,0.0
24021,2,4021,[302 427 197 180 603],13,5,17443,4.336897066136251,20.0,0.0
24022,2,4022,[185 144  25 135 125],194,2,17445,4.336316181953766,0.0,0.0
24023,2,4023,[302 427 197 180 603],90,5,17450,4.33648111332008,20.0,0.0
24024,2,4024,[302 427 197 180 603],537,5,17455,4.336645962732919,20.0,0.0
24025,2,4025,[302 427 197 180 603],664,5,17460,4.336810730253354,20.0,0.0
24026,2,4026,[302 427 197 180 603],90,5,17465,4.336975415942389,20.0,0.0
24027,2,4027,[302 427 197 180 603],339,5,17470,4.337140019860973,20.0,0.0
24028,2,4028,[302 427 197 180 603],383,5,17475,4.337304542069993,20.0,0.0
24029,2,4029,[302 427 197 180 603],90,5,17480,4.337468982630273,20.0,0.0
24030,2,4030,[  9 151 655 132 210],334,3,17483,4.337137186802282,0.0,0.0
24031,2,4031,[302 427 197 180 603],90,5,17488,4.337301587301587,20.0,0.0
24032,2,4032,[302 427 197 180 603],339,5,17493,4.337465906273246,20.0,0.0
24033,2,4033,[302 427 197 180 603],271,5,17498,4.337630143777888,20.0,0.0
24034,2,4034,[302 427 197 180 603],13,5,17503,4.337794299876085,20.0,0.0
24035,2,4035,[302 427 197 180 603],13,5,17508,4.337958374628345,20.0,0.0
24036,2,4036,[302 427 197 180 603],90,5,17513,4.33812236809512,20.0,0.0
24037,2,4037,[302 427 197 180 603],537,5,17518,4.3382862803368,20.0,0.0
24038,2,4038,[ 15 546   9 265  28],447,2,17520,4.337707353305274,0.0,0.0
24039,2,4039,[302 427 197 180 603],339,5,17525,4.337871287128713,20.0,0.0
24040,2,4040,[302 427 197 180 603],474,5,17530,4.338035139816877,20.0,0.0
24041,2,4041,[302 427 197 180 603],90,5,17535,4.338198911429985,20.0,0.0
24042,2,4042,[302 427 197 180 603],13,5,17540,4.338362602028197,20.0,0.0
24043,2,4043,[234   4 475 655 173],339,5,17545,4.338526211671613,0.0,0.0
24044,2,4044,[302 427 197 180 603],474,5,17550,4.338689740420272,20.0,0.0
24045,2,4045,[202 475 655 118 471],13,3,17553,4.338358872960949,0.0,0.0
24046,2,4046,[302 427 197 180 603],537,5,17558,4.338522362243637,20.0,0.0
24047,2,4047,[100 423 568 183 294],774,1,17559,4.337697628458498,0.0,20.0
24048,2,4048,[143  25  71  56 181],843,0,17559,4.336626327488268,0.0,0.0
24049,2,4049,[ 79   7 151 216  95],554,3,17562,4.336296296296296,0.0,0.0
24050,2,4050,[ 50 328 237 181 204],13,4,17566,4.336213280671439,0.0,20.0
24051,2,4051,[302 427 197 180 603],339,5,17571,4.336377097729517,20.0,0.0
24052,2,4052,[302 427 197 180 603],339,5,17576,4.336540833950161,20.0,0.0
24053,2,4053,[302 427 197 180 603],13,5,17581,4.336704489393192,20.0,0.0
24054,2,4054,[748 228 125  15   1],200,4,17585,4.336621454993835,0.0,0.0
24055,2,4055,[302 427 197 180 603],537,5,17590,4.336785009861933,20.0,0.0
24056,2,4056,[302 427 197 180 603],383,5,17595,4.336948484101553,20.0,0.0
24057,2,4057,[ 97 546 282 597 191],533,2,17597,4.33637259733859,0.0,0.0
24058,2,4058,[302 427 197 180 603],383,5,17602,4.336536092633653,20.0,0.0
24059,2,4059,[302 427 197 180 603],664,5,17607,4.336699507389163,20.0,0.0
24060,2,4060,[302 427 197 180 603],90,5,17612,4.336862841664614,20.0,0.0
24061,2,4061,[302 427 197 180 603],664,5,17617,4.337026095519448,20.0,0.0
24062,2,4062,[ 28 132 143 268 269],85,4,17621,4.336943145459021,0.0,0.0
24063,2,4063,[ 79 182 385 216 234],538,3,17624,4.336614173228346,0.0,0.0
24064,2,4064,[302 427 197 180 603],664,5,17629,4.336777367773678,20.0,0.0
24065,2,4065,[302 427 197 180 603],271,5,17634,4.336940482046237,20.0,0.0
24066,2,4066,[ 11 655 546  69 153],339,5,17639,4.337103516105238,0.0,0.0
24067,2,4067,[302 427 197 180 603],537,5,17644,4.3372664700098325,20.0,0.0
24068,2,4068,[215 143 187 195 496],538,4,17648,4.337183583189973,0.0,0.0
24069,2,4069,[302 427 197 180 603],90,5,17653,4.337346437346437,20.0,0.0
24070,2,4070,[302 427 197 180 603],666,5,17658,4.337509211495947,20.0,0.0
24071,2,4071,[302 427 197 180 603],666,5,17663,4.337671905697446,20.0,0.0
24072,2,4072,[302 427 197 180 603],90,5,17668,4.337834520009821,20.0,0.0
24073,2,4073,[302 427 197 180 603],90,5,17673,4.3379970544918995,20.0,0.0
24074,2,4074,[302 427 197 180 603],383,5,17678,4.338159509202454,20.0,0.0
24075,2,4075,[237  22 496 228  82],295,5,17683,4.338321884200196,0.0,0.0
24076,2,4076,[302 427 197 180 603],339,5,17688,4.338484179543782,20.0,0.0
24077,2,4077,[302 427 197 180 603],474,5,17693,4.33864639529181,20.0,0.0
24078,2,4078,[211 210 302 100 196],13,4,17697,4.338563373375828,0.0,20.0
24079,2,4079,[302 427 197 180 603],383,5,17702,4.338725490196079,20.0,0.0
24080,2,4080,[403 300 275 215 568],328,2,17704,4.338152413624112,0.0,0.0
24081,2,4081,[302 427 197 180 603],537,5,17709,4.338314551690348,20.0,0.0
24082,2,4082,[357 515   7  15 181],406,4,17713,4.338231692383052,20.0,0.0
24083,2,4083,[302 427 197 180 603],271,5,17718,4.338393731635652,20.0,0.0
24084,2,4084,[322 435 276 172 269],537,1,17719,4.337576499388005,0.0,0.0
24085,2,4085,[179 216 318 204 597],308,3,17722,4.337249143416544,20.0,0.0
24086,2,4086,[568 151 300  98 202],7,4,17726,4.337166625886959,0.0,20.0
24087,2,4087,[302 427 197 180 603],271,5,17731,4.337328767123288,20.0,0.0
24088,2,4088,[302 427 197 180 603],383,5,17736,4.337490829053558,20.0,0.0
24089,2,4089,[302 427 197 180 603],664,5,17741,4.337652811735941,20.0,0.0
24090,2,4090,[302 427 197 180 603],664,5,17746,4.337814715228551,20.0,0.0
24091,2,4091,[265   8 245 161 204],313,3,17749,4.3374877810361685,0.0,0.0
24092,2,4092,[302 427 197 180 603],90,5,17754,4.337649645736623,20.0,0.0
24093,2,4093,[302 427 197 180 603],13,5,17759,4.3378114313629705,20.0,0.0
24094,2,4094,[302 427 197 180 603],383,5,17764,4.337973137973138,20.0,0.0
24095,2,4095,[302 427 197 180 603],90,5,17769,4.338134765625,20.0,0.0
24096,2,4096,[286 300   9  95  69],85,4,17773,4.338052233341469,0.0,0.0
24097,2,4097,[302 427 197 180 603],339,5,17778,4.338213762811128,20.0,0.0
24098,2,4098,[302 427 197 180 603],664,5,17783,4.3383752134666995,20.0,0.0
24099,2,4099,[302 427 197 180 603],339,5,17788,4.338536585365854,20.0,0.0
24100,2,4100,[302 427 197 180 603],537,5,17793,4.338697878566204,20.0,0.0
24101,2,4101,[302 427 197 180 603],13,5,17798,4.338859093125305,20.0,0.0
24102,2,4102,[302 427 197 180 603],537,5,17803,4.339020229100658,20.0,0.0
24103,2,4103,[302 427 197 180 603],90,5,17808,4.3391812865497075,20.0,0.0
24104,2,4104,[302 427 197 180 603],666,5,17813,4.339342265529842,20.0,0.0
24105,2,4105,[302 427 197 180 603],383,5,17818,4.3395031660983925,20.0,0.0
24106,2,4106,[302 427 197 180 603],271,5,17823,4.339663988312637,20.0,0.0
24107,2,4107,[302 427 197 180 603],664,5,17828,4.339824732229795,20.0,0.0
24108,2,4108,[301 234  88 186 144],378,3,17831,4.339498661474812,0.0,0.0
24109,2,4109,[302 427 197 180 603],13,5,17836,4.339659367396593,20.0,0.0
24110,2,4110,[161   8  28 196  95],334,2,17838,4.339090245682316,0.0,0.0
24111,2,4111,[302 427 197 180 603],383,5,17843,4.339250972762646,20.0,0.0
24112,2,4112,[302 427 197 180 603],666,5,17848,4.339411621687333,20.0,0.0
24113,2,4113,[302 427 197 180 603],537,5,17853,4.339572192513369,20.0,0.0
24114,2,4114,[302 427 197 180 603],664,5,17858,4.339732685297691,20.0,0.0
24115,2,4115,[302 427 197 180 603],537,5,17863,4.339893100097182,20.0,0.0
24116,2,4116,[302 427 197 180 603],666,5,17868,4.340053436968667,20.0,0.0
24117,2,4117,[302 427 197 180 603],474,5,17873,4.340213695968917,20.0,0.0
24118,2,4118,[302 427 197 180 603],339,5,17878,4.340373877154649,20.0,0.0
24119,2,4119,[302 427 197 180 603],13,5,17883,4.340533980582524,20.0,0.0
24120,2,4120,[302 427 197 180 603],271,5,17888,4.340694006309148,20.0,0.0
24121,2,4121,[ 71  56 202 273 186],92,4,17892,4.3406113537117905,0.0,0.0
24122,2,4122,[302 427 197 180 603],383,5,17897,4.340771283046325,20.0,0.0
24123,2,4123,[179 176 333 228  82],64,3,17900,4.340446168768186,0.0,0.0
24124,2,4124,[496 742 257 234 302],378,4,17904,4.340363636363636,0.0,0.0
24125,2,4125,[153 289 288   9 175],378,4,17908,4.3402811439650995,0.0,0.0
24126,2,4126,[302 427 197 180 603],537,5,17913,4.340440998303853,20.0,0.0
24127,2,4127,[194 182 200 144 180],843,0,17913,4.339389534883721,0.0,0.0
24128,2,4128,[302 427 197 180 603],666,5,17918,4.339549527730686,20.0,0.0
24129,2,4129,[302 427 197 180 603],271,5,17923,4.339709443099274,20.0,0.0
24130,2,4130,[195   1 748 238  22],653,4,17927,4.339627208908254,0.0,0.0
24131,2,4131,[302 427 197 180 603],666,5,17932,4.339787028073572,20.0,0.0
24132,2,4132,[ 79 357  96 300 271],749,5,17937,4.3399467699007985,20.0,0.0
24133,2,4133,[302 427 197 180 603],537,5,17942,4.340106434446057,20.0,0.0
24134,2,4134,[179 282 238 183  15],207,3,17945,4.339782345828295,0.0,0.0
24135,2,4135,[302 427 197 180 603],339,5,17950,4.3399419729206965,20.0,0.0
24136,2,4136,[183  64 181  97 153],659,4,17954,4.3398598017887355,0.0,0.0
24137,2,4137,[302 427 197 180 603],383,5,17959,4.340019333011116,20.0,0.0
24138,2,4138,[302 427 197 180 603],474,5,17964,4.3401787871466535,20.0,0.0
24139,2,4139,[302 427 197 180 603],383,5,17969,4.340338164251207,20.0,0.0
24140,2,4140,[302 427 197 180 603],271,5,17974,4.340497464380585,20.0,0.0
24141,2,4141,[302 427 197 180 603],13,5,17979,4.340656687590536,20.0,0.0
24142,2,4142,[210  11 405 300 234],271,3,17982,4.340333091962346,0.0,0.0
24143,2,4143,[185  64 294 275   4],308,4,17986,4.3402509652509655,0.0,0.0
24144,2,4144,[ 70  69 111 182 328],234,1,17987,4.3394451145958985,0.0,0.0
24145,2,4145,[ 98 202 276 135 405],378,2,17989,4.338880849011095,0.0,20.0
24146,2,4146,[125 185  71  64  82],42,5,17994,4.339040270074753,0.0,0.0
24147,2,4147,[357 196 197 282 276],474,5,17999,4.339199614271938,20.0,0.0
24148,2,4148,[302 427 197 180 603],666,5,18004,4.339358881658231,20.0,0.0
24149,2,4149,[302 427 197 180 603],666,5,18009,4.339518072289157,20.0,0.0
24150,2,4150,[302 427 197 180 603],474,5,18014,4.339677186220188,20.0,0.0
24151,2,4151,[302 427 197 180 603],664,5,18019,4.339836223506744,20.0,0.0
24152,2,4152,[302 427 197 180 603],537,5,18024,4.33999518420419,20.0,0.0
24153,2,4153,[302 427 197 180 603],474,5,18029,4.340154068367839,20.0,0.0
24154,2,4154,[302 427 197 180 603],271,5,18034,4.340312876052948,20.0,0.0
24155,2,4155,[271 289 427  28 655],537,1,18035,4.339509143407122,0.0,0.0
24156,2,4156,[144 175 196 435 183],650,4,18039,4.339427471734424,0.0,0.0
24157,2,4157,[302 427 197 180 603],666,5,18044,4.339586339586339,20.0,0.0
24158,2,4158,[302 427 197 180 603],271,5,18049,4.3397451310411155,20.0,0.0
24159,2,4159,[172 151 216 237  11],892,4,18053,4.3396634615384615,0.0,0.0
24160,2,4160,[216 405 265  95 125],92,2,18055,4.339101177601538,0.0,0.0
24161,2,4161,[302 427 197 180 603],666,5,18060,4.339259971167708,20.0,0.0
24162,2,4162,[302 427 197 180 603],664,5,18065,4.339418688445832,20.0,0.0
24163,2,4163,[302 427 197 180 603],271,5,18070,4.339577329490874,20.0,0.0
24164,2,4164,[302 427 197 180 603],537,5,18075,4.3397358943577435,20.0,0.0
24165,2,4165,[276   9 301 275 118],13,2,18077,4.3391742678828615,0.0,0.0
24166,2,4166,[ 25 187 132 200  96],881,1,18078,4.338372930165587,0.0,0.0
24167,2,4167,[302 427 197 180 603],664,5,18083,4.338531669865643,20.0,0.0
24168,2,4168,[302 427 197 180 603],474,5,18088,4.338690333413289,20.0,0.0
24169,2,4169,[302 427 197 180 603],537,5,18093,4.33884892086331,20.0,0.0
24170,2,4170,[143  79 515 237  70],234,1,18094,4.338048429633181,0.0,0.0
24171,2,4171,[302 427 197 180 603],271,5,18099,4.338207094918505,20.0,0.0
24172,2,4172,[265  70  56 496 191],804,4,18103,4.338126048406422,0.0,0.0
24173,2,4173,[302 427 197 180 603],664,5,18108,4.338284619070436,20.0,0.0
24174,2,4174,[302 427 197 180 603],666,5,18113,4.338443113772455,20.0,0.0
24175,2,4175,[302 427 197 180 603],474,5,18118,4.33860153256705,20.0,0.0
24176,2,4176,[568 196 322 174 118],374,4,18122,4.338520469236294,0.0,20.0
24177,2,4177,[302 427 197 180 603],90,5,18127,4.338678793681187,20.0,0.0
24178,2,4178,[302 427 197 180 603],383,5,18132,4.33883704235463,20.0,0.0
24179,2,4179,[302 427 197 180 603],664,5,18137,4.338995215311005,20.0,0.0
24180,2,4180,[302 427 197 180 603],271,5,18142,4.33915331260464,20.0,0.0
24181,2,4181,[333  11 211 678 403],13,1,18143,4.338354854136776,0.0,0.0
24182,2,4182,[302 427 197 180 603],383,5,18148,4.338513028926608,20.0,0.0
24183,2,4183,[302 427 197 180 603],666,5,18153,4.338671128107075,20.0,0.0
24184,2,4184,[302 427 197 180 603],271,5,18158,4.338829151732377,20.0,0.0
24185,2,4185,[302 427 197 180 603],90,5,18163,4.338987099856665,20.0,0.0
24186,2,4186,[302 427 197 180 603],666,5,18168,4.339144972534034,20.0,0.0
24187,2,4187,[302 427 197 180 603],339,5,18173,4.339302769818529,20.0,0.0
24188,2,4188,[302 427 197 180 603],666,5,18178,4.339460491764144,20.0,0.0
24189,2,4189,[ 98 187 161 143 435],313,4,18182,4.339379474940334,0.0,20.0
24190,2,4190,[125 435 153 161 132],7,4,18186,4.339298496778811,0.0,0.0
24191,2,4191,[ 50  25 210  97 211],85,2,18188,4.338740458015267,0.0,20.0
24192,2,4192,[302 427 197 180 603],474,5,18193,4.33889816360601,20.0,0.0
24193,2,4193,[135 435 301 237 182],378,3,18196,4.338578922269909,0.0,0.0
24194,2,4194,[568 496 273  79 200],749,5,18201,4.338736591179976,0.0,0.0
24195,2,4195,[302 427 197 180 603],271,5,18206,4.338894184938036,20.0,0.0
24196,2,4196,[302 427 197 180 603],666,5,18211,4.339051703597808,20.0,0.0
24197,2,4197,[302 427 197 180 603],90,5,18216,4.339209147212959,20.0,0.0
24198,2,4198,[302 427 197 180 603],13,5,18221,4.339366515837104,20.0,0.0
24199,2,4199,[288 588 286 234 235],200,4,18225,4.339285714285714,0.0,0.0
24200,2,4200,[302 427 197 180 603],383,5,18230,4.339442989764342,20.0,0.0
24201,2,4201,[196 313 748 300 588],13,4,18234,4.339362208472156,0.0,0.0
24202,2,4202,[302 427 197 180 603],537,5,18239,4.339519390911254,20.0,0.0
24203,2,4203,[302 427 197 180 603],271,5,18244,4.339676498572788,20.0,0.0
24204,2,4204,[302 427 197 180 603],664,5,18249,4.339833531510107,20.0,0.0
24205,2,4205,[ 15  88 200  96 265],378,4,18253,4.339752734189253,0.0,0.0
24206,2,4206,[302 427 197 180 603],271,5,18258,4.33990967435227,20.0,0.0
24207,2,4207,[302 427 197 180 603],383,5,18263,4.340066539923955,20.0,0.0
24208,2,4208,[302 427 197 180 603],664,5,18268,4.340223330957472,20.0,0.0
24209,2,4209,[196 180  64 153  95],804,4,18272,4.340142517814727,0.0,0.0
24210,2,4210,[423  79 118 153 496],479,2,18274,4.339586796485396,0.0,0.0
24211,2,4211,[302 427 197 180 603],537,5,18279,4.339743589743589,20.0,0.0
24212,2,4212,[302 427 197 180 603],271,5,18284,4.339900308568716,20.0,0.0
24213,2,4213,[302 427 197 180 603],339,5,18289,4.340056953013764,20.0,0.0
24214,2,4214,[302 427 197 180 603],666,5,18294,4.3402135231316725,20.0,0.0
24215,2,4215,[302 427 197 180 603],339,5,18299,4.3403700189753325,20.0,0.0
24216,2,4216,[302 427 197 180 603],271,5,18304,4.340526440597581,20.0,0.0
24217,2,4217,[302 427 197 180 603],664,5,18309,4.340682788051209,20.0,0.0
24218,2,4218,[302 427 197 180 603],664,5,18314,4.340839061388955,20.0,0.0
24219,2,4219,[302 427 197 180 603],664,5,18319,4.340995260663507,20.0,0.0
24220,2,4220,[302 427 197 180 603],664,5,18324,4.341151385927505,20.0,0.0
24221,2,4221,[302 427 197 180 603],474,5,18329,4.341307437233539,20.0,0.0
24222,2,4222,[423  98 153 483 196],815,5,18334,4.341463414634147,20.0,20.0
24223,2,4223,[302 427 197 180 603],537,5,18339,4.341619318181818,20.0,0.0
24224,2,4224,[ 56 235 302 117 328],537,2,18341,4.3410650887573965,0.0,0.0
24225,2,4225,[496 191  50 237 161],295,5,18346,4.341221012778041,0.0,20.0
24226,2,4226,[302 427 197 180 603],474,5,18351,4.341376863023421,20.0,0.0
24227,2,4227,[302 427 197 180 603],339,5,18356,4.341532639545885,20.0,0.0
24228,2,4228,[302 427 197 180 603],474,5,18361,4.34168834239773,20.0,0.0
24229,2,4229,[302 427 197 180 603],664,5,18366,4.341843971631206,20.0,0.0
24230,2,4230,[302 427 197 180 603],339,5,18371,4.341999527298511,20.0,0.0
24231,2,4231,[302 427 197 180 603],13,5,18376,4.342155009451796,20.0,0.0
24232,2,4232,[302 427 197 180 603],271,5,18381,4.342310418143161,20.0,0.0
24233,2,4233,[302 427 197 180 603],271,5,18386,4.342465753424658,20.0,0.0
24234,2,4234,[  4   1 313 197 172],189,4,18390,4.342384887839433,0.0,0.0
24235,2,4235,[302 427 197 180 603],474,5,18395,4.342540132200189,20.0,0.0
24236,2,4236,[195 276 144  25  69],194,2,18397,4.341987255133349,0.0,0.0
24237,2,4237,[302 427 197 180 603],90,5,18402,4.342142520056631,20.0,0.0
24238,2,4238,[161  28  89 181  22],308,3,18405,4.341825902335456,0.0,0.0
24239,2,4239,[302 427 197 180 603],383,5,18410,4.341981132075472,20.0,0.0
24240,2,4240,[302 427 197 180 603],537,5,18415,4.342136288611177,20.0,0.0
24241,2,4241,[196 191   9 603 405],271,4,18419,4.342055634134842,20.0,0.0
24242,2,4242,[191 121 235 423 200],92,2,18421,4.341503653075654,0.0,0.0
24243,2,4243,[302 427 197 180 603],13,5,18426,4.341658812441094,20.0,0.0
24244,2,4244,[302 427 197 180 603],666,5,18431,4.341813898704358,20.0,0.0
24245,2,4245,[302 427 197 180 603],90,5,18436,4.341968911917099,20.0,0.0
24246,2,4246,[302 427 197 180 603],90,5,18441,4.342123852130916,20.0,0.0
24247,2,4247,[ 12 568  69 258 273],59,3,18444,4.34180790960452,20.0,0.0
24248,2,4248,[302 427 197 180 603],271,5,18449,4.341962814779948,20.0,0.0
24249,2,4249,[302 427 197 180 603],537,5,18454,4.342117647058823,20.0,0.0
24250,2,4250,[302 427 197 180 603],666,5,18459,4.34227240649259,20.0,0.0
24251,2,4251,[204 258  98 202 245],653,2,18461,4.341721542803387,0.0,20.0
24252,2,4252,[302 427 197 180 603],383,5,18466,4.341876322595815,20.0,0.0
24253,2,4253,[302 427 197 180 603],90,5,18471,4.342031029619182,20.0,0.0
24254,2,4254,[187 100 121 195 515],638,3,18474,4.3417156286721506,0.0,20.0
24255,2,4255,[302 427 197 180 603],474,5,18479,4.3418703007518795,20.0,0.0
24256,2,4256,[302 427 197 180 603],90,5,18484,4.342024900164435,20.0,0.0
24257,2,4257,[302 427 197 180 603],271,5,18489,4.342179426961015,20.0,0.0
24258,2,4258,[121 235   1 471 405],141,2,18491,4.3416294904907256,0.0,0.0
24259,2,4259,[194 195 568 111 496],95,5,18496,4.341784037558686,0.0,0.0
24260,2,4260,[265 435  82 496 210],64,3,18499,4.341469138699836,0.0,0.0
24261,2,4261,[302 427 197 180 603],90,5,18504,4.341623650868137,20.0,0.0
24262,2,4262,[174 405 234 328  50],833,0,18504,4.340605207600282,0.0,40.0
24263,2,4263,[ 70 195  71 216 742],648,3,18507,4.340290806754221,0.0,0.0
24264,2,4264,[302 427 197 180 603],537,5,18512,4.340445486518171,20.0,0.0
24265,2,4265,[288 423   9 174 118],648,4,18516,4.3403656821378345,0.0,20.0
24266,2,4266,[302 427 197 180 603],537,5,18521,4.340520271853761,20.0,0.0
24267,2,4267,[302 427 197 180 603],13,5,18526,4.340674789128397,20.0,0.0
24268,2,4268,[357 546 322 301  89],788,3,18529,4.340360740220192,20.0,0.0
24269,2,4269,[ 79 471 496 215 194],653,1,18530,4.339578454332552,0.0,0.0
24270,2,4270,[357 496 333 265 238],666,3,18533,4.339264809178179,20.0,0.0
24271,2,4271,[546  28 183 204 211],882,4,18537,4.339185393258427,0.0,0.0
24272,2,4272,[302 427 197 180 603],271,5,18542,4.339340042124971,20.0,0.0
24273,2,4273,[302 427 197 180 603],339,5,18547,4.33949461862424,20.0,0.0
24274,2,4274,[302 427 197 180 603],90,5,18552,4.3396491228070175,20.0,0.0
24275,2,4275,[302 427 197 180 603],271,5,18557,4.339803554724041,20.0,0.0
24276,2,4276,[237  70 215 211 483],7,4,18561,4.339724105681553,20.0,0.0
24277,2,4277,[302 427 197 180 603],339,5,18566,4.339878447872838,20.0,0.0
24278,2,4278,[143 318 200  88 195],474,4,18570,4.339799018462258,20.0,0.0
24279,2,4279,[302 427 197 180 603],537,5,18575,4.339953271028038,20.0,0.0
24280,2,4280,[302 427 197 180 603],13,5,18580,4.340107451530017,20.0,0.0
24281,2,4281,[302 427 197 180 603],537,5,18585,4.340261560018683,20.0,0.0
24282,2,4282,[  7 235   1  25 435],339,4,18589,4.340182115339715,0.0,0.0
24283,2,4283,[302 427 197 180 603],271,5,18594,4.340336134453781,20.0,0.0
24284,2,4284,[302 427 197 180 603],474,5,18599,4.34049008168028,20.0,0.0
24285,2,4285,[302 427 197 180 603],474,5,18604,4.3406439570695285,20.0,0.0
24286,2,4286,[302 427 197 180 603],383,5,18609,4.340797760671799,20.0,0.0
24287,2,4287,[302 427 197 180 603],383,5,18614,4.340951492537314,20.0,0.0
24288,2,4288,[302 427 197 180 603],474,5,18619,4.341105152716251,20.0,0.0
24289,2,4289,[302 427 197 180 603],271,5,18624,4.341258741258741,20.0,0.0
24290,2,4290,[302 427 197 180 603],339,5,18629,4.341412258214868,20.0,0.0
24291,2,4291,[302 427 197 180 603],383,5,18634,4.341565703634669,20.0,0.0
24292,2,4292,[302 427 197 180 603],339,5,18639,4.3417190775681345,20.0,0.0
24293,2,4293,[302 427 197 180 603],383,5,18644,4.341872380065207,20.0,0.0
24294,2,4294,[202  22 191 265  97],313,4,18648,4.3417927823050055,0.0,0.0
24295,2,4295,[235 603 515  79 183],537,2,18650,4.3412476722532585,20.0,0.0
24296,2,4296,[258 135   7  89 176],890,4,18654,4.341168256923435,0.0,0.0
24297,2,4297,[302 427 197 180 603],339,5,18659,4.3413215449046065,20.0,0.0
24298,2,4298,[302 427 197 180 603],13,5,18664,4.341474761572459,20.0,0.0
24299,2,4299,[302 427 197 180 603],666,5,18669,4.341627906976744,20.0,0.0
24300,2,4300,[302 427 197 180 603],271,5,18674,4.341780981167171,20.0,0.0
24301,2,4301,[302 427 197 180 603],537,5,18679,4.341933984193399,20.0,0.0
24302,2,4302,[302 427 197 180 603],664,5,18684,4.342086916105043,20.0,0.0
24303,2,4303,[302 427 197 180 603],537,5,18689,4.342239776951673,20.0,0.0
24304,2,4304,[234 182  95  50 121],378,5,18694,4.34239256678281,0.0,20.0
24305,2,4305,[302 427 197 180 603],666,5,18699,4.342545285647933,20.0,0.0
24306,2,4306,[302 427 197 180 603],666,5,18704,4.342697933596471,20.0,0.0
24307,2,4307,[302 427 197 180 603],664,5,18709,4.342850510677809,20.0,0.0
24308,2,4308,[302 427 197 180 603],537,5,18714,4.343003016941286,20.0,0.0
24309,2,4309,[302 427 197 180 603],666,5,18719,4.343155452436195,20.0,0.0
24310,2,4310,[302 427 197 180 603],90,5,18724,4.343307817211784,20.0,0.0
24311,2,4311,[302 427 197 180 603],383,5,18729,4.343460111317254,20.0,0.0
24312,2,4312,[302 427 197 180 603],90,5,18734,4.343612334801762,20.0,0.0
24313,2,4313,[302 427 197 180 603],537,5,18739,4.343764487714418,20.0,0.0
24314,2,4314,[302 427 197 180 603],271,5,18744,4.3439165701042874,20.0,0.0
24315,2,4315,[195 597 234   1 175],804,4,18748,4.343836886005561,0.0,0.0
24316,2,4316,[302 427 197 180 603],13,5,18753,4.343988881167477,20.0,0.0
24317,2,4317,[302 427 197 180 603],339,5,18758,4.344140805928671,20.0,0.0
24318,2,4318,[151 403 202 111 194],42,3,18761,4.343829590182913,0.0,0.0
24319,2,4319,[302 427 197 180 603],13,5,18766,4.343981481481482,20.0,0.0
24320,2,4320,[302 427 197 180 603],383,5,18771,4.344133302476279,20.0,0.0
24321,2,4321,[302 427 197 180 603],339,5,18776,4.344285053216104,20.0,0.0
24322,2,4322,[471  96 302  88 174],13,4,18780,4.344205412907703,0.0,20.0
24323,2,4323,[302 427 197 180 603],666,5,18785,4.344357076780758,20.0,0.0
24324,2,4324,[302 427 197 180 603],666,5,18790,4.344508670520232,20.0,0.0
24325,2,4325,[  4  79 216 197 144],666,2,18792,4.343966712898752,0.0,0.0
24326,2,4326,[302 427 197 180 603],13,5,18797,4.344118326785302,20.0,0.0
24327,2,4327,[302 427 197 180 603],339,5,18802,4.344269870609981,20.0,0.0
24328,2,4328,[210 181 568  50  89],749,5,18807,4.344421344421344,0.0,20.0
24329,2,4329,[302 427 197 180 603],664,5,18812,4.344572748267899,20.0,0.0
24330,2,4330,[ 12  11 496 117 235],334,2,18814,4.344031401523898,20.0,0.0
24331,2,4331,[302 427 197 180 603],271,5,18819,4.344182825484765,20.0,0.0
24332,2,4332,[302 427 197 180 603],271,5,18824,4.344334179552273,20.0,0.0
24333,2,4333,[ 22   8 333 151 515],64,3,18827,4.34402399630826,0.0,0.0
24334,2,4334,[302 427 197 180 603],90,5,18832,4.344175317185698,20.0,0.0
24335,2,4335,[273  98 271  70 568],13,1,18833,4.343404059040591,0.0,20.0
24336,2,4336,[300 588 222 195 168],479,3,18836,4.343094304818999,0.0,0.0
24337,2,4337,[238 276 234 742   7],458,5,18841,4.343245735361918,0.0,0.0
24338,2,4338,[302 427 197 180 603],13,5,18846,4.343397096105093,20.0,0.0
24339,2,4339,[302 427 197 180 603],90,5,18851,4.343548387096774,20.0,0.0
24340,2,4340,[302 427 197 180 603],474,5,18856,4.3436996083851644,20.0,0.0
24341,2,4341,[302 427 197 180 603],90,5,18861,4.343850760018425,20.0,0.0
24342,2,4342,[302 427 197 180 603],666,5,18866,4.34400184204467,20.0,0.0
24343,2,4343,[228  82  98 151 204],650,3,18869,4.343692449355433,0.0,20.0
24344,2,4344,[302 427 197 180 603],339,5,18874,4.343843498273878,20.0,0.0
24345,2,4345,[323 222  11 185  89],328,2,18876,4.343304187758859,0.0,0.0
24346,2,4346,[302 427 197 180 603],13,5,18881,4.343455256498735,20.0,0.0
24347,2,4347,[302 427 197 180 603],339,5,18886,4.34360625574977,20.0,0.0
24348,2,4348,[405 161 135  95 200],95,0,18886,4.342607495976086,0.0,0.0
24349,2,4349,[302 427 197 180 603],13,5,18891,4.342758620689655,20.0,0.0
24350,2,4350,[302 427 197 180 603],664,5,18896,4.342909675936566,20.0,0.0
24351,2,4351,[302 427 197 180 603],666,5,18901,4.343060661764706,20.0,0.0
24352,2,4352,[143 655 210 111   4],378,3,18904,4.342752124971284,0.0,0.0
24353,2,4353,[204 427 423  22 181],527,4,18908,4.342673403766652,0.0,0.0
24354,2,4354,[302 427 197 180 603],13,5,18913,4.342824339839265,20.0,0.0
24355,2,4355,[ 89 245 568  11  12],378,3,18916,4.342516069788797,20.0,0.0
24356,2,4356,[588 210  28 288 211],479,3,18919,4.342207941243975,0.0,0.0
24357,2,4357,[302 427 197 180 603],271,5,18924,4.342358880220284,20.0,0.0
24358,2,4358,[302 427 197 180 603],271,5,18929,4.342509749942647,20.0,0.0
24359,2,4359,[204 215  69 175 357],788,2,18931,4.34197247706422,20.0,0.0
24360,2,4360,[302 427 197 180 603],271,5,18936,4.342123366200413,20.0,0.0
24361,2,4361,[302 427 197 180 603],537,5,18941,4.342274186153141,20.0,0.0
24362,2,4362,[302 427 197 180 603],383,5,18946,4.342424936969975,20.0,0.0
24363,2,4363,[265 328  71  82 222],234,0,18946,4.341429880843263,0.0,0.0
24364,2,4364,[211 183 228 238 194],312,3,18949,4.341122565864834,0.0,0.0
24365,2,4365,[603 187  97 117 423],233,4,18953,4.341044434264774,20.0,0.0
24366,2,4366,[302 427 197 180 603],339,5,18958,4.34119532860087,20.0,0.0
24367,2,4367,[302 427 197 180 603],90,5,18963,4.341346153846154,20.0,0.0
24368,2,4368,[302 427 197 180 603],90,5,18968,4.341496910048066,20.0,0.0
24369,2,4369,[180 323 603 597 100],13,3,18971,4.341189931350114,20.0,20.0
24370,2,4370,[ 56 100 228 294 435],328,3,18974,4.340883093113704,0.0,20.0
24371,2,4371,[302 427 197 180 603],339,5,18979,4.34103385178408,20.0,0.0
24372,2,4372,[302 427 197 180 603],13,5,18984,4.3411845415046875,20.0,0.0
24373,2,4373,[302 427 197 180 603],664,5,18989,4.3413351623228165,20.0,0.0
24374,2,4374,[405 286 435 210 176],102,0,18989,4.340342857142857,0.0,0.0
24375,2,4375,[176 121 204 222 153],738,5,18994,4.340493601462523,0.0,0.0
24376,2,4376,[302 427 197 180 603],383,5,18999,4.340644276901988,20.0,0.0
24377,2,4377,[302 427 197 180 603],664,5,19004,4.340794883508451,20.0,0.0
24378,2,4378,[302 427 197 180 603],666,5,19009,4.340945421329071,20.0,0.0
24379,2,4379,[302 427 197 180 603],666,5,19014,4.341095890410959,20.0,0.0
24380,2,4380,[357 258 603   8 161],387,4,19018,4.341018032412691,40.0,0.0
24381,2,4381,[302 427 197 180 603],90,5,19023,4.341168416248289,20.0,0.0
24382,2,4382,[302 427 197 180 603],664,5,19028,4.341318731462469,20.0,0.0
24383,2,4383,[302 427 197 180 603],13,5,19033,4.341468978102189,20.0,0.0
24384,2,4384,[302 427 197 180 603],383,5,19038,4.341619156214367,20.0,0.0
24385,2,4385,[191 294 238 515 118],881,3,19041,4.341313269493844,0.0,0.0
24386,2,4386,[427 546 235 323 294],328,0,19041,4.340323683610668,0.0,0.0
24387,2,4387,[678 238  50 174 185],339,4,19045,4.34024612579763,0.0,40.0
24388,2,4388,[186 483 176 111 200],13,3,19048,4.339940760993392,20.0,0.0
24389,2,4389,[175 508 435 183 187],6,4,19052,4.3398633257403185,0.0,0.0
24390,2,4390,[302 427 197 180 603],666,5,19057,4.340013664313369,20.0,0.0
24391,2,4391,[302 427 197 180 603],339,5,19062,4.340163934426229,20.0,0.0
24392,2,4392,[302 427 197 180 603],271,5,19067,4.340314136125654,20.0,0.0
24393,2,4393,[568 435 289 508 172],125,4,19071,4.340236686390533,0.0,0.0
24394,2,4394,[302 427 197 180 603],666,5,19076,4.340386803185438,20.0,0.0
24395,2,4395,[302 427 197 180 603],13,5,19081,4.340536851683349,20.0,0.0
24396,2,4396,[ 69 282 117 180  64],406,4,19085,4.340459404139186,0.0,0.0
24397,2,4397,[742 265 197 483 323],59,4,19089,4.3403819918144615,20.0,0.0
24398,2,4398,[302 427 197 180 603],271,5,19094,4.340531939077063,20.0,0.0
24399,2,4399,[302 427 197 180 603],13,5,19099,4.340681818181818,20.0,0.0
24400,2,4400,[302 427 197 180 603],666,5,19104,4.340831629175187,20.0,0.0
24401,2,4401,[302 427 197 180 603],383,5,19109,4.340981372103589,20.0,0.0
24402,2,4402,[174 328  88 238 318],92,2,19111,4.34044969339087,20.0,20.0
24403,2,4403,[302 427 197 180 603],383,5,19116,4.340599455040872,20.0,0.0
24404,2,4404,[302 427 197 180 603],474,5,19121,4.340749148694665,20.0,0.0
24405,2,4405,[302 427 197 180 603],13,5,19126,4.340898774398547,20.0,0.0
24406,2,4406,[172 275 127  25 357],308,5,19131,4.341048332198775,20.0,20.0
24407,2,4407,[ 28 216 173 179  69],474,5,19136,4.34119782214156,0.0,0.0
24408,2,4408,[175 200 172 235 427],833,3,19139,4.340893626672715,0.0,0.0
24409,2,4409,[302 427 197 180 603],271,5,19144,4.341043083900227,20.0,0.0
24410,2,4410,[302 427 197 180 603],271,5,19149,4.3411924733620495,20.0,0.0
24411,2,4411,[125  97 144 161   4],64,0,19149,4.340208522212149,0.0,0.0
24412,2,4412,[302 427 197 180 603],474,5,19154,4.34035803308407,20.0,0.0
24413,2,4413,[302 427 197 180 603],664,5,19159,4.340507476212053,20.0,0.0
24414,2,4414,[258 179  88 118 176],378,4,19163,4.340430351075877,0.0,0.0
24415,2,4415,[265 191 357 187   8],311,5,19168,4.340579710144928,20.0,0.0
24416,2,4416,[  4 333 294 144 238],10,4,19172,4.340502603577089,0.0,0.0
24417,2,4417,[302 427 197 180 603],271,5,19177,4.340651878678135,20.0,0.0
24418,2,4418,[181 405 385  96 100],488,2,19179,4.340122199592668,0.0,20.0
24419,2,4419,[151  28 423  11 222],892,4,19183,4.340045248868778,0.0,0.0
24420,2,4420,[302 427 197 180 603],339,5,19188,4.340194526125311,20.0,0.0
24421,2,4421,[302 427 197 180 603],13,5,19193,4.340343735866124,20.0,0.0
24422,2,4422,[302 427 197 180 603],666,5,19198,4.340492878137011,20.0,0.0
24423,2,4423,[204 121  95 265  98],881,5,19203,4.3406419529837255,0.0,20.0
24424,2,4424,[302 427 197 180 603],13,5,19208,4.340790960451978,20.0,0.0
24425,2,4425,[ 28 143  98 496 121],59,4,19212,4.340713962946227,0.0,20.0
24426,2,4426,[302 427 197 180 603],271,5,19217,4.340862886830811,20.0,0.0
24427,2,4427,[302 427 197 180 603],339,5,19222,4.341011743450768,20.0,0.0
24428,2,4428,[302 427 197 180 603],537,5,19227,4.341160532851659,20.0,0.0
24429,2,4429,[302 427 197 180 603],271,5,19232,4.341309255079007,20.0,0.0
24430,2,4430,[302 427 197 180 603],339,5,19237,4.341457910178289,20.0,0.0
24431,2,4431,[302 427 197 180 603],339,5,19242,4.341606498194946,20.0,0.0
24432,2,4432,[195  15 313 357 257],308,3,19245,4.34130385743289,20.0,0.0
24433,2,4433,[302 427 197 180 603],537,5,19250,4.341452413170952,20.0,0.0
24434,2,4434,[302 427 197 180 603],666,5,19255,4.341600901916573,20.0,0.0
24435,2,4435,[286 179 257 323 258],378,3,19258,4.341298467087467,0.0,0.0
24436,2,4436,[302 427 197 180 603],474,5,19263,4.341446923597025,20.0,0.0
24437,2,4437,[302 427 197 180 603],339,5,19268,4.341595313204146,20.0,0.0
24438,2,4438,[302 427 197 180 603],383,5,19273,4.341743635954043,20.0,0.0
24439,2,4439,[302 427 197 180 603],474,5,19278,4.341891891891892,20.0,0.0
24440,2,4440,[302 427 197 180 603],474,5,19283,4.342040081062824,20.0,0.0
24441,2,4441,[ 69 257  22 174 187],334,4,19287,4.341963079693832,0.0,20.0
24442,2,4442,[302 427 197 180 603],383,5,19292,4.342111186135494,20.0,0.0
24443,2,4443,[302 427 197 180 603],339,5,19297,4.342259225922592,20.0,0.0
24444,2,4444,[302 427 197 180 603],90,5,19302,4.342407199100112,20.0,0.0
24445,2,4445,[302 427 197 180 603],474,5,19307,4.342555105713,20.0,0.0
24446,2,4446,[127 313 258 180 191],738,5,19312,4.3427029458061615,0.0,20.0
24447,2,4447,[302 427 197 180 603],537,5,19317,4.342850719424461,20.0,0.0
24448,2,4448,[302 427 197 180 603],666,5,19322,4.342998426612722,20.0,0.0
24449,2,4449,[302 427 197 180 603],474,5,19327,4.343146067415731,20.0,0.0
24450,2,4450,[302 427 197 180 603],537,5,19332,4.34329364187823,20.0,0.0
24451,2,4451,[302 427 197 180 603],90,5,19337,4.3434411500449235,20.0,0.0
24452,2,4452,[603 385 204 300 313],13,3,19340,4.343139456546148,20.0,0.0
24453,2,4453,[302 427 197 180 603],90,5,19345,4.343286933093848,20.0,0.0
24454,2,4454,[238 265  25 176  96],308,4,19349,4.3432098765432094,0.0,0.0
24455,2,4455,[302 427 197 180 603],666,5,19354,4.343357271095153,20.0,0.0
24456,2,4456,[302 427 197 180 603],474,5,19359,4.343504599506394,20.0,0.0
24457,2,4457,[748 238 318 237 273],64,3,19362,4.343203230148048,20.0,0.0
24458,2,4458,[302 427 197 180 603],537,5,19367,4.343350527023996,20.0,0.0
24459,2,4459,[302 427 197 180 603],90,5,19372,4.343497757847533,20.0,0.0
24460,2,4460,[302 427 197 180 603],383,5,19377,4.34364492266308,20.0,0.0
24461,2,4461,[302 427 197 180 603],666,5,19382,4.343792021515016,20.0,0.0
24462,2,4462,[302 427 197 180 603],664,5,19387,4.343939054447681,20.0,0.0
24463,2,4463,[197 286 483 302 475],334,5,19392,4.344086021505376,20.0,0.0
24464,2,4464,[302 427 197 180 603],383,5,19397,4.344232922732362,20.0,0.0
24465,2,4465,[302 427 197 180 603],474,5,19402,4.344379758172861,20.0,0.0
24466,2,4466,[333 211 322 194 168],13,3,19405,4.344078800089545,0.0,0.0
24467,2,4467,[302 427 197 180 603],339,5,19410,4.3442256042972245,20.0,0.0
24468,2,4468,[302 427 197 180 603],271,5,19415,4.344372342805997,20.0,0.0
24469,2,4469,[182 210 237 118 181],308,3,19418,4.344071588366891,0.0,0.0
24470,2,4470,[302 427 197 180 603],666,5,19423,4.344218295683293,20.0,0.0
24471,2,4471,[302 427 197 180 603],474,5,19428,4.344364937388193,20.0,0.0
24472,2,4472,[302 427 197 180 603],537,5,19433,4.344511513525598,20.0,0.0
24473,2,4473,[302 427 197 180 603],271,5,19438,4.3446580241394726,20.0,0.0
24474,2,4474,[302 427 197 180 603],537,5,19443,4.344804469273743,20.0,0.0
24475,2,4475,[302 427 197 180 603],666,5,19448,4.344950848972297,20.0,0.0
24476,2,4476,[302 427 197 180 603],271,5,19453,4.345097163278981,20.0,0.0
24477,2,4477,[216  22 269 427 294],288,4,19457,4.345020098258151,0.0,0.0
24478,2,4478,[302 427 197 180 603],474,5,19462,4.345166331770485,20.0,0.0
24479,2,4479,[302 427 197 180 603],664,5,19467,4.3453125,20.0,0.0
24480,2,4480,[302 427 197 180 603],666,5,19472,4.345458602990404,20.0,0.0
24481,2,4481,[302 427 197 180 603],383,5,19477,4.345604640785363,20.0,0.0
24482,2,4482,[302 427 197 180 603],474,5,19482,4.345750613428508,20.0,0.0
24483,2,4483,[186 508 183 258 196],339,4,19486,4.345673505798394,0.0,0.0
24484,2,4484,[ 88 471 202 603 385],533,5,19491,4.345819397993311,20.0,0.0
24485,2,4485,[276  28 300 172 471],537,1,19492,4.345073562193491,0.0,0.0
24486,2,4486,[302 427 197 180 603],537,5,19497,4.345219523066637,20.0,0.0
24487,2,4487,[302 427 197 180 603],666,5,19502,4.345365418894831,20.0,0.0
24488,2,4488,[318 172  89 153 237],374,2,19504,4.3448429494319445,20.0,0.0
24489,2,4489,[258 174  56 100 471],92,5,19509,4.344988864142539,0.0,40.0
24490,2,4490,[275 228 153   8  79],343,5,19514,4.345134713872189,0.0,0.0
24491,2,4491,[211 322 318 546 597],328,2,19516,4.344612644701692,20.0,0.0
24492,2,4492,[302 427 197 180 603],90,5,19521,4.344758513242822,20.0,0.0
24493,2,4493,[302 427 197 180 603],383,5,19526,4.344904316866934,20.0,0.0
24494,2,4494,[143 276  56 318  82],13,2,19528,4.344382647385984,20.0,0.0
24495,2,4495,[302 427 197 180 603],271,5,19533,4.344528469750889,20.0,0.0
24496,2,4496,[ 89 197 258 294  71],479,3,19536,4.344229486324216,0.0,0.0
24497,2,4497,[302 427 197 180 603],666,5,19541,4.34437527790129,20.0,0.0
24498,2,4498,[302 427 197 180 603],383,5,19546,4.344521004667704,20.0,0.0
24499,2,4499,[302 427 197 180 603],474,5,19551,4.344666666666667,20.0,0.0
24500,2,4500,[286 475  69  56 302],13,3,19554,4.344367918240391,0.0,0.0
24501,2,4501,[302 427 197 180 603],666,5,19559,4.3445135495335405,20.0,0.0
24502,2,4502,[117  95 423 191 196],13,3,19562,4.344214967799245,0.0,0.0
24503,2,4503,[196 588 179 135  82],95,1,19563,4.343472468916518,0.0,0.0
24504,2,4504,[302 427 197 180 603],537,5,19568,4.3436182019977805,20.0,0.0
24505,2,4505,[302 427 197 180 603],664,5,19573,4.343763870395029,20.0,0.0
24506,2,4506,[302 427 197 180 603],666,5,19578,4.34390947415132,20.0,0.0
24507,2,4507,[302 427 197 180 603],271,5,19583,4.344055013309672,20.0,0.0
24508,2,4508,[427 132  96 423 185],90,5,19588,4.344200487913063,0.0,0.0
24509,2,4509,[302 427 197 180 603],90,5,19593,4.344345898004435,20.0,0.0
24510,2,4510,[302 427 197 180 603],383,5,19598,4.34449124362669,20.0,0.0
24511,2,4511,[302 427 197 180 603],271,5,19603,4.344636524822695,20.0,0.0
24512,2,4512,[  7 111 121 125   9],26,2,19605,4.344116995346776,0.0,0.0
24513,2,4513,[  1  15 423 286  96],648,3,19608,4.34381922906513,0.0,0.0
24514,2,4514,[ 89  69 191 210 175],334,3,19611,4.343521594684385,0.0,0.0
24515,2,4515,[302 427 197 180 603],537,5,19616,4.343666961913198,20.0,0.0
24516,2,4516,[286  11 132 172 475],119,5,19621,4.343812264777507,0.0,0.0
24517,2,4517,[302 427 197 180 603],13,5,19626,4.343957503320053,20.0,0.0
24518,2,4518,[435 151 300 288   8],892,5,19631,4.344102677583536,0.0,0.0
24519,2,4519,[132  11 300 143 194],499,3,19634,4.343805309734513,0.0,0.0
24520,2,4520,[302 427 197 180 603],664,5,19639,4.343950453439504,20.0,0.0
24521,2,4521,[423 100 282  89 117],28,4,19643,4.343874391862008,0.0,20.0
24522,2,4522,[302 427 197 180 603],13,5,19648,4.344019456113199,20.0,0.0
24523,2,4523,[302 427 197 180 603],339,5,19653,4.344164456233422,20.0,0.0
24524,2,4524,[302 427 197 180 603],537,5,19658,4.344309392265194,20.0,0.0
24525,2,4525,[ 50 228 288 161 234],648,4,19662,4.3442333186036235,0.0,20.0
24526,2,4526,[302 427 197 180 603],13,5,19667,4.344378175392092,20.0,0.0
24527,2,4527,[302 427 197 180 603],271,5,19672,4.34452296819788,20.0,0.0
24528,2,4528,[546 187 172 238 144],234,1,19673,4.3437844998896,0.0,0.0
24529,2,4529,[  7 191 127 471  79],234,2,19675,4.343267108167771,0.0,20.0
24530,2,4530,[357 151  50 286 515],339,5,19680,4.343412050320017,20.0,20.0
24531,2,4531,[568 276 100   4 210],308,5,19685,4.343556928508385,0.0,20.0
24532,2,4532,[286 742  15 215 496],650,1,19686,4.342819324950364,0.0,0.0
24533,2,4533,[568  97 118 403  15],881,2,19688,4.342302602558448,0.0,0.0
24534,2,4534,[302 427 197 180 603],339,5,19693,4.34244762954796,20.0,0.0
24535,2,4535,[211 135 182 151 603],313,4,19697,4.342372134038801,20.0,0.0
24536,2,4536,[302 427 197 180 603],537,5,19702,4.342517081772096,20.0,0.0
24537,2,4537,[ 82 427 144 179 194],932,3,19705,4.342221242838255,0.0,0.0
24538,2,4538,[302 427 197 180 603],474,5,19710,4.342366159947125,20.0,0.0
24539,2,4539,[302 427 197 180 603],537,5,19715,4.342511013215859,20.0,0.0
24540,2,4540,[302 427 197 180 603],664,5,19720,4.342655802686633,20.0,0.0
24541,2,4541,[173 202 200 111 222],374,2,19722,4.342140026420079,0.0,0.0
24542,2,4542,[302 427 197 180 603],13,5,19727,4.3422848338102575,20.0,0.0
24543,2,4543,[302 427 197 180 603],13,5,19732,4.342429577464789,20.0,0.0
24544,2,4544,[302 427 197 180 603],271,5,19737,4.342574257425743,20.0,0.0
24545,2,4545,[318 588  71 235 100],313,4,19741,4.342498900131984,20.0,20.0
24546,2,4546,[302 427 197 180 603],666,5,19746,4.342643501209588,20.0,0.0
24547,2,4547,[ 69 161 301 423  15],455,3,19749,4.342348284960422,0.0,0.0
24548,2,4548,[ 69  96 385 228 118],455,4,19753,4.342273027038909,0.0,0.0
24549,2,4549,[302 427 197 180 603],339,5,19758,4.342417582417583,20.0,0.0
24550,2,4550,[302 427 197 180 603],271,5,19763,4.342562074269392,20.0,0.0
24551,2,4551,[302 427 197 180 603],13,5,19768,4.3427065026362035,20.0,0.0
24552,2,4552,[302 427 197 180 603],339,5,19773,4.342850867559851,20.0,0.0
24553,2,4553,[ 11   4  28  96 194],7,4,19777,4.342775581906016,0.0,0.0
24554,2,4554,[302 427 197 180 603],271,5,19782,4.342919868276619,20.0,0.0
24555,2,4555,[302 427 197 180 603],666,5,19787,4.343064091308165,20.0,0.0
24556,2,4556,[302 427 197 180 603],666,5,19792,4.343208251042353,20.0,0.0
24557,2,4557,[257 210 405 174 202],92,2,19794,4.342694164107065,0.0,20.0
24558,2,4558,[302 427 197 180 603],664,5,19799,4.34283834174161,20.0,0.0
24559,2,4559,[302 427 197 180 603],271,5,19804,4.3429824561403505,20.0,0.0
24560,2,4560,[302 427 197 180 603],271,5,19809,4.343126507344881,20.0,0.0
24561,2,4561,[302 427 197 180 603],666,5,19814,4.343270495396756,20.0,0.0
24562,2,4562,[302 427 197 180 603],474,5,19819,4.343414420337497,20.0,0.0
24563,2,4563,[197 183   4 143 117],308,3,19822,4.343120070113935,0.0,0.0
24564,2,4564,[ 22 403   7 194 185],883,3,19825,4.342825848849945,0.0,0.0
24565,2,4565,[302 427 197 180 603],664,5,19830,4.342969776609724,20.0,0.0
24566,2,4566,[ 50 191 111 496 180],59,5,19835,4.343113641340048,0.0,20.0
24567,2,4567,[302 427 197 180 603],383,5,19840,4.343257443082312,20.0,0.0
24568,2,4568,[302 427 197 180 603],474,5,19845,4.343401181877873,20.0,0.0
24569,2,4569,[302 427 197 180 603],666,5,19850,4.343544857768053,20.0,0.0
24570,2,4570,[302 427 197 180 603],339,5,19855,4.343688470794137,20.0,0.0
24571,2,4571,[302 427 197 180 603],383,5,19860,4.343832020997375,20.0,0.0
24572,2,4572,[302 427 197 180 603],339,5,19865,4.343975508418981,20.0,0.0
24573,2,4573,[302 427 197 180 603],474,5,19870,4.344118933100131,20.0,0.0
24574,2,4574,[302 427 197 180 603],13,5,19875,4.344262295081967,20.0,0.0
24575,2,4575,[302 427 197 180 603],537,5,19880,4.344405594405594,20.0,0.0
24576,2,4576,[302 427 197 180 603],339,5,19885,4.344548831112082,20.0,0.0
24577,2,4577,[302 427 197 180 603],271,5,19890,4.344692005242464,20.0,0.0
24578,2,4578,[276 275  89 328  64],13,3,19893,4.344398340248962,0.0,0.0
24579,2,4579,[302 427 197 180 603],666,5,19898,4.344541484716157,20.0,0.0
24580,2,4580,[  4 568 276  98 181],194,2,19900,4.344029687841083,0.0,20.0
24581,2,4581,[597 202 185 588 181],897,3,19903,4.343736359668267,0.0,0.0
24582,2,4582,[302 427 197 180 603],664,5,19908,4.343879554876718,20.0,0.0
24583,2,4583,[302 427 197 180 603],271,5,19913,4.344022687609075,20.0,0.0
24584,2,4584,[302 427 197 180 603],339,5,19918,4.344165757906216,20.0,0.0
24585,2,4585,[302 427 197 180 603],90,5,19923,4.344308765808984,20.0,0.0
24586,2,4586,[168 318  69 403  88],774,1,19924,4.343579681709178,20.0,0.0
24587,2,4587,[300 269 405 318 288],537,1,19925,4.34285091543156,20.0,0.0
24588,2,4588,[302 427 197 180 603],383,5,19930,4.3429941163652215,20.0,0.0
24589,2,4589,[187   7 151 176 210],890,5,19935,4.3431372549019605,0.0,0.0
24590,2,4590,[302 427 197 180 603],13,5,19940,4.3432803310825525,20.0,0.0
24591,2,4591,[302 427 197 180 603],271,5,19945,4.343423344947735,20.0,0.0
24592,2,4592,[196  70 475 423 435],90,4,19949,4.34334857391683,0.0,0.0
24593,2,4593,[302 427 197 180 603],664,5,19954,4.3434915106660865,20.0,0.0
24594,2,4594,[313  50 603 191 423],474,5,19959,4.343634385201306,20.0,20.0
24595,2,4595,[179 294 496 483 588],848,3,19962,4.3433420365535245,20.0,0.0
24596,2,4596,[302 427 197 180 603],664,5,19967,4.343484881444421,20.0,0.0
24597,2,4597,[196 742 202 508 435],378,4,19971,4.343410178338408,0.0,0.0
24598,2,4598,[496 427 385 182 176],326,2,19973,4.342900630571863,0.0,0.0
24599,2,4599,[196 423  15 275  69],537,1,19974,4.342173913043478,0.0,0.0
24600,2,4600,[678 427 385 289  12],454,1,19975,4.341447511410563,20.0,0.0
24601,2,4601,[302 427 197 180 603],666,5,19980,4.341590612777053,20.0,0.0
24602,2,4602,[302 427 197 180 603],537,5,19985,4.341733651966109,20.0,0.0
24603,2,4603,[302 427 197 180 603],664,5,19990,4.341876629018245,20.0,0.0
24604,2,4604,[151  64 301 117 211],524,2,19992,4.341368078175896,0.0,0.0
24605,2,4605,[302 427 197 180 603],271,5,19997,4.341511072514112,20.0,0.0
24606,2,4606,[302 427 197 180 603],13,5,20002,4.341654004775342,20.0,0.0
24607,2,4607,[302 427 197 180 603],474,5,20007,4.341796875,20.0,0.0
24608,2,4608,[ 64 268 235 168 546],13,3,20010,4.341505749620308,0.0,0.0
24609,2,4609,[302 427 197 180 603],664,5,20015,4.341648590021692,20.0,0.0
24610,2,4610,[302 427 197 180 603],474,5,20020,4.34179136846671,20.0,0.0
24611,2,4611,[181 403 228  56 144],158,4,20024,4.341717259323504,0.0,0.0
24612,2,4612,[302 427 197 180 603],537,5,20029,4.341859960979839,20.0,0.0
24613,2,4613,[302 427 197 180 603],664,5,20034,4.342002600780234,20.0,0.0
24614,2,4614,[302 427 197 180 603],537,5,20039,4.3421451787648975,20.0,0.0
24615,2,4615,[234 265 238 187 191],379,5,20044,4.3422876949740035,0.0,0.0
24616,2,4616,[302 427 197 180 603],474,5,20049,4.342430149447694,20.0,0.0
24617,2,4617,[302 427 197 180 603],666,5,20054,4.342572542226072,20.0,0.0
24618,2,4618,[182 318 181  71 210],59,4,20058,4.34249837627192,20.0,0.0
24619,2,4619,[302 427 197 180 603],90,5,20063,4.342640692640693,20.0,0.0
24620,2,4620,[302 427 197 180 603],474,5,20068,4.34278294741398,20.0,0.0
24621,2,4621,[302 427 197 180 603],271,5,20073,4.3429251406317615,20.0,0.0
24622,2,4622,[ 70 182 273 127 196],666,3,20076,4.342634652822842,0.0,20.0
24623,2,4623,[302 427 197 180 603],271,5,20081,4.342776816608996,20.0,0.0
24624,2,4624,[302 427 197 180 603],474,5,20086,4.342918918918919,20.0,0.0
24625,2,4625,[318   1 172 603 204],738,5,20091,4.343060959792477,40.0,0.0
24626,2,4626,[302 427 197 180 603],339,5,20096,4.3432029392695055,20.0,0.0
24627,2,4627,[302 427 197 180 603],383,5,20101,4.343344857389801,20.0,0.0
24628,2,4628,[228 195  64 191 194],234,3,20104,4.343054655433139,0.0,0.0
24629,2,4629,[144 183  12  25 323],378,4,20108,4.342980561555075,20.0,0.0
24630,2,4630,[196 194 286 173 185],406,2,20110,4.342474627510257,0.0,0.0
24631,2,4631,[302 427 197 180 603],339,5,20115,4.342616580310881,20.0,0.0
24632,2,4632,[597 195  97 403 275],308,3,20118,4.3423267860997194,0.0,0.0
24633,2,4633,[302 427 197 180 603],339,5,20123,4.3424687095381955,20.0,0.0
24634,2,4634,[302 427 197 180 603],13,5,20128,4.3426105717367856,20.0,0.0
24635,2,4635,[302 427 197 180 603],664,5,20133,4.3427523727351165,20.0,0.0
24636,2,4636,[302 427 197 180 603],474,5,20138,4.342894112572784,20.0,0.0
24637,2,4637,[302 427 197 180 603],383,5,20143,4.343035791289349,20.0,0.0
24638,2,4638,[302 427 197 180 603],271,5,20148,4.343177408924337,20.0,0.0
24639,2,4639,[ 50  11 257 276  70],334,4,20152,4.343103448275862,0.0,20.0
24640,2,4640,[302 427 197 180 603],383,5,20157,4.3432449903038135,20.0,0.0
24641,2,4641,[302 427 197 180 603],90,5,20162,4.343386471348556,20.0,0.0
24642,2,4642,[144 151 257 180 186],738,4,20166,4.343312513461124,0.0,0.0
24643,2,4643,[302 427 197 180 603],383,5,20171,4.343453919035315,20.0,0.0
24644,2,4644,[302 427 197 180 603],383,5,20176,4.343595263724435,20.0,0.0
24645,2,4645,[302 427 197 180 603],90,5,20181,4.343736547567801,20.0,0.0
24646,2,4646,[191 333 603  97 294],387,2,20183,4.343232192812567,20.0,0.0
24647,2,4647,[302 427 197 180 603],90,5,20188,4.343373493975903,20.0,0.0
24648,2,4648,[302 427 197 180 603],537,5,20193,4.343514734351474,20.0,0.0
24649,2,4649,[302 427 197 180 603],13,5,20198,4.343655913978495,20.0,0.0
24650,2,4650,[302 427 197 180 603],13,5,20203,4.343797032896151,20.0,0.0
24651,2,4651,[302 427 197 180 603],383,5,20208,4.3439380911435945,20.0,0.0
24652,2,4652,[302 427 197 180 603],666,5,20213,4.34407908875994,20.0,0.0
24653,2,4653,[302 427 197 180 603],13,5,20218,4.344220025784272,20.0,0.0
24654,2,4654,[237 228 333 385 180],13,3,20221,4.343931256713212,0.0,0.0
24655,2,4655,[302 427 197 180 603],90,5,20226,4.344072164948454,20.0,0.0
24656,2,4656,[ 82  79   9 195 289],234,1,20227,4.343354090616277,0.0,0.0
24657,2,4657,[302 427 197 180 603],339,5,20232,4.34349506225848,20.0,0.0
24658,2,4658,[302 427 197 180 603],339,5,20237,4.343635973384846,20.0,0.0
24659,2,4659,[302 427 197 180 603],13,5,20242,4.343776824034335,20.0,0.0
24660,2,4660,[302 427 197 180 603],271,5,20247,4.34391761424587,20.0,0.0
24661,2,4661,[161 118 117 286  15],454,2,20249,4.343414843414844,0.0,0.0
24662,2,4662,[385  98 655 678   4],881,3,20252,4.343126742440489,0.0,20.0
24663,2,4663,[302 427 197 180 603],383,5,20257,4.3432675814751285,20.0,0.0
24664,2,4664,[302 427 197 180 603],13,5,20262,4.343408360128618,20.0,0.0
24665,2,4665,[302 427 197 180 603],664,5,20267,4.343549078439777,20.0,0.0
24666,2,4666,[135  82 173 318 132],64,4,20271,4.34347546603814,20.0,0.0
24667,2,4667,[302 427 197 180 603],339,5,20276,4.343616109682948,20.0,0.0
24668,2,4668,[588 423  70 294 210],234,1,20277,4.342899978582137,0.0,0.0
24669,2,4669,[302 427 197 180 603],664,5,20282,4.34304068522484,20.0,0.0
24670,2,4670,[302 427 197 180 603],666,5,20287,4.343181331620638,20.0,0.0
24671,2,4671,[301 143 269 496 235],650,3,20290,4.342893835616438,0.0,0.0
24672,2,4672,[302 427 197 180 603],339,5,20295,4.343034453242029,20.0,0.0
24673,2,4673,[211 161 300 313 655],13,4,20299,4.342961061189559,0.0,0.0
24674,2,4674,[655 235  79 405 127],213,3,20302,4.342673796791444,0.0,20.0
24675,2,4675,[302 427 197 180 603],13,5,20307,4.342814371257485,20.0,0.0
24676,2,4676,[302 427 197 180 603],474,5,20312,4.342954885610434,20.0,0.0
24677,2,4677,[ 25 301 475 245  71],455,1,20313,4.342240273621206,0.0,0.0
24678,2,4678,[ 70  12 187 125  56],7,4,20317,4.342167129728574,20.0,0.0
24679,2,4679,[385 173 496 427   7],537,4,20321,4.342094017094017,0.0,0.0
24680,2,4680,[302 427 197 180 603],13,5,20326,4.342234565263833,20.0,0.0
24681,2,4681,[151 118 588 144 237],892,5,20331,4.342375053395985,0.0,0.0
24682,2,4682,[302 427 197 180 603],537,5,20336,4.342515481528935,20.0,0.0
24683,2,4683,[135 234 100  79 237],64,5,20341,4.34265584970111,0.0,20.0
24684,2,4684,[302 427 197 180 603],537,5,20346,4.342796157950907,20.0,0.0
24685,2,4685,[302 427 197 180 603],537,5,20351,4.342936406316688,20.0,0.0
24686,2,4686,[302 427 197 180 603],537,5,20356,4.343076594836782,20.0,0.0
24687,2,4687,[302 427 197 180 603],383,5,20361,4.343216723549488,20.0,0.0
24688,2,4688,[302 427 197 180 603],383,5,20366,4.3433567924930685,20.0,0.0
24689,2,4689,[ 69 318   7 121 111],653,3,20369,4.343070362473347,20.0,0.0
24690,2,4690,[302 427 197 180 603],537,5,20374,4.343210402899168,20.0,0.0
24691,2,4691,[302 427 197 180 603],13,5,20379,4.343350383631714,20.0,0.0
24692,2,4692,[302 427 197 180 603],664,5,20384,4.3434903047091415,20.0,0.0
24693,2,4693,[302 427 197 180 603],664,5,20389,4.343630166169578,20.0,0.0
24694,2,4694,[ 71 237 222  89   9],85,3,20392,4.343343982960596,0.0,0.0
24695,2,4695,[117  71  25 228 172],194,1,20393,4.34263202725724,0.0,0.0
24696,2,4696,[302 427 197 180 603],339,5,20398,4.342771982116244,20.0,0.0
24697,2,4697,[302 427 197 180 603],271,5,20403,4.342911877394636,20.0,0.0
24698,2,4698,[302 427 197 180 603],339,5,20408,4.343051713130453,20.0,0.0
24699,2,4699,[302 427 197 180 603],339,5,20413,4.343191489361702,20.0,0.0
24700,2,4700,[  8 423 357 265 276],343,4,20417,4.343118485428632,20.0,0.0
24701,2,4701,[302 427 197 180 603],537,5,20422,4.343258188005104,20.0,0.0
24702,2,4702,[180  28 202 151 483],666,3,20425,4.342972570699554,20.0,0.0
24703,2,4703,[ 96 181 194 603 210],60,5,20430,4.343112244897959,20.0,0.0
24704,2,4704,[302 427 197 180 603],13,5,20435,4.343251859723698,20.0,0.0
24705,2,4705,[302 427 197 180 603],383,5,20440,4.34339141521462,20.0,0.0
24706,2,4706,[302 427 197 180 603],339,5,20445,4.34353091140854,20.0,0.0
24707,2,4707,[302 427 197 180 603],13,5,20450,4.343670348343245,20.0,0.0
24708,2,4708,[100 515 215 176 182],804,5,20455,4.343809726056487,0.0,20.0
24709,2,4709,[302 427 197 180 603],339,5,20460,4.343949044585988,20.0,0.0
24710,2,4710,[132 182   9 200 268],13,3,20463,4.34366376565485,0.0,0.0
24711,2,4711,[435 508 197 313 211],207,5,20468,4.3438030560271645,0.0,0.0
24712,2,4712,[302 427 197 180 603],90,5,20473,4.343942287290473,20.0,0.0
24713,2,4713,[302 427 197 180 603],90,5,20478,4.344081459482393,20.0,0.0
24714,2,4714,[302 427 197 180 603],474,5,20483,4.344220572640509,20.0,0.0
24715,2,4715,[302 427 197 180 603],271,5,20488,4.344359626802375,20.0,0.0
24716,2,4716,[191  89 286  28 427],7,5,20493,4.344498622005512,0.0,0.0
24717,2,4717,[423 185  22 186 211],326,4,20497,4.344425604069521,0.0,0.0
24718,2,4718,[265 200 204 143 176],311,4,20501,4.34435261707989,0.0,0.0
24719,2,4719,[302 427 197 180 603],90,5,20506,4.344491525423729,20.0,0.0
24720,2,4720,[302 427 197 180 603],383,5,20511,4.344630374920568,20.0,0.0
24721,2,4721,[302 427 197 180 603],383,5,20516,4.344769165607794,20.0,0.0
24722,2,4722,[302 427 197 180 603],664,5,20521,4.344907897522761,20.0,0.0
24723,2,4723,[302 427 197 180 603],90,5,20526,4.345046570702794,20.0,0.0
24724,2,4724,[302 427 197 180 603],666,5,20531,4.345185185185185,20.0,0.0
24725,2,4725,[748 237 100 475   7],13,3,20534,4.344900550148116,0.0,20.0
24726,2,4726,[302 427 197 180 603],90,5,20539,4.3450391368732815,20.0,0.0
24727,2,4727,[302 427 197 180 603],13,5,20544,4.345177664974619,20.0,0.0
24728,2,4728,[302 427 197 180 603],90,5,20549,4.345316134489321,20.0,0.0
24729,2,4729,[302 427 197 180 603],13,5,20554,4.345454545454546,20.0,0.0
24730,2,4730,[302 427 197 180 603],13,5,20559,4.345592897907419,20.0,0.0
24731,2,4731,[302 427 197 180 603],664,5,20564,4.345731191885038,20.0,0.0
24732,2,4732,[ 95 125 508 144  71],92,4,20568,4.345658144939785,0.0,0.0
24733,2,4733,[302 427 197 180 603],383,5,20573,4.345796366708914,20.0,0.0
24734,2,4734,[302 427 197 180 603],664,5,20578,4.345934530095037,20.0,0.0
24735,2,4735,[302 427 197 180 603],13,5,20583,4.346072635135135,20.0,0.0
24736,2,4736,[ 70 237 357 144 132],666,3,20586,4.345788473717543,20.0,0.0
24737,2,4737,[273 194 172 588 222],13,3,20589,4.345504432249895,0.0,0.0
24738,2,4738,[403 588 301 118 194],650,2,20591,4.3450094956741925,0.0,0.0
24739,2,4739,[302 427 197 180 603],666,5,20596,4.345147679324895,20.0,0.0
24740,2,4740,[275 258 357 172  95],13,3,20599,4.344863952752584,20.0,0.0
24741,2,4741,[276  11 228 655 216],92,4,20603,4.344791227330241,0.0,0.0
24742,2,4742,[302 427 197 180 603],271,5,20608,4.344929369597302,20.0,0.0
24743,2,4743,[121  56 515 423 234],92,4,20612,4.344856661045531,0.0,0.0
24744,2,4744,[ 97 235  50 496 202],82,4,20616,4.344783983140148,0.0,20.0
24745,2,4745,[302 427 197 180 603],271,5,20621,4.344922039612305,20.0,0.0
24746,2,4746,[302 427 197 180 603],383,5,20626,4.345060037918685,20.0,0.0
24747,2,4747,[288   1   4 180 301],650,0,20626,4.344144903117102,0.0,0.0
24748,2,4748,[302 427 197 180 603],383,5,20631,4.344283006948832,20.0,0.0
24749,2,4749,[302 427 197 180 603],666,5,20636,4.344421052631579,20.0,0.0
24750,2,4750,[385 174 423 195 187],326,2,20638,4.3439275941906965,0.0,20.0
24751,2,4751,[302 427 197 180 603],90,5,20643,4.344065656565657,20.0,0.0
24752,2,4752,[175 174  28 121 323],378,4,20647,4.343993267410057,0.0,20.0
24753,2,4753,[318 216 234 258 423],538,3,20650,4.343710559528818,20.0,0.0
24754,2,4754,[302 427 197 180 603],90,5,20655,4.34384858044164,20.0,0.0
24755,2,4755,[435 173  96  95  88],892,5,20660,4.343986543313709,0.0,0.0
24756,2,4756,[302 427 197 180 603],90,5,20665,4.344124448181627,20.0,0.0
24757,2,4757,[302 427 197 180 603],664,5,20670,4.344262295081967,20.0,0.0
24758,2,4758,[302 427 197 180 603],537,5,20675,4.344400084051271,20.0,0.0
24759,2,4759,[125  98 357 238 185],207,4,20679,4.344327731092437,20.0,20.0
24760,2,4760,[175 204 143 197   4],537,2,20681,4.343835328712455,0.0,0.0
24761,2,4761,[302 427 197 180 603],90,5,20686,4.343973120537589,20.0,0.0
24762,2,4762,[186   9  97 655 180],308,4,20690,4.343900902792358,0.0,0.0
24763,2,4763,[357  97 179 265 176],7,4,20694,4.343828715365239,20.0,0.0
24764,2,4764,[302 427 197 180 603],537,5,20699,4.343966421825813,20.0,0.0
24765,2,4765,[125  28 135 405 282],533,3,20702,4.343684431389005,0.0,0.0
24766,2,4766,[302 427 197 180 603],537,5,20707,4.343822110341934,20.0,0.0
24767,2,4767,[265 273 318 288  56],7,4,20711,4.34375,20.0,0.0
24768,2,4768,[302 427 197 180 603],666,5,20716,4.343887607464877,20.0,0.0
24769,2,4769,[302 427 197 180 603],13,5,20721,4.344025157232704,20.0,0.0
24770,2,4770,[ 71 302 282 515 176],474,5,20726,4.344162649339761,0.0,0.0
24771,2,4771,[302 427 197 180 603],474,5,20731,4.344300083822297,20.0,0.0
24772,2,4772,[302 427 197 180 603],13,5,20736,4.344437460716531,20.0,0.0
24773,2,4773,[302 427 197 180 603],383,5,20741,4.344574780058651,20.0,0.0
24774,2,4774,[302 427 197 180 603],13,5,20746,4.344712041884817,20.0,0.0
24775,2,4775,[237 182 176  89 187],804,5,20751,4.344849246231155,0.0,0.0
24776,2,4776,[302 427 197 180 603],664,5,20756,4.344986393133766,20.0,0.0
24777,2,4777,[302 427 197 180 603],666,5,20761,4.345123482628715,20.0,0.0
24778,2,4778,[302 427 197 180 603],383,5,20766,4.34526051475204,20.0,0.0
24779,2,4779,[302 427 197 180 603],537,5,20771,4.345397489539749,20.0,0.0
24780,2,4780,[302 427 197 180 603],664,5,20776,4.345534407027818,20.0,0.0
24781,2,4781,[302 427 197 180 603],474,5,20781,4.345671267252196,20.0,0.0
24782,2,4782,[302 427 197 180 603],13,5,20786,4.345808070248798,20.0,0.0
24783,2,4783,[302 427 197 180 603],339,5,20791,4.345944816053512,20.0,0.0
24784,2,4784,[302 427 197 180 603],271,5,20796,4.346081504702195,20.0,0.0
24785,2,4785,[ 64   4 185 153 195],379,4,20800,4.346009193480986,0.0,0.0
24786,2,4786,[302 427 197 180 603],271,5,20805,4.3461458115730105,20.0,0.0
24787,2,4787,[302 427 197 180 603],537,5,20810,4.346282372598162,20.0,0.0
24788,2,4788,[471  89 289 483 181],374,1,20811,4.345583629150136,20.0,0.0
24789,2,4789,[302 427 197 180 603],271,5,20816,4.345720250521921,20.0,0.0
24790,2,4790,[183  12 403 302 210],346,3,20819,4.345439365476936,20.0,0.0
24791,2,4791,[302 427 197 180 603],664,5,20824,4.345575959933222,20.0,0.0
24792,2,4792,[302 427 197 180 603],537,5,20829,4.3457124973920305,20.0,0.0
24793,2,4793,[302 427 197 180 603],271,5,20834,4.345848977889028,20.0,0.0
24794,2,4794,[302 427 197 180 603],537,5,20839,4.3459854014598545,20.0,0.0
24795,2,4795,[302 427 197 180 603],474,5,20844,4.346121768140117,20.0,0.0
24796,2,4796,[286 269 234  11 301],537,0,20844,4.345215759849906,0.0,0.0
24797,2,4797,[302 427 197 180 603],664,5,20849,4.345352230095873,20.0,0.0
24798,2,4798,[302 427 197 180 603],666,5,20854,4.345488643467389,20.0,0.0
24799,2,4799,[153 168  95 172 318],64,4,20858,4.345416666666667,20.0,0.0
24800,2,4800,[302 427 197 180 603],13,5,20863,4.3455530097896276,20.0,0.0
24801,2,4801,[302 427 197 180 603],339,5,20868,4.345689296126614,20.0,0.0
24802,2,4802,[132 118 172 318 222],653,1,20869,4.3449927128877786,20.0,0.0
24803,2,4803,[302 427 197 180 603],666,5,20874,4.3451290591174025,20.0,0.0
24804,2,4804,[302 427 197 180 603],339,5,20879,4.3452653485952135,20.0,0.0
24805,2,4805,[ 56 515 483 323 357],91,3,20882,4.344985434873076,40.0,0.0
24806,2,4806,[475 172 194 135 302],833,1,20883,4.344289577699189,0.0,0.0
24807,2,4807,[302 427 197 180 603],537,5,20888,4.344425956738768,20.0,0.0
24808,2,4808,[288 191 328 117   8],13,1,20889,4.343730505302558,0.0,0.0
24809,2,4809,[258 121  82  25 174],882,3,20892,4.343451143451143,0.0,20.0
24810,2,4810,[302 427 197 180 603],339,5,20897,4.343587611723135,20.0,0.0
24811,2,4811,[237 405  69 191 174],184,2,20899,4.343100581878637,0.0,20.0
24812,2,4812,[ 98 235 196 125  96],374,3,20902,4.34282152503636,0.0,20.0
24813,2,4813,[302 427 197 180 603],537,5,20907,4.342958039052763,20.0,0.0
24814,2,4814,[302 427 197 180 603],271,5,20912,4.3430944963655245,20.0,0.0
24815,2,4815,[302 427 197 180 603],383,5,20917,4.343230897009967,20.0,0.0
24816,2,4816,[328  89   7 301 271],537,2,20919,4.34274444675109,0.0,0.0
24817,2,4817,[197  95 186  82 118],13,4,20923,4.3426733084267335,0.0,0.0
24818,2,4818,[357  79 161 210   1],454,3,20926,4.342394687694543,20.0,0.0
24819,2,4819,[271  11 265 275 151],64,3,20929,4.342116182572614,0.0,0.0
24820,2,4820,[194  25 268 318 423],387,0,20929,4.341215515453225,20.0,0.0
24821,2,4821,[302 427 197 180 603],13,5,20934,4.3413521360431355,20.0,0.0
24822,2,4822,[302 427 197 180 603],90,5,20939,4.341488699979266,20.0,0.0
24823,2,4823,[302 427 197 180 603],383,5,20944,4.3416252072968495,20.0,0.0
24824,2,4824,[302 427 197 180 603],383,5,20949,4.341761658031088,20.0,0.0
24825,2,4825,[302 427 197 180 603],474,5,20954,4.341898052217157,20.0,0.0
24826,2,4826,[302 427 197 180 603],271,5,20959,4.342034389890201,20.0,0.0
24827,2,4827,[  1 275 117 323 185],548,4,20963,4.341963545981773,0.0,0.0
24828,2,4828,[176 257 100 216 117],144,5,20968,4.342099813626009,0.0,20.0
24829,2,4829,[173 257 210 323  70],374,2,20970,4.341614906832298,0.0,0.0
24830,2,4830,[302 427 197 180 603],537,5,20975,4.3417511902297665,20.0,0.0
24831,2,4831,[678 173 143 237 276],537,2,20977,4.341266556291391,0.0,0.0
24832,2,4832,[302 427 197 180 603],271,5,20982,4.341402855369336,20.0,0.0
24833,2,4833,[302 427 197 180 603],474,5,20987,4.34153909805544,20.0,0.0
24834,2,4834,[302 427 197 180 603],339,5,20992,4.341675284384695,20.0,0.0
24835,2,4835,[302 427 197 180 603],90,5,20997,4.341811414392059,20.0,0.0
24836,2,4836,[302 427 197 180 603],90,5,21002,4.341947488112466,20.0,0.0
24837,2,4837,[132 238 191  50 215],749,4,21006,4.341876808598594,0.0,20.0
24838,2,4838,[111 258 179 186 403],749,4,21010,4.341806158297169,0.0,0.0
24839,2,4839,[302 427 197 180 603],339,5,21015,4.341942148760331,20.0,0.0
24840,2,4840,[302 427 197 180 603],339,5,21020,4.342078083040694,20.0,0.0
24841,2,4841,[ 88 185  70 234 176],543,5,21025,4.342213961173069,0.0,0.0
24842,2,4842,[ 89 185 127 182 194],897,5,21030,4.342349783192236,0.0,20.0
24843,2,4843,[302 427 197 180 603],383,5,21035,4.342485549132948,20.0,0.0
24844,2,4844,[748 515 111  98   9],92,3,21038,4.342208462332302,0.0,20.0
24845,2,4845,[302 427 197 180 603],383,5,21043,4.342344201403219,20.0,0.0
24846,2,4846,[302 427 197 180 603],666,5,21048,4.342479884464617,20.0,0.0
24847,2,4847,[302 427 197 180 603],474,5,21053,4.3426155115511555,20.0,0.0
24848,2,4848,[302 427 197 180 603],271,5,21058,4.342751082697464,20.0,0.0
24849,2,4849,[302 427 197 180 603],339,5,21063,4.342886597938144,20.0,0.0
24850,2,4850,[302 427 197 180 603],474,5,21068,4.343022057307771,20.0,0.0
24851,2,4851,[275  88 228  12 176],279,1,21069,4.342333058532564,20.0,0.0
24852,2,4852,[302 427 197 180 603],339,5,21074,4.342468576138471,20.0,0.0
24853,2,4853,[302 427 197 180 603],339,5,21079,4.342604037906881,20.0,0.0
24854,2,4854,[302 427 197 180 603],537,5,21084,4.342739443872297,20.0,0.0
24855,2,4855,[302 427 197 180 603],666,5,21089,4.342874794069193,20.0,0.0
24856,2,4856,[302 427 197 180 603],474,5,21094,4.343010088532016,20.0,0.0
24857,2,4857,[435 423 268  12 475],6,3,21097,4.342733635240839,20.0,0.0
24858,2,4858,[302 427 197 180 603],90,5,21102,4.342868903066474,20.0,0.0
24859,2,4859,[302 427 197 180 603],537,5,21107,4.3430041152263374,20.0,0.0
24860,2,4860,[196 132 202 100   1],13,4,21111,4.342933552766921,0.0,20.0
24861,2,4861,[211 180 313   9 427],533,4,21115,4.342863019333608,0.0,0.0
24862,2,4862,[515 211 357 405 210],313,4,21119,4.342792514908493,20.0,0.0
24863,2,4863,[194 222 742 127  69],648,3,21122,4.342516447368421,0.0,20.0
24864,2,4864,[ 12 144 175 187  69],527,4,21126,4.3424460431654675,20.0,0.0
24865,2,4865,[333 222 483  64 186],313,3,21129,4.342170160295931,20.0,0.0
24866,2,4866,[597  89 197 135 216],653,3,21132,4.341894390795151,0.0,0.0
24867,2,4867,[546 117 288 258 197],455,2,21134,4.341413311421529,0.0,0.0
24868,2,4868,[302 427 197 180 603],339,5,21139,4.341548572602177,20.0,0.0
24869,2,4869,[195 172 333 423 211],537,1,21140,4.3408624229979464,0.0,0.0
24870,2,4870,[302 427 197 180 603],90,5,21145,4.3409977417368095,20.0,0.0
24871,2,4871,[302 427 197 180 603],90,5,21150,4.3411330049261085,20.0,0.0
24872,2,4872,[302 427 197 180 603],664,5,21155,4.341268212600041,20.0,0.0
24873,2,4873,[269 427 153   4  97],13,4,21159,4.341198194501437,0.0,0.0
24874,2,4874,[302 427 197 180 603],537,5,21164,4.341333333333333,20.0,0.0
24875,2,4875,[127 202 475  70 748],648,1,21165,4.34064807219032,0.0,20.0
24876,2,4876,[588 275 173 289 385],85,0,21165,4.3397580479803155,0.0,0.0
24877,2,4877,[302 427 197 180 603],537,5,21170,4.339893398933989,20.0,0.0
24878,2,4878,[302 427 197 180 603],664,5,21175,4.340028694404591,20.0,0.0
24879,2,4879,[302 427 197 180 603],13,5,21180,4.340163934426229,20.0,0.0
24880,2,4880,[ 12 127 194 186 294],10,4,21184,4.340094242982995,20.0,20.0
24881,2,4881,[357 125 195  50 210],815,4,21188,4.340024580090127,20.0,20.0
24882,2,4882,[ 69 210 144 483 742],454,3,21191,4.339750153594102,20.0,0.0
24883,2,4883,[302 427 197 180 603],13,5,21196,4.33988533988534,20.0,0.0
24884,2,4884,[302 427 197 180 603],474,5,21201,4.340020470829068,20.0,0.0
24885,2,4885,[302 427 197 180 603],537,5,21206,4.340155546459272,20.0,0.0
24886,2,4886,[302 427 197 180 603],13,5,21211,4.340290566809903,20.0,0.0
24887,2,4887,[302 427 197 180 603],666,5,21216,4.340425531914893,20.0,0.0
24888,2,4888,[435 196 546 183 238],749,3,21219,4.3401513601963595,0.0,0.0
24889,2,4889,[302 427 197 180 603],383,5,21224,4.340286298568508,20.0,0.0
24890,2,4890,[313  79 237 271 515],334,4,21228,4.340216724596197,0.0,0.0
24891,2,4891,[302 427 197 180 603],474,5,21233,4.340351594439902,20.0,0.0
24892,2,4892,[302 427 197 180 603],474,5,21238,4.340486409155937,20.0,0.0
24893,2,4893,[302 427 197 180 603],383,5,21243,4.340621168778096,20.0,0.0
24894,2,4894,[151  89 204 228   7],804,4,21247,4.340551583248213,0.0,0.0
24895,2,4895,[211 333 187 186 405],666,2,21249,4.3400735294117645,0.0,0.0
24896,2,4896,[302 427 197 180 603],90,5,21254,4.3402082907902795,20.0,0.0
24897,2,4897,[302 427 197 180 603],537,5,21259,4.340342997141691,20.0,0.0
24898,2,4898,[ 64 174 125 182  25],234,1,21260,4.339661155337824,0.0,20.0
24899,2,4899,[302 427 197 180 603],537,5,21265,4.339795918367347,20.0,0.0
24900,2,4900,[302 427 197 180 603],537,5,21270,4.339930626402775,20.0,0.0
24901,2,4901,[302 427 197 180 603],271,5,21275,4.3400652794777645,20.0,0.0
24902,2,4902,[655 181  79 546 258],234,0,21275,4.33918009382011,0.0,0.0
24903,2,4903,[118 182   8 168  56],881,2,21277,4.338703099510604,0.0,0.0
24904,2,4904,[302 427 197 180 603],271,5,21282,4.338837920489297,20.0,0.0
24905,2,4905,[302 427 197 180 603],13,5,21287,4.3389726865063185,20.0,0.0
24906,2,4906,[302 427 197 180 603],90,5,21292,4.339107397595272,20.0,0.0
24907,2,4907,[475 275 322 515  97],13,1,21293,4.338427057864711,0.0,0.0
24908,2,4908,[ 64 100 265  50  69],892,5,21298,4.338561825218986,0.0,40.0
24909,2,4909,[302 427 197 180 603],474,5,21303,4.338696537678207,20.0,0.0
24910,2,4910,[186 168  97 173 121],664,3,21306,4.338423946243128,0.0,0.0
24911,2,4911,[302 427 197 180 603],271,5,21311,4.338558631921824,20.0,0.0
24912,2,4912,[483  50 172 200 143],308,4,21315,4.338489721147975,20.0,20.0
24913,2,4913,[302 427 197 180 603],666,5,21320,4.338624338624339,20.0,0.0
24914,2,4914,[302 427 197 180 603],383,5,21325,4.338758901322482,20.0,0.0
24915,2,4915,[302 427 197 180 603],474,5,21330,4.338893409275834,20.0,0.0
24916,2,4916,[302 427 197 180 603],664,5,21335,4.339027862517796,20.0,0.0
24917,2,4917,[302 427 197 180 603],664,5,21340,4.33916226108174,20.0,0.0
24918,2,4918,[302 427 197 180 603],13,5,21345,4.339296605001016,20.0,0.0
24919,2,4919,[302 427 197 180 603],13,5,21350,4.3394308943089435,20.0,0.0
24920,2,4920,[302 427 197 180 603],383,5,21355,4.339565129038813,20.0,0.0
24921,2,4921,[427  89 289  28 127],13,4,21359,4.339496139780577,0.0,20.0
24922,2,4922,[302 427 197 180 603],90,5,21364,4.339630306723542,20.0,0.0
24923,2,4923,[302 427 197 180 603],271,5,21369,4.339764419171406,20.0,0.0
24924,2,4924,[302 427 197 180 603],383,5,21374,4.3398984771573605,20.0,0.0
24925,2,4925,[176 216 597  88 276],374,4,21378,4.339829476248477,0.0,0.0
24926,2,4926,[302 427 197 180 603],271,5,21383,4.339963466612543,20.0,0.0
24927,2,4927,[302 427 197 180 603],90,5,21388,4.340097402597403,20.0,0.0
24928,2,4928,[ 15 322  79 294 237],474,4,21392,4.3400284033272465,0.0,0.0
24929,2,4929,[302 427 197 180 603],537,5,21397,4.340162271805274,20.0,0.0
24930,2,4930,[173  98 322 597 211],804,4,21401,4.3400932873656455,0.0,20.0
24931,2,4931,[302 427 197 180 603],383,5,21406,4.340227088402271,20.0,0.0
24932,2,4932,[302 427 197 180 603],271,5,21411,4.340360835191567,20.0,0.0
24933,2,4933,[ 56 135 121 168 182],7,5,21416,4.340494527766518,0.0,0.0
24934,2,4934,[302 427 197 180 603],383,5,21421,4.340628166160081,20.0,0.0
24935,2,4935,[302 427 197 180 603],271,5,21426,4.3407617504051865,20.0,0.0
24936,2,4936,[175 179 403 597 742],92,3,21429,4.340490176220377,0.0,0.0
24937,2,4937,[302 427 197 180 603],666,5,21434,4.340623734305387,20.0,0.0
24938,2,4938,[318  50 204 179 135],387,3,21437,4.34035229803604,20.0,20.0
24939,2,4939,[132  64  69 200 235],92,2,21439,4.339878542510122,0.0,0.0
24940,2,4940,[  4 222 235  28 202],194,2,21441,4.339404978749241,0.0,0.0
24941,2,4941,[302 427 197 180 603],474,5,21446,4.339538648320518,20.0,0.0
24942,2,4942,[302 427 197 180 603],271,5,21451,4.339672263807405,20.0,0.0
24943,2,4943,[302 427 197 180 603],383,5,21456,4.339805825242719,20.0,0.0
24944,2,4944,[302 427 197 180 603],271,5,21461,4.3399393326592515,20.0,0.0
24945,2,4945,[ 89  69 202 427 588],295,5,21466,4.340072786089769,0.0,0.0
24946,2,4946,[302 427 197 180 603],13,5,21471,4.34020618556701,20.0,0.0
24947,2,4947,[ 56   9 597 183 216],328,3,21474,4.339935327405012,0.0,0.0
24948,2,4948,[302 427 197 180 603],474,5,21479,4.340068700747626,20.0,0.0
24949,2,4949,[302 427 197 180 603],271,5,21484,4.34020202020202,20.0,0.0
24950,2,4950,[228 132 515  89 135],524,3,21487,4.339931327004646,0.0,0.0
24951,2,4951,[135 313 210 172 265],537,2,21489,4.339458804523425,0.0,0.0
24952,2,4952,[  1 238 357 186 194],648,3,21492,4.339188370684433,20.0,0.0
24953,2,4953,[302 427 197 180 603],474,5,21497,4.339321760193783,20.0,0.0
24954,2,4954,[302 427 197 180 603],90,5,21502,4.339455095862765,20.0,0.0
24955,2,4955,[302 427 197 180 603],664,5,21507,4.339588377723971,20.0,0.0
24956,2,4956,[435 245 385   4 127],207,3,21510,4.339318135969337,0.0,20.0
24957,2,4957,[546  79 118 603  22],145,3,21513,4.3390480032271075,20.0,0.0
24958,2,4958,[385  64 228 173 588],454,1,21514,4.338374672312966,0.0,0.0
24959,2,4959,[ 15  88  98 153 144],60,4,21518,4.338306451612903,0.0,20.0
24960,2,4960,[302 427 197 180 603],90,5,21523,4.338439830679299,20.0,0.0
24961,2,4961,[302 427 197 180 603],13,5,21528,4.33857315598549,20.0,0.0
24962,2,4962,[196 172 568 313 435],64,5,21533,4.338706427563974,0.0,0.0
24963,2,4963,[302 427 197 180 603],90,5,21538,4.33883964544722,20.0,0.0
24964,2,4964,[302 427 197 180 603],537,5,21543,4.338972809667673,20.0,0.0
24965,2,4965,[ 96 181 135 222   9],406,4,21547,4.3389045509464355,0.0,0.0
24966,2,4966,[302 427 197 180 603],666,5,21552,4.339037648479968,20.0,0.0
24967,2,4967,[302 427 197 180 603],271,5,21557,4.339170692431562,20.0,0.0
24968,2,4968,[302 427 197 180 603],271,5,21562,4.3393036828335685,20.0,0.0
24969,2,4969,[302 427 197 180 603],383,5,21567,4.33943661971831,20.0,0.0
24970,2,4970,[655  25  50   4 151],387,1,21568,4.3387648360490845,0.0,20.0
24971,2,4971,[323  88 127  50 357],13,3,21571,4.338495575221239,20.0,40.0
24972,2,4972,[302 427 197 180 603],664,5,21576,4.338628594409813,20.0,0.0
24973,2,4973,[302 427 197 180 603],474,5,21581,4.3387615601125855,20.0,0.0
24974,2,4974,[211  22 357 435 323],125,2,21583,4.338291457286432,20.0,0.0
24975,2,4975,[302 427 197 180 603],537,5,21588,4.338424437299035,20.0,0.0
24976,2,4976,[172 423 282 121 187],474,5,21593,4.33855736387382,0.0,0.0
24977,2,4977,[302 427 197 180 603],271,5,21598,4.338690237042989,20.0,0.0
24978,2,4978,[302 427 197 180 603],339,5,21603,4.338823056838723,20.0,0.0
24979,2,4979,[179 403 357 265  89],311,4,21607,4.338755020080321,20.0,0.0
24980,2,4980,[181 200   9  88 268],13,3,21610,4.338486247741417,0.0,0.0
24981,2,4981,[194  15 423 121 179],537,1,21611,4.33781613809715,0.0,0.0
24982,2,4982,[174   4  11  22 180],378,2,21613,4.337346979731086,0.0,20.0
24983,2,4983,[302 427 197 180 603],339,5,21618,4.337479935794542,20.0,0.0
24984,2,4984,[655 216 200  22   1],804,4,21622,4.33741223671013,0.0,0.0
24985,2,4985,[302 427 197 180 603],474,5,21627,4.337545126353791,20.0,0.0
24986,2,4986,[302 427 197 180 603],664,5,21632,4.337677962703028,20.0,0.0
24987,2,4987,[302 427 197 180 603],383,5,21637,4.337810745789896,20.0,0.0
24988,2,4988,[238 403  56 294 185],881,1,21638,4.337141711765885,0.0,0.0
24989,2,4989,[302 427 197 180 603],474,5,21643,4.337274549098196,20.0,0.0
24990,2,4990,[302 427 197 180 603],537,5,21648,4.337407333199759,20.0,0.0
24991,2,4991,[302 427 197 180 603],383,5,21653,4.337540064102564,20.0,0.0
24992,2,4992,[302 427 197 180 603],664,5,21658,4.337672741838574,20.0,0.0
24993,2,4993,[302 427 197 180 603],271,5,21663,4.337805366439728,20.0,0.0
24994,2,4994,[ 71 176  50 276 742],184,4,21667,4.337737737737737,0.0,20.0
24995,2,4995,[302 427 197 180 603],13,5,21672,4.337870296236989,20.0,0.0
24996,2,4996,[302 427 197 180 603],90,5,21677,4.338002801681009,20.0,0.0
24997,2,4997,[302 427 197 180 603],474,5,21682,4.3381352541016405,20.0,0.0
24998,2,4998,[302 427 197 180 603],664,5,21687,4.338267653530706,20.0,0.0
24999,2,4999,[302 427 197 180 603],474,5,21692,4.3384,20.0,0.0
25000,2,5000,[302 427 197 180 603],474,5,21697,4.3385322935412916,20.0,0.0
25001,2,5001,[302 427 197 180 603],383,5,21702,4.338664534186325,20.0,0.0
25002,2,5002,[215 151 603 100 318],474,4,21706,4.338596841894863,40.0,20.0
25003,2,5003,[302 427 197 180 603],474,5,21711,4.338729016786571,20.0,0.0
25004,2,5004,[302 427 197 180 603],474,5,21716,4.338861138861139,20.0,0.0
25005,2,5005,[302 427 197 180 603],339,5,21721,4.33899320815022,20.0,0.0
25006,2,5006,[ 71 111 323 301 196],83,2,21723,4.338526063511084,0.0,0.0
25007,2,5007,[302 427 197 180 603],271,5,21728,4.338658146964856,20.0,0.0
25008,2,5008,[302 427 197 180 603],13,5,21733,4.338790177680176,20.0,0.0
25009,2,5009,[302 427 197 180 603],13,5,21738,4.338922155688623,20.0,0.0
25010,2,5010,[302 427 197 180 603],339,5,21743,4.339054081021752,20.0,0.0
25011,2,5011,[ 88   4  97 191 176],343,5,21748,4.339185953711094,0.0,0.0
25012,2,5012,[302 427 197 180 603],537,5,21753,4.339317773788151,20.0,0.0
25013,2,5013,[302 427 197 180 603],271,5,21758,4.339449541284404,20.0,0.0
25014,2,5014,[ 69 183   9  22 182],145,4,21762,4.33938185443669,0.0,0.0
25015,2,5015,[302 427 197 180 603],474,5,21767,4.33951355661882,20.0,0.0
25016,2,5016,[302 427 197 180 603],90,5,21772,4.339645206298584,20.0,0.0
25017,2,5017,[302 427 197 180 603],664,5,21777,4.339776803507373,20.0,0.0
25018,2,5018,[302 427 197 180 603],339,5,21782,4.339908348276549,20.0,0.0
25019,2,5019,[302 427 197 180 603],664,5,21787,4.34003984063745,20.0,0.0
25020,2,5020,[302 427 197 180 603],537,5,21792,4.34017128062139,20.0,0.0
25021,2,5021,[483 191 216  97 435],194,3,21795,4.339904420549582,20.0,0.0
25022,2,5022,[302 427 197 180 603],474,5,21800,4.340035835158272,20.0,0.0
25023,2,5023,[228 111  25 144  89],87,5,21805,4.340167197452229,0.0,0.0
25024,2,5024,[302 427 197 180 603],90,5,21810,4.340298507462687,20.0,0.0
25025,2,5025,[118 215 546 187 202],298,3,21813,4.340031834460804,0.0,0.0
25026,2,5026,[302 427 197 180 603],537,5,21818,4.340163119156554,20.0,0.0
25027,2,5027,[742 546  88 275 168],271,2,21820,4.33969769291965,0.0,0.0
25028,2,5028,[302 427 197 180 603],666,5,21825,4.339828991847286,20.0,0.0
25029,2,5029,[302 427 197 180 603],13,5,21830,4.3399602385685885,20.0,0.0
25030,2,5030,[302 427 197 180 603],90,5,21835,4.340091433114689,20.0,0.0
25031,2,5031,[302 427 197 180 603],90,5,21840,4.340222575516693,20.0,0.0
25032,2,5032,[ 56 168 179 427  96],308,5,21845,4.340353665805683,0.0,0.0
25033,2,5033,[151 328 132 174   8],95,4,21849,4.3402860548271756,0.0,20.0
25034,2,5034,[302 427 197 180 603],537,5,21854,4.340417080436941,20.0,0.0
25035,2,5035,[302 427 197 180 603],537,5,21859,4.34054805401112,20.0,0.0
25036,2,5036,[197 216 302 265 282],334,3,21862,4.340281913837602,0.0,0.0
25037,2,5037,[  9 143  98 111 202],6,2,21864,4.339817387852323,0.0,20.0
25038,2,5038,[302 427 197 180 603],474,5,21869,4.339948402460806,20.0,0.0
25039,2,5039,[181  11 235 161 318],271,3,21872,4.339682539682539,20.0,0.0
25040,2,5040,[302 427 197 180 603],666,5,21877,4.339813529061694,20.0,0.0
25041,2,5041,[302 427 197 180 603],664,5,21882,4.339944466481555,20.0,0.0
25042,2,5042,[302 427 197 180 603],13,5,21887,4.340075351973032,20.0,0.0
25043,2,5043,[182 508 175 143 211],537,4,21891,4.3400079302141155,0.0,0.0
25044,2,5044,[302 427 197 180 603],666,5,21896,4.34013875123885,20.0,0.0
25045,2,5045,[302 427 197 180 603],537,5,21901,4.340269520412208,20.0,0.0
25046,2,5046,[302 427 197 180 603],13,5,21906,4.340400237765009,20.0,0.0
25047,2,5047,[302 427 197 180 603],383,5,21911,4.340530903328051,20.0,0.0
25048,2,5048,[302 427 197 180 603],474,5,21916,4.340661517132105,20.0,0.0
25049,2,5049,[302 427 197 180 603],90,5,21921,4.340792079207921,20.0,0.0
25050,2,5050,[302 427 197 180 603],90,5,21926,4.340922589586221,20.0,0.0
25051,2,5051,[302 427 197 180 603],339,5,21931,4.341053048297704,20.0,0.0
25052,2,5052,[302 427 197 180 603],271,5,21936,4.341183455373046,20.0,0.0
25053,2,5053,[302 427 197 180 603],474,5,21941,4.341313810842896,20.0,0.0
25054,2,5054,[302 427 197 180 603],474,5,21946,4.341444114737883,20.0,0.0
25055,2,5055,[483 234 222 228 117],648,4,21950,4.341376582278481,20.0,0.0
25056,2,5056,[181 286 204 183 176],447,4,21954,4.341309076527586,0.0,0.0
25057,2,5057,[302 427 197 180 603],90,5,21959,4.341439304072756,20.0,0.0
25058,2,5058,[ 28 194 161 288 435],13,4,21963,4.341371812611188,0.0,0.0
25059,2,5059,[302 427 197 180 603],383,5,21968,4.341501976284585,20.0,0.0
25060,2,5060,[302 427 197 180 603],664,5,21973,4.341632088520055,20.0,0.0
25061,2,5061,[302 427 197 180 603],537,5,21978,4.341762149348083,20.0,0.0
25062,2,5062,[211   8 222 435 742],328,3,21981,4.341497136085325,0.0,0.0
25063,2,5063,[100 187  28 515 117],537,3,21984,4.341232227488152,0.0,20.0
25064,2,5064,[222 143 286  11 238],474,5,21989,4.341362290227049,0.0,0.0
25065,2,5065,[302 427 197 180 603],474,5,21994,4.341492301618634,20.0,0.0
25066,2,5066,[302 427 197 180 603],271,5,21999,4.34162226169331,20.0,0.0
25067,2,5067,[210 435  28  25 237],406,2,22001,4.3411602209944755,0.0,0.0
25068,2,5068,[302 427 197 180 603],383,5,22006,4.3412901953047935,20.0,0.0
25069,2,5069,[302 427 197 180 603],474,5,22011,4.341420118343195,20.0,0.0
25070,2,5070,[302 427 197 180 603],664,5,22016,4.341549990140011,20.0,0.0
25071,2,5071,[ 96  71 289 275 508],406,2,22018,4.34108832807571,0.0,0.0
25072,2,5072,[302 427 197 180 603],664,5,22023,4.341218214074512,20.0,0.0
25073,2,5073,[ 11 588  96 228 172],406,4,22027,4.341150965707529,0.0,0.0
25074,2,5074,[302 427 197 180 603],383,5,22032,4.34128078817734,20.0,0.0
25075,2,5075,[302 427 197 180 603],474,5,22037,4.341410559495666,20.0,0.0
25076,2,5076,[427 405  69 144 111],666,1,22038,4.34075241284223,0.0,0.0
25077,2,5077,[302 427 197 180 603],664,5,22043,4.340882237101221,20.0,0.0
25078,2,5078,[302 427 197 180 603],664,5,22048,4.341012010238236,20.0,0.0
25079,2,5079,[302 427 197 180 603],537,5,22053,4.3411417322834644,20.0,0.0
25080,2,5080,[302 427 197 180 603],664,5,22058,4.341271403267074,20.0,0.0
25081,2,5081,[302 427 197 180 603],666,5,22063,4.341401023219205,20.0,0.0
25082,2,5082,[180 168 301 568 176],210,5,22068,4.3415305921699785,0.0,0.0
25083,2,5083,[302 427 197 180 603],664,5,22073,4.341660110149489,20.0,0.0
25084,2,5084,[302 427 197 180 603],474,5,22078,4.341789577187807,20.0,0.0
25085,2,5085,[ 98 318  89 496 423],184,5,22083,4.341918993314982,20.0,20.0
25086,2,5086,[302 427 197 180 603],271,5,22088,4.342048358561038,20.0,0.0
25087,2,5087,[302 427 197 180 603],13,5,22093,4.342177672955975,20.0,0.0
25088,2,5088,[269 435  22 176 237],64,5,22098,4.34230693652977,0.0,0.0
25089,2,5089,[302 427 197 180 603],271,5,22103,4.342436149312377,20.0,0.0
25090,2,5090,[302 427 197 180 603],383,5,22108,4.342565311333726,20.0,0.0
25091,2,5091,[216  64 182  70  11],13,2,22110,4.342105263157895,0.0,0.0
25092,2,5092,[  7 265 174  22 204],339,3,22113,4.3418417435696055,0.0,20.0
25093,2,5093,[238 179  98 132 273],643,2,22115,4.341382018060464,0.0,20.0
25094,2,5094,[238 300 180  50 423],843,0,22115,4.340529931305201,0.0,20.0
25095,2,5095,[302 427 197 180 603],537,5,22120,4.34065934065934,20.0,0.0
25096,2,5096,[302 427 197 180 603],13,5,22125,4.340788699234844,20.0,0.0
25097,2,5097,[588 144 181  71 515],308,3,22128,4.34052569635151,0.0,0.0
25098,2,5098,[302 427 197 180 603],271,5,22133,4.340655030398117,20.0,0.0
25099,2,5099,[302 427 197 180 603],90,5,22138,4.34078431372549,20.0,0.0
25100,2,5100,[302 427 197 180 603],90,5,22143,4.340913546363458,20.0,0.0
25101,2,5101,[302 427 197 180 603],666,5,22148,4.341042728341827,20.0,0.0
25102,2,5102,[302 427 197 180 603],271,5,22153,4.3411718596903786,20.0,0.0
25103,2,5103,[ 82 288 181 195  56],234,0,22153,4.34032131661442,0.0,0.0
25104,2,5104,[191 174 173 271 328],92,2,22155,4.339862879529873,0.0,20.0
25105,2,5105,[302 427 197 180 603],271,5,22160,4.3399921660791225,20.0,0.0
25106,2,5106,[302 427 197 180 603],13,5,22165,4.3401214019972585,20.0,0.0
25107,2,5107,[302 427 197 180 603],666,5,22170,4.340250587314017,20.0,0.0
25108,2,5108,[172   7 215 194 153],892,5,22175,4.340379722059112,0.0,0.0
25109,2,5109,[168 385   4  71 144],279,4,22179,4.3403131115459885,0.0,0.0
25110,2,5110,[302 427 197 180 603],664,5,22184,4.340442183525729,20.0,0.0
25111,2,5111,[302 427 197 180 603],474,5,22189,4.340571205007825,20.0,0.0
25112,2,5112,[234   7 748 568 215],524,2,22191,4.340113436338744,0.0,0.0
25113,2,5113,[302 427 197 180 603],474,5,22196,4.3402424716464605,20.0,0.0
25114,2,5114,[153 191  97 268 185],234,1,22197,4.3395894428152495,0.0,0.0
25115,2,5115,[302 427 197 180 603],339,5,22202,4.339718530101642,20.0,0.0
25116,2,5116,[197  97 204 179 151],374,3,22205,4.339456712917725,0.0,0.0
25117,2,5117,[302 427 197 180 603],537,5,22210,4.339585775693631,20.0,0.0
25118,2,5118,[215 742 196 194 143],42,5,22215,4.33971478804454,0.0,0.0
25119,2,5119,[ 28  97 132 179 204],194,3,22218,4.339453125,0.0,0.0
25120,2,5120,[265 179 742 228 235],92,3,22221,4.339191564147628,0.0,0.0
25121,2,5121,[302 427 197 180 603],339,5,22226,4.339320577899258,20.0,0.0
25122,2,5122,[302 427 197 180 603],537,5,22231,4.339449541284404,20.0,0.0
25123,2,5123,[302 427 197 180 603],13,5,22236,4.339578454332552,20.0,0.0
25124,2,5124,[111 121  28   8 132],378,4,22240,4.3395121951219515,0.0,0.0
25125,2,5125,[302 427 197 180 603],271,5,22245,4.339641045649629,20.0,0.0
25126,2,5126,[302 427 197 180 603],664,5,22250,4.33976984591379,20.0,0.0
25127,2,5127,[302 427 197 180 603],537,5,22255,4.339898595943838,20.0,0.0
25128,2,5128,[302 427 197 180 603],271,5,22260,4.340027295769156,20.0,0.0
25129,2,5129,[ 98 385 186  79 127],897,4,22264,4.339961013645224,0.0,40.0
25130,2,5130,[322  69 172 185 222],328,3,22267,4.339699863574352,0.0,0.0
25131,2,5131,[302 427 197 180 603],339,5,22272,4.339828526890101,20.0,0.0
25132,2,5132,[302 427 197 180 603],537,5,22277,4.339957140074031,20.0,0.0
25133,2,5133,[302 427 197 180 603],666,5,22282,4.3400857031554345,20.0,0.0
25134,2,5134,[302 427 197 180 603],666,5,22287,4.3402142161635835,20.0,0.0
25135,2,5135,[302 427 197 180 603],474,5,22292,4.340342679127726,20.0,0.0
25136,2,5136,[302 427 197 180 603],474,5,22297,4.340471092077088,20.0,0.0
25137,2,5137,[302 427 197 180 603],474,5,22302,4.340599455040872,20.0,0.0
25138,2,5138,[302 427 197 180 603],666,5,22307,4.340727768048258,20.0,0.0
25139,2,5139,[302 427 197 180 603],271,5,22312,4.340856031128404,20.0,0.0
25140,2,5140,[302 427 197 180 603],271,5,22317,4.340984244310445,20.0,0.0
25141,2,5141,[  4  71 655 471 515],194,4,22321,4.340917930766238,0.0,0.0
25142,2,5142,[302 427 197 180 603],13,5,22326,4.341046082053277,20.0,0.0
25143,2,5143,[302 427 197 180 603],474,5,22331,4.341174183514775,20.0,0.0
25144,2,5144,[302 427 197 180 603],339,5,22336,4.3413022351797865,20.0,0.0
25145,2,5145,[302 427 197 180 603],271,5,22341,4.341430237077342,20.0,0.0
25146,2,5146,[195 288   7 181 173],643,4,22345,4.3413639013017296,0.0,0.0
25147,2,5147,[271 258  11 235 153],64,2,22347,4.340909090909091,0.0,0.0
25148,2,5148,[302 427 197 180 603],383,5,22352,4.3410370945814725,20.0,0.0
25149,2,5149,[168  70 271 176 273],102,0,22352,4.340194174757282,0.0,0.0
25150,2,5150,[302 427 197 180 603],383,5,22357,4.34032226752087,20.0,0.0
25151,2,5151,[210   9 194  56 403],64,4,22361,4.340256211180124,0.0,0.0
25152,2,5152,[302 427 197 180 603],339,5,22366,4.340384242189016,20.0,0.0
25153,2,5153,[302 427 197 180 603],90,5,22371,4.340512223515716,20.0,0.0
25154,2,5154,[302 427 197 180 603],666,5,22376,4.340640155189137,20.0,0.0
25155,2,5155,[302 427 197 180 603],664,5,22381,4.340768037238169,20.0,0.0
25156,2,5156,[302 427 197 180 603],664,5,22386,4.340895869691681,20.0,0.0
25157,2,5157,[302 427 197 180 603],339,5,22391,4.341023652578519,20.0,0.0
25158,2,5158,[302 427 197 180 603],666,5,22396,4.341151385927505,20.0,0.0
25159,2,5159,[302 427 197 180 603],537,5,22401,4.341279069767442,20.0,0.0
25160,2,5160,[302 427 197 180 603],666,5,22406,4.341406704127107,20.0,0.0
25161,2,5161,[200 403 289 275 245],334,3,22409,4.341146842309183,0.0,0.0
25162,2,5162,[302 427 197 180 603],271,5,22414,4.341274452837498,20.0,0.0
25163,2,5163,[302 427 197 180 603],339,5,22419,4.34140201394268,20.0,0.0
25164,2,5164,[302 427 197 180 603],90,5,22424,4.341529525653437,20.0,0.0
25165,2,5165,[302 427 197 180 603],271,5,22429,4.3416569879984515,20.0,0.0
25166,2,5166,[144 135 196 313 318],144,5,22434,4.341784401006387,20.0,0.0
25167,2,5167,[302 427 197 180 603],90,5,22439,4.341911764705882,20.0,0.0
25168,2,5168,[302 427 197 180 603],13,5,22444,4.3420390791255565,20.0,0.0
25169,2,5169,[ 82 125 195 144 273],749,5,22449,4.342166344294004,0.0,0.0
25170,2,5170,[302 427 197 180 603],383,5,22454,4.342293560239799,20.0,0.0
25171,2,5171,[  7 179 678  11 235],537,2,22456,4.34184068058778,0.0,0.0
25172,2,5172,[186  28  25 176 471],899,4,22460,4.341774598878794,0.0,0.0
25173,2,5173,[302 427 197 180 603],666,5,22465,4.341901816776189,20.0,0.0
25174,2,5174,[302 427 197 180 603],664,5,22470,4.3420289855072465,20.0,0.0
25175,2,5175,[302 427 197 180 603],271,5,22475,4.342156105100464,20.0,0.0
25176,2,5176,[302 427 197 180 603],13,5,22480,4.342283175584315,20.0,0.0
25177,2,5177,[302 427 197 180 603],339,5,22485,4.342410196987254,20.0,0.0
25178,2,5178,[302 427 197 180 603],339,5,22490,4.34253716933771,20.0,0.0
25179,2,5179,[302 427 197 180 603],339,5,22495,4.3426640926640925,20.0,0.0
25180,2,5180,[302 427 197 180 603],664,5,22500,4.342790966994789,20.0,0.0
25181,2,5181,[ 71 210 228 289 322],234,1,22501,4.342145889617908,0.0,0.0
25182,2,5182,[302 427 197 180 603],13,5,22506,4.3422728149720236,20.0,0.0
25183,2,5183,[302 427 197 180 603],90,5,22511,4.3423996913580245,20.0,0.0
25184,2,5184,[302 427 197 180 603],13,5,22516,4.3425265188042435,20.0,0.0
25185,2,5185,[195  50  98 176 172],60,5,22521,4.342653297338989,0.0,40.0
25186,2,5186,[302 427 197 180 603],13,5,22526,4.342780026990553,20.0,0.0
25187,2,5187,[302 427 197 180 603],474,5,22531,4.3429067077872014,20.0,0.0
25188,2,5188,[302 427 197 180 603],666,5,22536,4.343033339757179,20.0,0.0
25189,2,5189,[302 427 197 180 603],90,5,22541,4.3431599229287094,20.0,0.0
25190,2,5190,[ 98 161 132 173 471],42,5,22546,4.343286457329994,0.0,20.0
25191,2,5191,[ 50  79 202 191  25],184,3,22549,4.3430277349768875,0.0,20.0
25192,2,5192,[302 427 197 180 603],664,5,22554,4.34315424610052,20.0,0.0
25193,2,5193,[302 427 197 180 603],90,5,22559,4.343280708509819,20.0,0.0
25194,2,5194,[302 427 197 180 603],90,5,22564,4.343407122232916,20.0,0.0
25195,2,5195,[302 427 197 180 603],474,5,22569,4.343533487297922,20.0,0.0
25196,2,5196,[ 70 151 161 200 143],653,2,22571,4.343082547623629,0.0,0.0
25197,2,5197,[302 427 197 180 603],383,5,22576,4.343208926510196,20.0,0.0
25198,2,5198,[302 427 197 180 603],383,5,22581,4.34333525678015,20.0,0.0
25199,2,5199,[302 427 197 180 603],474,5,22586,4.343461538461538,20.0,0.0
25200,2,5200,[302 427 197 180 603],666,5,22591,4.343587771582388,20.0,0.0
25201,2,5201,[302 427 197 180 603],537,5,22596,4.343713956170704,20.0,0.0
25202,2,5202,[302 427 197 180 603],271,5,22601,4.343840092254468,20.0,0.0
25203,2,5203,[302 427 197 180 603],474,5,22606,4.343966179861645,20.0,0.0
25204,2,5204,[302 427 197 180 603],664,5,22611,4.3440922190201725,20.0,0.0
25205,2,5205,[302 427 197 180 603],383,5,22616,4.344218209757972,20.0,0.0
25206,2,5206,[302 427 197 180 603],664,5,22621,4.344344152102939,20.0,0.0
25207,2,5207,[515 265  89  28 172],666,2,22623,4.34389400921659,0.0,0.0
25208,2,5208,[742 187 273 151  97],524,2,22625,4.343444039162987,0.0,0.0
25209,2,5209,[302 427 197 180 603],666,5,22630,4.343570057581574,20.0,0.0
25210,2,5210,[302 427 197 180 603],271,5,22635,4.343696027633851,20.0,0.0
25211,2,5211,[302 427 197 180 603],474,5,22640,4.343821949347659,20.0,0.0
25212,2,5212,[175 288 179 333 186],343,3,22643,4.34356416650681,0.0,0.0
25213,2,5213,[195 200 275 204 127],537,2,22645,4.343114691215957,0.0,20.0
25214,2,5214,[ 69 180  64  96 268],234,2,22647,4.342665388302972,0.0,0.0
25215,2,5215,[302 427 197 180 603],383,5,22652,4.342791411042945,20.0,0.0
25216,2,5216,[597   9  89 546 323],455,1,22653,4.3421506612995975,0.0,0.0
25217,2,5217,[302 427 197 180 603],90,5,22658,4.342276734380989,20.0,0.0
25218,2,5218,[302 427 197 180 603],664,5,22663,4.342402759149262,20.0,0.0
25219,2,5219,[302 427 197 180 603],664,5,22668,4.342528735632184,20.0,0.0
25220,2,5220,[222 144 100 546  96],64,3,22671,4.342271595479793,0.0,20.0
25221,2,5221,[ 15 302 173   7 265],14,4,22675,4.342206051321333,0.0,0.0
25222,2,5222,[403  64  98 357 135],749,5,22680,4.342331993107409,20.0,20.0
25223,2,5223,[210  28 118 427 121],454,5,22685,4.342457886676876,0.0,0.0
25224,2,5224,[238  69 100 568 515],313,5,22690,4.342583732057416,0.0,20.0
25225,2,5225,[302 427 197 180 603],13,5,22695,4.342709529276694,20.0,0.0
25226,2,5226,[302 427 197 180 603],664,5,22700,4.342835278362349,20.0,0.0
25227,2,5227,[302 427 197 180 603],664,5,22705,4.3429609793420045,20.0,0.0
25228,2,5228,[302 427 197 180 603],339,5,22710,4.343086632243259,20.0,0.0
25229,2,5229,[302 427 197 180 603],537,5,22715,4.34321223709369,20.0,0.0
25230,2,5230,[302 427 197 180 603],13,5,22720,4.343337793920856,20.0,0.0
25231,2,5231,[302 427 197 180 603],383,5,22725,4.343463302752293,20.0,0.0
25232,2,5232,[357   7 196  12 427],380,4,22729,4.343397668641315,40.0,0.0
25233,2,5233,[302 427 197 180 603],666,5,22734,4.34352311807413,20.0,0.0
25234,2,5234,[302 427 197 180 603],90,5,22739,4.343648519579752,20.0,0.0
25235,2,5235,[302 427 197 180 603],13,5,22744,4.343773873185638,20.0,0.0
25236,2,5236,[302 427 197 180 603],383,5,22749,4.343899178919228,20.0,0.0
25237,2,5237,[302 427 197 180 603],90,5,22754,4.344024436807942,20.0,0.0
25238,2,5238,[302 427 197 180 603],271,5,22759,4.344149646879176,20.0,0.0
25239,2,5239,[302 427 197 180 603],666,5,22764,4.344274809160305,20.0,0.0
25240,2,5240,[182  11 153 258 288],102,1,22765,4.343636710551421,0.0,0.0
25241,2,5241,[302 427 197 180 603],383,5,22770,4.343761922930179,20.0,0.0
25242,2,5242,[275 117  25 173 603],899,3,22773,4.343505626549685,20.0,0.0
25243,2,5243,[302 427 197 180 603],664,5,22778,4.343630816170862,20.0,0.0
25244,2,5244,[302 427 197 180 603],474,5,22783,4.343755958055291,20.0,0.0
25245,2,5245,[302 427 197 180 603],13,5,22788,4.34388105223027,20.0,0.0
25246,2,5246,[197 181 238 423 168],474,4,22792,4.343815513626835,0.0,0.0
25247,2,5247,[302 427 197 180 603],664,5,22797,4.343940548780488,20.0,0.0
25248,2,5248,[302 427 197 180 603],90,5,22802,4.344065536292627,20.0,0.0
25249,2,5249,[ 98 385 176  15 257],881,4,22806,4.344,0.0,20.0
25250,2,5250,[302 427 197 180 603],664,5,22811,4.344124928585032,20.0,0.0
25251,2,5251,[302 427 197 180 603],271,5,22816,4.344249809596344,20.0,0.0
25252,2,5252,[302 427 197 180 603],339,5,22821,4.344374643061108,20.0,0.0
25253,2,5253,[302 427 197 180 603],383,5,22826,4.344499429006471,20.0,0.0
25254,2,5254,[135 151 234 211 127],234,3,22829,4.344243577545195,0.0,20.0
25255,2,5255,[302 427 197 180 603],90,5,22834,4.344368340943683,20.0,0.0
25256,2,5256,[151   8 194  97 175],64,3,22837,4.3441126117557545,0.0,0.0
25257,2,5257,[302 427 197 180 603],383,5,22842,4.344237352605553,20.0,0.0
25258,2,5258,[302 427 197 180 603],13,5,22847,4.344362046016353,20.0,0.0
25259,2,5259,[302 427 197 180 603],664,5,22852,4.344486692015209,20.0,0.0
25260,2,5260,[302 427 197 180 603],271,5,22857,4.344611290629158,20.0,0.0
25261,2,5261,[302 427 197 180 603],339,5,22862,4.344735841885215,20.0,0.0
25262,2,5262,[302 427 197 180 603],666,5,22867,4.344860345810375,20.0,0.0
25263,2,5263,[603 179  22 228 111],749,4,22871,4.344794832826747,20.0,0.0
25264,2,5264,[294  25 121  69  96],666,0,22871,4.343969610636277,0.0,0.0
25265,2,5265,[302 427 197 180 603],90,5,22876,4.3440941891378655,20.0,0.0
25266,2,5266,[302 427 197 180 603],90,5,22881,4.3442187203341565,20.0,0.0
25267,2,5267,[302 427 197 180 603],271,5,22886,4.344343204252088,20.0,0.0
25268,2,5268,[302 427 197 180 603],271,5,22891,4.34446764091858,20.0,0.0
25269,2,5269,[302 427 197 180 603],13,5,22896,4.344592030360531,20.0,0.0
25270,2,5270,[302 427 197 180 603],666,5,22901,4.344716372604819,20.0,0.0
25271,2,5271,[302 427 197 180 603],90,5,22906,4.344840667678301,20.0,0.0
25272,2,5272,[302 427 197 180 603],383,5,22911,4.344964915607814,20.0,0.0
25273,2,5273,[302 427 197 180 603],339,5,22916,4.345089116420175,20.0,0.0
25274,2,5274,[265 135  15 318 173],537,3,22919,4.344834123222749,20.0,0.0
25275,2,5275,[302 427 197 180 603],666,5,22924,4.344958301743746,20.0,0.0
25276,2,5276,[302 427 197 180 603],664,5,22929,4.345082433200682,20.0,0.0
25277,2,5277,[302 427 197 180 603],537,5,22934,4.34520651762031,20.0,0.0
25278,2,5278,[302 427 197 180 603],13,5,22939,4.345330555029362,20.0,0.0
25279,2,5279,[302 427 197 180 603],666,5,22944,4.345454545454546,20.0,0.0
25280,2,5280,[302 427 197 180 603],664,5,22949,4.345578488922553,20.0,0.0
25281,2,5281,[302 427 197 180 603],90,5,22954,4.345702385460053,20.0,0.0
25282,2,5282,[125 179  97 265 288],64,3,22957,4.34544766231308,0.0,0.0
25283,2,5283,[302 427 197 180 603],666,5,22962,4.34557153671461,20.0,0.0
25284,2,5284,[302 427 197 180 603],474,5,22967,4.34569536423841,20.0,0.0
25285,2,5285,[302 427 197 180 603],90,5,22972,4.3458191449110855,20.0,0.0
25286,2,5286,[302 427 197 180 603],13,5,22977,4.345942878759221,20.0,0.0
25287,2,5287,[179 191 496  88  89],659,3,22980,4.345688350983359,0.0,0.0
25288,2,5288,[302 427 197 180 603],13,5,22985,4.345812062771791,20.0,0.0
25289,2,5289,[228 216 100 318  89],85,2,22987,4.345368620037807,20.0,20.0
25290,2,5290,[302 427 197 180 603],537,5,22992,4.345492345492345,20.0,0.0
25291,2,5291,[ 69 655  64  82 211],343,5,22997,4.345616024187453,0.0,0.0
25292,2,5292,[302 427 197 180 603],474,5,23002,4.3457396561496315,20.0,0.0
25293,2,5293,[302 427 197 180 603],90,5,23007,4.345863241405365,20.0,0.0
25294,2,5294,[127 181 121   4 185],643,4,23011,4.345797922568461,0.0,20.0
25295,2,5295,[210 234  22 603 508],13,3,23014,4.345543806646526,20.0,0.0
25296,2,5296,[435  71 153 568 172],788,0,23014,4.344723428355673,0.0,0.0
25297,2,5297,[302 427 197 180 603],339,5,23019,4.3448471121177805,20.0,0.0
25298,2,5298,[302 427 197 180 603],666,5,23024,4.3449707491979614,20.0,0.0
25299,2,5299,[282  56 257 322 546],533,3,23027,4.344716981132075,0.0,0.0
25300,2,5300,[302 427 197 180 603],666,5,23032,4.344840596113941,20.0,0.0
25301,2,5301,[302 427 197 180 603],537,5,23037,4.344964164466239,20.0,0.0
25302,2,5302,[318  64   1  69 118],380,3,23040,4.344710541203092,20.0,0.0
25303,2,5303,[302 427 197 180 603],339,5,23045,4.344834087481146,20.0,0.0
25304,2,5304,[127 496 195 186  22],387,3,23048,4.344580584354382,0.0,20.0
25305,2,5305,[258 210 144 151 180],215,3,23051,4.344327176781003,0.0,0.0
25306,2,5306,[132  50 202 748 257],749,3,23054,4.344073864706991,0.0,20.0
25307,2,5307,[174 215 289 200 508],474,2,23056,4.3436322532027125,0.0,20.0
25308,2,5308,[288 301 121 238  71],650,1,23057,4.343002448672066,0.0,0.0
25309,2,5309,[678 132 271 423 748],749,3,23060,4.342749529190207,0.0,0.0
25310,2,5310,[302 427 197 180 603],664,5,23065,4.3428732818678215,20.0,0.0
25311,2,5311,[302 427 197 180 603],474,5,23070,4.342996987951807,20.0,0.0
25312,2,5312,[302 427 197 180 603],537,5,23075,4.343120647468473,20.0,0.0
25313,2,5313,[302 427 197 180 603],13,5,23080,4.34324426044411,20.0,0.0
25314,2,5314,[302 427 197 180 603],339,5,23085,4.343367826904986,20.0,0.0
25315,2,5315,[302 427 197 180 603],90,5,23090,4.343491346877351,20.0,0.0
25316,2,5316,[302 427 197 180 603],537,5,23095,4.343614820387437,20.0,0.0
25317,2,5317,[172 405 496 273  56],59,3,23098,4.343362166227905,0.0,0.0
25318,2,5318,[302 427 197 180 603],664,5,23103,4.343485617597293,20.0,0.0
25319,2,5319,[302 427 197 180 603],271,5,23108,4.343609022556391,20.0,0.0
25320,2,5320,[289 187  25 678 161],474,3,23111,4.343356511933847,0.0,0.0
25321,2,5321,[117 508 235  64 258],378,4,23115,4.343291995490417,0.0,0.0
25322,2,5322,[175 202 235 211 180],738,3,23118,4.343039639301146,0.0,0.0
25323,2,5323,[302 427 197 180 603],664,5,23123,4.343163035311796,20.0,0.0
25324,2,5324,[302 427 197 180 603],666,5,23128,4.343286384976526,20.0,0.0
25325,2,5325,[302 427 197 180 603],664,5,23133,4.343409688321442,20.0,0.0
25326,2,5326,[302 427 197 180 603],90,5,23138,4.34353294537263,20.0,0.0
25327,2,5327,[302 427 197 180 603],664,5,23143,4.343656156156156,20.0,0.0
25328,2,5328,[302 427 197 180 603],13,5,23148,4.343779320698067,20.0,0.0
25329,2,5329,[302 427 197 180 603],383,5,23153,4.34390243902439,20.0,0.0
25330,2,5330,[302 427 197 180 603],664,5,23158,4.344025511161133,20.0,0.0
25331,2,5331,[302 427 197 180 603],383,5,23163,4.344148537134283,20.0,0.0
25332,2,5332,[302 427 197 180 603],537,5,23168,4.344271516969811,20.0,0.0
25333,2,5333,[302 427 197 180 603],474,5,23173,4.344394450693663,20.0,0.0
25334,2,5334,[302 427 197 180 603],271,5,23178,4.344517338331771,20.0,0.0
25335,2,5335,[132   8  25 385 182],234,2,23180,4.34407796101949,0.0,0.0
25336,2,5336,[302 427 197 180 603],474,5,23185,4.344200861907439,20.0,0.0
25337,2,5337,[302 427 197 180 603],474,5,23190,4.344323716747845,20.0,0.0
25338,2,5338,[302 427 197 180 603],271,5,23195,4.344446525566585,20.0,0.0
25339,2,5339,[302 427 197 180 603],339,5,23200,4.344569288389513,20.0,0.0
25340,2,5340,[117 294 678  95 176],308,2,23202,4.344130312675529,0.0,0.0
25341,2,5341,[302 427 197 180 603],537,5,23207,4.344253088730812,20.0,0.0
25342,2,5342,[302 427 197 180 603],271,5,23212,4.344375818828373,20.0,0.0
25343,2,5343,[302 427 197 180 603],537,5,23217,4.344498502994012,20.0,0.0
25344,2,5344,[302 427 197 180 603],537,5,23222,4.344621141253508,20.0,0.0
25345,2,5345,[568 183 427 204 435],379,5,23227,4.3447437336326225,0.0,0.0
25346,2,5346,[302 427 197 180 603],90,5,23232,4.344866280157097,20.0,0.0
25347,2,5347,[302 427 197 180 603],90,5,23237,4.344988780852655,20.0,0.0
25348,2,5348,[302 427 197 180 603],664,5,23242,4.345111235744999,20.0,0.0
25349,2,5349,[268 483 515 301 269],13,2,23244,4.344672897196261,20.0,0.0
25350,2,5350,[423 323 235  89 357],804,4,23248,4.34460848439544,20.0,0.0
25351,2,5351,[222 269 748 186 216],64,4,23252,4.344544095665172,0.0,0.0
25352,2,5352,[302 427 197 180 603],90,5,23257,4.3446665421259105,20.0,0.0
25353,2,5353,[ 69 427  98 271 655],328,3,23260,4.344415390362346,0.0,20.0
25354,2,5354,[302 427 197 180 603],271,5,23265,4.34453781512605,20.0,0.0
25355,2,5355,[302 427 197 180 603],474,5,23270,4.344660194174757,20.0,0.0
25356,2,5356,[194 294 435 678 210],13,2,23272,4.344222512600336,0.0,0.0
25357,2,5357,[435  69 286 357 111],59,4,23276,4.344158268010451,20.0,0.0
25358,2,5358,[ 28 182 275 181 132],474,4,23280,4.3440940473969025,0.0,0.0
25359,2,5359,[302 427 197 180 603],664,5,23285,4.344216417910448,20.0,0.0
25360,2,5360,[322 195  82 121 289],533,4,23289,4.344152210408506,0.0,0.0
25361,2,5361,[302 427 197 180 603],383,5,23294,4.3442745244311824,20.0,0.0
25362,2,5362,[302 427 197 180 603],339,5,23299,4.344396792839828,20.0,0.0
25363,2,5363,[302 427 197 180 603],664,5,23304,4.344519015659955,20.0,0.0
25364,2,5364,[  4 191 143  70  96],295,4,23308,4.344454799627213,0.0,0.0
25365,2,5365,[ 95 176 385 515 333],537,1,23309,4.343831531867313,0.0,0.0
25366,2,5366,[ 89 172 151 127 403],650,2,23311,4.343394820197504,0.0,20.0
25367,2,5367,[302 427 197 180 603],339,5,23316,4.343517138599106,20.0,0.0
25368,2,5368,[302 427 197 180 603],666,5,23321,4.343639411436022,20.0,0.0
25369,2,5369,[173   4 357 269  64],7,4,23325,4.343575418994414,20.0,0.0
25370,2,5370,[258 182 508 271 742],92,3,23328,4.343325265313722,0.0,0.0
25371,2,5371,[ 70 265 161 282 204],42,3,23331,4.343075204765451,0.0,0.0
25372,2,5372,[302 427 197 180 603],664,5,23336,4.343197468825609,20.0,0.0
25373,2,5373,[302 427 197 180 603],664,5,23341,4.3433196873836994,20.0,0.0
25374,2,5374,[302 427 197 180 603],383,5,23346,4.343441860465116,20.0,0.0
25375,2,5375,[302 427 197 180 603],537,5,23351,4.343563988095238,20.0,0.0
25376,2,5376,[235 322 748 210 423],524,2,23353,4.34312813836712,0.0,0.0
25377,2,5377,[302 427 197 180 603],664,5,23358,4.343250278914095,20.0,0.0
25378,2,5378,[302 427 197 180 603],339,5,23363,4.34337237404722,20.0,0.0
25379,2,5379,[ 97  50 435 471 265],234,1,23364,4.342750929368029,0.0,20.0
25380,2,5380,[302 427 197 180 603],90,5,23369,4.342873071919717,20.0,0.0
25381,2,5381,[179 197 182 153 200],339,5,23374,4.342995169082125,0.0,0.0
25382,2,5382,[180 228 238  98 275],95,3,23377,4.342745680847111,0.0,20.0
25383,2,5383,[302 427 197 180 603],537,5,23382,4.342867756315007,20.0,0.0
25384,2,5384,[302 427 197 180 603],666,5,23387,4.342989786443826,20.0,0.0
25385,2,5385,[302 427 197 180 603],537,5,23392,4.343111771258819,20.0,0.0
25386,2,5386,[302 427 197 180 603],664,5,23397,4.343233710785223,20.0,0.0
25387,2,5387,[302 427 197 180 603],474,5,23402,4.343355605048256,20.0,0.0
25388,2,5388,[302 427 197 180 603],13,5,23407,4.343477454073112,20.0,0.0
25389,2,5389,[302 427 197 180 603],474,5,23412,4.343599257884972,20.0,0.0
25390,2,5390,[678 568 302 322 111],13,2,23414,4.343164533481729,0.0,0.0
25391,2,5391,[302 427 197 180 603],271,5,23419,4.343286350148368,20.0,0.0
25392,2,5392,[175 301  22 385 180],90,4,23423,4.343222696087521,0.0,0.0
25393,2,5393,[302 427 197 180 603],664,5,23428,4.343344456803856,20.0,0.0
25394,2,5394,[302 427 197 180 603],666,5,23433,4.343466172381835,20.0,0.0
25395,2,5395,[302 427 197 180 603],664,5,23438,4.343587842846553,20.0,0.0
25396,2,5396,[302 427 197 180 603],339,5,23443,4.343709468223087,20.0,0.0
25397,2,5397,[302 427 197 180 603],666,5,23448,4.343831048536495,20.0,0.0
25398,2,5398,[302 427 197 180 603],537,5,23453,4.343952583811817,20.0,0.0
25399,2,5399,[183 403 186 195 289],881,2,23455,4.343518518518518,0.0,0.0
25400,2,5400,[302 427 197 180 603],90,5,23460,4.343640066654324,20.0,0.0
25401,2,5401,[302 427 197 180 603],474,5,23465,4.343761569788967,20.0,0.0
25402,2,5402,[302 427 197 180 603],537,5,23470,4.343883027947436,20.0,0.0
25403,2,5403,[302 427 197 180 603],666,5,23475,4.3440044411547,20.0,0.0
25404,2,5404,[302 427 197 180 603],666,5,23480,4.344125809435708,20.0,0.0
25405,2,5405,[  4 100 186  12 471],207,2,23482,4.343692193858676,20.0,20.0
25406,2,5406,[302 427 197 180 603],339,5,23487,4.343813574995377,20.0,0.0
25407,2,5407,[333 313 144 215 258],144,4,23491,4.34375,0.0,0.0
25408,2,5408,[302 427 197 180 603],474,5,23496,4.343871325568497,20.0,0.0
25409,2,5409,[302 427 197 180 603],537,5,23501,4.343992606284658,20.0,0.0
25410,2,5410,[302 427 197 180 603],664,5,23506,4.344113842173351,20.0,0.0
25411,2,5411,[182 181  88  96 179],13,4,23510,4.344050258684405,0.0,0.0
25412,2,5412,[302 427 197 180 603],664,5,23515,4.344171439128025,20.0,0.0
25413,2,5413,[302 427 197 180 603],339,5,23520,4.344292574806058,20.0,0.0
25414,2,5414,[302 427 197 180 603],383,5,23525,4.344413665743305,20.0,0.0
25415,2,5415,[302 427 197 180 603],90,5,23530,4.34453471196455,20.0,0.0
25416,2,5416,[302 427 197 180 603],383,5,23535,4.3446557134945545,20.0,0.0
25417,2,5417,[302 427 197 180 603],664,5,23540,4.3447766703580655,20.0,0.0
25418,2,5418,[ 15 427 405 196 289],406,2,23542,4.3443439749031185,0.0,0.0
25419,2,5419,[302 427 197 180 603],13,5,23547,4.344464944649446,20.0,0.0
25420,2,5420,[172 215 100 282 300],533,5,23552,4.344585869765726,0.0,20.0
25421,2,5421,[302 427 197 180 603],664,5,23557,4.344706750276651,20.0,0.0
25422,2,5422,[302 427 197 180 603],537,5,23562,4.344827586206897,20.0,0.0
25423,2,5423,[302 427 197 180 603],666,5,23567,4.344948377581121,20.0,0.0
25424,2,5424,[302 427 197 180 603],13,5,23572,4.345069124423963,20.0,0.0
25425,2,5425,[515   9 125 288 405],894,2,23574,4.344636933284187,0.0,0.0
25426,2,5426,[302 427 197 180 603],13,5,23579,4.344757693016399,20.0,0.0
25427,2,5427,[302 427 197 180 603],13,5,23584,4.344878408253501,20.0,0.0
25428,2,5428,[302 427 197 180 603],339,5,23589,4.344999079020077,20.0,0.0
25429,2,5429,[302 427 197 180 603],271,5,23594,4.3451197053407,20.0,0.0
25430,2,5430,[174 435 168 127 515],815,3,23597,4.34487203093353,0.0,40.0
25431,2,5431,[302 427 197 180 603],13,5,23602,4.344992636229749,20.0,0.0
25432,2,5432,[302 427 197 180 603],537,5,23607,4.345113197128658,20.0,0.0
25433,2,5433,[302 427 197 180 603],13,5,23612,4.345233713654766,20.0,0.0
25434,2,5434,[302 427 197 180 603],90,5,23617,4.345354185832567,20.0,0.0
25435,2,5435,[302 427 197 180 603],271,5,23622,4.345474613686534,20.0,0.0
25436,2,5436,[302 427 197 180 603],664,5,23627,4.345594997241125,20.0,0.0
25437,2,5437,[302 427 197 180 603],664,5,23632,4.3457153365207795,20.0,0.0
25438,2,5438,[  1 678  50 357 100],881,3,23635,4.345467916896489,20.0,40.0
25439,2,5439,[302 427 197 180 603],13,5,23640,4.345588235294118,20.0,0.0
25440,2,5440,[302 427 197 180 603],666,5,23645,4.3457085094651715,20.0,0.0
25441,2,5441,[302 427 197 180 603],13,5,23650,4.345828739434031,20.0,0.0
25442,2,5442,[302 427 197 180 603],271,5,23655,4.34594892522506,20.0,0.0
25443,2,5443,[302 427 197 180 603],339,5,23660,4.346069066862601,20.0,0.0
25444,2,5444,[302 427 197 180 603],13,5,23665,4.3461891643709825,20.0,0.0
25445,2,5445,[302 427 197 180 603],13,5,23670,4.346309217774514,20.0,0.0
25446,2,5446,[215 183 182 196  95],95,3,23673,4.3460620525059666,0.0,0.0
25447,2,5447,[ 22 678 191 181 294],537,1,23674,4.345447870778267,0.0,0.0
25448,2,5448,[302 427 197 180 603],339,5,23679,4.345567994127363,20.0,0.0
25449,2,5449,[302 427 197 180 603],666,5,23684,4.345688073394496,20.0,0.0
25450,2,5450,[302 427 197 180 603],339,5,23689,4.345808108603926,20.0,0.0
25451,2,5451,[302 427 197 180 603],474,5,23694,4.345928099779897,20.0,0.0
25452,2,5452,[302 427 197 180 603],666,5,23699,4.346048046946635,20.0,0.0
25453,2,5453,[302 427 197 180 603],537,5,23704,4.346167950128346,20.0,0.0
25454,2,5454,[276 300 235  89  69],537,2,23706,4.345737855178735,0.0,0.0
25455,2,5455,[302 427 197 180 603],666,5,23711,4.345857771260997,20.0,0.0
25456,2,5456,[302 427 197 180 603],90,5,23716,4.345977643393806,20.0,0.0
25457,2,5457,[403 215  25   4 176],234,1,23717,4.345364602418468,0.0,0.0
25458,2,5458,[195 153  70  82 185],194,1,23718,4.3447517860413996,0.0,0.0
25459,2,5459,[ 28 237 127 603   4],537,2,23720,4.344322344322344,20.0,20.0
25460,2,5460,[302 427 197 180 603],13,5,23725,4.344442409815052,20.0,0.0
25461,2,5461,[302 427 197 180 603],537,5,23730,4.34456243134383,20.0,0.0
25462,2,5462,[496 216  69  98  28],892,5,23735,4.344682408932821,0.0,20.0
25463,2,5463,[302 427 197 180 603],339,5,23740,4.344802342606149,20.0,0.0
25464,2,5464,[276  88 471 475 168],374,2,23742,4.344373284537969,0.0,0.0
25465,2,5465,[302 427 197 180 603],383,5,23747,4.344493230881815,20.0,0.0
25466,2,5466,[322 238 143 318 286],234,1,23748,4.343881470642034,20.0,0.0
25467,2,5467,[302 427 197 180 603],664,5,23753,4.344001463057791,20.0,0.0
25468,2,5468,[273 216  12 161 175],7,3,23756,4.343755714024502,20.0,0.0
25469,2,5469,[302 427 197 180 603],664,5,23761,4.343875685557586,20.0,0.0
25470,2,5470,[294 100  88 257 174],374,2,23763,4.34344726740998,0.0,40.0
25471,2,5471,[302 427 197 180 603],339,5,23768,4.343567251461988,20.0,0.0
25472,2,5472,[302 427 197 180 603],271,5,23773,4.343687191668189,20.0,0.0
25473,2,5473,[ 79 286  71 187 515],650,1,23774,4.3430763609791745,0.0,0.0
25474,2,5474,[302 427 197 180 603],537,5,23779,4.343196347031964,20.0,0.0
25475,2,5475,[302 427 197 180 603],339,5,23784,4.343316289262235,20.0,0.0
25476,2,5476,[302 427 197 180 603],383,5,23789,4.343436187693993,20.0,0.0
25477,2,5477,[179 127  56 168   8],85,5,23794,4.343556042351223,0.0,20.0
25478,2,5478,[302 427 197 180 603],383,5,23799,4.343675853257894,20.0,0.0
25479,2,5479,[302 427 197 180 603],664,5,23804,4.343795620437956,20.0,0.0
25480,2,5480,[ 25 183  15   7 194],537,1,23805,4.343185550082102,0.0,0.0
25481,2,5481,[302 427 197 180 603],383,5,23810,4.343305363006202,20.0,0.0
25482,2,5482,[238 228 204 135 153],194,2,23812,4.342877986503739,0.0,0.0
25483,2,5483,[302 427 197 180 603],383,5,23817,4.3429978118161925,20.0,0.0
25484,2,5484,[288 301  28 588 175],13,3,23820,4.342752962625342,0.0,0.0
25485,2,5485,[302 427 197 180 603],383,5,23825,4.342872767043383,20.0,0.0
25486,2,5486,[302 427 197 180 603],271,5,23830,4.3429925277929655,20.0,0.0
25487,2,5487,[302 427 197 180 603],271,5,23835,4.343112244897959,20.0,0.0
25488,2,5488,[385  25 191   8 403],892,3,23838,4.342867553288395,0.0,0.0
25489,2,5489,[202 435 385  95 125],881,4,23842,4.342805100182149,0.0,0.0
25490,2,5490,[302 427 197 180 603],339,5,23847,4.3429247860134765,20.0,0.0
25491,2,5491,[302 427 197 180 603],383,5,23852,4.343044428259287,20.0,0.0
25492,2,5492,[302 427 197 180 603],13,5,23857,4.343164026943382,20.0,0.0
25493,2,5493,[302 427 197 180 603],383,5,23862,4.343283582089552,20.0,0.0
25494,2,5494,[302 427 197 180 603],664,5,23867,4.343403093721565,20.0,0.0
25495,2,5495,[191 496  97 257 183],653,1,23868,4.342794759825328,0.0,0.0
25496,2,5496,[302 427 197 180 603],664,5,23873,4.342914316900127,20.0,0.0
25497,2,5497,[121 496  22 289 423],474,4,23877,4.342851946162241,0.0,0.0
25498,2,5498,[302 427 197 180 603],537,5,23882,4.342971449354428,20.0,0.0
25499,2,5499,[302 427 197 180 603],537,5,23887,4.343090909090909,20.0,0.0
25500,2,5500,[302 427 197 180 603],13,5,23892,4.343210325395383,20.0,0.0
25501,2,5501,[183 268 117 508 603],669,1,23893,4.342602689930934,20.0,0.0
25502,2,5502,[182  95  96 742 215],524,2,23895,4.342176994366709,0.0,0.0
25503,2,5503,[100 127 202 215 265],308,3,23898,4.341933139534884,0.0,40.0
25504,2,5504,[323 135 144  95 313],378,3,23901,4.341689373297003,0.0,0.0
25505,2,5505,[302 427 197 180 603],537,5,23906,4.341808935706502,20.0,0.0
25506,2,5506,[302 427 197 180 603],666,5,23911,4.341928454694026,20.0,0.0
25507,2,5507,[302 427 197 180 603],13,5,23916,4.342047930283225,20.0,0.0
25508,2,5508,[265 183 175  98 176],334,3,23919,4.341804320203304,0.0,20.0
25509,2,5509,[302 427 197 180 603],339,5,23924,4.341923774954628,20.0,0.0
25510,2,5510,[302 427 197 180 603],664,5,23929,4.342043186354563,20.0,0.0
25511,2,5511,[435   4 678 202 196],13,4,23933,4.341981132075472,0.0,0.0
25512,2,5512,[302 427 197 180 603],474,5,23938,4.3421004897514965,20.0,0.0
25513,2,5513,[132 357  97 271 151],650,2,23940,4.341675734494015,20.0,0.0
25514,2,5514,[302 427 197 180 603],339,5,23945,4.341795104261106,20.0,0.0
25515,2,5515,[302 427 197 180 603],666,5,23950,4.341914430746918,20.0,0.0
25516,2,5516,[496 234 186 183  56],385,1,23951,4.341308682254849,0.0,0.0
25517,2,5517,[302 427 197 180 603],271,5,23956,4.341428053642624,20.0,0.0
25518,2,5518,[302 427 197 180 603],664,5,23961,4.3415473817720605,20.0,0.0
25519,2,5519,[302 427 197 180 603],666,5,23966,4.341666666666667,20.0,0.0
25520,2,5520,[302 427 197 180 603],13,5,23971,4.341785908349936,20.0,0.0
25521,2,5521,[186 222 265 117 195],313,3,23974,4.341542919232162,0.0,0.0
25522,2,5522,[302 427 197 180 603],664,5,23979,4.341662140141228,20.0,0.0
25523,2,5523,[302 427 197 180 603],664,5,23984,4.34178131788559,20.0,0.0
25524,2,5524,[302 427 197 180 603],664,5,23989,4.341900452488688,20.0,0.0
25525,2,5525,[302 427 197 180 603],666,5,23994,4.342019543973941,20.0,0.0
25526,2,5526,[302 427 197 180 603],271,5,23999,4.342138592364755,20.0,0.0
25527,2,5527,[125 546 328 195 173],207,1,24000,4.341534008683068,0.0,0.0
25528,2,5528,[302 427 197 180 603],13,5,24005,4.341653101826732,20.0,0.0
25529,2,5529,[405 496  69  82 423],59,4,24009,4.341591320072332,0.0,0.0
25530,2,5530,[302 427 197 180 603],474,5,24014,4.341710359790273,20.0,0.0
25531,2,5531,[302 427 197 180 603],13,5,24019,4.341829356471439,20.0,0.0
25532,2,5532,[302 427 197 180 603],474,5,24024,4.341948310139165,20.0,0.0
25533,2,5533,[302 427 197 180 603],664,5,24029,4.342067220816769,20.0,0.0
25534,2,5534,[ 12  96 127 405 322],474,5,24034,4.342186088527552,20.0,20.0
25535,2,5535,[302 427 197 180 603],13,5,24039,4.3423049132947975,20.0,0.0
25536,2,5536,[302 427 197 180 603],537,5,24044,4.342423695141774,20.0,0.0
25537,2,5537,[302 427 197 180 603],537,5,24049,4.34254243409173,20.0,0.0
25538,2,5538,[302 427 197 180 603],664,5,24054,4.3426611301679,20.0,0.0
25539,2,5539,[302 427 197 180 603],13,5,24059,4.342779783393502,20.0,0.0
25540,2,5540,[235 238 185  88 176],313,3,24062,4.342537448114059,0.0,0.0
25541,2,5541,[302 427 197 180 603],90,5,24067,4.3426560808372425,20.0,0.0
25542,2,5542,[302 427 197 180 603],339,5,24072,4.342774670755908,20.0,0.0
25543,2,5543,[748  89 183  28 176],474,4,24076,4.342712842712842,0.0,0.0
25544,2,5544,[216 273 475 143 289],92,2,24078,4.3422903516681695,0.0,0.0
25545,2,5545,[ 71 143 276 186 195],474,5,24083,4.342408943382618,0.0,0.0
25546,2,5546,[302 427 197 180 603],339,5,24088,4.342527492338201,20.0,0.0
25547,2,5547,[302 427 197 180 603],271,5,24093,4.342645998558039,20.0,0.0
25548,2,5548,[173  88 181 748 195],454,3,24096,4.342404036763381,0.0,0.0
25549,2,5549,[302 427 197 180 603],383,5,24101,4.342522522522523,20.0,0.0
25550,2,5550,[ 96 275 568  71 300],378,5,24106,4.3426409655917855,0.0,0.0
25551,2,5551,[302 427 197 180 603],339,5,24111,4.342759365994237,20.0,0.0
25552,2,5552,[302 427 197 180 603],90,5,24116,4.342877723752927,20.0,0.0
25553,2,5553,[  9 435 405 234 742],144,5,24121,4.342996038890889,0.0,0.0
25554,2,5554,[258  69 211 322 483],311,4,24125,4.342934293429343,20.0,0.0
25555,2,5555,[172  96 211 289 265],533,3,24128,4.342692584593233,0.0,0.0
25556,2,5556,[302 427 197 180 603],90,5,24133,4.342810869174015,20.0,0.0
25557,2,5557,[302 427 197 180 603],474,5,24138,4.342929111191076,20.0,0.0
25558,2,5558,[302 427 197 180 603],383,5,24143,4.343047310667386,20.0,0.0
25559,2,5559,[302 427 197 180 603],537,5,24148,4.3431654676259,20.0,0.0
25560,2,5560,[423 427 276 210 288],234,2,24150,4.342744110771444,0.0,0.0
25561,2,5561,[302 427 197 180 603],537,5,24155,4.342862279755484,20.0,0.0
25562,2,5562,[302 427 197 180 603],537,5,24160,4.342980406255617,20.0,0.0
25563,2,5563,[302 427 197 180 603],13,5,24165,4.343098490294752,20.0,0.0
25564,2,5564,[302 427 197 180 603],339,5,24170,4.343216531895777,20.0,0.0
25565,2,5565,[302 427 197 180 603],90,5,24175,4.343334531081567,20.0,0.0
25566,2,5566,[  1 427 211 215   4],537,2,24177,4.342913597988145,0.0,0.0
25567,2,5567,[  9 357 275 153 328],328,4,24181,4.342852011494253,20.0,0.0
25568,2,5568,[118 322 180 161 546],804,4,24185,4.342790447117975,0.0,0.0
25569,2,5569,[195 257  69 357 181],210,5,24190,4.342908438061041,20.0,0.0
25570,2,5570,[302 427 197 180 603],271,5,24195,4.343026386645127,20.0,0.0
25571,2,5571,[302 427 197 180 603],666,5,24200,4.343144292893037,20.0,0.0
25572,2,5572,[302 427 197 180 603],537,5,24205,4.343262156827562,20.0,0.0
25573,2,5573,[302 427 197 180 603],90,5,24210,4.343379978471475,20.0,0.0
25574,2,5574,[313  50 210 127 318],537,4,24214,4.343318385650225,20.0,40.0
25575,2,5575,[300 268 678 245 588],683,2,24216,4.3428981348637015,0.0,0.0
25576,2,5576,[302 427 197 180 603],666,5,24221,4.343015958400573,20.0,0.0
25577,2,5577,[302 427 197 180 603],474,5,24226,4.343133739691646,20.0,0.0
25578,2,5578,[302 427 197 180 603],474,5,24231,4.343251478759634,20.0,0.0
25579,2,5579,[302 427 197 180 603],271,5,24236,4.34336917562724,20.0,0.0
25580,2,5580,[302 427 197 180 603],666,5,24241,4.343486830317148,20.0,0.0
25581,2,5581,[385 222 427 174  71],830,4,24245,4.3434252955929775,0.0,20.0
25582,2,5582,[302 427 197 180 603],339,5,24250,4.343542898083467,20.0,0.0
25583,2,5583,[172 182  89  22 265],650,3,24253,4.34330229226361,0.0,0.0
25584,2,5584,[195 496 515 508 173],60,5,24258,4.34341987466428,0.0,0.0
25585,2,5585,[289 211 196 268 269],537,2,24260,4.343000358037952,0.0,0.0
25586,2,5586,[302 427 197 180 603],666,5,24265,4.343117952389475,20.0,0.0
25587,2,5587,[143 172  79 183 275],13,2,24267,4.342698639942735,0.0,0.0
25588,2,5588,[302 427 197 180 603],666,5,24272,4.342816246197889,20.0,0.0
25589,2,5589,[302 427 197 180 603],90,5,24277,4.342933810375671,20.0,0.0
25590,2,5590,[302 427 197 180 603],271,5,24282,4.343051332498659,20.0,0.0
25591,2,5591,[197 403  89 405 276],378,3,24285,4.342811158798283,0.0,0.0
25592,2,5592,[302 427 197 180 603],13,5,24290,4.342928660826033,20.0,0.0
25593,2,5593,[302 427 197 180 603],339,5,24295,4.343046120843761,20.0,0.0
25594,2,5594,[302 427 197 180 603],666,5,24300,4.343163538873995,20.0,0.0
25595,2,5595,[294 289 385 143  28],374,2,24302,4.342744817726948,0.0,0.0
25596,2,5596,[175 151  56 117  69],313,3,24305,4.342504913346436,0.0,0.0
25597,2,5597,[302 427 197 180 603],339,5,24310,4.342622365130404,20.0,0.0
25598,2,5598,[302 427 197 180 603],474,5,24315,4.3427397749598144,20.0,0.0
25599,2,5599,[302 427 197 180 603],271,5,24320,4.3428571428571425,20.0,0.0
25600,2,5600,[302 427 197 180 603],271,5,24325,4.342974468844849,20.0,0.0
25601,2,5601,[302 427 197 180 603],90,5,24330,4.3430917529453765,20.0,0.0
25602,2,5602,[471  64 185 423 289],474,3,24333,4.342852043548099,0.0,0.0
25603,2,5603,[302 427 197 180 603],383,5,24338,4.342969307637402,20.0,0.0
25604,2,5604,[302 427 197 180 603],666,5,24343,4.343086529884032,20.0,0.0
25605,2,5605,[100 258 187 322  79],749,3,24346,4.342846949696754,0.0,20.0
25606,2,5606,[302 427 197 180 603],13,5,24351,4.342964151952916,20.0,0.0
25607,2,5607,[302 427 197 180 603],339,5,24356,4.343081312410842,20.0,0.0
25608,2,5608,[ 50 508 301  15 568],455,3,24359,4.342841861294349,0.0,20.0
25609,2,5609,[302 427 197 180 603],13,5,24364,4.342959001782531,20.0,0.0
25610,2,5610,[197 100 191 127 175],881,3,24367,4.342719657815006,0.0,40.0
25611,2,5611,[588 143 194  95 173],804,3,24370,4.34248039914469,0.0,0.0
25612,2,5612,[302 427 197 180 603],537,5,24375,4.3425975414217,20.0,0.0
25613,2,5613,[302 427 197 180 603],90,5,24380,4.342714641966512,20.0,0.0
25614,2,5614,[302 427 197 180 603],90,5,24385,4.342831700801424,20.0,0.0
25615,2,5615,[289 302 234 183  70],883,4,24389,4.342770655270655,0.0,0.0
25616,2,5616,[302 427 197 180 603],339,5,24394,4.342887662453267,20.0,0.0
25617,2,5617,[302 427 197 180 603],271,5,24399,4.343004627981488,20.0,0.0
25618,2,5618,[302 427 197 180 603],90,5,24404,4.343121551877558,20.0,0.0
25619,2,5619,[302 427 197 180 603],271,5,24409,4.343238434163701,20.0,0.0
25620,2,5620,[302 427 197 180 603],537,5,24414,4.343355274862124,20.0,0.0
25621,2,5621,[ 96 234 187 176 483],406,4,24418,4.343294201351832,20.0,0.0
25622,2,5622,[302 427 197 180 603],664,5,24423,4.3434109905744265,20.0,0.0
25623,2,5623,[302 427 197 180 603],339,5,24428,4.34352773826458,20.0,0.0
25624,2,5624,[ 11 215 121 405 235],92,3,24431,4.343288888888889,0.0,0.0
25625,2,5625,[302 427 197 180 603],271,5,24436,4.343405616779239,20.0,0.0
25626,2,5626,[302 427 197 180 603],666,5,24441,4.343522303181091,20.0,0.0
25627,2,5627,[568 265  22 496 435],387,2,24443,4.343105899076049,0.0,0.0
25628,2,5628,[302 427 197 180 603],339,5,24448,4.343222597264168,20.0,0.0
25629,2,5629,[179 168 181 546 194],13,3,24451,4.342984014209591,0.0,0.0
25630,2,5630,[302 427 197 180 603],474,5,24456,4.343100692594565,20.0,0.0
25631,2,5631,[302 427 197 180 603],474,5,24461,4.343217329545454,20.0,0.0
25632,2,5632,[302 427 197 180 603],90,5,24466,4.343333925084324,20.0,0.0
25633,2,5633,[302 427 197 180 603],537,5,24471,4.343450479233227,20.0,0.0
25634,2,5634,[237   1 300  89 318],144,3,24474,4.34321206743567,20.0,0.0
25635,2,5635,[300 153 302 423 289],378,5,24479,4.34332860184528,0.0,0.0
25636,2,5636,[302 427 197 180 603],664,5,24484,4.343445094908639,20.0,0.0
25637,2,5637,[302 427 197 180 603],90,5,24489,4.343561546647748,20.0,0.0
25638,2,5638,[302 427 197 180 603],90,5,24494,4.34367795708459,20.0,0.0
25639,2,5639,[302 427 197 180 603],13,5,24499,4.3437943262411345,20.0,0.0
25640,2,5640,[302 427 197 180 603],13,5,24504,4.343910654139337,20.0,0.0
25641,2,5641,[302 427 197 180 603],537,5,24509,4.344026940801134,20.0,0.0
25642,2,5642,[302 427 197 180 603],664,5,24514,4.344143186248449,20.0,0.0
25643,2,5643,[ 88  12 215 186  11],474,5,24519,4.344259390503189,20.0,0.0
25644,2,5644,[302 427 197 180 603],13,5,24524,4.344375553587246,20.0,0.0
25645,2,5645,[302 427 197 180 603],537,5,24529,4.344491675522494,20.0,0.0
25646,2,5646,[302 427 197 180 603],474,5,24534,4.344607756330795,20.0,0.0
25647,2,5647,[302 427 197 180 603],383,5,24539,4.344723796033994,20.0,0.0
25648,2,5648,[302 427 197 180 603],339,5,24544,4.344839794653921,20.0,0.0
25649,2,5649,[153 357 194  56 301],666,4,24548,4.344778761061947,20.0,0.0
25650,2,5650,[302 427 197 180 603],474,5,24553,4.344894708901079,20.0,0.0
25651,2,5651,[ 71 435 174  22  97],59,4,24557,4.344833687190375,0.0,20.0
25652,2,5652,[302 427 197 180 603],339,5,24562,4.344949584291527,20.0,0.0
25653,2,5653,[175 195 318 180 276],239,4,24566,4.344888574460559,20.0,0.0
25654,2,5654,[302 427 197 180 603],664,5,24571,4.3450044208664895,20.0,0.0
25655,2,5655,[302 427 197 180 603],474,5,24576,4.345120226308345,20.0,0.0
25656,2,5656,[173 125 174  95 211],897,3,24579,4.3448824465264275,0.0,20.0
25657,2,5657,[ 98 180  89  70 496],653,2,24581,4.34446800989749,0.0,20.0
25658,2,5658,[228 237 185 168  56],883,4,24585,4.3444071390705075,0.0,0.0
25659,2,5659,[ 11 174 228 180 118],59,5,24590,4.34452296819788,0.0,20.0
25660,2,5660,[  1 143 100  97 237],378,5,24595,4.344638756403462,0.0,20.0
25661,2,5661,[302 427 197 180 603],90,5,24600,4.344754503708937,20.0,0.0
25662,2,5662,[302 427 197 180 603],339,5,24605,4.34487021013597,20.0,0.0
25663,2,5663,[234  15 210  50  56],650,2,24607,4.344456214689266,0.0,20.0
25664,2,5664,[294 300 196 197 588],378,3,24610,4.344218887908208,0.0,0.0
25665,2,5665,[302 427 197 180 603],664,5,24615,4.3443346276032475,20.0,0.0
25666,2,5666,[302 427 197 180 603],271,5,24620,4.344450326451385,20.0,0.0
25667,2,5667,[ 97  70 403 234  22],13,3,24623,4.344213126323218,0.0,0.0
25668,2,5668,[302 427 197 180 603],90,5,24628,4.344328805785853,20.0,0.0
25669,2,5669,[228  95 175  88  28],892,4,24632,4.344268077601411,0.0,0.0
25670,2,5670,[161 313 237 275 357],533,3,24635,4.344031035090813,20.0,0.0
25671,2,5671,[302 427 197 180 603],537,5,24640,4.344146685472497,20.0,0.0
25672,2,5672,[302 427 197 180 603],271,5,24645,4.344262295081967,20.0,0.0
25673,2,5673,[176 423  96 121 357],13,3,24648,4.344025378921396,20.0,0.0
25674,2,5674,[302 427 197 180 603],90,5,24653,4.3441409691629955,20.0,0.0
25675,2,5675,[302 427 197 180 603],13,5,24658,4.344256518675123,20.0,0.0
25676,2,5676,[161 385 257 117  97],650,2,24660,4.343843579355293,0.0,0.0
25677,2,5677,[318 196  64 546 151],804,3,24663,4.34360690383938,20.0,0.0
25678,2,5678,[174 168  79 175 286],95,5,24668,4.343722486353231,0.0,20.0
25679,2,5679,[180  28 265 215 294],92,3,24671,4.343485915492958,0.0,0.0
25680,2,5680,[302 427 197 180 603],90,5,24676,4.3436014786129205,20.0,0.0
25681,2,5681,[302 427 197 180 603],383,5,24681,4.343717001055966,20.0,0.0
25682,2,5682,[302 427 197 180 603],339,5,24686,4.343832482843569,20.0,0.0
25683,2,5683,[222 282 471  98 546],194,1,24687,4.343244194229416,0.0,20.0
25684,2,5684,[302 427 197 180 603],90,5,24692,4.343359718557608,20.0,0.0
25685,2,5685,[423 294 216 183  11],881,4,24696,4.343299331691875,0.0,0.0
25686,2,5686,[302 427 197 180 603],271,5,24701,4.343414805697204,20.0,0.0
25687,2,5687,[121 286 215  89 403],59,4,24705,4.343354430379747,0.0,0.0
25688,2,5688,[125  89 100 144 195],788,3,24708,4.343118298470733,0.0,20.0
25689,2,5689,[143 151 176 265 132],290,3,24711,4.342882249560633,0.0,0.0
25690,2,5690,[127 204 496   9 210],308,4,24715,4.342821999648568,0.0,20.0
25691,2,5691,[195 318 118 191 403],524,4,24719,4.342761770906535,20.0,0.0
25692,2,5692,[302 427 197 180 603],537,5,24724,4.342877217635693,20.0,0.0
25693,2,5693,[302 427 197 180 603],383,5,24729,4.342992623814542,20.0,0.0
25694,2,5694,[183 269 222 118 172],378,4,24733,4.342932396839333,0.0,0.0
25695,2,5695,[302 427 197 180 603],666,5,24738,4.343047752808989,20.0,0.0
25696,2,5696,[302 427 197 180 603],383,5,24743,4.343163068281552,20.0,0.0
25697,2,5697,[302 427 197 180 603],271,5,24748,4.343278343278343,20.0,0.0
25698,2,5698,[100  79 300 185  50],840,4,24752,4.343218108440078,0.0,40.0
25699,2,5699,[302 427 197 180 603],271,5,24757,4.343333333333334,20.0,0.0
25700,2,5700,[302 427 197 180 603],664,5,24762,4.343448517803894,20.0,0.0
25701,2,5701,[132 153 179 515 471],308,2,24764,4.343037530690985,0.0,0.0
25702,2,5702,[678   7 655 175 153],308,4,24768,4.342977380326144,0.0,0.0
25703,2,5703,[302 427 197 180 603],474,5,24773,4.343092566619916,20.0,0.0
25704,2,5704,[302 427 197 180 603],666,5,24778,4.343207712532866,20.0,0.0
25705,2,5705,[302 427 197 180 603],664,5,24783,4.343322818086225,20.0,0.0
25706,2,5706,[ 25 273 546 216 655],378,4,24787,4.343262659891361,0.0,0.0
25707,2,5707,[302 427 197 180 603],537,5,24792,4.343377715487036,20.0,0.0
25708,2,5708,[302 427 197 180 603],271,5,24797,4.343492730775968,20.0,0.0
25709,2,5709,[302 427 197 180 603],271,5,24802,4.343607705779334,20.0,0.0
25710,2,5710,[ 79 234  89  82 195],788,2,24804,4.34319733846962,0.0,0.0
25711,2,5711,[302 427 197 180 603],383,5,24809,4.343312324929972,20.0,0.0
25712,2,5712,[228  15 405  25 202],145,2,24811,4.342902152984421,0.0,0.0
25713,2,5713,[ 82 288  28 483 427],7,4,24815,4.342842142107106,20.0,0.0
25714,2,5714,[322 288  88 318 181],533,4,24819,4.3427821522309715,20.0,0.0
25715,2,5715,[302 427 197 180 603],537,5,24824,4.342897130860742,20.0,0.0
25716,2,5716,[197 276 258 328 132],271,2,24826,4.342487318523701,0.0,0.0
25717,2,5717,[302 427 197 180 603],339,5,24831,4.342602308499475,20.0,0.0
25718,2,5718,[302 427 197 180 603],271,5,24836,4.342717258261934,20.0,0.0
25719,2,5719,[302 427 197 180 603],383,5,24841,4.342832167832168,20.0,0.0
25720,2,5720,[302 427 197 180 603],537,5,24846,4.342947037231253,20.0,0.0
25721,2,5721,[302 427 197 180 603],383,5,24851,4.343061866480252,20.0,0.0
25722,2,5722,[194 183 238 546 121],643,3,24854,4.3428271885374805,0.0,0.0
25723,2,5723,[302 427 197 180 603],383,5,24859,4.342941998602376,20.0,0.0
25724,2,5724,[302 427 197 180 603],271,5,24864,4.343056768558952,20.0,0.0
25725,2,5725,[234  70 121 200 174],213,4,24868,4.342996856444289,0.0,20.0
25726,2,5726,[302 427 197 180 603],13,5,24873,4.34311157674175,20.0,0.0
25727,2,5727,[302 427 197 180 603],339,5,24878,4.3432262569832405,20.0,0.0
25728,2,5728,[195  25 200 194 182],95,2,24880,4.342817245592599,0.0,0.0
25729,2,5729,[302 427 197 180 603],537,5,24885,4.342931937172775,20.0,0.0
25730,2,5730,[302 427 197 180 603],474,5,24890,4.343046588727971,20.0,0.0
25731,2,5731,[302 427 197 180 603],664,5,24895,4.343161200279135,20.0,0.0
25732,2,5732,[568 238 328  69 508],85,1,24896,4.342578056863771,0.0,0.0
25733,2,5733,[ 25  70 328 210 185],13,0,24896,4.341820718521102,0.0,0.0
25734,2,5734,[302 427 197 180 603],383,5,24901,4.341935483870968,20.0,0.0
25735,2,5735,[302 427 197 180 603],339,5,24906,4.342050209205021,20.0,0.0
25736,2,5736,[151 748 143 191   7],64,3,24909,4.3418162802858635,0.0,0.0
25737,2,5737,[172 265 183 144 168],60,5,24914,4.341930986406413,0.0,0.0
25738,2,5738,[ 64 238 483 202 273],749,4,24918,4.341871406168322,20.0,0.0
25739,2,5739,[182  69  89 318 195],13,3,24921,4.341637630662021,20.0,0.0
25740,2,5740,[237 423 301 151 405],6,0,24921,4.340881379550601,0.0,0.0
25741,2,5741,[286  95 197  79  56],271,4,24925,4.340822013235806,0.0,0.0
25742,2,5742,[302 427 197 180 603],339,5,24930,4.340936792617099,20.0,0.0
25743,2,5743,[302 427 197 180 603],339,5,24935,4.341051532033426,20.0,0.0
25744,2,5744,[302 427 197 180 603],13,5,24940,4.341166231505657,20.0,0.0
25745,2,5745,[302 427 197 180 603],666,5,24945,4.341280891054646,20.0,0.0
25746,2,5746,[302 427 197 180 603],339,5,24950,4.341395510701235,20.0,0.0
25747,2,5747,[302 427 197 180 603],13,5,24955,4.341510090466249,20.0,0.0
25748,2,5748,[302 427 197 180 603],13,5,24960,4.341624630370499,20.0,0.0
25749,2,5749,[302 427 197 180 603],13,5,24965,4.3417391304347825,20.0,0.0
25750,2,5750,[ 97 196 185  64 742],653,1,24966,4.341158059467919,0.0,0.0
25751,2,5751,[302 427 197 180 603],271,5,24971,4.341272600834492,20.0,0.0
25752,2,5752,[153 546  70 385 323],788,1,24972,4.3406918129671475,0.0,0.0
25753,2,5753,[302 427 197 180 603],339,5,24977,4.3408063955509215,20.0,0.0
25754,2,5754,[302 427 197 180 603],664,5,24982,4.340920938314509,20.0,0.0
25755,2,5755,[172  95 215 403 288],92,3,24985,4.340687977762335,0.0,0.0
25756,2,5756,[302 427 197 180 603],339,5,24990,4.340802501302762,20.0,0.0
25757,2,5757,[302 427 197 180 603],271,5,24995,4.340916985064259,20.0,0.0
25758,2,5758,[302 427 197 180 603],271,5,25000,4.341031429067546,20.0,0.0
25759,2,5759,[ 12 173 289 111 195],537,1,25001,4.340451388888889,20.0,0.0
25760,2,5760,[435   9 200  22 143],234,2,25003,4.340045131053636,0.0,0.0
25761,2,5761,[302 427 197 180 603],13,5,25008,4.340159666782367,20.0,0.0
25762,2,5762,[302 427 197 180 603],474,5,25013,4.34027416276245,20.0,0.0
25763,2,5763,[ 25 185  79 151 385],308,5,25018,4.340388619014573,0.0,0.0
25764,2,5764,[186 273 176 301 288],234,0,25018,4.3396357328707715,0.0,0.0
25765,2,5765,[302 427 197 180 603],90,5,25023,4.339750260145681,20.0,0.0
25766,2,5766,[302 427 197 180 603],537,5,25028,4.339864747702445,20.0,0.0
25767,2,5767,[191  28 153 182 603],234,3,25031,4.339632454923717,20.0,0.0
25768,2,5768,[302 427 197 180 603],474,5,25036,4.339746923210262,20.0,0.0
25769,2,5769,[302 427 197 180 603],383,5,25041,4.339861351819757,20.0,0.0
25770,2,5770,[ 11  95 475 132 186],537,2,25043,4.339455900190608,0.0,0.0
25771,2,5771,[302 427 197 180 603],474,5,25048,4.33957033957034,20.0,0.0
25772,2,5772,[176 173 435 100 403],385,2,25050,4.339165078815174,0.0,20.0
25773,2,5773,[302 427 197 180 603],666,5,25055,4.3392795289227575,20.0,0.0
25774,2,5774,[135 742 186 245  22],334,2,25057,4.338874458874459,0.0,0.0
25775,2,5775,[302 427 197 180 603],13,5,25062,4.33898891966759,20.0,0.0
25776,2,5776,[302 427 197 180 603],339,5,25067,4.339103340834343,20.0,0.0
25777,2,5777,[302 427 197 180 603],474,5,25072,4.339217722395293,20.0,0.0
25778,2,5778,[302 427 197 180 603],339,5,25077,4.339332064370998,20.0,0.0
25779,2,5779,[302 427 197 180 603],90,5,25082,4.339446366782007,20.0,0.0
25780,2,5780,[302 427 197 180 603],474,5,25087,4.33956062964885,20.0,0.0
25781,2,5781,[302 427 197 180 603],537,5,25092,4.339674852992045,20.0,0.0
25782,2,5782,[286 144 173 183  15],60,5,25097,4.339789036832094,0.0,0.0
25783,2,5783,[313 197 515 357 748],543,3,25100,4.3395573997233745,20.0,0.0
25784,2,5784,[302 427 197 180 603],474,5,25105,4.339671564390666,20.0,0.0
25785,2,5785,[294 268 655 174   4],234,1,25106,4.339094365710335,0.0,20.0
25786,2,5786,[175 245 258 204 302],207,2,25108,4.338690167617073,0.0,0.0
25787,2,5787,[ 82 151 215 118 143],42,5,25113,4.338804422944022,0.0,0.0
25788,2,5788,[302 427 197 180 603],13,5,25118,4.33891863879772,20.0,0.0
25789,2,5789,[302 427 197 180 603],13,5,25123,4.339032815198618,20.0,0.0
25790,2,5790,[211  82 234 318 483],326,3,25126,4.338801588672077,40.0,0.0
25791,2,5791,[302 427 197 180 603],537,5,25131,4.338915745856354,20.0,0.0
25792,2,5792,[ 82 151 496 173 678],648,3,25134,4.338684619368203,0.0,0.0
25793,2,5793,[423 196   9 168 216],326,1,25135,4.338108387987574,0.0,0.0
25794,2,5794,[302 427 197 180 603],666,5,25140,4.338222605694564,20.0,0.0
25795,2,5795,[435  71 175 286 318],194,3,25143,4.337991718426501,20.0,0.0
25796,2,5796,[302 427 197 180 603],271,5,25148,4.338105916853545,20.0,0.0
25797,2,5797,[302 427 197 180 603],271,5,25153,4.338220075888238,20.0,0.0
25798,2,5798,[135 153 121 288 258],64,2,25155,4.33781686497672,0.0,0.0
25799,2,5799,[302 427 197 180 603],271,5,25160,4.337931034482758,20.0,0.0
25800,2,5800,[302 427 197 180 603],339,5,25165,4.338045164626789,20.0,0.0
25801,2,5801,[302 427 197 180 603],13,5,25170,4.338159255429162,20.0,0.0
25802,2,5802,[302 427 197 180 603],664,5,25175,4.338273306910219,20.0,0.0
25803,2,5803,[  8 216 191  95 748],543,3,25178,4.338042729152309,0.0,0.0
25804,2,5804,[185 483 195  56 222],537,3,25181,4.337812230835486,20.0,0.0
25805,2,5805,[302 427 197 180 603],666,5,25186,4.337926283155356,20.0,0.0
25806,2,5806,[302 427 197 180 603],664,5,25191,4.338040296194248,20.0,0.0
25807,2,5807,[302 427 197 180 603],13,5,25196,4.338154269972452,20.0,0.0
25808,2,5808,[302 427 197 180 603],383,5,25201,4.338268204510243,20.0,0.0
25809,2,5809,[196 328 173 176 215],749,5,25206,4.338382099827883,0.0,0.0
25810,2,5810,[302 427 197 180 603],271,5,25211,4.33849595594562,20.0,0.0
25811,2,5811,[302 427 197 180 603],383,5,25216,4.3386097728836885,20.0,0.0
25812,2,5812,[ 97 238 323 121 175],474,4,25220,4.338551522449682,0.0,0.0
25813,2,5813,[302 427 197 180 603],13,5,25225,4.338665290677675,20.0,0.0
25814,2,5814,[118 235  25 216 174],378,5,25230,4.338779019776441,0.0,20.0
25815,2,5815,[302 427 197 180 603],90,5,25235,4.338892709766163,20.0,0.0
25816,2,5816,[173   8 211 196 257],479,5,25240,4.33900636066701,0.0,0.0
25817,2,5817,[ 64 288 568 210  69],308,4,25244,4.338948092127879,0.0,0.0
25818,2,5818,[ 25 100   1 265   8],795,4,25248,4.338889843615742,0.0,20.0
25819,2,5819,[302 427 197 180 603],339,5,25253,4.3390034364261165,20.0,0.0
25820,2,5820,[ 50 234  28  95 151],881,2,25255,4.33860161484281,0.0,20.0
25821,2,5821,[302 427 197 180 603],537,5,25260,4.338715218138097,20.0,0.0
25822,2,5822,[302 427 197 180 603],90,5,25265,4.338828782414563,20.0,0.0
25823,2,5823,[302 427 197 180 603],666,5,25270,4.3389423076923075,20.0,0.0
25824,2,5824,[302 427 197 180 603],666,5,25275,4.339055793991417,20.0,0.0
25825,2,5825,[302 427 197 180 603],271,5,25280,4.33916924133196,20.0,0.0
25826,2,5826,[228   1 357 118 143],295,4,25284,4.339111034837824,20.0,0.0
25827,2,5827,[302 427 197 180 603],666,5,25289,4.339224433768017,20.0,0.0
25828,2,5828,[ 50 508   9 289 176],533,3,25292,4.338994681763595,0.0,20.0
25829,2,5829,[546 174 403 515  82],194,2,25294,4.338593481989708,0.0,20.0
25830,2,5830,[ 22 313 276 471 151],308,3,25297,4.33836391699537,0.0,0.0
25831,2,5831,[302 427 197 180 603],666,5,25302,4.338477366255144,20.0,0.0
25832,2,5832,[302 427 197 180 603],13,5,25307,4.338590776615806,20.0,0.0
25833,2,5833,[302 427 197 180 603],90,5,25312,4.33870414809736,20.0,0.0
25834,2,5834,[568 204 508 176 423],378,5,25317,4.338817480719794,0.0,0.0
25835,2,5835,[302 427 197 180 603],383,5,25322,4.338930774503084,20.0,0.0
25836,2,5836,[302 427 197 180 603],13,5,25327,4.339044029467192,20.0,0.0
25837,2,5837,[302 427 197 180 603],474,5,25332,4.339157245632066,20.0,0.0
25838,2,5838,[302 427 197 180 603],271,5,25337,4.33927042301764,20.0,0.0
25839,2,5839,[302 427 197 180 603],664,5,25342,4.339383561643835,20.0,0.0
25840,2,5840,[302 427 197 180 603],474,5,25347,4.33949666153056,20.0,0.0
25841,2,5841,[161 118  88 194 603],42,5,25352,4.339609722697706,20.0,0.0
25842,2,5842,[302 427 197 180 603],90,5,25357,4.3397227451651545,20.0,0.0
25843,2,5843,[302 427 197 180 603],664,5,25362,4.339835728952772,20.0,0.0
25844,2,5844,[ 50 357 144  97  89],312,4,25366,4.3397775876817795,20.0,20.0
25845,2,5845,[302 427 197 180 603],13,5,25371,4.3398905234348275,20.0,0.0
25846,2,5846,[ 56 175 235 294  11],308,3,25374,4.3396613648024625,0.0,0.0
25847,2,5847,[302 427 197 180 603],13,5,25379,4.339774281805745,20.0,0.0
25848,2,5848,[302 427 197 180 603],537,5,25384,4.339887160198325,20.0,0.0
25849,2,5849,[302 427 197 180 603],383,5,25389,4.34,20.0,0.0
25850,2,5850,[302 427 197 180 603],474,5,25394,4.340112801230559,20.0,0.0
25851,2,5851,[302 427 197 180 603],90,5,25399,4.340225563909774,20.0,0.0
25852,2,5852,[302 427 197 180 603],271,5,25404,4.340338288057406,20.0,0.0
25853,2,5853,[302 427 197 180 603],474,5,25409,4.340450973693201,20.0,0.0
25854,2,5854,[181  79 117 135 180],479,4,25413,4.340392826643894,0.0,0.0
25855,2,5855,[302 427 197 180 603],664,5,25418,4.3405054644808745,20.0,0.0
25856,2,5856,[302 427 197 180 603],13,5,25423,4.340618063855216,20.0,0.0
25857,2,5857,[258 196 471 475 121],119,4,25427,4.340559918060771,0.0,0.0
25858,2,5858,[302 427 197 180 603],474,5,25432,4.340672469704728,20.0,0.0
25859,2,5859,[183 237 135 174 423],59,4,25436,4.34061433447099,0.0,20.0
25860,2,5860,[302 427 197 180 603],13,5,25441,4.340726838423477,20.0,0.0
25861,2,5861,[143  70 269 185 191],659,5,25446,4.340839303991812,0.0,0.0
25862,2,5862,[302 427 197 180 603],474,5,25451,4.340951731195633,20.0,0.0
25863,2,5863,[302 427 197 180 603],13,5,25456,4.34106412005457,20.0,0.0
25864,2,5864,[302 427 197 180 603],383,5,25461,4.341176470588235,20.0,0.0
25865,2,5865,[302 427 197 180 603],339,5,25466,4.341288782816229,20.0,0.0
25866,2,5866,[302 427 197 180 603],474,5,25471,4.341401056758139,20.0,0.0
25867,2,5867,[180 269 186 276 174],239,4,25475,4.34134287661895,0.0,20.0
25868,2,5868,[357 318 181 222 275],13,1,25476,4.340773555972056,40.0,0.0
25869,2,5869,[302 427 197 180 603],666,5,25481,4.340885860306644,20.0,0.0
25870,2,5870,[302 427 197 180 603],13,5,25486,4.340998126383921,20.0,0.0
25871,2,5871,[302 427 197 180 603],537,5,25491,4.341110354223433,20.0,0.0
25872,2,5872,[ 97 176 276 132 300],288,4,25495,4.341052273114252,0.0,0.0
25873,2,5873,[204 496  56 286   4],378,3,25498,4.340823970037453,0.0,0.0
25874,2,5874,[313  70 405 471 427],328,3,25501,4.340595744680851,0.0,0.0
25875,2,5875,[302 427 197 180 603],537,5,25506,4.34070796460177,20.0,0.0
25876,2,5876,[302 427 197 180 603],666,5,25511,4.340820146333163,20.0,0.0
25877,2,5877,[405 173 294 385 168],13,1,25512,4.340251786321878,0.0,0.0
25878,2,5878,[302 427 197 180 603],474,5,25517,4.340364007484266,20.0,0.0
25879,2,5879,[302 427 197 180 603],537,5,25522,4.34047619047619,20.0,0.0
25880,2,5880,[183 204 318 427 182],374,3,25525,4.340248257099133,20.0,0.0
25881,2,5881,[ 15  70 405 153   1],378,4,25529,4.340190411424685,0.0,0.0
25882,2,5882,[302 427 197 180 603],90,5,25534,4.340302566717661,20.0,0.0
25883,2,5883,[174 153  69 144 175],378,4,25538,4.340244731475187,0.0,20.0
25884,2,5884,[302 427 197 180 603],664,5,25543,4.34035683942226,20.0,0.0
25885,2,5885,[302 427 197 180 603],13,5,25548,4.3404689092762485,20.0,0.0
25886,2,5886,[302 427 197 180 603],383,5,25553,4.340580941056565,20.0,0.0
25887,2,5887,[153 546 151  56 237],234,0,25553,4.33984375,0.0,0.0
25888,2,5888,[302 427 197 180 603],537,5,25558,4.339955849889625,20.0,0.0
25889,2,5889,[385 655   9 427 323],328,2,25560,4.3395585738539895,0.0,0.0
25890,2,5890,[302 427 197 180 603],90,5,25565,4.339670684094381,20.0,0.0
25891,2,5891,[302 427 197 180 603],383,5,25570,4.339782756279702,20.0,0.0
25892,2,5892,[  7 273 121 678 238],537,2,25572,4.339385711861531,0.0,0.0
25893,2,5893,[302 427 197 180 603],383,5,25577,4.339497794367153,20.0,0.0
25894,2,5894,[302 427 197 180 603],666,5,25582,4.33960983884648,20.0,0.0
25895,2,5895,[302 427 197 180 603],339,5,25587,4.33972184531886,20.0,0.0
25896,2,5896,[302 427 197 180 603],339,5,25592,4.3398338138036285,20.0,0.0
25897,2,5897,[ 71 385 191  89 100],311,4,25596,4.3397761953204474,0.0,20.0
25898,2,5898,[ 56   8 742 328 181],271,2,25598,4.339379555856925,0.0,0.0
25899,2,5899,[302 427 197 180 603],13,5,25603,4.339491525423729,20.0,0.0
25900,2,5900,[302 427 197 180 603],383,5,25608,4.3396034570411794,20.0,0.0
25901,2,5901,[302 427 197 180 603],666,5,25613,4.339715350728566,20.0,0.0
25902,2,5902,[302 427 197 180 603],537,5,25618,4.339827206505167,20.0,0.0
25903,2,5903,[302 427 197 180 603],383,5,25623,4.339939024390244,20.0,0.0
25904,2,5904,[302 427 197 180 603],537,5,25628,4.340050804403048,20.0,0.0
25905,2,5905,[211  11 174 515 210],543,3,25631,4.339823907890281,0.0,20.0
25906,2,5906,[302 427 197 180 603],474,5,25636,4.339935669544608,20.0,0.0
25907,2,5907,[302 427 197 180 603],339,5,25641,4.340047393364929,20.0,0.0
25908,2,5908,[ 25 427  88 168  97],313,2,25643,4.339651379251989,0.0,0.0
25909,2,5909,[302 427 197 180 603],90,5,25648,4.339763113367174,20.0,0.0
25910,2,5910,[ 71  89  12 100 403],524,3,25651,4.3395364574522075,20.0,20.0
25911,2,5911,[302 427 197 180 603],339,5,25656,4.339648173207037,20.0,0.0
25912,2,5912,[302 427 197 180 603],537,5,25661,4.339759851175376,20.0,0.0
25913,2,5913,[302 427 197 180 603],537,5,25666,4.339871491376395,20.0,0.0
25914,2,5914,[302 427 197 180 603],664,5,25671,4.339983093829248,20.0,0.0
25915,2,5915,[302 427 197 180 603],13,5,25676,4.340094658553077,20.0,0.0
25916,2,5916,[ 88 435 173 191 127],648,4,25680,4.340037181003887,0.0,20.0
25917,2,5917,[357 143 318 678 238],537,3,25683,4.339810746873944,40.0,0.0
25918,2,5918,[100 144 135 276   9],207,1,25684,4.33924649434026,0.0,20.0
25919,2,5919,[302 427 197 180 603],90,5,25689,4.339358108108108,20.0,0.0
25920,2,5920,[302 427 197 180 603],271,5,25694,4.33946968417497,20.0,0.0
25921,2,5921,[302 427 197 180 603],339,5,25699,4.339581222559946,20.0,0.0
25922,2,5922,[302 427 197 180 603],90,5,25704,4.339692723282121,20.0,0.0
25923,2,5923,[302 427 197 180 603],383,5,25709,4.339804186360567,20.0,0.0
25924,2,5924,[302 427 197 180 603],474,5,25714,4.339915611814346,20.0,0.0
25925,2,5925,[302 427 197 180 603],90,5,25719,4.340026999662504,20.0,0.0
25926,2,5926,[302 427 197 180 603],474,5,25724,4.340138349924076,20.0,0.0
25927,2,5927,[302 427 197 180 603],339,5,25729,4.340249662618084,20.0,0.0
25928,2,5928,[302 427 197 180 603],339,5,25734,4.340360937763535,20.0,0.0
25929,2,5929,[  8 294   1 153 191],95,4,25738,4.340303541315346,0.0,0.0
25930,2,5930,[288 294 144  96 125],119,4,25742,4.340246164221885,0.0,0.0
25931,2,5931,[302 427 197 180 603],339,5,25747,4.340357383681726,20.0,0.0
25932,2,5932,[302 427 197 180 603],90,5,25752,4.340468565649756,20.0,0.0
25933,2,5933,[427  25  82  88 269],934,4,25756,4.340411189753961,0.0,0.0
25934,2,5934,[302 427 197 180 603],383,5,25761,4.3405223251895535,20.0,0.0
25935,2,5935,[302 427 197 180 603],474,5,25766,4.340633423180593,20.0,0.0
25936,2,5936,[265 183 185   7  95],59,4,25770,4.340576048509348,0.0,0.0
25937,2,5937,[302 427 197 180 603],339,5,25775,4.340687100033682,20.0,0.0
25938,2,5938,[191 273 204 183  89],666,3,25778,4.34046135713083,0.0,0.0
25939,2,5939,[302 427 197 180 603],339,5,25783,4.34057239057239,20.0,0.0
25940,2,5940,[302 427 197 180 603],666,5,25788,4.340683386635247,20.0,0.0
25941,2,5941,[302 427 197 180 603],90,5,25793,4.34079434533827,20.0,0.0
25942,2,5942,[302 427 197 180 603],537,5,25798,4.34090526670032,20.0,0.0
25943,2,5943,[302 427 197 180 603],339,5,25803,4.341016150740242,20.0,0.0
25944,2,5944,[568 197 118 204 588],194,3,25806,4.340790580319596,0.0,0.0
25945,2,5945,[302 427 197 180 603],90,5,25811,4.340901446350488,20.0,0.0
25946,2,5946,[302 427 197 180 603],90,5,25816,4.341012275096688,20.0,0.0
25947,2,5947,[357  50 597 405 196],95,3,25819,4.340786819098857,20.0,20.0
25948,2,5948,[302 427 197 180 603],90,5,25824,4.340897629853757,20.0,0.0
25949,2,5949,[302 427 197 180 603],474,5,25829,4.341008403361345,20.0,0.0
25950,2,5950,[423 403 143 318  28],815,5,25834,4.341119139640397,20.0,0.0
25951,2,5951,[302 427 197 180 603],271,5,25839,4.341229838709677,20.0,0.0
25952,2,5952,[302 427 197 180 603],271,5,25844,4.341340500587939,20.0,0.0
25953,2,5953,[302 427 197 180 603],271,5,25849,4.34145112529392,20.0,0.0
25954,2,5954,[197 385 172 210 300],379,3,25852,4.341225860621327,0.0,0.0
25955,2,5955,[ 70 333  69  50 496],537,3,25855,4.341000671591672,0.0,20.0
25956,2,5956,[186 294  95 127  12],271,4,25859,4.3409434278999495,20.0,20.0
25957,2,5957,[302 427 197 180 603],339,5,25864,4.341054044981537,20.0,0.0
25958,2,5958,[ 97  50 117   4 405],538,2,25866,4.340661184762544,0.0,20.0
25959,2,5959,[ 64  69 288 111 238],666,2,25868,4.340268456375839,0.0,0.0
25960,2,5960,[302 427 197 180 603],664,5,25873,4.3403791310182855,20.0,0.0
25961,2,5961,[228 179 196  95 185],537,2,25875,4.339986581683998,0.0,0.0
25962,2,5962,[301 118 180 182 186],650,2,25877,4.3395941640114035,0.0,0.0
25963,2,5963,[302 427 197 180 603],664,5,25882,4.3397048960429245,20.0,0.0
25964,2,5964,[302 427 197 180 603],383,5,25887,4.339815590947192,20.0,0.0
25965,2,5965,[302 427 197 180 603],13,5,25892,4.339926248742876,20.0,0.0
25966,2,5966,[742 302 187   9  98],458,4,25896,4.339869281045751,0.0,20.0
25967,2,5967,[302 427 197 180 603],537,5,25901,4.339979892761394,20.0,0.0
25968,2,5968,[273  64 222 204 294],666,1,25902,4.339420338415145,0.0,0.0
25969,2,5969,[234 322 211 196 275],90,5,25907,4.339530988274707,0.0,0.0
25970,2,5970,[ 50 191 435 185 181],194,3,25910,4.339306648802546,0.0,20.0
25971,2,5971,[302 427 197 180 603],383,5,25915,4.3394172806430005,20.0,0.0
25972,2,5972,[302 427 197 180 603],664,5,25920,4.339527875439478,20.0,0.0
25973,2,5973,[302 427 197 180 603],537,5,25925,4.339638433210579,20.0,0.0
25974,2,5974,[132 228 588 235 153],194,1,25926,4.3390794979079494,0.0,0.0
25975,2,5975,[302 427 197 180 603],383,5,25931,4.339190093708166,20.0,0.0
25976,2,5976,[302 427 197 180 603],271,5,25936,4.3393006525012545,20.0,0.0
25977,2,5977,[222 423 435 405 204],194,2,25938,4.338909334225494,0.0,0.0
25978,2,5978,[302 427 197 180 603],13,5,25943,4.339019902993812,20.0,0.0
25979,2,5979,[289 235 435 322 117],13,1,25944,4.338461538461538,0.0,0.0
25980,2,5980,[302 427 197 180 603],666,5,25949,4.338572145126233,20.0,0.0
25981,2,5981,[302 427 197 180 603],90,5,25954,4.3386827148111,20.0,0.0
25982,2,5982,[121 235 515 357 135],290,2,25956,4.338291826842721,20.0,0.0
25983,2,5983,[302 427 197 180 603],664,5,25961,4.338402406417113,20.0,0.0
25984,2,5984,[302 427 197 180 603],666,5,25966,4.338512949039265,20.0,0.0
25985,2,5985,[302 427 197 180 603],537,5,25971,4.338623454727698,20.0,0.0
25986,2,5986,[302 427 197 180 603],339,5,25976,4.338733923500919,20.0,0.0
25987,2,5987,[302 427 197 180 603],666,5,25981,4.338844355377422,20.0,0.0
25988,2,5988,[302 427 197 180 603],383,5,25986,4.338954750375689,20.0,0.0
25989,2,5989,[357 289 182  22 275],13,2,25988,4.3385642737896495,20.0,0.0
25990,2,5990,[302 427 197 180 603],383,5,25993,4.3386746786846935,20.0,0.0
25991,2,5991,[302 427 197 180 603],13,5,25998,4.338785046728972,20.0,0.0
25992,2,5992,[300 289 176 151 318],334,2,26000,4.3383947939262475,20.0,0.0
25993,2,5993,[161 100 322  28 235],313,2,26002,4.3380046713380045,0.0,20.0
25994,2,5994,[302 427 197 180 603],339,5,26007,4.338115095913261,20.0,0.0
25995,2,5995,[174 185 588 475 173],479,3,26010,4.337891927951968,0.0,20.0
25996,2,5996,[302 427 197 180 603],537,5,26015,4.338002334500584,20.0,0.0
25997,2,5997,[135  88  98  12  28],454,2,26017,4.337612537512504,20.0,20.0
25998,2,5998,[302 427 197 180 603],383,5,26022,4.337722953825637,20.0,0.0
25999,2,5999,[216 286 313 385 302],537,2,26024,4.3373333333333335,0.0,0.0
26000,2,6000,[118  12 100 385 111],524,3,26027,4.337110481586402,20.0,20.0
26001,2,6001,[302 427 197 180 603],474,5,26032,4.3372209263578805,20.0,0.0
26002,2,6002,[302 427 197 180 603],383,5,26037,4.337331334332833,20.0,0.0
26003,2,6003,[302 427 197 180 603],474,5,26042,4.337441705529647,20.0,0.0
26004,2,6004,[302 427 197 180 603],474,5,26047,4.3375520399666945,20.0,0.0
26005,2,6005,[302 427 197 180 603],271,5,26052,4.337662337662338,20.0,0.0
26006,2,6006,[302 427 197 180 603],13,5,26057,4.337772598634926,20.0,0.0
26007,2,6007,[245 118 100 144  12],455,2,26059,4.337383488681757,20.0,20.0
26008,2,6008,[302 427 197 180 603],271,5,26064,4.337493759360958,20.0,0.0
26009,2,6009,[302 427 197 180 603],13,5,26069,4.337603993344426,20.0,0.0
26010,2,6010,[194 186 143 216 132],804,4,26073,4.3375478289802025,0.0,0.0
26011,2,6011,[302 427 197 180 603],13,5,26078,4.337658017298736,20.0,0.0
26012,2,6012,[302 427 197 180 603],13,5,26083,4.337768168967238,20.0,0.0
26013,2,6013,[302 427 197 180 603],13,5,26088,4.337878284003991,20.0,0.0
26014,2,6014,[191 257 313  56 237],474,4,26092,4.3378221113881965,0.0,0.0
26015,2,6015,[423 143  22 197 294],298,4,26096,4.337765957446808,0.0,0.0
26016,2,6016,[302 427 197 180 603],90,5,26101,4.337876017949144,20.0,0.0
26017,2,6017,[302 427 197 180 603],13,5,26106,4.337986041874377,20.0,0.0
26018,2,6018,[302 427 197 180 603],664,5,26111,4.338096029240738,20.0,0.0
26019,2,6019,[289 194 483 678 183],881,2,26113,4.337707641196014,20.0,0.0
26020,2,6020,[302 427 197 180 603],383,5,26118,4.337817638266069,20.0,0.0
26021,2,6021,[ 89 211 568 161 423],311,4,26122,4.337761541016274,0.0,0.0
26022,2,6022,[597 202  56 185 288],13,2,26124,4.337373401959157,0.0,0.0
26023,2,6023,[302 427 197 180 603],383,5,26129,4.337483399734396,20.0,0.0
26024,2,6024,[302 427 197 180 603],271,5,26134,4.337593360995851,20.0,0.0
26025,2,6025,[222 204 111  95 153],479,5,26139,4.337703285761699,0.0,0.0
26026,2,6026,[742 237  70 121   8],95,4,26143,4.337647254023561,0.0,0.0
26027,2,6027,[288 183 194 144 174],339,3,26146,4.3374253483742535,0.0,20.0
26028,2,6028,[302 427 197 180 603],383,5,26151,4.337535246309504,20.0,0.0
26029,2,6029,[302 427 197 180 603],537,5,26156,4.337645107794361,20.0,0.0
26030,2,6030,[302 427 197 180 603],474,5,26161,4.337754932846957,20.0,0.0
26031,2,6031,[302 427 197 180 603],339,5,26166,4.337864721485412,20.0,0.0
26032,2,6032,[357 180 175 179  82],387,5,26171,4.33797447372783,20.0,0.0
26033,2,6033,[276 328 282 204  71],533,4,26175,4.337918462048393,0.0,0.0
26034,2,6034,[302 427 197 180 603],271,5,26180,4.338028169014085,20.0,0.0
26035,2,6035,[302 427 197 180 603],537,5,26185,4.338137839628893,20.0,0.0
26036,2,6036,[276 423 200 301  96],210,5,26190,4.338247473910883,0.0,0.0
26037,2,6037,[302 427 197 180 603],383,5,26195,4.3383570718781055,20.0,0.0
26038,2,6038,[ 64 423 180 323 121],804,4,26199,4.338301043219076,0.0,0.0
26039,2,6039,[302 427 197 180 603],271,5,26204,4.33841059602649,20.0,0.0
26040,2,6040,[228 118  88 144 269],738,2,26206,4.338023506042046,0.0,0.0
26041,2,6041,[302 427 197 180 603],537,5,26211,4.338133068520357,20.0,0.0
26042,2,6042,[302 427 197 180 603],537,5,26216,4.3382425947377135,20.0,0.0
26043,2,6043,[302 427 197 180 603],339,5,26221,4.3383520847121115,20.0,0.0
26044,2,6044,[302 427 197 180 603],90,5,26226,4.338461538461538,20.0,0.0
26045,2,6045,[302 427 197 180 603],383,5,26231,4.338570956003969,20.0,0.0
26046,2,6046,[302 427 197 180 603],537,5,26236,4.338680337357367,20.0,0.0
26047,2,6047,[302 427 197 180 603],271,5,26241,4.338789682539683,20.0,0.0
26048,2,6048,[183 185 234 186 161],638,5,26246,4.338898991568854,0.0,0.0
26049,2,6049,[185 196 172  11 180],840,3,26249,4.3386776859504135,0.0,0.0
26050,2,6050,[302 427 197 180 603],664,5,26254,4.338786977359114,20.0,0.0
26051,2,6051,[127 268 357  70 135],7,3,26257,4.338565763384005,20.0,20.0
26052,2,6052,[302 427 197 180 603],271,5,26262,4.33867503717165,20.0,0.0
26053,2,6053,[211 508  50 435  22],406,4,26266,4.338619094813347,0.0,20.0
26054,2,6054,[475 211 276 435 471],343,5,26271,4.338728323699422,0.0,0.0
26055,2,6055,[302 427 197 180 603],13,5,26276,4.33883751651255,20.0,0.0
26056,2,6056,[302 427 197 180 603],474,5,26281,4.338946673270596,20.0,0.0
26057,2,6057,[603 238 179 357   7],339,5,26286,4.339055793991417,40.0,0.0
26058,2,6058,[302 427 197 180 603],13,5,26291,4.339164878692854,20.0,0.0
26059,2,6059,[302 427 197 180 603],339,5,26296,4.339273927392739,20.0,0.0
26060,2,6060,[302 427 197 180 603],383,5,26301,4.339382940108893,20.0,0.0
26061,2,6061,[302 427 197 180 603],664,5,26306,4.339491916859123,20.0,0.0
26062,2,6062,[302 427 197 180 603],664,5,26311,4.339600857661224,20.0,0.0
26063,2,6063,[302 427 197 180 603],13,5,26316,4.339709762532982,20.0,0.0
26064,2,6064,[302 427 197 180 603],664,5,26321,4.339818631492168,20.0,0.0
26065,2,6065,[302 427 197 180 603],13,5,26326,4.339927464556545,20.0,0.0
26066,2,6066,[302 427 197 180 603],537,5,26331,4.34003626174386,20.0,0.0
26067,2,6067,[302 427 197 180 603],537,5,26336,4.340145023071853,20.0,0.0
26068,2,6068,[302 427 197 180 603],474,5,26341,4.340253748558247,20.0,0.0
26069,2,6069,[302 427 197 180 603],383,5,26346,4.340362438220758,20.0,0.0
26070,2,6070,[100 546 196 234  22],749,3,26349,4.340141657058146,0.0,20.0
26071,2,6071,[302 427 197 180 603],474,5,26354,4.340250329380765,20.0,0.0
26072,2,6072,[302 427 197 180 603],537,5,26359,4.340358965914705,20.0,0.0
26073,2,6073,[302 427 197 180 603],90,5,26364,4.340467566677642,20.0,0.0
26074,2,6074,[302 427 197 180 603],13,5,26369,4.340576131687243,20.0,0.0
26075,2,6075,[302 427 197 180 603],13,5,26374,4.340684660961158,20.0,0.0
26076,2,6076,[302 427 197 180 603],90,5,26379,4.340793154517032,20.0,0.0
26077,2,6077,[302 427 197 180 603],271,5,26384,4.340901612372491,20.0,0.0
26078,2,6078,[302 427 197 180 603],537,5,26389,4.341010034545156,20.0,0.0
26079,2,6079,[302 427 197 180 603],383,5,26394,4.341118421052632,20.0,0.0
26080,2,6080,[143 423 328  15 194],207,4,26398,4.341062325275448,0.0,0.0
26081,2,6081,[235 568 483 143 435],650,3,26401,4.340841828345939,20.0,0.0
26082,2,6082,[196 161 186 215 168],92,4,26405,4.340785796481999,0.0,0.0
26083,2,6083,[302 427 197 180 603],90,5,26410,4.3408941485864565,20.0,0.0
26084,2,6084,[302 427 197 180 603],474,5,26415,4.341002465078061,20.0,0.0
26085,2,6085,[302 427 197 180 603],383,5,26420,4.341110745974367,20.0,0.0
26086,2,6086,[302 427 197 180 603],90,5,26425,4.341218991292919,20.0,0.0
26087,2,6087,[302 427 197 180 603],339,5,26430,4.341327201051248,20.0,0.0
26088,2,6088,[269  12  89 313  96],883,3,26433,4.341106914107407,20.0,0.0
26089,2,6089,[302 427 197 180 603],13,5,26438,4.341215106732348,20.0,0.0
26090,2,6090,[302 427 197 180 603],339,5,26443,4.3413232638318835,20.0,0.0
26091,2,6091,[302 427 197 180 603],537,5,26448,4.3414313854235065,20.0,0.0
26092,2,6092,[302 427 197 180 603],13,5,26453,4.3415394715247,20.0,0.0
26093,2,6093,[302 427 197 180 603],13,5,26458,4.341647522152937,20.0,0.0
26094,2,6094,[258 568  50 127 234],59,4,26462,4.341591468416735,0.0,40.0
26095,2,6095,[302 427 197 180 603],271,5,26467,4.341699475065616,20.0,0.0
26096,2,6096,[603 215 357 191 318],537,4,26471,4.34164343119567,60.0,0.0
26097,2,6097,[302 427 197 180 603],474,5,26476,4.3417513938996395,20.0,0.0
26098,2,6098,[195  95  64 216  98],374,4,26480,4.3416953598950645,0.0,20.0
26099,2,6099,[ 82 234 508 385 289],13,1,26481,4.341147540983607,0.0,0.0
26100,2,6100,[302 427 197 180 603],666,5,26486,4.3412555318800194,20.0,0.0
26101,2,6101,[302 427 197 180 603],666,5,26491,4.341363487381186,20.0,0.0
26102,2,6102,[302 427 197 180 603],666,5,26496,4.341471407504506,20.0,0.0
26103,2,6103,[228 144 121 215 216],194,1,26497,4.340923984272608,0.0,0.0
26104,2,6104,[183 173 748 288  28],648,4,26501,4.340868140868141,0.0,0.0
26105,2,6105,[216 173   4 194 273],59,3,26504,4.340648542417294,0.0,0.0
26106,2,6106,[496 181 301 210 186],378,2,26506,4.340265269363026,0.0,0.0
26107,2,6107,[302 427 197 180 603],13,5,26511,4.340373280943026,20.0,0.0
26108,2,6108,[183 127 238  28 245],804,4,26515,4.340317564249468,0.0,20.0
26109,2,6109,[302 427 197 180 603],383,5,26520,4.340425531914893,20.0,0.0
26110,2,6110,[302 427 197 180 603],90,5,26525,4.340533464244804,20.0,0.0
26111,2,6111,[302 427 197 180 603],664,5,26530,4.340641361256544,20.0,0.0
26112,2,6112,[302 427 197 180 603],537,5,26535,4.340749222967446,20.0,0.0
26113,2,6113,[603 151 748  50  82],804,4,26539,4.3406934903500165,20.0,20.0
26114,2,6114,[302 427 197 180 603],90,5,26544,4.340801308258381,20.0,0.0
26115,2,6115,[273 210 194 125 655],234,1,26545,4.3402550686723345,0.0,0.0
26116,2,6116,[302 427 197 180 603],90,5,26550,4.3403629230014715,20.0,0.0
26117,2,6117,[302 427 197 180 603],13,5,26555,4.340470742072573,20.0,0.0
26118,2,6118,[302 427 197 180 603],339,5,26560,4.3405785259029255,20.0,0.0
26119,2,6119,[302 427 197 180 603],271,5,26565,4.340686274509804,20.0,0.0
26120,2,6120,[302 427 197 180 603],383,5,26570,4.340793987910472,20.0,0.0
26121,2,6121,[ 69  98 273 153 300],90,2,26572,4.340411630186214,0.0,20.0
26122,2,6122,[144  12 318 568 282],92,3,26575,4.340192715988894,40.0,0.0
26123,2,6123,[302 427 197 180 603],383,5,26580,4.340300457217505,20.0,0.0
26124,2,6124,[288 196 357 161 202],387,1,26581,4.339755102040816,20.0,0.0
26125,2,6125,[302 427 197 180 603],339,5,26586,4.339862879529873,20.0,0.0
26126,2,6126,[302 427 197 180 603],271,5,26591,4.339970621837767,20.0,0.0
26127,2,6127,[302 427 197 180 603],339,5,26596,4.340078328981723,20.0,0.0
26128,2,6128,[ 11 427 191  12 183],474,5,26601,4.340186000978952,20.0,0.0
26129,2,6129,[322 271 546 151 194],788,2,26603,4.339804241435563,0.0,0.0
26130,2,6130,[ 79  96 655  70 174],666,2,26605,4.339422606426358,0.0,20.0
26131,2,6131,[423 197 182 132 200],339,4,26609,4.339367253750815,0.0,0.0
26132,2,6132,[302 427 197 180 603],383,5,26614,4.33947497146584,20.0,0.0
26133,2,6133,[302 427 197 180 603],666,5,26619,4.339582654059341,20.0,0.0
26134,2,6134,[ 98 191  11 435 210],271,5,26624,4.339690301548492,0.0,20.0
26135,2,6135,[302 427 197 180 603],537,5,26629,4.3397979139504566,20.0,0.0
26136,2,6136,[302 427 197 180 603],666,5,26634,4.339905491282385,20.0,0.0
26137,2,6137,[175 144 174 435 257],804,4,26638,4.339850114043663,0.0,20.0
26138,2,6138,[748 211 678   1  11],804,5,26643,4.339957647825378,0.0,0.0
26139,2,6139,[194 215 143 200 300],694,4,26647,4.3399022801302936,0.0,0.0
26140,2,6140,[302 427 197 180 603],474,5,26652,4.340009770395701,20.0,0.0
26141,2,6141,[435  50 748 175 125],313,3,26655,4.339791598827744,0.0,20.0
26142,2,6142,[135 276 294 180 742],308,4,26659,4.33973628520267,0.0,0.0
26143,2,6143,[302 427 197 180 603],339,5,26664,4.33984375,20.0,0.0
26144,2,6144,[302 427 197 180 603],537,5,26669,4.339951179820993,20.0,0.0
26145,2,6145,[302 427 197 180 603],474,5,26674,4.34005857468272,20.0,0.0
26146,2,6146,[210 117 403 215   1],650,1,26675,4.339515210671872,0.0,0.0
26147,2,6147,[302 427 197 180 603],339,5,26680,4.339622641509434,20.0,0.0
26148,2,6148,[ 95 185 546 127 191],699,1,26681,4.339079525126037,0.0,20.0
26149,2,6149,[ 28 423  89 546  97],795,2,26683,4.33869918699187,0.0,0.0
26150,2,6150,[ 50 471 405 294 318],7,3,26686,4.338481547715818,20.0,20.0
26151,2,6151,[ 79 742  22 181 215],271,4,26690,4.338426527958387,0.0,0.0
26152,2,6152,[597   7 588 135 182],7,4,26694,4.338371526084837,0.0,0.0
26153,2,6153,[ 64 100 176 546  98],145,4,26698,4.338316542086448,0.0,40.0
26154,2,6154,[475 385 135 269 121],537,2,26700,4.337936636880585,0.0,0.0
26155,2,6155,[172 135 357   7 174],95,4,26704,4.337881741390514,20.0,20.0
26156,2,6156,[483 194 265 210 197],234,3,26707,4.337664446970927,20.0,0.0
26157,2,6157,[508 195 301 313  64],85,3,26710,4.337447223124391,0.0,0.0
26158,2,6158,[302 427 197 180 603],90,5,26715,4.337554797856795,20.0,0.0
26159,2,6159,[302 427 197 180 603],90,5,26720,4.337662337662338,20.0,0.0
26160,2,6160,[302 427 197 180 603],666,5,26725,4.337769842558027,20.0,0.0
26161,2,6161,[302 427 197 180 603],90,5,26730,4.337877312560857,20.0,0.0
26162,2,6162,[  4 265 117  56 153],194,3,26733,4.337660230407269,0.0,0.0
26163,2,6163,[302 427 197 180 603],90,5,26738,4.337767683322518,20.0,0.0
26164,2,6164,[302 427 197 180 603],383,5,26743,4.337875101378751,20.0,0.0
26165,2,6165,[302 427 197 180 603],664,5,26748,4.337982484592929,20.0,0.0
26166,2,6166,[302 427 197 180 603],474,5,26753,4.338089832982001,20.0,0.0
26167,2,6167,[302 427 197 180 603],664,5,26758,4.338197146562905,20.0,0.0
26168,2,6168,[302 427 197 180 603],383,5,26763,4.338304425352569,20.0,0.0
26169,2,6169,[302 427 197 180 603],90,5,26768,4.338411669367909,20.0,0.0
26170,2,6170,[603 196 678   4  98],13,4,26772,4.33835683033544,20.0,20.0
26171,2,6171,[302 427 197 180 603],383,5,26777,4.338464031108231,20.0,0.0
26172,2,6172,[302 427 197 180 603],537,5,26782,4.338571197148874,20.0,0.0
26173,2,6173,[678  25 161 127 238],474,4,26786,4.338516358924522,0.0,20.0
26174,2,6174,[302 427 197 180 603],271,5,26791,4.338623481781377,20.0,0.0
26175,2,6175,[302 427 197 180 603],271,5,26796,4.338730569948186,20.0,0.0
26176,2,6176,[302 427 197 180 603],271,5,26801,4.3388376234418,20.0,0.0
26177,2,6177,[496 168 483 275 269],125,4,26805,4.338782777597928,20.0,0.0
26178,2,6178,[302 427 197 180 603],383,5,26810,4.338889787991584,20.0,0.0
26179,2,6179,[302 427 197 180 603],271,5,26815,4.338996763754046,20.0,0.0
26180,2,6180,[302 427 197 180 603],474,5,26820,4.3391037049021195,20.0,0.0
26181,2,6181,[ 69  70 286 228  82],59,3,26823,4.33888709155613,0.0,0.0
26182,2,6182,[211 546  50  79 168],7,5,26828,4.338994015849911,0.0,20.0
26183,2,6183,[302 427 197 180 603],271,5,26833,4.339100905562742,20.0,0.0
26184,2,6184,[216 245 222 144  97],488,2,26835,4.33872271624899,0.0,0.0
26185,2,6185,[302 427 197 180 603],90,5,26840,4.3388296152602654,20.0,0.0
26186,2,6186,[ 89 183 496 655 187],479,4,26844,4.338774850492969,0.0,0.0
26187,2,6187,[302 427 197 180 603],90,5,26849,4.338881706528765,20.0,0.0
26188,2,6188,[302 427 197 180 603],383,5,26854,4.338988528033608,20.0,0.0
26189,2,6189,[302 427 197 180 603],13,5,26859,4.339095315024233,20.0,0.0
26190,2,6190,[302 427 197 180 603],271,5,26864,4.3392020675173635,20.0,0.0
26191,2,6191,[121 153  64 748 161],92,3,26867,4.338985788113695,0.0,0.0
26192,2,6192,[185 318  50  56   7],653,3,26870,4.338769578556435,20.0,20.0
26193,2,6193,[302 427 197 180 603],339,5,26875,4.33887633193413,20.0,0.0
26194,2,6194,[302 427 197 180 603],537,5,26880,4.338983050847458,20.0,0.0
26195,2,6195,[302 427 197 180 603],339,5,26885,4.339089735313105,20.0,0.0
26196,2,6196,[302 427 197 180 603],13,5,26890,4.339196385347749,20.0,0.0
26197,2,6197,[302 427 197 180 603],13,5,26895,4.339303000968054,20.0,0.0
26198,2,6198,[228 174 423  50 127],387,4,26899,4.3392482658493305,0.0,60.0
26199,2,6199,[435 302 288   9 153],343,4,26903,4.3391935483870965,0.0,0.0
26200,2,6200,[161  22 143 100 180],207,2,26905,4.338816319948395,0.0,20.0
26201,2,6201,[282 100 273 228 237],328,2,26907,4.338439213157046,0.0,20.0
26202,2,6202,[121   8 403 234 265],92,5,26912,4.338545864904079,0.0,0.0
26203,2,6203,[302 427 197 180 603],664,5,26917,4.338652482269503,20.0,0.0
26204,2,6204,[302 427 197 180 603],666,5,26922,4.338759065269944,20.0,0.0
26205,2,6205,[302 427 197 180 603],664,5,26927,4.338865613922011,20.0,0.0
26206,2,6206,[302 427 197 180 603],13,5,26932,4.3389721282423075,20.0,0.0
26207,2,6207,[302 427 197 180 603],339,5,26937,4.339078608247423,20.0,0.0
26208,2,6208,[302 427 197 180 603],271,5,26942,4.339185053953938,20.0,0.0
26209,2,6209,[300 211  95 313 135],64,4,26946,4.339130434782609,0.0,0.0
26210,2,6210,[302 427 197 180 603],271,5,26951,4.339236837868298,20.0,0.0
26211,2,6211,[302 427 197 180 603],13,5,26956,4.339343206696716,20.0,0.0
26212,2,6212,[302 427 197 180 603],13,5,26961,4.339449541284404,20.0,0.0
26213,2,6213,[302 427 197 180 603],537,5,26966,4.339555841647892,20.0,0.0
26214,2,6214,[302 427 197 180 603],537,5,26971,4.339662107803701,20.0,0.0
26215,2,6215,[302 427 197 180 603],13,5,26976,4.33976833976834,20.0,0.0
26216,2,6216,[302 427 197 180 603],383,5,26981,4.339874537558308,20.0,0.0
26217,2,6217,[302 427 197 180 603],666,5,26986,4.339980701190093,20.0,0.0
26218,2,6218,[302 427 197 180 603],664,5,26991,4.340086830680174,20.0,0.0
26219,2,6219,[302 427 197 180 603],537,5,26996,4.340192926045016,20.0,0.0
26220,2,6220,[302 427 197 180 603],664,5,27001,4.340298987301077,20.0,0.0
26221,2,6221,[257 258 234  11 185],653,0,27001,4.339601414336227,0.0,0.0
26222,2,6222,[234 273 144 357 180],308,2,27003,4.339225453961112,20.0,0.0
26223,2,6223,[302 427 197 180 603],537,5,27008,4.339331619537275,20.0,0.0
26224,2,6224,[302 427 197 180 603],664,5,27013,4.339437751004016,20.0,0.0
26225,2,6225,[ 95  98  64 238 200],387,3,27016,4.339222614840989,0.0,20.0
26226,2,6226,[  7 471 197  97 318],343,5,27021,4.3393287297253895,20.0,0.0
26227,2,6227,[238 168 313 135   1],13,3,27024,4.339113680154143,0.0,0.0
26228,2,6228,[302 427 197 180 603],664,5,27029,4.339219778455611,20.0,0.0
26229,2,6229,[302 427 197 180 603],664,5,27034,4.3393258426966295,20.0,0.0
26230,2,6230,[302 427 197 180 603],666,5,27039,4.339431872893597,20.0,0.0
26231,2,6231,[302 427 197 180 603],474,5,27044,4.339537869062901,20.0,0.0
26232,2,6232,[302 427 197 180 603],383,5,27049,4.339643831220921,20.0,0.0
26233,2,6233,[302 427 197 180 603],13,5,27054,4.3397497593840235,20.0,0.0
26234,2,6234,[302 427 197 180 603],339,5,27059,4.339855653568565,20.0,0.0
26235,2,6235,[423 238 496 318  69],308,3,27062,4.339640795381655,20.0,0.0
26236,2,6236,[302 427 197 180 603],666,5,27067,4.339746673080007,20.0,0.0
26237,2,6237,[302 427 197 180 603],90,5,27072,4.339852516832318,20.0,0.0
26238,2,6238,[302 427 197 180 603],537,5,27077,4.339958326654912,20.0,0.0
26239,2,6239,[302 427 197 180 603],90,5,27082,4.340064102564103,20.0,0.0
26240,2,6240,[302 427 197 180 603],666,5,27087,4.34016984457619,20.0,0.0
26241,2,6241,[302 427 197 180 603],339,5,27092,4.340275552707466,20.0,0.0
26242,2,6242,[302 427 197 180 603],271,5,27097,4.340381226974211,20.0,0.0
26243,2,6243,[302 427 197 180 603],339,5,27102,4.340486867392697,20.0,0.0
26244,2,6244,[182 748  97   8 385],328,0,27102,4.339791833466774,0.0,0.0
26245,2,6245,[302 427 197 180 603],90,5,27107,4.33989753442203,20.0,0.0
26246,2,6246,[302 427 197 180 603],664,5,27112,4.340003201536738,20.0,0.0
26247,2,6247,[302 427 197 180 603],90,5,27117,4.340108834827145,20.0,0.0
26248,2,6248,[302 427 197 180 603],537,5,27122,4.340214434309489,20.0,0.0
26249,2,6249,[204 183 742 111 276],92,3,27125,4.34,0.0,0.0
26250,2,6250,[238 269 194  95   7],64,5,27130,4.340105583106703,0.0,0.0
26251,2,6251,[423 118 215 211 181],804,4,27134,4.340051183621241,0.0,0.0
26252,2,6252,[ 15 210 323 385 435],378,4,27138,4.339996801535263,0.0,0.0
26253,2,6253,[302 427 197 180 603],339,5,27143,4.340102334505916,20.0,0.0
26254,2,6254,[302 427 197 180 603],13,5,27148,4.340207833733014,20.0,0.0
26255,2,6255,[302 427 197 180 603],271,5,27153,4.3403132992327365,20.0,0.0
26256,2,6256,[173  50  56 258 269],940,5,27158,4.3404187310212565,0.0,20.0
26257,2,6257,[302 427 197 180 603],90,5,27163,4.340524129114733,20.0,0.0
26258,2,6258,[302 427 197 180 603],666,5,27168,4.340629493529318,20.0,0.0
26259,2,6259,[302 427 197 180 603],90,5,27173,4.34073482428115,20.0,0.0
26260,2,6260,[302 427 197 180 603],383,5,27178,4.34084012138636,20.0,0.0
26261,2,6261,[302 427 197 180 603],664,5,27183,4.340945384861067,20.0,0.0
26262,2,6262,[302 427 197 180 603],339,5,27188,4.34105061472138,20.0,0.0
26263,2,6263,[302 427 197 180 603],13,5,27193,4.341155810983397,20.0,0.0
26264,2,6264,[302 427 197 180 603],13,5,27198,4.341260973663208,20.0,0.0
26265,2,6265,[302 427 197 180 603],474,5,27203,4.341366102776891,20.0,0.0
26266,2,6266,[603 111 174  56 222],474,5,27208,4.341471198340514,20.0,20.0
26267,2,6267,[302 427 197 180 603],383,5,27213,4.341576260370134,20.0,0.0
26268,2,6268,[302 427 197 180 603],90,5,27218,4.3416812888818,20.0,0.0
26269,2,6269,[302 427 197 180 603],271,5,27223,4.341786283891547,20.0,0.0
26270,2,6270,[302 427 197 180 603],271,5,27228,4.341891245415404,20.0,0.0
26271,2,6271,[302 427 197 180 603],664,5,27233,4.341996173469388,20.0,0.0
26272,2,6272,[302 427 197 180 603],383,5,27238,4.342101068069504,20.0,0.0
26273,2,6273,[302 427 197 180 603],13,5,27243,4.34220592923175,20.0,0.0
26274,2,6274,[302 427 197 180 603],474,5,27248,4.342310756972112,20.0,0.0
26275,2,6275,[302 427 197 180 603],664,5,27253,4.342415551306565,20.0,0.0
26276,2,6276,[  7 742 515 238  69],524,3,27256,4.342201688704796,0.0,0.0
26277,2,6277,[302 427 197 180 603],666,5,27261,4.342306467027716,20.0,0.0
26278,2,6278,[179  89 176 216 294],234,0,27261,4.341614906832298,0.0,0.0
26279,2,6279,[302 427 197 180 603],90,5,27266,4.34171974522293,20.0,0.0
26280,2,6280,[121 187 333 508 357],343,3,27269,4.341506129597198,20.0,0.0
26281,2,6281,[302 427 197 180 603],339,5,27274,4.341610951926138,20.0,0.0
26282,2,6282,[302 427 197 180 603],383,5,27279,4.341715740888111,20.0,0.0
26283,2,6283,[302 427 197 180 603],666,5,27284,4.341820496499045,20.0,0.0
26284,2,6284,[302 427 197 180 603],90,5,27289,4.341925218774861,20.0,0.0
26285,2,6285,[174  64 405 176 194],343,5,27294,4.342029907731467,0.0,20.0
26286,2,6286,[302 427 197 180 603],474,5,27299,4.342134563384763,20.0,0.0
26287,2,6287,[302 427 197 180 603],664,5,27304,4.342239185750636,20.0,0.0
26288,2,6288,[ 97 357  71 568 588],290,2,27306,4.341866751470822,20.0,0.0
26289,2,6289,[302 427 197 180 603],90,5,27311,4.341971383147854,20.0,0.0
26290,2,6290,[302 427 197 180 603],90,5,27316,4.34207598156096,20.0,0.0
26291,2,6291,[302 427 197 180 603],537,5,27321,4.342180546726001,20.0,0.0
26292,2,6292,[302 427 197 180 603],271,5,27326,4.342285078658827,20.0,0.0
26293,2,6293,[302 427 197 180 603],474,5,27331,4.342389577375278,20.0,0.0
26294,2,6294,[118 282 742  89 294],447,4,27335,4.342335186656077,0.0,0.0
26295,2,6295,[302 427 197 180 603],537,5,27340,4.342439644218551,20.0,0.0
26296,2,6296,[302 427 197 180 603],666,5,27345,4.342544068604097,20.0,0.0
26297,2,6297,[302 427 197 180 603],271,5,27350,4.342648459828517,20.0,0.0
26298,2,6298,[302 427 197 180 603],339,5,27355,4.342752817907605,20.0,0.0
26299,2,6299,[302 427 197 180 603],339,5,27360,4.3428571428571425,20.0,0.0
26300,2,6300,[288   1 135 385  56],533,2,27362,4.34248531979051,0.0,0.0
26301,2,6301,[302 427 197 180 603],537,5,27367,4.34258965407807,20.0,0.0
26302,2,6302,[302 427 197 180 603],13,5,27372,4.3426939552594,20.0,0.0
26303,2,6303,[111 228  97 742 357],488,5,27377,4.342798223350254,20.0,0.0
26304,2,6304,[435 181 125 187 161],7,3,27380,4.342585249801744,0.0,0.0
26305,2,6305,[302 427 197 180 603],666,5,27385,4.342689502061528,20.0,0.0
26306,2,6306,[302 427 197 180 603],537,5,27390,4.3427937212620895,20.0,0.0
26307,2,6307,[265 173 196 323 322],374,2,27392,4.342422320862397,0.0,0.0
26308,2,6308,[546  96 194 175 153],234,1,27393,4.34189253447456,0.0,0.0
26309,2,6309,[302 427 197 180 603],339,5,27398,4.341996830427893,20.0,0.0
26310,2,6310,[475 318  71 289 173],455,2,27400,4.341625732847409,20.0,0.0
26311,2,6311,[302 427 197 180 603],339,5,27405,4.341730038022813,20.0,0.0
26312,2,6312,[174 117   1 197 151],533,4,27409,4.341675906858863,0.0,20.0
26313,2,6313,[302 427 197 180 603],537,5,27414,4.341780171048463,20.0,0.0
26314,2,6314,[302 427 197 180 603],666,5,27419,4.341884402216944,20.0,0.0
26315,2,6315,[302 427 197 180 603],13,5,27424,4.341988600379987,20.0,0.0
26316,2,6316,[153  88 210 187 202],313,3,27427,4.341776159569416,0.0,0.0
26317,2,6317,[302 427 197 180 603],666,5,27432,4.3418803418803416,20.0,0.0
26318,2,6318,[302 427 197 180 603],537,5,27437,4.341984491216965,20.0,0.0
26319,2,6319,[132 276 151 268 238],334,4,27441,4.341930379746835,0.0,0.0
26320,2,6320,[302 427 197 180 603],537,5,27446,4.342034488213891,20.0,0.0
26321,2,6321,[302 427 197 180 603],13,5,27451,4.34213856374565,20.0,0.0
26322,2,6322,[302 427 197 180 603],537,5,27456,4.3422426063577415,20.0,0.0
26323,2,6323,[302 427 197 180 603],537,5,27461,4.3423466160657815,20.0,0.0
26324,2,6324,[302 427 197 180 603],537,5,27466,4.342450592885376,20.0,0.0
26325,2,6325,[302 427 197 180 603],666,5,27471,4.342554536832122,20.0,0.0
26326,2,6326,[302 427 197 180 603],383,5,27476,4.342658447921606,20.0,0.0
26327,2,6327,[302 427 197 180 603],271,5,27481,4.342762326169406,20.0,0.0
26328,2,6328,[ 69   7  98  96 210],666,2,27483,4.3423921630589355,0.0,20.0
26329,2,6329,[302 427 197 180 603],13,5,27488,4.342496050552922,20.0,0.0
26330,2,6330,[ 96  69 183 313 328],234,3,27491,4.342283999368188,0.0,0.0
26331,2,6331,[215 204  28 210 121],882,5,27496,4.342387871130764,0.0,0.0
26332,2,6332,[302 427 197 180 603],90,5,27501,4.3424917100900045,20.0,0.0
26333,2,6333,[302 427 197 180 603],383,5,27506,4.342595516261446,20.0,0.0
26334,2,6334,[302 427 197 180 603],13,5,27511,4.342699289660616,20.0,0.0
26335,2,6335,[302 427 197 180 603],664,5,27516,4.34280303030303,20.0,0.0
26336,2,6336,[302 427 197 180 603],537,5,27521,4.3429067382041975,20.0,0.0
26337,2,6337,[302 427 197 180 603],383,5,27526,4.3430104133796155,20.0,0.0
26338,2,6338,[257 172 194  25 237],271,4,27530,4.342956302255876,0.0,0.0
26339,2,6339,[302 427 197 180 603],474,5,27535,4.343059936908517,20.0,0.0
26340,2,6340,[127 568 289 300 748],488,3,27538,4.342848131209588,0.0,20.0
26341,2,6341,[273  50 471 173 187],234,2,27540,4.3424787133396405,0.0,20.0
26342,2,6342,[302 427 197 180 603],271,5,27545,4.34258237427085,20.0,0.0
26343,2,6343,[302 427 197 180 603],271,5,27550,4.342686002522068,20.0,0.0
26344,2,6344,[ 69 125 186 179 385],374,4,27554,4.342631993695823,0.0,0.0
26345,2,6345,[132 144 597   8  89],308,2,27556,4.342262842735582,0.0,0.0
26346,2,6346,[271 173 475 273 196],144,3,27559,4.34205136284859,0.0,0.0
26347,2,6347,[211  12  95  82 210],524,2,27561,4.341682419659735,20.0,0.0
26348,2,6348,[423  79 182 215 144],653,1,27562,4.3411560875728465,0.0,0.0
26349,2,6349,[302 427 197 180 603],474,5,27567,4.341259842519685,20.0,0.0
26350,2,6350,[ 28  22 655 286 237],537,0,27567,4.340576287198866,0.0,0.0
26351,2,6351,[179  98 313  50  28],64,5,27572,4.340680100755668,0.0,40.0
26352,2,6352,[471 357 678 483 127],7,4,27576,4.34062647568078,40.0,20.0
26353,2,6353,[302 427 197 180 603],339,5,27581,4.34073024866226,20.0,0.0
26354,2,6354,[302 427 197 180 603],13,5,27586,4.340833988985051,20.0,0.0
26355,2,6355,[302 427 197 180 603],383,5,27591,4.340937696664569,20.0,0.0
26356,2,6356,[ 25 237  70  89 175],95,2,27593,4.340569450998899,0.0,0.0
26357,2,6357,[302 427 197 180 603],90,5,27598,4.340673167662787,20.0,0.0
26358,2,6358,[302 427 197 180 603],383,5,27603,4.340776851706243,20.0,0.0
26359,2,6359,[328  79  64 132  71],95,4,27607,4.340723270440251,0.0,0.0
26360,2,6360,[180 179   7 202 210],774,3,27610,4.3405124980349,0.0,0.0
26361,2,6361,[302 427 197 180 603],666,5,27615,4.340616158440742,20.0,0.0
26362,2,6362,[302 427 197 180 603],666,5,27620,4.340719786264341,20.0,0.0
26363,2,6363,[302 427 197 180 603],13,5,27625,4.340823381521056,20.0,0.0
26364,2,6364,[302 427 197 180 603],474,5,27630,4.340926944226237,20.0,0.0
26365,2,6365,[302 427 197 180 603],383,5,27635,4.341030474395224,20.0,0.0
26366,2,6366,[302 427 197 180 603],664,5,27640,4.341133972043348,20.0,0.0
26367,2,6367,[125  50  98  56 215],406,3,27643,4.340923366834171,0.0,40.0
26368,2,6368,[302 427 197 180 603],664,5,27648,4.34102684879887,20.0,0.0
26369,2,6369,[302 427 197 180 603],383,5,27653,4.341130298273155,20.0,0.0
26370,2,6370,[302 427 197 180 603],537,5,27658,4.3412337152723275,20.0,0.0
26371,2,6371,[302 427 197 180 603],474,5,27663,4.3413370998116765,20.0,0.0
26372,2,6372,[302 427 197 180 603],339,5,27668,4.341440451906481,20.0,0.0
26373,2,6373,[302 427 197 180 603],13,5,27673,4.341543771572011,20.0,0.0
26374,2,6374,[ 11 135  56  98  69],59,5,27678,4.341647058823529,0.0,20.0
26375,2,6375,[568  89   4 265 228],883,3,27681,4.341436637390213,0.0,0.0
26376,2,6376,[ 22  96 318  98 118],804,5,27686,4.341539909048142,20.0,20.0
26377,2,6377,[302 427 197 180 603],339,5,27691,4.341643148322358,20.0,0.0
26378,2,6378,[403 323 286  28 204],881,2,27693,4.341276062078696,0.0,0.0
26379,2,6379,[300 275 117  12 294],121,3,27696,4.3410658307210035,20.0,0.0
26380,2,6380,[302 427 197 180 603],383,5,27701,4.341169095753017,20.0,0.0
26381,2,6381,[302 427 197 180 603],383,5,27706,4.341272328423692,20.0,0.0
26382,2,6382,[294 183  89  28 168],488,5,27711,4.341375528748237,0.0,0.0
26383,2,6383,[302 427 197 180 603],664,5,27716,4.341478696741855,20.0,0.0
26384,2,6384,[186 161 195 211  95],897,4,27720,4.341425215348473,0.0,0.0
26385,2,6385,[302 427 197 180 603],339,5,27725,4.341528343250861,20.0,0.0
26386,2,6386,[302 427 197 180 603],474,5,27730,4.341631438860185,20.0,0.0
26387,2,6387,[302 427 197 180 603],90,5,27735,4.341734502191609,20.0,0.0
26388,2,6388,[475  69  79 228 603],82,2,27737,4.341367976209109,20.0,0.0
26389,2,6389,[302 427 197 180 603],474,5,27742,4.341471048513302,20.0,0.0
26390,2,6390,[302 427 197 180 603],90,5,27747,4.34157408856204,20.0,0.0
26391,2,6391,[222 286 161 181  79],380,2,27749,4.341207759699625,0.0,0.0
26392,2,6392,[302 427 197 180 603],666,5,27754,4.3413108086970125,20.0,0.0
26393,2,6393,[185 174 286 181 269],329,4,27758,4.341257428839537,0.0,20.0
26394,2,6394,[302 427 197 180 603],339,5,27763,4.341360437842064,20.0,0.0
26395,2,6395,[427 546 125  96 300],533,4,27767,4.341307066916823,0.0,0.0
26396,2,6396,[302 427 197 180 603],383,5,27772,4.341410035954354,20.0,0.0
26397,2,6397,[302 427 197 180 603],13,5,27777,4.341512972804002,20.0,0.0
26398,2,6398,[191 135 435 265 143],666,3,27780,4.3413033286451,0.0,0.0
26399,2,6399,[302 427 197 180 603],537,5,27785,4.34140625,20.0,0.0
26400,2,6400,[302 427 197 180 603],339,5,27790,4.341509139197001,20.0,0.0
26401,2,6401,[302 427 197 180 603],474,5,27795,4.341611996251172,20.0,0.0
26402,2,6402,[302 427 197 180 603],666,5,27800,4.341714821177573,20.0,0.0
26403,2,6403,[302 427 197 180 603],13,5,27805,4.341817613991256,20.0,0.0
26404,2,6404,[183 202  82  71 187],650,1,27806,4.341295862607338,0.0,0.0
26405,2,6405,[302 427 197 180 603],13,5,27811,4.341398688729316,20.0,0.0
26406,2,6406,[302 427 197 180 603],339,5,27816,4.341501482753238,20.0,0.0
26407,2,6407,[195 173 742 483 204],59,4,27820,4.341448189762796,20.0,0.0
26408,2,6408,[302 427 197 180 603],664,5,27825,4.3415509439850215,20.0,0.0
26409,2,6409,[302 427 197 180 603],666,5,27830,4.341653666146646,20.0,0.0
26410,2,6410,[302 427 197 180 603],664,5,27835,4.341756356262674,20.0,0.0
26411,2,6411,[302 427 197 180 603],13,5,27840,4.341859014348097,20.0,0.0
26412,2,6412,[302 427 197 180 603],537,5,27845,4.341961640417901,20.0,0.0
26413,2,6413,[508 301 271 211 185],315,3,27848,4.3417524165887125,0.0,0.0
26414,2,6414,[302 427 197 180 603],339,5,27853,4.341855027279813,20.0,0.0
26415,2,6415,[302 427 197 180 603],339,5,27858,4.341957605985037,20.0,0.0
26416,2,6416,[302 427 197 180 603],383,5,27863,4.342060152719339,20.0,0.0
26417,2,6417,[302 427 197 180 603],90,5,27868,4.3421626674976626,20.0,0.0
26418,2,6418,[258 125 483 357 151],6,2,27870,4.341797787817417,40.0,0.0
26419,2,6419,[385 471 265 294 182],308,2,27872,4.3414330218068535,0.0,0.0
26420,2,6420,[302 427 197 180 603],664,5,27877,4.341535586357265,20.0,0.0
26421,2,6421,[302 427 197 180 603],474,5,27882,4.3416381189660544,20.0,0.0
26422,2,6422,[302 427 197 180 603],474,5,27887,4.34174061964814,20.0,0.0
26423,2,6423,[302 427 197 180 603],271,5,27892,4.341843088418431,20.0,0.0
26424,2,6424,[135 211 423  96 196],7,5,27897,4.341945525291829,0.0,0.0
26425,2,6425,[302 427 197 180 603],474,5,27902,4.342047930283225,20.0,0.0
26426,2,6426,[302 427 197 180 603],474,5,27907,4.342150303407499,20.0,0.0
26427,2,6427,[302 427 197 180 603],474,5,27912,4.342252644679527,20.0,0.0
26428,2,6428,[302 427 197 180 603],537,5,27917,4.34235495411417,20.0,0.0
26429,2,6429,[117  56  22  69 153],194,3,27920,4.342146189735614,0.0,0.0
26430,2,6430,[180  22 238 202 175],881,3,27923,4.341937490281449,0.0,0.0
26431,2,6431,[302 427 197 180 603],90,5,27928,4.342039800995025,20.0,0.0
26432,2,6432,[302 427 197 180 603],271,5,27933,4.342142079900513,20.0,0.0
26433,2,6433,[302 427 197 180 603],666,5,27938,4.342244327012745,20.0,0.0
26434,2,6434,[302 427 197 180 603],339,5,27943,4.342346542346542,20.0,0.0
26435,2,6435,[302 427 197 180 603],90,5,27948,4.342448725916719,20.0,0.0
26436,2,6436,[302 427 197 180 603],271,5,27953,4.342550877738077,20.0,0.0
26437,2,6437,[302 427 197 180 603],271,5,27958,4.342652997825412,20.0,0.0
26438,2,6438,[603  82  79 271 180],537,2,27960,4.342289175337785,20.0,0.0
26439,2,6439,[153  96 117 183 125],144,5,27965,4.342391304347826,0.0,0.0
26440,2,6440,[302 427 197 180 603],664,5,27970,4.342493401645707,20.0,0.0
26441,2,6441,[302 427 197 180 603],90,5,27975,4.342595467246197,20.0,0.0
26442,2,6442,[302 427 197 180 603],537,5,27980,4.342697501164054,20.0,0.0
26443,2,6443,[275 282 318 471  88],533,5,27985,4.342799503414029,20.0,0.0
26444,2,6444,[302 427 197 180 603],474,5,27990,4.342901474010861,20.0,0.0
26445,2,6445,[302 427 197 180 603],664,5,27995,4.343003412969283,20.0,0.0
26446,2,6446,[ 69  88 172 435 655],881,2,27997,4.342639987591127,0.0,0.0
26447,2,6447,[302 427 197 180 603],271,5,28002,4.342741935483871,20.0,0.0
26448,2,6448,[603 204 273 185 151],308,4,28006,4.342688788959529,20.0,0.0
26449,2,6449,[302 427 197 180 603],383,5,28011,4.342790697674419,20.0,0.0
26450,2,6450,[302 427 197 180 603],271,5,28016,4.342892574794606,20.0,0.0
26451,2,6451,[153 742 127 161  15],313,2,28018,4.342529448233106,0.0,20.0
26452,2,6452,[302 427 197 180 603],383,5,28023,4.3426313342631335,20.0,0.0
26453,2,6453,[200 301 603 235 234],145,5,28028,4.342733188720174,20.0,0.0
26454,2,6454,[302 427 197 180 603],474,5,28033,4.3428350116189005,20.0,0.0
26455,2,6455,[678 202 196 515 435],387,1,28034,4.342317224287484,0.0,0.0
26456,2,6456,[302 427 197 180 603],13,5,28039,4.342419080068143,20.0,0.0
26457,2,6457,[302 427 197 180 603],383,5,28044,4.342520904304738,20.0,0.0
26458,2,6458,[302 427 197 180 603],664,5,28049,4.3426226970119215,20.0,0.0
26459,2,6459,[183  15 180 202  25],207,2,28051,4.342260061919505,0.0,0.0
26460,2,6460,[ 15  88 204 318 294],234,1,28052,4.341742764277975,20.0,0.0
26461,2,6461,[222 168 181 597 235],102,0,28052,4.341070875889818,0.0,0.0
26462,2,6462,[302 427 197 180 603],13,5,28057,4.341172829955129,20.0,0.0
26463,2,6463,[302 427 197 180 603],537,5,28062,4.341274752475248,20.0,0.0
26464,2,6464,[302 427 197 180 603],90,5,28067,4.341376643464811,20.0,0.0
26465,2,6465,[568   4 288 176 475],339,3,28070,4.341169192700279,0.0,0.0
26466,2,6466,[302 427 197 180 603],339,5,28075,4.341271068501624,20.0,0.0
26467,2,6467,[302 427 197 180 603],339,5,28080,4.341372912801484,20.0,0.0
26468,2,6468,[302 427 197 180 603],383,5,28085,4.341474725614469,20.0,0.0
26469,2,6469,[655 385 197 168  25],308,4,28089,4.341421947449768,0.0,0.0
26470,2,6470,[302 427 197 180 603],664,5,28094,4.341523721217741,20.0,0.0
26471,2,6471,[742  25  88 143  96],207,3,28097,4.341316440049444,0.0,0.0
26472,2,6472,[302 427 197 180 603],339,5,28102,4.341418198671405,20.0,0.0
26473,2,6473,[238 161 678  82  96],749,2,28104,4.341056533827619,0.0,0.0
26474,2,6474,[ 22 182 234  69 258],64,4,28108,4.341003861003861,0.0,0.0
26475,2,6475,[588 276  11  12  79],308,5,28113,4.341105620753551,20.0,0.0
26476,2,6476,[302 427 197 180 603],13,5,28118,4.3412073490813645,20.0,0.0
26477,2,6477,[302 427 197 180 603],383,5,28123,4.341309046001853,20.0,0.0
26478,2,6478,[302 427 197 180 603],90,5,28128,4.341410711529557,20.0,0.0
26479,2,6479,[302 427 197 180 603],666,5,28133,4.341512345679012,20.0,0.0
26480,2,6480,[302 427 197 180 603],666,5,28138,4.341613948464743,20.0,0.0
26481,2,6481,[302 427 197 180 603],13,5,28143,4.341715519901265,20.0,0.0
26482,2,6482,[195 132  71 153 175],85,3,28146,4.341508560851458,0.0,0.0
26483,2,6483,[204 222  56 174 300],843,1,28147,4.340993214065391,0.0,20.0
26484,2,6484,[302 427 197 180 603],271,5,28152,4.341094834232845,20.0,0.0
26485,2,6485,[161 238 186 271 475],92,3,28155,4.340888066604995,0.0,0.0
26486,2,6486,[302 427 197 180 603],13,5,28160,4.340989671650994,20.0,0.0
26487,2,6487,[ 88  69 302 471 655],207,3,28163,4.340782983970407,0.0,0.0
26488,2,6488,[302 427 197 180 603],90,5,28168,4.340884573894282,20.0,0.0
26489,2,6489,[302 427 197 180 603],90,5,28173,4.340986132511556,20.0,0.0
26490,2,6490,[302 427 197 180 603],90,5,28178,4.341087659836697,20.0,0.0
26491,2,6491,[302 427 197 180 603],664,5,28183,4.341189155884165,20.0,0.0
26492,2,6492,[302 427 197 180 603],13,5,28188,4.3412906206684125,20.0,0.0
26493,2,6493,[  7 185 180   1 127],59,4,28192,4.341238065906991,0.0,20.0
26494,2,6494,[302 427 197 180 603],474,5,28197,4.341339491916859,20.0,0.0
26495,2,6495,[302 427 197 180 603],90,5,28202,4.341440886699507,20.0,0.0
26496,2,6496,[435 235 222 475 405],932,4,28206,4.341388333076805,0.0,0.0
26497,2,6497,[210 187  50 100 118],774,1,28207,4.340874115112342,0.0,40.0
26498,2,6498,[302 427 197 180 603],13,5,28212,4.3409755346976455,20.0,0.0
26499,2,6499,[302 427 197 180 603],271,5,28217,4.3410769230769235,20.0,0.0
26500,2,6500,[302 427 197 180 603],13,5,28222,4.341178280264574,20.0,0.0
26501,2,6501,[185  71 288 357  82],13,1,28223,4.340664410950477,20.0,0.0
26502,2,6502,[187 194   9 435 216],64,5,28228,4.340765800399815,0.0,0.0
26503,2,6503,[302 427 197 180 603],339,5,28233,4.340867158671586,20.0,0.0
26504,2,6504,[302 427 197 180 603],474,5,28238,4.340968485780169,20.0,0.0
26505,2,6505,[ 12 204  79 182 603],537,2,28240,4.340608668920996,40.0,0.0
26506,2,6506,[302 427 197 180 603],90,5,28245,4.340710004610419,20.0,0.0
26507,2,6507,[302 427 197 180 603],537,5,28250,4.340811309157959,20.0,0.0
26508,2,6508,[ 98 300 180 187 186],346,2,28252,4.340451682286066,0.0,20.0
26509,2,6509,[302 427 197 180 603],90,5,28257,4.340552995391705,20.0,0.0
26510,2,6510,[302 427 197 180 603],383,5,28262,4.340654277376747,20.0,0.0
26511,2,6511,[302 427 197 180 603],537,5,28267,4.340755528255528,20.0,0.0
26512,2,6512,[302 427 197 180 603],13,5,28272,4.340856748042377,20.0,0.0
26513,2,6513,[302 427 197 180 603],474,5,28277,4.340957936751612,20.0,0.0
26514,2,6514,[302 427 197 180 603],271,5,28282,4.3410590943975444,20.0,0.0
26515,2,6515,[302 427 197 180 603],537,5,28287,4.3411602209944755,20.0,0.0
26516,2,6516,[302 427 197 180 603],271,5,28292,4.341261316556698,20.0,0.0
26517,2,6517,[191 182 222 197 195],13,2,28294,4.3409021172138695,0.0,0.0
26518,2,6518,[403  95 282 180 181],804,3,28297,4.340696425832183,0.0,0.0
26519,2,6519,[302 427 197 180 603],383,5,28302,4.34079754601227,20.0,0.0
26520,2,6520,[302 427 197 180 603],666,5,28307,4.340898635178654,20.0,0.0
26521,2,6521,[302 427 197 180 603],383,5,28312,4.3409996933456,20.0,0.0
26522,2,6522,[302 427 197 180 603],271,5,28317,4.341100720527365,20.0,0.0
26523,2,6523,[302 427 197 180 603],474,5,28322,4.3412017167381975,20.0,0.0
26524,2,6524,[302 427 197 180 603],383,5,28327,4.341302681992337,20.0,0.0
26525,2,6525,[111 357 174 216  88],643,4,28331,4.341250383083052,20.0,20.0
26526,2,6526,[302 427 197 180 603],13,5,28336,4.341351309943312,20.0,0.0
26527,2,6527,[183 181 176  22  12],380,3,28339,4.341145833333333,20.0,0.0
26528,2,6528,[117 234  69  70 180],311,5,28344,4.341246745290244,0.0,0.0
26529,2,6529,[302 427 197 180 603],383,5,28349,4.341347626339969,20.0,0.0
26530,2,6530,[245   7   8 269 204],378,4,28353,4.341295360587965,0.0,0.0
26531,2,6531,[144 194 197 135  28],899,4,28357,4.341243110838946,0.0,0.0
26532,2,6532,[194  89  22  12 385],378,5,28362,4.3413439461197,20.0,0.0
26533,2,6533,[258 172  97 168  98],538,3,28365,4.341138659320477,0.0,20.0
26534,2,6534,[742  98 265 289  22],533,3,28368,4.340933435348125,0.0,20.0
26535,2,6535,[302 427 197 180 603],383,5,28373,4.341034271725826,20.0,0.0
26536,2,6536,[ 71 288 273 238 100],59,3,28376,4.340829126510632,0.0,20.0
26537,2,6537,[302 427 197 180 603],383,5,28381,4.3409299479963295,20.0,0.0
26538,2,6538,[302 427 197 180 603],383,5,28386,4.341030738645053,20.0,0.0
26539,2,6539,[302 427 197 180 603],13,5,28391,4.341131498470948,20.0,0.0
26540,2,6540,[182 597 194 196 238],207,2,28393,4.3407735820210975,0.0,0.0
26541,2,6541,[302 427 197 180 603],339,5,28398,4.340874350351575,20.0,0.0
26542,2,6542,[603 186 276  79 195],234,1,28399,4.34036374751643,20.0,0.0
26543,2,6543,[302 427 197 180 603],537,5,28404,4.340464547677262,20.0,0.0
26544,2,6544,[483 496  88  69 151],308,2,28406,4.3401069518716575,20.0,0.0
26545,2,6545,[172 427 176 508 185],474,4,28410,4.340054995417049,0.0,0.0
26546,2,6546,[302 427 197 180 603],537,5,28415,4.3401557965480375,20.0,0.0
26547,2,6547,[302 427 197 180 603],474,5,28420,4.340256566890654,20.0,0.0
26548,2,6548,[200 588 185 204 121],13,3,28423,4.340051916323103,0.0,0.0
26549,2,6549,[302 427 197 180 603],666,5,28428,4.3401526717557255,20.0,0.0
26550,2,6550,[144 211 403 228 200],738,2,28430,4.339795451076172,0.0,0.0
26551,2,6551,[302 427 197 180 603],271,5,28435,4.339896214896215,20.0,0.0
26552,2,6552,[121 175 276 289 179],13,3,28438,4.339691744239279,0.0,0.0
26553,2,6553,[168 405 180 191 194],881,3,28441,4.339487335978029,0.0,0.0
26554,2,6554,[302 427 197 180 603],383,5,28446,4.339588100686499,20.0,0.0
26555,2,6555,[172 132 153  69 173],850,5,28451,4.339688834655278,0.0,0.0
26556,2,6556,[385 181 135  96  89],774,0,28451,4.339026994052158,0.0,0.0
26557,2,6557,[302 427 197 180 603],13,5,28456,4.339127782860628,20.0,0.0
26558,2,6558,[302 427 197 180 603],383,5,28461,4.339228540936118,20.0,0.0
26559,2,6559,[318 301 302 175 385],788,2,28463,4.338871951219512,20.0,0.0
26560,2,6560,[302 427 197 180 603],383,5,28468,4.33897271757354,20.0,0.0
26561,2,6561,[302 427 197 180 603],339,5,28473,4.339073453215483,20.0,0.0
26562,2,6562,[294  15  98 182 289],488,3,28476,4.338869419472802,0.0,20.0
26563,2,6563,[197  88 496  79 210],271,5,28481,4.33897014015844,0.0,0.0
26564,2,6564,[302 427 197 180 603],537,5,28486,4.339070830159939,20.0,0.0
26565,2,6565,[302 427 197 180 603],383,5,28491,4.339171489491319,20.0,0.0
26566,2,6566,[302 427 197 180 603],664,5,28496,4.3392721181665905,20.0,0.0
26567,2,6567,[435 655  70 175 588],537,2,28498,4.338915956151036,0.0,0.0
26568,2,6568,[302 427 197 180 603],664,5,28503,4.3390165930887505,20.0,0.0
26569,2,6569,[302 427 197 180 603],383,5,28508,4.339117199391172,20.0,0.0
26570,2,6570,[ 28  70 121 143  71],194,2,28510,4.338761223558058,0.0,0.0
26571,2,6571,[194 237  64   8 273],234,3,28513,4.338557516737675,0.0,0.0
26572,2,6572,[172 121 357 202 185],308,4,28517,4.338506009432527,20.0,0.0
26573,2,6573,[127 515   8  15  70],474,5,28522,4.338606632187405,0.0,20.0
26574,2,6574,[302 427 197 180 603],383,5,28527,4.338707224334601,20.0,0.0
26575,2,6575,[176 215 174 282 127],881,4,28531,4.338655717761557,0.0,40.0
26576,2,6576,[302 427 197 180 603],339,5,28536,4.33875627185647,20.0,0.0
26577,2,6577,[301 603  12  25 237],666,3,28539,4.33855275159623,40.0,0.0
26578,2,6578,[302 427 197 180 603],383,5,28544,4.3386532907736735,20.0,0.0
26579,2,6579,[  7  22 197 204 176],774,1,28545,4.338145896656535,0.0,0.0
26580,2,6580,[302 427 197 180 603],666,5,28550,4.338246467102264,20.0,0.0
26581,2,6581,[210 742 302 237 204],378,5,28555,4.338347006988757,0.0,0.0
26582,2,6582,[302 427 197 180 603],339,5,28560,4.338447516329941,20.0,0.0
26583,2,6583,[302 427 197 180 603],666,5,28565,4.3385479951397325,20.0,0.0
26584,2,6584,[302 427 197 180 603],90,5,28570,4.338648443432042,20.0,0.0
26585,2,6585,[194  89 161 403 222],749,3,28573,4.3384451867597935,0.0,0.0
26586,2,6586,[655 257 172 181 151],213,5,28578,4.338545620160923,0.0,0.0
26587,2,6587,[195 216 125  15 385],881,4,28582,4.3384942319368545,0.0,0.0
26588,2,6588,[302 427 197 180 603],537,5,28587,4.338594627409319,20.0,0.0
26589,2,6589,[302 427 197 180 603],537,5,28592,4.338694992412747,20.0,0.0
26590,2,6590,[ 69 271 185  70 235],537,2,28594,4.338340160825368,0.0,0.0
26591,2,6591,[302 427 197 180 603],339,5,28599,4.338440533980583,20.0,0.0
26592,2,6592,[302 427 197 180 603],664,5,28604,4.338540876687396,20.0,0.0
26593,2,6593,[357 294  70 179 211],406,3,28607,4.33833788292387,20.0,0.0
26594,2,6594,[ 98 144  56 238 185],650,2,28609,4.337983320697498,0.0,20.0
26595,2,6595,[742 300 100 294 269],488,3,28612,4.3377804730139475,0.0,20.0
26596,2,6596,[257 174 403 546 294],378,3,28615,4.337577686827346,0.0,20.0
26597,2,6597,[302 427 197 180 603],339,5,28620,4.33767808426796,20.0,0.0
26598,2,6598,[302 427 197 180 603],537,5,28625,4.337778451280497,20.0,0.0
26599,2,6599,[302 427 197 180 603],537,5,28630,4.337878787878788,20.0,0.0
26600,2,6600,[302 427 197 180 603],271,5,28635,4.337979094076655,20.0,0.0
26601,2,6601,[302 427 197 180 603],383,5,28640,4.338079369887913,20.0,0.0
26602,2,6602,[302 427 197 180 603],664,5,28645,4.338179615326367,20.0,0.0
26603,2,6603,[269 117 196 328 173],271,3,28648,4.337976983646275,0.0,0.0
26604,2,6604,[161  98 286 655 187],85,4,28652,4.337925813777441,0.0,20.0
26605,2,6605,[357   7 496 172 121],115,3,28655,4.337723281864971,20.0,0.0
26606,2,6606,[302 427 197 180 603],666,5,28660,4.337823520508551,20.0,0.0
26607,2,6607,[496  95 179 118 151],749,3,28663,4.337621065375303,0.0,0.0
26608,2,6608,[302 427 197 180 603],13,5,28668,4.337721289151157,20.0,0.0
26609,2,6609,[302 427 197 180 603],537,5,28673,4.337821482602118,20.0,0.0
26610,2,6610,[302 427 197 180 603],90,5,28678,4.337921645741945,20.0,0.0
26611,2,6611,[302 427 197 180 603],90,5,28683,4.338021778584392,20.0,0.0
26612,2,6612,[302 427 197 180 603],664,5,28688,4.338121881143203,20.0,0.0
26613,2,6613,[302 427 197 180 603],339,5,28693,4.338221953432114,20.0,0.0
26614,2,6614,[302 427 197 180 603],271,5,28698,4.338321995464852,20.0,0.0
26615,2,6615,[302 427 197 180 603],474,5,28703,4.338422007255139,20.0,0.0
26616,2,6616,[302 427 197 180 603],339,5,28708,4.338521988816685,20.0,0.0
26617,2,6617,[302 427 197 180 603],339,5,28713,4.338621940163192,20.0,0.0
26618,2,6618,[302 427 197 180 603],383,5,28718,4.338721861308355,20.0,0.0
26619,2,6619,[294 175 288 268 238],7,3,28721,4.338519637462236,0.0,0.0
26620,2,6620,[302 427 197 180 603],474,5,28726,4.338619543875548,20.0,0.0
26621,2,6621,[302 427 197 180 603],383,5,28731,4.338719420114769,20.0,0.0
26622,2,6622,[258 216 176 403 151],650,2,28733,4.338366299260154,0.0,0.0
26623,2,6623,[216 302 427  12 235],669,3,28736,4.338164251207729,20.0,0.0
26624,2,6624,[ 11 202 322 258 271],537,1,28737,4.337660377358491,0.0,0.0
26625,2,6625,[235 202  70 185  28],82,2,28739,4.337307576214911,0.0,0.0
26626,2,6626,[302 427 197 180 603],90,5,28744,4.337407575071676,20.0,0.0
26627,2,6627,[286 187  70  64  50],213,3,28747,4.337205793602897,0.0,20.0
26628,2,6628,[302 427 197 180 603],474,5,28752,4.337305777643687,20.0,0.0
26629,2,6629,[302 427 197 180 603],339,5,28757,4.337405731523378,20.0,0.0
26630,2,6630,[288 318 405 143  50],374,2,28759,4.337053234806214,20.0,20.0
26631,2,6631,[302 427 197 180 603],537,5,28764,4.337153196622436,20.0,0.0
26632,2,6632,[302 427 197 180 603],664,5,28769,4.337253128297904,20.0,0.0
26633,2,6633,[302 427 197 180 603],666,5,28774,4.337353029846247,20.0,0.0
26634,2,6634,[302 427 197 180 603],666,5,28779,4.337452901281085,20.0,0.0
26635,2,6635,[ 12  71 196 222 202],406,1,28780,4.3369499698613625,20.0,0.0
26636,2,6636,[302 427 197 180 603],664,5,28785,4.3370498719300885,20.0,0.0
26637,2,6637,[302 427 197 180 603],90,5,28790,4.337149743898765,20.0,0.0
26638,2,6638,[180 111 483 210  70],605,2,28792,4.336797710498569,20.0,0.0
26639,2,6639,[117 508 678  64 471],474,2,28794,4.33644578313253,0.0,0.0
26640,2,6640,[302 427 197 180 603],474,5,28799,4.336545700948652,20.0,0.0
26641,2,6641,[302 427 197 180 603],339,5,28804,4.336645588678109,20.0,0.0
26642,2,6642,[302 427 197 180 603],90,5,28809,4.336745446334487,20.0,0.0
26643,2,6643,[302 427 197 180 603],474,5,28814,4.336845273931367,20.0,0.0
26644,2,6644,[302 427 197 180 603],666,5,28819,4.336945071482318,20.0,0.0
26645,2,6645,[245 568 269  96   8],207,2,28821,4.3365934396629555,0.0,0.0
26646,2,6646,[302 427 197 180 603],271,5,28826,4.336693245072965,20.0,0.0
26647,2,6647,[302 427 197 180 603],271,5,28831,4.33679302045728,20.0,0.0
26648,2,6648,[ 69  64 200 182 176],474,4,28835,4.336742367273274,0.0,0.0
26649,2,6649,[302 427 197 180 603],474,5,28840,4.336842105263158,20.0,0.0
26650,2,6650,[568 228 318  79 423],328,3,28843,4.336641106600511,20.0,0.0
26651,2,6651,[302 427 197 180 603],666,5,28848,4.336740829825616,20.0,0.0
26652,2,6652,[194 508  28 197 603],643,5,28853,4.336840523072298,20.0,0.0
26653,2,6653,[294 403 568  22 588],311,5,28858,4.336940186354073,0.0,0.0
26654,2,6654,[175  89 186 300 121],13,4,28862,4.336889556724268,0.0,0.0
26655,2,6655,[204  50  98 515 286],350,5,28867,4.3369891826923075,0.0,40.0
26656,2,6656,[302 427 197 180 603],474,5,28872,4.337088778729157,20.0,0.0
26657,2,6657,[302 427 197 180 603],271,5,28877,4.337188344848303,20.0,0.0
26658,2,6658,[172 135 235 132 483],210,4,28881,4.33713770836462,20.0,0.0
26659,2,6659,[323 271 597 288 328],119,5,28886,4.337237237237237,0.0,0.0
26660,2,6660,[302 427 197 180 603],383,5,28891,4.337336736225792,20.0,0.0
26661,2,6661,[302 427 197 180 603],90,5,28896,4.3374362053437405,20.0,0.0
26662,2,6662,[302 427 197 180 603],537,5,28901,4.337535644604532,20.0,0.0
26663,2,6663,[302 427 197 180 603],90,5,28906,4.337635054021608,20.0,0.0
26664,2,6664,[427 211 423 100  70],537,4,28910,4.337584396099024,0.0,20.0
26665,2,6665,[302 427 197 180 603],537,5,28915,4.337683768376838,20.0,0.0
26666,2,6666,[ 25 197 179 235 132],59,4,28919,4.337633118344082,0.0,0.0
26667,2,6667,[265 238 211 228 216],653,2,28921,4.337282543491302,0.0,0.0
26668,2,6668,[302 427 197 180 603],666,5,28926,4.337381916329285,20.0,0.0
26669,2,6669,[302 427 197 180 603],537,5,28931,4.337481259370315,20.0,0.0
26670,2,6670,[302 427 197 180 603],271,5,28936,4.337580572627792,20.0,0.0
26671,2,6671,[597 357 187 100 174],788,3,28939,4.337380095923262,20.0,40.0
26672,2,6672,[302 427 197 180 603],90,5,28944,4.337479394575154,20.0,0.0
26673,2,6673,[ 12 405 655 174 427],13,4,28948,4.337428828288882,20.0,20.0
26674,2,6674,[302 427 197 180 603],90,5,28953,4.33752808988764,20.0,0.0
26675,2,6675,[302 427 197 180 603],13,5,28958,4.337627321749551,20.0,0.0
26676,2,6676,[153 268  98 111 181],334,4,28962,4.337576756028156,0.0,20.0
26677,2,6677,[302 427 197 180 603],339,5,28967,4.337675950883498,20.0,0.0
26678,2,6678,[  8 238 125  88 405],92,3,28970,4.33747567001048,0.0,0.0
26679,2,6679,[ 12 597 288 333 282],605,4,28974,4.337425149700599,20.0,0.0
26680,2,6680,[302 427 197 180 603],271,5,28979,4.337524322706182,20.0,0.0
26681,2,6681,[302 427 197 180 603],339,5,28984,4.337623466028135,20.0,0.0
26682,2,6682,[234 403 235 135 222],804,3,28987,4.337423312883436,0.0,0.0
26683,2,6683,[302 427 197 180 603],383,5,28992,4.337522441651705,20.0,0.0
26684,2,6684,[302 427 197 180 603],666,5,28997,4.337621540762902,20.0,0.0
26685,2,6685,[302 427 197 180 603],666,5,29002,4.337720610230332,20.0,0.0
26686,2,6686,[269 235 234 328 135],145,5,29007,4.337819650067295,0.0,0.0
26687,2,6687,[275  69 238  64 597],13,2,29009,4.33747009569378,0.0,0.0
26688,2,6688,[ 79 405 237 168 186],313,1,29010,4.336971146658693,0.0,0.0
26689,2,6689,[603 302 186 121 515],339,4,29014,4.336920777279522,20.0,0.0
26690,2,6690,[471 216  95 294 385],234,0,29014,4.33627260499178,0.0,0.0
26691,2,6691,[302 427 197 180 603],339,5,29019,4.336371787208607,20.0,0.0
26692,2,6692,[ 79 238 117  56 168],406,2,29021,4.336022710294337,0.0,0.0
26693,2,6693,[176  98 588 180  64],378,4,29025,4.335972512697938,0.0,20.0
26694,2,6694,[204 357 202 483   1],59,4,29029,4.3359223300970875,40.0,0.0
26695,2,6695,[302 427 197 180 603],474,5,29034,4.336021505376344,20.0,0.0
26696,2,6696,[302 427 197 180 603],537,5,29039,4.3361206510377786,20.0,0.0
26697,2,6697,[302 427 197 180 603],537,5,29044,4.336219767094655,20.0,0.0
26698,2,6698,[302 427 197 180 603],339,5,29049,4.336318853560233,20.0,0.0
26699,2,6699,[302 427 197 180 603],666,5,29054,4.336417910447762,20.0,0.0
26700,2,6700,[302 427 197 180 603],339,5,29059,4.336516937770482,20.0,0.0
26701,2,6701,[302 427 197 180 603],474,5,29064,4.336615935541629,20.0,0.0
26702,2,6702,[302 427 197 180 603],271,5,29069,4.336714903774429,20.0,0.0
26703,2,6703,[515 211  79 294 117],271,3,29072,4.336515513126492,0.0,0.0
26704,2,6704,[302 427 197 180 603],90,5,29077,4.336614466815809,20.0,0.0
26705,2,6705,[302 427 197 180 603],474,5,29082,4.336713390993141,20.0,0.0
26706,2,6706,[ 98 423   4 121 182],271,3,29085,4.33651408975697,0.0,20.0
26707,2,6707,[294 435  50 204   1],537,1,29086,4.3360166964818125,0.0,20.0
26708,2,6708,[515 100 238 135 211],343,5,29091,4.3361156655239235,0.0,20.0
26709,2,6709,[  4 202  22 228 276],883,4,29095,4.336065573770492,0.0,0.0
26710,2,6710,[302 427 197 180 603],474,5,29100,4.336164506034868,20.0,0.0
26711,2,6711,[302 427 197 180 603],339,5,29105,4.336263408820024,20.0,0.0
26712,2,6712,[302 427 197 180 603],537,5,29110,4.336362282139133,20.0,0.0
26713,2,6713,[121 187 153 483 588],298,4,29114,4.33631218349717,20.0,0.0
26714,2,6714,[302 427 197 180 603],664,5,29119,4.3364110201042445,20.0,0.0
26715,2,6715,[135 222 245 286 273],328,2,29121,4.336063132817153,0.0,0.0
26716,2,6716,[125 322 181 168 222],92,4,29125,4.336013101086794,0.0,0.0
26717,2,6717,[302 427 197 180 603],666,5,29130,4.336111938076809,20.0,0.0
26718,2,6718,[ 98 174 144   7 597],92,4,29134,4.336061913975294,0.0,40.0
26719,2,6719,[302 427 197 180 603],664,5,29139,4.336160714285715,20.0,0.0
26720,2,6720,[135 202  64 197 234],749,5,29144,4.336259485195655,0.0,0.0
26721,2,6721,[302 427 197 180 603],664,5,29149,4.336358226718239,20.0,0.0
26722,2,6722,[313  64 748 515 435],91,4,29153,4.336308195745946,0.0,0.0
26723,2,6723,[210 161 748 471 302],454,4,29157,4.336258179654967,0.0,0.0
26724,2,6724,[302 427 197 180 603],90,5,29162,4.3363568773234205,20.0,0.0
26725,2,6725,[302 427 197 180 603],664,5,29167,4.33645554564377,20.0,0.0
26726,2,6726,[333 127 313 186 300],85,2,29169,4.336108220603538,0.0,20.0
26727,2,6727,[302 427 197 180 603],474,5,29174,4.336206896551724,20.0,0.0
26728,2,6728,[302 427 197 180 603],666,5,29179,4.336305543171348,20.0,0.0
26729,2,6729,[302 427 197 180 603],664,5,29184,4.336404160475483,20.0,0.0
26730,2,6730,[302 427 197 180 603],664,5,29189,4.336502748477195,20.0,0.0
26731,2,6731,[333 257  79 132 546],666,2,29191,4.336155674390969,0.0,0.0
26732,2,6732,[302 427 197 180 603],90,5,29196,4.336254270013367,20.0,0.0
26733,2,6733,[238 471 216 111 135],92,3,29199,4.336055836055836,0.0,0.0
26734,2,6734,[302 427 197 180 603],271,5,29204,4.33615441722346,20.0,0.0
26735,2,6735,[385 508 127 186 161],643,3,29207,4.335956057007126,0.0,20.0
26736,2,6736,[118 135 210 151  70],533,3,29210,4.3357577556776015,0.0,0.0
26737,2,6737,[302 427 197 180 603],474,5,29215,4.3358563371920456,20.0,0.0
26738,2,6738,[ 88 269  50 153 200],339,5,29220,4.335954889449473,0.0,20.0
26739,2,6739,[302 427 197 180 603],664,5,29225,4.336053412462908,20.0,0.0
26740,2,6740,[302 427 197 180 603],383,5,29230,4.336151906245364,20.0,0.0
26741,2,6741,[172  71 191 271 121],290,3,29233,4.335953722930881,0.0,0.0
26742,2,6742,[302 427 197 180 603],13,5,29238,4.33605220228385,20.0,0.0
26743,2,6743,[302 427 197 180 603],339,5,29243,4.336150652431791,20.0,0.0
26744,2,6744,[302 427 197 180 603],537,5,29248,4.336249073387695,20.0,0.0
26745,2,6745,[302 427 197 180 603],271,5,29253,4.336347465164542,20.0,0.0
26746,2,6746,[302 427 197 180 603],383,5,29258,4.336445827775307,20.0,0.0
26747,2,6747,[  7 183 181 258  70],537,3,29261,4.336247777119146,0.0,0.0
26748,2,6748,[ 15 496 318 172 288],533,4,29265,4.33619795525263,20.0,0.0
26749,2,6749,[302 427 197 180 603],537,5,29270,4.336296296296296,20.0,0.0
26750,2,6750,[302 427 197 180 603],537,5,29275,4.3363946082061915,20.0,0.0
26751,2,6751,[302 427 197 180 603],474,5,29280,4.3364928909952605,20.0,0.0
26752,2,6752,[302 427 197 180 603],13,5,29285,4.33659114467644,20.0,0.0
26753,2,6753,[302 427 197 180 603],271,5,29290,4.336689369262659,20.0,0.0
26754,2,6754,[302 427 197 180 603],537,5,29295,4.33678756476684,20.0,0.0
26755,2,6755,[302 427 197 180 603],90,5,29300,4.336885731201894,20.0,0.0
26756,2,6756,[200 168 194 135 179],666,4,29304,4.336835873908539,0.0,0.0
26757,2,6757,[302 427 197 180 603],474,5,29309,4.336934004143238,20.0,0.0
26758,2,6758,[302 427 197 180 603],666,5,29314,4.337032105341026,20.0,0.0
26759,2,6759,[302 427 197 180 603],666,5,29319,4.337130177514793,20.0,0.0
26760,2,6760,[ 97  82  96 144 215],295,4,29323,4.337080313563082,0.0,0.0
26761,2,6761,[143 385   7 282 195],374,2,29325,4.336734693877551,0.0,0.0
26762,2,6762,[302 427 197 180 603],537,5,29330,4.336832766523732,20.0,0.0
26763,2,6763,[302 427 197 180 603],383,5,29335,4.336930810171496,20.0,0.0
26764,2,6764,[302 427 197 180 603],666,5,29340,4.337028824833703,20.0,0.0
26765,2,6765,[302 427 197 180 603],383,5,29345,4.337126810523205,20.0,0.0
26766,2,6766,[ 70  98 118 100 186],194,3,29348,4.336929215309591,0.0,40.0
26767,2,6767,[302 427 197 180 603],90,5,29353,4.33702718676123,20.0,0.0
26768,2,6768,[302 427 197 180 603],90,5,29358,4.33712512926577,20.0,0.0
26769,2,6769,[302 427 197 180 603],271,5,29363,4.337223042836041,20.0,0.0
26770,2,6770,[302 427 197 180 603],339,5,29368,4.337320927484862,20.0,0.0
26771,2,6771,[302 427 197 180 603],664,5,29373,4.337418783225044,20.0,0.0
26772,2,6772,[175 742 180 197 357],207,3,29376,4.337221319946848,20.0,0.0
26773,2,6773,[ 95 568 176  15 228],290,4,29380,4.337171538234426,0.0,0.0
26774,2,6774,[302 427 197 180 603],271,5,29385,4.337269372693727,20.0,0.0
26775,2,6775,[302 427 197 180 603],383,5,29390,4.337367178276269,20.0,0.0
26776,2,6776,[313  70 196 204 288],334,3,29393,4.337169839161871,0.0,0.0
26777,2,6777,[302 427 197 180 603],666,5,29398,4.33726763056949,20.0,0.0
26778,2,6778,[302 427 197 180 603],271,5,29403,4.33736539312583,20.0,0.0
26779,2,6779,[ 11 546 237  88 265],145,4,29407,4.337315634218289,0.0,0.0
26780,2,6780,[117 286 405  64 333],13,1,29408,4.336823477363221,0.0,0.0
26781,2,6781,[ 70 235 385 216 173],64,5,29413,4.336921262164553,0.0,0.0
26782,2,6782,[302 427 197 180 603],271,5,29418,4.337019018133569,20.0,0.0
26783,2,6783,[196 435  50 678 143],749,4,29422,4.336969339622642,0.0,20.0
26784,2,6784,[302 427 197 180 603],90,5,29427,4.337067059690494,20.0,0.0
26785,2,6785,[302 427 197 180 603],13,5,29432,4.337164750957855,20.0,0.0
26786,2,6786,[302 427 197 180 603],383,5,29437,4.337262413437454,20.0,0.0
26787,2,6787,[302 427 197 180 603],383,5,29442,4.337360047142015,20.0,0.0
26788,2,6788,[257 318 135 286  25],378,4,29446,4.337310354986006,20.0,0.0
26789,2,6789,[302 427 197 180 603],383,5,29451,4.33740795287187,20.0,0.0
26790,2,6790,[302 427 197 180 603],474,5,29456,4.337505522014431,20.0,0.0
26791,2,6791,[143 121 176 318 237],666,2,29458,4.3371613663133095,20.0,0.0
26792,2,6792,[302 427 197 180 603],666,5,29463,4.337258943029589,20.0,0.0
26793,2,6793,[302 427 197 180 603],13,5,29468,4.33735649102149,20.0,0.0
26794,2,6794,[302 427 197 180 603],339,5,29473,4.337454010301692,20.0,0.0
26795,2,6795,[302 427 197 180 603],90,5,29478,4.3375515008828724,20.0,0.0
26796,2,6796,[286 117 185 603 187],271,3,29481,4.3373547153155805,20.0,0.0
26797,2,6797,[302 427 197 180 603],383,5,29486,4.337452191821124,20.0,0.0
26798,2,6798,[302 427 197 180 603],90,5,29491,4.33754963965289,20.0,0.0
26799,2,6799,[302 427 197 180 603],339,5,29496,4.33764705882353,20.0,0.0
26800,2,6800,[ 79 234 111 603   1],64,4,29500,4.337597412145273,20.0,0.0
26801,2,6801,[302 427 197 180 603],474,5,29505,4.337694795648339,20.0,0.0
26802,2,6802,[302 427 197 180 603],664,5,29510,4.337792150521828,20.0,0.0
26803,2,6803,[302 427 197 180 603],666,5,29515,4.337889476778366,20.0,0.0
26804,2,6804,[302 427 197 180 603],90,5,29520,4.337986774430566,20.0,0.0
26805,2,6805,[127 100 435 603 568],804,3,29523,4.337790185130767,20.0,40.0
26806,2,6806,[302 427 197 180 603],383,5,29528,4.337887468782136,20.0,0.0
26807,2,6807,[222 153 546  82  28],648,5,29533,4.337984723854289,0.0,0.0
26808,2,6808,[302 427 197 180 603],13,5,29538,4.338081950359818,20.0,0.0
26809,2,6809,[302 427 197 180 603],339,5,29543,4.338179148311307,20.0,0.0
26810,2,6810,[144 282 194 597 204],653,2,29545,4.3378358537659665,0.0,0.0
26811,2,6811,[302 427 197 180 603],13,5,29550,4.3379330593071055,20.0,0.0
26812,2,6812,[302 427 197 180 603],339,5,29555,4.338030236312931,20.0,0.0
26813,2,6813,[302 427 197 180 603],474,5,29560,4.3381273847960085,20.0,0.0
26814,2,6814,[302 427 197 180 603],13,5,29565,4.338224504768892,20.0,0.0
26815,2,6815,[168 288  82 100  97],343,4,29569,4.338174882629108,0.0,20.0
26816,2,6816,[302 427 197 180 603],474,5,29574,4.3382719671409715,20.0,0.0
26817,2,6817,[302 427 197 180 603],13,5,29579,4.338369023173951,20.0,0.0
26818,2,6818,[302 427 197 180 603],383,5,29584,4.3384660507405775,20.0,0.0
26819,2,6819,[302 427 197 180 603],383,5,29589,4.338563049853373,20.0,0.0
26820,2,6820,[302 427 197 180 603],383,5,29594,4.338660020524849,20.0,0.0
26821,2,6821,[302 427 197 180 603],474,5,29599,4.338756962767516,20.0,0.0
26822,2,6822,[302 427 197 180 603],90,5,29604,4.338853876593873,20.0,0.0
26823,2,6823,[508 176 153 144 515],643,5,29609,4.338950762016412,0.0,0.0
26824,2,6824,[302 427 197 180 603],339,5,29614,4.339047619047619,20.0,0.0
26825,2,6825,[200 515  89 265  71],234,2,29616,4.338704951655435,0.0,0.0
26826,2,6826,[153 121 471 111 151],95,5,29621,4.338801816317563,0.0,0.0
26827,2,6827,[423 168  64  88 182],339,4,29625,4.338752196836555,0.0,0.0
26828,2,6828,[302 427 197 180 603],664,5,29630,4.338849026211744,20.0,0.0
26829,2,6829,[302 427 197 180 603],339,5,29635,4.338945827232797,20.0,0.0
26830,2,6830,[302 427 197 180 603],474,5,29640,4.339042599912165,20.0,0.0
26831,2,6831,[302 427 197 180 603],666,5,29645,4.339139344262295,20.0,0.0
26832,2,6832,[302 427 197 180 603],271,5,29650,4.339236060295624,20.0,0.0
26833,2,6833,[235 185 172 117   4],648,3,29653,4.3390400936494,0.0,0.0
26834,2,6834,[302 427 197 180 603],666,5,29658,4.339136795903438,20.0,0.0
26835,2,6835,[ 56 182 196 215 174],774,1,29659,4.338648332358104,0.0,20.0
26836,2,6836,[302 427 197 180 603],666,5,29664,4.338745063624397,20.0,0.0
26837,2,6837,[302 427 197 180 603],383,5,29669,4.338841766598421,20.0,0.0
26838,2,6838,[168 597 515  64 210],279,3,29672,4.338646000877321,0.0,0.0
26839,2,6839,[302 427 197 180 603],537,5,29677,4.33874269005848,20.0,0.0
26840,2,6840,[187 191 405  50 174],833,2,29679,4.338400818593773,0.0,40.0
26841,2,6841,[100 237 288 144  98],455,2,29681,4.338059047062263,0.0,40.0
26842,2,6842,[302 427 197 180 603],474,5,29686,4.338155779628818,20.0,0.0
26843,2,6843,[302 427 197 180 603],664,5,29691,4.338252483927528,20.0,0.0
26844,2,6844,[302 427 197 180 603],383,5,29696,4.3383491599707815,20.0,0.0
26845,2,6845,[191 271 111 135 182],833,4,29700,4.338299737072743,0.0,0.0
26846,2,6846,[302 427 197 180 603],664,5,29705,4.338396377975756,20.0,0.0
26847,2,6847,[597 174 121 168 187],533,4,29709,4.338346962616822,0.0,20.0
26848,2,6848,[302 427 197 180 603],13,5,29714,4.338443568404147,20.0,0.0
26849,2,6849,[302 427 197 180 603],90,5,29719,4.338540145985402,20.0,0.0
26850,2,6850,[302 427 197 180 603],339,5,29724,4.338636695372938,20.0,0.0
26851,2,6851,[302 427 197 180 603],13,5,29729,4.338733216579101,20.0,0.0
26852,2,6852,[302 427 197 180 603],383,5,29734,4.338829709616227,20.0,0.0
26853,2,6853,[302 427 197 180 603],383,5,29739,4.3389261744966445,20.0,0.0
26854,2,6854,[302 427 197 180 603],664,5,29744,4.339022611232677,20.0,0.0
26855,2,6855,[302 427 197 180 603],474,5,29749,4.339119019836639,20.0,0.0
26856,2,6856,[302 427 197 180 603],537,5,29754,4.33921540032084,20.0,0.0
26857,2,6857,[302 427 197 180 603],13,5,29759,4.339311752697579,20.0,0.0
26858,2,6858,[302 427 197 180 603],664,5,29764,4.339408076979152,20.0,0.0
26859,2,6859,[302 427 197 180 603],271,5,29769,4.339504373177842,20.0,0.0
26860,2,6860,[ 97  96 185 153 180],326,3,29772,4.339309138609532,0.0,0.0
26861,2,6861,[288 258 508 235  22],92,2,29774,4.338968230836491,0.0,0.0
26862,2,6862,[302 427 197 180 603],271,5,29779,4.339064549031036,20.0,0.0
26863,2,6863,[302 427 197 180 603],13,5,29784,4.339160839160839,20.0,0.0
26864,2,6864,[228 211 323 118 405],648,5,29789,4.339257101238164,0.0,0.0
26865,2,6865,[302 427 197 180 603],90,5,29794,4.33935333527527,20.0,0.0
26866,2,6866,[191  25 357 234  70],474,5,29799,4.339449541284404,20.0,0.0
26867,2,6867,[357 197  11 176 181],643,4,29803,4.339400116482237,20.0,0.0
26868,2,6868,[302 427 197 180 603],339,5,29808,4.339496287669238,20.0,0.0
26869,2,6869,[302 427 197 180 603],664,5,29813,4.339592430858806,20.0,0.0
26870,2,6870,[302 427 197 180 603],13,5,29818,4.339688546063164,20.0,0.0
26871,2,6871,[302 427 197 180 603],339,5,29823,4.339784633294529,20.0,0.0
26872,2,6872,[200  22 135 405 194],6,2,29825,4.339444201949658,0.0,0.0
26873,2,6873,[302 427 197 180 603],537,5,29830,4.33954029677044,20.0,0.0
26874,2,6874,[302 427 197 180 603],537,5,29835,4.339636363636363,20.0,0.0
26875,2,6875,[302 427 197 180 603],271,5,29840,4.339732402559628,20.0,0.0
26876,2,6876,[302 427 197 180 603],13,5,29845,4.339828413552421,20.0,0.0
26877,2,6877,[322 282 475 215 168],92,4,29849,4.3397790055248615,0.0,0.0
26878,2,6878,[302 427 197 180 603],537,5,29854,4.339874981828754,20.0,0.0
26879,2,6879,[302 427 197 180 603],537,5,29859,4.339970930232558,20.0,0.0
26880,2,6880,[302 427 197 180 603],13,5,29864,4.340066850748438,20.0,0.0
26881,2,6881,[302 427 197 180 603],666,5,29869,4.34016274338855,20.0,0.0
26882,2,6882,[  9  25 597 742 471],26,1,29870,4.339677466221125,0.0,0.0
26883,2,6883,[117 180 269 121 318],343,3,29873,4.339482858803022,20.0,0.0
26884,2,6884,[515 187 151 286 143],6,2,29875,4.3391430646332605,0.0,0.0
26885,2,6885,[302 427 197 180 603],664,5,29880,4.339239035724659,20.0,0.0
26886,2,6886,[302 427 197 180 603],271,5,29885,4.33933497894584,20.0,0.0
26887,2,6887,[302 427 197 180 603],664,5,29890,4.3394308943089435,20.0,0.0
26888,2,6888,[546 196 257 183 288],339,4,29894,4.339381622877051,0.0,0.0
26889,2,6889,[302 427 197 180 603],339,5,29899,4.339477503628447,20.0,0.0
26890,2,6890,[302 427 197 180 603],537,5,29904,4.339573356552024,20.0,0.0
26891,2,6891,[302 427 197 180 603],339,5,29909,4.339669181659896,20.0,0.0
26892,2,6892,[125 289 435 678  22],881,2,29911,4.339329754823734,0.0,0.0
26893,2,6893,[135 180 174 200 385],843,2,29913,4.338990426457789,0.0,20.0
26894,2,6894,[302 427 197 180 603],339,5,29918,4.339086294416243,20.0,0.0
26895,2,6895,[161 144 423 603  98],648,4,29922,4.339037122969837,20.0,20.0
26896,2,6896,[302 427 197 180 603],339,5,29927,4.339132956357837,20.0,0.0
26897,2,6897,[302 427 197 180 603],383,5,29932,4.339228761959989,20.0,0.0
26898,2,6898,[234 328 245 172  71],378,3,29935,4.339034642701841,0.0,0.0
26899,2,6899,[302 427 197 180 603],383,5,29940,4.339130434782609,20.0,0.0
26900,2,6900,[328 182 275 471 216],328,2,29942,4.338791479495725,0.0,0.0
26901,2,6901,[ 50 176 357 286 118],648,3,29945,4.3385975079687045,20.0,20.0
26902,2,6902,[265 328 174  95 175],102,3,29948,4.338403592640881,0.0,20.0
26903,2,6903,[196 179 153 273 475],479,3,29951,4.338209733487833,0.0,0.0
26904,2,6904,[302 427 197 180 603],664,5,29956,4.338305575669804,20.0,0.0
26905,2,6905,[483 144 121  79 185],60,5,29961,4.338401390095569,20.0,0.0
26906,2,6906,[302 427 197 180 603],474,5,29966,4.3384971767771825,20.0,0.0
26907,2,6907,[302 427 197 180 603],537,5,29971,4.338592935726694,20.0,0.0
26908,2,6908,[302 427 197 180 603],271,5,29976,4.338688666956144,20.0,0.0
26909,2,6909,[  8  71  11 273 186],92,5,29981,4.338784370477569,0.0,0.0
26910,2,6910,[302 427 197 180 603],537,5,29986,4.338880046302995,20.0,0.0
26911,2,6911,[302 427 197 180 603],339,5,29991,4.338975694444445,20.0,0.0
26912,2,6912,[302 427 197 180 603],666,5,29996,4.33907131491393,20.0,0.0
26913,2,6913,[216 161 143 210 265],188,4,30000,4.339022273647672,0.0,0.0
26914,2,6914,[302 427 197 180 603],339,5,30005,4.339117859725235,20.0,0.0
26915,2,6915,[302 427 197 180 603],537,5,30010,4.339213418160787,20.0,0.0
26916,2,6916,[435 515 183  97 202],64,4,30014,4.339164377620356,0.0,0.0
26917,2,6917,[282 200 546 180  97],653,2,30016,4.338826250361376,0.0,0.0
26918,2,6918,[302 427 197 180 603],664,5,30021,4.338921809510045,20.0,0.0
26919,2,6919,[302 427 197 180 603],339,5,30026,4.339017341040463,20.0,0.0
26920,2,6920,[132 211 234 357 186],85,4,30030,4.338968357173819,20.0,0.0
26921,2,6921,[302 427 197 180 603],13,5,30035,4.339063854377348,20.0,0.0
26922,2,6922,[302 427 197 180 603],271,5,30040,4.339159323992488,20.0,0.0
26923,2,6923,[302 427 197 180 603],474,5,30045,4.339254766031196,20.0,0.0
26924,2,6924,[302 427 197 180 603],474,5,30050,4.3393501805054155,20.0,0.0
26925,2,6925,[302 427 197 180 603],339,5,30055,4.339445567427086,20.0,0.0
26926,2,6926,[302 427 197 180 603],664,5,30060,4.339540926808142,20.0,0.0
26927,2,6927,[302 427 197 180 603],537,5,30065,4.339636258660508,20.0,0.0
26928,2,6928,[179 111 132 175 318],59,5,30070,4.3397315629961035,20.0,0.0
26929,2,6929,[185  22 121  25 742],749,4,30074,4.339682539682539,0.0,0.0
26930,2,6930,[222 132 183 125 423],64,4,30078,4.339633530515077,0.0,0.0
26931,2,6931,[302 427 197 180 603],271,5,30083,4.339728793998846,20.0,0.0
26932,2,6932,[302 427 197 180 603],13,5,30088,4.339824030001442,20.0,0.0
26933,2,6933,[302 427 197 180 603],90,5,30093,4.3399192385347565,20.0,0.0
26934,2,6934,[302 427 197 180 603],383,5,30098,4.340014419610671,20.0,0.0
26935,2,6935,[655  98  97 435 182],194,3,30101,4.33982122260669,0.0,20.0
26936,2,6936,[302 427 197 180 603],13,5,30106,4.339916390370477,20.0,0.0
26937,2,6937,[211 655 174  95 202],406,3,30109,4.3397232631882385,0.0,20.0
26938,2,6938,[187  28 603  22 323],537,2,30111,4.339386078685689,20.0,0.0
26939,2,6939,[302 427 197 180 603],383,5,30116,4.339481268011528,20.0,0.0
26940,2,6940,[302 427 197 180 603],339,5,30121,4.339576429909235,20.0,0.0
26941,2,6941,[302 427 197 180 603],13,5,30126,4.339671564390666,20.0,0.0
26942,2,6942,[302 427 197 180 603],664,5,30131,4.3397666714676655,20.0,0.0
26943,2,6943,[302 427 197 180 603],339,5,30136,4.339861751152074,20.0,0.0
26944,2,6944,[275 403 187 118 179],648,4,30140,4.339812814974802,0.0,0.0
26945,2,6945,[302 427 197 180 603],90,5,30145,4.339907860639217,20.0,0.0
26946,2,6946,[302 427 197 180 603],537,5,30150,4.34000287894055,20.0,0.0
26947,2,6947,[302 427 197 180 603],13,5,30155,4.340097869890616,20.0,0.0
26948,2,6948,[302 427 197 180 603],13,5,30160,4.340192833501223,20.0,0.0
26949,2,6949,[182 294 135 100 204],213,4,30164,4.340143884892086,0.0,20.0
26950,2,6950,[302 427 197 180 603],664,5,30169,4.340238814559056,20.0,0.0
26951,2,6951,[ 95 568 423 196 742],897,2,30171,4.339902186421174,0.0,0.0
26952,2,6952,[179 153  96 173  95],60,4,30175,4.3398533007334965,0.0,0.0
26953,2,6953,[302 427 197 180 603],383,5,30180,4.339948231233822,20.0,0.0
26954,2,6954,[302 427 197 180 603],666,5,30185,4.340043134435658,20.0,0.0
26955,2,6955,[302 427 197 180 603],666,5,30190,4.340138010350777,20.0,0.0
26956,2,6956,[302 427 197 180 603],90,5,30195,4.3402328589909445,20.0,0.0
26957,2,6957,[176 271   1 153  70],536,2,30197,4.339896521989077,0.0,0.0
26958,2,6958,[  8 194   7 197 385],881,3,30200,4.339703980456962,0.0,0.0
26959,2,6959,[ 56 588 202 483 215],308,3,30203,4.339511494252873,20.0,0.0
26960,2,6960,[597  96 258 742   7],200,5,30208,4.339606378393909,0.0,0.0
26961,2,6961,[216 273 496 515 237],666,2,30210,4.3392703246193625,0.0,0.0
26962,2,6962,[302 427 197 180 603],474,5,30215,4.339365216142467,20.0,0.0
26963,2,6963,[302 427 197 180 603],271,5,30220,4.339460080413556,20.0,0.0
26964,2,6964,[302 427 197 180 603],537,5,30225,4.339554917444365,20.0,0.0
26965,2,6965,[302 427 197 180 603],383,5,30230,4.339649727246626,20.0,0.0
26966,2,6966,[194   7 568 234 238],881,2,30232,4.339313908425434,0.0,0.0
26967,2,6967,[302 427 197 180 603],666,5,30237,4.339408725602755,20.0,0.0
26968,2,6968,[276  12 183 288   1],92,4,30241,4.339360022958818,20.0,0.0
26969,2,6969,[ 28  71   1 265 187],313,4,30245,4.339311334289813,0.0,0.0
26970,2,6970,[496 195 471  28  71],308,2,30247,4.338975756706355,0.0,0.0
26971,2,6971,[302 427 197 180 603],537,5,30252,4.339070567986231,20.0,0.0
26972,2,6972,[302 427 197 180 603],383,5,30257,4.339165352072278,20.0,0.0
26973,2,6973,[471 235  70 222 151],378,2,30259,4.338829939776312,0.0,0.0
26974,2,6974,[302 427 197 180 603],90,5,30264,4.338924731182796,20.0,0.0
26975,2,6975,[302 427 197 180 603],474,5,30269,4.339019495412844,20.0,0.0
26976,2,6976,[302 427 197 180 603],383,5,30274,4.339114232478143,20.0,0.0
26977,2,6977,[302 427 197 180 603],474,5,30279,4.3392089423903695,20.0,0.0
26978,2,6978,[181 132 546 100 216],92,2,30281,4.338873764149592,0.0,20.0
26979,2,6979,[302 427 197 180 603],474,5,30286,4.338968481375358,20.0,0.0
26980,2,6980,[302 427 197 180 603],383,5,30291,4.339063171465406,20.0,0.0
26981,2,6981,[568 121  96 385   1],454,3,30294,4.33887138355772,0.0,0.0
26982,2,6982,[302 427 197 180 603],666,5,30299,4.338966060432479,20.0,0.0
26983,2,6983,[302 427 197 180 603],664,5,30304,4.3390607101947305,20.0,0.0
26984,2,6984,[302 427 197 180 603],339,5,30309,4.33915533285612,20.0,0.0
26985,2,6985,[302 427 197 180 603],664,5,30314,4.339249928428285,20.0,0.0
26986,2,6986,[302 427 197 180 603],339,5,30319,4.339344496922857,20.0,0.0
26987,2,6987,[302 427 197 180 603],664,5,30324,4.339439038351459,20.0,0.0
26988,2,6988,[742   7 215  88  64],653,1,30325,4.3389612247818,0.0,0.0
26989,2,6989,[302 427 197 180 603],339,5,30330,4.339055793991417,20.0,0.0
26990,2,6990,[185 127 427 235 257],385,4,30334,4.339007295093692,0.0,20.0
26991,2,6991,[302 427 197 180 603],537,5,30339,4.3391018306636155,20.0,0.0
26992,2,6992,[175 197 204  70  69],527,4,30343,4.339053339053339,0.0,0.0
26993,2,6993,[234  28 100 211 597],447,4,30347,4.339004861309694,0.0,20.0
26994,2,6994,[302 427 197 180 603],537,5,30352,4.339099356683345,20.0,0.0
26995,2,6995,[238 276 211 471 135],308,4,30356,4.339050886220697,0.0,0.0
26996,2,6996,[302 427 197 180 603],339,5,30361,4.339145348006288,20.0,0.0
26997,2,6997,[197 211 175 403 515],64,4,30365,4.339096884824236,0.0,0.0
26998,2,6998,[302 427 197 180 603],383,5,30370,4.33919131304472,20.0,0.0
26999,2,6999,[302 427 197 180 603],13,5,30375,4.339285714285714,20.0,0.0
27000,2,7000,[302 427 197 180 603],537,5,30380,4.339380088558777,20.0,0.0
27001,2,7001,[302 427 197 180 603],664,5,30385,4.339474435875464,20.0,0.0
27002,2,7002,[202 471 282 151 385],666,2,30387,4.3391403684135375,0.0,0.0
27003,2,7003,[302 427 197 180 603],339,5,30392,4.339234723015419,20.0,0.0
27004,2,7004,[302 427 197 180 603],90,5,30397,4.339329050678087,20.0,0.0
27005,2,7005,[302 427 197 180 603],13,5,30402,4.339423351413075,20.0,0.0
27006,2,7006,[302 427 197 180 603],666,5,30407,4.3395176252319105,20.0,0.0
27007,2,7007,[302 427 197 180 603],383,5,30412,4.3396118721461185,20.0,0.0
27008,2,7008,[302 427 197 180 603],474,5,30417,4.339706092167214,20.0,0.0
27009,2,7009,[302 427 197 180 603],13,5,30422,4.339800285306705,20.0,0.0
27010,2,7010,[234   4 176 282 546],378,3,30425,4.33960918556554,0.0,0.0
27011,2,7011,[302 427 197 180 603],383,5,30430,4.33970336565887,20.0,0.0
27012,2,7012,[172   4 405 423  96],934,4,30434,4.33965492656495,0.0,0.0
27013,2,7013,[302 427 197 180 603],339,5,30439,4.339749073282007,20.0,0.0
27014,2,7014,[175 405 179 435 151],378,2,30441,4.339415538132573,0.0,0.0
27015,2,7015,[ 88 143 357 121 117],648,3,30444,4.339224629418472,20.0,0.0
27016,2,7016,[515 357  25 286  15],360,4,30448,4.339176286162178,20.0,0.0
27017,2,7017,[  7 435 423 235 294],650,2,30450,4.338842975206612,0.0,0.0
27018,2,7018,[385 195  79 204 144],158,4,30454,4.338794700099729,0.0,0.0
27019,2,7019,[313 748 405 215 265],474,4,30458,4.338746438746439,0.0,0.0
27020,2,7020,[405 179 174 588 282],85,2,30460,4.3384133314342685,0.0,20.0
27021,2,7021,[568 144 185  97 323],328,2,30462,4.338080318997437,0.0,0.0
27022,2,7022,[181 197  89 168 234],833,2,30464,4.337747401395415,0.0,0.0
27023,2,7023,[302 427 197 180 603],474,5,30469,4.337841685649202,20.0,0.0
27024,2,7024,[302 427 197 180 603],666,5,30474,4.337935943060498,20.0,0.0
27025,2,7025,[302 427 197 180 603],13,5,30479,4.338030173640763,20.0,0.0
27026,2,7026,[302 427 197 180 603],474,5,30484,4.338124377401452,20.0,0.0
27027,2,7027,[302 427 197 180 603],537,5,30489,4.338218554354013,20.0,0.0
27028,2,7028,[302 427 197 180 603],664,5,30494,4.338312704509888,20.0,0.0
27029,2,7029,[ 56 288 200 435  22],378,3,30497,4.338122332859175,0.0,0.0
27030,2,7030,[302 427 197 180 603],474,5,30502,4.3382164699189305,20.0,0.0
27031,2,7031,[302 427 197 180 603],90,5,30507,4.338310580204778,20.0,0.0
27032,2,7032,[  1 195 655 183 174],749,5,30512,4.338404663728139,0.0,20.0
27033,2,7033,[ 88 194 210 186  97],774,0,30512,4.337787887404038,0.0,0.0
27034,2,7034,[302 427 197 180 603],666,5,30517,4.337882018479033,20.0,0.0
27035,2,7035,[302 427 197 180 603],474,5,30522,4.337976122797044,20.0,0.0
27036,2,7036,[515 546 186 234  15],308,1,30523,4.337501776325139,0.0,0.0
27037,2,7037,[210  98 181 215 234],42,5,30528,4.337595907928389,0.0,20.0
27038,2,7038,[302 427 197 180 603],666,5,30533,4.337690012785907,20.0,0.0
27039,2,7039,[302 427 197 180 603],13,5,30538,4.337784090909091,20.0,0.0
27040,2,7040,[302 427 197 180 603],13,5,30543,4.337878142309331,20.0,0.0
27041,2,7041,[328 294  70 235 269],119,2,30545,4.33754615166146,0.0,0.0
27042,2,7042,[302 427 197 180 603],474,5,30550,4.337640210137725,20.0,0.0
27043,2,7043,[ 96 237   9  97  12],59,4,30554,4.3375922771152755,20.0,0.0
27044,2,7044,[302 427 197 180 603],537,5,30559,4.337686302342086,20.0,0.0
27045,2,7045,[176  79 215 143 121],536,4,30563,4.337638376383764,0.0,0.0
27046,2,7046,[302 427 197 180 603],339,5,30568,4.337732368383709,20.0,0.0
27047,2,7047,[302 427 197 180 603],664,5,30573,4.337826333711691,20.0,0.0
27048,2,7048,[302 427 197 180 603],271,5,30578,4.337920272379061,20.0,0.0
27049,2,7049,[302 427 197 180 603],339,5,30583,4.338014184397163,20.0,0.0
27050,2,7050,[302 427 197 180 603],271,5,30588,4.338108069777337,20.0,0.0
27051,2,7051,[302 427 197 180 603],537,5,30593,4.338201928530913,20.0,0.0
27052,2,7052,[302 427 197 180 603],537,5,30598,4.338295760669219,20.0,0.0
27053,2,7053,[215 161  71 318 328],234,1,30599,4.3378225120499,20.0,0.0
27054,2,7054,[302 427 197 180 603],537,5,30604,4.337916371367824,20.0,0.0
27055,2,7055,[ 22 546 403 357 197],95,3,30607,4.337726757369614,20.0,0.0
27056,2,7056,[302 427 197 180 603],474,5,30612,4.337820603655945,20.0,0.0
27057,2,7057,[200 302  12 135  50],328,4,30616,4.337772740153018,20.0,20.0
27058,2,7058,[302 427 197 180 603],537,5,30621,4.337866553336166,20.0,0.0
27059,2,7059,[302 427 197 180 603],271,5,30626,4.337960339943343,20.0,0.0
27060,2,7060,[302 427 197 180 603],537,5,30631,4.338054099985838,20.0,0.0
27061,2,7061,[471  79  50 173 258],815,4,30635,4.338006230529595,0.0,20.0
27062,2,7062,[302 427 197 180 603],90,5,30640,4.338099957525131,20.0,0.0
27063,2,7063,[302 427 197 180 603],13,5,30645,4.338193657984145,20.0,0.0
27064,2,7064,[237 483 269 471 111],537,1,30646,4.337721160651097,20.0,0.0
27065,2,7065,[302 427 197 180 603],271,5,30651,4.337814888196999,20.0,0.0
27066,2,7066,[302 427 197 180 603],664,5,30656,4.33790858921749,20.0,0.0
27067,2,7067,[  8 176  95 168 191],766,3,30659,4.337719298245614,0.0,0.0
27068,2,7068,[302 427 197 180 603],13,5,30664,4.337812986278116,20.0,0.0
27069,2,7069,[302 427 197 180 603],383,5,30669,4.337906647807638,20.0,0.0
27070,2,7070,[ 89 200 135  95 222],881,4,30673,4.337858860132937,0.0,0.0
27071,2,7071,[302 427 197 180 603],537,5,30678,4.337952488687783,20.0,0.0
27072,2,7072,[302 427 197 180 603],666,5,30683,4.338046090767708,20.0,0.0
27073,2,7073,[302 427 197 180 603],383,5,30688,4.338139666383941,20.0,0.0
27074,2,7074,[302 427 197 180 603],664,5,30693,4.338233215547703,20.0,0.0
27075,2,7075,[216 195 405 117 222],374,4,30697,4.338185415488977,0.0,0.0
27076,2,7076,[302 427 197 180 603],537,5,30702,4.338278931750742,20.0,0.0
27077,2,7077,[385 235 168 127 597],643,3,30705,4.338089855891495,0.0,20.0
27078,2,7078,[302 427 197 180 603],537,5,30710,4.33818335923153,20.0,0.0
27079,2,7079,[ 97 313 322 182 117],474,5,30715,4.338276836158192,0.0,0.0
27080,2,7080,[302 427 197 180 603],383,5,30720,4.338370286682672,20.0,0.0
27081,2,7081,[302 427 197 180 603],13,5,30725,4.3384637108161535,20.0,0.0
27082,2,7082,[302 427 197 180 603],271,5,30730,4.338557108569815,20.0,0.0
27083,2,7083,[179 546  50  22  82],92,2,30732,4.338226990400903,0.0,20.0
27084,2,7084,[302 427 197 180 603],383,5,30737,4.338320395201129,20.0,0.0
27085,2,7085,[ 50 265 258 385 496],7,5,30742,4.33841377363816,0.0,20.0
27086,2,7086,[216 117 196 508 180],207,3,30745,4.338224918865529,0.0,0.0
27087,2,7087,[423 175 204 196  98],232,5,30750,4.338318284424379,0.0,20.0
27088,2,7088,[238   1 204  64 313],92,5,30755,4.338411623642263,0.0,0.0
27089,2,7089,[302 427 197 180 603],664,5,30760,4.338504936530325,20.0,0.0
27090,2,7090,[302 427 197 180 603],339,5,30765,4.338598223099704,20.0,0.0
27091,2,7091,[302 427 197 180 603],90,5,30770,4.338691483361534,20.0,0.0
27092,2,7092,[302 427 197 180 603],474,5,30775,4.338784717326942,20.0,0.0
27093,2,7093,[302 427 197 180 603],666,5,30780,4.338877925007048,20.0,0.0
27094,2,7094,[302 427 197 180 603],666,5,30785,4.338971106412967,20.0,0.0
27095,2,7095,[216 423 204 276 483],374,3,30788,4.338782412626832,20.0,0.0
27096,2,7096,[302 427 197 180 603],90,5,30793,4.338875581231506,20.0,0.0
27097,2,7097,[302 427 197 180 603],383,5,30798,4.338968723584109,20.0,0.0
27098,2,7098,[302 427 197 180 603],474,5,30803,4.339061839695732,20.0,0.0
27099,2,7099,[483 357 588 475 323],537,3,30806,4.338873239436619,40.0,0.0
27100,2,7100,[302 427 197 180 603],13,5,30811,4.338966342768624,20.0,0.0
27101,2,7101,[302 427 197 180 603],537,5,30816,4.339059419881724,20.0,0.0
27102,2,7102,[302 427 197 180 603],383,5,30821,4.339152470786991,20.0,0.0
27103,2,7103,[143  96   1  82 175],843,1,30822,4.3386824324324325,0.0,0.0
27104,2,7104,[302 427 197 180 603],666,5,30827,4.338775510204082,20.0,0.0
27105,2,7105,[194 151 202 258 143],6,1,30828,4.338305657191106,0.0,0.0
27106,2,7106,[302 427 197 180 603],271,5,30833,4.338398761784156,20.0,0.0
27107,2,7107,[125 323 258 322 151],788,2,30835,4.338069780528982,0.0,0.0
27108,2,7108,[222   1 237 143 515],343,5,30840,4.338162892108595,0.0,0.0
27109,2,7109,[282  96 210 245  22],378,4,30844,4.338115330520393,0.0,0.0
27110,2,7110,[302 427 197 180 603],666,5,30849,4.338208409506398,20.0,0.0
27111,2,7111,[302 427 197 180 603],537,5,30854,4.338301462317211,20.0,0.0
27112,2,7112,[302 427 197 180 603],664,5,30859,4.338394488963869,20.0,0.0
27113,2,7113,[302 427 197 180 603],339,5,30864,4.338487489457408,20.0,0.0
27114,2,7114,[496 173  89 273 127],897,3,30867,4.33829936753338,0.0,20.0
27115,2,7115,[302 427 197 180 603],474,5,30872,4.3383923552557615,20.0,0.0
27116,2,7116,[302 427 197 180 603],13,5,30877,4.338485316846986,20.0,0.0
27117,2,7117,[302 427 197 180 603],90,5,30882,4.338578252318067,20.0,0.0
27118,2,7118,[302 427 197 180 603],90,5,30887,4.338671161680011,20.0,0.0
27119,2,7119,[302 427 197 180 603],537,5,30892,4.3387640449438205,20.0,0.0
27120,2,7120,[302 313 196  12 215],271,5,30897,4.338856902120488,20.0,0.0
27121,2,7121,[302 427 197 180 603],537,5,30902,4.338949733221005,20.0,0.0
27122,2,7122,[302 427 197 180 603],664,5,30907,4.339042538256352,20.0,0.0
27123,2,7123,[302 427 197 180 603],271,5,30912,4.339135317237507,20.0,0.0
27124,2,7124,[118 143 276 125 471],374,4,30916,4.339087719298246,0.0,0.0
27125,2,7125,[302 427 197 180 603],537,5,30921,4.339180465899523,20.0,0.0
27126,2,7126,[302 427 197 180 603],664,5,30926,4.339273186473973,20.0,0.0
27127,2,7127,[302 427 197 180 603],537,5,30931,4.339365881032547,20.0,0.0
27128,2,7128,[ 56 238 323 265  15],650,2,30933,4.339037733202413,0.0,0.0
27129,2,7129,[216 286  50 483 194],328,3,30936,4.338849929873772,20.0,20.0
27130,2,7130,[187 294   4 196 132],881,1,30937,4.33838171364465,0.0,0.0
27131,2,7131,[186  79 748 175 655],313,3,30940,4.3381940549635445,0.0,0.0
27132,2,7132,[302 427 197 180 603],339,5,30945,4.3382868358334505,20.0,0.0
27133,2,7133,[180 186 483 742  88],207,3,30948,4.3380992430613965,20.0,0.0
27134,2,7134,[568 204 186  56 237],374,5,30953,4.3381920112123336,0.0,0.0
27135,2,7135,[  4 180 121 273 111],87,4,30957,4.338144618834081,0.0,0.0
27136,2,7136,[302 427 197 180 603],271,5,30962,4.338237354630797,20.0,0.0
27137,2,7137,[302 427 197 180 603],537,5,30967,4.338330064443822,20.0,0.0
27138,2,7138,[302 427 197 180 603],666,5,30972,4.338422748284073,20.0,0.0
27139,2,7139,[ 79  22   9 318 174],200,5,30977,4.338515406162465,20.0,20.0
27140,2,7140,[302 427 197 180 603],339,5,30982,4.3386080380899035,20.0,0.0
27141,2,7141,[302 427 197 180 603],13,5,30987,4.3387006440772895,20.0,0.0
27142,2,7142,[302 427 197 180 603],664,5,30992,4.338793224135517,20.0,0.0
27143,2,7143,[423 235 204 210 276],92,3,30995,4.338605823068309,0.0,0.0
27144,2,7144,[302 427 197 180 603],474,5,31000,4.338698390482855,20.0,0.0
27145,2,7145,[282 546 216 168 237],42,3,31003,4.33851105513574,0.0,0.0
27146,2,7146,[302 427 197 180 603],90,5,31008,4.338603609906254,20.0,0.0
27147,2,7147,[302 427 197 180 603],664,5,31013,4.338696138780079,20.0,0.0
27148,2,7148,[471  15   7 100 294],552,2,31015,4.338369002657714,0.0,20.0
27149,2,7149,[302 427 197 180 603],90,5,31020,4.338461538461538,20.0,0.0
27150,2,7150,[175 180 200 215 187],804,4,31024,4.338414207803105,0.0,0.0
27151,2,7151,[302 427 197 180 603],383,5,31029,4.338506711409396,20.0,0.0
27152,2,7152,[302 427 197 180 603],383,5,31034,4.338599189151405,20.0,0.0
27153,2,7153,[302 427 197 180 603],537,5,31039,4.338691641039977,20.0,0.0
27154,2,7154,[405  64  71 235 471],524,1,31040,4.3382250174703,0.0,0.0
27155,2,7155,[302 427 197 180 603],537,5,31045,4.338317495807714,20.0,0.0
27156,2,7156,[ 88 496 678 228 197],454,3,31048,4.338130501606819,0.0,0.0
27157,2,7157,[210 318 313 435   7],308,4,31052,4.338083263481419,20.0,0.0
27158,2,7158,[302 427 197 180 603],271,5,31057,4.338175722866322,20.0,0.0
27159,2,7159,[302 427 197 180 603],474,5,31062,4.338268156424581,20.0,0.0
27160,2,7160,[302 427 197 180 603],90,5,31067,4.338360564167016,20.0,0.0
27161,2,7161,[302 427 197 180 603],664,5,31072,4.33845294610444,20.0,0.0
27162,2,7162,[302 427 197 180 603],383,5,31077,4.338545302247661,20.0,0.0
27163,2,7163,[302 427 197 180 603],537,5,31082,4.338637632607482,20.0,0.0
27164,2,7164,[302 427 197 180 603],537,5,31087,4.338729937194697,20.0,0.0
27165,2,7165,[302 427 197 180 603],90,5,31092,4.338822216020095,20.0,0.0
27166,2,7166,[302 427 197 180 603],13,5,31097,4.338914469094461,20.0,0.0
27167,2,7167,[385  98 168 655 427],379,4,31101,4.3388671875,0.0,20.0
27168,2,7168,[302 427 197 180 603],666,5,31106,4.338959408564653,20.0,0.0
27169,2,7169,[302 427 197 180 603],383,5,31111,4.33905160390516,20.0,0.0
27170,2,7170,[403 191 588 427 357],308,5,31116,4.339143773532283,20.0,0.0
27171,2,7171,[302 427 197 180 603],664,5,31121,4.339235917456777,20.0,0.0
27172,2,7172,[302 427 197 180 603],474,5,31126,4.339328035689391,20.0,0.0
27173,2,7173,[302 427 197 180 603],664,5,31131,4.33942012824087,20.0,0.0
27174,2,7174,[302 427 197 180 603],339,5,31136,4.3395121951219515,20.0,0.0
27175,2,7175,[ 22  89 191   4  71],378,4,31140,4.339464882943144,0.0,0.0
27176,2,7176,[176 183 215 173 197],766,2,31142,4.339138915981608,0.0,0.0
27177,2,7177,[302 427 197 180 603],474,5,31147,4.33923098356088,20.0,0.0
27178,2,7178,[302 427 197 180 603],666,5,31152,4.339323025491016,20.0,0.0
27179,2,7179,[302 427 197 180 603],664,5,31157,4.33941504178273,20.0,0.0
27180,2,7180,[302 427 197 180 603],664,5,31162,4.339507032446734,20.0,0.0
27181,2,7181,[423 211  25   7 228],95,3,31165,4.3393205235310495,0.0,0.0
27182,2,7182,[302 427 197 180 603],13,5,31170,4.33941250174022,20.0,0.0
27183,2,7183,[302 427 197 180 603],666,5,31175,4.339504454342984,20.0,0.0
27184,2,7184,[302 427 197 180 603],666,5,31180,4.3395963813500344,20.0,0.0
27185,2,7185,[302 427 197 180 603],664,5,31185,4.339688282772057,20.0,0.0
27186,2,7186,[302 427 197 180 603],474,5,31190,4.33978015861973,20.0,0.0
27187,2,7187,[288 294  95 385  97],804,3,31193,4.339593767390094,0.0,0.0
27188,2,7188,[302 427 197 180 603],90,5,31198,4.339685630824872,20.0,0.0
27189,2,7189,[ 97  15   1 204 174],406,5,31203,4.3397774687065365,0.0,20.0
27190,2,7190,[302 427 197 180 603],13,5,31208,4.339869281045751,20.0,0.0
27191,2,7191,[302 427 197 180 603],664,5,31213,4.33996106785317,20.0,0.0
27192,2,7192,[173 508 125  12 234],455,3,31216,4.33977478103712,20.0,0.0
27193,2,7193,[302 427 197 180 603],474,5,31221,4.339866555462886,20.0,0.0
27194,2,7194,[302 427 197 180 603],537,5,31226,4.33995830437804,20.0,0.0
27195,2,7195,[302 427 197 180 603],13,5,31231,4.340050027793218,20.0,0.0
27196,2,7196,[302 427 197 180 603],537,5,31236,4.340141725719049,20.0,0.0
27197,2,7197,[302 427 197 180 603],13,5,31241,4.340233398166157,20.0,0.0
27198,2,7198,[235 423 475 286 288],13,1,31242,4.339769412418391,0.0,0.0
27199,2,7199,[302 427 197 180 603],339,5,31247,4.339861111111111,20.0,0.0
27200,2,7200,[197 282  50 515 204],334,5,31252,4.339952784335509,0.0,20.0
27201,2,7201,[302 427 197 180 603],474,5,31257,4.340044432102194,20.0,0.0
27202,2,7202,[302 427 197 180 603],13,5,31262,4.340136054421769,20.0,0.0
27203,2,7203,[302 427 197 180 603],537,5,31267,4.340227651304831,20.0,0.0
27204,2,7204,[302 427 197 180 603],474,5,31272,4.340319222761971,20.0,0.0
27205,2,7205,[302 427 197 180 603],383,5,31277,4.340410768803775,20.0,0.0
27206,2,7206,[302 427 197 180 603],474,5,31282,4.340502289440821,20.0,0.0
27207,2,7207,[302 427 197 180 603],474,5,31287,4.340593784683684,20.0,0.0
27208,2,7208,[328 127   9 210 655],749,4,31291,4.340546539048412,0.0,20.0
27209,2,7209,[403 211 125   1 483],59,3,31294,4.340360610263523,20.0,0.0
27210,2,7210,[  9 597 202 318   4],308,4,31298,4.340313410067952,20.0,0.0
27211,2,7211,[302 427 197 180 603],537,5,31303,4.340404880754298,20.0,0.0
27212,2,7212,[302 427 197 180 603],90,5,31308,4.340496326077915,20.0,0.0
27213,2,7213,[265  89  98 423 172],326,4,31312,4.340449126698087,0.0,20.0
27214,2,7214,[302 427 197 180 603],13,5,31317,4.34054054054054,20.0,0.0
27215,2,7215,[143  71 597 172 195],59,2,31319,4.340216186252771,0.0,0.0
27216,2,7216,[302 427 197 180 603],666,5,31324,4.340307607038936,20.0,0.0
27217,2,7217,[  9 496 748  88 300],749,3,31327,4.34012191742865,0.0,0.0
27218,2,7218,[143 195  71   8   9],298,5,31332,4.340213325945422,0.0,0.0
27219,2,7219,[302 427 197 180 603],13,5,31337,4.340304709141274,20.0,0.0
27220,2,7220,[302 427 197 180 603],664,5,31342,4.340396067026727,20.0,0.0
27221,2,7221,[302 427 197 180 603],90,5,31347,4.340487399612296,20.0,0.0
27222,2,7222,[302 427 197 180 603],90,5,31352,4.340578706908487,20.0,0.0
27223,2,7223,[302 427 197 180 603],13,5,31357,4.340669988925803,20.0,0.0
27224,2,7224,[302 427 197 180 603],90,5,31362,4.340761245674741,20.0,0.0
27225,2,7225,[302 427 197 180 603],13,5,31367,4.34085247716579,20.0,0.0
27226,2,7226,[143 238  95 222 194],749,2,31369,4.340528573405286,0.0,0.0
27227,2,7227,[ 22 508 300 153 268],13,3,31372,4.340343110127283,0.0,0.0
27228,2,7228,[273 185 403  70 179],479,3,31375,4.340157698160188,0.0,0.0
27229,2,7229,[302 427 197 180 603],474,5,31380,4.340248962655601,20.0,0.0
27230,2,7230,[302 427 197 180 603],383,5,31385,4.340340201908449,20.0,0.0
27231,2,7231,[302 427 197 180 603],383,5,31390,4.340431415929204,20.0,0.0
27232,2,7232,[302 427 197 180 603],666,5,31395,4.340522604728329,20.0,0.0
27233,2,7233,[216 175  82 173 100],892,4,31399,4.340475532209013,0.0,20.0
27234,2,7234,[302 427 197 180 603],537,5,31404,4.340566689702833,20.0,0.0
27235,2,7235,[302 427 197 180 603],13,5,31409,4.340657822001106,20.0,0.0
27236,2,7236,[234 588 196  25 235],308,2,31411,4.340334392704159,0.0,0.0
27237,2,7237,[302 427 197 180 603],339,5,31416,4.340425531914893,20.0,0.0
27238,2,7238,[302 427 197 180 603],271,5,31421,4.340516645945573,20.0,0.0
27239,2,7239,[215 118 127 151 515],804,3,31424,4.340331491712707,0.0,20.0
27240,2,7240,[ 25 100 194 228  70],579,3,31427,4.340146388620356,0.0,20.0
27241,2,7241,[  1   9  89  22 597],200,5,31432,4.3402375034520855,0.0,0.0
27242,2,7242,[302 427 197 180 603],537,5,31437,4.340328593124396,20.0,0.0
27243,2,7243,[302 427 197 180 603],271,5,31442,4.3404196576477085,20.0,0.0
27244,2,7244,[273 655 183 121 202],59,4,31446,4.3403726708074535,0.0,0.0
27245,2,7245,[302 427 197 180 603],664,5,31451,4.340463704112614,20.0,0.0
27246,2,7246,[ 98 202  70  96  25],374,4,31455,4.340416724161722,0.0,20.0
27247,2,7247,[302 427 197 180 603],90,5,31460,4.3405077262693155,20.0,0.0
27248,2,7248,[302 427 197 180 603],537,5,31465,4.340598703269417,20.0,0.0
27249,2,7249,[100 174  15   1  56],145,3,31468,4.3404137931034485,0.0,40.0
27250,2,7250,[302 427 197 180 603],664,5,31473,4.3405047579644185,20.0,0.0
27251,2,7251,[ 50   4 200 273  12],59,4,31477,4.340457804743519,20.0,20.0
27252,2,7252,[302 427 197 180 603],339,5,31482,4.340548738453054,20.0,0.0
27253,2,7253,[302 427 197 180 603],666,5,31487,4.34063964709126,20.0,0.0
27254,2,7254,[294 483 546 179 168],13,2,31489,4.340317022742936,20.0,0.0
27255,2,7255,[302 427 197 180 603],537,5,31494,4.340407938257993,20.0,0.0
27256,2,7256,[302 427 197 180 603],13,5,31499,4.3404988287171005,20.0,0.0
27257,2,7257,[302 427 197 180 603],664,5,31504,4.340589694130615,20.0,0.0
27258,2,7258,[302 427 197 180 603],474,5,31509,4.340680534508886,20.0,0.0
27259,2,7259,[588 180 323 423 603],804,4,31513,4.340633608815427,20.0,0.0
27260,2,7260,[302 427 197 180 603],339,5,31518,4.340724418124226,20.0,0.0
27261,2,7261,[302 427 197 180 603],666,5,31523,4.340815202423575,20.0,0.0
27262,2,7262,[302 427 197 180 603],537,5,31528,4.340905961723806,20.0,0.0
27263,2,7263,[302 427 197 180 603],339,5,31533,4.340996696035242,20.0,0.0
27264,2,7264,[302 427 197 180 603],383,5,31538,4.341087405368204,20.0,0.0
27265,2,7265,[ 11   1 597  22 257],378,3,31541,4.340902835122488,0.0,0.0
27266,2,7266,[302 427 197 180 603],474,5,31546,4.34099353240677,20.0,0.0
27267,2,7267,[302 427 197 180 603],13,5,31551,4.341084204733076,20.0,0.0
27268,2,7268,[302 427 197 180 603],271,5,31556,4.341174852111707,20.0,0.0
27269,2,7269,[302 427 197 180 603],383,5,31561,4.341265474552958,20.0,0.0
27270,2,7270,[655 276 238 273  71],378,4,31565,4.341218539403108,0.0,0.0
27271,2,7271,[302 427 197 180 603],664,5,31570,4.341309130913091,20.0,0.0
27272,2,7272,[302 427 197 180 603],13,5,31575,4.341399697511343,20.0,0.0
27273,2,7273,[ 69 121 222 176 435],406,4,31579,4.341352763266428,0.0,0.0
27274,2,7274,[302 427 197 180 603],90,5,31584,4.3414432989690726,20.0,0.0
27275,2,7275,[ 50 194  89 168 228],881,1,31585,4.340984057174271,0.0,20.0
27276,2,7276,[302 427 197 180 603],666,5,31590,4.341074618661536,20.0,0.0
27277,2,7277,[289 211   9 143 186],85,3,31593,4.340890354492992,0.0,0.0
27278,2,7278,[302 427 197 180 603],664,5,31598,4.340980903970325,20.0,0.0
27279,2,7279,[302 427 197 180 603],666,5,31603,4.3410714285714285,20.0,0.0
27280,2,7280,[ 98 127 357 655 135],308,4,31607,4.341024584535091,20.0,40.0
27281,2,7281,[ 69  98   1  11 313],145,4,31611,4.34097775336446,0.0,20.0
27282,2,7282,[302 427 197 180 603],537,5,31616,4.341068241109433,20.0,0.0
27283,2,7283,[302 427 197 180 603],664,5,31621,4.3411587040087865,20.0,0.0
27284,2,7284,[302 427 197 180 603],666,5,31626,4.341249142072752,20.0,0.0
27285,2,7285,[302 427 197 180 603],13,5,31631,4.341339555311556,20.0,0.0
27286,2,7286,[302 427 197 180 603],271,5,31636,4.341429943735419,20.0,0.0
27287,2,7287,[302 427 197 180 603],339,5,31641,4.341520307354555,20.0,0.0
27288,2,7288,[271 179 655 191 405],379,3,31644,4.341336260117986,0.0,0.0
27289,2,7289,[302 427 197 180 603],90,5,31649,4.341426611796982,20.0,0.0
27290,2,7290,[302 427 197 180 603],383,5,31654,4.341516938691537,20.0,0.0
27291,2,7291,[204 151  98  69  79],380,4,31658,4.341470104223807,0.0,20.0
27292,2,7292,[302 427 197 180 603],666,5,31663,4.34156040038393,20.0,0.0
27293,2,7293,[302 427 197 180 603],271,5,31668,4.341650671785029,20.0,0.0
27294,2,7294,[ 70 185 748 357 276],13,2,31670,4.341329677861549,20.0,0.0
27295,2,7295,[202 228 174  82 187],774,2,31672,4.3410087719298245,0.0,20.0
27296,2,7296,[302 427 197 180 603],383,5,31677,4.341099081814444,20.0,0.0
27297,2,7297,[427 186 180  79 546],328,3,31680,4.3409153192655525,0.0,0.0
27298,2,7298,[302 427 197 180 603],537,5,31685,4.341005617207837,20.0,0.0
27299,2,7299,[302 427 197 180 603],666,5,31690,4.341095890410959,20.0,0.0
27300,2,7300,[125 111 245 181  56],92,4,31694,4.341049171346391,0.0,0.0
27301,2,7301,[302 427 197 180 603],664,5,31699,4.341139413859216,20.0,0.0
27302,2,7302,[302 427 197 180 603],271,5,31704,4.341229631658223,20.0,0.0
27303,2,7303,[302 427 197 180 603],271,5,31709,4.34131982475356,20.0,0.0
27304,2,7304,[  7 475 117 678 153],387,2,31711,4.340999315537303,0.0,0.0
27305,2,7305,[ 96 194 588 181 403],378,5,31716,4.34108951546674,0.0,0.0
27306,2,7306,[475  22   4 173 175],537,3,31719,4.34090598056658,0.0,0.0
27307,2,7307,[302 427 197 180 603],90,5,31724,4.340996168582375,20.0,0.0
27308,2,7308,[508  69 180 385 496],378,2,31726,4.340675879053222,0.0,0.0
27309,2,7309,[302 427 197 180 603],664,5,31731,4.340766073871409,20.0,0.0
27310,2,7310,[302 427 197 180 603],271,5,31736,4.340856244015867,20.0,0.0
27311,2,7311,[427 300 597 546  12],13,2,31738,4.340536105032823,20.0,0.0
27312,2,7312,[302 427 197 180 603],13,5,31743,4.340626281963626,20.0,0.0
27313,2,7313,[302 427 197 180 603],383,5,31748,4.340716434235713,20.0,0.0
27314,2,7314,[302 427 197 180 603],383,5,31753,4.340806561859194,20.0,0.0
27315,2,7315,[302 427 197 180 603],271,5,31758,4.340896664844177,20.0,0.0
27316,2,7316,[302 427 197 180 603],537,5,31763,4.340986743200765,20.0,0.0
27317,2,7317,[302 427 197 180 603],271,5,31768,4.3410767969390545,20.0,0.0
27318,2,7318,[302 427 197 180 603],666,5,31773,4.341166826069135,20.0,0.0
27319,2,7319,[302 427 197 180 603],90,5,31778,4.341256830601093,20.0,0.0
27320,2,7320,[ 15 435 144 132 258],447,4,31782,4.341210217183445,0.0,0.0
27321,2,7321,[265  64   8 228 135],254,4,31786,4.341163616498225,0.0,0.0
27322,2,7322,[302 427 197 180 603],474,5,31791,4.341253584596477,20.0,0.0
27323,2,7323,[302 427 197 180 603],339,5,31796,4.341343528126707,20.0,0.0
27324,2,7324,[302 427 197 180 603],339,5,31801,4.341433447098976,20.0,0.0
27325,2,7325,[302 427 197 180 603],537,5,31806,4.341523341523342,20.0,0.0
27326,2,7326,[302 427 197 180 603],271,5,31811,4.341613211409854,20.0,0.0
27327,2,7327,[302 427 197 180 603],339,5,31816,4.341703056768559,20.0,0.0
27328,2,7328,[302 427 197 180 603],13,5,31821,4.341792877609497,20.0,0.0
27329,2,7329,[302 427 197 180 603],339,5,31826,4.341882673942702,20.0,0.0
27330,2,7330,[302 427 197 180 603],537,5,31831,4.341972445778202,20.0,0.0
27331,2,7331,[302 427 197 180 603],664,5,31836,4.342062193126023,20.0,0.0
27332,2,7332,[ 12 318 144  98 176],883,4,31840,4.342015546161189,40.0,20.0
27333,2,7333,[302 427 197 180 603],537,5,31845,4.342105263157895,20.0,0.0
27334,2,7334,[302 427 197 180 603],664,5,31850,4.342194955691888,20.0,0.0
27335,2,7335,[302 427 197 180 603],271,5,31855,4.342284623773174,20.0,0.0
27336,2,7336,[357 197 181 322 127],749,5,31860,4.342374267411748,20.0,20.0
27337,2,7337,[185   7 204 144 328],653,2,31862,4.342055055873535,0.0,0.0
27338,2,7338,[302 427 197 180 603],271,5,31867,4.342144706363265,20.0,0.0
27339,2,7339,[302 427 197 180 603],13,5,31872,4.342234332425068,20.0,0.0
27340,2,7340,[302 427 197 180 603],664,5,31877,4.342323934068928,20.0,0.0
27341,2,7341,[302 427 197 180 603],383,5,31882,4.342413511304821,20.0,0.0
27342,2,7342,[176 196 185 435 496],326,3,31885,4.342230695900858,0.0,0.0
27343,2,7343,[186 546 568 496 323],378,1,31886,4.341775599128541,0.0,0.0
27344,2,7344,[302 427 197 180 603],339,5,31891,4.341865214431586,20.0,0.0
27345,2,7345,[181   7 427 195 187],650,4,31895,4.341818676830928,0.0,0.0
27346,2,7346,[302 427 197 180 603],383,5,31900,4.341908261875595,20.0,0.0
27347,2,7347,[302 427 197 180 603],666,5,31905,4.341997822536745,20.0,0.0
27348,2,7348,[302 427 197 180 603],13,5,31910,4.34208735882433,20.0,0.0
27349,2,7349,[202  28  12 265  56],13,5,31915,4.3421768707482995,20.0,0.0
27350,2,7350,[302 427 197 180 603],537,5,31920,4.3422663583185965,20.0,0.0
27351,2,7351,[302 427 197 180 603],90,5,31925,4.342355821545158,20.0,0.0
27352,2,7352,[302 427 197 180 603],271,5,31930,4.342445260437916,20.0,0.0
27353,2,7353,[302 427 197 180 603],537,5,31935,4.3425346750067995,20.0,0.0
27354,2,7354,[135 111 204 100   9],402,5,31940,4.3426240652617265,0.0,20.0
27355,2,7355,[302 427 197 180 603],474,5,31945,4.342713431212616,20.0,0.0
27356,2,7356,[302 427 197 180 603],13,5,31950,4.342802772869376,20.0,0.0
27357,2,7357,[302 427 197 180 603],537,5,31955,4.3428920902419135,20.0,0.0
27358,2,7358,[302 427 197 180 603],537,5,31960,4.342981383340128,20.0,0.0
27359,2,7359,[  1 180  64 191 211],10,5,31965,4.343070652173913,0.0,0.0
27360,2,7360,[176 173 258 427   4],537,3,31968,4.342888194538785,0.0,0.0
27361,2,7361,[405 496  89 271  95],537,2,31970,4.342569953816898,0.0,0.0
27362,2,7362,[302 427 197 180 603],339,5,31975,4.34265924215673,20.0,0.0
27363,2,7363,[302 427 197 180 603],664,5,31980,4.342748506246605,20.0,0.0
27364,2,7364,[302 427 197 180 603],13,5,31985,4.342837746096402,20.0,0.0
27365,2,7365,[302 427 197 180 603],339,5,31990,4.3429269617159925,20.0,0.0
27366,2,7366,[302 427 197 180 603],339,5,31995,4.343016153115244,20.0,0.0
27367,2,7367,[302 427 197 180 603],271,5,32000,4.3431053203040175,20.0,0.0
27368,2,7368,[302 427 197 180 603],13,5,32005,4.3431944632921695,20.0,0.0
27369,2,7369,[302 427 197 180 603],537,5,32010,4.343283582089552,20.0,0.0
27370,2,7370,[  8  96 151  95 323],897,3,32013,4.343101343101343,0.0,0.0
27371,2,7371,[302 427 197 180 603],537,5,32018,4.343190450352686,20.0,0.0
27372,2,7372,[302 427 197 180 603],664,5,32023,4.343279533432796,20.0,0.0
27373,2,7373,[318 181 187 127 186],271,5,32028,4.3433685923515055,20.0,20.0
27374,2,7374,[302 427 197 180 603],271,5,32033,4.343457627118644,20.0,0.0
27375,2,7375,[302 427 197 180 603],383,5,32038,4.343546637744034,20.0,0.0
27376,2,7376,[275 435 289 318  12],378,5,32043,4.3436356242374945,40.0,0.0
27377,2,7377,[302 427 197 180 603],339,5,32048,4.343724586608837,20.0,0.0
27378,2,7378,[302 427 197 180 603],537,5,32053,4.343813524867868,20.0,0.0
27379,2,7379,[ 12  11 161 322 289],13,2,32055,4.34349593495935,20.0,0.0
27380,2,7380,[302 427 197 180 603],474,5,32060,4.343584880097548,20.0,0.0
27381,2,7381,[496  89   4  11 180],653,2,32062,4.343267407206719,0.0,0.0
27382,2,7382,[182  56   4 118 300],774,1,32063,4.342814574021401,0.0,0.0
27383,2,7383,[302 427 197 180 603],664,5,32068,4.3429035752979415,20.0,0.0
27384,2,7384,[302 427 197 180 603],90,5,32073,4.342992552471226,20.0,0.0
27385,2,7385,[144 471  56 191  28],7,5,32078,4.3430815055510426,0.0,0.0
27386,2,7386,[302 427 197 180 603],90,5,32083,4.3431704345471775,20.0,0.0
27387,2,7387,[302 427 197 180 603],383,5,32088,4.34325933946941,20.0,0.0
27388,2,7388,[276  25 118  70 176],378,5,32093,4.343348220327514,0.0,0.0
27389,2,7389,[655 175 211  25 282],42,2,32095,4.343031123139378,0.0,0.0
27390,2,7390,[302 427 197 180 603],339,5,32100,4.343120010823975,20.0,0.0
27391,2,7391,[302 427 197 180 603],537,5,32105,4.343208874458875,20.0,0.0
27392,2,7392,[302 427 197 180 603],271,5,32110,4.3432977140538345,20.0,0.0
27393,2,7393,[ 70 216 257   9 302],6,3,32113,4.343116040032458,0.0,0.0
27394,2,7394,[568  88 202 655 176],42,3,32116,4.342934415145368,0.0,0.0
27395,2,7395,[125 195   7 282 508],653,1,32117,4.342482422931314,0.0,0.0
27396,2,7396,[180 237 100 173  25],666,3,32120,4.342300932810599,0.0,20.0
27397,2,7397,[302 427 197 180 603],90,5,32125,4.342389835090565,20.0,0.0
27398,2,7398,[302 427 197 180 603],383,5,32130,4.3424787133396405,20.0,0.0
27399,2,7399,[302 427 197 180 603],13,5,32135,4.342567567567568,20.0,0.0
27400,2,7400,[276   9 135  11 405],406,4,32139,4.342521280907985,0.0,0.0
27401,2,7401,[ 79  56 183 204 588],59,4,32143,4.342475006754931,0.0,0.0
27402,2,7402,[132   4  28  82  98],339,5,32148,4.342563825476159,0.0,20.0
27403,2,7403,[187 318 603 161 127],91,4,32152,4.3425175580767155,40.0,20.0
27404,2,7404,[302 427 197 180 603],13,5,32157,4.342606347062795,20.0,0.0
27405,2,7405,[302 427 197 180 603],90,5,32162,4.3426951120712936,20.0,0.0
27406,2,7406,[302 427 197 180 603],13,5,32167,4.342783853111921,20.0,0.0
27407,2,7407,[302 427 197 180 603],666,5,32172,4.342872570194385,20.0,0.0
27408,2,7408,[302 427 197 180 603],537,5,32177,4.342961263328385,20.0,0.0
27409,2,7409,[302 427 197 180 603],90,5,32182,4.343049932523617,20.0,0.0
27410,2,7410,[161 405  89 222  98],313,3,32185,4.342868708676292,0.0,20.0
27411,2,7411,[302 427 197 180 603],537,5,32190,4.342957366432811,20.0,0.0
27412,2,7412,[515 269  11 300 196],90,4,32194,4.342911102117901,0.0,0.0
27413,2,7413,[132 403 175  28  70],881,1,32195,4.342460210412733,0.0,0.0
27414,2,7414,[302 427 197 180 603],474,5,32200,4.342548887390425,20.0,0.0
27415,2,7415,[183 195   1 202 496],738,5,32205,4.342637540453074,0.0,0.0
27416,2,7416,[302 427 197 180 603],271,5,32210,4.342726169610355,20.0,0.0
27417,2,7417,[183 173 588  22  50],194,3,32213,4.342545160420599,0.0,20.0
27418,2,7418,[302 427 197 180 603],271,5,32218,4.342633778137215,20.0,0.0
27419,2,7419,[302 427 197 180 603],537,5,32223,4.342722371967655,20.0,0.0
27420,2,7420,[302 427 197 180 603],339,5,32228,4.342810941921574,20.0,0.0
27421,2,7421,[258 204  11 294  56],234,0,32228,4.342225815144166,0.0,0.0
27422,2,7422,[302 427 197 180 603],474,5,32233,4.342314428128789,20.0,0.0
27423,2,7423,[302 427 197 180 603],666,5,32238,4.342403017241379,20.0,0.0
27424,2,7424,[302 427 197 180 603],13,5,32243,4.342491582491583,20.0,0.0
27425,2,7425,[302 427 197 180 603],339,5,32248,4.3425801238890385,20.0,0.0
27426,2,7426,[238 174 185  89 117],479,4,32252,4.34253399757641,0.0,20.0
27427,2,7427,[302 427 197 180 603],383,5,32257,4.342622509423802,20.0,0.0
27428,2,7428,[302 427 197 180 603],474,5,32262,4.342710997442455,20.0,0.0
27429,2,7429,[302 427 197 180 603],666,5,32267,4.342799461641992,20.0,0.0
27430,2,7430,[302 427 197 180 603],271,5,32272,4.342887902032028,20.0,0.0
27431,2,7431,[302 427 197 180 603],271,5,32277,4.342976318622174,20.0,0.0
27432,2,7432,[302 427 197 180 603],383,5,32282,4.343064711422037,20.0,0.0
27433,2,7433,[302 427 197 180 603],271,5,32287,4.343153080441216,20.0,0.0
27434,2,7434,[100  56 181 237 471],328,4,32291,4.3431069266980495,0.0,20.0
27435,2,7435,[357 125 471 216  71],899,4,32295,4.343060785368477,20.0,0.0
27436,2,7436,[302 427 197 180 603],271,5,32300,4.3431491192685225,20.0,0.0
27437,2,7437,[302 427 197 180 603],664,5,32305,4.34323742941651,20.0,0.0
27438,2,7438,[302 427 197 180 603],271,5,32310,4.343325715822019,20.0,0.0
27439,2,7439,[172 197  88 161 238],653,1,32311,4.342876344086021,0.0,0.0
27440,2,7440,[302 427 197 180 603],13,5,32316,4.3429646552882675,20.0,0.0
27441,2,7441,[228  89  96 174   1],932,5,32321,4.343052942757323,0.0,20.0
27442,2,7442,[302 427 197 180 603],339,5,32326,4.343141206502755,20.0,0.0
27443,2,7443,[302 427 197 180 603],383,5,32331,4.343229446534122,20.0,0.0
27444,2,7444,[302 427 197 180 603],339,5,32336,4.34331766286098,20.0,0.0
27445,2,7445,[ 97 194 257  98 180],881,3,32339,4.3431372549019605,0.0,20.0
27446,2,7446,[302 427 197 180 603],537,5,32344,4.343225459916745,20.0,0.0
27447,2,7447,[187 175 403 597 191],804,3,32347,4.3430451127819545,0.0,0.0
27448,2,7448,[302 427 197 180 603],383,5,32352,4.343133306484092,20.0,0.0
27449,2,7449,[286 475 204 196  69],455,5,32357,4.343221476510067,0.0,0.0
27450,2,7450,[302 427 197 180 603],537,5,32362,4.3433096228694135,20.0,0.0
27451,2,7451,[ 69 318 121 197 496],694,5,32367,4.343397745571659,20.0,0.0
27452,2,7452,[  1 173 328 196 257],378,4,32371,4.343351670468268,0.0,0.0
27453,2,7453,[204 435  22 258 121],474,5,32376,4.343439763885162,0.0,0.0
27454,2,7454,[ 50 288 515 237 269],64,5,32381,4.343527833668679,0.0,20.0
27455,2,7455,[302 427 197 180 603],13,5,32386,4.343615879828326,20.0,0.0
27456,2,7456,[302 427 197 180 603],339,5,32391,4.343703902373608,20.0,0.0
27457,2,7457,[302 427 197 180 603],537,5,32396,4.343791901314026,20.0,0.0
27458,2,7458,[302 427 197 180 603],537,5,32401,4.343879876659069,20.0,0.0
27459,2,7459,[302 427 197 180 603],13,5,32406,4.34396782841823,20.0,0.0
27460,2,7460,[302 427 197 180 603],666,5,32411,4.344055756600992,20.0,0.0
27461,2,7461,[204 181 302 215 238],380,1,32412,4.343607611900294,0.0,0.0
27462,2,7462,[302 427 197 180 603],13,5,32417,4.343695564786279,20.0,0.0
27463,2,7463,[187 183 186 265 117],774,1,32418,4.343247588424437,0.0,0.0
27464,2,7464,[132 423 385 194 318],234,4,32422,4.343201607501674,20.0,0.0
27465,2,7465,[302 427 197 180 603],474,5,32427,4.3432895794267345,20.0,0.0
27466,2,7466,[302 427 197 180 603],90,5,32432,4.343377527788938,20.0,0.0
27467,2,7467,[ 79 195 194 234 135],804,4,32436,4.3433315479378685,0.0,0.0
27468,2,7468,[302 427 197 180 603],90,5,32441,4.343419467130808,20.0,0.0
27469,2,7469,[265 268 234  69 423],13,5,32446,4.343507362784472,0.0,0.0
27470,2,7470,[ 95   8 172 153 748],899,5,32451,4.343595234908312,0.0,0.0
27471,2,7471,[302 427 197 180 603],474,5,32456,4.3436830835117775,20.0,0.0
27472,2,7472,[302 427 197 180 603],90,5,32461,4.343770908604309,20.0,0.0
27473,2,7473,[302 427 197 180 603],339,5,32466,4.343858710195343,20.0,0.0
27474,2,7474,[302 427 197 180 603],383,5,32471,4.343946488294314,20.0,0.0
27475,2,7475,[302 427 197 180 603],383,5,32476,4.344034242910648,20.0,0.0
27476,2,7476,[302 427 197 180 603],664,5,32481,4.344121974053765,20.0,0.0
27477,2,7477,[302 427 197 180 603],13,5,32486,4.3442096817330835,20.0,0.0
27478,2,7478,[302 427 197 180 603],271,5,32491,4.344297365958016,20.0,0.0
27479,2,7479,[ 96 405 204 211 135],479,5,32496,4.344385026737968,0.0,0.0
27480,2,7480,[302 427 197 180 603],339,5,32501,4.344472664082342,20.0,0.0
27481,2,7481,[302 427 197 180 603],474,5,32506,4.344560278000535,20.0,0.0
27482,2,7482,[200 269  71 286 175],6,3,32509,4.34438059601764,0.0,0.0
27483,2,7483,[302 427 197 180 603],666,5,32514,4.344468198824158,20.0,0.0
27484,2,7484,[302 427 197 180 603],383,5,32519,4.344555778223113,20.0,0.0
27485,2,7485,[302 427 197 180 603],383,5,32524,4.344643334223885,20.0,0.0
27486,2,7486,[302 427 197 180 603],90,5,32529,4.344730866835849,20.0,0.0
27487,2,7487,[302 427 197 180 603],474,5,32534,4.3448183760683765,20.0,0.0
27488,2,7488,[302 427 197 180 603],537,5,32539,4.344905861930832,20.0,0.0
27489,2,7489,[302 427 197 180 603],383,5,32544,4.3449933244325765,20.0,0.0
27490,2,7490,[302 427 197 180 603],474,5,32549,4.345080763582966,20.0,0.0
27491,2,7491,[302 427 197 180 603],339,5,32554,4.345168179391351,20.0,0.0
27492,2,7492,[302 427 197 180 603],664,5,32559,4.345255571867076,20.0,0.0
27493,2,7493,[302 427 197 180 603],664,5,32564,4.345342941019482,20.0,0.0
27494,2,7494,[302 427 197 180 603],13,5,32569,4.345430286857905,20.0,0.0
27495,2,7495,[276 257 183 210 423],378,5,32574,4.345517609391676,0.0,0.0
27496,2,7496,[234  11 655 181 289],881,3,32577,4.345338135254102,0.0,0.0
27497,2,7497,[ 70 117 186 546 258],378,2,32579,4.34502534009069,0.0,0.0
27498,2,7498,[174 196  25  89 258],13,4,32583,4.34497933057741,0.0,20.0
27499,2,7499,[302 427 197 180 603],383,5,32588,4.345066666666667,20.0,0.0
27500,2,7500,[302 427 197 180 603],537,5,32593,4.345153979469404,20.0,0.0
27501,2,7501,[483 111 385 175  69],95,4,32597,4.345107971207678,20.0,0.0
27502,2,7502,[302 427 197 180 603],271,5,32602,4.345195255231241,20.0,0.0
27503,2,7503,[302 427 197 180 603],13,5,32607,4.345282515991471,20.0,0.0
27504,2,7504,[176 135 216 204 185],840,4,32611,4.345236508994004,0.0,0.0
27505,2,7505,[ 69 135 228 405  22],343,5,32616,4.345323741007194,0.0,0.0
27506,2,7506,[194   1 508 268 143],537,2,32618,4.345011322765419,0.0,0.0
27507,2,7507,[302 427 197 180 603],664,5,32623,4.345098561534363,20.0,0.0
27508,2,7508,[302 427 197 180 603],383,5,32628,4.345185777067519,20.0,0.0
27509,2,7509,[302 427 197 180 603],339,5,32633,4.345272969374168,20.0,0.0
27510,2,7510,[200 289 322  25 568],537,0,32633,4.344694448142724,0.0,0.0
27511,2,7511,[215 210 286 175  15],95,5,32638,4.344781682641107,0.0,0.0
27512,2,7512,[302 427 197 180 603],666,5,32643,4.34486889391721,20.0,0.0
27513,2,7513,[302 427 197 180 603],383,5,32648,4.344956081980303,20.0,0.0
27514,2,7514,[302 427 197 180 603],664,5,32653,4.345043246839654,20.0,0.0
27515,2,7515,[318  64 182 191  12],458,5,32658,4.345130388504524,40.0,0.0
27516,2,7516,[302 427 197 180 603],13,5,32663,4.345217506984169,20.0,0.0
27517,2,7517,[302 427 197 180 603],90,5,32668,4.345304602287842,20.0,0.0
27518,2,7518,[302 427 197 180 603],537,5,32673,4.345391674424791,20.0,0.0
27519,2,7519,[302 427 197 180 603],271,5,32678,4.345478723404256,20.0,0.0
27520,2,7520,[302 427 197 180 603],271,5,32683,4.345565749235474,20.0,0.0
27521,2,7521,[204 168 125  97   8],271,3,32686,4.345386865195427,0.0,0.0
27522,2,7522,[302 427 197 180 603],666,5,32691,4.345473880101023,20.0,0.0
27523,2,7523,[302 427 197 180 603],474,5,32696,4.345560871876661,20.0,0.0
27524,2,7524,[302 427 197 180 603],383,5,32701,4.345647840531561,20.0,0.0
27525,2,7525,[302 427 197 180 603],383,5,32706,4.3457347860749405,20.0,0.0
27526,2,7526,[211 423 216 273 385],308,3,32709,4.3455559984057395,0.0,0.0
27527,2,7527,[302 427 197 180 603],271,5,32714,4.345642933049946,20.0,0.0
27528,2,7528,[302 427 197 180 603],537,5,32719,4.345729844600877,20.0,0.0
27529,2,7529,[302 427 197 180 603],537,5,32724,4.345816733067729,20.0,0.0
27530,2,7530,[302 427 197 180 603],90,5,32729,4.3459035984597,20.0,0.0
27531,2,7531,[302 427 197 180 603],13,5,32734,4.34599044078598,20.0,0.0
27532,2,7532,[302 427 197 180 603],383,5,32739,4.346077260055755,20.0,0.0
27533,2,7533,[ 97 742 357  50 603],666,3,32742,4.345898593044863,40.0,20.0
27534,2,7534,[215 238  56   4 118],749,2,32744,4.345587259455873,0.0,0.0
27535,2,7535,[ 11  79  98 222  28],666,2,32746,4.345276008492569,0.0,20.0
27536,2,7536,[151  98 172 202  71],313,4,32750,4.345230197691389,0.0,20.0
27537,2,7537,[302 427 197 180 603],666,5,32755,4.345317060228178,20.0,0.0
27538,2,7538,[302 427 197 180 603],537,5,32760,4.345403899721449,20.0,0.0
27539,2,7539,[172 127 179 210 175],85,4,32764,4.345358090185677,0.0,20.0
27540,2,7540,[302 427 197 180 603],383,5,32769,4.345444901206736,20.0,0.0
27541,2,7541,[302 427 197 180 603],666,5,32774,4.345531689207107,20.0,0.0
27542,2,7542,[302 427 197 180 603],271,5,32779,4.345618454195943,20.0,0.0
27543,2,7543,[197 135 183  50  64],804,4,32783,4.345572640509014,0.0,20.0
27544,2,7544,[302 427 197 180 603],666,5,32788,4.345659377070908,20.0,0.0
27545,2,7545,[302 427 197 180 603],664,5,32793,4.34574609064405,20.0,0.0
27546,2,7546,[597 318 174 265 216],533,3,32796,4.345567775274944,20.0,20.0
27547,2,7547,[302 427 197 180 603],666,5,32801,4.345654478007419,20.0,0.0
27548,2,7548,[125 176 245 181 357],313,3,32804,4.345476222016161,20.0,0.0
27549,2,7549,[196 197 546 174 194],13,4,32808,4.345430463576159,0.0,20.0
27550,2,7550,[302 427 197 180 603],271,5,32813,4.345517150046351,20.0,0.0
27551,2,7551,[168  79 322 135  15],488,4,32817,4.345471398305085,0.0,0.0
27552,2,7552,[301 313 288 435  56],102,0,32817,4.3448960677876345,0.0,0.0
27553,2,7553,[181 191 228 245 546],554,3,32820,4.344718030182685,0.0,0.0
27554,2,7554,[191  82 286 258 200],234,2,32822,4.344407677035076,0.0,0.0
27555,2,7555,[302 427 197 180 603],13,5,32827,4.344494441503441,20.0,0.0
27556,2,7556,[216 211 187  25 215],313,4,32831,4.3444488553658855,0.0,0.0
27557,2,7557,[302 427 197 180 603],339,5,32836,4.344535591426303,20.0,0.0
27558,2,7558,[302 427 197 180 603],339,5,32841,4.344622304537637,20.0,0.0
27559,2,7559,[257 181 161 483   9],334,4,32845,4.34457671957672,20.0,0.0
27560,2,7560,[302 427 197 180 603],537,5,32850,4.344663404311599,20.0,0.0
27561,2,7561,[200  96 405 211 174],59,4,32854,4.344617825971965,0.0,20.0
27562,2,7562,[302 427 197 180 603],90,5,32859,4.344704482348274,20.0,0.0
27563,2,7563,[ 96   1 275 742 132],308,4,32863,4.344658910629296,0.0,0.0
27564,2,7564,[245 300 405  50   7],334,2,32865,4.344348975545274,0.0,20.0
27565,2,7565,[302 427 197 180 603],666,5,32870,4.344435633095427,20.0,0.0
27566,2,7566,[302 427 197 180 603],339,5,32875,4.344522267741509,20.0,0.0
27567,2,7567,[302 427 197 180 603],383,5,32880,4.3446088794926006,20.0,0.0
27568,2,7568,[302 427 197 180 603],474,5,32885,4.344695468357775,20.0,0.0
27569,2,7569,[ 71 175   8 215 204],840,4,32889,4.3446499339498015,0.0,0.0
27570,2,7570,[ 79   8  96 185 194],207,3,32892,4.344472328622375,0.0,0.0
27571,2,7571,[204 288 143 300 216],479,1,32893,4.344030639197042,0.0,0.0
27572,2,7572,[435 100 427 144  25],308,4,32897,4.3439852106166645,0.0,20.0
27573,2,7573,[302 427 197 180 603],666,5,32902,4.344071824663322,20.0,0.0
27574,2,7574,[302 427 197 180 603],271,5,32907,4.3441584158415845,20.0,0.0
27575,2,7575,[357 300 100 204 211],788,4,32911,4.344112988384372,20.0,20.0
27576,2,7576,[302 427 197 180 603],339,5,32916,4.344199551273591,20.0,0.0
27577,2,7577,[302 427 197 180 603],271,5,32921,4.34428609131697,20.0,0.0
27578,2,7578,[ 69   9 125 265  71],815,5,32926,4.344372608523552,0.0,0.0
27579,2,7579,[100  71 117  22 161],194,4,32930,4.344327176781003,0.0,20.0
27580,2,7580,[215 546 176 186  50],774,2,32932,4.3440179395858065,0.0,20.0
27581,2,7581,[302 427 197 180 603],271,5,32937,4.344104457926669,20.0,0.0
27582,2,7582,[194 294 483 288 222],82,3,32940,4.343927205591455,20.0,0.0
27583,2,7583,[191 597 161  82  89],95,1,32941,4.343486286919831,0.0,0.0
27584,2,7584,[302 427 197 180 603],664,5,32946,4.343572841133817,20.0,0.0
27585,2,7585,[302 427 197 180 603],383,5,32951,4.343659372528342,20.0,0.0
27586,2,7586,[302 427 197 180 603],13,5,32956,4.343745881112429,20.0,0.0
27587,2,7587,[302 427 197 180 603],90,5,32961,4.343832366895097,20.0,0.0
27588,2,7588,[238 597 125 172 273],92,4,32965,4.343787060218737,0.0,0.0
27589,2,7589,[ 28 228 196 471 322],13,3,32968,4.343610013175231,0.0,0.0
27590,2,7590,[302 427 197 180 603],383,5,32973,4.3436964826768545,20.0,0.0
27591,2,7591,[216 187  69  12 176],328,4,32977,4.343651211801896,20.0,0.0
27592,2,7592,[  7 176 194 200   4],10,5,32982,4.343737653101541,0.0,0.0
27593,2,7593,[302 427 197 180 603],666,5,32987,4.343824071635502,20.0,0.0
27594,2,7594,[302 427 197 180 603],339,5,32992,4.343910467412772,20.0,0.0
27595,2,7595,[302 427 197 180 603],664,5,32997,4.343996840442338,20.0,0.0
27596,2,7596,[302 427 197 180 603],537,5,33002,4.344083190733184,20.0,0.0
27597,2,7597,[302 427 197 180 603],474,5,33007,4.344169518294288,20.0,0.0
27598,2,7598,[302 427 197 180 603],339,5,33012,4.344255823134623,20.0,0.0
27599,2,7599,[302 427 197 180 603],666,5,33017,4.344342105263158,20.0,0.0
27600,2,7600,[288 286  11 546 180],378,1,33018,4.34390211814235,0.0,0.0
27601,2,7601,[302 427 197 180 603],474,5,33023,4.343988424098922,20.0,0.0
27602,2,7602,[302 427 197 180 603],537,5,33028,4.344074707352361,20.0,0.0
27603,2,7603,[302 427 197 180 603],537,5,33033,4.344160967911625,20.0,0.0
27604,2,7604,[ 95 182 313  11 187],234,2,33035,4.343852728468113,0.0,0.0
27605,2,7605,[302 427 197 180 603],271,5,33040,4.343938995529845,20.0,0.0
27606,2,7606,[ 79 195  22 294 202],200,5,33045,4.344025239910609,0.0,0.0
27607,2,7607,[302 427 197 180 603],474,5,33050,4.344111461619348,20.0,0.0
27608,2,7608,[294   7 191  15 286],234,1,33051,4.343671967407018,0.0,0.0
27609,2,7609,[302 427 197 180 603],664,5,33056,4.343758212877792,20.0,0.0
27610,2,7610,[211  28 144  89 216],543,5,33061,4.343844435685193,0.0,0.0
27611,2,7611,[302 427 197 180 603],537,5,33066,4.34393063583815,20.0,0.0
27612,2,7612,[302 427 197 180 603],664,5,33071,4.344016813345593,20.0,0.0
27613,2,7613,[186 127   1 496  89],59,4,33075,4.343971631205674,0.0,20.0
27614,2,7614,[294 161   1 182  98],653,2,33077,4.343663821405121,0.0,20.0
27615,2,7615,[302 427 197 180 603],537,5,33082,4.34375,20.0,0.0
27616,2,7616,[302 427 197 180 603],537,5,33087,4.343836155966916,20.0,0.0
27617,2,7617,[300  50 153 597 215],144,4,33091,4.343791021265424,0.0,20.0
27618,2,7618,[275 603   1 183 172],13,3,33094,4.343614647591547,20.0,0.0
27619,2,7619,[191 173 333 216 175],13,1,33095,4.343175853018373,0.0,0.0
27620,2,7620,[151 186 161 117 282],334,2,33097,4.342868389975069,0.0,0.0
27621,2,7621,[ 50 100 200 117  88],749,4,33101,4.342823405930202,0.0,40.0
27622,2,7622,[302 427 197 180 603],271,5,33106,4.342909615636889,20.0,0.0
27623,2,7623,[302 427 197 180 603],339,5,33111,4.342995802728226,20.0,0.0
27624,2,7624,[302 427 197 180 603],13,5,33116,4.343081967213115,20.0,0.0
27625,2,7625,[143 168  95 181   1],308,5,33121,4.3431681091004455,0.0,0.0
27626,2,7626,[302 427 197 180 603],474,5,33126,4.3432542283991085,20.0,0.0
27627,2,7627,[302 427 197 180 603],271,5,33131,4.343340325117986,20.0,0.0
27628,2,7628,[302 427 197 180 603],13,5,33136,4.343426399265959,20.0,0.0
27629,2,7629,[302 427 197 180 603],666,5,33141,4.3435124508519,20.0,0.0
27630,2,7630,[302 427 197 180 603],90,5,33146,4.3435984798846805,20.0,0.0
27631,2,7631,[302 427 197 180 603],664,5,33151,4.343684486373165,20.0,0.0
27632,2,7632,[302 427 197 180 603],339,5,33156,4.343770470326215,20.0,0.0
27633,2,7633,[144 183 174 117 121],339,2,33158,4.343463452973539,0.0,20.0
27634,2,7634,[302 427 197 180 603],13,5,33163,4.3435494433529795,20.0,0.0
27635,2,7635,[302 427 197 180 603],339,5,33168,4.343635411210058,20.0,0.0
27636,2,7636,[302 427 197 180 603],271,5,33173,4.343721356553621,20.0,0.0
27637,2,7637,[197 132 181 496 238],749,4,33177,4.343676355066771,0.0,0.0
27638,2,7638,[302 427 197 180 603],664,5,33182,4.343762272548763,20.0,0.0
27639,2,7639,[300 183  22 588 176],537,0,33182,4.343193717277487,0.0,0.0
27640,2,7640,[182  82 195 181   7],194,0,33182,4.34262531082319,0.0,0.0
27641,2,7641,[302 427 197 180 603],664,5,33187,4.342711332112013,20.0,0.0
27642,2,7642,[302 427 197 180 603],383,5,33192,4.3427973308910115,20.0,0.0
27643,2,7643,[302 427 197 180 603],271,5,33197,4.342883307169021,20.0,0.0
27644,2,7644,[302 427 197 180 603],666,5,33202,4.342969260954873,20.0,0.0
27645,2,7645,[153 211 181  98 318],13,4,33206,4.342924404917604,20.0,20.0
27646,2,7646,[302 427 197 180 603],474,5,33211,4.343010330848699,20.0,0.0
27647,2,7647,[302 427 197 180 603],271,5,33216,4.343096234309623,20.0,0.0
27648,2,7648,[302 427 197 180 603],664,5,33221,4.343182115309191,20.0,0.0
27649,2,7649,[302 427 197 180 603],666,5,33226,4.343267973856209,20.0,0.0
27650,2,7650,[302 427 197 180 603],383,5,33231,4.343353809959482,20.0,0.0
27651,2,7651,[302 427 197 180 603],664,5,33236,4.34343962362781,20.0,0.0
27652,2,7652,[302 427 197 180 603],383,5,33241,4.343525414869986,20.0,0.0
27653,2,7653,[204 496 228 168 603],899,4,33245,4.343480533054612,20.0,0.0
27654,2,7654,[302 427 197 180 603],13,5,33250,4.34356629653821,20.0,0.0
27655,2,7655,[302 427 197 180 603],271,5,33255,4.343652037617555,20.0,0.0
27656,2,7656,[302 427 197 180 603],664,5,33260,4.343737756301423,20.0,0.0
27657,2,7657,[302 427 197 180 603],339,5,33265,4.34382345259859,20.0,0.0
27658,2,7658,[135 183 435 121 172],64,4,33269,4.343778561169866,0.0,0.0
27659,2,7659,[127 597 603 175  70],7,3,33272,4.343603133159269,20.0,20.0
27660,2,7660,[302 427 197 180 603],339,5,33277,4.343688813470826,20.0,0.0
27661,2,7661,[258 546   9 182  97],7,5,33282,4.343774471417385,0.0,0.0
27662,2,7662,[127 195 483 655 588],479,4,33286,4.343729609813389,20.0,20.0
27663,2,7663,[132 196 265 118 185],42,4,33290,4.343684759916493,0.0,0.0
27664,2,7664,[302 427 197 180 603],474,5,33295,4.343770384866275,20.0,0.0
27665,2,7665,[181 194  97  25  64],213,5,33300,4.343855987477172,0.0,0.0
27666,2,7666,[302 427 197 180 603],474,5,33305,4.343941567757923,20.0,0.0
27667,2,7667,[234  12 186 228 742],788,1,33306,4.343505477308295,20.0,0.0
27668,2,7668,[302  95 211 196 515],271,5,33311,4.343591080975355,0.0,0.0
27669,2,7669,[302 427 197 180 603],383,5,33316,4.34367666232073,20.0,0.0
27670,2,7670,[302 427 197 180 603],474,5,33321,4.343762221353148,20.0,0.0
27671,2,7671,[302 427 197 180 603],339,5,33326,4.343847758081335,20.0,0.0
27672,2,7672,[200 121 237 151 175],7,5,33331,4.34393327251401,0.0,0.0
27673,2,7673,[302 427 197 180 603],90,5,33336,4.34401876465989,20.0,0.0
27674,2,7674,[294 313   1 153 597],144,5,33341,4.344104234527688,0.0,0.0
27675,2,7675,[168 385  28 471 204],42,4,33345,4.344059405940594,0.0,0.0
27676,2,7676,[302 427 197 180 603],90,5,33350,4.344144848248013,20.0,0.0
27677,2,7677,[302 427 197 180 603],664,5,33355,4.344230268299036,20.0,0.0
27678,2,7678,[302 427 197 180 603],474,5,33360,4.344315666102357,20.0,0.0
27679,2,7679,[588 483 194 127  28],804,4,33364,4.344270833333334,20.0,20.0
27680,2,7680,[302 427 197 180 603],474,5,33369,4.344356203619321,20.0,0.0
27681,2,7681,[302 427 197 180 603],664,5,33374,4.3444415516792505,20.0,0.0
27682,2,7682,[302 427 197 180 603],13,5,33379,4.344526877521801,20.0,0.0
27683,2,7683,[302 427 197 180 603],666,5,33384,4.344612181155648,20.0,0.0
27684,2,7684,[302 427 197 180 603],90,5,33389,4.34469746258946,20.0,0.0
27685,2,7685,[483  12 268 237 182],13,5,33394,4.344782721831902,40.0,0.0
27686,2,7686,[302 427 197 180 603],383,5,33399,4.344867958891635,20.0,0.0
27687,2,7687,[302 427 197 180 603],474,5,33404,4.3449531737773155,20.0,0.0
27688,2,7688,[302 427 197 180 603],90,5,33409,4.345038366497594,20.0,0.0
27689,2,7689,[302 427 197 180 603],383,5,33414,4.345123537061118,20.0,0.0
27690,2,7690,[302 427 197 180 603],271,5,33419,4.345208685476531,20.0,0.0
27691,2,7691,[302 427 197 180 603],339,5,33424,4.34529381175247,20.0,0.0
27692,2,7692,[183 172 289 161 181],197,5,33429,4.3453789158975695,0.0,0.0
27693,2,7693,[194 403 300 289 100],378,5,33434,4.345463997920458,0.0,20.0
27694,2,7694,[302 427 197 180 603],664,5,33439,4.34554905782976,20.0,0.0
27695,2,7695,[302 427 197 180 603],666,5,33444,4.345634095634096,20.0,0.0
27696,2,7696,[302 427 197 180 603],537,5,33449,4.345719111342081,20.0,0.0
27697,2,7697,[121 143 588 132 194],378,5,33454,4.345804104962328,0.0,0.0
27698,2,7698,[302 427 197 180 603],271,5,33459,4.345889076503442,20.0,0.0
27699,2,7699,[302 427 197 180 603],537,5,33464,4.345974025974026,20.0,0.0
27700,2,7700,[302 427 197 180 603],90,5,33469,4.346058953382678,20.0,0.0
27701,2,7701,[144  98  15 100 276],234,2,33471,4.345754349519606,0.0,40.0
27702,2,7702,[302 427 197 180 603],13,5,33476,4.34583928339608,20.0,0.0
27703,2,7703,[302 427 197 180 603],666,5,33481,4.345924195223261,20.0,0.0
27704,2,7704,[302 427 197 180 603],537,5,33486,4.346009085009734,20.0,0.0
27705,2,7705,[302 427 197 180 603],383,5,33491,4.34609395276408,20.0,0.0
27706,2,7706,[288   1 127   7   4],650,1,33492,4.345659789801479,0.0,20.0
27707,2,7707,[302 427 197 180 603],383,5,33497,4.345744680851064,20.0,0.0
27708,2,7708,[302 427 197 180 603],90,5,33502,4.345829549876767,20.0,0.0
27709,2,7709,[302 427 197 180 603],13,5,33507,4.345914396887159,20.0,0.0
27710,2,7710,[302 427 197 180 603],537,5,33512,4.345999221890805,20.0,0.0
27711,2,7711,[302 427 197 180 603],339,5,33517,4.346084024896266,20.0,0.0
27712,2,7712,[302 427 197 180 603],13,5,33522,4.346168805912097,20.0,0.0
27713,2,7713,[302 427 197 180 603],666,5,33527,4.34625356494685,20.0,0.0
27714,2,7714,[235 275 222 183 273],145,4,33531,4.346208684381076,0.0,0.0
27715,2,7715,[302 427 197 180 603],474,5,33536,4.346293416277864,20.0,0.0
27716,2,7716,[302 427 197 180 603],271,5,33541,4.346378126214851,20.0,0.0
27717,2,7717,[ 12 546  95 483 435],524,3,33544,4.346203679709769,40.0,0.0
27718,2,7718,[302 427 197 180 603],90,5,33549,4.346288379323747,20.0,0.0
27719,2,7719,[302 427 197 180 603],13,5,33554,4.3463730569948185,20.0,0.0
27720,2,7720,[282 117 245 655 289],334,2,33556,4.346069162025644,0.0,0.0
27721,2,7721,[302 427 197 180 603],474,5,33561,4.346153846153846,20.0,0.0
27722,2,7722,[286 234 121   1 172],213,3,33564,4.345979541628901,0.0,0.0
27723,2,7723,[302 427 197 180 603],664,5,33569,4.346064215432419,20.0,0.0
27724,2,7724,[302 427 197 180 603],474,5,33574,4.346148867313916,20.0,0.0
27725,2,7725,[302 427 197 180 603],666,5,33579,4.346233497281905,20.0,0.0
27726,2,7726,[ 28 385 153 471 143],479,3,33582,4.346059272680212,0.0,0.0
27727,2,7727,[237 191 333 117 172],313,4,33586,4.346014492753623,0.0,0.0
27728,2,7728,[ 69 200 496 275  70],60,5,33591,4.346099107258378,0.0,0.0
27729,2,7729,[195 275 257 403 508],533,4,33595,4.346054333764553,0.0,0.0
27730,2,7730,[194 508 118 289 125],378,4,33599,4.3460095718535765,0.0,0.0
27731,2,7731,[302 427 197 180 603],666,5,33604,4.346094154164511,20.0,0.0
27732,2,7732,[302 427 197 180 603],271,5,33609,4.346178714599767,20.0,0.0
27733,2,7733,[132  71 143  25  89],882,4,33613,4.346133953969486,0.0,0.0
27734,2,7734,[302 427 197 180 603],339,5,33618,4.346218487394958,20.0,0.0
27735,2,7735,[302 427 197 180 603],474,5,33623,4.346302998965874,20.0,0.0
27736,2,7736,[302 427 197 180 603],537,5,33628,4.346387488690707,20.0,0.0
27737,2,7737,[302 427 197 180 603],271,5,33633,4.346471956577927,20.0,0.0
27738,2,7738,[302 427 197 180 603],90,5,33638,4.346556402636,20.0,0.0
27739,2,7739,[135 173 301  71 546],650,2,33640,4.3462532299741605,0.0,0.0
27740,2,7740,[125 471 111 300 294],234,0,33640,4.345691771089006,0.0,0.0
27741,2,7741,[302 427 197 180 603],13,5,33645,4.345776285197624,20.0,0.0
27742,2,7742,[302 427 197 180 603],664,5,33650,4.34586077747643,20.0,0.0
27743,2,7743,[302 427 197 180 603],90,5,33655,4.3459452479338845,20.0,0.0
27744,2,7744,[211  11 176 234  95],804,4,33659,4.345900581020013,0.0,0.0
27745,2,7745,[302 427 197 180 603],664,5,33664,4.345985024528789,20.0,0.0
27746,2,7746,[302 427 197 180 603],383,5,33669,4.346069446237253,20.0,0.0
27747,2,7747,[302 427 197 180 603],666,5,33674,4.346153846153846,20.0,0.0
27748,2,7748,[302 427 197 180 603],271,5,33679,4.346238224287005,20.0,0.0
27749,2,7749,[302 427 197 180 603],537,5,33684,4.346322580645161,20.0,0.0
27750,2,7750,[302 427 197 180 603],13,5,33689,4.346406915236743,20.0,0.0
27751,2,7751,[302 427 197 180 603],664,5,33694,4.3464912280701755,20.0,0.0
27752,2,7752,[302 427 197 180 603],13,5,33699,4.346575519153876,20.0,0.0
27753,2,7753,[288 174 475 191 125],82,2,33701,4.346272891410885,0.0,20.0
27754,2,7754,[483   7 276  11 195],339,4,33705,4.346228239845261,20.0,0.0
27755,2,7755,[302 427 197 180 603],474,5,33710,4.34631253223311,20.0,0.0
27756,2,7756,[185 117  50 313 678],548,5,33715,4.346396802887714,0.0,20.0
27757,2,7757,[302 427 197 180 603],474,5,33720,4.346481051817479,20.0,0.0
27758,2,7758,[ 11 597 187 200 288],643,3,33723,4.346307513854878,0.0,0.0
27759,2,7759,[302 427 197 180 603],90,5,33728,4.346391752577319,20.0,0.0
27760,2,7760,[302 427 197 180 603],664,5,33733,4.346475969591547,20.0,0.0
27761,2,7761,[174 151  12   7  69],60,5,33738,4.346560164905952,20.0,20.0
27762,2,7762,[302 427 197 180 603],383,5,33743,4.346644338528919,20.0,0.0
27763,2,7763,[302 427 197 180 603],383,5,33748,4.346728490468831,20.0,0.0
27764,2,7764,[121 742 322 294 435],308,2,33750,4.346426271732131,0.0,0.0
27765,2,7765,[302 427 197 180 603],537,5,33755,4.346510430079835,20.0,0.0
27766,2,7766,[302 427 197 180 603],271,5,33760,4.346594566756791,20.0,0.0
27767,2,7767,[302 427 197 180 603],537,5,33765,4.34667868177137,20.0,0.0
27768,2,7768,[302 427 197 180 603],666,5,33770,4.346762775131935,20.0,0.0
27769,2,7769,[302 427 197 180 603],383,5,33775,4.346846846846847,20.0,0.0
27770,2,7770,[ 95 176 515 202 215],263,5,33780,4.346930896924463,0.0,0.0
27771,2,7771,[302 427 197 180 603],537,5,33785,4.347014925373134,20.0,0.0
27772,2,7772,[328 100 515 173 385],92,3,33788,4.346841631287791,0.0,20.0
27773,2,7773,[302 427 197 180 603],537,5,33793,4.346925649601235,20.0,0.0
27774,2,7774,[302 427 197 180 603],664,5,33798,4.347009646302251,20.0,0.0
27775,2,7775,[302 427 197 180 603],383,5,33803,4.347093621399177,20.0,0.0
27776,2,7776,[302 427 197 180 603],339,5,33808,4.347177574900347,20.0,0.0
27777,2,7777,[302 427 197 180 603],271,5,33813,4.347261506814091,20.0,0.0
27778,2,7778,[302 427 197 180 603],664,5,33818,4.347345417148734,20.0,0.0
27779,2,7779,[302 427 197 180 603],664,5,33823,4.347429305912597,20.0,0.0
27780,2,7780,[302 427 197 180 603],90,5,33828,4.347513173113995,20.0,0.0
27781,2,7781,[302 427 197 180 603],664,5,33833,4.347597018761244,20.0,0.0
27782,2,7782,[237 186 289 257 655],95,3,33836,4.347423872542722,0.0,0.0
27783,2,7783,[ 82  56 210 183 603],840,3,33839,4.347250770811922,20.0,0.0
27784,2,7784,[302 427 197 180 603],271,5,33844,4.347334617854849,20.0,0.0
27785,2,7785,[302 427 197 180 603],474,5,33849,4.347418443359877,20.0,0.0
27786,2,7786,[302 427 197 180 603],664,5,33854,4.347502247335302,20.0,0.0
27787,2,7787,[302 427 197 180 603],664,5,33859,4.3475860297894195,20.0,0.0
27788,2,7788,[ 28 603 471  95 181],42,5,33864,4.347669790730517,20.0,0.0
27789,2,7789,[ 11 121  97 125 483],897,3,33867,4.347496790757381,20.0,0.0
27790,2,7790,[ 98  56 300 222  95],843,0,33867,4.346938775510204,0.0,20.0
27791,2,7791,[302 427 197 180 603],271,5,33872,4.347022587268994,20.0,0.0
27792,2,7792,[302 427 197 180 603],271,5,33877,4.347106377518285,20.0,0.0
27793,2,7793,[302 427 197 180 603],90,5,33882,4.3471901462663585,20.0,0.0
27794,2,7794,[508  88  64 222 194],125,4,33886,4.3471456061577936,0.0,0.0
27795,2,7795,[302 427 197 180 603],666,5,33891,4.347229348383786,20.0,0.0
27796,2,7796,[302 427 197 180 603],90,5,33896,4.347313069129152,20.0,0.0
27797,2,7797,[302 427 197 180 603],13,5,33901,4.347396768402154,20.0,0.0
27798,2,7798,[302 427 197 180 603],664,5,33906,4.347480446211053,20.0,0.0
27799,2,7799,[302 427 197 180 603],474,5,33911,4.347564102564102,20.0,0.0
27800,2,7800,[302 427 197 180 603],537,5,33916,4.347647737469555,20.0,0.0
27801,2,7801,[168 288 183 228 597],643,4,33920,4.347603178672135,0.0,0.0
27802,2,7802,[302 427 197 180 603],339,5,33925,4.347686787133154,20.0,0.0
27803,2,7803,[302 427 197 180 603],271,5,33930,4.347770374167093,20.0,0.0
27804,2,7804,[302 427 197 180 603],271,5,33935,4.3478539397821905,20.0,0.0
27805,2,7805,[268 135  79 302 132],537,3,33938,4.34768127081732,0.0,0.0
27806,2,7806,[302 427 197 180 603],666,5,33943,4.347764826437812,20.0,0.0
27807,2,7807,[302 427 197 180 603],271,5,33948,4.347848360655738,20.0,0.0
27808,2,7808,[191 597 471 118 175],308,2,33950,4.347547701370214,0.0,0.0
27809,2,7809,[302 427 197 180 603],13,5,33955,4.347631241997439,20.0,0.0
27810,2,7810,[302 427 197 180 603],339,5,33960,4.347714761234157,20.0,0.0
27811,2,7811,[302 427 197 180 603],271,5,33965,4.347798259088582,20.0,0.0
27812,2,7812,[269   8 258  12  28],271,4,33969,4.347753743760399,20.0,0.0
27813,2,7813,[302 427 197 180 603],474,5,33974,4.347837215254671,20.0,0.0
27814,2,7814,[  7  79  98 546  12],774,1,33975,4.347408829174664,20.0,20.0
27815,2,7815,[302 427 197 180 603],13,5,33980,4.347492323439099,20.0,0.0
27816,2,7816,[300 235 655  56  96],774,0,33980,4.346936164769093,0.0,0.0
27817,2,7817,[302 427 197 180 603],339,5,33985,4.347019698132515,20.0,0.0
27818,2,7818,[302 427 197 180 603],537,5,33990,4.3471032101291724,20.0,0.0
27819,2,7819,[302 427 197 180 603],537,5,33995,4.3471867007672635,20.0,0.0
27820,2,7820,[302 427 197 180 603],339,5,34000,4.34727017005498,20.0,0.0
27821,2,7821,[174 546 100 435 508],455,4,34004,4.347225773459473,0.0,40.0
27822,2,7822,[302 427 197 180 603],383,5,34009,4.347309216413141,20.0,0.0
27823,2,7823,[ 50 515 333 282 216],334,4,34013,4.347264826175869,0.0,20.0
27824,2,7824,[302 427 197 180 603],537,5,34018,4.347348242811502,20.0,0.0
27825,2,7825,[202 151 405  28   4],378,1,34019,4.346920521339126,0.0,0.0
27826,2,7826,[302 427 197 180 603],537,5,34024,4.347003960649036,20.0,0.0
27827,2,7827,[302 427 197 180 603],666,5,34029,4.347087378640777,20.0,0.0
27828,2,7828,[302 427 197 180 603],339,5,34034,4.347170775322519,20.0,0.0
27829,2,7829,[302 427 197 180 603],474,5,34039,4.347254150702427,20.0,0.0
27830,2,7830,[302 427 197 180 603],271,5,34044,4.34733750478866,20.0,0.0
27831,2,7831,[302 427 197 180 603],474,5,34049,4.347420837589377,20.0,0.0
27832,2,7832,[237 127 153 117  12],328,4,34053,4.347376484105706,20.0,20.0
27833,2,7833,[ 56 508  79 176 235],406,4,34057,4.347332141945366,0.0,0.0
27834,2,7834,[302 427 197 180 603],271,5,34062,4.347415443522655,20.0,0.0
27835,2,7835,[143 286 202  64   4],406,1,34063,4.346988259315977,0.0,0.0
27836,2,7836,[196  25 245 235  95],92,2,34065,4.346688783973459,0.0,0.0
27837,2,7837,[302 427 197 180 603],271,5,34070,4.346772135748916,20.0,0.0
27838,2,7838,[302 427 197 180 603],339,5,34075,4.346855466258451,20.0,0.0
27839,2,7839,[483 403 515 181  95],290,3,34078,4.346683673469387,20.0,0.0
27840,2,7840,[302 427 197 180 603],474,5,34083,4.346766994005867,20.0,0.0
27841,2,7841,[ 56 496  95  69 179],334,2,34085,4.3464677378219845,0.0,0.0
27842,2,7842,[204  97  88 588 187],830,3,34088,4.346296060181053,0.0,0.0
27843,2,7843,[302 427 197 180 603],13,5,34093,4.3463793982661905,20.0,0.0
27844,2,7844,[197  50 176 483 153],308,3,34096,4.346207775653283,20.0,20.0
27845,2,7845,[385 475 181 127 423],455,4,34100,4.346163650267652,0.0,20.0
27846,2,7846,[191 168  88 151  56],650,2,34102,4.345864661654136,0.0,0.0
27847,2,7847,[302 427 197 180 603],271,5,34107,4.345948012232416,20.0,0.0
27848,2,7848,[ 64  56 597 153  82],328,3,34110,4.345776532042298,0.0,0.0
27849,2,7849,[302 427 197 180 603],271,5,34115,4.345859872611465,20.0,0.0
27850,2,7850,[174  11 202 237 135],343,5,34120,4.34594319195007,0.0,20.0
27851,2,7851,[302 427 197 180 603],666,5,34125,4.346026490066225,20.0,0.0
27852,2,7852,[302 427 197 180 603],339,5,34130,4.346109766968038,20.0,0.0
27853,2,7853,[302 427 197 180 603],383,5,34135,4.346193022663611,20.0,0.0
27854,2,7854,[183 211 191 215 204],538,4,34139,4.346148949713558,0.0,0.0
27855,2,7855,[302 427 197 180 603],537,5,34144,4.346232179226069,20.0,0.0
27856,2,7856,[302 427 197 180 603],13,5,34149,4.346315387552501,20.0,0.0
27857,2,7857,[302 427 197 180 603],666,5,34154,4.346398574700942,20.0,0.0
27858,2,7858,[302 427 197 180 603],537,5,34159,4.346481740679476,20.0,0.0
27859,2,7859,[302 427 197 180 603],666,5,34164,4.346564885496183,20.0,0.0
27860,2,7860,[302 427 197 180 603],271,5,34169,4.34664800915914,20.0,0.0
27861,2,7861,[302 427 197 180 603],339,5,34174,4.3467311116764185,20.0,0.0
27862,2,7862,[179 195 173 197 204],738,4,34178,4.346687015134172,0.0,0.0
27863,2,7863,[302 427 197 180 603],339,5,34183,4.3467700915564595,20.0,0.0
27864,2,7864,[302 427 197 180 603],90,5,34188,4.346853146853147,20.0,0.0
27865,2,7865,[385  28 603 143  56],474,5,34193,4.346936181032291,20.0,0.0
27866,2,7866,[302 427 197 180 603],383,5,34198,4.347019194101945,20.0,0.0
27867,2,7867,[302 427 197 180 603],383,5,34203,4.347102186070158,20.0,0.0
27868,2,7868,[302 427 197 180 603],339,5,34208,4.347185156944974,20.0,0.0
27869,2,7869,[302 427 197 180 603],90,5,34213,4.347268106734434,20.0,0.0
27870,2,7870,[302 427 197 180 603],339,5,34218,4.347351035446576,20.0,0.0
27871,2,7871,[302 427 197 180 603],271,5,34223,4.347433943089431,20.0,0.0
27872,2,7872,[132 117 197 301 423],334,2,34225,4.3471357805156865,0.0,0.0
27873,2,7873,[302 427 197 180 603],537,5,34230,4.347218694437389,20.0,0.0
27874,2,7874,[496 100 318 161 187],334,3,34233,4.347047619047619,20.0,20.0
27875,2,7875,[ 89 385 294 237 245],653,3,34236,4.346876587100051,0.0,0.0
27876,2,7876,[302 427 197 180 603],271,5,34241,4.34695950234861,20.0,0.0
27877,2,7877,[210   7 215  28 300],843,1,34242,4.346534653465347,0.0,0.0
27878,2,7878,[302 427 197 180 603],383,5,34247,4.346617591064856,20.0,0.0
27879,2,7879,[302 427 197 180 603],383,5,34252,4.346700507614213,20.0,0.0
27880,2,7880,[302 427 197 180 603],474,5,34257,4.346783403121432,20.0,0.0
27881,2,7881,[302 427 197 180 603],474,5,34262,4.346866277594519,20.0,0.0
27882,2,7882,[302 427 197 180 603],666,5,34267,4.346949131041482,20.0,0.0
27883,2,7883,[302 427 197 180 603],271,5,34272,4.34703196347032,20.0,0.0
27884,2,7884,[302 427 197 180 603],474,5,34277,4.34711477488903,20.0,0.0
27885,2,7885,[302 427 197 180 603],537,5,34282,4.3471975653056045,20.0,0.0
27886,2,7886,[175  70  64 568 471],194,1,34283,4.346773171040954,0.0,0.0
27887,2,7887,[302 427 197 180 603],271,5,34288,4.346855983772819,20.0,0.0
27888,2,7888,[302 427 197 180 603],666,5,34293,4.346938775510204,20.0,0.0
27889,2,7889,[302 427 197 180 603],474,5,34298,4.34702154626109,20.0,0.0
27890,2,7890,[302 427 197 180 603],90,5,34303,4.347104296033456,20.0,0.0
27891,2,7891,[302 427 197 180 603],666,5,34308,4.347187024835276,20.0,0.0
27892,2,7892,[302 427 197 180 603],666,5,34313,4.347269732674522,20.0,0.0
27893,2,7893,[173 435 328 300 385],749,4,34317,4.347225741069167,0.0,0.0
27894,2,7894,[302 427 197 180 603],383,5,34322,4.3473084230525645,20.0,0.0
27895,2,7895,[100  70  56 153  22],840,2,34324,4.347011144883485,0.0,20.0
27896,2,7896,[302 427 197 180 603],13,5,34329,4.3470938331011775,20.0,0.0
27897,2,7897,[302 427 197 180 603],339,5,34334,4.347176500379843,20.0,0.0
27898,2,7898,[328 286 288   1 323],894,3,34337,4.347005950120268,0.0,0.0
27899,2,7899,[196 237 100 121 265],537,1,34338,4.346582278481013,0.0,20.0
27900,2,7900,[ 70 597 483  89 222],374,3,34341,4.346411846601696,20.0,0.0
27901,2,7901,[196  98  71 228 268],234,1,34342,4.345988357377879,0.0,20.0
27902,2,7902,[302 427 197 180 603],339,5,34347,4.34607111223586,20.0,0.0
27903,2,7903,[302 427 197 180 603],664,5,34352,4.346153846153846,20.0,0.0
27904,2,7904,[302 427 197 180 603],537,5,34357,4.346236559139785,20.0,0.0
27905,2,7905,[302 427 197 180 603],13,5,34362,4.346319251201619,20.0,0.0
27906,2,7906,[302 427 197 180 603],339,5,34367,4.346401922347288,20.0,0.0
27907,2,7907,[302 427 197 180 603],474,5,34372,4.346484572584725,20.0,0.0
27908,2,7908,[197  50 515 211   9],194,4,34376,4.346440763686939,0.0,20.0
27909,2,7909,[302 427 197 180 603],339,5,34381,4.346523388116308,20.0,0.0
27910,2,7910,[302 427 197 180 603],664,5,34386,4.346605991657186,20.0,0.0
27911,2,7911,[302 427 197 180 603],90,5,34391,4.346688574317493,20.0,0.0
27912,2,7912,[302 427 197 180 603],339,5,34396,4.3467711361051435,20.0,0.0
27913,2,7913,[302 427 197 180 603],537,5,34401,4.346853677028052,20.0,0.0
27914,2,7914,[302 427 197 180 603],537,5,34406,4.346936197094125,20.0,0.0
27915,2,7915,[302 427 197 180 603],666,5,34411,4.3470186963112685,20.0,0.0
27916,2,7916,[302 427 197 180 603],271,5,34416,4.347101174687381,20.0,0.0
27917,2,7917,[282 245 176 597 471],548,5,34421,4.347183632230362,0.0,0.0
27918,2,7918,[302 427 197 180 603],339,5,34426,4.347266068948099,20.0,0.0
27919,2,7919,[302 427 197 180 603],13,5,34431,4.347348484848485,20.0,0.0
27920,2,7920,[302 427 197 180 603],666,5,34436,4.3474308799394015,20.0,0.0
27921,2,7921,[210 100 182 191 118],454,4,34440,4.34738702347892,0.0,20.0
27922,2,7922,[ 25 313 271 143 172],650,3,34443,4.347216963271488,0.0,0.0
27923,2,7923,[ 69  98 211  97  89],271,4,34447,4.347173144876325,0.0,20.0
27924,2,7924,[302 427 197 180 603],339,5,34452,4.347255520504732,20.0,0.0
27925,2,7925,[302 427 197 180 603],666,5,34457,4.34733787534696,20.0,0.0
27926,2,7926,[302 427 197 180 603],339,5,34462,4.347420209410874,20.0,0.0
27927,2,7927,[302 427 197 180 603],474,5,34467,4.347502522704339,20.0,0.0
27928,2,7928,[302 427 197 180 603],339,5,34472,4.347584815235212,20.0,0.0
27929,2,7929,[302 427 197 180 603],271,5,34477,4.34766708701135,20.0,0.0
27930,2,7930,[289 483 172 135 196],13,4,34481,4.347623250535872,20.0,0.0
27931,2,7931,[302 427 197 180 603],13,5,34486,4.3477054967221385,20.0,0.0
27932,2,7932,[302 427 197 180 603],666,5,34491,4.347787722173201,20.0,0.0
27933,2,7933,[302 427 197 180 603],474,5,34496,4.347869926896899,20.0,0.0
27934,2,7934,[302 427 197 180 603],271,5,34501,4.347952110901071,20.0,0.0
27935,2,7935,[302 427 197 180 603],664,5,34506,4.348034274193548,20.0,0.0
27936,2,7936,[328   8 111 196 143],479,4,34510,4.347990424593675,0.0,0.0
27937,2,7937,[302 427 197 180 603],383,5,34515,4.3480725623582765,20.0,0.0
27938,2,7938,[302 427 197 180 603],383,5,34520,4.3481546794306585,20.0,0.0
27939,2,7939,[302 427 197 180 603],474,5,34525,4.3482367758186395,20.0,0.0
27940,2,7940,[204   8 211  79 135],379,5,34530,4.348318851530034,0.0,0.0
27941,2,7941,[ 50  28  22  70 515],7,3,34533,4.348149080836062,0.0,20.0
27942,2,7942,[302 427 197 180 603],537,5,34538,4.348231146921818,20.0,0.0
27943,2,7943,[546 228 135 125 111],92,3,34541,4.348061430010071,0.0,0.0
27944,2,7944,[276 173 180 210 245],92,4,34545,4.348017621145375,0.0,0.0
27945,2,7945,[180 135 143 186 403],60,3,34548,4.347847973823307,0.0,0.0
27946,2,7946,[302 427 197 180 603],383,5,34553,4.347930036491758,20.0,0.0
27947,2,7947,[186 117 222 265 194],892,4,34557,4.347886260694515,0.0,0.0
27948,2,7948,[302 427 197 180 603],664,5,34562,4.347968297899107,20.0,0.0
27949,2,7949,[302 427 197 180 603],383,5,34567,4.348050314465409,20.0,0.0
27950,2,7950,[302 427 197 180 603],90,5,34572,4.3481323104012075,20.0,0.0
27951,2,7951,[127 210 385 496  98],653,3,34575,4.347962776659959,0.0,40.0
27952,2,7952,[302 427 197 180 603],537,5,34580,4.348044762982522,20.0,0.0
27953,2,7953,[302 427 197 180 603],90,5,34585,4.348126728689968,20.0,0.0
27954,2,7954,[302 427 197 180 603],90,5,34590,4.348208673790069,20.0,0.0
27955,2,7955,[302 427 197 180 603],271,5,34595,4.348290598290598,20.0,0.0
27956,2,7956,[238 313  50 496 195],537,4,34599,4.348246826693478,0.0,20.0
27957,2,7957,[302 427 197 180 603],271,5,34604,4.3483287258105054,20.0,0.0
27958,2,7958,[302 427 197 180 603],90,5,34609,4.34841060434728,20.0,0.0
27959,2,7959,[ 22 172 175 423 302],334,4,34613,4.348366834170855,0.0,0.0
27960,2,7960,[302 427 197 180 603],90,5,34618,4.348448687350835,20.0,0.0
27961,2,7961,[202  22 496 197 125],648,3,34621,4.348279326802311,0.0,0.0
27962,2,7962,[302 427 197 180 603],474,5,34626,4.348361170413161,20.0,0.0
27963,2,7963,[302 427 197 180 603],13,5,34631,4.348442993470618,20.0,0.0
27964,2,7964,[302 427 197 180 603],271,5,34636,4.348524795982423,20.0,0.0
27965,2,7965,[302 427 197 180 603],666,5,34641,4.348606577956314,20.0,0.0
27966,2,7966,[302 427 197 180 603],90,5,34646,4.3486883394000255,20.0,0.0
27967,2,7967,[302 427 197 180 603],474,5,34651,4.348770080321285,20.0,0.0
27968,2,7968,[302 427 197 180 603],537,5,34656,4.348851800727821,20.0,0.0
27969,2,7969,[302 427 197 180 603],474,5,34661,4.348933500627353,20.0,0.0
27970,2,7970,[302 427 197 180 603],474,5,34666,4.3490151800276005,20.0,0.0
27971,2,7971,[235  71 405 195 132],313,3,34669,4.348845960863021,0.0,0.0
27972,2,7972,[302 427 197 180 603],664,5,34674,4.348927630753794,20.0,0.0
27973,2,7973,[161  56 143 515 181],13,3,34677,4.3487584650112865,0.0,0.0
27974,2,7974,[ 70 210 222 200 483],804,4,34681,4.3487147335423195,20.0,0.0
27975,2,7975,[302 427 197 180 603],474,5,34686,4.348796389167503,20.0,0.0
27976,2,7976,[302 427 197 180 603],664,5,34691,4.348878024319919,20.0,0.0
27977,2,7977,[196 403 546 269 435],343,4,34695,4.34883429430935,0.0,0.0
27978,2,7978,[237 132 125 143 185],6,2,34697,4.348539917282867,0.0,0.0
27979,2,7979,[302 427 197 180 603],383,5,34702,4.348621553884712,20.0,0.0
27980,2,7980,[423 194 197 196 143],804,3,34705,4.348452574865305,0.0,0.0
27981,2,7981,[302 427 197 180 603],271,5,34710,4.348534201954397,20.0,0.0
27982,2,7982,[125 234 258 435 588],254,2,34712,4.3482400100212955,0.0,0.0
27983,2,7983,[302 427 197 180 603],664,5,34717,4.348321643286573,20.0,0.0
27984,2,7984,[302 427 197 180 603],664,5,34722,4.348403256105197,20.0,0.0
27985,2,7985,[ 82 313 435 118 197],59,5,34727,4.348484848484849,0.0,0.0
27986,2,7986,[302 427 197 180 603],339,5,34732,4.348566420433204,20.0,0.0
27987,2,7987,[302 427 197 180 603],339,5,34737,4.348647971957937,20.0,0.0
27988,2,7988,[302 427 197 180 603],271,5,34742,4.348729503066717,20.0,0.0
27989,2,7989,[302 427 197 180 603],537,5,34747,4.348811013767209,20.0,0.0
27990,2,7990,[191  64 515 471 210],360,5,34752,4.348892504067075,0.0,0.0
27991,2,7991,[302 427 197 180 603],13,5,34757,4.348973973973974,20.0,0.0
27992,2,7992,[289 183 173 300 228],537,1,34758,4.348554985612411,0.0,0.0
27993,2,7993,[100 257 323 258 235],168,3,34761,4.348386289717288,0.0,20.0
27994,2,7994,[302 427 197 180 603],664,5,34766,4.348467792370231,20.0,0.0
27995,2,7995,[302 427 197 180 603],271,5,34771,4.348549274637318,20.0,0.0
27996,2,7996,[302 427 197 180 603],666,5,34776,4.348630736526197,20.0,0.0
27997,2,7997,[302 427 197 180 603],666,5,34781,4.3487121780445115,20.0,0.0
27998,2,7998,[302 427 197 180 603],537,5,34786,4.3487935991999,20.0,0.0
27999,2,7999,[302 427 197 180 603],90,5,34791,4.348875,20.0,0.0
28000,2,8000,[302 427 197 180 603],271,5,34796,4.348956380452443,20.0,0.0
28001,2,8001,[302 427 197 180 603],271,5,34801,4.349037740564858,20.0,0.0
28002,2,8002,[302 427 197 180 603],666,5,34806,4.34911908034487,20.0,0.0
28003,2,8003,[328 179  88  79  12],92,3,34809,4.348950524737631,20.0,0.0
28004,2,8004,[483 181  22   8 257],479,5,34814,4.349031855090568,20.0,0.0
28005,2,8005,[302 427 197 180 603],664,5,34819,4.349113165126155,20.0,0.0
28006,2,8006,[127 322  97 357 174],804,4,34823,4.349069564131385,20.0,40.0
28007,2,8007,[302 427 197 180 603],13,5,34828,4.349150849150849,20.0,0.0
28008,2,8008,[302 427 197 180 603],537,5,34833,4.349232113871894,20.0,0.0
28009,2,8009,[302 427 197 180 603],383,5,34838,4.349313358302123,20.0,0.0
28010,2,8010,[179 385 258 161 135],311,4,34842,4.349269754088128,0.0,0.0
28011,2,8011,[302 427 197 180 603],13,5,34847,4.34935097353969,20.0,0.0
28012,2,8012,[302 427 197 180 603],271,5,34852,4.3494321727193315,20.0,0.0
28013,2,8013,[302 427 197 180 603],664,5,34857,4.34951335163464,20.0,0.0
28014,2,8014,[546 216 204 288 265],650,3,34860,4.349344978165939,0.0,0.0
28015,2,8015,[405 183  69 282 216],666,1,34861,4.348927145708583,0.0,0.0
28016,2,8016,[302 427 197 180 603],537,5,34866,4.349008357240863,20.0,0.0
28017,2,8017,[  9 172  28  11  82],554,5,34871,4.349089548515839,0.0,0.0
28018,2,8018,[200  89 238 603 403],334,5,34876,4.34917071954109,20.0,0.0
28019,2,8019,[302 427 197 180 603],537,5,34881,4.349251870324189,20.0,0.0
28020,2,8020,[302 427 197 180 603],90,5,34886,4.34933300087271,20.0,0.0
28021,2,8021,[  1 258  96 143 515],843,1,34887,4.348915482423336,0.0,0.0
28022,2,8022,[302 427 197 180 603],13,5,34892,4.348996634675308,20.0,0.0
28023,2,8023,[302 427 197 180 603],271,5,34897,4.3490777666999,20.0,0.0
28024,2,8024,[302 427 197 180 603],90,5,34902,4.349158878504673,20.0,0.0
28025,2,8025,[174 568 183 153  69],92,4,34906,4.349115375031149,0.0,20.0
28026,2,8026,[302 427 197 180 603],271,5,34911,4.3491964619409496,20.0,0.0
28027,2,8027,[195 111 200 258 508],474,3,34914,4.349028400597907,0.0,0.0
28028,2,8028,[275 294  69 100 302],378,3,34917,4.348860381118445,0.0,20.0
28029,2,8029,[302 427 197 180 603],383,5,34922,4.348941469489414,20.0,0.0
28030,2,8030,[187 195 161 271 181],650,2,34924,4.348648985182418,0.0,0.0
28031,2,8031,[174 181 172 100  82],7,3,34927,4.348481075697211,0.0,40.0
28032,2,8032,[302 427 197 180 603],474,5,34932,4.348562181003361,20.0,0.0
28033,2,8033,[508  12 186 275 403],318,4,34936,4.348518795120737,20.0,0.0
28034,2,8034,[302 427 197 180 603],339,5,34941,4.348599875544493,20.0,0.0
28035,2,8035,[180 302 195  56  97],210,5,34946,4.348680935788949,0.0,0.0
28036,2,8036,[210 144 265 195 222],194,2,34948,4.348388702252084,0.0,0.0
28037,2,8037,[ 96  15  11 313 385],537,1,34949,4.347972132371237,0.0,0.0
28038,2,8038,[302 427 197 180 603],271,5,34954,4.348053240452793,20.0,0.0
28039,2,8039,[302 427 197 180 603],537,5,34959,4.348134328358209,20.0,0.0
28040,2,8040,[ 25 289 405 153  64],13,2,34961,4.347842308170626,0.0,0.0
28041,2,8041,[ 71 655   8 496  28],85,4,34965,4.3477990549614525,0.0,0.0
28042,2,8042,[  4 286 180 179 300],234,1,34966,4.347382817356707,0.0,0.0
28043,2,8043,[302 427 197 180 603],664,5,34971,4.347463948284435,20.0,0.0
28044,2,8044,[302 427 197 180 603],383,5,34976,4.347545059042884,20.0,0.0
28045,2,8045,[302 427 197 180 603],664,5,34981,4.347626149639573,20.0,0.0
28046,2,8046,[302 427 197 180 603],271,5,34986,4.347707220082018,20.0,0.0
28047,2,8047,[302 427 197 180 603],339,5,34991,4.347788270377734,20.0,0.0
28048,2,8048,[179 216  69 185 144],7,5,34996,4.347869300534228,0.0,0.0
28049,2,8049,[ 69 151  56 228 588],804,3,34999,4.347701863354037,0.0,0.0
28050,2,8050,[  8 322 471 655 313],308,2,35001,4.347410259595081,0.0,0.0
28051,2,8051,[302 427 197 180 603],474,5,35006,4.3474913065077,20.0,0.0
28052,2,8052,[302 427 197 180 603],271,5,35011,4.347572333291941,20.0,0.0
28053,2,8053,[302 427 197 180 603],537,5,35016,4.3476533399553015,20.0,0.0
28054,2,8054,[403 196 423 183  89],59,5,35021,4.347734326505276,0.0,0.0
28055,2,8055,[302 427 197 180 603],383,5,35026,4.347815292949354,20.0,0.0
28056,2,8056,[258 173   9  95  71],378,5,35031,4.347896239295023,0.0,0.0
28057,2,8057,[ 22  71 435  15   8],234,2,35033,4.347604864730703,0.0,0.0
28058,2,8058,[302 427 197 180 603],13,5,35038,4.3476858170988955,20.0,0.0
28059,2,8059,[302 427 197 180 603],383,5,35043,4.347766749379653,20.0,0.0
28060,2,8060,[302 427 197 180 603],339,5,35048,4.347847661580449,20.0,0.0
28061,2,8061,[603  28 181 135 275],843,1,35049,4.34743239890846,20.0,0.0
28062,2,8062,[302 427 197 180 603],13,5,35054,4.347513332506511,20.0,0.0
28063,2,8063,[302 427 197 180 603],13,5,35059,4.347594246031746,20.0,0.0
28064,2,8064,[568 222  28 288 121],537,0,35059,4.347055176689398,0.0,0.0
28065,2,8065,[ 70 187 210 235  28],271,4,35063,4.347012149764443,0.0,0.0
28066,2,8066,[302 427 197 180 603],271,5,35068,4.347093095326639,20.0,0.0
28067,2,8067,[302 427 197 180 603],664,5,35073,4.3471740208230045,20.0,0.0
28068,2,8068,[200 313  56 678 153],13,3,35076,4.3470070640723755,0.0,0.0
28069,2,8069,[111 508 237 742   9],486,4,35080,4.346964064436183,0.0,0.0
28070,2,8070,[216 222 286  70 471],378,3,35083,4.346797175071242,0.0,0.0
28071,2,8071,[302 427 197 180 603],537,5,35088,4.346878097125868,20.0,0.0
28072,2,8072,[302 427 197 180 603],666,5,35093,4.346958999132912,20.0,0.0
28073,2,8073,[302 427 197 180 603],339,5,35098,4.3470398810998265,20.0,0.0
28074,2,8074,[302 427 197 180 603],664,5,35103,4.347120743034056,20.0,0.0
28075,2,8075,[302 427 197 180 603],664,5,35108,4.347201584943041,20.0,0.0
28076,2,8076,[302 427 197 180 603],90,5,35113,4.34728240683422,20.0,0.0
28077,2,8077,[302 427 197 180 603],474,5,35118,4.347363208715029,20.0,0.0
28078,2,8078,[302 427 197 180 603],383,5,35123,4.347443990592895,20.0,0.0
28079,2,8079,[302 427 197 180 603],664,5,35128,4.347524752475247,20.0,0.0
28080,2,8080,[302 427 197 180 603],13,5,35133,4.347605494369509,20.0,0.0
28081,2,8081,[302 427 197 180 603],13,5,35138,4.3476862162830985,20.0,0.0
28082,2,8082,[191 121  22 144 161],95,4,35142,4.3476432017815165,0.0,0.0
28083,2,8083,[302 427 197 180 603],537,5,35147,4.347723899059871,20.0,0.0
28084,2,8084,[196  96  22 568 234],749,5,35152,4.347804576376005,0.0,0.0
28085,2,8085,[302 427 197 180 603],271,5,35157,4.3478852337373235,20.0,0.0
28086,2,8086,[172 238 273 135 289],537,2,35159,4.347594905403734,0.0,0.0
28087,2,8087,[302 427 197 180 603],666,5,35164,4.347675568743818,20.0,0.0
28088,2,8088,[302 427 197 180 603],474,5,35169,4.347756212139943,20.0,0.0
28089,2,8089,[ 98 286 197  79  56],664,5,35174,4.347836835599505,0.0,20.0
28090,2,8090,[ 82 235  96 168 121],901,4,35178,4.347793845012977,0.0,0.0
28091,2,8091,[302 427 197 180 603],537,5,35183,4.347874443895205,20.0,0.0
28092,2,8092,[655 151   8 210 273],7,4,35187,4.3478314592858025,0.0,0.0
28093,2,8093,[302 427 197 180 603],90,5,35192,4.34791203360514,20.0,0.0
28094,2,8094,[173  98 180 187 222],524,3,35195,4.3477455219271155,0.0,20.0
28095,2,8095,[302 427 197 180 603],537,5,35200,4.3478260869565215,20.0,0.0
28096,2,8096,[302 427 197 180 603],90,5,35205,4.347906632085958,20.0,0.0
28097,2,8097,[143  11 186  64 125],64,4,35209,4.347863670041986,0.0,0.0
28098,2,8098,[302 427 197 180 603],474,5,35214,4.34794419064082,20.0,0.0
28099,2,8099,[302 427 197 180 603],13,5,35219,4.348024691358025,20.0,0.0
28100,2,8100,[302 427 197 180 603],537,5,35224,4.348105172200963,20.0,0.0
28101,2,8101,[302 427 197 180 603],666,5,35229,4.3481856331769935,20.0,0.0
28102,2,8102,[215 268 276 132  22],664,3,35232,4.348019252128841,0.0,0.0
28103,2,8103,[210 187 194 271  89],890,4,35236,4.347976307996051,0.0,0.0
28104,2,8104,[302 427 197 180 603],474,5,35241,4.348056755089451,20.0,0.0
28105,2,8105,[302 427 197 180 603],474,5,35246,4.3481371823340735,20.0,0.0
28106,2,8106,[302 427 197 180 603],474,5,35251,4.348217589737264,20.0,0.0
28107,2,8107,[ 28 196 172 132  64],311,5,35256,4.348297977306364,0.0,0.0
28108,2,8108,[302 427 197 180 603],383,5,35261,4.348378345048712,20.0,0.0
28109,2,8109,[ 56 483 655 435 151],666,4,35265,4.348335388409371,20.0,0.0
28110,2,8110,[302  28 294  88 185],271,3,35268,4.348169153002096,0.0,0.0
28111,2,8111,[302 427 197 180 603],537,5,35273,4.348249506903353,20.0,0.0
28112,2,8112,[  8 172   1  22  89],454,2,35275,4.3479600640946625,0.0,0.0
28113,2,8113,[257 515  25 186 202],95,4,35279,4.3479171801824,0.0,0.0
28114,2,8114,[ 69 588 405 216  12],537,0,35279,4.347381392483056,20.0,0.0
28115,2,8115,[302 427 197 180 603],13,5,35284,4.347461803844258,20.0,0.0
28116,2,8116,[302 427 197 180 603],666,5,35289,4.3475421953923865,20.0,0.0
28117,2,8117,[ 69  64 143 117  12],892,4,35293,4.34749938408475,20.0,0.0
28118,2,8118,[302 427 197 180 603],383,5,35298,4.347579751200887,20.0,0.0
28119,2,8119,[228 546 301 435 179],13,2,35300,4.347290640394089,0.0,0.0
28120,2,8120,[302 427 197 180 603],271,5,35305,4.347371013421992,20.0,0.0
28121,2,8121,[302 427 197 180 603],664,5,35310,4.347451366658459,20.0,0.0
28122,2,8122,[302 427 197 180 603],271,5,35315,4.347531700110797,20.0,0.0
28123,2,8123,[302 427 197 180 603],13,5,35320,4.347612013786312,20.0,0.0
28124,2,8124,[302 427 197 180 603],383,5,35325,4.3476923076923075,20.0,0.0
28125,2,8125,[302 427 197 180 603],271,5,35330,4.3477725818360815,20.0,0.0
28126,2,8126,[302 427 197 180 603],271,5,35335,4.347852836224929,20.0,0.0
28127,2,8127,[302 427 197 180 603],537,5,35340,4.347933070866142,20.0,0.0
28128,2,8128,[302 427 197 180 603],537,5,35345,4.348013285767007,20.0,0.0
28129,2,8129,[302 427 197 180 603],474,5,35350,4.34809348093481,20.0,0.0
28130,2,8130,[302 427 197 180 603],664,5,35355,4.348173656376829,20.0,0.0
28131,2,8131,[313 435 204 175 273],102,2,35357,4.347884899163797,0.0,0.0
28132,2,8132,[289  88   4 180 546],92,2,35359,4.347596212959547,0.0,0.0
28133,2,8133,[282   4 328 235   9],92,3,35362,4.347430538480452,0.0,0.0
28134,2,8134,[302 427 197 180 603],664,5,35367,4.347510755992625,20.0,0.0
28135,2,8135,[ 95  79  15 195 286],648,2,35369,4.347222222222222,0.0,0.0
28136,2,8136,[125 216 238  89 471],311,5,35374,4.347302445618778,0.0,0.0
28137,2,8137,[302 427 197 180 603],90,5,35379,4.347382649299583,20.0,0.0
28138,2,8138,[100 185 483 135 271],749,4,35383,4.347339968055044,20.0,20.0
28139,2,8139,[302 427 197 180 603],666,5,35388,4.347420147420148,20.0,0.0
28140,2,8140,[302 427 197 180 603],13,5,35393,4.347500307087581,20.0,0.0
28141,2,8141,[ 50 318 588 228 181],13,4,35397,4.3474576271186445,20.0,20.0
28142,2,8142,[302 427 197 180 603],474,5,35402,4.347537762495395,20.0,0.0
28143,2,8143,[302 427 197 180 603],474,5,35407,4.347617878192534,20.0,0.0
28144,2,8144,[174 238 216 200 121],13,2,35409,4.347329650092081,0.0,20.0
28145,2,8145,[423  56  89 175  88],343,4,35413,4.347287012030445,0.0,0.0
28146,2,8146,[302 427 197 180 603],271,5,35418,4.3473671290045415,20.0,0.0
28147,2,8147,[302 427 197 180 603],383,5,35423,4.347447226313205,20.0,0.0
28148,2,8148,[ 22 475 385  25   4],648,2,35425,4.347159160633207,0.0,0.0
28149,2,8149,[302 427 197 180 603],383,5,35430,4.347239263803681,20.0,0.0
28150,2,8150,[302 427 197 180 603],666,5,35435,4.347319347319347,20.0,0.0
28151,2,8151,[302 427 197 180 603],339,5,35440,4.347399411187439,20.0,0.0
28152,2,8152,[435 496 181 132 294],533,5,35445,4.3474794554151845,0.0,0.0
28153,2,8153,[172 742 211  79   1],313,4,35449,4.347436840814324,0.0,0.0
28154,2,8154,[302 427 197 180 603],271,5,35454,4.347516860821582,20.0,0.0
28155,2,8155,[302 427 197 180 603],666,5,35459,4.3475968612064735,20.0,0.0
28156,2,8156,[276 175  89 357 238],6,4,35463,4.347554247885252,20.0,0.0
28157,2,8157,[302 427 197 180 603],537,5,35468,4.347634224074528,20.0,0.0
28158,2,8158,[748 186  71 187 191],648,2,35470,4.347346488540262,0.0,0.0
28159,2,8159,[173 197 127 273 216],374,3,35473,4.34718137254902,0.0,20.0
28160,2,8160,[302 427 197 180 603],664,5,35478,4.347261365028795,20.0,0.0
28161,2,8161,[302 427 197 180 603],537,5,35483,4.347341337907376,20.0,0.0
28162,2,8162,[302 427 197 180 603],664,5,35488,4.347421291191964,20.0,0.0
28163,2,8163,[302 427 197 180 603],664,5,35493,4.3475012248897595,20.0,0.0
28164,2,8164,[ 15 655 204 423   9],378,5,35498,4.347581139007961,0.0,0.0
28165,2,8165,[288 265 216 151 423],892,5,35503,4.347661033553759,0.0,0.0
28166,2,8166,[385 135 237 427 153],343,4,35507,4.347618464552467,0.0,0.0
28167,2,8167,[172  11 181 182 269],334,2,35509,4.3473310479921645,0.0,0.0
28168,2,8168,[135 269  11 322 153],13,2,35511,4.347043701799486,0.0,0.0
28169,2,8169,[302 427 197 180 603],383,5,35516,4.347123623011016,20.0,0.0
28170,2,8170,[121 234 132 423  22],653,2,35518,4.346836372537021,0.0,0.0
28171,2,8171,[258 176 197  28  50],59,4,35522,4.346793930494371,0.0,20.0
28172,2,8172,[302 427 197 180 603],666,5,35527,4.34687385293038,20.0,0.0
28173,2,8173,[302 427 197 180 603],537,5,35532,4.346953755811108,20.0,0.0
28174,2,8174,[302 427 197 180 603],474,5,35537,4.3470336391437305,20.0,0.0
28175,2,8175,[302 427 197 180 603],383,5,35542,4.347113502935421,20.0,0.0
28176,2,8176,[302 427 197 180 603],537,5,35547,4.347193347193347,20.0,0.0
28177,2,8177,[302 427 197 180 603],13,5,35552,4.347273171924676,20.0,0.0
28178,2,8178,[302 427 197 180 603],664,5,35557,4.347352977136569,20.0,0.0
28179,2,8179,[302 427 197 180 603],90,5,35562,4.347432762836186,20.0,0.0
28180,2,8180,[ 15 118   4  98 238],92,3,35565,4.347268060139347,0.0,20.0
28181,2,8181,[302 427 197 180 603],664,5,35570,4.347347836714739,20.0,0.0
28182,2,8182,[204  96  95  69 132],200,5,35575,4.347427593792008,0.0,0.0
28183,2,8183,[302 427 197 180 603],383,5,35580,4.347507331378299,20.0,0.0
28184,2,8184,[568 182  82 210 127],804,4,35584,4.347464874770923,0.0,20.0
28185,2,8185,[ 97   8 286 427 385],452,5,35589,4.347544588321525,0.0,0.0
28186,2,8186,[302 427 197 180 603],90,5,35594,4.347624282398925,20.0,0.0
28187,2,8187,[302 427 197 180 603],666,5,35599,4.347703957010259,20.0,0.0
28188,2,8188,[ 96 195 294 427 286],666,2,35601,4.347417267065576,0.0,0.0
28189,2,8189,[257 118 215 286 197],479,2,35603,4.347130647130647,0.0,0.0
28190,2,8190,[302 427 197 180 603],537,5,35608,4.347210352826273,20.0,0.0
28191,2,8191,[302 427 197 180 603],474,5,35613,4.3472900390625,20.0,0.0
28192,2,8192,[302 427 197 180 603],383,5,35618,4.347369705846455,20.0,0.0
28193,2,8193,[302 427 197 180 603],339,5,35623,4.347449353185257,20.0,0.0
28194,2,8194,[302 427 197 180 603],13,5,35628,4.347528981086028,20.0,0.0
28195,2,8195,[302 427 197 180 603],666,5,35633,4.347608589555881,20.0,0.0
28196,2,8196,[302 427 197 180 603],339,5,35638,4.347688178601928,20.0,0.0
28197,2,8197,[172 333 265 222  97],64,3,35641,4.347523786289339,0.0,0.0
28198,2,8198,[271 655 168 568 403],102,0,35641,4.346993535797049,0.0,0.0
28199,2,8199,[ 71 118 168 546 288],479,1,35642,4.346585365853659,0.0,0.0
28200,2,8200,[302 427 197 180 603],13,5,35647,4.346665040848677,20.0,0.0
28201,2,8201,[302 427 197 180 603],383,5,35652,4.3467446964155085,20.0,0.0
28202,2,8202,[ 97 357 237 276 294],308,2,35654,4.34645861270267,20.0,0.0
28203,2,8203,[748 515 210 191 174],882,5,35659,4.346538274012676,0.0,20.0
28204,2,8204,[121 172 234 427   9],7,5,35664,4.346617915904936,0.0,0.0
28205,2,8205,[302 427 197 180 603],474,5,35669,4.346697538386547,20.0,0.0
28206,2,8206,[ 69 174 132  56 175],664,4,35673,4.346655294260997,0.0,20.0
28207,2,8207,[302 427 197 180 603],383,5,35678,4.3467348927875245,20.0,0.0
28208,2,8208,[302 427 197 180 603],13,5,35683,4.346814471921062,20.0,0.0
28209,2,8209,[302 427 197 180 603],537,5,35688,4.346894031668697,20.0,0.0
28210,2,8210,[100 257 289  82 172],378,5,35693,4.346973572037511,0.0,20.0
28211,2,8211,[  9 257 204 403  12],378,5,35698,4.347053093034583,20.0,0.0
28212,2,8212,[302 427 197 180 603],339,5,35703,4.347132594666991,20.0,0.0
28213,2,8213,[302 427 197 180 603],537,5,35708,4.347212076941807,20.0,0.0
28214,2,8214,[302 427 197 180 603],383,5,35713,4.347291539866099,20.0,0.0
28215,2,8215,[187 176 204  70 294],271,3,35716,4.347127555988315,0.0,0.0
28216,2,8216,[302 427 197 180 603],90,5,35721,4.3472070098576125,20.0,0.0
28217,2,8217,[185  70 318  25 568],42,3,35724,4.347043076174252,20.0,0.0
28218,2,8218,[302 427 197 180 603],13,5,35729,4.347122520987955,20.0,0.0
28219,2,8219,[121  11 183  89 168],653,2,35731,4.3468369829683695,0.0,0.0
28220,2,8220,[ 28  69  50 237 238],378,3,35734,4.346673154117504,0.0,20.0
28221,2,8221,[ 12 197 211 300 318],234,2,35736,4.346387740209195,40.0,0.0
28222,2,8222,[302 427 197 180 603],474,5,35741,4.34646722607321,20.0,0.0
28223,2,8223,[302 427 197 180 603],13,5,35746,4.346546692607004,20.0,0.0
28224,2,8224,[302 427 197 180 603],13,5,35751,4.346626139817629,20.0,0.0
28225,2,8225,[  4 132 276 151  79],308,4,35755,4.346584001945052,0.0,0.0
28226,2,8226,[302 427 197 180 603],666,5,35760,4.346663425306916,20.0,0.0
28227,2,8227,[ 64 238 181 678 100],213,5,35765,4.3467428293631505,0.0,20.0
28228,2,8228,[302 427 197 180 603],537,5,35770,4.346822214120793,20.0,0.0
28229,2,8229,[302 427 197 180 603],339,5,35775,4.346901579586877,20.0,0.0
28230,2,8230,[405 179 568 118 182],774,2,35777,4.346616450006074,0.0,0.0
28231,2,8231,[515 568  56 187 125],804,4,35781,4.346574344023324,0.0,0.0
28232,2,8232,[ 79 132  25 483 568],194,1,35782,4.346167861047006,20.0,0.0
28233,2,8233,[302 427 197 180 603],90,5,35787,4.346247267427739,20.0,0.0
28234,2,8234,[302 427 197 180 603],13,5,35792,4.346326654523375,20.0,0.0
28235,2,8235,[302 427 197 180 603],383,5,35797,4.346406022340942,20.0,0.0
28236,2,8236,[302 427 197 180 603],666,5,35802,4.346485370887459,20.0,0.0
28237,2,8237,[302 427 197 180 603],537,5,35807,4.346564700169944,20.0,0.0
28238,2,8238,[117 100  89 174  71],6,4,35811,4.346522636242263,0.0,40.0
28239,2,8239,[302 427 197 180 603],271,5,35816,4.346601941747573,20.0,0.0
28240,2,8240,[127 172 143 197 176],406,4,35820,4.346559883509283,0.0,20.0
28241,2,8241,[237  98 172 427 515],899,4,35824,4.346517835476826,0.0,20.0
28242,2,8242,[302 427 197 180 603],474,5,35829,4.346597112701686,20.0,0.0
28243,2,8243,[302 427 197 180 603],90,5,35834,4.346676370693838,20.0,0.0
28244,2,8244,[302 427 197 180 603],271,5,35839,4.346755609460279,20.0,0.0
28245,2,8245,[302 427 197 180 603],537,5,35844,4.346834829008004,20.0,0.0
28246,2,8246,[271 655 403 322 275],328,2,35846,4.346550260700861,0.0,0.0
28247,2,8247,[ 28 191 135 185 183],311,4,35850,4.34650824442289,0.0,0.0
28248,2,8248,[302 427 197 180 603],90,5,35855,4.346587465147291,20.0,0.0
28249,2,8249,[ 95  98 238 194 196],749,3,35858,4.346424242424242,0.0,20.0
28250,2,8250,[302 427 197 180 603],474,5,35863,4.346503454126773,20.0,0.0
28251,2,8251,[302 427 197 180 603],474,5,35868,4.34658264663112,20.0,0.0
28252,2,8252,[302 427 197 180 603],383,5,35873,4.346661819944263,20.0,0.0
28253,2,8253,[302 427 197 180 603],271,5,35878,4.346740974073176,20.0,0.0
28254,2,8254,[302 427 197 180 603],666,5,35883,4.346820109024834,20.0,0.0
28255,2,8255,[302 427 197 180 603],666,5,35888,4.346899224806202,20.0,0.0
28256,2,8256,[302 427 197 180 603],90,5,35893,4.346978321424246,20.0,0.0
28257,2,8257,[302 427 197 180 603],90,5,35898,4.347057398885929,20.0,0.0
28258,2,8258,[302 427 197 180 603],13,5,35903,4.347136457198208,20.0,0.0
28259,2,8259,[302 427 197 180 603],664,5,35908,4.3472154963680385,20.0,0.0
28260,2,8260,[302 427 197 180 603],13,5,35913,4.347294516402372,20.0,0.0
28261,2,8261,[302 427 197 180 603],339,5,35918,4.347373517308158,20.0,0.0
28262,2,8262,[ 97 202 655  89 435],194,2,35920,4.3470894348299645,0.0,0.0
28263,2,8263,[302 427 197 180 603],271,5,35925,4.3471684414327205,20.0,0.0
28264,2,8264,[302 427 197 180 603],666,5,35930,4.347247428917121,20.0,0.0
28265,2,8265,[603 273 237 211 508],13,3,35933,4.347084442293734,20.0,0.0
28266,2,8266,[496 183  64 210 323],254,4,35937,4.347042457965404,0.0,0.0
28267,2,8267,[204 173 202 153 186],579,3,35940,4.346879535558781,0.0,0.0
28268,2,8268,[302 427 197 180 603],13,5,35945,4.346958519772645,20.0,0.0
28269,2,8269,[302 427 197 180 603],339,5,35950,4.347037484885127,20.0,0.0
28270,2,8270,[603 183 202 121 185],897,4,35954,4.346995526538508,20.0,0.0
28271,2,8271,[302 427 197 180 603],664,5,35959,4.347074468085107,20.0,0.0
28272,2,8272,[302 427 197 180 603],271,5,35964,4.3471533905475646,20.0,0.0
28273,2,8273,[302 427 197 180 603],664,5,35969,4.347232293932802,20.0,0.0
28274,2,8274,[302 427 197 180 603],383,5,35974,4.347311178247734,20.0,0.0
28275,2,8275,[302 427 197 180 603],271,5,35979,4.347390043499275,20.0,0.0
28276,2,8276,[302 427 197 180 603],666,5,35984,4.347468889694333,20.0,0.0
28277,2,8277,[302 427 197 180 603],339,5,35989,4.3475477168398164,20.0,0.0
28278,2,8278,[302 427 197 180 603],537,5,35994,4.347626524942626,20.0,0.0
28279,2,8279,[328 204 238 265 546],479,4,35998,4.347584541062802,0.0,0.0
28280,2,8280,[357 176 234 313 215],59,5,36003,4.3476633256853034,20.0,0.0
28281,2,8281,[588 179 294 269 173],537,2,36005,4.347379859937213,0.0,0.0
28282,2,8282,[302 427 197 180 603],90,5,36010,4.347458650247495,20.0,0.0
28283,2,8283,[ 96 180 268 202 187],537,3,36013,4.3472959922742636,0.0,0.0
28284,2,8284,[603 186 403  22 228],648,5,36018,4.3473747736873865,20.0,0.0
28285,2,8285,[302 427 197 180 603],666,5,36023,4.347453536084963,20.0,0.0
28286,2,8286,[302 427 197 180 603],90,5,36028,4.347532279473874,20.0,0.0
28287,2,8287,[302 427 197 180 603],664,5,36033,4.347611003861004,20.0,0.0
28288,2,8288,[235 100 471 288 200],447,3,36036,4.3474484256243215,0.0,20.0
28289,2,8289,[405 144 161 125 288],378,2,36038,4.347165259348613,0.0,0.0
28290,2,8290,[588  89  12 215 597],59,3,36041,4.347002774092389,20.0,0.0
28291,2,8291,[302 427 197 180 603],90,5,36046,4.34708152436083,20.0,0.0
28292,2,8292,[302 427 197 180 603],383,5,36051,4.347160255637284,20.0,0.0
28293,2,8293,[302 427 197 180 603],383,5,36056,4.347238967928623,20.0,0.0
28294,2,8294,[302 427 197 180 603],666,5,36061,4.3473176612417115,20.0,0.0
28295,2,8295,[302 427 197 180 603],537,5,36066,4.347396335583413,20.0,0.0
28296,2,8296,[302 427 197 180 603],339,5,36071,4.347474990960588,20.0,0.0
28297,2,8297,[180 204   8  71 471],13,4,36075,4.347433116413594,0.0,0.0
28298,2,8298,[302 427 197 180 603],13,5,36080,4.347511748403422,20.0,0.0
28299,2,8299,[ 70 185 127 237 216],452,3,36083,4.347349397590362,0.0,20.0
28300,2,8300,[302 427 197 180 603],383,5,36088,4.347428020720395,20.0,0.0
28301,2,8301,[423 238 216 313 100],474,5,36093,4.34750662490966,0.0,20.0
28302,2,8302,[515 271  12  79  69],334,3,36096,4.34734433337348,20.0,0.0
28303,2,8303,[271  82  12 508 100],940,3,36099,4.347182080924855,20.0,20.0
28304,2,8304,[302 427 197 180 603],664,5,36104,4.347260686333534,20.0,0.0
28305,2,8305,[302 427 197 180 603],537,5,36109,4.347339272814833,20.0,0.0
28306,2,8306,[302 427 197 180 603],664,5,36114,4.347417840375587,20.0,0.0
28307,2,8307,[302 427 197 180 603],664,5,36119,4.347496389022629,20.0,0.0
28308,2,8308,[302 427 197 180 603],339,5,36124,4.3475749187627875,20.0,0.0
28309,2,8309,[ 97 202 276 100 313],234,2,36126,4.347292418772563,0.0,20.0
28310,2,8310,[568 318 357  12 211],774,0,36126,4.34676934183612,60.0,0.0
28311,2,8311,[  4 183 202  89 286],666,5,36131,4.346847930702599,0.0,0.0
28312,2,8312,[302 427 197 180 603],339,5,36136,4.346926500661614,20.0,0.0
28313,2,8313,[302 427 197 180 603],383,5,36141,4.34700505171999,20.0,0.0
28314,2,8314,[471 588 597 222 655],378,2,36143,4.346722790138304,0.0,0.0
28315,2,8315,[302 427 197 180 603],90,5,36148,4.346801346801347,20.0,0.0
28316,2,8316,[ 64 742 257 121 174],271,3,36151,4.34663941324997,0.0,20.0
28317,2,8317,[302 427 197 180 603],13,5,36156,4.346717961048329,20.0,0.0
28318,2,8318,[302 427 197 180 603],13,5,36161,4.346796489962736,20.0,0.0
28319,2,8319,[302 427 197 180 603],664,5,36166,4.346875,20.0,0.0
28320,2,8320,[302 427 197 180 603],339,5,36171,4.346953491166927,20.0,0.0
28321,2,8321,[265 176 423 200  70],653,2,36173,4.346671473203557,0.0,0.0
28322,2,8322,[132   7 235 405 271],328,3,36176,4.346509671993272,0.0,0.0
28323,2,8323,[302 427 197 180 603],339,5,36181,4.346588178760212,20.0,0.0
28324,2,8324,[302 427 197 180 603],666,5,36186,4.346666666666667,20.0,0.0
28325,2,8325,[121 435 222 151 265],650,3,36189,4.346504924333414,0.0,0.0
28326,2,8326,[302 427 197 180 603],383,5,36194,4.346583403386574,20.0,0.0
28327,2,8327,[100  69 125   9 143],311,3,36197,4.346421709894332,0.0,20.0
28328,2,8328,[302 427 197 180 603],666,5,36202,4.346500180093649,20.0,0.0
28329,2,8329,[302 427 197 180 603],90,5,36207,4.346578631452581,20.0,0.0
28330,2,8330,[302 427 197 180 603],537,5,36212,4.346657063977914,20.0,0.0
28331,2,8331,[302 427 197 180 603],339,5,36217,4.346735477676428,20.0,0.0
28332,2,8332,[302 427 197 180 603],271,5,36222,4.346813872554902,20.0,0.0
28333,2,8333,[302 427 197 180 603],666,5,36227,4.346892248620111,20.0,0.0
28334,2,8334,[655   7  50 117 183],184,2,36229,4.346610677864427,0.0,20.0
28335,2,8335,[302 427 197 180 603],271,5,36234,4.346689059500959,20.0,0.0
28336,2,8336,[302 427 197 180 603],271,5,36239,4.346767422334173,20.0,0.0
28337,2,8337,[302 427 197 180 603],537,5,36244,4.346845766370833,20.0,0.0
28338,2,8338,[302 427 197 180 603],664,5,36249,4.3469240916177,20.0,0.0
28339,2,8339,[302 427 197 180 603],339,5,36254,4.347002398081535,20.0,0.0
28340,2,8340,[179  15 245 258   1],894,4,36258,4.346960796067618,0.0,0.0
28341,2,8341,[302 427 197 180 603],383,5,36263,4.347039079357468,20.0,0.0
28342,2,8342,[302 427 197 180 603],271,5,36268,4.347117343881098,20.0,0.0
28343,2,8343,[302 427 197 180 603],13,5,36273,4.347195589645254,20.0,0.0
28344,2,8344,[302 427 197 180 603],13,5,36278,4.3472738166566804,20.0,0.0
28345,2,8345,[194 210 151  82 191],64,2,36280,4.346992571291636,0.0,0.0
28346,2,8346,[121 275 238  88 385],308,4,36284,4.346951000359411,0.0,0.0
28347,2,8347,[ 98  89 313 275  82],537,3,36287,4.34678965021562,0.0,20.0
28348,2,8348,[302 427 197 180 603],474,5,36292,4.346867888369864,20.0,0.0
28349,2,8349,[302 427 197 180 603],339,5,36297,4.346946107784431,20.0,0.0
28350,2,8350,[302 427 197 180 603],90,5,36302,4.347024308466052,20.0,0.0
28351,2,8351,[302 427 197 180 603],666,5,36307,4.347102490421456,20.0,0.0
28352,2,8352,[302 427 197 180 603],13,5,36312,4.347180653657369,20.0,0.0
28353,2,8353,[302 427 197 180 603],271,5,36317,4.347258798180512,20.0,0.0
28354,2,8354,[176 322 222 202 210],311,5,36322,4.347336923997606,0.0,0.0
28355,2,8355,[302 427 197 180 603],90,5,36327,4.347415031115366,20.0,0.0
28356,2,8356,[302 427 197 180 603],383,5,36332,4.347493119540505,20.0,0.0
28357,2,8357,[302 427 197 180 603],537,5,36337,4.347571189279732,20.0,0.0
28358,2,8358,[216  69 127 483  50],374,3,36340,4.347409977270009,20.0,40.0
28359,2,8359,[ 15 202 276  22 185],311,4,36344,4.347368421052631,0.0,0.0
28360,2,8360,[302 427 197 180 603],13,5,36349,4.347446477694056,20.0,0.0
28361,2,8361,[ 79 546 471 197 186],343,4,36353,4.3474049270509445,0.0,0.0
28362,2,8362,[302 427 197 180 603],271,5,36358,4.3474829606600505,20.0,0.0
28363,2,8363,[300 475 238 183 271],537,2,36360,4.347202295552368,0.0,0.0
28364,2,8364,[302 427 197 180 603],13,5,36365,4.347280334728033,20.0,0.0
28365,2,8365,[ 15  79 161  88 258],378,5,36370,4.34735835524743,0.0,0.0
28366,2,8366,[175  98 748 182 197],474,4,36374,4.347316839966536,0.0,20.0
28367,2,8367,[423 237  50 132 125],92,3,36377,4.347155831739962,0.0,20.0
28368,2,8368,[186 202 294 289 100],579,3,36380,4.34699486199068,0.0,20.0
28369,2,8369,[385 183 111  88 742],42,4,36384,4.3469534050179215,0.0,0.0
28370,2,8370,[302 427 197 180 603],474,5,36389,4.347031417990682,20.0,0.0
28371,2,8371,[302 427 197 180 603],90,5,36394,4.3471094123268035,20.0,0.0
28372,2,8372,[302 427 197 180 603],90,5,36399,4.347187388032963,20.0,0.0
28373,2,8373,[302 427 197 180 603],90,5,36404,4.347265345115835,20.0,0.0
28374,2,8374,[302 427 197 180 603],664,5,36409,4.34734328358209,20.0,0.0
28375,2,8375,[302 427 197 180 603],339,5,36414,4.347421203438396,20.0,0.0
28376,2,8376,[176 202 265  69  82],42,3,36417,4.347260355735943,0.0,0.0
28377,2,8377,[302 427 197 180 603],537,5,36422,4.347338266889472,20.0,0.0
28378,2,8378,[127  12 508 603 125],59,4,36426,4.347296813462227,40.0,20.0
28379,2,8379,[234 471  28  25  69],343,3,36429,4.347136038186157,0.0,0.0
28380,2,8380,[195  82 313 427 655],308,4,36433,4.3470946187805755,0.0,0.0
28381,2,8381,[302 427 197 180 603],383,5,36438,4.347172512526844,20.0,0.0
28382,2,8382,[302 427 197 180 603],666,5,36443,4.347250387689371,20.0,0.0
28383,2,8383,[302 427 197 180 603],13,5,36448,4.347328244274809,20.0,0.0
28384,2,8384,[302 427 197 180 603],271,5,36453,4.347406082289803,20.0,0.0
28385,2,8385,[515 200 496 471 195],7,4,36457,4.347364655378011,0.0,0.0
28386,2,8386,[302 427 197 180 603],90,5,36462,4.347442470490044,20.0,0.0
28387,2,8387,[302 427 197 180 603],90,5,36467,4.347520267048164,20.0,0.0
28388,2,8388,[121 161 135 196 265],474,5,36472,4.347598045059006,0.0,0.0
28389,2,8389,[302 427 197 180 603],90,5,36477,4.347675804529201,20.0,0.0
28390,2,8390,[174  88 603  97 313],234,2,36479,4.3473960195447505,20.0,20.0
28391,2,8391,[302 427 197 180 603],271,5,36484,4.347473784556721,20.0,0.0
28392,2,8392,[302 427 197 180 603],537,5,36489,4.3475515310377695,20.0,0.0
28393,2,8393,[302 427 197 180 603],271,5,36494,4.34762925899452,20.0,0.0
28394,2,8394,[ 50 143 483 186 174],95,4,36498,4.347587849910661,20.0,40.0
28395,2,8395,[302 427 197 180 603],339,5,36503,4.347665555026203,20.0,0.0
28396,2,8396,[302 427 197 180 603],13,5,36508,4.347743241633917,20.0,0.0
28397,2,8397,[ 97 186 435 175 222],234,0,36508,4.347225529888068,0.0,0.0
28398,2,8398,[302 427 197 180 603],664,5,36513,4.34730325038695,20.0,0.0
28399,2,8399,[302 427 197 180 603],271,5,36518,4.347380952380952,20.0,0.0
28400,2,8400,[ 28  79 153  25 216],899,4,36522,4.347339602428282,0.0,0.0
28401,2,8401,[215 475 265 568  64],343,3,36525,4.347179243037372,0.0,0.0
28402,2,8402,[302 427 197 180 603],664,5,36530,4.3472569320480785,20.0,0.0
28403,2,8403,[546 185 118 153 200],804,3,36533,4.3470966206568304,0.0,0.0
28404,2,8404,[302 427 197 180 603],271,5,36538,4.347174301011303,20.0,0.0
28405,2,8405,[655 678 174  70 173],454,2,36540,4.346895074946467,0.0,20.0
28406,2,8406,[ 25  64 258 265 546],84,3,36543,4.346734863803973,0.0,0.0
28407,2,8407,[302 427 197 180 603],271,5,36548,4.346812559467174,20.0,0.0
28408,2,8408,[ 82 186 202 194   4],579,2,36550,4.346533476037579,0.0,0.0
28409,2,8409,[302 427 197 180 603],666,5,36555,4.346611177170035,20.0,0.0
28410,2,8410,[302 427 197 180 603],474,5,36560,4.3466888598264175,20.0,0.0
28411,2,8411,[302 427 197 180 603],271,5,36565,4.346766524013314,20.0,0.0
28412,2,8412,[257 748 132 125 144],92,2,36567,4.346487578747177,0.0,0.0
28413,2,8413,[ 88 125   4 678 197],749,4,36571,4.346446398859045,0.0,0.0
28414,2,8414,[302 427 197 180 603],664,5,36576,4.346524064171123,20.0,0.0
28415,2,8415,[302 427 197 180 603],90,5,36581,4.346601711026616,20.0,0.0
28416,2,8416,[  7 286 269 143 132],524,3,36584,4.3464417250801946,0.0,0.0
28417,2,8417,[302 427 197 180 603],271,5,36589,4.346519363269185,20.0,0.0
28418,2,8418,[302 427 197 180 603],474,5,36594,4.34659698301461,20.0,0.0
28419,2,8419,[ 11 151 568 176 257],213,5,36599,4.346674584323041,0.0,0.0
28420,2,8420,[302 427 197 180 603],271,5,36604,4.346752167201045,20.0,0.0
28421,2,8421,[302 427 197 180 603],13,5,36609,4.3468297316551885,20.0,0.0
28422,2,8422,[302 427 197 180 603],383,5,36614,4.346907277692034,20.0,0.0
28423,2,8423,[302 427 197 180 603],537,5,36619,4.346984805318138,20.0,0.0
28424,2,8424,[195 588 423 288 172],144,4,36623,4.346943620178042,0.0,0.0
28425,2,8425,[302 427 197 180 603],383,5,36628,4.34702112508901,20.0,0.0
28426,2,8426,[161 181 197 496  95],454,3,36631,4.3468612792215495,0.0,0.0
28427,2,8427,[215  82 435 234 423],13,4,36635,4.346820123398197,0.0,0.0
28428,2,8428,[302 427 197 180 603],664,5,36640,4.3468976153754895,20.0,0.0
28429,2,8429,[302 427 197 180 603],664,5,36645,4.346975088967971,20.0,0.0
28430,2,8430,[302 427 197 180 603],537,5,36650,4.347052544182185,20.0,0.0
28431,2,8431,[302 427 197 180 603],271,5,36655,4.3471299810246675,20.0,0.0
28432,2,8432,[323  69 121 215 125],648,2,36657,4.346851654215581,0.0,0.0
28433,2,8433,[302 427 197 180 603],339,5,36662,4.34692909651411,20.0,0.0
28434,2,8434,[302 427 197 180 603],90,5,36667,4.3470065204505035,20.0,0.0
28435,2,8435,[168 100 132  79 228],194,2,36669,4.346728307254623,0.0,20.0
28436,2,8436,[ 70 111 222 568 385],537,1,36670,4.346331634467227,0.0,0.0
28437,2,8437,[302 427 197 180 603],537,5,36675,4.346409101682863,20.0,0.0
28438,2,8438,[748 183 117 215 202],200,4,36679,4.3463680530868585,0.0,0.0
28439,2,8439,[168  28 197 182 423],474,4,36683,4.3463270142180095,0.0,0.0
28440,2,8440,[302 427 197 180 603],666,5,36688,4.346404454448525,20.0,0.0
28441,2,8441,[289 742 318  71 151],788,2,36690,4.346126510305615,20.0,0.0
28442,2,8442,[302 427 197 180 603],664,5,36695,4.346203955939832,20.0,0.0
28443,2,8443,[302 427 197 180 603],474,5,36700,4.346281383230696,20.0,0.0
28444,2,8444,[302 427 197 180 603],13,5,36705,4.346358792184724,20.0,0.0
28445,2,8445,[302 427 197 180 603],474,5,36710,4.34643618280843,20.0,0.0
28446,2,8446,[302 427 197 180 603],537,5,36715,4.346513555108323,20.0,0.0
28447,2,8447,[302 427 197 180 603],90,5,36720,4.346590909090909,20.0,0.0
28448,2,8448,[302 427 197 180 603],383,5,36725,4.346668244762694,20.0,0.0
28449,2,8449,[302 427 197 180 603],537,5,36730,4.346745562130177,20.0,0.0
28450,2,8450,[  4 172 194 121 427],833,0,36730,4.3462312152408,0.0,0.0
28451,2,8451,[302 427 197 180 603],339,5,36735,4.346308566019877,20.0,0.0
28452,2,8452,[234 405 121 385 748],92,3,36738,4.346149296107891,0.0,0.0
28453,2,8453,[302 427 197 180 603],339,5,36743,4.346226638277738,20.0,0.0
28454,2,8454,[  7 211 100 235 423],524,3,36746,4.346067415730337,0.0,20.0
28455,2,8455,[302 427 197 180 603],13,5,36751,4.346144749290445,20.0,0.0
28456,2,8456,[603 143  22 269 185],90,5,36756,4.346222064561902,20.0,0.0
28457,2,8457,[302 427 197 180 603],537,5,36761,4.3462993615511945,20.0,0.0
28458,2,8458,[302 427 197 180 603],90,5,36766,4.346376640264807,20.0,0.0
28459,2,8459,[302 427 197 180 603],90,5,36771,4.3464539007092196,20.0,0.0
28460,2,8460,[302 427 197 180 603],90,5,36776,4.346531142890911,20.0,0.0
28461,2,8461,[  9 235 237  95  88],13,3,36779,4.34637201607185,0.0,0.0
28462,2,8462,[302 427 197 180 603],666,5,36784,4.346449249675056,20.0,0.0
28463,2,8463,[ 70 258   9 173 216],378,5,36789,4.346526465028355,0.0,0.0
28464,2,8464,[357 111  79 245 423],653,3,36792,4.346367395156527,20.0,0.0
28465,2,8465,[ 98 294   9  69  12],7,4,36796,4.346326482400189,20.0,20.0
28466,2,8466,[302 427 197 180 603],271,5,36801,4.3464036848942955,20.0,0.0
28467,2,8467,[302 427 197 180 603],537,5,36806,4.346480869154464,20.0,0.0
28468,2,8468,[302 427 197 180 603],537,5,36811,4.346558035187154,20.0,0.0
28469,2,8469,[302 427 197 180 603],271,5,36816,4.34663518299882,20.0,0.0
28470,2,8470,[172 210 121  95 191],64,3,36819,4.3464762129618695,0.0,0.0
28471,2,8471,[ 79 211 258 423  97],313,4,36823,4.346435316336166,0.0,0.0
28472,2,8472,[302 427 197 180 603],666,5,36828,4.346512451315944,20.0,0.0
28473,2,8473,[302 427 197 180 603],383,5,36833,4.34658956809063,20.0,0.0
28474,2,8474,[172 216 196 286   4],7,5,36838,4.346666666666667,0.0,0.0
28475,2,8475,[302 427 197 180 603],339,5,36843,4.346743747050495,20.0,0.0
28476,2,8476,[176 294 333 475 117],533,3,36846,4.346584876725257,0.0,0.0
28477,2,8477,[302 427 197 180 603],666,5,36851,4.346661948572777,20.0,0.0
28478,2,8478,[302 427 197 180 603],666,5,36856,4.34673900224083,20.0,0.0
28479,2,8479,[302 427 197 180 603],339,5,36861,4.346816037735849,20.0,0.0
28480,2,8480,[302 427 197 180 603],383,5,36866,4.346893055064261,20.0,0.0
28481,2,8481,[302 427 197 180 603],474,5,36871,4.346970054232492,20.0,0.0
28482,2,8482,[302 427 197 180 603],383,5,36876,4.347047035246964,20.0,0.0
28483,2,8483,[302 427 197 180 603],474,5,36881,4.347123998114097,20.0,0.0
28484,2,8484,[302 427 197 180 603],383,5,36886,4.347200942840306,20.0,0.0
28485,2,8485,[302 427 197 180 603],537,5,36891,4.347277869432006,20.0,0.0
28486,2,8486,[302 427 197 180 603],666,5,36896,4.347354777895605,20.0,0.0
28487,2,8487,[302 427 197 180 603],666,5,36901,4.347431668237512,20.0,0.0
28488,2,8488,[194  96 127 172 228],13,5,36906,4.34750854046413,0.0,20.0
28489,2,8489,[302 427 197 180 603],271,5,36911,4.347585394581861,20.0,0.0
28490,2,8490,[302 427 197 180 603],666,5,36916,4.347662230597103,20.0,0.0
28491,2,8491,[238  69 655 172 186],666,2,36918,4.347385774846915,0.0,0.0
28492,2,8492,[302 427 197 180 603],383,5,36923,4.3474626162722245,20.0,0.0
28493,2,8493,[302 427 197 180 603],537,5,36928,4.347539439604427,20.0,0.0
28494,2,8494,[302 427 197 180 603],666,5,36933,4.347616244849911,20.0,0.0
28495,2,8495,[172 385  69  50  70],474,5,36938,4.347693032015066,0.0,20.0
28496,2,8496,[143 313  64 153 183],659,5,36943,4.347769801106272,0.0,0.0
28497,2,8497,[183 194 288 135 435],897,3,36946,4.347611202635914,0.0,0.0
28498,2,8498,[508 151  71 742 168],524,1,36947,4.347217319684669,0.0,0.0
28499,2,8499,[302 427 197 180 603],339,5,36952,4.347294117647059,20.0,0.0
28500,2,8500,[302 427 197 180 603],664,5,36957,4.347370897541466,20.0,0.0
28501,2,8501,[515  88 228 187 183],339,5,36962,4.347447659374265,0.0,0.0
28502,2,8502,[302 427 197 180 603],13,5,36967,4.347524403151829,20.0,0.0
28503,2,8503,[257 318 210 117 181],499,2,36969,4.347248353715899,20.0,0.0
28504,2,8504,[ 79 204 276  89 180],385,2,36971,4.346972369194591,0.0,0.0
28505,2,8505,[302 427 197 180 603],13,5,36976,4.347049141782271,20.0,0.0
28506,2,8506,[483 568 153 427 144],308,3,36979,4.346890795815211,20.0,0.0
28507,2,8507,[302 427 197 180 603],271,5,36984,4.346967559943582,20.0,0.0
28508,2,8508,[302 427 197 180 603],474,5,36989,4.347044306028911,20.0,0.0
28509,2,8509,[204 161 471 302 117],207,2,36991,4.346768507638073,0.0,0.0
28510,2,8510,[302 427 197 180 603],537,5,36996,4.346845259076489,20.0,0.0
28511,2,8511,[302 427 197 180 603],13,5,37001,4.346921992481203,20.0,0.0
28512,2,8512,[182  70  98  88   4],533,3,37004,4.346763773052978,0.0,20.0
28513,2,8513,[185 179 286  79 174],207,4,37008,4.346723044397463,0.0,20.0
28514,2,8514,[  1 197 271 268 181],560,5,37013,4.346799765120376,0.0,0.0
28515,2,8515,[423 603 275 748   4],648,3,37016,4.346641615782057,20.0,0.0
28516,2,8516,[302 427 197 180 603],339,5,37021,4.346718328049783,20.0,0.0
28517,2,8517,[302 427 197 180 603],339,5,37026,4.346795022305706,20.0,0.0
28518,2,8518,[  7 121 234 268 194],643,5,37031,4.346871698556169,0.0,0.0
28519,2,8519,[302 427 197 180 603],13,5,37036,4.346948356807512,20.0,0.0
28520,2,8520,[302 427 197 180 603],90,5,37041,4.347024997066072,20.0,0.0
28521,2,8521,[204 333 568 222 228],881,4,37045,4.346984275991551,0.0,0.0
28522,2,8522,[302 427 197 180 603],383,5,37050,4.34706089405139,20.0,0.0
28523,2,8523,[302 427 197 180 603],90,5,37055,4.347137494134209,20.0,0.0
28524,2,8524,[302 427 197 180 603],537,5,37060,4.347214076246335,20.0,0.0
28525,2,8525,[ 70 185 173 471 748],479,4,37064,4.34717335209946,0.0,0.0
28526,2,8526,[ 25 435  69 568 245],804,4,37068,4.347132637504398,0.0,0.0
28527,2,8527,[153  69 161 234 197],234,3,37071,4.346974671669794,0.0,0.0
28528,2,8528,[302 427 197 180 603],339,5,37076,4.347051236956267,20.0,0.0
28529,2,8529,[302 427 197 180 603],90,5,37081,4.3471277842907385,20.0,0.0
28530,2,8530,[302 427 197 180 603],13,5,37086,4.347204313679522,20.0,0.0
28531,2,8531,[302 427 197 180 603],474,5,37091,4.3472808251289266,20.0,0.0
28532,2,8532,[302 427 197 180 603],271,5,37096,4.347357318645259,20.0,0.0
28533,2,8533,[ 28   1 275 748 597],13,2,37098,4.3470822591985,0.0,0.0
28534,2,8534,[302 427 197 180 603],666,5,37103,4.347158758055067,20.0,0.0
28535,2,8535,[302 427 197 180 603],537,5,37108,4.347235238987817,20.0,0.0
28536,2,8536,[183  56 748 546 258],749,2,37110,4.346960290500176,0.0,0.0
28537,2,8537,[302 427 197 180 603],13,5,37115,4.347036776762708,20.0,0.0
28538,2,8538,[302 427 197 180 603],474,5,37120,4.347113245110669,20.0,0.0
28539,2,8539,[302 427 197 180 603],537,5,37125,4.347189695550352,20.0,0.0
28540,2,8540,[302 427 197 180 603],537,5,37130,4.347266128088046,20.0,0.0
28541,2,8541,[302 427 197 180 603],666,5,37135,4.34734254273004,20.0,0.0
28542,2,8542,[302 427 197 180 603],383,5,37140,4.347418939482617,20.0,0.0
28543,2,8543,[678 288 175 196 174],537,1,37141,4.347027153558052,0.0,20.0
28544,2,8544,[302 427 197 180 603],339,5,37146,4.3471035693387945,20.0,0.0
28545,2,8545,[302 427 197 180 603],271,5,37151,4.3471799672361335,20.0,0.0
28546,2,8546,[135  89 496 181  71],524,1,37152,4.346788346788347,0.0,0.0
28547,2,8547,[276 568 385  98  79],207,3,37155,4.3466307908282635,0.0,20.0
28548,2,8548,[302 427 197 180 603],537,5,37160,4.3467072172183885,20.0,0.0
28549,2,8549,[588 603 483 118 125],7,4,37164,4.346666666666667,40.0,0.0
28550,2,8550,[302 427 197 180 603],90,5,37169,4.346743070985849,20.0,0.0
28551,2,8551,[302 427 197 180 603],664,5,37174,4.346819457436857,20.0,0.0
28552,2,8552,[302 427 197 180 603],383,5,37179,4.346895826025956,20.0,0.0
28553,2,8553,[200  97 127 186 168],298,4,37183,4.346855272387187,0.0,20.0
28554,2,8554,[302 427 197 180 603],271,5,37188,4.346931618936295,20.0,0.0
28555,2,8555,[302 427 197 180 603],537,5,37193,4.347007947639083,20.0,0.0
28556,2,8556,[  1 118 174  12 173],92,3,37196,4.34685053172841,20.0,20.0
28557,2,8557,[302 427 197 180 603],90,5,37201,4.34692685206824,20.0,0.0
28558,2,8558,[655 228  25  88 202],234,0,37201,4.346418974179227,0.0,0.0
28559,2,8559,[655 176 168  64 475],92,5,37206,4.3464953271028035,0.0,0.0
28560,2,8560,[302 427 197 180 603],383,5,37211,4.346571662188997,20.0,0.0
28561,2,8561,[302 427 197 180 603],271,5,37216,4.346647979444056,20.0,0.0
28562,2,8562,[ 79 153  95 288 176],479,4,37220,4.346607497372416,0.0,0.0
28563,2,8563,[302 427 197 180 603],13,5,37225,4.346683792620271,20.0,0.0
28564,2,8564,[183 186  28 302  88],474,5,37230,4.3467600700525395,0.0,0.0
28565,2,8565,[302 427 197 180 603],664,5,37235,4.346836329675461,20.0,0.0
28566,2,8566,[302 427 197 180 603],666,5,37240,4.346912571495273,20.0,0.0
28567,2,8567,[302 427 197 180 603],13,5,37245,4.346988795518207,20.0,0.0
28568,2,8568,[302 427 197 180 603],13,5,37250,4.347065001750496,20.0,0.0
28569,2,8569,[ 50 234 121 655  89],7,5,37255,4.347141190198366,0.0,20.0
28570,2,8570,[151 194 187 179 175],339,5,37260,4.347217360868044,0.0,0.0
28571,2,8571,[302 427 197 180 603],383,5,37265,4.347293513765749,20.0,0.0
28572,2,8572,[200 173  11 195  64],387,3,37268,4.347136358334305,0.0,0.0
28573,2,8573,[302 427 197 180 603],13,5,37273,4.3472125029157915,20.0,0.0
28574,2,8574,[302 427 197 180 603],383,5,37278,4.347288629737609,20.0,0.0
28575,2,8575,[302 427 197 180 603],90,5,37283,4.34736473880597,20.0,0.0
28576,2,8576,[302 427 197 180 603],666,5,37288,4.347440830127084,20.0,0.0
28577,2,8577,[302 427 197 180 603],474,5,37293,4.347516903707158,20.0,0.0
28578,2,8578,[302 427 197 180 603],664,5,37298,4.347592959552395,20.0,0.0
28579,2,8579,[ 89 300 194 125 257],653,2,37300,4.347319347319347,0.0,0.0
28580,2,8580,[302 427 197 180 603],13,5,37305,4.347395408460552,20.0,0.0
28581,2,8581,[302 427 197 180 603],666,5,37310,4.34747145187602,20.0,0.0
28582,2,8582,[302 427 197 180 603],537,5,37315,4.347547477571944,20.0,0.0
28583,2,8583,[302 427 197 180 603],339,5,37320,4.34762348555452,20.0,0.0
28584,2,8584,[302 427 197 180 603],90,5,37325,4.347699475829936,20.0,0.0
28585,2,8585,[ 98 471 357  50 265],311,5,37330,4.347775448404379,20.0,40.0
28586,2,8586,[302 427 197 180 603],271,5,37335,4.347851403284034,20.0,0.0
28587,2,8587,[265  12 191 211 655],14,4,37339,4.347810898928738,20.0,0.0
28588,2,8588,[323  56 265 423 568],311,4,37343,4.347770404005123,0.0,0.0
28589,2,8589,[328 322   4 237 204],13,3,37346,4.347613504074506,0.0,0.0
28590,2,8590,[302 427 197 180 603],664,5,37351,4.347689442439763,20.0,0.0
28591,2,8591,[302 427 197 180 603],339,5,37356,4.347765363128492,20.0,0.0
28592,2,8592,[302 427 197 180 603],383,5,37361,4.3478412661468635,20.0,0.0
28593,2,8593,[183  98  96 742  50],458,3,37364,4.347684430998371,0.0,40.0
28594,2,8594,[ 70 197 135 179  88],934,4,37368,4.347643979057592,0.0,0.0
28595,2,8595,[302 427 197 180 603],339,5,37373,4.34771986970684,20.0,0.0
28596,2,8596,[302 427 197 180 603],13,5,37378,4.347795742700942,20.0,0.0
28597,2,8597,[302 127  28 294  95],271,4,37382,4.3477552919283555,0.0,20.0
28598,2,8598,[302 427 197 180 603],339,5,37387,4.347831143156181,20.0,0.0
28599,2,8599,[302 427 197 180 603],537,5,37392,4.347906976744186,20.0,0.0
28600,2,8600,[302 427 197 180 603],666,5,37397,4.347982792698524,20.0,0.0
28601,2,8601,[302 427 197 180 603],271,5,37402,4.348058591025343,20.0,0.0
28602,2,8602,[302 427 197 180 603],664,5,37407,4.348134371730792,20.0,0.0
28603,2,8603,[302 427 197 180 603],13,5,37412,4.348210134821014,20.0,0.0
28604,2,8604,[  7 161  71 127  12],308,4,37416,4.348169668797211,20.0,20.0
28605,2,8605,[ 89 173 275  82 215],524,3,37419,4.348013014176156,0.0,0.0
28606,2,8606,[302 427 197 180 603],13,5,37424,4.348088764958755,20.0,0.0
28607,2,8607,[302 427 197 180 603],664,5,37429,4.348164498141264,20.0,0.0
28608,2,8608,[194  88   1   8 161],897,4,37433,4.348124056220235,0.0,0.0
28609,2,8609,[302 427 197 180 603],537,5,37438,4.348199767711963,20.0,0.0
28610,2,8610,[ 12 603 194 427 179],458,4,37442,4.3481593310881435,40.0,0.0
28611,2,8611,[286 132 269 118 111],13,3,37445,4.348002786809103,0.0,0.0
28612,2,8612,[302 427 197 180 603],664,5,37450,4.348078486009521,20.0,0.0
28613,2,8613,[182   8 176  97  70],479,4,37454,4.3480380775481775,0.0,0.0
28614,2,8614,[302 427 197 180 603],666,5,37459,4.3481137550783515,20.0,0.0
28615,2,8615,[588  95 597 257 151],650,0,37459,4.347609099350047,0.0,0.0
28616,2,8616,[302 427 197 180 603],664,5,37464,4.347684809098294,20.0,0.0
28617,2,8617,[ 50 143 173 597 179],650,3,37467,4.347528428869808,0.0,20.0
28618,2,8618,[182  64 172 568 194],749,4,37471,4.347488107669103,0.0,0.0
28619,2,8619,[302 427 197 180 603],666,5,37476,4.347563805104408,20.0,0.0
28620,2,8620,[200 195 318 196 471],308,3,37479,4.34740749333024,20.0,0.0
28621,2,8621,[182 427 174 588 185],537,3,37482,4.347251217814892,0.0,20.0
28622,2,8622,[302 427 197 180 603],474,5,37487,4.347326916386408,20.0,0.0
28623,2,8623,[302 427 197 180 603],90,5,37492,4.347402597402597,20.0,0.0
28624,2,8624,[302 427 197 180 603],474,5,37497,4.347478260869565,20.0,0.0
28625,2,8625,[302 427 197 180 603],474,5,37502,4.347553906793415,20.0,0.0
28626,2,8626,[182  28  79  25 273],892,5,37507,4.347629535180248,0.0,0.0
28627,2,8627,[302 427 197 180 603],383,5,37512,4.347705146036161,20.0,0.0
28628,2,8628,[302 427 197 180 603],537,5,37517,4.34778073936725,20.0,0.0
28629,2,8629,[ 79 118 132 357 496],42,5,37522,4.347856315179606,20.0,0.0
28630,2,8630,[302 427 197 180 603],474,5,37527,4.347931873479319,20.0,0.0
28631,2,8631,[300 234  89 182 187],506,4,37531,4.34789156626506,0.0,0.0
28632,2,8632,[302 427 197 180 603],339,5,37536,4.347967102976949,20.0,0.0
28633,2,8633,[302 427 197 180 603],339,5,37541,4.348042622191336,20.0,0.0
28634,2,8634,[168 282 597 121 228],899,3,37544,4.347886508396063,0.0,0.0
28635,2,8635,[302 427 197 180 603],383,5,37549,4.34796201945345,20.0,0.0
28636,2,8636,[302 427 197 180 603],383,5,37554,4.348037513025356,20.0,0.0
28637,2,8637,[302 427 197 180 603],383,5,37559,4.348112989117851,20.0,0.0
28638,2,8638,[302 427 197 180 603],474,5,37564,4.348188447737007,20.0,0.0
28639,2,8639,[132 748 180  79  28],882,5,37569,4.348263888888889,0.0,0.0
28640,2,8640,[172 271  50   8 322],883,4,37573,4.348223585233191,0.0,20.0
28641,2,8641,[302 427 197 180 603],90,5,37578,4.348299004859986,20.0,0.0
28642,2,8642,[302 427 197 180 603],474,5,37583,4.348374407034594,20.0,0.0
28643,2,8643,[ 56   1 121 180 294],447,4,37587,4.3483341045812125,0.0,0.0
28644,2,8644,[302 427 197 180 603],271,5,37592,4.34840948525159,20.0,0.0
28645,2,8645,[ 95 435  97 405 153],406,3,37595,4.34825352764284,0.0,0.0
28646,2,8646,[302 427 197 180 603],271,5,37600,4.3483289001966,20.0,0.0
28647,2,8647,[302 427 197 180 603],383,5,37605,4.348404255319149,20.0,0.0
28648,2,8648,[302 427 197 180 603],271,5,37610,4.348479593016534,20.0,0.0
28649,2,8649,[302 427 197 180 603],90,5,37615,4.348554913294798,20.0,0.0
28650,2,8650,[302 427 197 180 603],474,5,37620,4.3486302161599815,20.0,0.0
28651,2,8651,[302 427 197 180 603],537,5,37625,4.348705501618123,20.0,0.0
28652,2,8652,[302 427 197 180 603],339,5,37630,4.348780769675257,20.0,0.0
28653,2,8653,[111 216 294 655  82],749,3,37633,4.348624913334874,0.0,0.0
28654,2,8654,[302 427 197 180 603],13,5,37638,4.348700173310226,20.0,0.0
28655,2,8655,[302 427 197 180 603],339,5,37643,4.348775415896488,20.0,0.0
28656,2,8656,[ 25 603 183 173 215],897,3,37646,4.348619614185052,20.0,0.0
28657,2,8657,[302 427 197 180 603],271,5,37651,4.348694848694849,20.0,0.0
28658,2,8658,[302 427 197 180 603],664,5,37656,4.348770065827463,20.0,0.0
28659,2,8659,[302 427 197 180 603],271,5,37661,4.348845265588914,20.0,0.0
28660,2,8660,[302 427 197 180 603],664,5,37666,4.348920447985221,20.0,0.0
28661,2,8661,[302 427 197 180 603],664,5,37671,4.348995613022397,20.0,0.0
28662,2,8662,[257 118 328 275 301],637,1,37672,4.3486090268959945,0.0,0.0
28663,2,8663,[302 427 197 180 603],383,5,37677,4.348684210526316,20.0,0.0
28664,2,8664,[302 427 197 180 603],474,5,37682,4.3487593768032315,20.0,0.0
28665,2,8665,[302 427 197 180 603],339,5,37687,4.348834525732749,20.0,0.0
28666,2,8666,[302 427 197 180 603],537,5,37692,4.348909657320872,20.0,0.0
28667,2,8667,[117 748 196 183 194],311,5,37697,4.348984771573604,0.0,0.0
28668,2,8668,[276 546  82 100  96],378,4,37701,4.348944514938286,0.0,20.0
28669,2,8669,[ 96 204 258  28 568],506,5,37706,4.349019607843137,0.0,0.0
28670,2,8670,[302 427 197 180 603],666,5,37711,4.349094683427517,20.0,0.0
28671,2,8671,[302 427 197 180 603],383,5,37716,4.349169741697417,20.0,0.0
28672,2,8672,[318  79 100 183 186],653,4,37720,4.349129482301395,20.0,20.0
28673,2,8673,[191 196 597  89   8],308,3,37723,4.348973945123357,0.0,0.0
28674,2,8674,[302 427 197 180 603],271,5,37728,4.349048991354467,20.0,0.0
28675,2,8675,[742  70 748 202  28],454,3,37731,4.348893499308437,0.0,0.0
28676,2,8676,[ 95 135 183  89 228],881,4,37735,4.34885329030771,0.0,0.0
28677,2,8677,[302 427 197 180 603],271,5,37740,4.348928324498733,20.0,0.0
28678,2,8678,[ 69 216 210  56  64],194,3,37743,4.3487729001036985,0.0,0.0
28679,2,8679,[302 427 197 180 603],339,5,37748,4.348847926267281,20.0,0.0
28680,2,8680,[302 427 197 180 603],90,5,37753,4.348922935145721,20.0,0.0
28681,2,8681,[302 427 197 180 603],90,5,37758,4.34899792674499,20.0,0.0
28682,2,8682,[302 427 197 180 603],537,5,37763,4.349072901071058,20.0,0.0
28683,2,8683,[ 64 423  96 546 181],374,3,37766,4.348917549516352,0.0,0.0
28684,2,8684,[302 427 197 180 603],271,5,37771,4.3489925158318945,20.0,0.0
28685,2,8685,[289 322 181 423 288],374,2,37773,4.348722081510477,0.0,0.0
28686,2,8686,[302 427 197 180 603],13,5,37778,4.348797053067803,20.0,0.0
28687,2,8687,[211 265 216 194 153],666,2,37780,4.348526703499079,0.0,0.0
28688,2,8688,[302 427 197 180 603],474,5,37785,4.348601680285419,20.0,0.0
28689,2,8689,[302 427 197 180 603],666,5,37790,4.3486766398158805,20.0,0.0
28690,2,8690,[302 427 197 180 603],271,5,37795,4.348751582096422,20.0,0.0
28691,2,8691,[302 427 197 180 603],383,5,37800,4.348826507132996,20.0,0.0
28692,2,8692,[302 427 197 180 603],474,5,37805,4.348901414931554,20.0,0.0
28693,2,8693,[117 228 435 423 100],387,2,37807,4.348631239935588,0.0,20.0
28694,2,8694,[197 568 194 100 385],59,4,37811,4.348591144335825,0.0,20.0
28695,2,8695,[302 427 197 180 603],664,5,37816,4.348666053357865,20.0,0.0
28696,2,8696,[302 427 197 180 603],474,5,37821,4.3487409451535015,20.0,0.0
28697,2,8697,[302 427 197 180 603],90,5,37826,4.3488158197286735,20.0,0.0
28698,2,8698,[302 427 197 180 603],664,5,37831,4.3488906770893205,20.0,0.0
28699,2,8699,[302 427 197 180 603],537,5,37836,4.348965517241379,20.0,0.0
28700,2,8700,[302 427 197 180 603],666,5,37841,4.349040340190783,20.0,0.0
28701,2,8701,[302 427 197 180 603],13,5,37846,4.349115145943461,20.0,0.0
28702,2,8702,[ 50  69 508 127 151],653,3,37849,4.348960128691256,0.0,40.0
28703,2,8703,[ 88 179 385 215 234],200,5,37854,4.349034926470588,0.0,0.0
28704,2,8704,[302 427 197 180 603],666,5,37859,4.349109707064906,20.0,0.0
28705,2,8705,[302 427 197 180 603],474,5,37864,4.349184470480129,20.0,0.0
28706,2,8706,[302 427 197 180 603],271,5,37869,4.349259216722178,20.0,0.0
28707,2,8707,[302 427 197 180 603],666,5,37874,4.349333945796968,20.0,0.0
28708,2,8708,[187  69 215 234 403],648,2,37876,4.349064186473763,0.0,0.0
28709,2,8709,[302 427 197 180 603],271,5,37881,4.349138920780712,20.0,0.0
28710,2,8710,[181  56 127  97 186],85,3,37884,4.348984043163816,0.0,20.0
28711,2,8711,[302 427 197 180 603],474,5,37889,4.349058769513315,20.0,0.0
28712,2,8712,[302 427 197 180 603],383,5,37894,4.349133478709974,20.0,0.0
28713,2,8713,[302 427 197 180 603],666,5,37899,4.349208170759697,20.0,0.0
28714,2,8714,[302 427 197 180 603],666,5,37904,4.349282845668387,20.0,0.0
28715,2,8715,[302 427 197 180 603],90,5,37909,4.349357503441946,20.0,0.0
28716,2,8716,[302 427 197 180 603],13,5,37914,4.349432144086268,20.0,0.0
28717,2,8717,[302 427 197 180 603],90,5,37919,4.34950676760725,20.0,0.0
28718,2,8718,[302 427 197 180 603],664,5,37924,4.349581374010781,20.0,0.0
28719,2,8719,[302 427 197 180 603],271,5,37929,4.3496559633027525,20.0,0.0
28720,2,8720,[302 427 197 180 603],383,5,37934,4.34973053548905,20.0,0.0
28721,2,8721,[302 427 197 180 603],13,5,37939,4.349805090575556,20.0,0.0
28722,2,8722,[302 427 197 180 603],90,5,37944,4.349879628568154,20.0,0.0
28723,2,8723,[173 185  15 289 151],537,2,37946,4.349610270518111,0.0,0.0
28724,2,8724,[357 204 127 111 271],833,3,37949,4.3494555873925504,20.0,20.0
28725,2,8725,[603 200 294  64 117],271,3,37952,4.349300939720376,20.0,0.0
28726,2,8726,[302 427 197 180 603],537,5,37957,4.349375501317749,20.0,0.0
28727,2,8727,[302 427 197 180 603],474,5,37962,4.349450045829514,20.0,0.0
28728,2,8728,[302 427 197 180 603],664,5,37967,4.349524573261542,20.0,0.0
28729,2,8729,[302 427 197 180 603],271,5,37972,4.349599083619702,20.0,0.0
28730,2,8730,[ 82 204 195 197  64],749,5,37977,4.349673576909861,0.0,0.0
28731,2,8731,[161 194 211 125 405],533,4,37981,4.349633531836922,0.0,0.0
28732,2,8732,[286 143 186 603 483],7,4,37985,4.349593495934959,40.0,0.0
28733,2,8733,[161   8 183 237 286],13,4,37989,4.349553469200824,0.0,0.0
28734,2,8734,[ 22 210 191 196 385],308,4,37993,4.349513451631368,0.0,0.0
28735,2,8735,[302 427 197 180 603],383,5,37998,4.349587912087912,20.0,0.0
28736,2,8736,[  9 265 286 180 200],271,5,38003,4.349662355499599,0.0,0.0
28737,2,8737,[302 427 197 180 603],383,5,38008,4.349736781872282,20.0,0.0
28738,2,8738,[228 471 302 176 435],158,5,38013,4.349811191211809,0.0,0.0
28739,2,8739,[151 127 183 161  71],308,4,38017,4.349771167048055,0.0,20.0
28740,2,8740,[  1 228 204 234 100],59,4,38021,4.3497311520421,0.0,20.0
28741,2,8741,[302 427 197 180 603],90,5,38026,4.349805536490505,20.0,0.0
28742,2,8742,[302 427 197 180 603],664,5,38031,4.349879903923139,20.0,0.0
28743,2,8743,[302 427 197 180 603],664,5,38036,4.349954254345837,20.0,0.0
28744,2,8744,[546  15 588 195 471],313,4,38040,4.34991423670669,0.0,0.0
28745,2,8745,[302 427 197 180 603],339,5,38045,4.349988566201692,20.0,0.0
28746,2,8746,[186 144 174   8 180],13,5,38050,4.350062878701269,0.0,20.0
28747,2,8747,[302 427 197 180 603],271,5,38055,4.350137174211248,20.0,0.0
28748,2,8748,[302 427 197 180 603],474,5,38060,4.350211452737455,20.0,0.0
28749,2,8749,[302 427 197 180 603],13,5,38065,4.3502857142857145,20.0,0.0
28750,2,8750,[302 427 197 180 603],537,5,38070,4.350359958861844,20.0,0.0
28751,2,8751,[302 427 197 180 603],664,5,38075,4.350434186471664,20.0,0.0
28752,2,8752,[288 475 117  11 294],474,3,38078,4.350279904032903,0.0,0.0
28753,2,8753,[174 197 678 215 471],537,1,38079,4.349897189856065,0.0,20.0
28754,2,8754,[302 427 197 180 603],383,5,38084,4.349971444888635,20.0,0.0
28755,2,8755,[313 121 179   8 196],271,4,38088,4.349931475559616,0.0,0.0
28756,2,8756,[302 427 197 180 603],474,5,38093,4.35000570971794,20.0,0.0
28757,2,8757,[302 427 197 180 603],90,5,38098,4.350079926923955,20.0,0.0
28758,2,8758,[ 95 186   8  56 216],85,3,38101,4.349925790615367,0.0,0.0
28759,2,8759,[302 427 197 180 603],383,5,38106,4.35,20.0,0.0
28760,2,8760,[302 427 197 180 603],474,5,38111,4.350074192443785,20.0,0.0
28761,2,8761,[302 427 197 180 603],537,5,38116,4.350148367952523,20.0,0.0
28762,2,8762,[258 168 237 655 222],13,4,38120,4.350108410361749,0.0,0.0
28763,2,8763,[302 427 197 180 603],90,5,38125,4.350182565038795,20.0,0.0
28764,2,8764,[168 194  15 435  98],6,4,38129,4.350142612664005,0.0,20.0
28765,2,8765,[302 427 197 180 603],666,5,38134,4.350216746520648,20.0,0.0
28766,2,8766,[302 427 197 180 603],474,5,38139,4.3502908634652675,20.0,0.0
28767,2,8767,[302 427 197 180 603],666,5,38144,4.350364963503649,20.0,0.0
28768,2,8768,[302 427 197 180 603],13,5,38149,4.350439046641578,20.0,0.0
28769,2,8769,[302 427 197 180 603],339,5,38154,4.350513112884834,20.0,0.0
28770,2,8770,[204 185 333 183 322],313,4,38158,4.350473150153916,0.0,0.0
28771,2,8771,[302 427 197 180 603],383,5,38163,4.350547195622435,20.0,0.0
28772,2,8772,[302 427 197 180 603],664,5,38168,4.350621224210646,20.0,0.0
28773,2,8773,[302 427 197 180 603],90,5,38173,4.350695235924322,20.0,0.0
28774,2,8774,[302 427 197 180 603],271,5,38178,4.350769230769231,20.0,0.0
28775,2,8775,[200 333 568 515 435],343,2,38180,4.350501367365543,0.0,0.0
28776,2,8776,[323 546 174 273  96],897,4,38184,4.350461433291557,0.0,20.0
28777,2,8777,[302 427 197 180 603],664,5,38189,4.350535429482798,20.0,0.0
28778,2,8778,[302 427 197 180 603],339,5,38194,4.350609408816494,20.0,0.0
28779,2,8779,[385 183 568 197 276],881,4,38198,4.350569476082004,0.0,0.0
28780,2,8780,[288  69 211  95 273],64,4,38202,4.350529552442774,0.0,0.0
28781,2,8781,[302 427 197 180 603],13,5,38207,4.350603507173765,20.0,0.0
28782,2,8782,[302 427 197 180 603],474,5,38212,4.350677445064329,20.0,0.0
28783,2,8783,[196 357 435  56 301],537,2,38214,4.350409836065574,20.0,0.0
28784,2,8784,[302 427 197 180 603],474,5,38219,4.350483779169038,20.0,0.0
28785,2,8785,[ 79  98  69 235 180],804,5,38224,4.350557705440473,0.0,20.0
28786,2,8786,[302 427 197 180 603],271,5,38229,4.350631614885627,20.0,0.0
28787,2,8787,[748  89 180 216 568],543,3,38232,4.350477924442422,0.0,0.0
28788,2,8788,[302 427 197 180 603],383,5,38237,4.35055182614632,20.0,0.0
28789,2,8789,[302 427 197 180 603],271,5,38242,4.350625711035267,20.0,0.0
28790,2,8790,[302 427 197 180 603],383,5,38247,4.350699579115004,20.0,0.0
28791,2,8791,[302 427 197 180 603],383,5,38252,4.350773430391265,20.0,0.0
28792,2,8792,[302 427 197 180 603],339,5,38257,4.350847264869783,20.0,0.0
28793,2,8793,[302 427 197 180 603],666,5,38262,4.3509210825562885,20.0,0.0
28794,2,8794,[  9  69 194 181 111],749,3,38265,4.350767481523593,0.0,0.0
28795,2,8795,[ 56 111 173 678 423],13,3,38268,4.3506139154160985,0.0,0.0
28796,2,8796,[238 508 186 678   7],339,4,38272,4.350574059338411,0.0,0.0
28797,2,8797,[603 195 568 173 135],387,4,38276,4.350534212320982,20.0,0.0
28798,2,8798,[328  50 265 258  11],334,3,38279,4.350380725082395,0.0,20.0
28799,2,8799,[191 182 678 100 172],881,3,38282,4.350227272727273,0.0,20.0
28800,2,8800,[302 427 197 180 603],339,5,38287,4.350301102147483,20.0,0.0
28801,2,8801,[222 275 211   1 294],533,5,38292,4.350374914792092,0.0,0.0
28802,2,8802,[ 96 161 403 179 182],92,4,38296,4.350335113029649,0.0,0.0
28803,2,8803,[302 427 197 180 603],664,5,38301,4.350408905043162,20.0,0.0
28804,2,8804,[302 427 197 180 603],90,5,38306,4.350482680295287,20.0,0.0
28805,2,8805,[302 427 197 180 603],537,5,38311,4.350556438791733,20.0,0.0
28806,2,8806,[185 191 153 228   8],234,2,38313,4.350289542409447,0.0,0.0
28807,2,8807,[302 427 197 180 603],383,5,38318,4.350363306085377,20.0,0.0
28808,2,8808,[302 427 197 180 603],474,5,38323,4.350437053013963,20.0,0.0
28809,2,8809,[302 427 197 180 603],383,5,38328,4.3505107832009084,20.0,0.0
28810,2,8810,[302 427 197 180 603],474,5,38333,4.350584496651912,20.0,0.0
28811,2,8811,[174 180 515 135 269],13,3,38336,4.3504312301407175,0.0,20.0
28812,2,8812,[195 289 200 183 100],387,4,38340,4.3503914671508,0.0,20.0
28813,2,8813,[ 56  50 258 385 435],13,4,38344,4.350351713183572,0.0,20.0
28814,2,8814,[ 50 496 483 238 151],537,4,38348,4.350311968235961,20.0,20.0
28815,2,8815,[302 427 197 180 603],13,5,38353,4.350385662431942,20.0,0.0
28816,2,8816,[302 427 197 180 603],339,5,38358,4.350459339911534,20.0,0.0
28817,2,8817,[302 427 197 180 603],339,5,38363,4.350533000680427,20.0,0.0
28818,2,8818,[302 427 197 180 603],537,5,38368,4.350606644744302,20.0,0.0
28819,2,8819,[269 286 302 273   9],90,4,38372,4.350566893424037,0.0,0.0
28820,2,8820,[173 269 268 328 172],85,2,38374,4.350300419453577,0.0,0.0
28821,2,8821,[302 427 197 180 603],537,5,38379,4.350374064837905,20.0,0.0
28822,2,8822,[302 427 197 180 603],90,5,38384,4.350447693528278,20.0,0.0
28823,2,8823,[302 427 197 180 603],13,5,38389,4.350521305530371,20.0,0.0
28824,2,8824,[179 496 175  50 237],85,4,38393,4.350481586402267,0.0,20.0
28825,2,8825,[210  15 282 202 196],207,3,38396,4.3503285746657605,0.0,0.0
28826,2,8826,[302 427 197 180 603],537,5,38401,4.350402175144443,20.0,0.0
28827,2,8827,[  1 186 117 125 742],648,3,38404,4.350249207068419,0.0,0.0
28828,2,8828,[302 427 197 180 603],537,5,38409,4.3503227998640845,20.0,0.0
28829,2,8829,[302 427 197 180 603],664,5,38414,4.35039637599094,20.0,0.0
28830,2,8830,[302 427 197 180 603],13,5,38419,4.350469935454648,20.0,0.0
28831,2,8831,[302 427 197 180 603],537,5,38424,4.350543478260869,20.0,0.0
28832,2,8832,[302 427 197 180 603],13,5,38429,4.350617004415261,20.0,0.0
28833,2,8833,[ 50 161 174 471 111],653,3,38432,4.35046411591578,0.0,40.0
28834,2,8834,[268 216  95  15 265],92,2,38434,4.350198075834748,0.0,0.0
28835,2,8835,[302 427 197 180 603],537,5,38439,4.350271616115889,20.0,0.0
28836,2,8836,[405 151  96 210  71],533,3,38442,4.350118818603598,0.0,0.0
28837,2,8837,[302 427 197 180 603],90,5,38447,4.350192351210681,20.0,0.0
28838,2,8838,[197  22 100 269 186],10,5,38452,4.350265867179545,0.0,20.0
28839,2,8839,[302 427 197 180 603],13,5,38457,4.350339366515837,20.0,0.0
28840,2,8840,[144  50 483  79 265],650,3,38460,4.350186630471666,20.0,20.0
28841,2,8841,[ 25  28  56 328 269],13,2,38462,4.349920832390862,0.0,0.0
28842,2,8842,[302 427 197 180 603],383,5,38467,4.349994345810245,20.0,0.0
28843,2,8843,[302 427 197 180 603],271,5,38472,4.350067842605156,20.0,0.0
28844,2,8844,[ 64 168 403  98 185],543,4,38476,4.350028264556246,0.0,20.0
28845,2,8845,[ 28 151 286 228  15],554,5,38481,4.3501017408998415,0.0,0.0
28846,2,8846,[179  98 568 200   7],13,1,38482,4.3497230699672205,0.0,20.0
28847,2,8847,[ 25 238 174 597 273],59,3,38485,4.349570524412297,0.0,20.0
28848,2,8848,[302 427 197 180 603],664,5,38490,4.349644027573738,20.0,0.0
28849,2,8849,[302 427 197 180 603],339,5,38495,4.349717514124293,20.0,0.0
28850,2,8850,[302 427 197 180 603],90,5,38500,4.349790984069597,20.0,0.0
28851,2,8851,[302 427 197 180 603],383,5,38505,4.349864437415273,20.0,0.0
28852,2,8852,[302 427 197 180 603],383,5,38510,4.349937874166949,20.0,0.0
28853,2,8853,[302 427 197 180 603],339,5,38515,4.350011294330246,20.0,0.0
28854,2,8854,[195 168  70  28 176],883,3,38518,4.349858836815359,0.0,0.0
28855,2,8855,[302 427 197 180 603],383,5,38523,4.349932249322493,20.0,0.0
28856,2,8856,[172 121 245 546  98],92,4,38527,4.349892740205487,0.0,20.0
28857,2,8857,[ 79 215 132 153 202],378,4,38531,4.349853240009032,0.0,0.0
28858,2,8858,[302 427 197 180 603],666,5,38536,4.3499266282876174,20.0,0.0
28859,2,8859,[174   7  64 515 100],346,3,38539,4.349774266365689,0.0,40.0
28860,2,8860,[302 427 197 180 603],666,5,38544,4.349847646992439,20.0,0.0
28861,2,8861,[282  50 275  95  88],406,2,38546,4.349582487023246,0.0,20.0
28862,2,8862,[302 427 197 180 603],90,5,38551,4.349655872729324,20.0,0.0
28863,2,8863,[302 427 197 180 603],537,5,38556,4.349729241877256,20.0,0.0
28864,2,8864,[302 427 197 180 603],271,5,38561,4.349802594472645,20.0,0.0
28865,2,8865,[135  50 204 328 172],95,4,38565,4.349763140085721,0.0,20.0
28866,2,8866,[302 427 197 180 603],271,5,38570,4.349836472313071,20.0,0.0
28867,2,8867,[302 427 197 180 603],271,5,38575,4.3499097880018045,20.0,0.0
28868,2,8868,[275 191 258 300 173],85,2,38577,4.349644830307814,0.0,0.0
28869,2,8869,[302 427 197 180 603],339,5,38582,4.349718151071026,20.0,0.0
28870,2,8870,[258 237 313 289  82],334,4,38586,4.3496787284409875,0.0,0.0
28871,2,8871,[302 427 197 180 603],537,5,38591,4.349752028854824,20.0,0.0
28872,2,8872,[294  98 257 238 174],213,4,38595,4.349712611292686,0.0,40.0
28873,2,8873,[515 210 546 237  88],234,1,38596,4.349335136353392,0.0,0.0
28874,2,8874,[302 427 197 180 603],666,5,38601,4.349408450704225,20.0,0.0
28875,2,8875,[302 427 197 180 603],339,5,38606,4.349481748535377,20.0,0.0
28876,2,8876,[302 427 197 180 603],666,5,38611,4.349555029852428,20.0,0.0
28877,2,8877,[302 427 197 180 603],474,5,38616,4.34962829466096,20.0,0.0
28878,2,8878,[173  25  95 127 204],455,4,38620,4.349588917670909,0.0,20.0
28879,2,8879,[302 427 197 180 603],664,5,38625,4.349662162162162,20.0,0.0
28880,2,8880,[211 323  71 200 183],474,3,38628,4.349510190293886,0.0,0.0
28881,2,8881,[302 427 197 180 603],339,5,38633,4.349583427156046,20.0,0.0
28882,2,8882,[302 427 197 180 603],537,5,38638,4.349656647528988,20.0,0.0
28883,2,8883,[302 427 197 180 603],537,5,38643,4.34972985141828,20.0,0.0
28884,2,8884,[302 427 197 180 603],537,5,38648,4.349803038829488,20.0,0.0
28885,2,8885,[302 427 197 180 603],13,5,38653,4.3498762097681745,20.0,0.0
28886,2,8886,[302 427 197 180 603],13,5,38658,4.349949364239901,20.0,0.0
28887,2,8887,[302 427 197 180 603],13,5,38663,4.3500225022502255,20.0,0.0
28888,2,8888,[111  64  70 173 151],59,4,38667,4.349983125210935,0.0,0.0
28889,2,8889,[302 427 197 180 603],537,5,38672,4.350056242969629,20.0,0.0
28890,2,8890,[302 427 197 180 603],271,5,38677,4.350129344280734,20.0,0.0
28891,2,8891,[302 427 197 180 603],664,5,38682,4.350202429149798,20.0,0.0
28892,2,8892,[153 191 117  96 427],454,3,38685,4.350050601596761,0.0,0.0
28893,2,8893,[302 427 197 180 603],474,5,38690,4.350123678884641,20.0,0.0
28894,2,8894,[302 427 197 180 603],383,5,38695,4.350196739741428,20.0,0.0
28895,2,8895,[742 258  98 475 111],334,3,38698,4.350044964028777,0.0,20.0
28896,2,8896,[216 121 183 195 185],843,2,38700,4.34978082499719,0.0,0.0
28897,2,8897,[186 211 265 127 121],308,3,38703,4.349629130141605,0.0,20.0
28898,2,8898,[302 427 197 180 603],271,5,38708,4.34970221373188,20.0,0.0
28899,2,8899,[483   1 194 182 181],804,5,38713,4.349775280898877,20.0,0.0
28900,2,8900,[302 427 197 180 603],664,5,38718,4.349848331648129,20.0,0.0
28901,2,8901,[302 427 197 180 603],339,5,38723,4.349921365985172,20.0,0.0
28902,2,8902,[302 427 197 180 603],90,5,38728,4.349994383915534,20.0,0.0
28903,2,8903,[302 427 197 180 603],383,5,38733,4.350067385444744,20.0,0.0
28904,2,8904,[302 427 197 180 603],271,5,38738,4.350140370578327,20.0,0.0
28905,2,8905,[234 200 294 176 215],488,4,38742,4.350101055468223,0.0,0.0
28906,2,8906,[191 588 195  69  96],311,5,38747,4.350174020433367,0.0,0.0
28907,2,8907,[302 427 197 180 603],474,5,38752,4.350246969016614,20.0,0.0
28908,2,8908,[302 427 197 180 603],90,5,38757,4.3503199012234814,20.0,0.0
28909,2,8909,[302 427 197 180 603],474,5,38762,4.350392817059483,20.0,0.0
28910,2,8910,[302 427 197 180 603],90,5,38767,4.350465716530131,20.0,0.0
28911,2,8911,[302 427 197 180 603],666,5,38772,4.350538599640934,20.0,0.0
28912,2,8912,[302 427 197 180 603],666,5,38777,4.350611466397397,20.0,0.0
28913,2,8913,[302 427 197 180 603],90,5,38782,4.350684316805026,20.0,0.0
28914,2,8914,[302 427 197 180 603],474,5,38787,4.350757150869321,20.0,0.0
28915,2,8915,[ 95 257  15 173 210],454,2,38789,4.350493494840736,0.0,0.0
28916,2,8916,[302 427 197 180 603],339,5,38794,4.350566333968824,20.0,0.0
28917,2,8917,[302 427 197 180 603],383,5,38799,4.350639156761606,20.0,0.0
28918,2,8918,[302 427 197 180 603],666,5,38804,4.350711963224577,20.0,0.0
28919,2,8919,[204 210  50 211 127],650,3,38807,4.350560538116592,0.0,40.0
28920,2,8920,[302 427 197 180 603],339,5,38812,4.350633337069835,20.0,0.0
28921,2,8921,[302 427 197 180 603],537,5,38817,4.350706119704102,20.0,0.0
28922,2,8922,[302 427 197 180 603],666,5,38822,4.350778886024879,20.0,0.0
28923,2,8923,[302 427 197 180 603],664,5,38827,4.3508516360376515,20.0,0.0
28924,2,8924,[302 427 197 180 603],339,5,38832,4.350924369747899,20.0,0.0
28925,2,8925,[302 427 197 180 603],90,5,38837,4.350997087161103,20.0,0.0
28926,2,8926,[121  15 234 742 173],59,4,38841,4.350957768567268,0.0,0.0
28927,2,8927,[302 427 197 180 603],271,5,38846,4.351030465949821,20.0,0.0
28928,2,8928,[302 427 197 180 603],664,5,38851,4.351103147048942,20.0,0.0
28929,2,8929,[176 153 405  97 183],892,5,38856,4.3511758118701005,0.0,0.0
28930,2,8930,[302 427 197 180 603],13,5,38861,4.351248460418766,20.0,0.0
28931,2,8931,[302 427 197 180 603],13,5,38866,4.351321092700403,20.0,0.0
28932,2,8932,[302 427 197 180 603],474,5,38871,4.351393708720475,20.0,0.0
28933,2,8933,[302 427 197 180 603],13,5,38876,4.351466308484442,20.0,0.0
28934,2,8934,[302 427 197 180 603],13,5,38881,4.351538891997762,20.0,0.0
28935,2,8935,[302 427 197 180 603],537,5,38886,4.351611459265891,20.0,0.0
28936,2,8936,[302 427 197 180 603],664,5,38891,4.351684010294282,20.0,0.0
28937,2,8937,[202 135  56 234 286],7,4,38895,4.351644663235623,0.0,0.0
28938,2,8938,[302 427 197 180 603],271,5,38900,4.351717194317038,20.0,0.0
28939,2,8939,[302 427 197 180 603],271,5,38905,4.35178970917226,20.0,0.0
28940,2,8940,[302 427 197 180 603],90,5,38910,4.351862207806733,20.0,0.0
28941,2,8941,[ 95 168 318  89  69],233,4,38914,4.351822858420935,20.0,0.0
28942,2,8942,[302 427 197 180 603],90,5,38919,4.35189533713519,20.0,0.0
28943,2,8943,[ 50 302 210 211 588],14,5,38924,4.351967799642218,0.0,20.0
28944,2,8944,[302 427 197 180 603],13,5,38929,4.352040245947457,20.0,0.0
28945,2,8945,[302 427 197 180 603],474,5,38934,4.352112676056338,20.0,0.0
28946,2,8946,[302 427 197 180 603],666,5,38939,4.352185089974293,20.0,0.0
28947,2,8947,[302 427 197 180 603],13,5,38944,4.35225748770675,20.0,0.0
28948,2,8948,[302 427 197 180 603],339,5,38949,4.352329869259135,20.0,0.0
28949,2,8949,[275 323 186  28 288],648,5,38954,4.352402234636871,0.0,0.0
28950,2,8950,[  9   7  12 121 234],455,4,38958,4.352362864484415,20.0,0.0
28951,2,8951,[302 427 197 180 603],271,5,38963,4.352435210008936,20.0,0.0
28952,2,8952,[302 427 197 180 603],664,5,38968,4.352507539372278,20.0,0.0
28953,2,8953,[515 194 655 282 238],666,3,38971,4.352356488720125,0.0,0.0
28954,2,8954,[238 174 471  64 276],271,3,38974,4.352205471803462,0.0,20.0
28955,2,8955,[265 172 100 385 235],374,3,38977,4.352054488610987,0.0,20.0
28956,2,8956,[ 98 258 202 294 161],774,2,38979,4.35179189460757,0.0,20.0
28957,2,8957,[302 427 197 180 603],474,5,38984,4.351864255414155,20.0,0.0
28958,2,8958,[302 427 197 180 603],383,5,38989,4.3519366000669715,20.0,0.0
28959,2,8959,[302 427 197 180 603],13,5,38994,4.352008928571428,20.0,0.0
28960,2,8960,[ 97 176 186 427  96],664,3,38997,4.3518580515567455,0.0,0.0
28961,2,8961,[302 427 197 180 603],537,5,39002,4.351930372684668,20.0,0.0
28962,2,8962,[302 427 197 180 603],383,5,39007,4.352002677674886,20.0,0.0
28963,2,8963,[302 427 197 180 603],474,5,39012,4.352074966532798,20.0,0.0
28964,2,8964,[302 427 197 180 603],339,5,39017,4.352147239263804,20.0,0.0
28965,2,8965,[302 427 197 180 603],664,5,39022,4.352219495873299,20.0,0.0
28966,2,8966,[302 427 197 180 603],537,5,39027,4.352291736366678,20.0,0.0
28967,2,8967,[302 427 197 180 603],271,5,39032,4.352363960749331,20.0,0.0
28968,2,8968,[302 427 197 180 603],383,5,39037,4.352436169026648,20.0,0.0
28969,2,8969,[302 427 197 180 603],474,5,39042,4.352508361204014,20.0,0.0
28970,2,8970,[302 427 197 180 603],666,5,39047,4.352580537286813,20.0,0.0
28971,2,8971,[302 427 197 180 603],666,5,39052,4.352652697280428,20.0,0.0
28972,2,8972,[302 427 197 180 603],537,5,39057,4.352724841190238,20.0,0.0
28973,2,8973,[302 427 197 180 603],666,5,39062,4.352796969021618,20.0,0.0
28974,2,8974,[302 427 197 180 603],537,5,39067,4.352869080779945,20.0,0.0
28975,2,8975,[302 427 197 180 603],537,5,39072,4.352941176470588,20.0,0.0
28976,2,8976,[302 427 197 180 603],13,5,39077,4.35301325609892,20.0,0.0
28977,2,8977,[182 135 172  12 427],194,2,39079,4.352751169525507,20.0,0.0
28978,2,8978,[196 181   8 153 143],454,2,39081,4.3524891413297695,0.0,0.0
28979,2,8979,[302 427 197 180 603],271,5,39086,4.352561247216036,20.0,0.0
28980,2,8980,[302 427 197 180 603],537,5,39091,4.352633337044873,20.0,0.0
28981,2,8981,[302 427 197 180 603],664,5,39096,4.352705410821644,20.0,0.0
28982,2,8982,[100 515 222 173 172],883,4,39100,4.352666147166871,0.0,20.0
28983,2,8983,[302 427 197 180 603],537,5,39105,4.352738201246661,20.0,0.0
28984,2,8984,[302 427 197 180 603],339,5,39110,4.3528102392877015,20.0,0.0
28985,2,8985,[568 191 385  70 269],13,0,39110,4.35232584019586,0.0,0.0
28986,2,8986,[302 427 197 180 603],13,5,39115,4.352397908089462,20.0,0.0
28987,2,8987,[176 588 117 245 435],263,3,39118,4.352247441032488,0.0,0.0
28988,2,8988,[144 427 151 161  88],234,1,39119,4.351874513294026,0.0,0.0
28989,2,8989,[302 427 197 180 603],666,5,39124,4.351946607341491,20.0,0.0
28990,2,8990,[185 228 294 215 176],766,1,39125,4.351573796018241,0.0,0.0
28991,2,8991,[302 427 197 180 603],271,5,39130,4.351645907473309,20.0,0.0
28992,2,8992,[568  25 294  95  71],804,4,39134,4.351606805293006,0.0,0.0
28993,2,8993,[302 427 197 180 603],90,5,39139,4.351678897042473,20.0,0.0
28994,2,8994,[168 143  71 357 121],95,5,39144,4.3517509727626456,20.0,0.0
28995,2,8995,[302 427 197 180 603],90,5,39149,4.351823032458871,20.0,0.0
28996,2,8996,[185 222 228 282 655],194,2,39151,4.351561631654996,0.0,0.0
28997,2,8997,[302 427 197 180 603],537,5,39156,4.351633696376973,20.0,0.0
28998,2,8998,[127 117 655 153 204],102,1,39157,4.351261251250139,0.0,20.0
28999,2,8999,[435 222 271 235 323],650,2,39159,4.351,0.0,0.0
29000,2,9000,[302 427 197 180 603],474,5,39164,4.351072103099655,20.0,0.0
29001,2,9001,[302 427 197 180 603],664,5,39169,4.35114419017996,20.0,0.0
29002,2,9002,[302 427 197 180 603],13,5,39174,4.351216261246251,20.0,0.0
29003,2,9003,[175 234 238   7 183],308,4,39178,4.351177254553532,0.0,0.0
29004,2,9004,[302 427 197 180 603],664,5,39183,4.351249305941144,20.0,0.0
29005,2,9005,[302 427 197 180 603],666,5,39188,4.351321341328004,20.0,0.0
29006,2,9006,[302 427 197 180 603],474,5,39193,4.351393360719441,20.0,0.0
29007,2,9007,[173 245 200 282  98],378,3,39196,4.351243339253997,0.0,20.0
29008,2,9008,[302 427 197 180 603],666,5,39201,4.3513153513153515,20.0,0.0
29009,2,9009,[302 427 197 180 603],13,5,39206,4.351387347391787,20.0,0.0
29010,2,9010,[282 742 117  12  25],447,4,39210,4.351348352014205,20.0,0.0
29011,2,9011,[302 427 197 180 603],664,5,39215,4.3514203284509545,20.0,0.0
29012,2,9012,[302 427 197 180 603],537,5,39220,4.351492288916011,20.0,0.0
29013,2,9013,[234 181 100 289 748],474,3,39223,4.351342356334591,0.0,20.0
29014,2,9014,[302 427 197 180 603],666,5,39228,4.351414309484193,20.0,0.0
29015,2,9015,[302 427 197 180 603],339,5,39233,4.351486246672582,20.0,0.0
29016,2,9016,[ 64  82   1 215 151],788,1,39234,4.351114561384052,0.0,0.0
29017,2,9017,[748 187 173   4 655],804,5,39239,4.351186515857175,0.0,0.0
29018,2,9018,[302 427 197 180 603],537,5,39244,4.351258454374099,20.0,0.0
29019,2,9019,[302 427 197 180 603],339,5,39249,4.351330376940133,20.0,0.0
29020,2,9020,[302 427 197 180 603],474,5,39254,4.351402283560581,20.0,0.0
29021,2,9021,[302 427 197 180 603],90,5,39259,4.351474174240745,20.0,0.0
29022,2,9022,[302 427 197 180 603],537,5,39264,4.351546048985925,20.0,0.0
29023,2,9023,[302 427 197 180 603],90,5,39269,4.351617907801418,20.0,0.0
29024,2,9024,[151 603 435 222  82],537,1,39270,4.351246537396122,20.0,0.0
29025,2,9025,[655 748 423 265 215],13,5,39275,4.351318413472192,0.0,0.0
29026,2,9026,[302 427 197 180 603],474,5,39280,4.351390273623574,20.0,0.0
29027,2,9027,[302 427 197 180 603],666,5,39285,4.351462117855561,20.0,0.0
29028,2,9028,[302 427 197 180 603],339,5,39290,4.351533946173441,20.0,0.0
29029,2,9029,[302 427 197 180 603],271,5,39295,4.351605758582503,20.0,0.0
29030,2,9030,[302 427 197 180 603],13,5,39300,4.35167755508803,20.0,0.0
29031,2,9031,[302 427 197 180 603],666,5,39305,4.351749335695305,20.0,0.0
29032,2,9032,[302 427 197 180 603],13,5,39310,4.351821100409609,20.0,0.0
29033,2,9033,[302 427 197 180 603],664,5,39315,4.3518928492362186,20.0,0.0
29034,2,9034,[302 427 197 180 603],474,5,39320,4.351964582180409,20.0,0.0
29035,2,9035,[187 435  64 127 546],64,4,39324,4.351925630810093,0.0,20.0
29036,2,9036,[302 427 197 180 603],474,5,39329,4.351997344251411,20.0,0.0
29037,2,9037,[302 427 197 180 603],664,5,39334,4.3520690418234125,20.0,0.0
29038,2,9038,[302 427 197 180 603],339,5,39339,4.352140723531364,20.0,0.0
29039,2,9039,[302 427 197 180 603],90,5,39344,4.352212389380531,20.0,0.0
29040,2,9040,[181 186 200 318 135],738,4,39348,4.352173432142462,20.0,0.0
29041,2,9041,[302 427 197 180 603],537,5,39353,4.352245078522451,20.0,0.0
29042,2,9042,[302 427 197 180 603],474,5,39358,4.352316709056729,20.0,0.0
29043,2,9043,[302 427 197 180 603],90,5,39363,4.352388323750553,20.0,0.0
29044,2,9044,[302 427 197 180 603],383,5,39368,4.352459922609176,20.0,0.0
29045,2,9045,[385 186 597 245 234],653,4,39372,4.352420959540129,0.0,0.0
29046,2,9046,[204   7 302   1 195],339,3,39375,4.352271471205925,0.0,0.0
29047,2,9047,[302 427 197 180 603],537,5,39380,4.352343059239611,20.0,0.0
29048,2,9048,[302 427 197 180 603],383,5,39385,4.352414631450989,20.0,0.0
29049,2,9049,[302 427 197 180 603],383,5,39390,4.352486187845304,20.0,0.0
29050,2,9050,[302 427 197 180 603],339,5,39395,4.352557728427798,20.0,0.0
29051,2,9051,[302 427 197 180 603],666,5,39400,4.352629253203712,20.0,0.0
29052,2,9052,[132 385   4  82 197],881,2,39402,4.352369380315918,0.0,0.0
29053,2,9053,[ 50 228  95  56 471],374,4,39406,4.352330461674398,0.0,20.0
29054,2,9054,[302 427 197 180 603],383,5,39411,4.352401987852016,20.0,0.0
29055,2,9055,[294 153 289 111 216],13,2,39413,4.35214222614841,0.0,0.0
29056,2,9056,[302 427 197 180 603],13,5,39418,4.352213757314784,20.0,0.0
29057,2,9057,[302 427 197 180 603],13,5,39423,4.352285272687127,20.0,0.0
29058,2,9058,[302 427 197 180 603],90,5,39428,4.35235677227067,20.0,0.0
29059,2,9059,[302 427 197 180 603],339,5,39433,4.35242825607064,20.0,0.0
29060,2,9060,[302 427 197 180 603],90,5,39438,4.352499724092263,20.0,0.0
29061,2,9061,[302 427 197 180 603],474,5,39443,4.3525711763407635,20.0,0.0
29062,2,9062,[302 427 197 180 603],339,5,39448,4.352642612821362,20.0,0.0
29063,2,9063,[302 427 197 180 603],90,5,39453,4.352714033539276,20.0,0.0
29064,2,9064,[215 313 216 197 515],233,5,39458,4.352785438499724,0.0,0.0
29065,2,9065,[153 183 423   4 496],527,3,39461,4.35263622325171,0.0,0.0
29066,2,9066,[302 427 197 180 603],664,5,39466,4.352707621043344,20.0,0.0
29067,2,9067,[302 427 197 180 603],339,5,39471,4.3527790030877815,20.0,0.0
29068,2,9068,[546  88  69 182 172],378,3,39474,4.352629837909362,0.0,0.0
29069,2,9069,[333   1 195 275 182],10,5,39479,4.352701212789416,0.0,0.0
29070,2,9070,[  7 234 294 173   4],474,4,39483,4.3526623305038035,0.0,0.0
29071,2,9071,[302 427 197 180 603],90,5,39488,4.35273368606702,20.0,0.0
29072,2,9072,[ 71 191 265 435 194],533,4,39492,4.3526948087732835,0.0,0.0
29073,2,9073,[ 82 196  96 215  28],488,3,39495,4.352545735067225,0.0,0.0
29074,2,9074,[302 427 197 180 603],664,5,39500,4.352617079889807,20.0,0.0
29075,2,9075,[ 69 288   9  79 237],374,4,39504,4.352578228294403,0.0,0.0
29076,2,9076,[475 678 222  22  70],82,1,39505,4.352208879585766,0.0,0.0
29077,2,9077,[302 427 197 180 603],664,5,39510,4.3522802379378716,20.0,0.0
29078,2,9078,[182 318 508 403 111],524,5,39515,4.352351580570548,20.0,0.0
29079,2,9079,[302 427 197 180 603],339,5,39520,4.352422907488987,20.0,0.0
29080,2,9080,[288 294 496  70 603],234,2,39522,4.352163858605881,20.0,0.0
29081,2,9081,[302 427 197 180 603],90,5,39527,4.3522351904866765,20.0,0.0
29082,2,9082,[300 211 191 271  98],749,5,39532,4.352306506660795,0.0,20.0
29083,2,9083,[144 483 235 175 228],650,3,39535,4.3521576398062525,20.0,0.0
29084,2,9084,[313  69 161 200 318],59,4,39539,4.352118877270225,20.0,0.0
29085,2,9085,[302 427 197 180 603],537,5,39544,4.352190182698657,20.0,0.0
29086,2,9086,[302 427 197 180 603],13,5,39549,4.352261472433146,20.0,0.0
29087,2,9087,[302 427 197 180 603],90,5,39554,4.352332746478873,20.0,0.0
29088,2,9088,[302 427 197 180 603],474,5,39559,4.352404004841016,20.0,0.0
29089,2,9089,[302 427 197 180 603],90,5,39564,4.352475247524753,20.0,0.0
29090,2,9090,[302 427 197 180 603],271,5,39569,4.352546474535255,20.0,0.0
29091,2,9091,[302 427 197 180 603],13,5,39574,4.352617685877695,20.0,0.0
29092,2,9092,[302 427 197 180 603],339,5,39579,4.352688881557242,20.0,0.0
29093,2,9093,[121   9 168   4 204],339,3,39582,4.35254013635364,0.0,0.0
29094,2,9094,[302 427 197 180 603],339,5,39587,4.352611324903793,20.0,0.0
29095,2,9095,[302 427 197 180 603],383,5,39592,4.352682497801231,20.0,0.0
29096,2,9096,[302 427 197 180 603],537,5,39597,4.3527536550511154,20.0,0.0
29097,2,9097,[302 427 197 180 603],271,5,39602,4.352824796658607,20.0,0.0
29098,2,9098,[302 427 197 180 603],339,5,39607,4.352895922628861,20.0,0.0
29099,2,9099,[302 427 197 180 603],13,5,39612,4.352967032967033,20.0,0.0
29100,2,9100,[265 179 238 546 655],95,2,39614,4.352708493572135,0.0,0.0
29101,2,9101,[302 427 197 180 603],13,5,39619,4.35277960887717,20.0,0.0
29102,2,9102,[302 427 197 180 603],664,5,39624,4.352850708557618,20.0,0.0
29103,2,9103,[302 427 197 180 603],90,5,39629,4.352921792618629,20.0,0.0
29104,2,9104,[322 176  95 100  79],334,2,39631,4.352663371773751,0.0,20.0
29105,2,9105,[302 427 197 180 603],474,5,39636,4.35273446079508,20.0,0.0
29106,2,9106,[302 427 197 180 603],383,5,39641,4.3528055342044585,20.0,0.0
29107,2,9107,[302 427 197 180 603],13,5,39646,4.352876592007027,20.0,0.0
29108,2,9108,[  1 196 191 100 588],295,5,39651,4.3529476342079265,0.0,20.0
29109,2,9109,[302 427 197 180 603],271,5,39656,4.353018660812294,20.0,0.0
29110,2,9110,[  4 423 204 135 174],374,3,39659,4.352870156953133,0.0,20.0
29111,2,9111,[302 427 197 180 603],474,5,39664,4.352941176470588,20.0,0.0
29112,2,9112,[197 186 194  12 195],385,1,39665,4.352573247009766,20.0,0.0
29113,2,9113,[ 70 197 191  11 300],378,3,39668,4.352424840904104,0.0,0.0
29114,2,9114,[302 427 197 180 603],339,5,39673,4.352495885902359,20.0,0.0
29115,2,9115,[471 180 546 176 328],95,2,39675,4.3522378236068455,0.0,0.0
29116,2,9116,[302 427 197 180 603],90,5,39680,4.3523088735329605,20.0,0.0
29117,2,9117,[302 427 197 180 603],664,5,39685,4.352379907874534,20.0,0.0
29118,2,9118,[302 427 197 180 603],537,5,39690,4.352450926636693,20.0,0.0
29119,2,9119,[302 427 197 180 603],664,5,39695,4.352521929824562,20.0,0.0
29120,2,9120,[302 427 197 180 603],271,5,39700,4.352592917443263,20.0,0.0
29121,2,9121,[302 427 197 180 603],537,5,39705,4.352663889497917,20.0,0.0
29122,2,9122,[111 125 318 323 174],59,4,39709,4.352625232927765,20.0,20.0
29123,2,9123,[ 89 186  64 121  69],380,2,39711,4.352367382726874,0.0,0.0
29124,2,9124,[302 427 197 180 603],339,5,39716,4.352438356164384,20.0,0.0
29125,2,9125,[302 427 197 180 603],537,5,39721,4.352509314047776,20.0,0.0
29126,2,9126,[302 427 197 180 603],383,5,39726,4.352580256382163,20.0,0.0
29127,2,9127,[302 427 197 180 603],90,5,39731,4.3526511831726555,20.0,0.0
29128,2,9128,[275  12 286 588  98],537,1,39732,4.352283930331909,20.0,20.0
29129,2,9129,[302 427 197 180 603],271,5,39737,4.352354874041621,20.0,0.0
29130,2,9130,[273 222  25 234 275],537,1,39738,4.351987734092652,0.0,0.0
29131,2,9131,[302 427 197 180 603],90,5,39743,4.352058694699956,20.0,0.0
29132,2,9132,[ 79 144 183 655 204],840,4,39747,4.352020146720683,0.0,0.0
29133,2,9133,[302 427 197 180 603],666,5,39752,4.3520910882417345,20.0,0.0
29134,2,9134,[127 195  50 121 191],881,4,39756,4.352052545155994,0.0,40.0
29135,2,9135,[302 427 197 180 603],537,5,39761,4.3521234676007,20.0,0.0
29136,2,9136,[302 427 197 180 603],383,5,39766,4.3521943745211775,20.0,0.0
29137,2,9137,[183  95 185  96 200],897,4,39770,4.352155832786168,0.0,0.0
29138,2,9138,[302 427 197 180 603],664,5,39775,4.352226720647773,20.0,0.0
29139,2,9139,[357 174 176 269   7],339,5,39780,4.352297592997812,20.0,20.0
29140,2,9140,[302 427 197 180 603],383,5,39785,4.352368449841374,20.0,0.0
29141,2,9141,[302 427 197 180 603],13,5,39790,4.352439291183549,20.0,0.0
29142,2,9142,[302 427 197 180 603],383,5,39795,4.352510117029421,20.0,0.0
29143,2,9143,[302 427 197 180 603],666,5,39800,4.352580927384077,20.0,0.0
29144,2,9144,[302 427 197 180 603],339,5,39805,4.352651722252597,20.0,0.0
29145,2,9145,[302 427 197 180 603],90,5,39810,4.352722501640061,20.0,0.0
29146,2,9146,[234 196 328 385 427],533,4,39814,4.352683940089647,0.0,0.0
29147,2,9147,[302 427 197 180 603],339,5,39819,4.352754700480979,20.0,0.0
29148,2,9148,[181  79 121 603 204],42,5,39824,4.3528254454038695,20.0,0.0
29149,2,9149,[302 427 197 180 603],474,5,39829,4.352896174863388,20.0,0.0
29150,2,9150,[302 427 197 180 603],664,5,39834,4.352966888864605,20.0,0.0
29151,2,9151,[211 121 228 238 153],643,4,39838,4.352928321678322,0.0,0.0
29152,2,9152,[ 98 153 385 211 275],85,2,39840,4.352671255326123,0.0,20.0
29153,2,9153,[302 427 197 180 603],339,5,39845,4.352741970723181,20.0,0.0
29154,2,9154,[211 143 313  79 161],650,3,39848,4.352594210813763,0.0,0.0
29155,2,9155,[215 237  64 748  88],92,3,39851,4.352446483180428,0.0,0.0
29156,2,9156,[302 427 197 180 603],383,5,39856,4.352517199956318,20.0,0.0
29157,2,9157,[302 427 197 180 603],664,5,39861,4.352587901288491,20.0,0.0
29158,2,9158,[385 191 132 180 234],308,3,39864,4.352440222731739,0.0,0.0
29159,2,9159,[302 427 197 180 603],339,5,39869,4.352510917030568,20.0,0.0
29160,2,9160,[276 496 323 117 300],311,4,39873,4.3524724375068224,0.0,0.0
29161,2,9161,[288 121 100  64  98],892,5,39878,4.352543112857455,0.0,40.0
29162,2,9162,[151 276 179 161  22],334,4,39882,4.352504638218924,0.0,0.0
29163,2,9163,[176 597 228 234 435],102,1,39883,4.352138804015714,0.0,0.0
29164,2,9164,[185  11 182 153  28],13,3,39886,4.351991271140207,0.0,0.0
29165,2,9165,[302 427 197 180 603],474,5,39891,4.352061968143138,20.0,0.0
29166,2,9166,[302 427 197 180 603],90,5,39896,4.3521326497218285,20.0,0.0
29167,2,9167,[302 427 197 180 603],271,5,39901,4.352203315881327,20.0,0.0
29168,2,9168,[302 427 197 180 603],666,5,39906,4.352273966626677,20.0,0.0
29169,2,9169,[302 427 197 180 603],339,5,39911,4.352344601962923,20.0,0.0
29170,2,9170,[302 427 197 180 603],537,5,39916,4.352415221895104,20.0,0.0
29171,2,9171,[118 222  95 313 496],454,3,39919,4.352267771478412,0.0,0.0
29172,2,9172,[302 427 197 180 603],664,5,39924,4.352338384388967,20.0,0.0
29173,2,9173,[302 427 197 180 603],537,5,39929,4.352408981905385,20.0,0.0
29174,2,9174,[216 191 179 275  64],90,5,39934,4.352479564032698,0.0,0.0
29175,2,9175,[302 427 197 180 603],90,5,39939,4.3525501307759376,20.0,0.0
29176,2,9176,[121 111  69 258 161],533,5,39944,4.352620682140133,0.0,0.0
29177,2,9177,[302 427 197 180 603],13,5,39949,4.352691218130311,20.0,0.0
29178,2,9178,[403  28 132 483 265],308,1,39950,4.352325961433707,20.0,0.0
29179,2,9179,[195 655  82  28 144],804,5,39955,4.35239651416122,0.0,0.0
29180,2,9180,[302 427 197 180 603],664,5,39960,4.352467051519442,20.0,0.0
29181,2,9181,[302 427 197 180 603],666,5,39965,4.352537573513396,20.0,0.0
29182,2,9182,[  4 427 313  50   7],537,4,39969,4.35249918327344,0.0,20.0
29183,2,9183,[302 427 197 180 603],271,5,39974,4.35256968641115,20.0,0.0
29184,2,9184,[302 427 197 180 603],339,5,39979,4.35264017419706,20.0,0.0
29185,2,9185,[302 427 197 180 603],666,5,39984,4.352710646636186,20.0,0.0
29186,2,9186,[302 427 197 180 603],474,5,39989,4.352781103733537,20.0,0.0
29187,2,9187,[302 427 197 180 603],271,5,39994,4.352851545494123,20.0,0.0
29188,2,9188,[302 427 197 180 603],664,5,39999,4.352921971922951,20.0,0.0
29189,2,9189,[302 427 197 180 603],339,5,40004,4.352992383025027,20.0,0.0
29190,2,9190,[302 427 197 180 603],271,5,40009,4.353062778805353,20.0,0.0
29191,2,9191,[302 427 197 180 603],271,5,40014,4.353133159268929,20.0,0.0
29192,2,9192,[302 427 197 180 603],537,5,40019,4.3532035244207545,20.0,0.0
29193,2,9193,[302 427 197 180 603],339,5,40024,4.353273874265826,20.0,0.0
29194,2,9194,[125  96  95 475 313],64,4,40028,4.353235454051115,0.0,0.0
29195,2,9195,[302 427 197 180 603],383,5,40033,4.353305785123967,20.0,0.0
29196,2,9196,[302 427 197 180 603],383,5,40038,4.3533761009024685,20.0,0.0
29197,2,9197,[302 427 197 180 603],383,5,40043,4.353446401391607,20.0,0.0
29198,2,9198,[302 427 197 180 603],474,5,40048,4.353516686596369,20.0,0.0
29199,2,9199,[403 237   1 161 202],934,4,40052,4.353478260869565,0.0,0.0
29200,2,9200,[302 427 197 180 603],537,5,40057,4.353548527333985,20.0,0.0
29201,2,9201,[302 427 197 180 603],383,5,40062,4.353618778526407,20.0,0.0
29202,2,9202,[302 427 197 180 603],271,5,40067,4.353689014451809,20.0,0.0
29203,2,9203,[302 427 197 180 603],537,5,40072,4.3537592351151675,20.0,0.0
29204,2,9204,[302 427 197 180 603],664,5,40077,4.353829440521456,20.0,0.0
29205,2,9205,[ 11 168 176 257 175],881,3,40080,4.353682381055833,0.0,0.0
29206,2,9206,[302 427 197 180 603],90,5,40085,4.353752579559031,20.0,0.0
29207,2,9207,[357 748 191 211 475],533,2,40087,4.353496959165943,20.0,0.0
29208,2,9208,[302 427 197 180 603],666,5,40092,4.353567162558367,20.0,0.0
29209,2,9209,[302 427 197 180 603],664,5,40097,4.353637350705754,20.0,0.0
29210,2,9210,[302 427 197 180 603],90,5,40102,4.353707523613071,20.0,0.0
29211,2,9211,[302 427 197 180 603],666,5,40107,4.35377768128528,20.0,0.0
29212,2,9212,[302 427 197 180 603],537,5,40112,4.3538478237273415,20.0,0.0
29213,2,9213,[ 97 204  95 483  79],60,4,40116,4.353809420447146,20.0,0.0
29214,2,9214,[153 496 678 187 173],648,3,40119,4.35366250678242,0.0,0.0
29215,2,9215,[302 427 197 180 603],383,5,40124,4.353732638888889,20.0,0.0
29216,2,9216,[302 427 197 180 603],537,5,40129,4.353802755777368,20.0,0.0
29217,2,9217,[302 427 197 180 603],537,5,40134,4.35387285745281,20.0,0.0
29218,2,9218,[742 405  56 183  96],313,2,40136,4.353617529016162,0.0,0.0
29219,2,9219,[302 427 197 180 603],537,5,40141,4.353687635574837,20.0,0.0
29220,2,9220,[427  70 423 173  95],537,3,40144,4.353540830712504,0.0,0.0
29221,2,9221,[ 95 258 313 194 100],454,3,40147,4.353394057688137,0.0,20.0
29222,2,9222,[237 568 186 200 238],13,2,40149,4.3531388919006835,0.0,0.0
29223,2,9223,[302 427 197 180 603],13,5,40154,4.353209019947962,20.0,0.0
29224,2,9224,[302 427 197 180 603],271,5,40159,4.353279132791328,20.0,0.0
29225,2,9225,[183 496  71   7 153],892,4,40163,4.353240841101235,0.0,0.0
29226,2,9226,[302 427 197 180 603],474,5,40168,4.35331093529858,20.0,0.0
29227,2,9227,[302 427 197 180 603],13,5,40173,4.353381014304292,20.0,0.0
29228,2,9228,[302 427 197 180 603],666,5,40178,4.353451078123307,20.0,0.0
29229,2,9229,[302 427 197 180 603],13,5,40183,4.353521126760564,20.0,0.0
29230,2,9230,[302 427 197 180 603],13,5,40188,4.3535911602209945,20.0,0.0
29231,2,9231,[302 427 197 180 603],13,5,40193,4.353661178509532,20.0,0.0
29232,2,9232,[183  89 211 496 181],897,4,40197,4.353622874472003,0.0,0.0
29233,2,9233,[289 302 182 172 173],454,1,40198,4.353259692440979,0.0,0.0
29234,2,9234,[268 235 475 135 121],13,3,40201,4.353113156469951,0.0,0.0
29235,2,9235,[302 427 197 180 603],664,5,40206,4.3531831961888265,20.0,0.0
29236,2,9236,[302 427 197 180 603],90,5,40211,4.3532532207426655,20.0,0.0
29237,2,9237,[276 100 202  50 515],234,3,40214,4.353106733059104,0.0,40.0
29238,2,9238,[302 427 197 180 603],339,5,40219,4.353176750730599,20.0,0.0
29239,2,9239,[302 427 197 180 603],339,5,40224,4.353246753246753,20.0,0.0
29240,2,9240,[302 427 197 180 603],13,5,40229,4.353316740612488,20.0,0.0
29241,2,9241,[204 222  95 173 385],194,2,40231,4.353062107768881,0.0,0.0
29242,2,9242,[  9  79 151 275 515],7,4,40235,4.353023909985935,0.0,0.0
29243,2,9243,[515 276 210 127  82],194,2,40237,4.352769363911727,0.0,20.0
29244,2,9244,[403 328 678  89  50],506,4,40241,4.352731206057328,0.0,20.0
29245,2,9245,[302 427 197 180 603],474,5,40246,4.352801211334631,20.0,0.0
29246,2,9246,[385 185  71 238 475],648,2,40248,4.35254677192603,0.0,0.0
29247,2,9247,[302 427 197 180 603],474,5,40253,4.352616782006921,20.0,0.0
29248,2,9248,[302 427 197 180 603],339,5,40258,4.352686776948859,20.0,0.0
29249,2,9249,[302 427 197 180 603],90,5,40263,4.352756756756757,20.0,0.0
29250,2,9250,[302 427 197 180 603],664,5,40268,4.3528267214355205,20.0,0.0
29251,2,9251,[302 427 197 180 603],666,5,40273,4.352896670990056,20.0,0.0
29252,2,9252,[302 427 197 180 603],537,5,40278,4.352966605425268,20.0,0.0
29253,2,9253,[ 56 195 216  15 258],92,3,40281,4.352820401988329,0.0,0.0
29254,2,9254,[302 427 197 180 603],664,5,40286,4.3528903295515935,20.0,0.0
29255,2,9255,[294 168 288 196 302],474,2,40288,4.352636127917027,0.0,0.0
29256,2,9256,[302 427 197 180 603],664,5,40293,4.352706060278708,20.0,0.0
29257,2,9257,[ 69 742 273 127 181],833,1,40294,4.352343918772953,0.0,20.0
29258,2,9258,[176 183  50 210 483],311,5,40299,4.352413867588292,20.0,20.0
29259,2,9259,[302 427 197 180 603],474,5,40304,4.352483801295897,20.0,0.0
29260,2,9260,[302 427 197 180 603],13,5,40309,4.3525537199006585,20.0,0.0
29261,2,9261,[302 427 197 180 603],664,5,40314,4.352623623407472,20.0,0.0
29262,2,9262,[302 427 197 180 603],664,5,40319,4.352693511821224,20.0,0.0
29263,2,9263,[302 427 197 180 603],474,5,40324,4.352763385146805,20.0,0.0
29264,2,9264,[302 427 197 180 603],90,5,40329,4.352833243389099,20.0,0.0
29265,2,9265,[302 427 197 180 603],339,5,40334,4.352903086552989,20.0,0.0
29266,2,9266,[302 427 197 180 603],13,5,40339,4.352972914643358,20.0,0.0
29267,2,9267,[ 15 258 234 185   4],59,4,40343,4.352934829520932,0.0,0.0
29268,2,9268,[302 427 197 180 603],666,5,40348,4.353004639119646,20.0,0.0
29269,2,9269,[302 427 197 180 603],339,5,40353,4.353074433656958,20.0,0.0
29270,2,9270,[302 427 197 180 603],13,5,40358,4.353144213137742,20.0,0.0
29271,2,9271,[238 228  96 300  97],13,3,40361,4.35299827437446,0.0,0.0
29272,2,9272,[181  98  89  15 121],648,4,40365,4.352960207052734,0.0,20.0
29273,2,9273,[191 655 175 174 568],92,4,40369,4.352922147940479,0.0,20.0
29274,2,9274,[302 427 197 180 603],271,5,40374,4.352991913746631,20.0,0.0
29275,2,9275,[302 427 197 180 603],664,5,40379,4.353061664510565,20.0,0.0
29276,2,9276,[302 427 197 180 603],474,5,40384,4.353131400237146,20.0,0.0
29277,2,9277,[183 234 200 197 385],833,2,40386,4.352877775382626,0.0,0.0
29278,2,9278,[ 89 194  79 269 423],7,4,40390,4.352839745662248,0.0,0.0
29279,2,9279,[302 427 197 180 603],666,5,40395,4.352909482758621,20.0,0.0
29280,2,9280,[302 427 197 180 603],664,5,40400,4.352979204827066,20.0,0.0
29281,2,9281,[135 435 210 228 186],533,3,40403,4.352833441068735,0.0,0.0
29282,2,9282,[302 427 197 180 603],666,5,40408,4.352903156307228,20.0,0.0
29283,2,9283,[302 427 197 180 603],537,5,40413,4.352972856527359,20.0,0.0
29284,2,9284,[258 210 168 216 496],215,4,40417,4.352934841141626,0.0,0.0
29285,2,9285,[ 97 496 204 135 483],85,4,40421,4.352896833943571,20.0,0.0
29286,2,9286,[302 427 197 180 603],666,5,40426,4.352966512329062,20.0,0.0
29287,2,9287,[127 182 143 175 508],385,3,40429,4.352820844099914,0.0,20.0
29288,2,9288,[302 427 197 180 603],383,5,40434,4.352890515663688,20.0,0.0
29289,2,9289,[182 286  12 127 172],271,4,40438,4.352852529601722,20.0,20.0
29290,2,9290,[302 427 197 180 603],537,5,40443,4.352922182757507,20.0,0.0
29291,2,9291,[496 100 546 191 182],650,3,40446,4.352776582006027,0.0,20.0
29292,2,9292,[ 96 568 288 515 135],537,2,40448,4.352523404713225,0.0,0.0
29293,2,9293,[211 268 405 288 172],537,2,40450,4.352270281902302,0.0,0.0
29294,2,9294,[143 125 196 151  22],254,3,40453,4.352124798278645,0.0,0.0
29295,2,9295,[294 588 186 111  56],378,2,40455,4.351871772805508,0.0,0.0
29296,2,9296,[322 276  79  50 301],537,2,40457,4.35161880176401,0.0,20.0
29297,2,9297,[135 143 174 210 328],13,2,40459,4.351365885136588,0.0,20.0
29298,2,9298,[302 427 197 180 603],90,5,40464,4.351435638240671,20.0,0.0
29299,2,9299,[302 427 197 180 603],271,5,40469,4.351505376344086,20.0,0.0
29300,2,9300,[135 237 181 191 175],666,3,40472,4.3513600688098055,0.0,0.0
29301,2,9301,[121 318 515  64 423],207,4,40476,4.35132229628037,20.0,0.0
29302,2,9302,[302 427 197 180 603],90,5,40481,4.351392024078255,20.0,0.0
29303,2,9303,[302 427 197 180 603],13,5,40486,4.3514617368873605,20.0,0.0
29304,2,9304,[302 427 197 180 603],474,5,40491,4.35153143471252,20.0,0.0
29305,2,9305,[302 427 197 180 603],271,5,40496,4.351601117558564,20.0,0.0
29306,2,9306,[ 11 289 300 125  28],378,3,40499,4.35145589341356,0.0,0.0
29307,2,9307,[302 427 197 180 603],13,5,40504,4.351525569402664,20.0,0.0
29308,2,9308,[302 427 197 180 603],271,5,40509,4.351595230422172,20.0,0.0
29309,2,9309,[302 427 197 180 603],13,5,40514,4.351664876476907,20.0,0.0
29310,2,9310,[302 427 197 180 603],90,5,40519,4.351734507571689,20.0,0.0
29311,2,9311,[302 427 197 180 603],666,5,40524,4.35180412371134,20.0,0.0
29312,2,9312,[179 132  96  97 195],536,3,40527,4.351658971330399,0.0,0.0
29313,2,9313,[ 97 237 238 175 172],308,3,40530,4.351513850118102,0.0,0.0
29314,2,9314,[302 427 197 180 603],339,5,40535,4.351583467525496,20.0,0.0
29315,2,9315,[302 427 197 180 603],474,5,40540,4.351653069987119,20.0,0.0
29316,2,9316,[302 427 197 180 603],666,5,40545,4.351722657507781,20.0,0.0
29317,2,9317,[302 427 197 180 603],474,5,40550,4.351792230092294,20.0,0.0
29318,2,9318,[302 427 197 180 603],664,5,40555,4.351861787745467,20.0,0.0
29319,2,9319,[302 427 197 180 603],271,5,40560,4.351931330472103,20.0,0.0
29320,2,9320,[302 427 197 180 603],339,5,40565,4.352000858277009,20.0,0.0
29321,2,9321,[196 288 204 194  22],387,1,40566,4.351641278695559,0.0,0.0
29322,2,9322,[172 185 111 234 194],271,4,40570,4.351603561085487,0.0,0.0
29323,2,9323,[174 183 111 186 151],374,3,40573,4.351458601458601,0.0,20.0
29324,2,9324,[302 427 197 180 603],271,5,40578,4.351528150134048,20.0,0.0
29325,2,9325,[302 427 197 180 603],664,5,40583,4.3515976838944885,20.0,0.0
29326,2,9326,[302 427 197 180 603],90,5,40588,4.35166720274472,20.0,0.0
29327,2,9327,[302 427 197 180 603],271,5,40593,4.351736706689537,20.0,0.0
29328,2,9328,[302 427 197 180 603],271,5,40598,4.351806195733734,20.0,0.0
29329,2,9329,[302 427 197 180 603],474,5,40603,4.351875669882101,20.0,0.0
29330,2,9330,[ 95 127 187 435 322],524,4,40607,4.351837959489872,0.0,20.0
29331,2,9331,[  7 385 197 294  25],650,3,40610,4.3516930990141445,0.0,0.0
29332,2,9332,[427 215 143 423 405],7,3,40613,4.351548269581056,0.0,0.0
29333,2,9333,[302 427 197 180 603],90,5,40618,4.3516177415898865,20.0,0.0
29334,2,9334,[302 427 197 180 603],383,5,40623,4.351687198714515,20.0,0.0
29335,2,9335,[  9 132  50 238 135],749,3,40626,4.3515424164524426,0.0,20.0
29336,2,9336,[302 427 197 180 603],271,5,40631,4.3516118667666275,20.0,0.0
29337,2,9337,[302 427 197 180 603],664,5,40636,4.35168130220604,20.0,0.0
29338,2,9338,[302 427 197 180 603],339,5,40641,4.351750722775458,20.0,0.0
29339,2,9339,[302 427 197 180 603],90,5,40646,4.351820128479657,20.0,0.0
29340,2,9340,[603 405 200 127 197],7,4,40650,4.3517824644042395,20.0,20.0
29341,2,9341,[302 427 197 180 603],13,5,40655,4.351851851851852,20.0,0.0
29342,2,9342,[475 322 117 286 257],533,4,40659,4.35181419244354,0.0,0.0
29343,2,9343,[135 483 265 172 435],848,4,40663,4.351776541095891,20.0,0.0
29344,2,9344,[302 427 197 180 603],383,5,40668,4.351845906902087,20.0,0.0
29345,2,9345,[302 427 197 180 603],537,5,40673,4.351915257864327,20.0,0.0
29346,2,9346,[302 427 197 180 603],537,5,40678,4.351984593987376,20.0,0.0
29347,2,9347,[168 143 132  79 405],653,1,40679,4.3516260162601625,0.0,0.0
29348,2,9348,[748 151 423 176 265],648,3,40682,4.35148144186544,0.0,0.0
29349,2,9349,[302 427 197 180 603],271,5,40687,4.351550802139037,20.0,0.0
29350,2,9350,[471 496 200 282  64],271,3,40690,4.351406266709443,0.0,0.0
29351,2,9351,[  9 258  11 515 222],474,5,40695,4.351475620188195,0.0,0.0
29352,2,9352,[302 427 197 180 603],271,5,40700,4.351544958836737,20.0,0.0
29353,2,9353,[302 427 197 180 603],13,5,40705,4.351614282659825,20.0,0.0
29354,2,9354,[302 427 197 180 603],383,5,40710,4.351683591662213,20.0,0.0
29355,2,9355,[302 427 197 180 603],474,5,40715,4.351752885848653,20.0,0.0
29356,2,9356,[302 427 197 180 603],664,5,40720,4.351822165223896,20.0,0.0
29357,2,9357,[568 357 318 151 405],537,2,40722,4.351570848471896,40.0,0.0
29358,2,9358,[302 427 197 180 603],474,5,40727,4.351640132492788,20.0,0.0
29359,2,9359,[202 185 405 111 294],42,4,40731,4.351602564102564,0.0,0.0
29360,2,9360,[302 427 197 180 603],339,5,40736,4.351671829932699,20.0,0.0
29361,2,9361,[302 427 197 180 603],13,5,40741,4.351741080965605,20.0,0.0
29362,2,9362,[302 427 197 180 603],271,5,40746,4.351810317206024,20.0,0.0
29363,2,9363,[197 301  50 117 286],184,3,40749,4.351665954720205,0.0,20.0
29364,2,9364,[276  50 597  64 168],374,3,40752,4.3515216230646026,0.0,20.0
29365,2,9365,[302 427 197 180 603],666,5,40757,4.351590860559471,20.0,0.0
29366,2,9366,[302 427 197 180 603],383,5,40762,4.351660083271058,20.0,0.0
29367,2,9367,[302 427 197 180 603],474,5,40767,4.351729291204099,20.0,0.0
29368,2,9368,[182  25 423  98 323],59,5,40772,4.351798484363326,0.0,20.0
29369,2,9369,[302 427 197 180 603],666,5,40777,4.3518676627534685,20.0,0.0
29370,2,9370,[302 427 197 180 603],13,5,40782,4.351936826379255,20.0,0.0
29371,2,9371,[302 427 197 180 603],90,5,40787,4.352005975245412,20.0,0.0
29372,2,9372,[302 427 197 180 603],383,5,40792,4.3520751093566625,20.0,0.0
29373,2,9373,[ 11   1 182  50  15],378,4,40796,4.352037550672072,0.0,20.0
29374,2,9374,[302 427 197 180 603],271,5,40801,4.352106666666667,20.0,0.0
29375,2,9375,[135 187  12  50 181],686,5,40806,4.352175767918089,20.0,20.0
29376,2,9376,[302 427 197 180 603],339,5,40811,4.352244854431055,20.0,0.0
29377,2,9377,[302 427 197 180 603],664,5,40816,4.35231392621028,20.0,0.0
29378,2,9378,[ 97 183 423  88   8],543,3,40819,4.352169740910544,0.0,0.0
29379,2,9379,[302 427 197 180 603],664,5,40824,4.352238805970149,20.0,0.0
29380,2,9380,[302 427 197 180 603],537,5,40829,4.352307856305298,20.0,0.0
29381,2,9381,[302 427 197 180 603],383,5,40834,4.3523768919206995,20.0,0.0
29382,2,9382,[302 427 197 180 603],537,5,40839,4.352445912821059,20.0,0.0
29383,2,9383,[302 427 197 180 603],339,5,40844,4.352514919011083,20.0,0.0
29384,2,9384,[302 427 197 180 603],664,5,40849,4.352583910495471,20.0,0.0
29385,2,9385,[125  56 328 294 546],234,0,40849,4.352120178989985,0.0,0.0
29386,2,9386,[197 300  56 172 196],13,4,40853,4.352082667518909,0.0,0.0
29387,2,9387,[403 174  96 357 204],311,5,40858,4.352151682999574,20.0,20.0
29388,2,9388,[302 427 197 180 603],271,5,40863,4.35222068377889,20.0,0.0
29389,2,9389,[302 427 197 180 603],474,5,40868,4.3522896698615545,20.0,0.0
29390,2,9390,[655 268 176  22 172],13,4,40872,4.352252156319881,0.0,0.0
29391,2,9391,[302 427 197 180 603],339,5,40877,4.352321124361159,20.0,0.0
29392,2,9392,[302 427 197 180 603],383,5,40882,4.352390077717449,20.0,0.0
29393,2,9393,[302 427 197 180 603],474,5,40887,4.352459016393443,20.0,0.0
29394,2,9394,[302 427 197 180 603],271,5,40892,4.352527940393826,20.0,0.0
29395,2,9395,[237  95  50 161 405],313,2,40894,4.352277564921243,0.0,20.0
29396,2,9396,[302 427 197 180 603],383,5,40899,4.352346493561775,20.0,0.0
29397,2,9397,[302 427 197 180 603],13,5,40904,4.352415407533518,20.0,0.0
29398,2,9398,[185 215  97 204 269],659,5,40909,4.352484306841153,0.0,0.0
29399,2,9399,[302 427 197 180 603],383,5,40914,4.352553191489362,20.0,0.0
29400,2,9400,[302 427 197 180 603],666,5,40919,4.352622061482821,20.0,0.0
29401,2,9401,[302 427 197 180 603],664,5,40924,4.352690916826207,20.0,0.0
29402,2,9402,[302 427 197 180 603],383,5,40929,4.352759757524194,20.0,0.0
29403,2,9403,[302 427 197 180 603],13,5,40934,4.352828583581455,20.0,0.0
29404,2,9404,[302 427 197 180 603],271,5,40939,4.352897395002659,20.0,0.0
29405,2,9405,[302 427 197 180 603],383,5,40944,4.352966191792473,20.0,0.0
29406,2,9406,[183 322   4 546 237],374,4,40948,4.352928670139258,0.0,0.0
29407,2,9407,[302 427 197 180 603],90,5,40953,4.3529974489795915,20.0,0.0
29408,2,9408,[302 427 197 180 603],271,5,40958,4.353066213200128,20.0,0.0
29409,2,9409,[302 427 197 180 603],90,5,40963,4.353134962805526,20.0,0.0
29410,2,9410,[ 12 742 496 318 423],271,4,40967,4.353097439166932,40.0,0.0
29411,2,9411,[286   9 210 179 323],648,3,40970,4.352953676158096,0.0,0.0
29412,2,9412,[302 427 197 180 603],271,5,40975,4.353022415807925,20.0,0.0
29413,2,9413,[302 427 197 180 603],339,5,40980,4.353091140854048,20.0,0.0
29414,2,9414,[265   1 168  69 173],883,2,40982,4.352841210833776,0.0,0.0
29415,2,9415,[210 135 508 302 174],378,4,40986,4.352803738317757,0.0,20.0
29416,2,9416,[302 427 197 180 603],271,5,40991,4.352872464691515,20.0,0.0
29417,2,9417,[302 427 197 180 603],383,5,40996,4.352941176470588,20.0,0.0
29418,2,9418,[435 403 282  64 405],328,3,40999,4.3527975368935135,0.0,0.0
29419,2,9419,[ 98 175 125 318 181],378,4,41003,4.35276008492569,20.0,20.0
29420,2,9420,[302 427 197 180 603],666,5,41008,4.3528287867529984,20.0,0.0
29421,2,9421,[302 427 197 180 603],13,5,41013,4.352897473997028,20.0,0.0
29422,2,9422,[302 427 197 180 603],474,5,41018,4.352966146662422,20.0,0.0
29423,2,9423,[302 427 197 180 603],271,5,41023,4.35303480475382,20.0,0.0
29424,2,9424,[302 427 197 180 603],271,5,41028,4.353103448275862,20.0,0.0
29425,2,9425,[302 427 197 180 603],271,5,41033,4.353172077233185,20.0,0.0
29426,2,9426,[302 427 197 180 603],537,5,41038,4.353240691630424,20.0,0.0
29427,2,9427,[302 427 197 180 603],13,5,41043,4.35330929147221,20.0,0.0
29428,2,9428,[302 427 197 180 603],13,5,41048,4.353377876763178,20.0,0.0
29429,2,9429,[302 427 197 180 603],666,5,41053,4.353446447507953,20.0,0.0
29430,2,9430,[125  96 196 273  79],7,4,41057,4.3534089704167105,0.0,0.0
29431,2,9431,[302 427 197 180 603],339,5,41062,4.353477523324852,20.0,0.0
29432,2,9432,[216 186 427  88 357],398,5,41067,4.353546061698293,20.0,0.0
29433,2,9433,[302 427 197 180 603],339,5,41072,4.353614585541658,20.0,0.0
29434,2,9434,[302 427 197 180 603],474,5,41077,4.353683094859566,20.0,0.0
29435,2,9435,[302 427 197 180 603],537,5,41082,4.353751589656635,20.0,0.0
29436,2,9436,[302 427 197 180 603],664,5,41087,4.3538200699374805,20.0,0.0
29437,2,9437,[194 204 187 234 423],897,5,41092,4.353888535706718,0.0,0.0
29438,2,9438,[ 28 265   1 151 204],537,0,41092,4.353427269837907,0.0,0.0
29439,2,9439,[302 427 197 180 603],383,5,41097,4.353495762711864,20.0,0.0
29440,2,9440,[179  70 143 385 742],648,4,41101,4.35345832009321,0.0,0.0
29441,2,9441,[302 427 197 180 603],383,5,41106,4.353526795170515,20.0,0.0
29442,2,9442,[302 427 197 180 603],271,5,41111,4.353595255744996,20.0,0.0
29443,2,9443,[302 427 197 180 603],271,5,41116,4.3536637018212625,20.0,0.0
29444,2,9444,[ 50 238 222 173 153],804,5,41121,4.353732133403917,0.0,20.0
29445,2,9445,[302 427 197 180 603],90,5,41126,4.353800550497565,20.0,0.0
29446,2,9446,[302 427 197 180 603],474,5,41131,4.353868953106806,20.0,0.0
29447,2,9447,[302 427 197 180 603],666,5,41136,4.35393734123624,20.0,0.0
29448,2,9448,[168  79 655  50 196],7,5,41141,4.354005714890465,0.0,20.0
29449,2,9449,[302 427 197 180 603],13,5,41146,4.354074074074074,20.0,0.0
29450,2,9450,[302 427 197 180 603],537,5,41151,4.354142418791662,20.0,0.0
29451,2,9451,[302 427 197 180 603],666,5,41156,4.35421074904782,20.0,0.0
29452,2,9452,[302 427 197 180 603],537,5,41161,4.354279064847138,20.0,0.0
29453,2,9453,[151 286 196 210 423],95,5,41166,4.354347366194204,0.0,0.0
29454,2,9454,[302 427 197 180 603],271,5,41171,4.354415653093601,20.0,0.0
29455,2,9455,[ 97  88 258 195 318],454,5,41176,4.354483925549915,20.0,0.0
29456,2,9456,[302 427 197 180 603],271,5,41181,4.354552183567727,20.0,0.0
29457,2,9457,[196 318 237 508 211],59,4,41185,4.354514696553182,20.0,0.0
29458,2,9458,[175 333 257 271 678],334,3,41188,4.35437149804419,0.0,0.0
29459,2,9459,[302 427 197 180 603],474,5,41193,4.354439746300211,20.0,0.0
29460,2,9460,[302 427 197 180 603],664,5,41198,4.35450798012895,20.0,0.0
29461,2,9461,[302 427 197 180 603],666,5,41203,4.354576199534982,20.0,0.0
29462,2,9462,[302 427 197 180 603],383,5,41208,4.354644404522879,20.0,0.0
29463,2,9463,[302 427 197 180 603],666,5,41213,4.354712595097211,20.0,0.0
29464,2,9464,[302 427 197 180 603],666,5,41218,4.354780771262546,20.0,0.0
29465,2,9465,[302 427 197 180 603],13,5,41223,4.354848933023453,20.0,0.0
29466,2,9466,[302 427 197 180 603],383,5,41228,4.354917080384493,20.0,0.0
29467,2,9467,[302 427 197 180 603],474,5,41233,4.354985213350233,20.0,0.0
29468,2,9468,[302 427 197 180 603],537,5,41238,4.355053331925229,20.0,0.0
29469,2,9469,[302 427 197 180 603],90,5,41243,4.355121436114044,20.0,0.0
29470,2,9470,[302 427 197 180 603],537,5,41248,4.355189525921233,20.0,0.0
29471,2,9471,[234   7 471 151 357],788,2,41250,4.354940878378378,20.0,0.0
29472,2,9472,[423  82 357 183  69],543,4,41254,4.3549034096907,20.0,0.0
29473,2,9473,[302 427 197 180 603],339,5,41259,4.3549715009499685,20.0,0.0
29474,2,9474,[200 183  28 125 216],92,2,41261,4.354722955145118,0.0,0.0
29475,2,9475,[268  22 216 423 196],92,2,41263,4.354474461798227,0.0,0.0
29476,2,9476,[302 427 197 180 603],666,5,41268,4.354542576764799,20.0,0.0
29477,2,9477,[302 427 197 180 603],666,5,41273,4.354610677358092,20.0,0.0
29478,2,9478,[161  22  88  96 151],749,4,41277,4.354573267222281,0.0,0.0
29479,2,9479,[174 238 288 216 228],643,4,41281,4.354535864978903,0.0,20.0
29480,2,9480,[211 603 748 483 202],749,4,41285,4.354498470625462,40.0,0.0
29481,2,9481,[  4 118 333 215 175],881,2,41287,4.354250158194474,0.0,0.0
29482,2,9482,[127 125  89  88 403],653,2,41289,4.354001898133502,0.0,20.0
29483,2,9483,[302 427 197 180 603],383,5,41294,4.3540700126528895,20.0,0.0
29484,2,9484,[302 427 197 180 603],474,5,41299,4.354138112809699,20.0,0.0
29485,2,9485,[302 427 197 180 603],271,5,41304,4.354206198608476,20.0,0.0
29486,2,9486,[  4 427 176  12 175],339,5,41309,4.354274270053757,20.0,0.0
29487,2,9487,[302 427 197 180 603],666,5,41314,4.354342327150085,20.0,0.0
29488,2,9488,[302 427 197 180 603],13,5,41319,4.354410369901991,20.0,0.0
29489,2,9489,[313 742  22 216 238],184,3,41322,4.354267650158061,0.0,0.0
29490,2,9490,[302 427 197 180 603],383,5,41327,4.354335686439785,20.0,0.0
29491,2,9491,[204  11 185 423 168],881,4,41331,4.354298356510746,0.0,0.0
29492,2,9492,[302 427 197 180 603],664,5,41336,4.354366375223849,20.0,0.0
29493,2,9493,[302 427 197 180 603],474,5,41341,4.354434379608174,20.0,0.0
29494,2,9494,[435 423 515 286 288],537,1,41342,4.354081095313322,0.0,0.0
29495,2,9495,[302 427 197 180 603],271,5,41347,4.354149115417018,20.0,0.0
29496,2,9496,[302 427 197 180 603],13,5,41352,4.354217121196167,20.0,0.0
29497,2,9497,[302 427 197 180 603],666,5,41357,4.354285112655296,20.0,0.0
29498,2,9498,[302 427 197 180 603],13,5,41362,4.354353089798926,20.0,0.0
29499,2,9499,[302 427 197 180 603],474,5,41367,4.3544210526315785,20.0,0.0
29500,2,9500,[302 427 197 180 603],383,5,41372,4.354489001157773,20.0,0.0
29501,2,9501,[302 427 197 180 603],339,5,41377,4.354556935382025,20.0,0.0
29502,2,9502,[678  15 196 153 294],488,2,41379,4.354309165526676,0.0,0.0
29503,2,9503,[ 12 222 181 204 515],745,2,41381,4.354061447811448,20.0,0.0
29504,2,9504,[302 427 197 180 603],90,5,41386,4.354129405576012,20.0,0.0
29505,2,9505,[180 216  71 187  69],233,5,41391,4.3541973490427095,0.0,0.0
29506,2,9506,[302 427 197 180 603],664,5,41396,4.354265278216051,20.0,0.0
29507,2,9507,[186 403   4  88 318],13,3,41399,4.3541228439209085,20.0,0.0
29508,2,9508,[302 427 197 180 603],271,5,41404,4.3541907666421285,20.0,0.0
29509,2,9509,[302 427 197 180 603],666,5,41409,4.3542586750788645,20.0,0.0
29510,2,9510,[302 427 197 180 603],271,5,41414,4.354326569235622,20.0,0.0
29511,2,9511,[238 153 117  89 132],184,3,41417,4.354184188393608,0.0,0.0
29512,2,9512,[302 427 197 180 603],90,5,41422,4.3542520761063805,20.0,0.0
29513,2,9513,[302 427 197 180 603],90,5,41427,4.354319949548034,20.0,0.0
29514,2,9514,[183 187 546 215  82],804,4,41431,4.354282711508145,0.0,0.0
29515,2,9515,[302 427 197 180 603],664,5,41436,4.354350567465321,20.0,0.0
29516,2,9516,[302 427 197 180 603],13,5,41441,4.354418409162551,20.0,0.0
29517,2,9517,[302 427 197 180 603],271,5,41446,4.354486236604329,20.0,0.0
29518,2,9518,[135   1 568  98 200],326,2,41448,4.354238890639773,0.0,20.0
29519,2,9519,[302 427 197 180 603],90,5,41453,4.354306722689076,20.0,0.0
29520,2,9520,[302 427 197 180 603],664,5,41458,4.354374540489444,20.0,0.0
29521,2,9521,[302 427 197 180 603],13,5,41463,4.354442344045369,20.0,0.0
29522,2,9522,[302 427 197 180 603],666,5,41468,4.354510133361336,20.0,0.0
29523,2,9523,[302 427 197 180 603],271,5,41473,4.354577908441831,20.0,0.0
29524,2,9524,[302 427 197 180 603],537,5,41478,4.3546456692913385,20.0,0.0
29525,2,9525,[302 427 197 180 603],383,5,41483,4.35471341591434,20.0,0.0
29526,2,9526,[302 427 197 180 603],13,5,41488,4.354781148315315,20.0,0.0
29527,2,9527,[161 423  98 168  69],648,3,41491,4.354638958858103,0.0,20.0
29528,2,9528,[302 427 197 180 603],474,5,41496,4.354706684856753,20.0,0.0
29529,2,9529,[  9  22 185 121 289],474,4,41500,4.354669464847849,0.0,0.0
29530,2,9530,[302 427 197 180 603],271,5,41505,4.354737173434057,20.0,0.0
29531,2,9531,[655  88 288 183 100],92,3,41508,4.354595048258497,0.0,20.0
29532,2,9532,[302 427 197 180 603],339,5,41513,4.3546627504458195,20.0,0.0
29533,2,9533,[302 427 197 180 603],339,5,41518,4.354730438430879,20.0,0.0
29534,2,9534,[302 427 197 180 603],664,5,41523,4.354798112218144,20.0,0.0
29535,2,9535,[302 427 197 180 603],383,5,41528,4.35486577181208,20.0,0.0
29536,2,9536,[121 181 197 294 245],452,3,41531,4.354723707664884,0.0,0.0
29537,2,9537,[135 216 273   4 210],13,2,41533,4.3544768295240095,0.0,0.0
29538,2,9538,[294 118 237 282 173],145,4,41537,4.354439668728379,0.0,0.0
29539,2,9539,[  7 471  97 191  64],7,5,41542,4.354507337526205,0.0,0.0
29540,2,9540,[302 427 197 180 603],271,5,41547,4.354574992139189,20.0,0.0
29541,2,9541,[302 427 197 180 603],666,5,41552,4.354642632571788,20.0,0.0
29542,2,9542,[302 427 197 180 603],90,5,41557,4.354710258828461,20.0,0.0
29543,2,9543,[100 603  69 405   7],537,3,41560,4.354568315171836,20.0,20.0
29544,2,9544,[ 25 204   7 275 258],13,2,41562,4.354321634363541,0.0,0.0
29545,2,9545,[302 427 197 180 603],537,5,41567,4.354389272993924,20.0,0.0
29546,2,9546,[302 427 197 180 603],664,5,41572,4.354456897454698,20.0,0.0
29547,2,9547,[302 427 197 180 603],90,5,41577,4.354524507750314,20.0,0.0
29548,2,9548,[302 427 197 180 603],474,5,41582,4.354592103885223,20.0,0.0
29549,2,9549,[302 427 197 180 603],664,5,41587,4.354659685863874,20.0,0.0
29550,2,9550,[302 427 197 180 603],13,5,41592,4.354727253690713,20.0,0.0
29551,2,9551,[210  79 258   4 301],234,1,41593,4.354376046901173,0.0,0.0
29552,2,9552,[302 427 197 180 603],90,5,41598,4.354443630273213,20.0,0.0
29553,2,9553,[265   9  82  25 161],194,3,41601,4.354301863093992,0.0,0.0
29554,2,9554,[228 174 121 238  89],87,4,41605,4.3542647828362115,0.0,20.0
29555,2,9555,[302 427 197 180 603],666,5,41610,4.3543323566345755,20.0,0.0
29556,2,9556,[302 427 197 180 603],271,5,41615,4.354399916291723,20.0,0.0
29557,2,9557,[302 427 197 180 603],271,5,41620,4.354467461812095,20.0,0.0
29558,2,9558,[302 427 197 180 603],537,5,41625,4.354534993200126,20.0,0.0
29559,2,9559,[302 427 197 180 603],271,5,41630,4.354602510460251,20.0,0.0
29560,2,9560,[302 427 197 180 603],666,5,41635,4.3546700135969045,20.0,0.0
29561,2,9561,[302 427 197 180 603],339,5,41640,4.354737502614515,20.0,0.0
29562,2,9562,[302 427 197 180 603],271,5,41645,4.3548049775175155,20.0,0.0
29563,2,9563,[302 427 197 180 603],90,5,41650,4.3548724383103306,20.0,0.0
29564,2,9564,[475 471 568 289 215],533,3,41653,4.354730789336121,0.0,0.0
29565,2,9565,[ 70 597  98 228 238],59,3,41656,4.354589169977002,0.0,20.0
29566,2,9566,[183 322 427  70 175],788,3,41659,4.3544475802236855,0.0,0.0
29567,2,9567,[302 427 197 180 603],664,5,41664,4.354515050167224,20.0,0.0
29568,2,9568,[302 427 197 180 603],537,5,41669,4.354582506008987,20.0,0.0
29569,2,9569,[302 427 197 180 603],666,5,41674,4.354649947753396,20.0,0.0
29570,2,9570,[302 427 197 180 603],90,5,41679,4.354717375404869,20.0,0.0
29571,2,9571,[216 423 174  11 182],881,4,41683,4.35468031759298,0.0,20.0
29572,2,9572,[245  22 197 211 597],653,3,41686,4.354538807061528,0.0,0.0
29573,2,9573,[ 82 173 172 179 204],524,3,41689,4.354397326091497,0.0,0.0
29574,2,9574,[471 286  82   8  25],194,0,41689,4.353942558746736,0.0,0.0
29575,2,9575,[302 427 197 180 603],664,5,41694,4.3540100250626566,20.0,0.0
29576,2,9576,[302 427 197 180 603],90,5,41699,4.354077477289339,20.0,0.0
29577,2,9577,[302 427 197 180 603],664,5,41704,4.354144915431196,20.0,0.0
29578,2,9578,[269  82 181   8  15],254,3,41707,4.354003549431047,0.0,0.0
29579,2,9579,[302 427 197 180 603],339,5,41712,4.354070981210856,20.0,0.0
29580,2,9580,[302 427 197 180 603],664,5,41717,4.354138398914518,20.0,0.0
29581,2,9581,[302 427 197 180 603],271,5,41722,4.354205802546441,20.0,0.0
29582,2,9582,[302 427 197 180 603],339,5,41727,4.35427319211103,20.0,0.0
29583,2,9583,[302 427 197 180 603],90,5,41732,4.354340567612688,20.0,0.0
29584,2,9584,[302 427 197 180 603],664,5,41737,4.354407929055816,20.0,0.0
29585,2,9585,[302 427 197 180 603],271,5,41742,4.354475276444815,20.0,0.0
29586,2,9586,[302 427 197 180 603],13,5,41747,4.354542609784082,20.0,0.0
29587,2,9587,[121  69 151 172 180],833,2,41749,4.3542970379641215,0.0,0.0
29588,2,9588,[302 427 197 180 603],339,5,41754,4.354364375847325,20.0,0.0
29589,2,9589,[302 427 197 180 603],271,5,41759,4.354431699687174,20.0,0.0
29590,2,9590,[ 12  88 186 173 271],13,3,41762,4.3542904806589515,20.0,0.0
29591,2,9591,[302 427 197 180 603],271,5,41767,4.354357798165138,20.0,0.0
29592,2,9592,[302 427 197 180 603],664,5,41772,4.35442510163661,20.0,0.0
29593,2,9593,[302 427 197 180 603],271,5,41777,4.354492391077757,20.0,0.0
29594,2,9594,[302 427 197 180 603],474,5,41782,4.354559666492965,20.0,0.0
29595,2,9595,[286 175 195 483 322],788,3,41785,4.3544185077115465,20.0,0.0
29596,2,9596,[294 276 135  25 405],537,2,41787,4.354173179118474,0.0,0.0
29597,2,9597,[302 427 197 180 603],664,5,41792,4.354240466763909,20.0,0.0
29598,2,9598,[302 427 197 180 603],664,5,41797,4.354307740389624,20.0,0.0
29599,2,9599,[ 50 181 603 186 275],308,5,41802,4.354375,20.0,20.0
29600,2,9600,[135 196  88  70  95],506,5,41807,4.354442245599417,0.0,0.0
29601,2,9601,[302 427 197 180 603],664,5,41812,4.354509477192251,20.0,0.0
29602,2,9602,[302 427 197 180 603],339,5,41817,4.354576694782881,20.0,0.0
29603,2,9603,[302 427 197 180 603],537,5,41822,4.354643898375677,20.0,0.0
29604,2,9604,[302 427 197 180 603],666,5,41827,4.354711087975013,20.0,0.0
29605,2,9605,[302 427 197 180 603],537,5,41832,4.354778263585259,20.0,0.0
29606,2,9606,[302 427 197 180 603],664,5,41837,4.354845425210784,20.0,0.0
29607,2,9607,[210 568 181  12 300],379,4,41841,4.354808492922564,20.0,0.0
29608,2,9608,[302 427 197 180 603],537,5,41846,4.354875637423249,20.0,0.0
29609,2,9609,[302 427 197 180 603],339,5,41851,4.354942767950052,20.0,0.0
29610,2,9610,[302 427 197 180 603],383,5,41856,4.355009884507336,20.0,0.0
29611,2,9611,[471  69 328 282 135],92,4,41860,4.354972950478569,0.0,0.0
29612,2,9612,[302 427 197 180 603],383,5,41865,4.355040049932383,20.0,0.0
29613,2,9613,[ 25 276 176 235 173],210,4,41869,4.355003120449345,0.0,0.0
29614,2,9614,[302 427 197 180 603],13,5,41874,4.355070202808112,20.0,0.0
29615,2,9615,[302 427 197 180 603],13,5,41879,4.355137271214642,20.0,0.0
29616,2,9616,[302 427 197 180 603],664,5,41884,4.355204325673287,20.0,0.0
29617,2,9617,[302 427 197 180 603],537,5,41889,4.355271366188397,20.0,0.0
29618,2,9618,[302 427 197 180 603],90,5,41894,4.35533839276432,20.0,0.0
29619,2,9619,[186 318 515  64 118],524,3,41897,4.355197505197506,20.0,0.0
29620,2,9620,[302 427 197 180 603],271,5,41902,4.355264525517098,20.0,0.0
29621,2,9621,[302 427 197 180 603],13,5,41907,4.355331531906049,20.0,0.0
29622,2,9622,[302 427 197 180 603],339,5,41912,4.3553985243687,20.0,0.0
29623,2,9623,[302 427 197 180 603],90,5,41917,4.355465502909393,20.0,0.0
29624,2,9624,[302 427 197 180 603],271,5,41922,4.355532467532467,20.0,0.0
29625,2,9625,[302 427 197 180 603],474,5,41927,4.35559941824226,20.0,0.0
29626,2,9626,[655 222 546 143 210],194,1,41928,4.355250856964787,0.0,0.0
29627,2,9627,[475  97 187 357 144],343,5,41933,4.355317823016203,20.0,0.0
29628,2,9628,[302 427 197 180 603],271,5,41938,4.355384775158376,20.0,0.0
29629,2,9629,[118 144 121 423 748],328,3,41941,4.355244029075805,0.0,0.0
29630,2,9630,[302 427 197 180 603],537,5,41946,4.355310974976638,20.0,0.0
29631,2,9631,[302 427 197 180 603],271,5,41951,4.355377906976744,20.0,0.0
29632,2,9632,[151 403  89 161 200],899,3,41954,4.355237205439635,0.0,0.0
29633,2,9633,[302 427 197 180 603],13,5,41959,4.355304131201993,20.0,0.0
29634,2,9634,[302 427 197 180 603],339,5,41964,4.355371043072132,20.0,0.0
29635,2,9635,[302 427 197 180 603],666,5,41969,4.3554379410543795,20.0,0.0
29636,2,9636,[302 427 197 180 603],666,5,41974,4.355504825153056,20.0,0.0
29637,2,9637,[302 427 197 180 603],666,5,41979,4.355571695372484,20.0,0.0
29638,2,9638,[286   7   4 234 111],653,1,41980,4.355223570909845,0.0,0.0
29639,2,9639,[496  98 118 603 135],59,5,41985,4.355290456431535,20.0,20.0
29640,2,9640,[302 427 197 180 603],13,5,41990,4.355357328078,20.0,0.0
29641,2,9641,[302 427 197 180 603],271,5,41995,4.355424185853558,20.0,0.0
29642,2,9642,[302 427 197 180 603],339,5,42000,4.355491029762522,20.0,0.0
29643,2,9643,[275 655 322 403 222],328,2,42002,4.355246785566155,0.0,0.0
29644,2,9644,[302 427 197 180 603],474,5,42007,4.355313634007258,20.0,0.0
29645,2,9645,[121  88 385 289 125],533,4,42011,4.355276798673025,0.0,0.0
29646,2,9646,[302 427 197 180 603],383,5,42016,4.355343630144087,20.0,0.0
29647,2,9647,[185  82  79 174  70],64,4,42020,4.35530679933665,0.0,20.0
29648,2,9648,[302 427 197 180 603],90,5,42025,4.355373613845995,20.0,0.0
29649,2,9649,[ 12 181   8 180 597],7,3,42028,4.355233160621761,20.0,0.0
29650,2,9650,[302 427 197 180 603],271,5,42033,4.355299968915138,20.0,0.0
29651,2,9651,[302 427 197 180 603],339,5,42038,4.355366763365105,20.0,0.0
29652,2,9652,[302 427 197 180 603],339,5,42043,4.355433543975966,20.0,0.0
29653,2,9653,[302 427 197 180 603],474,5,42048,4.35550031075202,20.0,0.0
29654,2,9654,[302 427 197 180 603],383,5,42053,4.355567063697566,20.0,0.0
29655,2,9655,[302 427 197 180 603],537,5,42058,4.355633802816901,20.0,0.0
29656,2,9656,[302 427 197 180 603],383,5,42063,4.355700528114321,20.0,0.0
29657,2,9657,[302 427 197 180 603],664,5,42068,4.355767239594119,20.0,0.0
29658,2,9658,[302 427 197 180 603],474,5,42073,4.355833937260586,20.0,0.0
29659,2,9659,[215 655 176 121 678],749,3,42076,4.355693581780538,0.0,0.0
29660,2,9660,[302 427 197 180 603],13,5,42081,4.355760273263638,20.0,0.0
29661,2,9661,[302 427 197 180 603],537,5,42086,4.355826950941834,20.0,0.0
29662,2,9662,[302 427 197 180 603],383,5,42091,4.355893614819414,20.0,0.0
29663,2,9663,[302 427 197 180 603],339,5,42096,4.355960264900662,20.0,0.0
29664,2,9664,[302 427 197 180 603],90,5,42101,4.3560269011898605,20.0,0.0
29665,2,9665,[385 135 100 273  97],774,0,42101,4.355576246637699,0.0,20.0
29666,2,9666,[302 427 197 180 603],474,5,42106,4.355642908865211,20.0,0.0
29667,2,9667,[302 427 197 180 603],90,5,42111,4.355709557302441,20.0,0.0
29668,2,9668,[286 194 234  82  11],343,4,42115,4.3556727686420516,0.0,0.0
29669,2,9669,[302 427 197 180 603],339,5,42120,4.355739400206825,20.0,0.0
29670,2,9670,[286  50 508 275 515],343,5,42125,4.3558060179919345,0.0,20.0
29671,2,9671,[302 427 197 180 603],90,5,42130,4.355872622001654,20.0,0.0
29672,2,9672,[302 427 197 180 603],666,5,42135,4.355939212240257,20.0,0.0
29673,2,9673,[302 427 197 180 603],383,5,42140,4.356005788712012,20.0,0.0
29674,2,9674,[302 427 197 180 603],90,5,42145,4.356072351421188,20.0,0.0
29675,2,9675,[302 427 197 180 603],339,5,42150,4.356138900372055,20.0,0.0
29676,2,9676,[195 435  56  98 187],650,3,42153,4.355998759946265,0.0,20.0
29677,2,9677,[121 282 405 186  56],92,4,42157,4.355961975614797,0.0,0.0
29678,2,9678,[302 427 197 180 603],339,5,42162,4.356028515342494,20.0,0.0
29679,2,9679,[302 427 197 180 603],537,5,42167,4.356095041322314,20.0,0.0
29680,2,9680,[302 427 197 180 603],90,5,42172,4.3561615535585165,20.0,0.0
29681,2,9681,[328 265 200  15 144],92,2,42174,4.355918198719273,0.0,0.0
29682,2,9682,[302 427 197 180 603],537,5,42179,4.35598471548074,20.0,0.0
29683,2,9683,[275 168  50 276 269],883,4,42183,4.355947955390334,0.0,20.0
29684,2,9684,[302 427 197 180 603],474,5,42188,4.356014455343314,20.0,0.0
29685,2,9685,[111  71 302 323 265],13,4,42192,4.355977699772868,0.0,0.0
29686,2,9686,[200  12 195 174  89],6,4,42196,4.3559409517910606,20.0,20.0
29687,2,9687,[302 427 197 180 603],339,5,42201,4.356007431874484,20.0,0.0
29688,2,9688,[204 127 546 508 423],643,3,42204,4.355867478583961,0.0,20.0
29689,2,9689,[302 427 197 180 603],90,5,42209,4.35593395252838,20.0,0.0
29690,2,9690,[302 427 197 180 603],90,5,42214,4.356000412754102,20.0,0.0
29691,2,9691,[302 427 197 180 603],474,5,42219,4.356066859265374,20.0,0.0
29692,2,9692,[302 427 197 180 603],666,5,42224,4.356133292066439,20.0,0.0
29693,2,9693,[302 427 197 180 603],537,5,42229,4.356199711161543,20.0,0.0
29694,2,9694,[302 427 197 180 603],271,5,42234,4.3562661165549255,20.0,0.0
29695,2,9695,[302 427 197 180 603],474,5,42239,4.3563325082508255,20.0,0.0
29696,2,9696,[179 194 216  22  82],194,3,42242,4.35619263689801,0.0,0.0
29697,2,9697,[302 427 197 180 603],383,5,42247,4.356259022478862,20.0,0.0
29698,2,9698,[302 427 197 180 603],271,5,42252,4.356325394370554,20.0,0.0
29699,2,9699,[215 483 568 210 202],892,5,42257,4.35639175257732,20.0,0.0
29700,2,9700,[302 427 197 180 603],271,5,42262,4.356458097103391,20.0,0.0
29701,2,9701,[302 427 197 180 603],339,5,42267,4.3565244279529995,20.0,0.0
29702,2,9702,[195 135 179 161 183],308,4,42271,4.356487684221375,0.0,0.0
29703,2,9703,[302 427 197 180 603],383,5,42276,4.356553998351195,20.0,0.0
29704,2,9704,[302 427 197 180 603],537,5,42281,4.356620298815044,20.0,0.0
29705,2,9705,[210 403 597 286 471],378,3,42284,4.356480527508757,0.0,0.0
29706,2,9706,[302 427 197 180 603],383,5,42289,4.356546821881117,20.0,0.0
29707,2,9707,[302 427 197 180 603],339,5,42294,4.356613102595797,20.0,0.0
29708,2,9708,[302 427 197 180 603],537,5,42299,4.356679369657019,20.0,0.0
29709,2,9709,[ 88 168 215 245   1],653,2,42301,4.356436663233779,0.0,0.0
29710,2,9710,[294 471 153 211 127],234,1,42302,4.356091030789826,0.0,20.0
29711,2,9711,[302 427 197 180 603],13,5,42307,4.356157331136738,20.0,0.0
29712,2,9712,[302 427 197 180 603],339,5,42312,4.3562236178317715,20.0,0.0
29713,2,9713,[302 427 197 180 603],271,5,42317,4.356289890879143,20.0,0.0
29714,2,9714,[125 282 323  82 121],200,4,42321,4.356253216675245,0.0,0.0
29715,2,9715,[302 427 197 180 603],90,5,42326,4.35631947303417,20.0,0.0
29716,2,9716,[328   9 100 276   1],271,2,42328,4.356076978491304,0.0,20.0
29717,2,9717,[302 427 197 180 603],271,5,42333,4.35614323934966,20.0,0.0
29718,2,9718,[302 427 197 180 603],666,5,42338,4.356209486572693,20.0,0.0
29719,2,9719,[302 427 197 180 603],271,5,42343,4.356275720164609,20.0,0.0
29720,2,9720,[302 427 197 180 603],664,5,42348,4.356341940129616,20.0,0.0
29721,2,9721,[181 235 288 132 258],64,4,42352,4.356305286977988,0.0,0.0
29722,2,9722,[302 427 197 180 603],271,5,42357,4.356371490280778,20.0,0.0
29723,2,9723,[302 427 197 180 603],339,5,42362,4.356437679967092,20.0,0.0
29724,2,9724,[302 427 197 180 603],339,5,42367,4.356503856041131,20.0,0.0
29725,2,9725,[302 427 197 180 603],537,5,42372,4.356570018507094,20.0,0.0
29726,2,9726,[302 427 197 180 603],474,5,42377,4.356636167369179,20.0,0.0
29727,2,9727,[191 435 176 603 385],59,5,42382,4.356702302631579,20.0,0.0
29728,2,9728,[302 427 197 180 603],339,5,42387,4.356768424298489,20.0,0.0
29729,2,9729,[302 427 197 180 603],666,5,42392,4.3568345323741005,20.0,0.0
29730,2,9730,[135 603 269   4 161],339,4,42396,4.356797862501285,20.0,0.0
29731,2,9731,[238  56 117 435  69],6,3,42399,4.356658446362515,0.0,0.0
29732,2,9732,[ 25  82 333 202 496],343,3,42402,4.356519058871879,0.0,0.0
29733,2,9733,[302 427 197 180 603],664,5,42407,4.35658516539963,20.0,0.0
29734,2,9734,[117 294 204 202  69],13,3,42410,4.3564458140729325,0.0,0.0
29735,2,9735,[302 427 197 180 603],271,5,42415,4.356511914543961,20.0,0.0
29736,2,9736,[302 427 197 180 603],537,5,42420,4.356578001437814,20.0,0.0
29737,2,9737,[258 234  82  28 172],64,3,42423,4.356438693776957,0.0,0.0
29738,2,9738,[302 427 197 180 603],666,5,42428,4.356504774617517,20.0,0.0
29739,2,9739,[302 427 197 180 603],90,5,42433,4.356570841889117,20.0,0.0
29740,2,9740,[302 427 197 180 603],537,5,42438,4.356636895595935,20.0,0.0
29741,2,9741,[302 427 197 180 603],664,5,42443,4.356702935742147,20.0,0.0
29742,2,9742,[302 427 197 180 603],90,5,42448,4.35676896233193,20.0,0.0
29743,2,9743,[508 179  22 475 302],207,3,42451,4.356629720853859,0.0,0.0
29744,2,9744,[302 427 197 180 603],383,5,42456,4.356695741405849,20.0,0.0
29745,2,9745,[302 427 197 180 603],474,5,42461,4.356761748409604,20.0,0.0
29746,2,9746,[228 187 268 276 496],334,4,42465,4.356725146198831,0.0,0.0
29747,2,9747,[302 427 197 180 603],666,5,42470,4.356791136643414,20.0,0.0
29748,2,9748,[175 269 742 121  70],666,3,42473,4.356651964304032,0.0,0.0
29749,2,9749,[  9 427 202 161 483],694,5,42478,4.356717948717948,20.0,0.0
29750,2,9750,[302 427 197 180 603],339,5,42483,4.35678391959799,20.0,0.0
29751,2,9751,[302 427 197 180 603],537,5,42488,4.356849876948318,20.0,0.0
29752,2,9752,[ 98 174  82 168 748],64,3,42491,4.356710755664924,0.0,40.0
29753,2,9753,[302 427 197 180 603],90,5,42496,4.356776706992004,20.0,0.0
29754,2,9754,[161 597 186 288  96],643,3,42499,4.356637621732445,0.0,0.0
29755,2,9755,[302 427 197 180 603],339,5,42504,4.35670356703567,20.0,0.0
29756,2,9756,[302 427 197 180 603],474,5,42509,4.356769498821359,20.0,0.0
29757,2,9757,[273  69 151 172 603],59,4,42513,4.35673293707727,20.0,0.0
29758,2,9758,[302 427 197 180 603],271,5,42518,4.356798852341428,20.0,0.0
29759,2,9759,[302 427 197 180 603],537,5,42523,4.3568647540983605,20.0,0.0
29760,2,9760,[302 427 197 180 603],666,5,42528,4.356930642352218,20.0,0.0
29761,2,9761,[302 427 197 180 603],537,5,42533,4.3569965171071505,20.0,0.0
29762,2,9762,[302 427 197 180 603],383,5,42538,4.3570623783673055,20.0,0.0
29763,2,9763,[302 427 197 180 603],664,5,42543,4.35712822613683,20.0,0.0
29764,2,9764,[546  89 143 496 237],882,4,42547,4.357091653865847,0.0,0.0
29765,2,9765,[302 427 197 180 603],13,5,42552,4.3571574851525705,20.0,0.0
29766,2,9766,[144 237 186 515 173],194,4,42556,4.357120917374834,0.0,0.0
29767,2,9767,[289 121   9 288  50],554,4,42560,4.357084357084357,0.0,20.0
29768,2,9768,[302 427 197 180 603],383,5,42565,4.357150168901628,20.0,0.0
29769,2,9769,[302 427 197 180 603],664,5,42570,4.357215967246674,20.0,0.0
29770,2,9770,[202 515 471 508  15],92,3,42573,4.357077064783543,0.0,0.0
29771,2,9771,[118 202 215 168 588],892,5,42578,4.357142857142857,0.0,0.0
29772,2,9772,[ 64 111  89 204  12],234,1,42579,4.356799345134554,20.0,0.0
29773,2,9773,[143  88   4 568 234],648,4,42583,4.356762840188255,0.0,0.0
29774,2,9774,[302 427 197 180 603],664,5,42588,4.356828644501279,20.0,0.0
29775,2,9775,[302 427 197 180 603],339,5,42593,4.356894435351882,20.0,0.0
29776,2,9776,[302 427 197 180 603],90,5,42598,4.3569602127441955,20.0,0.0
29777,2,9777,[302 427 197 180 603],664,5,42603,4.3570259766823485,20.0,0.0
29778,2,9778,[195 328 289 471 300],537,0,42603,4.356580427446569,0.0,0.0
29779,2,9779,[302 427 197 180 603],537,5,42608,4.356646216768916,20.0,0.0
29780,2,9780,[234 175  89 257 403],934,4,42612,4.356609753603926,0.0,0.0
29781,2,9781,[302 427 197 180 603],271,5,42617,4.356675526477203,20.0,0.0
29782,2,9782,[302 427 197 180 603],90,5,42622,4.3567412859041195,20.0,0.0
29783,2,9783,[302 427 197 180 603],474,5,42627,4.356807031888798,20.0,0.0
29784,2,9784,[ 79 568 435 179  56],378,4,42631,4.356770567194686,0.0,0.0
29785,2,9785,[302 427 197 180 603],537,5,42636,4.35683629675046,20.0,0.0
29786,2,9786,[245 742  64 515 183],666,3,42639,4.356697660161439,0.0,0.0
29787,2,9787,[302 427 197 180 603],339,5,42644,4.356763383735186,20.0,0.0
29788,2,9788,[302 427 197 180 603],339,5,42649,4.3568290938808865,20.0,0.0
29789,2,9789,[568  89 100 179   1],194,3,42652,4.356690500510725,0.0,20.0
29790,2,9790,[302 427 197 180 603],664,5,42657,4.356756204677765,20.0,0.0
29791,2,9791,[302 427 197 180 603],474,5,42662,4.3568218954248366,20.0,0.0
29792,2,9792,[302 427 197 180 603],13,5,42667,4.35688757275605,20.0,0.0
29793,2,9793,[302 427 197 180 603],13,5,42672,4.3569532366755155,20.0,0.0
29794,2,9794,[302 427 197 180 603],666,5,42677,4.3570188871873405,20.0,0.0
29795,2,9795,[302 427 197 180 603],383,5,42682,4.357084524295631,20.0,0.0
29796,2,9796,[302 427 197 180 603],13,5,42687,4.357150148004491,20.0,0.0
29797,2,9797,[302 427 197 180 603],537,5,42692,4.357215758318024,20.0,0.0
29798,2,9798,[302 427 197 180 603],13,5,42697,4.357281355240331,20.0,0.0
29799,2,9799,[302 427 197 180 603],664,5,42702,4.35734693877551,20.0,0.0
29800,2,9800,[302 427 197 180 603],666,5,42707,4.35741250892766,20.0,0.0
29801,2,9801,[546 174 204 173 216],295,5,42712,4.357478065700877,0.0,20.0
29802,2,9802,[269  22  95 168 216],271,4,42716,4.357441599510354,0.0,0.0
29803,2,9803,[357 143 288 268  82],537,2,42718,4.357201142390861,20.0,0.0
29804,2,9804,[302 427 197 180 603],666,5,42723,4.357266700662927,20.0,0.0
29805,2,9805,[195 301 423 202 313],378,2,42725,4.3570263104221905,0.0,0.0
29806,2,9806,[302 427 197 180 603],339,5,42730,4.35709187315183,20.0,0.0
29807,2,9807,[ 71 175 237 174  28],194,3,42733,4.356953507340946,0.0,20.0
29808,2,9808,[302 427 197 180 603],666,5,42738,4.357019064124783,20.0,0.0
29809,2,9809,[302 427 197 180 603],537,5,42743,4.357084607543323,20.0,0.0
29810,2,9810,[ 95 318 182   4 200],59,4,42747,4.35704821119152,20.0,0.0
29811,2,9811,[302 427 197 180 603],666,5,42752,4.357113738279658,20.0,0.0
29812,2,9812,[ 98 121 127 172 268],643,4,42756,4.357077346377254,0.0,40.0
29813,2,9813,[ 82 117 181 235 176],643,2,42758,4.356837171387813,0.0,0.0
29814,2,9814,[302 427 197 180 603],474,5,42763,4.356902699949058,20.0,0.0
29815,2,9815,[302 427 197 180 603],474,5,42768,4.356968215158925,20.0,0.0
29816,2,9816,[300 234 185 273 588],537,1,42769,4.356626260568402,0.0,0.0
29817,2,9817,[180 483 568 603 546],13,3,42772,4.356488083112651,40.0,0.0
29818,2,9818,[302 427 197 180 603],271,5,42777,4.356553620531622,20.0,0.0
29819,2,9819,[302 427 197 180 603],90,5,42782,4.356619144602852,20.0,0.0
29820,2,9820,[302 427 197 180 603],537,5,42787,4.356684655330414,20.0,0.0
29821,2,9821,[302 427 197 180 603],474,5,42792,4.356750152718387,20.0,0.0
29822,2,9822,[302 427 197 180 603],339,5,42797,4.356815636770844,20.0,0.0
29823,2,9823,[302 427 197 180 603],383,5,42802,4.356881107491857,20.0,0.0
29824,2,9824,[302 427 197 180 603],90,5,42807,4.356946564885496,20.0,0.0
29825,2,9825,[302 427 197 180 603],666,5,42812,4.357012008955832,20.0,0.0
29826,2,9826,[302 427 197 180 603],271,5,42817,4.35707743970693,20.0,0.0
29827,2,9827,[302 427 197 180 603],13,5,42822,4.357142857142857,20.0,0.0
29828,2,9828,[302 427 197 180 603],90,5,42827,4.357208261267678,20.0,0.0
29829,2,9829,[302 427 197 180 603],339,5,42832,4.3572736520854525,20.0,0.0
29830,2,9830,[302 427 197 180 603],271,5,42837,4.3573390296002446,20.0,0.0
29831,2,9831,[265 187  64  88 172],452,2,42839,4.357099267697315,0.0,0.0
29832,2,9832,[302 427 197 180 603],664,5,42844,4.357164649649141,20.0,0.0
29833,2,9833,[176 405 182  28  97],537,1,42845,4.356823266219239,0.0,0.0
29834,2,9834,[ 88 216  50 228 222],60,5,42850,4.356888662938485,0.0,20.0
29835,2,9835,[302 427 197 180 603],474,5,42855,4.356954046360309,20.0,0.0
29836,2,9836,[302 427 197 180 603],666,5,42860,4.357019416488767,20.0,0.0
29837,2,9837,[302 427 197 180 603],537,5,42865,4.357084773327912,20.0,0.0
29838,2,9838,[  7 187 258 176 179],774,2,42867,4.356845207846326,0.0,0.0
29839,2,9839,[385 257 318 144 515],455,2,42869,4.35660569105691,20.0,0.0
29840,2,9840,[ 71 597  25   1 215],308,3,42872,4.356467838634285,0.0,0.0
29841,2,9841,[302 427 197 180 603],13,5,42877,4.356533224954277,20.0,0.0
29842,2,9842,[ 97  70  71 153 483],406,2,42879,4.356293812861932,20.0,0.0
29843,2,9843,[265 318 132 172 568],536,5,42884,4.356359203575782,20.0,0.0
29844,2,9844,[174 748 151 515 546],346,5,42889,4.356424581005586,0.0,20.0
29845,2,9845,[302 427 197 180 603],666,5,42894,4.356489945155393,20.0,0.0
29846,2,9846,[302 427 197 180 603],90,5,42899,4.3565552960292475,20.0,0.0
29847,2,9847,[302 427 197 180 603],474,5,42904,4.356620633631194,20.0,0.0
29848,2,9848,[302 427 197 180 603],666,5,42909,4.356685957965276,20.0,0.0
29849,2,9849,[302 427 197 180 603],537,5,42914,4.356751269035533,20.0,0.0
29850,2,9850,[302 427 197 180 603],339,5,42919,4.356816566846005,20.0,0.0
29851,2,9851,[323  25 235 176 257],548,3,42922,4.356678846934632,0.0,0.0
29852,2,9852,[186 196 181 179 100],339,5,42927,4.356744138840962,0.0,20.0
29853,2,9853,[127 546 257 435 385],343,2,42929,4.35650497259996,0.0,20.0
29854,2,9854,[302 427 197 180 603],383,5,42934,4.356570268899036,20.0,0.0
29855,2,9855,[161 176 179 180 211],210,4,42938,4.356534090909091,0.0,0.0
29856,2,9856,[ 56  98 678 153  22],749,3,42941,4.356396469514051,0.0,20.0
29857,2,9857,[302 427 197 180 603],666,5,42946,4.356461756948671,20.0,0.0
29858,2,9858,[302 427 197 180 603],664,5,42951,4.356527031139061,20.0,0.0
29859,2,9859,[302 427 197 180 603],666,5,42956,4.35659229208925,20.0,0.0
29860,2,9860,[173 235  95 496  69],194,3,42959,4.35645472061657,0.0,0.0
29861,2,9861,[ 15 175 187 235 182],406,4,42963,4.356418576353681,0.0,0.0
29862,2,9862,[546  12  28 117 204],774,0,42963,4.355976883301227,20.0,0.0
29863,2,9863,[385 597 515 194 121],804,4,42967,4.355940794809408,0.0,0.0
29864,2,9864,[210  22   9 403  56],749,3,42970,4.355803345159655,0.0,0.0
29865,2,9865,[ 28  79 235  95 135],313,2,42972,4.355564565173323,0.0,0.0
29866,2,9866,[302 427 197 180 603],666,5,42977,4.355629877369008,20.0,0.0
29867,2,9867,[302 427 197 180 603],537,5,42982,4.355695176327523,20.0,0.0
29868,2,9868,[302 427 197 180 603],666,5,42987,4.355760462052893,20.0,0.0
29869,2,9869,[121 175 302 176 742],334,2,42989,4.3555217831813575,0.0,0.0
29870,2,9870,[302 427 197 180 603],666,5,42994,4.355587073244859,20.0,0.0
29871,2,9871,[ 96 168  56  28 655],527,3,42997,4.355449756888168,0.0,0.0
29872,2,9872,[161 144 211 323 194],650,2,42999,4.355211182011547,0.0,0.0
29873,2,9873,[302 427 197 180 603],664,5,43004,4.355276483694551,20.0,0.0
29874,2,9874,[111 471 546   7 228],653,1,43005,4.35493670886076,0.0,0.0
29875,2,9875,[100 187  12 211 655],527,4,43009,4.354900769542325,20.0,20.0
29876,2,9876,[302 427 197 180 603],339,5,43014,4.354966082818669,20.0,0.0
29877,2,9877,[211 143  25  56  71],474,5,43019,4.355031382871027,0.0,0.0
29878,2,9878,[748 186 187 228 211],804,5,43024,4.3550966697034115,0.0,0.0
29879,2,9879,[302 427 197 180 603],90,5,43029,4.355161943319838,20.0,0.0
29880,2,9880,[302 427 197 180 603],474,5,43034,4.355227203724319,20.0,0.0
29881,2,9881,[302 427 197 180 603],474,5,43039,4.355292450920866,20.0,0.0
29882,2,9882,[185   8 678  79   4],474,4,43043,4.3552565010624305,0.0,0.0
29883,2,9883,[302 427 197 180 603],537,5,43048,4.35532173209227,20.0,0.0
29884,2,9884,[125 194 603  56 144],398,4,43052,4.355285786545271,20.0,0.0
29885,2,9885,[302 427 197 180 603],90,5,43057,4.355351001416144,20.0,0.0
29886,2,9886,[302 427 197 180 603],13,5,43062,4.355416203094973,20.0,0.0
29887,2,9887,[302 427 197 180 603],339,5,43067,4.35548139158576,20.0,0.0
29888,2,9888,[ 96   7 210 655 187],527,4,43071,4.355445444433209,0.0,0.0
29889,2,9889,[302 427 197 180 603],537,5,43076,4.355510616784631,20.0,0.0
29890,2,9890,[302 427 197 180 603],664,5,43081,4.355575775957941,20.0,0.0
29891,2,9891,[195 275  12   8 294],406,3,43084,4.355438738374444,20.0,0.0
29892,2,9892,[302 427 197 180 603],339,5,43089,4.355503891640554,20.0,0.0
29893,2,9893,[302 427 197 180 603],90,5,43094,4.3555690317364055,20.0,0.0
29894,2,9894,[302 427 197 180 603],537,5,43099,4.355634158665993,20.0,0.0
29895,2,9895,[302 427 197 180 603],666,5,43104,4.355699272433307,20.0,0.0
29896,2,9896,[302 427 197 180 603],271,5,43109,4.355764373042336,20.0,0.0
29897,2,9897,[302 427 197 180 603],271,5,43114,4.35582946049707,20.0,0.0
29898,2,9898,[ 88 568 191 269 118],343,3,43117,4.355692494191333,0.0,0.0
29899,2,9899,[302 427 197 180 603],666,5,43122,4.3557575757575755,20.0,0.0
29900,2,9900,[302 427 197 180 603],90,5,43127,4.355822644177356,20.0,0.0
29901,2,9901,[168 210 265  50  89],59,5,43132,4.355887699454656,0.0,20.0
29902,2,9902,[302 427 197 180 603],271,5,43137,4.355952741593456,20.0,0.0
29903,2,9903,[302 427 197 180 603],666,5,43142,4.356017770597738,20.0,0.0
29904,2,9904,[302 427 197 180 603],666,5,43147,4.356082786471479,20.0,0.0
29905,2,9905,[ 64 215 357  96  28],774,0,43147,4.3556430446194225,20.0,0.0
29906,2,9906,[237 276  64 282   9],474,5,43152,4.355708085192289,0.0,0.0
29907,2,9907,[234 168 187 121 515],311,5,43157,4.355773112636253,0.0,0.0
29908,2,9908,[302 427 197 180 603],383,5,43162,4.355838126955293,20.0,0.0
29909,2,9909,[ 98 496 265 161 245],533,3,43165,4.355701311806256,0.0,20.0
29910,2,9910,[302 427 197 180 603],474,5,43170,4.355766320250227,20.0,0.0
29911,2,9911,[ 12 197 286 235  28],334,3,43173,4.355629539951574,20.0,0.0
29912,2,9912,[302 427 197 180 603],474,5,43178,4.355694542519923,20.0,0.0
29913,2,9913,[302 427 197 180 603],537,5,43183,4.355759531974985,20.0,0.0
29914,2,9914,[302 427 197 180 603],474,5,43188,4.355824508320726,20.0,0.0
29915,2,9915,[302 427 197 180 603],664,5,43193,4.355889471561113,20.0,0.0
29916,2,9916,[204  22  97  79 197],263,5,43198,4.355954421700111,0.0,0.0
29917,2,9917,[302 427 197 180 603],13,5,43203,4.356019358741682,20.0,0.0
29918,2,9918,[302 427 197 180 603],474,5,43208,4.356084282689787,20.0,0.0
29919,2,9919,[  4 294 118  98 185],328,2,43210,4.355846774193548,0.0,20.0
29920,2,9920,[302 427 197 180 603],664,5,43215,4.35591170244935,20.0,0.0
29921,2,9921,[302 427 197 180 603],537,5,43220,4.355976617617416,20.0,0.0
29922,2,9922,[302 427 197 180 603],339,5,43225,4.356041519701703,20.0,0.0
29923,2,9923,[302 427 197 180 603],474,5,43230,4.356106408706167,20.0,0.0
29924,2,9924,[302 427 197 180 603],664,5,43235,4.356171284634761,20.0,0.0
29925,2,9925,[302 427 197 180 603],339,5,43240,4.356236147491437,20.0,0.0
29926,2,9926,[302 427 197 180 603],339,5,43245,4.356300997280145,20.0,0.0
29927,2,9927,[302 427 197 180 603],383,5,43250,4.356365834004835,20.0,0.0
29928,2,9928,[302 427 197 180 603],474,5,43255,4.356430657669453,20.0,0.0
29929,2,9929,[302 427 197 180 603],666,5,43260,4.356495468277946,20.0,0.0
29930,2,9930,[302 427 197 180 603],383,5,43265,4.356560265834256,20.0,0.0
29931,2,9931,[302 427 197 180 603],90,5,43270,4.356625050342328,20.0,0.0
29932,2,9932,[302 427 197 180 603],383,5,43275,4.356689821806101,20.0,0.0
29933,2,9933,[302 427 197 180 603],474,5,43280,4.356754580229515,20.0,0.0
29934,2,9934,[125 121 237 257 222],804,5,43285,4.356819325616507,0.0,0.0
29935,2,9935,[302 427 197 180 603],666,5,43290,4.356884057971015,20.0,0.0
29936,2,9936,[ 70  89   7 405 117],447,3,43293,4.3567475093086445,0.0,0.0
29937,2,9937,[302 427 197 180 603],339,5,43298,4.356812235862346,20.0,0.0
29938,2,9938,[200 423 125 286 603],648,2,43300,4.356575108159775,20.0,0.0
29939,2,9939,[302 427 197 180 603],271,5,43305,4.356639839034205,20.0,0.0
29940,2,9940,[302 427 197 180 603],537,5,43310,4.356704556885625,20.0,0.0
29941,2,9941,[187 313  98 286  22],334,5,43315,4.3567692617179645,0.0,20.0
29942,2,9942,[302 427 197 180 603],13,5,43320,4.35683395353515,20.0,0.0
29943,2,9943,[423 300 195  88 121],454,5,43325,4.35689863234111,0.0,0.0
29944,2,9944,[302 427 197 180 603],339,5,43330,4.356963298139768,20.0,0.0
29945,2,9945,[302 427 197 180 603],537,5,43335,4.357027950935049,20.0,0.0
29946,2,9946,[302 427 197 180 603],383,5,43340,4.357092590730874,20.0,0.0
29947,2,9947,[423 568 181  64 194],892,5,43345,4.357157217531162,0.0,0.0
29948,2,9948,[515  70 181 185  56],60,5,43350,4.357221831339833,0.0,0.0
29949,2,9949,[302 427 197 180 603],537,5,43355,4.357286432160804,20.0,0.0
29950,2,9950,[186 238 216   7 234],406,2,43357,4.357049542759522,0.0,0.0
29951,2,9951,[302 427 197 180 603],90,5,43362,4.357114147909968,20.0,0.0
29952,2,9952,[302 427 197 180 603],474,5,43367,4.357178740078369,20.0,0.0
29953,2,9953,[302 427 197 180 603],666,5,43372,4.357243319268636,20.0,0.0
29954,2,9954,[302 427 197 180 603],271,5,43377,4.357307885484681,20.0,0.0
29955,2,9955,[302 427 197 180 603],666,5,43382,4.357372438730414,20.0,0.0
29956,2,9956,[302 427 197 180 603],13,5,43387,4.357436979009742,20.0,0.0
29957,2,9957,[302 427 197 180 603],339,5,43392,4.357501506326572,20.0,0.0
29958,2,9958,[302 427 197 180 603],271,5,43397,4.357566020684808,20.0,0.0
29959,2,9959,[197 515 276 135  98],6,4,43401,4.357530120481928,0.0,20.0
29960,2,9960,[258 168   4 216 118],666,3,43404,4.357393835960245,0.0,0.0
29961,2,9961,[ 12 483 182 289  50],13,4,43408,4.357357960248946,40.0,20.0
29962,2,9962,[196 238 173  79 194],378,4,43412,4.3573220917394355,0.0,0.0
29963,2,9963,[151 183 179 222 269],666,3,43415,4.357185869128864,0.0,0.0
29964,2,9964,[215  11 118 196  88],13,4,43419,4.357150025087807,0.0,0.0
29965,2,9965,[302 427 197 180 603],537,5,43424,4.35721452939996,20.0,0.0
29966,2,9966,[302 427 197 180 603],90,5,43429,4.357279020768536,20.0,0.0
29967,2,9967,[302 427 197 180 603],13,5,43434,4.357343499197432,20.0,0.0
29968,2,9968,[302 427 197 180 603],474,5,43439,4.357407964690541,20.0,0.0
29969,2,9969,[302 427 197 180 603],339,5,43444,4.357472417251755,20.0,0.0
29970,2,9970,[302 427 197 180 603],664,5,43449,4.357536856884966,20.0,0.0
29971,2,9971,[302 427 197 180 603],664,5,43454,4.357601283594064,20.0,0.0
29972,2,9972,[302 427 197 180 603],383,5,43459,4.3576656973829335,20.0,0.0
29973,2,9973,[302 427 197 180 603],383,5,43464,4.357730098255464,20.0,0.0
29974,2,9974,[302 427 197 180 603],13,5,43469,4.357794486215539,20.0,0.0
29975,2,9975,[427 181 194 135  79],13,4,43473,4.357758620689655,0.0,0.0
29976,2,9976,[302 427 197 180 603],339,5,43478,4.357822992883633,20.0,0.0
29977,2,9977,[302 427 197 180 603],339,5,43483,4.357887352174784,20.0,0.0
29978,2,9978,[302 427 197 180 603],13,5,43488,4.357951698566991,20.0,0.0
29979,2,9979,[269 117 143 318 216],6,3,43491,4.357815631262525,20.0,0.0
29980,2,9980,[423  15 216 603 194],533,5,43496,4.357879971946699,20.0,0.0
29981,2,9981,[302 427 197 180 603],666,5,43501,4.357944299739531,20.0,0.0
29982,2,9982,[302 427 197 180 603],13,5,43506,4.358008614644897,20.0,0.0
29983,2,9983,[173 121 196 288 111],59,5,43511,4.358072916666667,0.0,0.0
29984,2,9984,[302 427 197 180 603],474,5,43516,4.358137205808713,20.0,0.0
29985,2,9985,[183 144 174 210 185],298,3,43519,4.358001201682355,0.0,20.0
29986,2,9986,[302 427 197 180 603],474,5,43524,4.35806548513067,20.0,0.0
29987,2,9987,[302 427 197 180 603],13,5,43529,4.358129755706848,20.0,0.0
29988,2,9988,[405 655 322 117 100],749,3,43532,4.35799379317249,0.0,20.0
29989,2,9989,[183 322 318 100  12],13,3,43535,4.357857857857858,40.0,20.0
29990,2,9990,[181 118  88 194  70],311,4,43539,4.3578220398358525,0.0,0.0
29991,2,9991,[194 127  64 435 174],398,5,43544,4.357886309047238,0.0,40.0
29992,2,9992,[118  69 211 174 515],313,5,43549,4.357950565395777,0.0,20.0
29993,2,9993,[302 427 197 180 603],339,5,43554,4.358014808885331,20.0,0.0
29994,2,9994,[302 427 197 180 603],90,5,43559,4.35807903951976,20.0,0.0
29995,2,9995,[202 748  50   1 222],13,3,43562,4.357943177270909,0.0,20.0
29996,2,9996,[471 496  82 111 301],666,3,43565,4.357807342202661,0.0,0.0
29997,2,9997,[302 427 197 180 603],13,5,43570,4.357871574314863,20.0,0.0
29998,2,9998,[302 427 197 180 603],339,5,43575,4.357935793579358,20.0,0.0
29999,2,9999,[302 427 197 180 603],271,5,43580,4.358,20.0,0.0
30000,3,0,[678 118  69  71 197],455,3,3,3.0,0.0,0.0
30001,3,1,[ 15 183 273 405 318],42,4,7,3.5,20.0,0.0
30002,3,2,[405  69 197 183  15],184,2,9,3.0,0.0,0.0
30003,3,3,[197 183 318 118 405],774,1,10,2.5,20.0,0.0
30004,3,4,[183 197  69  15 318],59,5,15,3.0,20.0,0.0
30005,3,5,[183 197  69  15 318],311,5,20,3.3333333333333335,20.0,0.0
30006,3,6,[496   8 194 132 475],465,3,23,3.2857142857142856,0.0,0.0
30007,3,7,[132 183 194   8 197],194,2,25,3.125,0.0,0.0
30008,3,8,[194 197 183  69 318],474,5,30,3.3333333333333335,20.0,0.0
30009,3,9,[194 197 183  69 318],7,5,35,3.5,20.0,0.0
30010,3,10,[194 197 183  69 318],387,1,36,3.272727272727273,20.0,0.0
30011,3,11,[183 194 197  15  69],311,5,41,3.4166666666666665,0.0,0.0
30012,3,12,[183 194 197  15  69],313,4,45,3.4615384615384617,0.0,0.0
30013,3,13,[183 194 197  69 318],766,3,48,3.4285714285714284,20.0,0.0
30014,3,14,[183  69 197 194 318],387,1,49,3.2666666666666666,20.0,0.0
30015,3,15,[183  69 197  15 194],234,4,53,3.3125,0.0,0.0
30016,3,16,[183  69 197 194 318],194,4,57,3.3529411764705883,20.0,0.0
30017,3,17,[183  69 197 194 318],474,5,62,3.4444444444444446,20.0,0.0
30018,3,18,[183  69 197 194 318],308,3,65,3.4210526315789473,20.0,0.0
30019,3,19,[183 194 318  69 197],537,2,67,3.35,20.0,0.0
30020,3,20,[183 318 197 194  69],378,3,70,3.3333333333333335,20.0,0.0
30021,3,21,[265 258 121 194 127],890,2,72,3.272727272727273,0.0,20.0
30022,3,22,[127 183 318 194 197],766,3,75,3.260869565217391,20.0,20.0
30023,3,23,[127 183 318 194 197],59,4,79,3.2916666666666665,20.0,20.0
30024,3,24,[127 183 318 197 194],648,2,81,3.24,20.0,20.0
30025,3,25,[183 318 127 194  69],64,5,86,3.3076923076923075,20.0,20.0
30026,3,26,[238  15 655 322   8],207,2,88,3.259259259259259,0.0,0.0
30027,3,27,[655 183 127 318 194],474,5,93,3.3214285714285716,20.0,20.0
30028,3,28,[655 183 127 318 194],311,5,98,3.3793103448275863,20.0,20.0
30029,3,29,[655 183 127 318 194],326,4,102,3.4,20.0,20.0
30030,3,30,[655 183 318 127 194],328,4,106,3.4193548387096775,20.0,20.0
30031,3,31,[655 183 318 127 194],13,4,110,3.4375,20.0,20.0
30032,3,32,[655 183 127 318 194],144,5,115,3.484848484848485,20.0,20.0
30033,3,33,[655 183 127 318 194],804,4,119,3.5,20.0,20.0
30034,3,34,[655 183 318 127 194],537,2,121,3.4571428571428573,20.0,20.0
30035,3,35,[655 183 318 127 194],311,5,126,3.5,20.0,20.0
30036,3,36,[ 64  22 195  97 294],537,0,126,3.4054054054054053,0.0,0.0
30037,3,37,[655 183 318 127 194],194,4,130,3.4210526315789473,20.0,20.0
30038,3,38,[655 183 318 127 194],144,5,135,3.4615384615384617,20.0,20.0
30039,3,39,[655 183 318 127 194],311,5,140,3.5,20.0,20.0
30040,3,40,[655 183 318 127 194],387,2,142,3.4634146341463414,20.0,20.0
30041,3,41,[183 655 127 318 194],326,4,146,3.4761904761904763,20.0,20.0
30042,3,42,[655 183 318 127 194],666,4,150,3.488372093023256,20.0,20.0
30043,3,43,[655 183 318 127 194],326,4,154,3.5,20.0,20.0
30044,3,44,[655 183 318 127 194],7,5,159,3.533333333333333,20.0,20.0
30045,3,45,[655 183 318 127 194],64,5,164,3.5652173913043477,20.0,20.0
30046,3,46,[655 183 318 127 194],13,4,168,3.574468085106383,20.0,20.0
30047,3,47,[655 183 318 127 194],664,3,171,3.5625,20.0,20.0
30048,3,48,[183 655 318 127 194],406,4,175,3.5714285714285716,20.0,20.0
30049,3,49,[183 318 655 127 194],234,4,179,3.58,20.0,20.0
30050,3,50,[183 318 127 655 194],144,5,184,3.607843137254902,20.0,20.0
30051,3,51,[183 318 127 655 194],474,5,189,3.6346153846153846,20.0,20.0
30052,3,52,[183 318 127 655 194],13,4,193,3.641509433962264,20.0,20.0
30053,3,53,[ 50 195   9 144 245],458,3,196,3.6296296296296298,0.0,20.0
30054,3,54,[144   9 183 127 318],194,4,200,3.6363636363636362,20.0,20.0
30055,3,55,[144   9 183 127 318],87,5,205,3.6607142857142856,20.0,20.0
30056,3,56,[144   9 183 127 318],326,3,208,3.6491228070175437,20.0,20.0
30057,3,57,[144 183 318 127 655],538,4,212,3.6551724137931036,20.0,20.0
30058,3,58,[  1 174  56 176 186],64,5,217,3.6779661016949152,0.0,20.0
30059,3,59,[ 56 144 174 186   1],339,4,221,3.683333333333333,0.0,20.0
30060,3,60,[ 56 174 186   1 176],843,2,223,3.6557377049180326,0.0,20.0
30061,3,61,[174 176 183 144 318],7,4,227,3.661290322580645,20.0,20.0
30062,3,62,[475 202 172 508 318],92,3,230,3.6507936507936507,20.0,0.0
30063,3,63,[508 174 172 183 144],13,4,234,3.65625,0.0,20.0
30064,3,64,[172 174 144 183 127],749,5,239,3.6769230769230767,0.0,40.0
30065,3,65,[118 180 222 678 322],13,2,241,3.6515151515151514,0.0,0.0
30066,3,66,[180 174 172 144 183],488,2,243,3.626865671641791,0.0,20.0
30067,3,67,[174 183 127 318 144],64,4,247,3.6323529411764706,20.0,40.0
30068,3,68,[174 183 127 318 655],194,4,251,3.63768115942029,20.0,40.0
30069,3,69,[174 183 127 318 655],194,4,255,3.642857142857143,20.0,40.0
30070,3,70,[174 183 127 318 655],184,3,258,3.6338028169014085,20.0,40.0
30071,3,71,[174 183 127 318 194],82,3,261,3.625,20.0,40.0
30072,3,72,[174 183 318 127 194],194,4,265,3.6301369863013697,20.0,40.0
30073,3,73,[174 318 127 183 194],892,5,270,3.6486486486486487,20.0,40.0
30074,3,74,[174 318 127 183 194],87,5,275,3.6666666666666665,20.0,40.0
30075,3,75,[174 318 127 183 194],87,5,280,3.6842105263157894,20.0,40.0
30076,3,76,[174 318 127 183 194],6,5,285,3.7012987012987013,20.0,40.0
30077,3,77,[174 318 127 183 194],263,5,290,3.717948717948718,20.0,40.0
30078,3,78,[216  69 471 143 200],95,4,294,3.721518987341772,0.0,0.0
30079,3,79,[216 143 471 174 318],479,3,297,3.7125,20.0,20.0
30080,3,80,[471 174 318 127 183],455,4,301,3.7160493827160495,20.0,40.0
30081,3,81,[471 174 127 318 183],313,5,306,3.731707317073171,20.0,40.0
30082,3,82,[471 174 127 318 183],374,4,310,3.7349397590361444,20.0,40.0
30083,3,83,[471 174 127 183 318],815,3,313,3.7261904761904763,20.0,40.0
30084,3,84,[174 183 127 471 318],6,4,317,3.7294117647058824,20.0,40.0
30085,3,85,[174 183 127 318 194],64,5,322,3.744186046511628,20.0,40.0
30086,3,86,[174 183 127 318 194],499,4,326,3.7471264367816093,20.0,40.0
30087,3,87,[174 183 127 318 194],406,5,331,3.7613636363636362,20.0,40.0
30088,3,88,[174 183 127 318 194],6,5,336,3.7752808988764044,20.0,40.0
30089,3,89,[174 183 127 318 194],263,5,341,3.7888888888888888,20.0,40.0
30090,3,90,[302 427 235 153  69],788,2,343,3.769230769230769,0.0,0.0
30091,3,91,[302 174 127 183 318],346,4,347,3.7717391304347827,20.0,40.0
30092,3,92,[174 127 183 318 194],385,1,348,3.7419354838709675,20.0,40.0
30093,3,93,[174 127 183 318 194],537,2,350,3.723404255319149,20.0,40.0
30094,3,94,[174 127 318 183 194],7,5,355,3.736842105263158,20.0,40.0
30095,3,95,[174 127 318 183 194],64,5,360,3.75,20.0,40.0
30096,3,96,[174 127 318 183 194],194,4,364,3.752577319587629,20.0,40.0
30097,3,97,[174 127 318 183 194],694,5,369,3.7653061224489797,20.0,40.0
30098,3,98,[174 127 318 183 194],308,5,374,3.7777777777777777,20.0,40.0
30099,3,99,[174 127 318 183 194],387,3,377,3.77,20.0,40.0
30100,3,100,[174 127 318 183 194],694,5,382,3.782178217821782,20.0,40.0
30101,3,101,[174 127 318 183 194],308,5,387,3.7941176470588234,20.0,40.0
30102,3,102,[174 127 318 183 194],207,4,391,3.796116504854369,20.0,40.0
30103,3,103,[174 127 318 183 194],406,5,396,3.8076923076923075,20.0,40.0
30104,3,104,[174 127 318 183 194],207,4,400,3.8095238095238093,20.0,40.0
30105,3,105,[174 127 318 183 194],326,4,404,3.811320754716981,20.0,40.0
30106,3,106,[174 127 318 183 194],311,5,409,3.822429906542056,20.0,40.0
30107,3,107,[174 127 318 183 194],648,3,412,3.814814814814815,20.0,40.0
30108,3,108,[174 127 318 183 194],892,5,417,3.8256880733944953,20.0,40.0
30109,3,109,[174 127 318 183 194],144,5,422,3.8363636363636364,20.0,40.0
30110,3,110,[174 127 318 183 194],144,5,427,3.8468468468468466,20.0,40.0
30111,3,111,[174 127 318 183 194],648,3,430,3.8392857142857144,20.0,40.0
30112,3,112,[174 127 318 183 194],883,4,434,3.84070796460177,20.0,40.0
30113,3,113,[117   1 179  79 546],881,5,439,3.8508771929824563,0.0,0.0
30114,3,114,[117 179 546  79 174],308,3,442,3.8434782608695652,0.0,20.0
30115,3,115,[179  79 174 127 318],406,4,446,3.8448275862068964,20.0,40.0
30116,3,116,[135  25 161 132 228],881,1,447,3.8205128205128207,0.0,0.0
30117,3,117,[135 179 174 127 318],474,5,452,3.830508474576271,20.0,40.0
30118,3,118,[135 179 174 127 318],308,5,457,3.8403361344537816,20.0,40.0
30119,3,119,[135 179 174 127 318],207,4,461,3.841666666666667,20.0,40.0
30120,3,120,[179 174 127 318 183],815,3,464,3.834710743801653,20.0,40.0
30121,3,121,[174 179 127 318 183],207,4,468,3.8360655737704916,20.0,40.0
30122,3,122,[174 179 127 318 183],387,4,472,3.83739837398374,20.0,40.0
30123,3,123,[174 179 127 318 183],334,5,477,3.846774193548387,20.0,40.0
30124,3,124,[174 179 127 318 183],406,5,482,3.856,20.0,40.0
30125,3,125,[174 179 127 318 183],334,5,487,3.865079365079365,20.0,40.0
30126,3,126,[174 179 127 318 183],387,4,491,3.8661417322834644,20.0,40.0
30127,3,127,[174 179 127 183 318],59,5,496,3.875,20.0,40.0
30128,3,128,[174 179 127 183 318],13,3,499,3.868217054263566,20.0,40.0
30129,3,129,[174 127 179 183 318],774,3,502,3.8615384615384616,20.0,40.0
30130,3,130,[174 179 127 183 318],406,5,507,3.8702290076335877,20.0,40.0
30131,3,131,[174 179 127 183 318],666,4,511,3.871212121212121,20.0,40.0
30132,3,132,[174 179 127 183 318],458,4,515,3.8721804511278197,20.0,40.0
30133,3,133,[174 179 127 183 318],648,3,518,3.8656716417910446,20.0,40.0
30134,3,134,[174 179 127 183 194],643,5,523,3.8740740740740742,0.0,40.0
30135,3,135,[179 174 127 183 194],766,3,526,3.8676470588235294,0.0,40.0
30136,3,136,[215  79 245  25 742],92,3,529,3.8613138686131387,0.0,0.0
30137,3,137,[215 179 174 127 183],650,2,531,3.847826086956522,0.0,40.0
30138,3,138,[174 179 127 183 318],648,3,534,3.841726618705036,20.0,40.0
30139,3,139,[174 179 183 127 318],64,5,539,3.85,20.0,40.0
30140,3,140,[403 215 357 427 121],13,3,542,3.8439716312056738,20.0,0.0
30141,3,141,[174 179 183 127 318],774,3,545,3.8380281690140845,20.0,40.0
30142,3,142,[179 174 183 127 194],64,5,550,3.8461538461538463,0.0,40.0
30143,3,143,[179 174 183 127 194],537,2,552,3.8333333333333335,0.0,40.0
30144,3,144,[179 174 127 183 318],537,3,555,3.8275862068965516,20.0,40.0
30145,3,145,[180 173 318  97   9],326,3,558,3.8219178082191783,20.0,0.0
30146,3,146,[173 179 174 127 183],7,5,563,3.8299319727891157,0.0,40.0
30147,3,147,[173 179 174 127 183],194,4,567,3.831081081081081,0.0,40.0
30148,3,148,[173 179 174 127 183],815,3,570,3.825503355704698,0.0,40.0
30149,3,149,[173 179 174 127 183],194,4,574,3.8266666666666667,0.0,40.0
30150,3,150,[173 179 174 127 183],374,3,577,3.8211920529801326,0.0,40.0
30151,3,151,[ 97 405 168 313 222],474,4,581,3.8223684210526314,0.0,0.0
30152,3,152,[435 174 483  50 132],380,4,585,3.823529411764706,20.0,40.0
30153,3,153,[483 313 174 127 179],537,4,589,3.824675324675325,20.0,40.0
30154,3,154,[483 313 174 179 127],334,5,594,3.832258064516129,20.0,40.0
30155,3,155,[483 313 174 179 127],815,3,597,3.826923076923077,20.0,40.0
30156,3,156,[483 313 174 127 179],890,5,602,3.8343949044585988,20.0,40.0
30157,3,157,[483 313 174 127 179],234,3,605,3.829113924050633,20.0,40.0
30158,3,158,[483 313 174 127 183],308,3,608,3.8238993710691824,20.0,40.0
30159,3,159,[483 313 174 127 183],215,5,613,3.83125,20.0,40.0
30160,3,160,[483 313 174 127 183],334,5,618,3.8385093167701863,20.0,40.0
30161,3,161,[483 313 174 127 183],308,3,621,3.8333333333333335,20.0,40.0
30162,3,162,[174 127 183 173 179],890,4,625,3.834355828220859,0.0,40.0
30163,3,163,[174 127 173 183 179],234,2,627,3.823170731707317,0.0,40.0
30164,3,164,[127 174 183 318 194],694,5,632,3.83030303030303,20.0,40.0
30165,3,165,[127 174 183 318 194],311,5,637,3.8373493975903616,20.0,40.0
30166,3,166,[127 174 183 318 194],406,5,642,3.844311377245509,20.0,40.0
30167,3,167,[127 174 183 318 194],406,5,647,3.8511904761904763,20.0,40.0
30168,3,168,[127 174 183 318 194],499,4,651,3.8520710059171597,20.0,40.0
30169,3,169,[127 174 183 318 194],308,5,656,3.8588235294117648,20.0,40.0
30170,3,170,[127 174 183 318 194],59,4,660,3.8596491228070176,20.0,40.0
30171,3,171,[127 174 183 318 194],82,3,663,3.854651162790698,20.0,40.0
30172,3,172,[127 174 183 318 194],387,3,666,3.8497109826589595,20.0,40.0
30173,3,173,[127 174 183 318 179],406,5,671,3.8563218390804597,20.0,40.0
30174,3,174,[127 174 183 318 179],664,4,675,3.857142857142857,20.0,40.0
30175,3,175,[127 174 183 318 179],664,4,679,3.8579545454545454,20.0,40.0
30176,3,176,[127 174 183 318 179],374,3,682,3.853107344632768,20.0,40.0
30177,3,177,[127 174 183 318 194],194,4,686,3.853932584269663,20.0,40.0
30178,3,178,[127 174 183 318 194],474,5,691,3.8603351955307263,20.0,40.0
30179,3,179,[318 174 286   9 127],527,3,694,3.8555555555555556,20.0,40.0
30180,3,180,[127 174 183 318 194],664,4,698,3.856353591160221,20.0,40.0
30181,3,181,[127 174 183 318 194],664,4,702,3.857142857142857,20.0,40.0
30182,3,182,[127 174 318 183 194],87,5,707,3.8633879781420766,20.0,40.0
30183,3,183,[127 174 318 183 194],308,5,712,3.869565217391304,20.0,40.0
30184,3,184,[127 174 318 183 194],666,3,715,3.864864864864865,20.0,40.0
30185,3,185,[127 174 318 183 194],666,3,718,3.860215053763441,20.0,40.0
30186,3,186,[127 174 318 183 483],385,2,720,3.8502673796791442,40.0,40.0
30187,3,187,[127 174 483 318 183],892,5,725,3.856382978723404,40.0,40.0
30188,3,188,[127 174 483 318 183],848,3,728,3.8518518518518516,40.0,40.0
30189,3,189,[423 235  28 328 118],328,3,731,3.8473684210526318,0.0,0.0
30190,3,190,[328 423  28 127 174],537,1,732,3.832460732984293,0.0,40.0
30191,3,191,[127 483 174 318 183],374,3,735,3.828125,40.0,40.0
30192,3,192,[127 174 183 318 313],537,3,738,3.8238341968911915,20.0,40.0
30193,3,193,[127 174 313 318 183],64,5,743,3.829896907216495,20.0,40.0
30194,3,194,[127 174 313 318 183],883,4,747,3.830769230769231,20.0,40.0
30195,3,195,[127 174 318 183 179],738,4,751,3.8316326530612246,20.0,40.0
30196,3,196,[234 237   4 211  70],271,5,756,3.8375634517766497,0.0,0.0
30197,3,197,[  4 237  70 211 234],59,3,759,3.8333333333333335,0.0,0.0
30198,3,198,[  4 234 211 127 174],533,3,762,3.829145728643216,0.0,40.0
30199,3,199,[211 127 174 318 183],527,4,766,3.83,20.0,40.0
30200,3,200,[211 127 174 183 318],346,5,771,3.8358208955223883,20.0,40.0
30201,3,201,[211 127 174 183 318],406,5,776,3.8415841584158414,20.0,40.0
30202,3,202,[211 127 174 183 318],64,5,781,3.8472906403940885,20.0,40.0
30203,3,203,[211 127 174 318 183],234,3,784,3.843137254901961,20.0,40.0
30204,3,204,[127 211 174 318 183],738,4,788,3.84390243902439,20.0,40.0
30205,3,205,[127 174 318 183 194],406,5,793,3.849514563106796,20.0,40.0
30206,3,206,[127 174 318 183 194],6,5,798,3.8550724637681157,20.0,40.0
30207,3,207,[211 289 194   8  56],90,4,802,3.855769230769231,0.0,0.0
30208,3,208,[  9  95 276 222 435],378,4,806,3.8564593301435406,0.0,0.0
30209,3,209,[276  95 127 174 318],59,4,810,3.857142857142857,20.0,40.0
30210,3,210,[276 127 174 318 183],311,5,815,3.862559241706161,20.0,40.0
30211,3,211,[276 127 174 318 183],334,5,820,3.8679245283018866,20.0,40.0
30212,3,212,[276 127 174 318 183],234,3,823,3.863849765258216,20.0,40.0
30213,3,213,[127 174 318 183 194],6,5,828,3.869158878504673,20.0,40.0
30214,3,214,[127 174 318 183 194],664,4,832,3.869767441860465,20.0,40.0
30215,3,215,[127 174 318 183 194],664,4,836,3.8703703703703702,20.0,40.0
30216,3,216,[127 174 318 183 194],13,4,840,3.870967741935484,20.0,40.0
30217,3,217,[127 174 318 183 194],13,4,844,3.871559633027523,20.0,40.0
30218,3,218,[127 174 318 183 194],326,4,848,3.872146118721461,20.0,40.0
30219,3,219,[127 174 318 183 194],194,4,852,3.8727272727272726,20.0,40.0
30220,3,220,[127 174 318 194 183],6,5,857,3.8778280542986425,20.0,40.0
30221,3,221,[127 174 318 194 183],499,4,861,3.8783783783783785,20.0,40.0
30222,3,222,[127 174 318 194 183],7,5,866,3.883408071748879,20.0,40.0
30223,3,223,[127 174 318 194 183],298,4,870,3.8839285714285716,20.0,40.0
30224,3,224,[127 174 194 318 183],474,5,875,3.888888888888889,20.0,40.0
30225,3,225,[127 174 194 318 183],406,5,880,3.893805309734513,20.0,40.0
30226,3,226,[127 174 194 318 183],298,4,884,3.894273127753304,20.0,40.0
30227,3,227,[127 174 194 318 183],387,3,887,3.8903508771929824,20.0,40.0
30228,3,228,[127 174 318 194 183],387,3,890,3.88646288209607,20.0,40.0
30229,3,229,[127 174 318 194 183],6,5,895,3.891304347826087,20.0,40.0
30230,3,230,[127 174 318 194 183],326,4,899,3.8917748917748916,20.0,40.0
30231,3,231,[197 603 269 678   7],7,3,902,3.8879310344827585,20.0,0.0
30232,3,232,[  7 603 127 174 318],465,4,906,3.888412017167382,40.0,40.0
30233,3,233,[121 183  79 135  82],882,5,911,3.893162393162393,0.0,0.0
30234,3,234,[603  82   7 127 174],738,5,916,3.8978723404255318,20.0,40.0
30235,3,235,[603  82   7 127 174],666,3,919,3.8940677966101696,20.0,40.0
30236,3,236,[603   7 127 174 318],189,4,923,3.8945147679324896,40.0,40.0
30237,3,237,[603 127 174 318 194],474,5,928,3.899159663865546,40.0,40.0
30238,3,238,[603 127 174 318 194],452,5,933,3.903765690376569,40.0,40.0
30239,3,239,[603 127 174 318 194],694,5,938,3.908333333333333,40.0,40.0
30240,3,240,[603 127 174 318 194],213,5,943,3.912863070539419,40.0,40.0
30241,3,241,[  1 195  71 181  50],881,4,947,3.9132231404958677,0.0,20.0
30242,3,242,[181 603 127 174 318],334,5,952,3.9176954732510287,40.0,40.0
30243,3,243,[181 603 127 174 318],458,3,955,3.9139344262295084,40.0,40.0
30244,3,244,[603 127 174 318 194],776,5,960,3.9183673469387754,40.0,40.0
30245,3,245,[121 111  50 288 228],648,5,965,3.9227642276422765,0.0,20.0
30246,3,246,[318 153 196  11 265],378,4,969,3.923076923076923,20.0,0.0
30247,3,247,[603 111 288 196 127],537,2,971,3.9153225806451615,20.0,20.0
30248,3,248,[603 127 174 318 194],298,5,976,3.9196787148594376,40.0,40.0
30249,3,249,[603 127 174 318 194],694,5,981,3.924,40.0,40.0
30250,3,250,[603 127 174 318 194],458,3,984,3.9203187250996017,40.0,40.0
30251,3,251,[603 127 174 318 194],537,3,987,3.9166666666666665,40.0,40.0
30252,3,252,[603 127 174 318 194],452,5,992,3.9209486166007905,40.0,40.0
30253,3,253,[603 127 174 318 194],308,5,997,3.925196850393701,40.0,40.0
30254,3,254,[603 127 174 318 194],82,4,1001,3.925490196078431,40.0,40.0
30255,3,255,[187 748 235 195 161],804,5,1006,3.9296875,0.0,0.0
30256,3,256,[423  97 118 151 127],897,5,1011,3.933852140077821,0.0,20.0
30257,3,257,[603 748 187 151 127],474,3,1014,3.9302325581395348,20.0,20.0
30258,3,258,[603 187 127 174 318],90,5,1019,3.9343629343629343,40.0,40.0
30259,3,259,[603 187 127 174 318],13,4,1023,3.9346153846153844,40.0,40.0
30260,3,260,[603 187 127 174 318],90,5,1028,3.9386973180076628,40.0,40.0
30261,3,261,[603 187 127 174 318],13,4,1032,3.9389312977099236,40.0,40.0
30262,3,262,[603 187 127 174 318],59,5,1037,3.9429657794676807,40.0,40.0
30263,3,263,[603 187 127 174 318],271,5,1042,3.946969696969697,40.0,40.0
30264,3,264,[603 187 127 174 318],533,5,1047,3.950943396226415,40.0,40.0
30265,3,265,[603 187 127 174 318],648,2,1049,3.943609022556391,40.0,40.0
30266,3,266,[603 187 127 174 318],387,4,1053,3.943820224719101,40.0,40.0
30267,3,267,[603 187 127 174 318],234,4,1057,3.9440298507462686,40.0,40.0
30268,3,268,[603 187 127 174 318],804,4,1061,3.9442379182156135,40.0,40.0
30269,3,269,[603 187 127 174 318],13,4,1065,3.9444444444444446,40.0,40.0
30270,3,270,[603 187 127 174 318],804,4,1069,3.944649446494465,40.0,40.0
30271,3,271,[603 187 127 174 318],64,4,1073,3.9448529411764706,40.0,40.0
30272,3,272,[427 100 202 194  56],308,5,1078,3.948717948717949,0.0,20.0
30273,3,273,[100 603 187 127 174],537,4,1082,3.948905109489051,20.0,60.0
30274,3,274,[100 603 187 127 174],650,3,1085,3.9454545454545453,20.0,60.0
30275,3,275,[100 603 187 127 174],537,4,1089,3.9456521739130435,20.0,60.0
30276,3,276,[100 603 187 127 174],524,4,1093,3.9458483754512637,20.0,60.0
30277,3,277,[100 603 187 127 174],664,5,1098,3.949640287769784,20.0,60.0
30278,3,278,[100 603 187 127 174],533,5,1103,3.953405017921147,20.0,60.0
30279,3,279,[100 603 187 127 174],452,4,1107,3.9535714285714287,20.0,60.0
30280,3,280,[100 603 127 187 174],524,4,1111,3.9537366548042705,20.0,60.0
30281,3,281,[275  98  70 117 546],882,3,1114,3.950354609929078,0.0,20.0
30282,3,282,[ 98 275 100 603 127],64,4,1118,3.950530035335689,20.0,60.0
30283,3,283,[195  12   1 204 180],92,5,1123,3.954225352112676,20.0,0.0
30284,3,284,[204  98  12 275 100],233,4,1127,3.9543859649122806,20.0,40.0
30285,3,285,[ 98 275 100 204 603],474,4,1131,3.9545454545454546,20.0,40.0
30286,3,286,[ 89 405 153 151 172],290,1,1132,3.9442508710801394,0.0,0.0
30287,3,287,[ 98 204 100 603 127],14,3,1135,3.9409722222222223,20.0,60.0
30288,3,288,[204 100 603 127 187],527,5,1140,3.944636678200692,20.0,40.0
30289,3,289,[204 100 603 127 187],387,4,1144,3.9448275862068964,20.0,40.0
30290,3,290,[100 603 187 127 174],59,5,1149,3.948453608247423,20.0,60.0
30291,3,291,[100 603 187 127 174],840,4,1153,3.9486301369863015,20.0,60.0
30292,3,292,[100 603 127 187 174],271,5,1158,3.95221843003413,20.0,60.0
30293,3,293,[100 603 127 187 174],527,5,1163,3.95578231292517,20.0,60.0
30294,3,294,[100 603 127 187 174],527,5,1168,3.9593220338983053,20.0,60.0
30295,3,295,[100 603 127 187 174],308,5,1173,3.9628378378378377,20.0,60.0
30296,3,296,[100 603 127 187 174],524,4,1177,3.962962962962963,20.0,60.0
30297,3,297,[100 603 127 187 174],409,4,1181,3.9630872483221475,20.0,60.0
30298,3,298,[100 603 127 187 174],527,5,1186,3.9665551839464883,20.0,60.0
30299,3,299,[100 603 127 187 174],840,4,1190,3.966666666666667,20.0,60.0
30300,3,300,[100 603 127 174   1],387,5,1195,3.9700996677740865,20.0,60.0
30301,3,301,[100 603 127   1 174],64,4,1199,3.9701986754966887,20.0,60.0
30302,3,302,[100 603 127   1 174],64,4,1203,3.9702970297029703,20.0,60.0
30303,3,303,[100   1 127 603 174],379,5,1208,3.973684210526316,20.0,60.0
30304,3,304,[313 405 245 216 257],653,2,1210,3.9672131147540983,0.0,0.0
30305,3,305,[100   1 127 603 174],59,4,1214,3.9673202614379086,20.0,60.0
30306,3,306,[100 127 603 174 204],524,3,1217,3.964169381107492,20.0,60.0
30307,3,307,[100 127 603 174 187],213,5,1222,3.9675324675324677,20.0,60.0
30308,3,308,[100 127 603 174 187],694,5,1227,3.970873786407767,20.0,60.0
30309,3,309,[100 127 603 174 187],452,4,1231,3.970967741935484,20.0,60.0
30310,3,310,[ 28 313 742 180 181],653,4,1235,3.9710610932475885,0.0,0.0
30311,3,311,[100 127 603 174 318],664,5,1240,3.9743589743589745,40.0,60.0
30312,3,312,[100 127 603 174 318],533,5,1245,3.977635782747604,40.0,60.0
30313,3,313,[100 127 603 174 318],804,4,1249,3.977707006369427,40.0,60.0
30314,3,314,[100 127 603 174 318],694,5,1254,3.980952380952381,40.0,60.0
30315,3,315,[100 127 603 174 318],7,5,1259,3.9841772151898733,40.0,60.0
30316,3,316,[100 127 603 174 318],82,4,1263,3.9842271293375395,40.0,60.0
30317,3,317,[100 603 127 174 318],527,4,1267,3.9842767295597485,40.0,60.0
30318,3,318,[100 603 127 174 318],234,4,1271,3.9843260188087775,40.0,60.0
30319,3,319,[100 603 127 174 318],313,5,1276,3.9875,40.0,60.0
30320,3,320,[100 603 127 174 318],694,5,1281,3.9906542056074765,40.0,60.0
30321,3,321,[100 603 127 174 318],409,5,1286,3.9937888198757765,40.0,60.0
30322,3,322,[100 603 127 174 318],387,4,1290,3.9938080495356036,40.0,60.0
30323,3,323,[100 603 127 174 318],465,3,1293,3.990740740740741,40.0,60.0
30324,3,324,[100 603 127 174 318],64,4,1297,3.9907692307692306,40.0,60.0
30325,3,325,[100 127 603 174 318],7,5,1302,3.9938650306748467,40.0,60.0
30326,3,326,[475 216 275 423   4],474,4,1306,3.99388379204893,0.0,0.0
30327,3,327,[100 603 127 174 318],313,5,1311,3.9969512195121952,40.0,60.0
30328,3,328,[100 603 127 174 318],524,4,1315,3.9969604863221884,40.0,60.0
30329,3,329,[100 127 603 174 318],308,5,1320,4.0,40.0,60.0
30330,3,330,[100 127 603 174 318],537,4,1324,4.0,40.0,60.0
30331,3,331,[100 127 603 174 318],465,3,1327,3.996987951807229,40.0,60.0
30332,3,332,[100 127 603 174 318],313,5,1332,4.0,40.0,60.0
30333,3,333,[100 127 603 174 318],524,4,1336,4.0,40.0,60.0
30334,3,334,[100 127 603 174 318],527,4,1340,4.0,40.0,60.0
30335,3,335,[100 127 603 174 318],409,5,1345,4.002976190476191,40.0,60.0
30336,3,336,[100 127 603 174 318],233,5,1350,4.005934718100891,40.0,60.0
30337,3,337,[100 127 603 174 318],474,5,1355,4.008875739644971,40.0,60.0
30338,3,338,[100 127 603 174 318],738,4,1359,4.008849557522124,40.0,60.0
30339,3,339,[100 127 603 174 318],694,5,1364,4.011764705882353,40.0,60.0
30340,3,340,[100 127 603 174 318],385,3,1367,4.008797653958944,40.0,60.0
30341,3,341,[100 127 603 174 318],90,5,1372,4.011695906432749,40.0,60.0
30342,3,342,[100 127 603 174 318],738,4,1376,4.011661807580175,40.0,60.0
30343,3,343,[100 127 603 174 318],189,5,1381,4.0145348837209305,40.0,60.0
30344,3,344,[100 127 603 174 318],524,4,1385,4.0144927536231885,40.0,60.0
30345,3,345,[100 127 603 174 318],82,4,1389,4.014450867052023,40.0,60.0
30346,3,346,[100 127 603 174 318],664,5,1394,4.017291066282421,40.0,60.0
30347,3,347,[121  28  69 597 403],13,3,1397,4.014367816091954,0.0,0.0
30348,3,348,[100 127 603 174 318],90,5,1402,4.017191977077364,40.0,60.0
30349,3,349,[100 127 603 174 318],7,5,1407,4.02,40.0,60.0
30350,3,350,[187 238 215 357 515],194,4,1411,4.01994301994302,20.0,0.0
30351,3,351,[191  11  79   9 508],13,0,1411,4.0085227272727275,0.0,0.0
30352,3,352,[515 100 127 603 174],233,5,1416,4.0113314447592066,20.0,60.0
30353,3,353,[515 100 127 603 174],313,5,1421,4.0141242937853105,20.0,60.0
30354,3,354,[515 100 127 603 174],90,5,1426,4.016901408450704,20.0,60.0
30355,3,355,[117 173 568 216  89],882,5,1431,4.019662921348314,0.0,0.0
30356,3,356,[515 568 100 127 603],7,4,1435,4.019607843137255,20.0,40.0
30357,3,357,[568 100 127 603 174],59,5,1440,4.022346368715084,20.0,60.0
30358,3,358,[568 100 127 603 174],804,4,1444,4.022284122562674,20.0,60.0
30359,3,359,[568 100 127 603 174],738,3,1447,4.019444444444445,20.0,60.0
30360,3,360,[100 127 603 174 318],59,5,1452,4.022160664819944,40.0,60.0
30361,3,361,[228  89 153 237 210],13,4,1456,4.0220994475138125,0.0,0.0
30362,3,362,[100 127 603 174 318],664,5,1461,4.024793388429752,40.0,60.0
30363,3,363,[483 118 435  71 196],533,5,1466,4.027472527472527,20.0,0.0
30364,3,364,[100 127 603 174 318],7,5,1471,4.03013698630137,40.0,60.0
30365,3,365,[100 127 603 174 318],59,5,1476,4.032786885245901,40.0,60.0
30366,3,366,[100 603 127 174 318],189,5,1481,4.03542234332425,40.0,60.0
30367,3,367,[100 603 127 174 318],233,5,1486,4.038043478260869,40.0,60.0
30368,3,368,[100 603 127 174 318],59,5,1491,4.040650406504065,40.0,60.0
30369,3,369,[181 222 176 403 161],506,5,1496,4.043243243243243,0.0,0.0
30370,3,370,[100 603 127 174 318],524,4,1500,4.0431266846361185,40.0,60.0
30371,3,371,[100 127 603 174 318],474,5,1505,4.045698924731183,40.0,60.0
30372,3,372,[100 127 603 174 318],59,5,1510,4.048257372654155,40.0,60.0
30373,3,373,[100 127 603 174 318],233,5,1515,4.050802139037433,40.0,60.0
30374,3,374,[100 127 603 174 318],694,5,1520,4.053333333333334,40.0,60.0
30375,3,375,[100 127 603 174 318],527,4,1524,4.053191489361702,40.0,60.0
30376,3,376,[100 127 603 174 318],537,4,1528,4.053050397877984,40.0,60.0
30377,3,377,[100 127 603 174 318],82,4,1532,4.052910052910053,40.0,60.0
30378,3,378,[100 603 127 174 318],465,3,1535,4.050131926121372,40.0,60.0
30379,3,379,[100 603 127 174 318],387,4,1539,4.05,40.0,60.0
30380,3,380,[100 603 127 174 318],465,3,1542,4.047244094488189,40.0,60.0
30381,3,381,[100 603 127 174 318],59,5,1547,4.049738219895288,40.0,60.0
30382,3,382,[100 603 127 174 318],308,5,1552,4.052219321148825,40.0,60.0
30383,3,383,[100 603 127 174 318],313,5,1557,4.0546875,40.0,60.0
30384,3,384,[100 603 127 174 318],334,5,1562,4.057142857142857,40.0,60.0
30385,3,385,[100 603 127 174 318],666,4,1566,4.05699481865285,40.0,60.0
30386,3,386,[100 603 127 174 318],666,4,1570,4.056847545219639,40.0,60.0
30387,3,387,[100 603 127 174 318],804,4,1574,4.056701030927835,40.0,60.0
30388,3,388,[100 603 127 174 318],474,5,1579,4.059125964010283,40.0,60.0
30389,3,389,[172 196 176  89 568],506,5,1584,4.061538461538461,0.0,0.0
30390,3,390,[100 603 127 174 318],59,5,1589,4.063938618925831,40.0,60.0
30391,3,391,[100 603 127 174 318],666,4,1593,4.063775510204081,40.0,60.0
30392,3,392,[100 603 127 174 318],527,4,1597,4.0636132315521625,40.0,60.0
30393,3,393,[100 603 127 174 318],271,5,1602,4.065989847715736,40.0,60.0
30394,3,394,[100 603 127 174 318],883,5,1607,4.068354430379747,40.0,60.0
30395,3,395,[100 603 127 174 318],664,5,1612,4.070707070707071,40.0,60.0
30396,3,396,[117  69  95 238 185],897,3,1615,4.06801007556675,0.0,0.0
30397,3,397,[185 100 603 127 174],398,4,1619,4.067839195979899,20.0,60.0
30398,3,398,[185 100 603 127 174],694,5,1624,4.0701754385964914,20.0,60.0
30399,3,399,[185 100 603 127 174],804,4,1628,4.07,20.0,60.0
30400,3,400,[185 100 603 127 174],308,5,1633,4.072319201995012,20.0,60.0
30401,3,401,[185 100 603 127 174],840,5,1638,4.074626865671642,20.0,60.0
30402,3,402,[185 100 603 127 174],271,4,1642,4.074441687344913,20.0,60.0
30403,3,403,[100 603 127 174 185],480,3,1645,4.071782178217822,20.0,60.0
30404,3,404,[100 603 127 174 318],694,5,1650,4.074074074074074,40.0,60.0
30405,3,405,[100 603 127 174 318],666,4,1654,4.073891625615763,40.0,60.0
30406,3,406,[100 603 127 174 318],527,4,1658,4.073710073710074,40.0,60.0
30407,3,407,[100 603 127 174 318],524,4,1662,4.073529411764706,40.0,60.0
30408,3,408,[100 603 127 174 318],308,5,1667,4.075794621026895,40.0,60.0
30409,3,409,[100 603 127 174 318],233,5,1672,4.078048780487805,40.0,60.0
30410,3,410,[568  82 132 196 427],339,4,1676,4.077858880778589,0.0,0.0
30411,3,411,[100 603 127 174 318],527,4,1680,4.077669902912621,40.0,60.0
30412,3,412,[100 603 127 174 318],308,5,1685,4.079903147699758,40.0,60.0
30413,3,413,[100 603 127 174 318],90,5,1690,4.082125603864735,40.0,60.0
30414,3,414,[100 603 127 174 318],666,4,1694,4.081927710843374,40.0,60.0
30415,3,415,[100 603 127 174 318],465,3,1697,4.079326923076923,40.0,60.0
30416,3,416,[100 603 127 174 318],409,5,1702,4.081534772182255,40.0,60.0
30417,3,417,[100 603 127 174 318],308,5,1707,4.083732057416268,40.0,60.0
30418,3,418,[100 603 127 174 318],313,5,1712,4.085918854415274,40.0,60.0
30419,3,419,[100 603 127 174 318],694,5,1717,4.088095238095238,40.0,60.0
30420,3,420,[100 603 127 174 318],465,3,1720,4.085510688836105,40.0,60.0
30421,3,421,[100 603 127 174 318],7,5,1725,4.087677725118484,40.0,60.0
30422,3,422,[100 603 127 174 318],313,5,1730,4.08983451536643,40.0,60.0
30423,3,423,[100 603 127 174 318],233,5,1735,4.091981132075472,40.0,60.0
30424,3,424,[100 603 127 174 318],664,5,1740,4.094117647058823,40.0,60.0
30425,3,425,[100 603 127 174 318],64,4,1744,4.093896713615023,40.0,60.0
30426,3,426,[318 153 211 151 183],653,1,1745,4.086651053864169,20.0,0.0
30427,3,427,[100 603 127 174 318],452,5,1750,4.088785046728972,40.0,60.0
30428,3,428,[100 603 127 174 318],7,5,1755,4.090909090909091,40.0,60.0
30429,3,429,[100 603 127 174 318],452,5,1760,4.093023255813954,40.0,60.0
30430,3,430,[100 603 127 174 318],271,5,1765,4.0951276102088165,40.0,60.0
30431,3,431,[748 403 210 286 173],648,3,1768,4.092592592592593,0.0,0.0
30432,3,432,[238 215 222 185 275],537,3,1771,4.090069284064665,0.0,0.0
30433,3,433,[100 603 127 174 318],524,4,1775,4.089861751152074,40.0,60.0
30434,3,434,[100 603 127 174 318],465,3,1778,4.0873563218390805,40.0,60.0
30435,3,435,[100 603 127 174 318],233,5,1783,4.089449541284404,40.0,60.0
30436,3,436,[100 603 127 174 318],82,4,1787,4.089244851258581,40.0,60.0
30437,3,437,[215 175 179  64   8],774,1,1788,4.082191780821918,0.0,0.0
30438,3,438,[151 181 179  89 118],653,3,1791,4.079726651480637,0.0,0.0
30439,3,439,[100 603 127 174 318],452,5,1796,4.081818181818182,40.0,60.0
30440,3,440,[100 603 127 174 318],90,5,1801,4.083900226757369,40.0,60.0
30441,3,441,[100 603 127 174 318],234,4,1805,4.083710407239819,40.0,60.0
30442,3,442,[100 603 127 174 318],474,5,1810,4.085778781038375,40.0,60.0
30443,3,443,[100 603 127 174 318],474,5,1815,4.087837837837838,40.0,60.0
30444,3,444,[100 603 127 174 318],233,5,1820,4.089887640449438,40.0,60.0
30445,3,445,[185 132 471 202 216],313,5,1825,4.091928251121076,0.0,0.0
30446,3,446,[100 603 127 174 318],234,4,1829,4.091722595078299,40.0,60.0
30447,3,447,[100 603 127 174 318],524,4,1833,4.091517857142857,40.0,60.0
30448,3,448,[100 603 127 174 318],64,4,1837,4.091314031180401,40.0,60.0
30449,3,449,[100 603 127 174 318],82,4,1841,4.091111111111111,40.0,60.0
30450,3,450,[100 603 127 174 318],527,4,1845,4.090909090909091,40.0,60.0
30451,3,451,[269  70 328   9 273],13,0,1845,4.081858407079646,0.0,0.0
30452,3,452,[100 603 127 174 318],694,5,1850,4.083885209713024,40.0,60.0
30453,3,453,[322  82 117  69  50],524,4,1854,4.083700440528634,0.0,20.0
30454,3,454,[100 603 127 174 318],233,5,1859,4.085714285714285,40.0,60.0
30455,3,455,[100 603 127 174 318],527,4,1863,4.0855263157894735,40.0,60.0
30456,3,456,[100 603 127 174 318],234,4,1867,4.085339168490153,40.0,60.0
30457,3,457,[100 603 127 174 318],7,5,1872,4.0873362445414845,40.0,60.0
30458,3,458,[100 603 127 174 318],694,5,1877,4.089324618736383,40.0,60.0
30459,3,459,[100 603 127 174 318],666,4,1881,4.089130434782609,40.0,60.0
30460,3,460,[100 603 127 174 318],452,5,1886,4.091106290672451,40.0,60.0
30461,3,461,[100 603 127 174 318],474,5,1891,4.093073593073593,40.0,60.0
30462,3,462,[100 603 127 174 318],387,4,1895,4.092872570194385,40.0,60.0
30463,3,463,[100 603 127 174 318],334,5,1900,4.094827586206897,40.0,60.0
30464,3,464,[100 603 127 174 318],738,4,1904,4.094623655913979,40.0,60.0
30465,3,465,[100 603 127 174 318],474,5,1909,4.0965665236051505,40.0,60.0
30466,3,466,[100 603 127 174 318],883,5,1914,4.098501070663811,40.0,60.0
30467,3,467,[100 603 127 174 318],334,5,1919,4.10042735042735,40.0,60.0
30468,3,468,[100 603 127 174 318],524,4,1923,4.100213219616204,40.0,60.0
30469,3,469,[100 603 127 174 318],90,5,1928,4.102127659574468,40.0,60.0
30470,3,470,[100 603 127 174 318],189,5,1933,4.104033970276008,40.0,60.0
30471,3,471,[435   8 289 118 174],881,3,1936,4.101694915254237,0.0,20.0
30472,3,472,[100 603 127 174 318],664,5,1941,4.103594080338266,40.0,60.0
30473,3,473,[282  97 211 275   1],95,3,1944,4.10126582278481,0.0,0.0
30474,3,474,[282 100 603 127 174],334,5,1949,4.103157894736842,20.0,60.0
30475,3,475,[ 22  69 238  64 132],454,3,1952,4.100840336134453,0.0,0.0
30476,3,476,[282 100 603 127 174],533,5,1957,4.10272536687631,20.0,60.0
30477,3,477,[282 100 603 127 174],643,4,1961,4.102510460251046,20.0,60.0
30478,3,478,[100 603 127 174 318],474,5,1966,4.104384133611691,40.0,60.0
30479,3,479,[100 603 127 174 318],271,5,1971,4.10625,40.0,60.0
30480,3,480,[100 603 127 174 318],189,5,1976,4.108108108108108,40.0,60.0
30481,3,481,[100 603 127 174 318],59,5,1981,4.109958506224066,40.0,60.0
30482,3,482,[100 603 127 174 318],59,5,1986,4.111801242236025,40.0,60.0
30483,3,483,[100 603 127 174 318],387,4,1990,4.1115702479338845,40.0,60.0
30484,3,484,[100 603 127 174 318],90,5,1995,4.11340206185567,40.0,60.0
30485,3,485,[508 568 238  12  50],385,1,1996,4.106995884773663,20.0,20.0
30486,3,486,[100 603 127 174 318],233,5,2001,4.108829568788501,40.0,60.0
30487,3,487,[100 603 127 174 318],409,5,2006,4.110655737704918,40.0,60.0
30488,3,488,[100 603 127 174 318],527,4,2010,4.110429447852761,40.0,60.0
30489,3,489,[100 603 127 174 318],308,5,2015,4.112244897959184,40.0,60.0
30490,3,490,[100 603 127 174 318],452,5,2020,4.114052953156823,40.0,60.0
30491,3,491,[100 603 127 174 318],308,5,2025,4.115853658536586,40.0,60.0
30492,3,492,[100 603 127 174 318],458,4,2029,4.1156186612576064,40.0,60.0
30493,3,493,[100 603 127 174 318],82,4,2033,4.115384615384615,40.0,60.0
30494,3,494,[197  28   8 655   4],194,4,2037,4.115151515151515,0.0,0.0
30495,3,495,[100 603 127 174 318],64,4,2041,4.11491935483871,40.0,60.0
30496,3,496,[100 603 127 174 318],7,5,2046,4.116700201207244,40.0,60.0
30497,3,497,[180 276   9  15 385],311,5,2051,4.118473895582329,0.0,0.0
30498,3,498,[385 100 603 127 174],10,5,2056,4.1202404809619235,20.0,60.0
30499,3,499,[385 100 603 127 174],650,4,2060,4.12,20.0,60.0
30500,3,500,[385 100 603 127 174],666,3,2063,4.1177644710578845,20.0,60.0
30501,3,501,[100 603 127 174 318],465,3,2066,4.115537848605578,40.0,60.0
30502,3,502,[100 603 127 174 318],387,4,2070,4.11530815109344,40.0,60.0
30503,3,503,[100 603 127 174 318],313,5,2075,4.117063492063492,40.0,60.0
30504,3,504,[100 603 127 174 318],474,5,2080,4.118811881188119,40.0,60.0
30505,3,505,[100 603 127 174 318],90,5,2085,4.120553359683795,40.0,60.0
30506,3,506,[100 603 127 174 318],334,5,2090,4.122287968441815,40.0,60.0
30507,3,507,[100 603 127 174 318],59,5,2095,4.124015748031496,40.0,60.0
30508,3,508,[100 603 127 174 318],458,4,2099,4.1237721021611,40.0,60.0
30509,3,509,[100 603 127 174 318],458,4,2103,4.123529411764705,40.0,60.0
30510,3,510,[100 603 127 174 318],458,4,2107,4.123287671232877,40.0,60.0
30511,3,511,[100 603 127 318 174],189,5,2112,4.125,40.0,60.0
30512,3,512,[100 603 127 318 174],387,4,2116,4.124756335282651,40.0,60.0
30513,3,513,[100 603 127 174 318],13,4,2120,4.124513618677042,40.0,60.0
30514,3,514,[100 603 127 174 318],13,4,2124,4.1242718446601945,40.0,60.0
30515,3,515,[100 603 127 174 318],387,4,2128,4.124031007751938,40.0,60.0
30516,3,516,[100 603 127 174 318],527,4,2132,4.123791102514507,40.0,60.0
30517,3,517,[100 603 127 174 318],409,5,2137,4.125482625482626,40.0,60.0
30518,3,518,[100 603 127 174 318],213,5,2142,4.127167630057803,40.0,60.0
30519,3,519,[100 603 127 174 318],537,4,2146,4.126923076923077,40.0,60.0
30520,3,520,[100 603 127 174 318],465,3,2149,4.1247600767754315,40.0,60.0
30521,3,521,[100 603 127 174 318],313,5,2154,4.126436781609195,40.0,60.0
30522,3,522,[100 603 127 174 318],233,5,2159,4.128107074569789,40.0,60.0
30523,3,523,[100 603 127 174 318],465,3,2162,4.125954198473282,40.0,60.0
30524,3,524,[100 603 127 174 318],13,4,2166,4.1257142857142854,40.0,60.0
30525,3,525,[100 603 127 174 318],313,5,2171,4.1273764258555135,40.0,60.0
30526,3,526,[100 603 127 174 318],59,5,2176,4.129032258064516,40.0,60.0
30527,3,527,[100 603 127 174 318],537,4,2180,4.128787878787879,40.0,60.0
30528,3,528,[187 144  50  88 228],650,2,2182,4.12476370510397,0.0,20.0
30529,3,529,[100 603 127 174 318],59,5,2187,4.126415094339623,40.0,60.0
30530,3,530,[100 603 127 174 318],213,5,2192,4.1280602636534836,40.0,60.0
30531,3,531,[100 603 127 174 318],664,5,2197,4.129699248120301,40.0,60.0
30532,3,532,[100 603 127 174 318],308,5,2202,4.1313320825515945,40.0,60.0
30533,3,533,[100 603 127 174 318],524,4,2206,4.131086142322097,40.0,60.0
30534,3,534,[100 603 127 174 318],13,4,2210,4.130841121495327,40.0,60.0
30535,3,535,[100 603 127 174 318],409,5,2215,4.132462686567164,40.0,60.0
30536,3,536,[100 603 127 174 318],537,4,2219,4.132216014897579,40.0,60.0
30537,3,537,[100 603 127 174 318],883,5,2224,4.133828996282528,40.0,60.0
30538,3,538,[100 603 127 174 318],387,4,2228,4.133580705009276,40.0,60.0
30539,3,539,[100 603 127 174 318],409,5,2233,4.135185185185185,40.0,60.0
30540,3,540,[100 603 127 174 318],474,5,2238,4.136783733826248,40.0,60.0
30541,3,541,[100 603 127 174 318],533,5,2243,4.138376383763838,40.0,60.0
30542,3,542,[435 269 195  28 125],64,4,2247,4.138121546961326,0.0,0.0
30543,3,543,[100 603 127 174 318],537,4,2251,4.137867647058823,40.0,60.0
30544,3,544,[100 603 127 174 318],387,4,2255,4.137614678899083,40.0,60.0
30545,3,545,[100 603 127 174 318],883,5,2260,4.13919413919414,40.0,60.0
30546,3,546,[100 603 127 174 318],213,5,2265,4.140767824497257,40.0,60.0
30547,3,547,[100 603 127 174 318],234,4,2269,4.140510948905109,40.0,60.0
30548,3,548,[100 603 127 174 318],804,4,2273,4.140255009107468,40.0,60.0
30549,3,549,[100 603 127 174 318],666,4,2277,4.14,40.0,60.0
30550,3,550,[100 603 127 174 318],64,4,2281,4.139745916515427,40.0,60.0
30551,3,551,[483 196 300 508 328],537,2,2283,4.135869565217392,20.0,0.0
30552,3,552,[100 603 127 174 318],64,4,2287,4.135623869801085,40.0,60.0
30553,3,553,[100 603 127 174 318],7,5,2292,4.137184115523466,40.0,60.0
30554,3,554,[100 603 127 174 318],385,3,2295,4.135135135135135,40.0,60.0
30555,3,555,[100 603 127 174 318],234,4,2299,4.134892086330935,40.0,60.0
30556,3,556,[100 603 127 318 174],409,5,2304,4.136445242369838,40.0,60.0
30557,3,557,[100 603 127 318 174],804,4,2308,4.136200716845878,40.0,60.0
30558,3,558,[100 603 127 318 174],213,5,2313,4.137745974955277,40.0,60.0
30559,3,559,[100 603 127 318 174],474,5,2318,4.139285714285714,40.0,60.0
30560,3,560,[100 603 127 318 174],271,5,2323,4.140819964349376,40.0,60.0
30561,3,561,[100 603 127 318 174],82,4,2327,4.140569395017794,40.0,60.0
30562,3,562,[100 603 127 318 174],465,3,2330,4.13854351687389,40.0,60.0
30563,3,563,[100 603 127 318 174],527,4,2334,4.138297872340425,40.0,60.0
30564,3,564,[100 603 127 318 174],7,5,2339,4.139823008849557,40.0,60.0
30565,3,565,[100 603 127 318 174],527,4,2343,4.139575971731449,40.0,60.0
30566,3,566,[100 603 127 174 318],387,4,2347,4.139329805996472,40.0,60.0
30567,3,567,[100 603 127 174 318],7,5,2352,4.140845070422535,40.0,60.0
30568,3,568,[211 210 173  89 183],311,4,2356,4.140597539543058,0.0,0.0
30569,3,569,[100 603 127 174 318],313,5,2361,4.1421052631578945,40.0,60.0
30570,3,570,[100 603 127 174 318],308,5,2366,4.143607705779335,40.0,60.0
30571,3,571,[100 603 127 174 318],64,4,2370,4.143356643356643,40.0,60.0
30572,3,572,[100 603 127 174 318],189,5,2375,4.144851657940663,40.0,60.0
30573,3,573,[100 603 127 174 318],527,4,2379,4.144599303135888,40.0,60.0
30574,3,574,[100 603 127 174 318],537,4,2383,4.144347826086957,40.0,60.0
30575,3,575,[ 89 496  12 210   7],60,5,2388,4.145833333333333,20.0,0.0
30576,3,576,[100 603 127  89 174],7,5,2393,4.147313691507799,20.0,60.0
30577,3,577,[100 603 127  89 174],313,5,2398,4.14878892733564,20.0,60.0
30578,3,578,[100 603 127  89 174],334,5,2403,4.150259067357513,20.0,60.0
30579,3,579,[100 603 127  89 174],233,4,2407,4.15,20.0,60.0
30580,3,580,[100 603 127 174 318],738,4,2411,4.1497418244406195,40.0,60.0
30581,3,581,[100 603 127 174 318],804,4,2415,4.149484536082475,40.0,60.0
30582,3,582,[100 603 127 174 318],537,4,2419,4.149228130360206,40.0,60.0
30583,3,583,[515   4 385 204  97],7,4,2423,4.148972602739726,0.0,0.0
30584,3,584,[100 603 127 174 318],452,5,2428,4.150427350427351,40.0,60.0
30585,3,585,[269 435 144 175 143],125,3,2431,4.148464163822526,0.0,0.0
30586,3,586,[100 603 127 174 318],271,5,2436,4.149914821124361,40.0,60.0
30587,3,587,[100 603 127 174 318],308,5,2441,4.151360544217687,40.0,60.0
30588,3,588,[100 603 127 174 318],59,5,2446,4.152801358234296,40.0,60.0
30589,3,589,[100 603 127 174 318],387,4,2450,4.1525423728813555,40.0,60.0
30590,3,590,[100 603 127 174 318],883,5,2455,4.153976311336717,40.0,60.0
30591,3,591,[182 423 135 202 237],537,2,2457,4.150337837837838,0.0,0.0
30592,3,592,[182 100 603 127 174],10,5,2462,4.1517706576728495,20.0,60.0
30593,3,593,[182 100 603 127 174],537,4,2466,4.151515151515151,20.0,60.0
30594,3,594,[182 100 603 127 174],308,5,2471,4.152941176470589,20.0,60.0
30595,3,595,[182 100 603 127 174],7,5,2476,4.154362416107382,20.0,60.0
30596,3,596,[182 100 603 127 174],533,4,2480,4.1541038525963145,20.0,60.0
30597,3,597,[100 603 127 174 318],409,5,2485,4.155518394648829,40.0,60.0
30598,3,598,[172 258  88  22 125],533,5,2490,4.156928213689483,0.0,0.0
30599,3,599,[100 603 127 172 174],313,5,2495,4.158333333333333,20.0,60.0
30600,3,600,[100 603 127 172 174],465,2,2497,4.1547420965058235,20.0,60.0
30601,3,601,[172  11 211 273 144],749,5,2502,4.156146179401993,0.0,0.0
30602,3,602,[100 603 127 174 318],308,5,2507,4.157545605306799,40.0,60.0
30603,3,603,[100 603 127 174 318],59,5,2512,4.158940397350993,40.0,60.0
30604,3,604,[100 603 127 174 318],271,5,2517,4.160330578512396,40.0,60.0
30605,3,605,[100 603 127 174 318],7,5,2522,4.161716171617162,40.0,60.0
30606,3,606,[100 603 127 174 318],234,4,2526,4.161449752883032,40.0,60.0
30607,3,607,[100 603 127 174 318],271,5,2531,4.162828947368421,40.0,60.0
30608,3,608,[100 603 127 174 318],465,3,2534,4.160919540229885,40.0,60.0
30609,3,609,[100 603 127 318 174],524,4,2538,4.160655737704918,40.0,60.0
30610,3,610,[100 603 127 318 174],234,4,2542,4.160392798690671,40.0,60.0
30611,3,611,[100 603 127 318 174],537,4,2546,4.160130718954249,40.0,60.0
30612,3,612,[508 435 117  28 300],378,4,2550,4.159869494290375,0.0,0.0
30613,3,613,[100 603 127  28 318],59,5,2555,4.1612377850162865,40.0,40.0
30614,3,614,[100 603 127  28 318],13,4,2559,4.160975609756098,40.0,40.0
30615,3,615,[100 603 127  28 318],465,3,2562,4.159090909090909,40.0,40.0
30616,3,616,[100 603 127 318 174],271,5,2567,4.160453808752026,40.0,60.0
30617,3,617,[100 603 127 318 174],387,4,2571,4.160194174757281,40.0,60.0
30618,3,618,[100 603 127 318 174],59,5,2576,4.161550888529887,40.0,60.0
30619,3,619,[100 603 127 318 174],90,5,2581,4.162903225806452,40.0,60.0
30620,3,620,[100 603 127 318 174],738,4,2585,4.162640901771336,40.0,60.0
30621,3,621,[100 603 127 318 174],7,5,2590,4.163987138263666,40.0,60.0
30622,3,622,[100 603 127 318 174],537,4,2594,4.163723916532906,40.0,60.0
30623,3,623,[100 603 127 318 174],883,5,2599,4.165064102564102,40.0,60.0
30624,3,624,[100 603 127 318 174],533,5,2604,4.1664,40.0,60.0
30625,3,625,[100 603 127 318 174],385,3,2607,4.164536741214057,40.0,60.0
30626,3,626,[100 603 127 318 174],409,5,2612,4.165869218500798,40.0,60.0
30627,3,627,[100 603 127 318 174],537,4,2616,4.165605095541402,40.0,60.0
30628,3,628,[100 603 127 318 174],524,4,2620,4.165341812400636,40.0,60.0
30629,3,629,[100 603 127 318 174],465,3,2623,4.163492063492064,40.0,60.0
30630,3,630,[100 603 127 318 174],804,4,2627,4.163232963549921,40.0,60.0
30631,3,631,[100 603 127 318 174],385,3,2630,4.1613924050632916,40.0,60.0
30632,3,632,[100 603 127 318 174],533,5,2635,4.162717219589258,40.0,60.0
30633,3,633,[100 603 127 318 174],474,5,2640,4.16403785488959,40.0,60.0
30634,3,634,[100 603 127 318 174],452,5,2645,4.165354330708661,40.0,60.0
30635,3,635,[100 603 127 318 174],804,4,2649,4.165094339622642,40.0,60.0
30636,3,636,[100 603 127 318 174],308,5,2654,4.166405023547881,40.0,60.0
30637,3,637,[100 603 127 318 174],465,3,2657,4.164576802507837,40.0,60.0
30638,3,638,[100 603 127 318 174],59,5,2662,4.165884194053208,40.0,60.0
30639,3,639,[100 603 127 318 174],527,4,2666,4.165625,40.0,60.0
30640,3,640,[100 603 127 318 174],694,5,2671,4.1669266770670825,40.0,60.0
30641,3,641,[100 603 127 318 174],334,5,2676,4.168224299065421,40.0,60.0
30642,3,642,[100 603 127 318 174],694,5,2681,4.169517884914463,40.0,60.0
30643,3,643,[100 603 127 318 174],7,5,2686,4.170807453416149,40.0,60.0
30644,3,644,[183 405  89 678 143],474,4,2690,4.170542635658915,0.0,0.0
30645,3,645,[100 603 127 318 174],533,5,2695,4.171826625386997,40.0,60.0
30646,3,646,[100 603 127 318 174],271,5,2700,4.1731066460587325,40.0,60.0
30647,3,647,[100 603 127 318 174],738,4,2704,4.172839506172839,40.0,60.0
30648,3,648,[603 100 127 318 174],308,5,2709,4.174114021571649,40.0,60.0
30649,3,649,[191 132 318 508 357],59,5,2714,4.1753846153846155,40.0,0.0
30650,3,650,[603 100 127 318 174],387,4,2718,4.175115207373272,40.0,60.0
30651,3,651,[603 100 127 318 174],474,5,2723,4.17638036809816,40.0,60.0
30652,3,652,[143 286 588 222 322],234,0,2723,4.169984686064319,0.0,0.0
30653,3,653,[603 100 127 318 174],334,5,2728,4.17125382262997,40.0,60.0
30654,3,654,[603 100 127 318 174],308,5,2733,4.1725190839694655,40.0,60.0
30655,3,655,[603 100 127 318 174],465,3,2736,4.170731707317073,40.0,60.0
30656,3,656,[603 100 127 318 174],474,5,2741,4.171993911719939,40.0,60.0
30657,3,657,[603 100 127 318 174],537,4,2745,4.171732522796352,40.0,60.0
30658,3,658,[603 100 127 318 174],666,4,2749,4.171471927162367,40.0,60.0
30659,3,659,[603 100 127 318 174],738,4,2753,4.171212121212121,40.0,60.0
30660,3,660,[603 100 127 318 174],90,5,2758,4.172465960665658,40.0,60.0
30661,3,661,[603 100 127 318 174],90,5,2763,4.173716012084592,40.0,60.0
30662,3,662,[603 100 127 318 174],213,5,2768,4.174962292609352,40.0,60.0
30663,3,663,[603 100 127 318 174],213,5,2773,4.176204819277109,40.0,60.0
30664,3,664,[603 100 127 318 174],883,5,2778,4.177443609022556,40.0,60.0
30665,3,665,[603 100 127 318 174],234,4,2782,4.177177177177177,40.0,60.0
30666,3,666,[603 100 127 318 174],59,5,2787,4.178410794602699,40.0,60.0
30667,3,667,[603 100 127 318 174],213,5,2792,4.179640718562874,40.0,60.0
30668,3,668,[603 100 127 318 174],387,4,2796,4.179372197309417,40.0,60.0
30669,3,669,[603 100 127 318 174],465,3,2799,4.177611940298507,40.0,60.0
30670,3,670,[127  69 197 546 323],13,3,2802,4.175856929955291,0.0,20.0
30671,3,671,[191 238 302  96  82],666,3,2805,4.174107142857143,0.0,0.0
30672,3,672,[196 191 176 151 603],339,5,2810,4.175334323922734,20.0,0.0
30673,3,673,[603 100 127 318 174],452,5,2815,4.1765578635014835,40.0,60.0
30674,3,674,[603 100 127 318 174],13,4,2819,4.176296296296297,40.0,60.0
30675,3,675,[603 100 127 318 174],64,4,2823,4.17603550295858,40.0,60.0
30676,3,676,[603 100 127 318 174],465,3,2826,4.174298375184638,40.0,60.0
30677,3,677,[603 100 127 318 174],334,5,2831,4.17551622418879,40.0,60.0
30678,3,678,[603 100 127 318 174],452,5,2836,4.176730486008837,40.0,60.0
30679,3,679,[603 100 127 318 174],465,3,2839,4.175,40.0,60.0
30680,3,680,[588 322 143 174  22],454,3,2842,4.173274596182085,0.0,20.0
30681,3,681,[603 127 100 318 174],527,4,2846,4.173020527859237,40.0,60.0
30682,3,682,[235  98  95 183  25],804,4,2850,4.172767203513909,0.0,20.0
30683,3,683,[265 182 186  22 194],653,3,2853,4.171052631578948,0.0,0.0
30684,3,684,[603 127 100 318 174],90,5,2858,4.172262773722628,40.0,60.0
30685,3,685,[603 127 100 318 174],387,4,2862,4.17201166180758,40.0,60.0
30686,3,686,[603 127 100 318 174],385,3,2865,4.170305676855895,40.0,60.0
30687,3,687,[603 127 100 318 174],213,5,2870,4.171511627906977,40.0,60.0
30688,3,688,[603 127 100 318 174],7,5,2875,4.172714078374455,40.0,60.0
30689,3,689,[603 127 100 318 174],533,5,2880,4.173913043478261,40.0,60.0
30690,3,690,[603 127 100 318 174],537,4,2884,4.173661360347323,40.0,60.0
30691,3,691,[603 127 100 318 174],334,5,2889,4.17485549132948,40.0,60.0
30692,3,692,[603 127 100 318 174],313,5,2894,4.176046176046176,40.0,60.0
30693,3,693,[603 127 100 318 174],738,4,2898,4.175792507204611,40.0,60.0
30694,3,694,[603 127 100 318 174],13,4,2902,4.175539568345323,40.0,60.0
30695,3,695,[603 127 100 318 174],59,5,2907,4.176724137931035,40.0,60.0
30696,3,696,[603 127 100 318 174],189,5,2912,4.177905308464849,40.0,60.0
30697,3,697,[603 127 100 318 174],465,3,2915,4.17621776504298,40.0,60.0
30698,3,698,[603 127 100 318 174],458,4,2919,4.175965665236052,40.0,60.0
30699,3,699,[603 127 100 318 174],664,5,2924,4.177142857142857,40.0,60.0
30700,3,700,[603 127 100 318 174],59,5,2929,4.178316690442226,40.0,60.0
30701,3,701,[603 127 100 318 174],313,5,2934,4.17948717948718,40.0,60.0
30702,3,702,[603 127 100 318 174],465,3,2937,4.177809388335704,40.0,60.0
30703,3,703,[603 127 100 318  97],666,5,2942,4.1789772727272725,40.0,40.0
30704,3,704,[603 127 100  97 318],189,5,2947,4.180141843971631,40.0,40.0
30705,3,705,[603 127 100  97 318],59,5,2952,4.181303116147308,40.0,40.0
30706,3,706,[603 127 100  97 318],308,4,2956,4.181046676096181,40.0,40.0
30707,3,707,[603 127 100 318 195],64,4,2960,4.1807909604519775,40.0,40.0
30708,3,708,[603 127 100 195 318],533,5,2965,4.18194640338505,40.0,40.0
30709,3,709,[603 127 100 195 318],409,5,2970,4.183098591549296,40.0,40.0
30710,3,710,[603 127 100 195 318],313,5,2975,4.184247538677918,40.0,40.0
30711,3,711,[174 655 288 385   7],308,5,2980,4.185393258426966,0.0,20.0
30712,3,712,[603 127 100 195   7],14,4,2984,4.185133239831697,20.0,40.0
30713,3,713,[313  15 276 173   1],144,4,2988,4.184873949579832,0.0,0.0
30714,3,714,[603 127 100 195   7],13,3,2991,4.183216783216783,20.0,40.0
30715,3,715,[603 127 100 318   1],387,4,2995,4.182960893854749,40.0,40.0
30716,3,716,[603 127 100   1 318],804,4,2999,4.182705718270572,40.0,40.0
30717,3,717,[603 127 100   1 318],664,5,3004,4.183844011142061,40.0,40.0
30718,3,718,[269 294  25 186 427],271,3,3007,4.1821974965229485,0.0,0.0
30719,3,719,[603 127 100   1 318],13,3,3010,4.180555555555555,40.0,40.0
30720,3,720,[603 127 100 318  98],883,4,3014,4.180305131761442,40.0,60.0
30721,3,721,[423 181 132  71 508],533,5,3019,4.1814404432132966,0.0,0.0
30722,3,722,[603 127 100 181 318],409,5,3024,4.182572614107884,40.0,40.0
30723,3,723,[603 127 100 181 318],271,5,3029,4.183701657458563,40.0,40.0
30724,3,724,[603 127 100 181 318],666,4,3033,4.183448275862069,40.0,40.0
30725,3,725,[603 127 100 318 173],409,4,3037,4.183195592286501,40.0,40.0
30726,3,726,[603 127 100 318   4],664,5,3042,4.184319119669876,40.0,40.0
30727,3,727,[603 127 100   4 318],234,5,3047,4.18543956043956,40.0,40.0
30728,3,728,[603 127 100   4 318],387,3,3050,4.183813443072703,40.0,40.0
30729,3,729,[191  98   9  70 143],184,4,3054,4.183561643835616,0.0,20.0
30730,3,730,[603 127 100 318 135],465,3,3057,4.181942544459645,40.0,40.0
30731,3,731,[603 127 100 318 385],694,5,3062,4.183060109289618,40.0,40.0
30732,3,732,[603 127 100 385 318],804,4,3066,4.18281036834925,40.0,40.0
30733,3,733,[ 97 237 132 568  64],59,4,3070,4.182561307901907,0.0,0.0
30734,3,734,[202 588 222 172 161],102,2,3072,4.179591836734694,0.0,0.0
30735,3,735,[603 127 100 385 318],537,4,3076,4.179347826086956,40.0,40.0
30736,3,736,[603 127 100 318 176],738,4,3080,4.17910447761194,40.0,40.0
30737,3,737,[603 127 100 176 318],271,4,3084,4.178861788617886,40.0,40.0
30738,3,738,[603 127 100 318 195],234,4,3088,4.178619756427605,40.0,40.0
30739,3,739,[603 127 100 318  89],90,5,3093,4.17972972972973,40.0,40.0
30740,3,740,[603 127 100 318  89],666,5,3098,4.180836707152497,40.0,40.0
30741,3,741,[603 127 100  89 318],234,4,3102,4.180592991913747,40.0,40.0
30742,3,742,[603 127 100 318 174],7,5,3107,4.181695827725437,40.0,60.0
30743,3,743,[603 127 100 318 174],59,5,3112,4.182795698924731,40.0,60.0
30744,3,744,[603 127 100 318 174],694,5,3117,4.183892617449664,40.0,60.0
30745,3,745,[603 127 100 318 174],452,5,3122,4.184986595174263,40.0,60.0
30746,3,746,[258 143  71 100 289],378,5,3127,4.186077643908969,0.0,20.0
30747,3,747,[423  12  69 265 183],311,5,3132,4.18716577540107,20.0,0.0
30748,3,748,[603 127 100 318 174],13,4,3136,4.186915887850467,40.0,60.0
30749,3,749,[234 357  97 471 655],194,2,3138,4.184,20.0,0.0
30750,3,750,[603 127 100 318 174],533,5,3143,4.18508655126498,40.0,60.0
30751,3,751,[603 127 100 318 174],465,3,3146,4.183510638297872,40.0,60.0
30752,3,752,[603 127 100 318 174],804,4,3150,4.183266932270916,40.0,60.0
30753,3,753,[603 127 100 318 174],533,5,3155,4.184350132625995,40.0,60.0
30754,3,754,[603 127 100 318 174],387,4,3159,4.1841059602649,40.0,60.0
30755,3,755,[603 127 100 318 174],90,5,3164,4.185185185185185,40.0,60.0
30756,3,756,[603 127 100 318 174],82,4,3168,4.184940554821664,40.0,60.0
30757,3,757,[603 127 100 318 174],213,5,3173,4.186015831134565,40.0,60.0
30758,3,758,[603 127 100 318 174],452,5,3178,4.187088274044796,40.0,60.0
30759,3,759,[603 127 100 318 174],474,5,3183,4.188157894736842,40.0,60.0
30760,3,760,[603 127 100 318 174],409,5,3188,4.189224704336399,40.0,60.0
30761,3,761,[603 127 100 318 174],694,5,3193,4.190288713910761,40.0,60.0
30762,3,762,[603 127 100 318 174],64,4,3197,4.190039318479686,40.0,60.0
30763,3,763,[603 127 100 318 174],458,4,3201,4.189790575916231,40.0,60.0
30764,3,764,[603 127 100 318 174],13,4,3205,4.189542483660131,40.0,60.0
30765,3,765,[603 127 100 318 174],82,4,3209,4.189295039164491,40.0,60.0
30766,3,766,[196 546 235 742 161],290,2,3211,4.186440677966102,0.0,0.0
30767,3,767,[603 127 100 318 174],213,5,3216,4.1875,40.0,60.0
30768,3,768,[603 127 100 318 174],271,5,3221,4.188556566970091,40.0,60.0
30769,3,769,[603 127 100 318 174],308,5,3226,4.189610389610389,40.0,60.0
30770,3,770,[603 127 100 318 174],694,5,3231,4.190661478599222,40.0,60.0
30771,3,771,[603 127 100 318 174],271,5,3236,4.191709844559585,40.0,60.0
30772,3,772,[603 127 100 318 174],474,5,3241,4.192755498059508,40.0,60.0
30773,3,773,[603 127 100 318 174],537,4,3245,4.19250645994832,40.0,60.0
30774,3,774,[603 127 100 318 174],59,5,3250,4.193548387096774,40.0,60.0
30775,3,775,[603 127 100 318 174],13,4,3254,4.193298969072165,40.0,60.0
30776,3,776,[603 127 100 318 174],694,5,3259,4.194337194337194,40.0,60.0
30777,3,777,[603 127 100 318 174],533,5,3264,4.195372750642673,40.0,60.0
30778,3,778,[603 127 100 318 174],465,3,3267,4.193838254172015,40.0,60.0
30779,3,779,[603 127 100 318 174],738,4,3271,4.193589743589744,40.0,60.0
30780,3,780,[603 127 100 318 174],409,5,3276,4.194622279129321,40.0,60.0
30781,3,781,[603 127 100 318 174],90,5,3281,4.195652173913044,40.0,60.0
30782,3,782,[603 127 100 318 174],694,5,3286,4.196679438058748,40.0,60.0
30783,3,783,[603 127 100 318 174],533,5,3291,4.197704081632653,40.0,60.0
30784,3,784,[603 127 100 318 174],666,4,3295,4.197452229299363,40.0,60.0
30785,3,785,[603 127 100 318 174],59,5,3300,4.198473282442748,40.0,60.0
30786,3,786,[603 127 100 318 174],234,4,3304,4.198221092757306,40.0,60.0
30787,3,787,[301  28  79 318 258],378,4,3308,4.197969543147208,20.0,0.0
30788,3,788,[603 127 100 318 174],334,5,3313,4.198986058301648,40.0,60.0
30789,3,789,[603 127 100 318 174],533,5,3318,4.2,40.0,60.0
30790,3,790,[603 127 100 318 174],533,5,3323,4.201011378002528,40.0,60.0
30791,3,791,[603 127 100 318 174],409,5,3328,4.202020202020202,40.0,60.0
30792,3,792,[603 127 100 318 174],524,4,3332,4.201765447667087,40.0,60.0
30793,3,793,[403 328 176 405 121],95,2,3334,4.198992443324937,0.0,0.0
30794,3,794,[603 127 100 318 174],474,5,3339,4.2,40.0,60.0
30795,3,795,[603 127 100 318 174],334,5,3344,4.201005025125628,40.0,60.0
30796,3,796,[603 127 100 318 174],385,3,3347,4.199498117942284,40.0,60.0
30797,3,797,[603 127 100 318 174],334,5,3352,4.200501253132832,40.0,60.0
30798,3,798,[603 127 100 318 174],59,5,3357,4.201501877346684,40.0,60.0
30799,3,799,[603 127 100 318 174],213,5,3362,4.2025,40.0,60.0
30800,3,800,[603 127 100 318 174],527,4,3366,4.202247191011236,40.0,60.0
30801,3,801,[603 127 100 318 174],524,4,3370,4.201995012468828,40.0,60.0
30802,3,802,[603 127 100 318 174],537,4,3374,4.2017434620174345,40.0,60.0
30803,3,803,[ 15 132 294 234 151],234,2,3376,4.199004975124378,0.0,0.0
30804,3,804,[603 127 100 318 174],387,4,3380,4.198757763975156,40.0,60.0
30805,3,805,[603 127 100 318 174],385,3,3383,4.197270471464019,40.0,60.0
30806,3,806,[603 127 100 318 174],664,5,3388,4.198265179677819,40.0,60.0
30807,3,807,[603 127 100 318 174],90,5,3393,4.199257425742574,40.0,60.0
30808,3,808,[603 127 100 318 174],738,4,3397,4.199011124845488,40.0,60.0
30809,3,809,[603 127 100 318 174],271,5,3402,4.2,40.0,60.0
30810,3,810,[603 127 100 318 174],233,5,3407,4.200986436498151,40.0,60.0
30811,3,811,[121 289 273 300 483],13,2,3409,4.198275862068965,20.0,0.0
30812,3,812,[603 127 100 121 318],804,4,3413,4.198031980319803,40.0,40.0
30813,3,813,[603 127 100 121 318],533,5,3418,4.199017199017199,40.0,40.0
30814,3,814,[603 127 100 121 318],334,4,3422,4.198773006134969,40.0,40.0
30815,3,815,[603 127 100 318 174],524,4,3426,4.198529411764706,40.0,60.0
30816,3,816,[603 127 100 318 174],234,4,3430,4.19828641370869,40.0,60.0
30817,3,817,[603 127 100 318 174],804,4,3434,4.198044009779951,40.0,60.0
30818,3,818,[603 127 100 318 174],524,4,3438,4.197802197802198,40.0,60.0
30819,3,819,[603 127 100 318 174],458,4,3442,4.197560975609756,40.0,60.0
30820,3,820,[603 127 100 318 174],313,5,3447,4.198538367844092,40.0,60.0
30821,3,821,[603 127 100 318 174],804,4,3451,4.198296836982968,40.0,60.0
30822,3,822,[603 127 100 318 174],59,5,3456,4.199270959902795,40.0,60.0
30823,3,823,[603 127 100 318 174],883,5,3461,4.200242718446602,40.0,60.0
30824,3,824,[275  97 111   4 173],537,2,3463,4.197575757575757,0.0,0.0
30825,3,825,[603 127 100 318 174],409,5,3468,4.198547215496368,40.0,60.0
30826,3,826,[265  95 238 153  56],295,5,3473,4.199516324062878,0.0,0.0
30827,3,827,[603 127 100 318 174],533,5,3478,4.200483091787439,40.0,60.0
30828,3,828,[603 127 100 318 174],524,4,3482,4.200241254523522,40.0,60.0
30829,3,829,[603 127 100 318 174],90,5,3487,4.201204819277108,40.0,60.0
30830,3,830,[603 127 100 318 174],234,4,3491,4.200962695547533,40.0,60.0
30831,3,831,[603 127 100 318 174],465,3,3494,4.199519230769231,40.0,60.0
30832,3,832,[187 125 168 471 546],271,1,3495,4.195678271308523,0.0,0.0
30833,3,833,[603 127 100 318  56],385,4,3499,4.195443645083933,40.0,40.0
30834,3,834,[603 127 100 318  56],458,5,3504,4.196407185628742,40.0,40.0
30835,3,835,[603 127 100  56 318],524,4,3508,4.196172248803828,40.0,40.0
30836,3,836,[603 127 100  56 318],90,5,3513,4.197132616487456,40.0,40.0
30837,3,837,[603 127 100  56 318],664,5,3518,4.198090692124105,40.0,40.0
30838,3,838,[603 127 100  56 318],315,5,3523,4.199046483909416,40.0,40.0
30839,3,839,[603 127 100  56 318],666,5,3528,4.2,40.0,40.0
30840,3,840,[153 191 176 405 194],313,3,3531,4.198573127229489,0.0,0.0
30841,3,841,[603 127  56 100 318],387,4,3535,4.19833729216152,40.0,40.0
30842,3,842,[603  56 127 100 318],666,5,3540,4.199288256227758,40.0,40.0
30843,3,843,[603  56 127 100 318],82,3,3543,4.197867298578199,40.0,40.0
30844,3,844,[603 127 100  56 318],232,4,3547,4.197633136094675,40.0,40.0
30845,3,845,[187 204  71 132 275],533,5,3552,4.198581560283688,0.0,0.0
30846,3,846,[603 100 127  56 318],59,5,3557,4.199527744982291,40.0,40.0
30847,3,847,[603 100 127  56 318],458,5,3562,4.2004716981132075,40.0,40.0
30848,3,848,[ 89 144 174  15 172],290,3,3565,4.199057714958775,0.0,20.0
30849,3,849,[603 100 127  56 318],334,5,3570,4.2,40.0,40.0
30850,3,850,[603 100 127  56 318],524,4,3574,4.1997649823736785,40.0,40.0
30851,3,851,[588 282 175 385 196],378,5,3579,4.200704225352113,0.0,0.0
30852,3,852,[603 100 127  56 318],308,5,3584,4.201641266119578,40.0,40.0
30853,3,853,[603 100 127  56 318],232,4,3588,4.201405152224824,40.0,40.0
30854,3,854,[603 100 127  56 318],59,5,3593,4.20233918128655,40.0,40.0
30855,3,855,[603 100 127  56 318],271,4,3597,4.202102803738318,40.0,40.0
30856,3,856,[603 100 127  56 318],315,5,3602,4.2030338389731625,40.0,40.0
30857,3,857,[603 100 127  56 318],64,4,3606,4.2027972027972025,40.0,40.0
30858,3,858,[603 100 127  56 318],334,5,3611,4.20372526193248,40.0,40.0
30859,3,859,[603 100 127  56 318],474,5,3616,4.2046511627906975,40.0,40.0
30860,3,860,[588 211 568 204 234],897,5,3621,4.205574912891986,0.0,0.0
30861,3,861,[603 100 127  56 318],13,4,3625,4.205336426914153,40.0,40.0
30862,3,862,[603 100 127  56 318],313,4,3629,4.205098493626883,40.0,40.0
30863,3,863,[603 100 127  56 318],666,5,3634,4.206018518518518,40.0,40.0
30864,3,864,[603 100 127  56 318],524,4,3638,4.205780346820809,40.0,40.0
30865,3,865,[603 100 127  56 318],385,4,3642,4.20554272517321,40.0,40.0
30866,3,866,[603 100 127  56 318],233,5,3647,4.206459054209919,40.0,40.0
30867,3,867,[603 100 127  56 318],524,4,3651,4.206221198156682,40.0,40.0
30868,3,868,[185 121 427 168  79],452,5,3656,4.207134637514384,0.0,0.0
30869,3,869,[603 100 127  56 318],533,4,3660,4.206896551724138,40.0,40.0
30870,3,870,[603 100 127  56 318],7,5,3665,4.2078071182548795,40.0,40.0
30871,3,871,[603 100 127  56 318],533,4,3669,4.20756880733945,40.0,40.0
30872,3,872,[603 100 127 318  56],527,4,3673,4.207331042382589,40.0,40.0
30873,3,873,[603 100 127 318  56],387,4,3677,4.2070938215102975,40.0,40.0
30874,3,874,[603 100 127 318  56],232,4,3681,4.206857142857143,40.0,40.0
30875,3,875,[211 603 168 237 258],537,4,3685,4.20662100456621,20.0,0.0
30876,3,876,[603 100 127 318  56],315,5,3690,4.2075256556442415,40.0,40.0
30877,3,877,[603 100 127  56 318],189,5,3695,4.208428246013668,40.0,40.0
30878,3,878,[603 100 127  56 318],308,5,3700,4.2093287827076225,40.0,40.0
30879,3,879,[  1 168 546 179  56],653,3,3703,4.2079545454545455,0.0,0.0
30880,3,880,[603 100 127  56 318],233,5,3708,4.208853575482406,40.0,40.0
30881,3,881,[603 100 127  56 318],533,4,3712,4.208616780045351,40.0,40.0
30882,3,882,[603 100 127 318  56],385,4,3716,4.2083805209513026,40.0,40.0
30883,3,883,[603 100 127  56 318],387,4,3720,4.208144796380091,40.0,40.0
30884,3,884,[603 100 127  56 318],271,4,3724,4.207909604519774,40.0,40.0
30885,3,885,[132 202 143  71 180],7,3,3727,4.206546275395034,0.0,0.0
30886,3,886,[ 82 187 423 588   8],387,3,3730,4.205186020293123,0.0,0.0
30887,3,887,[603 100 127  71 318],524,3,3733,4.203828828828829,40.0,40.0
30888,3,888,[603 100 127 318  56],804,3,3736,4.202474690663667,40.0,40.0
30889,3,889,[194 275 100 197 222],454,2,3738,4.2,0.0,20.0
30890,3,890,[603 100 127 318 427],533,5,3743,4.200897867564534,40.0,40.0
30891,3,891,[603 100 127 427 318],666,5,3748,4.201793721973094,40.0,40.0
30892,3,892,[603 100 127 427 318],13,4,3752,4.201567749160135,40.0,40.0
30893,3,893,[603 100 127 427 318],452,5,3757,4.202460850111857,40.0,40.0
30894,3,894,[603 100 127 427 318],334,5,3762,4.203351955307262,40.0,40.0
30895,3,895,[603 100 127 427 318],308,5,3767,4.204241071428571,40.0,40.0
30896,3,896,[603 100 127 427 318],308,5,3772,4.205128205128205,40.0,40.0
30897,3,897,[603 100 427 127 318],533,5,3777,4.206013363028953,40.0,40.0
30898,3,898,[603 100 427 127 318],533,5,3782,4.206896551724138,40.0,40.0
30899,3,899,[111 322  69 200 238],474,4,3786,4.206666666666667,0.0,0.0
30900,3,900,[427 603 100 127 318],234,5,3791,4.2075471698113205,40.0,40.0
30901,3,901,[222 173 323 273 127],883,4,3795,4.2073170731707314,0.0,20.0
30902,3,902,[427 603 100 127 318],313,5,3800,4.208194905869324,40.0,40.0
30903,3,903,[427 603 100 127 318],458,5,3805,4.209070796460177,40.0,40.0
30904,3,904,[427 603 100 127 318],334,5,3810,4.209944751381215,40.0,40.0
30905,3,905,[427 603 100 127 318],694,5,3815,4.210816777041942,40.0,40.0
30906,3,906,[427 603 100 127 318],474,5,3820,4.211686879823595,40.0,40.0
30907,3,907,[427 603 100 127 318],474,5,3825,4.212555066079295,40.0,40.0
30908,3,908,[427 603 100 127 318],533,5,3830,4.213421342134214,40.0,40.0
30909,3,909,[427 603 100 127 318],313,5,3835,4.214285714285714,40.0,40.0
30910,3,910,[427 603 100 127 318],694,5,3840,4.2151481888035125,40.0,40.0
30911,3,911,[427 603 100 127 318],537,5,3845,4.2160087719298245,40.0,40.0
30912,3,912,[427 603 100 127 318],13,4,3849,4.215772179627601,40.0,40.0
30913,3,913,[427 603 100 127 318],474,5,3854,4.216630196936543,40.0,40.0
30914,3,914,[100 357 197 228  96],312,4,3858,4.216393442622951,20.0,20.0
30915,3,915,[427 603 100 127 318],694,5,3863,4.217248908296943,40.0,40.0
30916,3,916,[427 603 100 127 318],537,5,3868,4.218102508178844,40.0,40.0
30917,3,917,[427 603 100 127 318],533,5,3873,4.218954248366013,40.0,40.0
30918,3,918,[  1 173 144 125 204],378,4,3877,4.218715995647443,0.0,0.0
30919,3,919,[427 603 100 127 318],13,4,3881,4.218478260869565,40.0,40.0
30920,3,920,[427 603 100 127 318],13,4,3885,4.2182410423452765,40.0,40.0
30921,3,921,[427 603 100 127 318],458,5,3890,4.219088937093275,40.0,40.0
30922,3,922,[427 603 100 127 318],13,4,3894,4.218851570964247,40.0,40.0
30923,3,923,[427 603 100 127 318],385,4,3898,4.2186147186147185,40.0,40.0
30924,3,924,[427 603 100 127 318],385,4,3902,4.218378378378379,40.0,40.0
30925,3,925,[427 603 100 127 318],694,5,3907,4.219222462203024,40.0,40.0
30926,3,926,[427 603 100 127 318],527,4,3911,4.21898597626753,40.0,40.0
30927,3,927,[427 603 100 127 318],452,5,3916,4.219827586206897,40.0,40.0
30928,3,928,[427 603 100 127 318],13,4,3920,4.219590958019376,40.0,40.0
30929,3,929,[427 603 100 127 318],313,5,3925,4.220430107526882,40.0,40.0
30930,3,930,[427 603 100 127 318],666,5,3930,4.221267454350161,40.0,40.0
30931,3,931,[132 435  28 238 183],537,1,3931,4.217811158798283,0.0,0.0
30932,3,932,[185 237  82 180 323],13,2,3933,4.215434083601286,0.0,0.0
30933,3,933,[427 603 100 127 318],7,5,3938,4.2162740899357605,40.0,40.0
30934,3,934,[427 603 100 127 318],664,5,3943,4.21711229946524,40.0,40.0
30935,3,935,[427 603 100 127 318],409,5,3948,4.217948717948718,40.0,40.0
30936,3,936,[427 603 100 127 318],7,5,3953,4.218783351120598,40.0,40.0
30937,3,937,[405 175 228 111 234],749,2,3955,4.2164179104477615,0.0,0.0
30938,3,938,[427 603 100 127 318],666,5,3960,4.217252396166134,40.0,40.0
30939,3,939,[427 603 100 127 318],334,5,3965,4.218085106382978,40.0,40.0
30940,3,940,[427 603 100 127 318],13,4,3969,4.217853347502657,40.0,40.0
30941,3,941,[427 603 100 127 318],527,4,3973,4.217622080679406,40.0,40.0
30942,3,942,[427 603 100 127 318],527,4,3977,4.217391304347826,40.0,40.0
30943,3,943,[427 603 100 127 318],664,5,3982,4.218220338983051,40.0,40.0
30944,3,944,[427 603 100 127 318],59,5,3987,4.219047619047619,40.0,40.0
30945,3,945,[427 603 100 127 318],13,4,3991,4.218816067653277,40.0,40.0
30946,3,946,[ 69  70 435 405 655],406,2,3993,4.216473072861668,0.0,0.0
30947,3,947,[427 603 100 127 318],409,5,3998,4.217299578059071,40.0,40.0
30948,3,948,[427 603 100 127 318],234,5,4003,4.218124341412013,40.0,40.0
30949,3,949,[427 603 100 127 318],527,4,4007,4.217894736842105,40.0,40.0
30950,3,950,[427 603 100 127 318],271,5,4012,4.218717139852787,40.0,40.0
30951,3,951,[427 603 100 127 318],234,5,4017,4.21953781512605,40.0,40.0
30952,3,952,[427 603 100 127 318],313,5,4022,4.220356768100735,40.0,40.0
30953,3,953,[427 603 100 127 318],59,5,4027,4.221174004192872,40.0,40.0
30954,3,954,[427 603 100 127 318],7,5,4032,4.221989528795811,40.0,40.0
30955,3,955,[427 603 100 127 318],59,5,4037,4.222803347280335,40.0,40.0
30956,3,956,[427 603 100 127 318],13,4,4041,4.222570532915361,40.0,40.0
30957,3,957,[427 603 100 127 318],452,5,4046,4.223382045929019,40.0,40.0
30958,3,958,[427 603 100 127 318],458,5,4051,4.224191866527633,40.0,40.0
30959,3,959,[427 603 100 127 318],234,5,4056,4.225,40.0,40.0
30960,3,960,[183 235 174 186 323],537,1,4057,4.221644120707596,0.0,20.0
30961,3,961,[427 603 100 127 318],666,5,4062,4.222453222453223,40.0,40.0
30962,3,962,[427 603 100 127 318],90,5,4067,4.2232606438213915,40.0,40.0
30963,3,963,[427 603 100 127 318],7,5,4072,4.224066390041494,40.0,40.0
30964,3,964,[427 603 100 127 318],234,5,4077,4.224870466321244,40.0,40.0
30965,3,965,[427 603 100 127 318],271,5,4082,4.225672877846791,40.0,40.0
30966,3,966,[275 234 180 211 655],527,3,4085,4.2244053774560495,0.0,0.0
30967,3,967,[427 603 100 127 318],308,5,4090,4.225206611570248,40.0,40.0
30968,3,968,[234 286 508 197 275],60,5,4095,4.226006191950464,0.0,0.0
30969,3,969,[427 603 100 127 318],666,5,4100,4.22680412371134,40.0,40.0
30970,3,970,[427 603 100 127 318],537,5,4105,4.2276004119464465,40.0,40.0
30971,3,971,[427 603 100 127 318],308,5,4110,4.228395061728395,40.0,40.0
30972,3,972,[427 603 100 127 318],409,5,4115,4.229188078108941,40.0,40.0
30973,3,973,[427 603 100 127 318],385,4,4119,4.228952772073922,40.0,40.0
30974,3,974,[161 200  97 187 323],474,3,4122,4.227692307692307,0.0,0.0
30975,3,975,[427 603 100 127 318],234,5,4127,4.228483606557377,40.0,40.0
30976,3,976,[427 603 100 127 318],664,5,4132,4.229273285568065,40.0,40.0
30977,3,977,[427 603 100 127 318],527,4,4136,4.229038854805726,40.0,40.0
30978,3,978,[427 603 100 127 318],537,5,4141,4.229826353421859,40.0,40.0
30979,3,979,[216 471 173 273  79],42,4,4145,4.229591836734694,0.0,0.0
30980,3,980,[427 603 100 127 318],694,5,4150,4.230377166156982,40.0,40.0
30981,3,981,[427 603 100 127 318],537,5,4155,4.231160896130346,40.0,40.0
30982,3,982,[427 603 100 127 318],474,5,4160,4.2319430315361135,40.0,40.0
30983,3,983,[427 603 100 127 318],385,4,4164,4.2317073170731705,40.0,40.0
30984,3,984,[427 603 100 127 318],452,5,4169,4.23248730964467,40.0,40.0
30985,3,985,[144  98 182 237 215],346,3,4172,4.231237322515213,0.0,20.0
30986,3,986,[427 603 100 127 318],313,5,4177,4.232016210739615,40.0,40.0
30987,3,987,[427 603 100 127 318],527,4,4181,4.231781376518219,40.0,40.0
30988,3,988,[427 603 100 127 318],308,5,4186,4.232558139534884,40.0,40.0
30989,3,989,[  1 423  64 191  56],184,4,4190,4.232323232323233,0.0,0.0
30990,3,990,[427 603 100 127 191],474,5,4195,4.233097880928355,20.0,40.0
30991,3,991,[427 603 100 127 191],7,5,4200,4.233870967741935,20.0,40.0
30992,3,992,[197 276 181  69  28],406,4,4204,4.233635448136959,0.0,0.0
30993,3,993,[  8 215 300 222   4],328,1,4205,4.230382293762576,0.0,0.0
30994,3,994,[427 603 100 127 191],650,4,4209,4.230150753768844,20.0,40.0
30995,3,995,[427 603 100 127 191],458,5,4214,4.230923694779117,20.0,40.0
30996,3,996,[427 603 100 127 191],313,5,4219,4.231695085255767,20.0,40.0
30997,3,997,[427 603 100 127 191],409,5,4224,4.232464929859719,20.0,40.0
30998,3,998,[427 603 100 127 191],694,5,4229,4.233233233233233,20.0,40.0
30999,3,999,[427 603 100 127 191],271,5,4234,4.234,20.0,40.0
31000,3,1000,[427 603 100 191 127],568,5,4239,4.234765234765235,20.0,40.0
31001,3,1001,[427 603 100 191 127],527,5,4244,4.235528942115768,20.0,40.0
31002,3,1002,[427 191 603 100 127],409,5,4249,4.23629112662014,20.0,40.0
31003,3,1003,[427 191 603 100 127],409,5,4254,4.2370517928286855,20.0,40.0
31004,3,1004,[  8  97  11   4 180],387,2,4256,4.234825870646766,0.0,0.0
31005,3,1005,[427 191 603 100 127],313,5,4261,4.23558648111332,20.0,40.0
31006,3,1006,[427 191 603 100 127],458,5,4266,4.236345580933466,20.0,40.0
31007,3,1007,[427 191 603 100 127],458,5,4271,4.237103174603175,20.0,40.0
31008,3,1008,[427 191 603 100 127],694,5,4276,4.237859266600594,20.0,40.0
31009,3,1009,[173 168 294  69  64],374,2,4278,4.235643564356436,0.0,0.0
31010,3,1010,[427 191 603 100 127],650,4,4282,4.235410484668645,20.0,40.0
31011,3,1011,[427 191 603 100 127],7,5,4287,4.236166007905139,20.0,40.0
31012,3,1012,[427 191 603 100 127],452,5,4292,4.236920039486673,20.0,40.0
31013,3,1013,[  9 144 294 265 194],13,3,4295,4.235700197238659,0.0,0.0
31014,3,1014,[ 89 471  28 423 546],648,5,4300,4.236453201970443,0.0,0.0
31015,3,1015,[427 191 603 100 127],234,5,4305,4.237204724409449,20.0,40.0
31016,3,1016,[427 191 603 100 127],379,5,4310,4.23795476892822,20.0,40.0
31017,3,1017,[427 191 603 100 127],452,5,4315,4.238703339882122,20.0,40.0
31018,3,1018,[427 191 603 100 127],14,4,4319,4.23846908734053,20.0,40.0
31019,3,1019,[427 191 603 100 127],334,5,4324,4.23921568627451,20.0,40.0
31020,3,1020,[427 191 603 100 127],379,5,4329,4.2399608227228205,20.0,40.0
31021,3,1021,[144 100 435 294 202],387,1,4330,4.236790606653621,0.0,20.0
31022,3,1022,[427 191 603 100 127],234,5,4335,4.237536656891495,20.0,40.0
31023,3,1023,[427 191 603 100 127],452,5,4340,4.23828125,20.0,40.0
31024,3,1024,[427 191 603 100 127],533,5,4345,4.239024390243903,20.0,40.0
31025,3,1025,[427 191 603 100 127],568,5,4350,4.239766081871345,20.0,40.0
31026,3,1026,[427 191 603 100 127],537,5,4355,4.2405063291139244,20.0,40.0
31027,3,1027,[427 191 603 100 127],398,4,4359,4.240272373540856,20.0,40.0
31028,3,1028,[427 191 603 100 127],537,5,4364,4.241010689990282,20.0,40.0
31029,3,1029,[405 655 318 181   1],738,3,4367,4.239805825242718,20.0,0.0
31030,3,1030,[427 191 603 100 127],398,4,4371,4.239573229873908,20.0,40.0
31031,3,1031,[427 191 603 100 127],474,5,4376,4.24031007751938,20.0,40.0
31032,3,1032,[427 191 603 100 127],90,5,4381,4.241045498547919,20.0,40.0
31033,3,1033,[427 191 603 100 127],398,4,4385,4.240812379110252,20.0,40.0
31034,3,1034,[427 191 603 100 127],379,5,4390,4.241545893719807,20.0,40.0
31035,3,1035,[427 191 603 100 127],458,5,4395,4.242277992277992,20.0,40.0
31036,3,1036,[427 191 603 100 127],334,5,4400,4.243008678881389,20.0,40.0
31037,3,1037,[403  56 100 318 210],308,5,4405,4.24373795761079,20.0,20.0
31038,3,1038,[427 191 603 100 127],7,5,4410,4.24446583253128,20.0,40.0
31039,3,1039,[427 191 603 100 127],379,5,4415,4.2451923076923075,20.0,40.0
31040,3,1040,[427 191 603 100 127],537,5,4420,4.245917387127761,20.0,40.0
31041,3,1041,[427 191 603 100 127],7,5,4425,4.246641074856046,20.0,40.0
31042,3,1042,[427 191 603 100 127],664,4,4429,4.2464046021093,20.0,40.0
31043,3,1043,[427 191 603 100 127],271,5,4434,4.247126436781609,20.0,40.0
31044,3,1044,[427 191 603 100 127],474,5,4439,4.247846889952153,20.0,40.0
31045,3,1045,[276 187 194 210  79],406,3,4442,4.246653919694072,0.0,0.0
31046,3,1046,[427 191 603 100 127],271,5,4447,4.247373447946514,20.0,40.0
31047,3,1047,[427 191 603 100 127],313,5,4452,4.248091603053435,20.0,40.0
31048,3,1048,[403  25 100 405 508],318,3,4455,4.246901811248808,0.0,20.0
31049,3,1049,[427 191 603 100 127],379,5,4460,4.247619047619048,20.0,40.0
31050,3,1050,[427 191 603 100 127],650,4,4464,4.247383444338725,20.0,40.0
31051,3,1051,[427 191 603 100 127],313,5,4469,4.248098859315589,20.0,40.0
31052,3,1052,[427 191 603 100 127],650,4,4473,4.247863247863248,20.0,40.0
31053,3,1053,[427 191 603 100 127],533,5,4478,4.248576850094877,20.0,40.0
31054,3,1054,[427 191 603 100 127],313,5,4483,4.249289099526067,20.0,40.0
31055,3,1055,[427 191 603 100 127],527,5,4488,4.25,20.0,40.0
31056,3,1056,[175  97 322 127 135],474,5,4493,4.250709555345317,0.0,20.0
31057,3,1057,[427 191 603 100 127],234,5,4498,4.251417769376181,20.0,40.0
31058,3,1058,[427 191 603 100 127],694,5,4503,4.252124645892351,20.0,40.0
31059,3,1059,[235  12 144 568 597],328,2,4505,4.25,20.0,0.0
31060,3,1060,[427 191 603 100 127],385,4,4509,4.249764373232799,20.0,40.0
31061,3,1061,[427 191 603 100 127],474,5,4514,4.250470809792843,20.0,40.0
31062,3,1062,[427 191 603 100 127],7,5,4519,4.251175917215428,20.0,40.0
31063,3,1063,[427 191 603 100 127],398,4,4523,4.25093984962406,20.0,40.0
31064,3,1064,[323 182 180 228   4],87,4,4527,4.250704225352113,0.0,0.0
31065,3,1065,[427 191 603 100 127],537,5,4532,4.25140712945591,20.0,40.0
31066,3,1066,[427 191 603 100 127],271,5,4537,4.252108716026242,20.0,40.0
31067,3,1067,[427 191 603 100 127],398,4,4541,4.25187265917603,20.0,40.0
31068,3,1068,[427 191 603 100 127],379,5,4546,4.252572497661366,20.0,40.0
31069,3,1069,[427 191 603 100 127],452,5,4551,4.253271028037383,20.0,40.0
31070,3,1070,[427 191 603 100 127],59,5,4556,4.253968253968254,20.0,40.0
31071,3,1071,[427 191 603 100 127],527,5,4561,4.254664179104478,20.0,40.0
31072,3,1072,[427 191 603 100 127],409,5,4566,4.255358807082945,20.0,40.0
31073,3,1073,[427 191 603 100 127],409,5,4571,4.256052141527002,20.0,40.0
31074,3,1074,[427 191 603 100 127],234,5,4576,4.256744186046512,20.0,40.0
31075,3,1075,[427 191 603 100 127],664,4,4580,4.256505576208179,20.0,40.0
31076,3,1076,[427 191 603 100 127],650,4,4584,4.256267409470752,20.0,40.0
31077,3,1077,[427 191 603 100 127],313,5,4589,4.2569573283859,20.0,40.0
31078,3,1078,[427 191 603 100 127],313,5,4594,4.257645968489342,20.0,40.0
31079,3,1079,[427 191 603 100 127],334,5,4599,4.258333333333334,20.0,40.0
31080,3,1080,[427 191 603 100 127],90,5,4604,4.259019426456984,20.0,40.0
31081,3,1081,[427 191 603 100 127],568,5,4609,4.259704251386322,20.0,40.0
31082,3,1082,[427 191 603 100 127],7,5,4614,4.260387811634349,20.0,40.0
31083,3,1083,[427 191 603 100 127],452,5,4619,4.261070110701107,20.0,40.0
31084,3,1084,[ 79 228 333 132 168],313,3,4622,4.259907834101383,0.0,0.0
31085,3,1085,[318   7 211 655 196],235,4,4626,4.259668508287293,20.0,0.0
31086,3,1086,[333 427 191 603 100],313,5,4631,4.260349586016559,20.0,20.0
31087,3,1087,[ 50  69 186 200  97],339,5,4636,4.261029411764706,0.0,20.0
31088,3,1088,[333 427 191 603 100],458,4,4640,4.26078971533517,20.0,20.0
31089,3,1089,[427 191 603 100 127],666,5,4645,4.261467889908257,20.0,40.0
31090,3,1090,[427 191 603 100 127],452,5,4650,4.2621448212648945,20.0,40.0
31091,3,1091,[427 191 603 100 127],666,5,4655,4.262820512820513,20.0,40.0
31092,3,1092,[427 191 603 100 127],398,4,4659,4.262580054894785,20.0,40.0
31093,3,1093,[427 191 603 100 127],13,4,4663,4.262340036563072,20.0,40.0
31094,3,1094,[427 191 603 100 127],13,4,4667,4.262100456621004,20.0,40.0
31095,3,1095,[427 603 100 191 127],7,5,4672,4.262773722627737,20.0,40.0
31096,3,1096,[289  64 302 144 323],328,4,4676,4.26253418413856,0.0,0.0
31097,3,1097,[265 144  79 269 423],339,2,4678,4.260473588342441,0.0,0.0
31098,3,1098,[427 603 191 100 127],537,5,4683,4.261146496815287,20.0,40.0
31099,3,1099,[427 603 191 100 127],527,5,4688,4.261818181818182,20.0,40.0
31100,3,1100,[427 603 191 100 127],339,5,4693,4.262488646684832,20.0,40.0
31101,3,1101,[427 603 191 100 127],458,5,4698,4.2631578947368425,20.0,40.0
31102,3,1102,[427 603 191 100 127],664,4,4702,4.262919310970082,20.0,40.0
31103,3,1103,[427 603 100 191 127],59,5,4707,4.263586956521739,20.0,40.0
31104,3,1104,[210 211 191 197 301],13,2,4709,4.2615384615384615,0.0,0.0
31105,3,1105,[427 603 100 127 191],14,4,4713,4.26130198915009,20.0,40.0
31106,3,1106,[427 603 100 127 191],458,5,4718,4.26196928635953,20.0,40.0
31107,3,1107,[427 603 100 127 191],339,5,4723,4.262635379061372,20.0,40.0
31108,3,1108,[427 603 100 127 191],379,5,4728,4.263300270513977,20.0,40.0
31109,3,1109,[ 56 191 176   4 423],881,3,4731,4.262162162162162,0.0,0.0
31110,3,1110,[427 603 100 127 191],452,5,4736,4.262826282628263,20.0,40.0
31111,3,1111,[427 603 100 127 191],313,5,4741,4.263489208633094,20.0,40.0
31112,3,1112,[427 603 100 127 191],458,5,4746,4.264150943396227,20.0,40.0
31113,3,1113,[427 603 100 127 191],385,4,4750,4.26391382405745,20.0,40.0
31114,3,1114,[427 603 100 127 191],694,5,4755,4.26457399103139,20.0,40.0
31115,3,1115,[427 603 100 127 191],666,5,4760,4.265232974910394,20.0,40.0
31116,3,1116,[265 245 197 568  69],804,5,4765,4.265890778871978,0.0,0.0
31117,3,1117,[427 603 100 127 191],308,5,4770,4.26654740608229,20.0,40.0
31118,3,1118,[427 603 100 127 191],568,5,4775,4.267202859696157,20.0,40.0
31119,3,1119,[427 603 100 127 191],271,5,4780,4.267857142857143,20.0,40.0
31120,3,1120,[427 603 100 127 191],379,5,4785,4.268510258697591,20.0,40.0
31121,3,1121,[427 603 100 127 191],385,4,4789,4.268270944741533,20.0,40.0
31122,3,1122,[427 603 100 127 191],664,4,4793,4.268032056990204,20.0,40.0
31123,3,1123,[427 603 100 127 191],452,5,4798,4.2686832740213525,20.0,40.0
31124,3,1124,[427 603 100 127 191],385,4,4802,4.2684444444444445,20.0,40.0
31125,3,1125,[427 603 100 127 191],308,5,4807,4.269094138543517,20.0,40.0
31126,3,1126,[427 603 100 127 191],474,5,4812,4.269742679680568,20.0,40.0
31127,3,1127,[ 71 182 174 197 483],474,5,4817,4.2703900709219855,20.0,20.0
31128,3,1128,[427 603 100 127 191],234,5,4822,4.271036315323295,20.0,40.0
31129,3,1129,[483  12 197  11 302],560,5,4827,4.271681415929203,40.0,0.0
31130,3,1130,[427 603 100 127 191],527,5,4832,4.272325375773652,20.0,40.0
31131,3,1131,[427 603 100 127 191],537,5,4837,4.272968197879859,20.0,40.0
31132,3,1132,[427 603 100 127 191],474,5,4842,4.27360988526037,20.0,40.0
31133,3,1133,[427 603 100 127 191],308,5,4847,4.274250440917108,20.0,40.0
31134,3,1134,[  1 144 173 200 546],795,3,4850,4.273127753303965,0.0,0.0
31135,3,1135,[427 603 100 127 191],379,5,4855,4.273767605633803,20.0,40.0
31136,3,1136,[427 603 100 127 191],308,5,4860,4.274406332453826,20.0,40.0
31137,3,1137,[172 257 288 286 245],455,3,4863,4.273286467486819,0.0,0.0
31138,3,1138,[427 603 100 127 191],474,5,4868,4.273924495171203,20.0,40.0
31139,3,1139,[427 603 100 127 191],398,4,4872,4.273684210526316,20.0,40.0
31140,3,1140,[427 603 100 127 191],527,5,4877,4.2743207712532865,20.0,40.0
31141,3,1141,[427 603 100 127 191],474,5,4882,4.274956217162872,20.0,40.0
31142,3,1142,[427 603 100 127 191],568,5,4887,4.275590551181103,20.0,40.0
31143,3,1143,[427 603 100 127 191],90,5,4892,4.276223776223776,20.0,40.0
31144,3,1144,[427 603 100 127 191],90,5,4897,4.2768558951965066,20.0,40.0
31145,3,1145,[423 271 195 742 238],92,2,4899,4.274869109947644,0.0,0.0
31146,3,1146,[427 603 100 127 191],452,5,4904,4.275501307759372,20.0,40.0
31147,3,1147,[427 603 100 127 191],59,5,4909,4.276132404181185,20.0,40.0
31148,3,1148,[427 603 100 127 191],458,5,4914,4.276762402088773,20.0,40.0
31149,3,1149,[427 603 100 127 191],452,5,4919,4.277391304347826,20.0,40.0
31150,3,1150,[427 603 100 127 191],664,4,4923,4.277150304083405,20.0,40.0
31151,3,1151,[427 603 100 127 191],339,5,4928,4.277777777777778,20.0,40.0
31152,3,1152,[427 603 100 127 191],271,5,4933,4.2784041630529055,20.0,40.0
31153,3,1153,[427 603 100 127 191],385,4,4937,4.278162911611785,20.0,40.0
31154,3,1154,[427 603 100 127 191],568,5,4942,4.278787878787878,20.0,40.0
31155,3,1155,[427 603 100 127 191],666,5,4947,4.279411764705882,20.0,40.0
31156,3,1156,[427 603 100 127 191],474,5,4952,4.280034572169404,20.0,40.0
31157,3,1157,[427 603 100 127 191],398,4,4956,4.27979274611399,20.0,40.0
31158,3,1158,[427 603 100 127 191],90,5,4961,4.280414150129422,20.0,40.0
31159,3,1159,[427 603 100 127 191],409,5,4966,4.281034482758621,20.0,40.0
31160,3,1160,[427 603 100 127 191],234,5,4971,4.281653746770026,20.0,40.0
31161,3,1161,[427 603 100 127 191],409,5,4976,4.282271944922547,20.0,40.0
31162,3,1162,[427 603 100 127 191],339,5,4981,4.2828890799656065,20.0,40.0
31163,3,1163,[427 603 100 127 191],59,5,4986,4.283505154639175,20.0,40.0
31164,3,1164,[427 603 100 127 191],474,5,4991,4.28412017167382,20.0,40.0
31165,3,1165,[427 603 100 127 191],14,4,4995,4.283876500857633,20.0,40.0
31166,3,1166,[427 603 100 127 191],568,5,5000,4.284490145672665,20.0,40.0
31167,3,1167,[427 603 100 127 191],694,5,5005,4.285102739726027,20.0,40.0
31168,3,1168,[427 603 100 127 191],14,4,5009,4.284858853721129,20.0,40.0
31169,3,1169,[ 69 168 172 228 135],7,5,5014,4.285470085470085,0.0,0.0
31170,3,1170,[357 153 234 197 405],385,3,5017,4.284372331340735,20.0,0.0
31171,3,1171,[427 603 100 127 191],13,4,5021,4.284129692832765,20.0,40.0
31172,3,1172,[427 603 100 127 191],409,5,5026,4.284739982949701,20.0,40.0
31173,3,1173,[427 603 100 127 191],234,5,5031,4.285349233390119,20.0,40.0
31174,3,1174,[427 603 100 127 191],334,5,5036,4.285957446808511,20.0,40.0
31175,3,1175,[427 603 100 127 191],313,5,5041,4.28656462585034,20.0,40.0
31176,3,1176,[204 176  50 328  70],102,2,5043,4.284621920135939,0.0,20.0
31177,3,1177,[194 186   4 175 204],543,2,5045,4.282682512733446,0.0,0.0
31178,3,1178,[427 603 100 127 191],458,5,5050,4.283290924512299,20.0,40.0
31179,3,1179,[427 603 100 127 191],59,5,5055,4.283898305084746,20.0,40.0
31180,3,1180,[427 603 100 127 191],664,4,5059,4.283657917019475,20.0,40.0
31181,3,1181,[427 603 100 127 191],694,5,5064,4.284263959390863,20.0,40.0
31182,3,1182,[427 603 100 127 191],308,5,5069,4.28486897717667,20.0,40.0
31183,3,1183,[427 603 100 127 191],385,4,5073,4.284628378378378,20.0,40.0
31184,3,1184,[427 603 100 127 191],537,5,5078,4.285232067510549,20.0,40.0
31185,3,1185,[427 603 100 127 191],59,5,5083,4.285834738617201,20.0,40.0
31186,3,1186,[135  12 597 357 194],207,2,5085,4.28390901432182,40.0,0.0
31187,3,1187,[427 603 100 127 191],527,5,5090,4.284511784511785,20.0,40.0
31188,3,1188,[427 603 100 127 191],339,5,5095,4.28511354079058,20.0,40.0
31189,3,1189,[182 301 385  71  89],788,1,5096,4.2823529411764705,0.0,0.0
31190,3,1190,[427 603 100 127 191],650,4,5100,4.282115869017632,20.0,40.0
31191,3,1191,[  9 333   4 282  12],144,4,5104,4.281879194630872,20.0,0.0
31192,3,1192,[111 333 678 515 322],488,3,5107,4.280804694048617,0.0,0.0
31193,3,1193,[427 603 100 127 191],694,5,5112,4.28140703517588,20.0,40.0
31194,3,1194,[427 603 100 127 191],474,5,5117,4.282008368200837,20.0,40.0
31195,3,1195,[427 603 100 127 191],7,5,5122,4.282608695652174,20.0,40.0
31196,3,1196,[427 603 100 127 191],90,5,5127,4.283208020050125,20.0,40.0
31197,3,1197,[427 603 100 127 191],90,5,5132,4.283806343906511,20.0,40.0
31198,3,1198,[427 603 100 127 191],13,4,5136,4.283569641367807,20.0,40.0
31199,3,1199,[427 603 100 127 191],398,4,5140,4.283333333333333,20.0,40.0
31200,3,1200,[121 191 179 173  82],200,5,5145,4.283930058284763,0.0,0.0
31201,3,1201,[427 603 100 127 191],59,5,5150,4.284525790349417,20.0,40.0
31202,3,1202,[427 603 100 127 191],398,4,5154,4.28428927680798,20.0,40.0
31203,3,1203,[427 603 100 127 191],409,5,5159,4.284883720930233,20.0,40.0
31204,3,1204,[289  79 118 405 176],13,1,5160,4.282157676348548,0.0,0.0
31205,3,1205,[204 597 161 111  79],83,3,5163,4.281094527363184,0.0,0.0
31206,3,1206,[427 603 100 127 191],14,4,5167,4.28086164043082,20.0,40.0
31207,3,1207,[427 603 100 127 191],385,4,5171,4.280629139072848,20.0,40.0
31208,3,1208,[427 603 100 127 191],334,5,5176,4.281224152191895,20.0,40.0
31209,3,1209,[427 603 100 127 191],664,4,5180,4.2809917355371905,20.0,40.0
31210,3,1210,[427 603 100 127 191],313,5,5185,4.281585466556565,20.0,40.0
31211,3,1211,[427 603 100 127 191],90,5,5190,4.282178217821782,20.0,40.0
31212,3,1212,[427 603 100 127 191],90,5,5195,4.282769991755977,20.0,40.0
31213,3,1213,[427 603 100 127 191],339,5,5200,4.283360790774299,20.0,40.0
31214,3,1214,[127 405 181 144 174],360,2,5202,4.281481481481482,0.0,40.0
31215,3,1215,[427 603 100 127 191],14,4,5206,4.28125,20.0,40.0
31216,3,1216,[427 603 100 127 191],308,5,5211,4.281840591618734,20.0,40.0
31217,3,1217,[427 603 100 127 191],694,5,5216,4.282430213464696,20.0,40.0
31218,3,1218,[427 603 100 127 191],527,5,5221,4.283018867924528,20.0,40.0
31219,3,1219,[427 603 100 127 191],313,5,5226,4.283606557377049,20.0,40.0
31220,3,1220,[427 603 100 127 191],409,5,5231,4.284193284193284,20.0,40.0
31221,3,1221,[427 603 100 127 191],379,5,5236,4.284779050736497,20.0,40.0
31222,3,1222,[427 603 100 127 191],334,5,5241,4.285363859362224,20.0,40.0
31223,3,1223,[427 603 100 127 191],334,5,5246,4.2859477124183005,20.0,40.0
31224,3,1224,[427 603 100 127 191],59,5,5251,4.286530612244898,20.0,40.0
31225,3,1225,[427 603 100 127 191],13,4,5255,4.286296900489396,20.0,40.0
31226,3,1226,[427 603 100 127 191],398,4,5259,4.286063569682152,20.0,40.0
31227,3,1227,[427 603 100 127 191],379,5,5264,4.286644951140065,20.0,40.0
31228,3,1228,[427 603 100 127 191],271,5,5269,4.287225386493084,20.0,40.0
31229,3,1229,[427 603 100 127 191],313,5,5274,4.287804878048781,20.0,40.0
31230,3,1230,[237 333 508 471  56],144,4,5278,4.2875710804224205,0.0,0.0
31231,3,1231,[427 603 100 127 191],334,5,5283,4.28814935064935,20.0,40.0
31232,3,1232,[427 603 100 127 191],334,5,5288,4.288726682887267,20.0,40.0
31233,3,1233,[427 603 100 127 191],666,5,5293,4.289303079416531,20.0,40.0
31234,3,1234,[427 603 100 127 191],650,4,5297,4.289068825910931,20.0,40.0
31235,3,1235,[427 603 100 127 191],339,5,5302,4.289644012944984,20.0,40.0
31236,3,1236,[427 603 100 127 191],385,4,5306,4.289409862570736,20.0,40.0
31237,3,1237,[427 603 100 127 191],664,4,5310,4.289176090468498,20.0,40.0
31238,3,1238,[427 603 100 127 191],533,5,5315,4.289749798224374,20.0,40.0
31239,3,1239,[427 603 100 127 191],379,5,5320,4.290322580645161,20.0,40.0
31240,3,1240,[427 603 100 127 191],271,5,5325,4.290894439967768,20.0,40.0
31241,3,1241,[427 603 100 127 191],13,4,5329,4.290660225442834,20.0,40.0
31242,3,1242,[427 603 100 127 191],568,5,5334,4.2912308930008045,20.0,40.0
31243,3,1243,[288  82 200   4  11],7,3,5337,4.290192926045016,0.0,0.0
31244,3,1244,[427 603 100 127 191],234,5,5342,4.290763052208836,20.0,40.0
31245,3,1245,[427 603 100 127 191],379,5,5347,4.291332263242376,20.0,40.0
31246,3,1246,[427 603 100 127 191],474,5,5352,4.291900561347234,20.0,40.0
31247,3,1247,[427 603 100 127 191],409,5,5357,4.292467948717949,20.0,40.0
31248,3,1248,[427 603 100 127 191],379,5,5362,4.293034427542033,20.0,40.0
31249,3,1249,[427 603 100 127 191],379,5,5367,4.2936,20.0,40.0
31250,3,1250,[427 603 100 127 191],409,5,5372,4.294164668265387,20.0,40.0
31251,3,1251,[117 174 121 144  71],275,2,5374,4.292332268370607,0.0,20.0
31252,3,1252,[427 603 100 127 191],474,5,5379,4.292897047086991,20.0,40.0
31253,3,1253,[153 515  50  25 655],406,1,5380,4.290271132376396,0.0,20.0
31254,3,1254,[427 603 100 127 191],527,5,5385,4.290836653386454,20.0,40.0
31255,3,1255,[333 588 180 176 357],387,2,5387,4.289012738853503,20.0,0.0
31256,3,1256,[ 56 168 200  22 385],537,2,5389,4.287191726332538,0.0,0.0
31257,3,1257,[427 603 100 127 191],537,5,5394,4.287758346581876,20.0,40.0
31258,3,1258,[427 603 100 127 191],398,4,5398,4.287529785544082,20.0,40.0
31259,3,1259,[427 603 100 127 191],7,5,5403,4.288095238095238,20.0,40.0
31260,3,1260,[427 603 100 127 191],568,5,5408,4.288659793814433,20.0,40.0
31261,3,1261,[427 603 100 127 191],694,5,5413,4.289223454833597,20.0,40.0
31262,3,1262,[427 603 100 127 191],568,5,5418,4.289786223277909,20.0,40.0
31263,3,1263,[427 603 100 127 191],379,5,5423,4.290348101265823,20.0,40.0
31264,3,1264,[427 603 100 127 191],271,5,5428,4.290909090909091,20.0,40.0
31265,3,1265,[204 168   8 603 216],398,3,5431,4.289889415481833,20.0,0.0
31266,3,1266,[427 603 100 127 191],568,5,5436,4.290449881610103,20.0,40.0
31267,3,1267,[427 603 100 127 191],666,5,5441,4.291009463722397,20.0,40.0
31268,3,1268,[427 603 100 127 191],409,5,5446,4.29156816390859,20.0,40.0
31269,3,1269,[  4   8 275  11  12],64,4,5450,4.291338582677166,20.0,0.0
31270,3,1270,[427 603 100 127 191],666,5,5455,4.291896144767899,20.0,40.0
31271,3,1271,[427 603 100 127 191],313,5,5460,4.2924528301886795,20.0,40.0
31272,3,1272,[427 603 100 127 191],458,5,5465,4.293008641005499,20.0,40.0
31273,3,1273,[427 603 100 127 191],379,5,5470,4.293563579277865,20.0,40.0
31274,3,1274,[427 603 100 127 191],308,5,5475,4.294117647058823,20.0,40.0
31275,3,1275,[427 603 100 127 191],308,5,5480,4.294670846394984,20.0,40.0
31276,3,1276,[427 603 100 127 191],14,4,5484,4.294440093970243,20.0,40.0
31277,3,1277,[183 302 153  12  22],13,5,5489,4.294992175273865,20.0,0.0
31278,3,1278,[427 603 100 127 191],664,4,5493,4.294761532447224,20.0,40.0
31279,3,1279,[427 603 100 127 191],694,5,5498,4.2953125,20.0,40.0
31280,3,1280,[427 603 100 127 191],409,5,5503,4.295862607338017,20.0,40.0
31281,3,1281,[  8 234 181 191 132],378,5,5508,4.296411856474259,0.0,0.0
31282,3,1282,[427 603 100 127 191],313,5,5513,4.296960249415433,20.0,40.0
31283,3,1283,[427 603 100 127 191],13,4,5517,4.296728971962617,20.0,40.0
31284,3,1284,[427 603 100 127 191],537,5,5522,4.2972762645914395,20.0,40.0
31285,3,1285,[427 603 100 127 191],339,5,5527,4.297822706065319,20.0,40.0
31286,3,1286,[427 603 100 127 191],474,5,5532,4.298368298368298,20.0,40.0
31287,3,1287,[427 603 100 127 191],533,5,5537,4.298913043478261,20.0,40.0
31288,3,1288,[427 603 100 127 191],13,4,5541,4.298681148176882,20.0,40.0
31289,3,1289,[427 603 100 127 191],313,5,5546,4.299224806201551,20.0,40.0
31290,3,1290,[427 603 100 127 191],271,5,5551,4.299767621998451,20.0,40.0
31291,3,1291,[427 603 100 127 191],385,4,5555,4.29953560371517,20.0,40.0
31292,3,1292,[603 597 215 132 294],533,4,5559,4.299303944315545,20.0,0.0
31293,3,1293,[427 603 100 127 191],533,5,5564,4.2998454404945905,20.0,40.0
31294,3,1294,[427 603 100 127 191],409,5,5569,4.300386100386101,20.0,40.0
31295,3,1295,[301 357 385 237 144],788,3,5572,4.299382716049383,20.0,0.0
31296,3,1296,[144 143 191 323 245],804,4,5576,4.299151888974556,0.0,0.0
31297,3,1297,[161  79 185 153 655],13,3,5579,4.298151001540832,0.0,0.0
31298,3,1298,[427 603 100 127 191],379,5,5584,4.29869130100077,20.0,40.0
31299,3,1299,[427 603 100 127 191],334,5,5589,4.299230769230769,20.0,40.0
31300,3,1300,[427 603 100 127 191],59,5,5594,4.299769408147578,20.0,40.0
31301,3,1301,[222 121 275 282  98],533,5,5599,4.300307219662058,0.0,20.0
31302,3,1302,[427 603 100 127 191],308,5,5604,4.300844205679202,20.0,40.0
31303,3,1303,[427 603 100 127 191],234,5,5609,4.30138036809816,20.0,40.0
31304,3,1304,[186  22 161 132 471],313,3,5612,4.3003831417624525,0.0,0.0
31305,3,1305,[508  12 678 187 186],474,3,5615,4.299387442572741,20.0,0.0
31306,3,1306,[427 603 100 127 191],59,5,5620,4.2999234889058915,20.0,40.0
31307,3,1307,[427 603 100 127 191],458,5,5625,4.3004587155963305,20.0,40.0
31308,3,1308,[427 603 100 127 191],385,4,5629,4.3002291825821235,20.0,40.0
31309,3,1309,[427 603 100 127 191],313,5,5634,4.300763358778626,20.0,40.0
31310,3,1310,[ 70 275 179 475 318],90,4,5638,4.300533943554538,20.0,0.0
31311,3,1311,[427 603 100 127 191],385,4,5642,4.300304878048781,20.0,40.0
31312,3,1312,[204 515   9 121 125],334,3,5645,4.299314546839299,0.0,0.0
31313,3,1313,[427 603 100 127 191],13,4,5649,4.299086757990867,20.0,40.0
31314,3,1314,[427 603 100 127 357],313,5,5654,4.299619771863118,40.0,40.0
31315,3,1315,[427 603 100 127 357],308,5,5659,4.300151975683891,40.0,40.0
31316,3,1316,[427 603 100 127 357],90,5,5664,4.300683371298406,40.0,40.0
31317,3,1317,[427 603 100 127 357],379,5,5669,4.301213960546282,40.0,40.0
31318,3,1318,[427 603 100 127 357],308,5,5674,4.301743745261562,40.0,40.0
31319,3,1319,[427 603 100 127 357],90,5,5679,4.302272727272728,40.0,40.0
31320,3,1320,[427 603 100 127 357],13,4,5683,4.302043906131718,40.0,40.0
31321,3,1321,[427 603 100 127 191],474,5,5688,4.302571860816944,20.0,40.0
31322,3,1322,[427 597  64 196 423],374,2,5690,4.300831443688587,0.0,0.0
31323,3,1323,[427 603 100 127 191],313,5,5695,4.301359516616314,20.0,40.0
31324,3,1324,[427 603 100 127 191],398,4,5699,4.301132075471698,20.0,40.0
31325,3,1325,[427 603 100 127 191],458,5,5704,4.301659125188537,20.0,40.0
31326,3,1326,[234 168 180 333  98],263,4,5708,4.301431801055012,0.0,20.0
31327,3,1327,[427 603 100 127 191],694,5,5713,4.301957831325301,20.0,40.0
31328,3,1328,[427 603 100 127 191],533,5,5718,4.302483069977427,20.0,40.0
31329,3,1329,[427 603 100 127 191],452,5,5723,4.303007518796992,20.0,40.0
31330,3,1330,[427 603 100 127 191],13,4,5727,4.302779864763336,20.0,40.0
31331,3,1331,[427 603 100 127 191],527,5,5732,4.303303303303303,20.0,40.0
31332,3,1332,[568  50 183 403 135],650,3,5735,4.3023255813953485,0.0,20.0
31333,3,1333,[427 603 100 127 191],452,5,5740,4.302848575712144,20.0,40.0
31334,3,1334,[427 603 100 127 191],271,5,5745,4.303370786516854,20.0,40.0
31335,3,1335,[197 603 322 423 483],749,5,5750,4.303892215568863,40.0,0.0
31336,3,1336,[427 603 100 127 191],385,4,5754,4.303664921465969,20.0,40.0
31337,3,1337,[427 603 100 127 191],398,4,5758,4.303437967115097,20.0,40.0
31338,3,1338,[111 313 271 191 174],13,3,5761,4.3024645257654965,0.0,20.0
31339,3,1339,[ 69 191 196 238 194],318,3,5764,4.3014925373134325,0.0,0.0
31340,3,1340,[427 603 100 127 191],409,5,5769,4.302013422818792,20.0,40.0
31341,3,1341,[427 603 100 127 191],379,5,5774,4.302533532041728,20.0,40.0
31342,3,1342,[427 603 100 127 191],308,5,5779,4.303052866716307,20.0,40.0
31343,3,1343,[427 603 100 127 191],527,5,5784,4.303571428571429,20.0,40.0
31344,3,1344,[427 603 100 127 191],398,4,5788,4.3033457249070635,20.0,40.0
31345,3,1345,[427 603 100 127 191],308,5,5793,4.303863298662704,20.0,40.0
31346,3,1346,[427 603 100 127 191],385,4,5797,4.303637713437268,20.0,40.0
31347,3,1347,[427 603 100 127 191],650,4,5801,4.303412462908012,20.0,40.0
31348,3,1348,[427 603 100 127 191],313,5,5806,4.303928836174944,20.0,40.0
31349,3,1349,[427 603 100 127 191],334,5,5811,4.304444444444444,20.0,40.0
31350,3,1350,[427 603 100 127 191],13,4,5815,4.304219096965211,20.0,40.0
31351,3,1351,[427 603 100 127 191],234,5,5820,4.304733727810651,20.0,40.0
31352,3,1352,[238 318 742 202  95],92,1,5821,4.3022912047302295,20.0,0.0
31353,3,1353,[427 603 100 127 191],458,5,5826,4.302806499261448,20.0,40.0
31354,3,1354,[427 603 100 127 191],334,5,5831,4.303321033210332,20.0,40.0
31355,3,1355,[427 603 100 127 191],664,4,5835,4.303097345132743,20.0,40.0
31356,3,1356,[427 603 100 127 191],90,5,5840,4.303610906411201,20.0,40.0
31357,3,1357,[427 603 100 127 191],379,5,5845,4.304123711340206,20.0,40.0
31358,3,1358,[427 603 100 127 191],527,5,5850,4.304635761589404,20.0,40.0
31359,3,1359,[427 603 100 127 191],90,5,5855,4.305147058823529,20.0,40.0
31360,3,1360,[427 603 100 127 191],537,5,5860,4.305657604702425,20.0,40.0
31361,3,1361,[427 603 100 127 191],533,5,5865,4.3061674008810575,20.0,40.0
31362,3,1362,[427 603 100 127 191],385,4,5869,4.305942773294204,20.0,40.0
31363,3,1363,[427 603 100 127 191],409,5,5874,4.306451612903226,20.0,40.0
31364,3,1364,[173 127 197 403 168],210,5,5879,4.306959706959707,0.0,20.0
31365,3,1365,[427 603 100 127 191],568,5,5884,4.307467057101025,20.0,40.0
31366,3,1366,[427 603 100 127 191],7,5,5889,4.307973664959766,20.0,40.0
31367,3,1367,[427 603 100 127 191],13,4,5893,4.307748538011696,20.0,40.0
31368,3,1368,[427 603 100 127 191],398,4,5897,4.3075237399561725,20.0,40.0
31369,3,1369,[427 603 100 127 191],334,5,5902,4.308029197080292,20.0,40.0
31370,3,1370,[427 603 100 127 191],537,5,5907,4.308533916849015,20.0,40.0
31371,3,1371,[427 603 100 127 191],385,4,5911,4.308309037900875,20.0,40.0
31372,3,1372,[427 603 100 127 191],385,4,5915,4.308084486525856,20.0,40.0
31373,3,1373,[427 603 100 127 357],90,5,5920,4.308588064046579,40.0,40.0
31374,3,1374,[427 603 100 127 357],398,4,5924,4.308363636363636,40.0,40.0
31375,3,1375,[427 603 100 127 357],474,5,5929,4.308866279069767,40.0,40.0
31376,3,1376,[427 603 100 127 357],13,4,5933,4.308641975308642,40.0,40.0
31377,3,1377,[427 603 100 127 204],666,4,5937,4.3084179970972425,20.0,40.0
31378,3,1378,[427 603 100 127 191],650,4,5941,4.3081943437273384,20.0,40.0
31379,3,1379,[181  89   4 215 678],13,4,5945,4.307971014492754,0.0,0.0
31380,3,1380,[427 603 100 127 191],568,5,5950,4.308472121650977,20.0,40.0
31381,3,1381,[427 603 100 127 191],271,5,5955,4.308972503617945,20.0,40.0
31382,3,1382,[427 603 100 127 191],234,5,5960,4.309472161966739,20.0,40.0
31383,3,1383,[427 603 100 127 191],527,5,5965,4.309971098265896,20.0,40.0
31384,3,1384,[427 603 100 127 191],452,5,5970,4.310469314079422,20.0,40.0
31385,3,1385,[ 82 200 180  79 655],378,3,5973,4.309523809523809,0.0,0.0
31386,3,1386,[427 603 100 127 191],650,4,5977,4.3093006488824805,20.0,40.0
31387,3,1387,[427 603 100 127 191],527,5,5982,4.3097982708933715,20.0,40.0
31388,3,1388,[427 603 100 127 191],527,5,5987,4.310295176385889,20.0,40.0
31389,3,1389,[427 603 100 127 191],568,5,5992,4.310791366906475,20.0,40.0
31390,3,1390,[132   4 153 100 423],295,5,5997,4.311286843997125,0.0,20.0
31391,3,1391,[427 603 100 127 191],568,5,6002,4.311781609195402,20.0,40.0
31392,3,1392,[427 603 100 127 191],308,5,6007,4.312275664034458,20.0,40.0
31393,3,1393,[427 603 100 127 191],409,5,6012,4.312769010043041,20.0,40.0
31394,3,1394,[427 603 100 127 191],409,5,6017,4.313261648745519,20.0,40.0
31395,3,1395,[427 603 100 127 191],308,5,6022,4.313753581661891,20.0,40.0
31396,3,1396,[427 603 100 127 191],533,5,6027,4.314244810307803,20.0,40.0
31397,3,1397,[427 603 100 127 191],308,5,6032,4.3147353361945635,20.0,40.0
31398,3,1398,[427 603 100 127 191],664,4,6036,4.314510364546105,20.0,40.0
31399,3,1399,[427 603 100 127 191],90,5,6041,4.315,20.0,40.0
31400,3,1400,[427 603 100 127 191],13,4,6045,4.314775160599572,20.0,40.0
31401,3,1401,[427 603 100 127 191],409,5,6050,4.315263908701854,20.0,40.0
31402,3,1402,[427 603 100 127 191],90,5,6055,4.315751960085531,20.0,40.0
31403,3,1403,[427 603 100 127 191],650,4,6059,4.315527065527066,20.0,40.0
31404,3,1404,[135 603 435 191 289],90,4,6063,4.3153024911032025,20.0,0.0
31405,3,1405,[427 603 100 127 191],7,5,6068,4.315789473684211,20.0,40.0
31406,3,1406,[427 603 100 127 191],568,5,6073,4.316275764036958,20.0,40.0
31407,3,1407,[427 603 100 127 191],90,5,6078,4.316761363636363,20.0,40.0
31408,3,1408,[427 603 100 127 191],13,4,6082,4.31653655074521,20.0,40.0
31409,3,1409,[427 603 100 127 191],666,5,6087,4.317021276595745,20.0,40.0
31410,3,1410,[313 289 181 238 405],92,3,6090,4.316087880935506,0.0,0.0
31411,3,1411,[427 603 100 127 191],385,4,6094,4.31586402266289,20.0,40.0
31412,3,1412,[427 603 100 127 181],339,5,6099,4.316348195329087,20.0,40.0
31413,3,1413,[427 603 100 127 181],339,5,6104,4.316831683168317,20.0,40.0
31414,3,1414,[427 603 100 127 181],452,5,6109,4.317314487632509,20.0,40.0
31415,3,1415,[597 496 286 204 174],452,4,6113,4.317090395480226,0.0,20.0
31416,3,1416,[427 603 100 127 181],59,5,6118,4.31757233592096,20.0,40.0
31417,3,1417,[427 603 100 127 181],398,4,6122,4.317348377997179,20.0,40.0
31418,3,1418,[427 603 100 127 181],339,5,6127,4.317829457364341,20.0,40.0
31419,3,1419,[427 603 100 127 181],334,5,6132,4.31830985915493,20.0,40.0
31420,3,1420,[427 603 100 127 181],452,5,6137,4.318789584799437,20.0,40.0
31421,3,1421,[427 603 100 127 181],537,4,6141,4.318565400843882,20.0,40.0
31422,3,1422,[427 603 100 127 181],694,5,6146,4.319044272663387,20.0,40.0
31423,3,1423,[427 603 100 127 181],271,5,6151,4.319522471910112,20.0,40.0
31424,3,1424,[427 603 100 127 181],339,5,6156,4.32,20.0,40.0
31425,3,1425,[427 603 100 127 181],334,5,6161,4.320476858345021,20.0,40.0
31426,3,1426,[427 603 100 127 181],745,3,6164,4.319551506657323,20.0,40.0
31427,3,1427,[427 603 100 127 191],234,5,6169,4.3200280112044815,20.0,40.0
31428,3,1428,[427 603 100 127 191],409,5,6174,4.320503848845346,20.0,40.0
31429,3,1429,[427 603 100 127 191],452,5,6179,4.320979020979021,20.0,40.0
31430,3,1430,[427 603 100 127 191],694,5,6184,4.321453529000699,20.0,40.0
31431,3,1431,[427 603 100 127 191],13,4,6188,4.32122905027933,20.0,40.0
31432,3,1432,[427 603 100 127 191],537,5,6193,4.321702721563154,20.0,40.0
31433,3,1433,[427 603 100 127 191],385,4,6197,4.321478382147839,20.0,40.0
31434,3,1434,[427 603 100 127 191],537,5,6202,4.321951219512195,20.0,40.0
31435,3,1435,[427 603 100 127 191],14,4,6206,4.321727019498607,20.0,40.0
31436,3,1436,[427 603 100 127 191],90,5,6211,4.322199025748087,20.0,40.0
31437,3,1437,[427 603 100 127 191],452,5,6216,4.322670375521557,20.0,40.0
31438,3,1438,[427 603 100 127 191],334,5,6221,4.3231410701876305,20.0,40.0
31439,3,1439,[427 603 100 127 191],7,5,6226,4.323611111111111,20.0,40.0
31440,3,1440,[238 265 100 245 357],313,4,6230,4.3233865371269955,20.0,20.0
31441,3,1441,[427 603 100 127 191],664,4,6234,4.323162274618586,20.0,40.0
31442,3,1442,[427 603 100 127 191],271,5,6239,4.323631323631323,20.0,40.0
31443,3,1443,[427 603 100 127 191],234,5,6244,4.32409972299169,20.0,40.0
31444,3,1444,[427 603 100 127 191],379,5,6249,4.324567474048443,20.0,40.0
31445,3,1445,[427 603 100 127 191],339,5,6254,4.325034578146611,20.0,40.0
31446,3,1446,[427 603 100 127 191],334,5,6259,4.3255010366275055,20.0,40.0
31447,3,1447,[427 603 100 127 191],7,5,6264,4.3259668508287294,20.0,40.0
31448,3,1448,[427 603 100 127 191],13,4,6268,4.325741890959282,20.0,40.0
31449,3,1449,[427 603 100 127 191],59,5,6273,4.326206896551724,20.0,40.0
31450,3,1450,[269 237 234  11 174],537,0,6273,4.323225361819435,0.0,20.0
31451,3,1451,[427 603 100 127 191],398,4,6277,4.323002754820936,20.0,40.0
31452,3,1452,[427 603 100 127 191],7,5,6282,4.32346868547832,20.0,40.0
31453,3,1453,[427 603 100 127 191],452,5,6287,4.323933975240715,20.0,40.0
31454,3,1454,[427 603 100 127 191],385,4,6291,4.323711340206185,20.0,40.0
31455,3,1455,[427 603 100 127 191],458,5,6296,4.324175824175824,20.0,40.0
31456,3,1456,[ 96 216 135 655 168],479,4,6300,4.323953328757721,0.0,0.0
31457,3,1457,[427 603 100 127 191],474,5,6305,4.324417009602195,20.0,40.0
31458,3,1458,[427 603 100 127 191],666,5,6310,4.324880054832077,20.0,40.0
31459,3,1459,[427 603 100 127 191],14,4,6314,4.324657534246575,20.0,40.0
31460,3,1460,[427 603 100 127 191],568,5,6319,4.325119780971937,20.0,40.0
31461,3,1461,[427 603 100 127 191],14,4,6323,4.324897400820793,20.0,40.0
31462,3,1462,[427 603 100 127 191],458,5,6328,4.3253588516746415,20.0,40.0
31463,3,1463,[427 603 100 127 191],650,4,6332,4.325136612021858,20.0,40.0
31464,3,1464,[427 603 100 127 191],379,5,6337,4.3255972696245735,20.0,40.0
31465,3,1465,[427 603 100 127 191],664,4,6341,4.32537517053206,20.0,40.0
31466,3,1466,[427 603 100 127 191],334,5,6346,4.325835037491479,20.0,40.0
31467,3,1467,[427 603 100 127 191],664,4,6350,4.325613079019074,20.0,40.0
31468,3,1468,[185  96 187 318 117],479,4,6354,4.325391422736556,20.0,0.0
31469,3,1469,[427 603 100 127 191],452,5,6359,4.325850340136054,20.0,40.0
31470,3,1470,[427 603 100 127 191],14,4,6363,4.3256288239293,20.0,40.0
31471,3,1471,[427 603 100 127 191],313,5,6368,4.326086956521739,20.0,40.0
31472,3,1472,[427 603 100 127 191],90,5,6373,4.326544467073998,20.0,40.0
31473,3,1473,[427 603 100 127 191],452,5,6378,4.3270013568521035,20.0,40.0
31474,3,1474,[427 603 100 127 191],234,5,6383,4.327457627118644,20.0,40.0
31475,3,1475,[427 603 100 127 191],271,5,6388,4.327913279132791,20.0,40.0
31476,3,1476,[427 603 100 127 191],527,5,6393,4.328368314150305,20.0,40.0
31477,3,1477,[427 603 100 127 191],59,5,6398,4.328822733423546,20.0,40.0
31478,3,1478,[427 603 100 127 191],59,5,6403,4.329276538201487,20.0,40.0
31479,3,1479,[427 603 100 127 191],664,4,6407,4.329054054054054,20.0,40.0
31480,3,1480,[427 603 100 127 191],568,5,6412,4.329507089804187,20.0,40.0
31481,3,1481,[427 603 100 127 191],59,5,6417,4.32995951417004,20.0,40.0
31482,3,1482,[427 603 100 127 191],379,5,6422,4.330411328388402,20.0,40.0
31483,3,1483,[427 603 100 127 191],666,5,6427,4.330862533692723,20.0,40.0
31484,3,1484,[427 603 100 127 191],458,5,6432,4.331313131313132,20.0,40.0
31485,3,1485,[ 50 117 427  28  97],536,4,6436,4.331090174966353,0.0,20.0
31486,3,1486,[427 603 100 127 191],90,5,6441,4.331540013449899,20.0,40.0
31487,3,1487,[427 603 100 127 191],694,5,6446,4.331989247311828,20.0,40.0
31488,3,1488,[427 603 100 127 191],409,5,6451,4.332437877770316,20.0,40.0
31489,3,1489,[286  64 111 238 216],271,5,6456,4.332885906040269,0.0,0.0
31490,3,1490,[313 176 135 597 238],13,2,6458,4.331321260898726,0.0,0.0
31491,3,1491,[427 603 100 127 191],537,5,6463,4.331769436997319,20.0,40.0
31492,3,1492,[427 603 100 127 191],385,4,6467,4.331547220361688,20.0,40.0
31493,3,1493,[655  50  89 196 748],13,5,6472,4.331994645247657,0.0,20.0
31494,3,1494,[258 117 132 183 121],13,4,6476,4.331772575250836,0.0,0.0
31495,3,1495,[427 603 100 127 191],234,5,6481,4.332219251336898,20.0,40.0
31496,3,1496,[427 603 100 127 191],533,5,6486,4.332665330661323,20.0,40.0
31497,3,1497,[427 603 100 127 191],458,5,6491,4.333110814419226,20.0,40.0
31498,3,1498,[174 235 313  79  50],650,3,6494,4.332221480987325,0.0,40.0
31499,3,1499,[427 603 100 127 191],59,5,6499,4.332666666666666,20.0,40.0
31500,3,1500,[427 603 100 127 191],664,4,6503,4.3324450366422385,20.0,40.0
31501,3,1501,[427 603 100 127 191],537,5,6508,4.33288948069241,20.0,40.0
31502,3,1502,[427 603 100 127 191],7,5,6513,4.333333333333333,20.0,40.0
31503,3,1503,[427 603 100 127 191],409,5,6518,4.3337765957446805,20.0,40.0
31504,3,1504,[427 603 100 127 191],409,5,6523,4.33421926910299,20.0,40.0
31505,3,1505,[427 258 301 515  12],666,5,6528,4.334661354581673,20.0,0.0
31506,3,1506,[282  71 195   7 265],804,5,6533,4.335102853351029,0.0,0.0
31507,3,1507,[427 603 100 127 282],334,5,6538,4.335543766578249,20.0,40.0
31508,3,1508,[186 111 181   9 121],271,4,6542,4.33532140490391,0.0,0.0
31509,3,1509,[427 603 100 127 282],334,5,6547,4.335761589403973,20.0,40.0
31510,3,1510,[185 282 197  79 100],406,3,6550,4.334877564526804,0.0,20.0
31511,3,1511,[135 176 200 748 197],488,3,6553,4.333994708994709,0.0,0.0
31512,3,1512,[427 603 100 127 181],458,4,6557,4.333773959021811,20.0,40.0
31513,3,1513,[427 603 100 127 191],385,4,6561,4.333553500660502,20.0,40.0
31514,3,1514,[427 603 100 127 191],13,4,6565,4.333333333333333,20.0,40.0
31515,3,1515,[427 603 100 127 191],308,5,6570,4.33377308707124,20.0,40.0
31516,3,1516,[427 603 100 127 191],650,4,6574,4.333553065260382,20.0,40.0
31517,3,1517,[427 603 100 127 191],385,4,6578,4.333333333333333,20.0,40.0
31518,3,1518,[427 603 100 127 191],666,5,6583,4.333772218564845,20.0,40.0
31519,3,1519,[427 603 100 127 191],313,5,6588,4.33421052631579,20.0,40.0
31520,3,1520,[427 603 100 127 191],7,5,6593,4.33464825772518,20.0,40.0
31521,3,1521,[427 603 100 127 191],458,5,6598,4.335085413929041,20.0,40.0
31522,3,1522,[427 603 100 127 191],313,5,6603,4.3355219960604074,20.0,40.0
31523,3,1523,[385 333  11 121 173],64,3,6606,4.334645669291339,0.0,0.0
31524,3,1524,[427 603 100 127 191],537,5,6611,4.335081967213115,20.0,40.0
31525,3,1525,[427 603 100 127 191],694,5,6616,4.335517693315858,20.0,40.0
31526,3,1526,[427 603 100 127 191],90,5,6621,4.335952848722986,20.0,40.0
31527,3,1527,[427 603 100 127 191],650,4,6625,4.335732984293194,20.0,40.0
31528,3,1528,[427 603 100 127 191],271,5,6630,4.336167429692609,20.0,40.0
31529,3,1529,[427 603 100 127 191],90,5,6635,4.336601307189542,20.0,40.0
31530,3,1530,[427 603 100 127 191],339,5,6640,4.3370346178968,20.0,40.0
31531,3,1531,[427 603 100 127 191],385,4,6644,4.336814621409921,20.0,40.0
31532,3,1532,[427 603 100 127 191],385,4,6648,4.336594911937378,20.0,40.0
31533,3,1533,[179 183 161  50  82],648,4,6652,4.336375488917862,0.0,20.0
31534,3,1534,[427 603 100 127 191],13,4,6656,4.336156351791531,20.0,40.0
31535,3,1535,[427 603 100 127   1],533,5,6661,4.336588541666667,20.0,40.0
31536,3,1536,[427 603 100 127   1],308,5,6666,4.337020169160703,20.0,40.0
31537,3,1537,[174 435 423 168  79],648,5,6671,4.337451235370612,0.0,20.0
31538,3,1538,[427 603 100 127   1],664,5,6676,4.337881741390514,20.0,40.0
31539,3,1539,[568 234   9 300 496],311,5,6681,4.338311688311689,0.0,0.0
31540,3,1540,[182 197 273 603 186],7,4,6685,4.338092147955873,20.0,0.0
31541,3,1541,[121 175 168  98 182],650,3,6688,4.337224383916991,0.0,20.0
31542,3,1542,[427 603 100 127   1],745,3,6691,4.336357744653273,20.0,40.0
31543,3,1543,[427 603 100 127 191],339,5,6696,4.33678756476684,20.0,40.0
31544,3,1544,[427 603 100 127 191],664,4,6700,4.336569579288026,20.0,40.0
31545,3,1545,[427 603 100 127 191],694,5,6705,4.336998706338939,20.0,40.0
31546,3,1546,[427 603 100 127 191],568,5,6710,4.337427278603749,20.0,40.0
31547,3,1547,[427 603 100 127 191],339,5,6715,4.337855297157622,20.0,40.0
31548,3,1548,[204  64 546  12   9],378,4,6719,4.337637185280826,20.0,0.0
31549,3,1549,[427 603 100 127 191],59,5,6724,4.338064516129032,20.0,40.0
31550,3,1550,[427 603 100 127 191],474,5,6729,4.338491295938105,20.0,40.0
31551,3,1551,[427 603 100 127 191],339,5,6734,4.338917525773196,20.0,40.0
31552,3,1552,[427 603 100 127 191],308,5,6739,4.339343206696716,20.0,40.0
31553,3,1553,[427 603 100 127 191],313,5,6744,4.33976833976834,20.0,40.0
31554,3,1554,[427 603 100 127 191],452,5,6749,4.340192926045016,20.0,40.0
31555,3,1555,[427 603 100 127 191],650,4,6753,4.339974293059126,20.0,40.0
31556,3,1556,[427 603 100 127 191],14,4,6757,4.33975594091201,20.0,40.0
31557,3,1557,[427 603 100 127 191],650,4,6761,4.339537869062901,20.0,40.0
31558,3,1558,[427 603 100 127 191],458,5,6766,4.339961513790891,20.0,40.0
31559,3,1559,[427 603 100 127 191],664,4,6770,4.339743589743589,20.0,40.0
31560,3,1560,[427 603 100 127 191],666,5,6775,4.340166559897502,20.0,40.0
31561,3,1561,[427 603 100 127 191],59,5,6780,4.340588988476313,20.0,40.0
31562,3,1562,[427 603 100 127 191],409,5,6785,4.341010876519514,20.0,40.0
31563,3,1563,[483 127 197 289 286],488,1,6786,4.338874680306906,20.0,20.0
31564,3,1564,[210 194 174 515 183],843,2,6788,4.337380191693291,0.0,20.0
31565,3,1565,[161 197 215 216 196],311,5,6793,4.3378033205619415,0.0,0.0
31566,3,1566,[427 603 100 127 191],527,5,6798,4.3382259093809825,20.0,40.0
31567,3,1567,[427 603 100 127 191],313,5,6803,4.338647959183674,20.0,40.0
31568,3,1568,[427 603 100 127 191],13,4,6807,4.338432122370937,20.0,40.0
31569,3,1569,[427 603 100 127 191],271,5,6812,4.338853503184714,20.0,40.0
31570,3,1570,[427 603 100 127 191],234,5,6817,4.339274347549332,20.0,40.0
31571,3,1571,[427 603 100 127 191],313,5,6822,4.3396946564885495,20.0,40.0
31572,3,1572,[427 603 100 127 191],385,4,6826,4.339478703115066,20.0,40.0
31573,3,1573,[427 603 100 127 191],90,5,6831,4.33989834815756,20.0,40.0
31574,3,1574,[427 603 100 127 191],474,5,6836,4.34031746031746,20.0,40.0
31575,3,1575,[427 603 100 127 191],339,5,6841,4.340736040609137,20.0,40.0
31576,3,1576,[427 603 100 127 191],271,5,6846,4.341154090044388,20.0,40.0
31577,3,1577,[427 603 100 127 191],59,5,6851,4.341571609632446,20.0,40.0
31578,3,1578,[427 603 100 127 191],334,5,6856,4.341988600379987,20.0,40.0
31579,3,1579,[427 603 100 127 191],664,4,6860,4.341772151898734,20.0,40.0
31580,3,1580,[210 204 151 238 179],215,3,6863,4.340923466160658,0.0,0.0
31581,3,1581,[427 603 100 127 191],379,5,6868,4.34134007585335,20.0,40.0
31582,3,1582,[427 603 100 127 191],474,5,6873,4.341756159191409,20.0,40.0
31583,3,1583,[427 603 100 127 191],568,5,6878,4.342171717171717,20.0,40.0
31584,3,1584,[427 603 100 127 191],7,5,6883,4.3425867507886435,20.0,40.0
31585,3,1585,[427 603 100 127 191],7,5,6888,4.343001261034048,20.0,40.0
31586,3,1586,[427 603 100 127 191],313,5,6893,4.343415248897291,20.0,40.0
31587,3,1587,[161   7 423 117 215],378,4,6897,4.343198992443325,0.0,0.0
31588,3,1588,[427 603 100 127 191],385,4,6901,4.342983008181246,20.0,40.0
31589,3,1589,[427 603 100 127 191],334,5,6906,4.343396226415094,20.0,40.0
31590,3,1590,[427 603 100 127 191],533,5,6911,4.343808925204274,20.0,40.0
31591,3,1591,[427 603 100 127 191],7,5,6916,4.344221105527638,20.0,40.0
31592,3,1592,[427 603 100 127 191],334,5,6921,4.344632768361582,20.0,40.0
31593,3,1593,[427 603 100 127 191],385,4,6925,4.344416562107905,20.0,40.0
31594,3,1594,[427 603 100 127 191],7,5,6930,4.344827586206897,20.0,40.0
31595,3,1595,[427 603 100 127 191],568,5,6935,4.345238095238095,20.0,40.0
31596,3,1596,[427 603 100 127 191],664,4,6939,4.345021916092674,20.0,40.0
31597,3,1597,[427 603 100 127 191],385,4,6943,4.344806007509387,20.0,40.0
31598,3,1598,[427 603 100 127 191],533,5,6948,4.345215759849906,20.0,40.0
31599,3,1599,[ 56 186 175 385 403],738,4,6952,4.345,0.0,0.0
31600,3,1600,[427 603 100 127 191],409,5,6957,4.345409119300437,20.0,40.0
31601,3,1601,[127 187 546  22 215],479,3,6960,4.344569288389513,0.0,20.0
31602,3,1602,[427 603 100 127 191],458,5,6965,4.344978165938865,20.0,40.0
31603,3,1603,[427 603 100 127 191],694,5,6970,4.3453865336658355,20.0,40.0
31604,3,1604,[427 603 100 127 191],234,5,6975,4.345794392523365,20.0,40.0
31605,3,1605,[427 603 100 127 191],398,4,6979,4.345579078455791,20.0,40.0
31606,3,1606,[427 603 100 127 191],308,5,6984,4.345986309894212,20.0,40.0
31607,3,1607,[  9 173 194 195 191],406,4,6988,4.345771144278607,0.0,0.0
31608,3,1608,[ 22  88 187 168   1],653,3,6991,4.344934742075823,0.0,0.0
31609,3,1609,[427 603 100 127 191],650,4,6995,4.34472049689441,20.0,40.0
31610,3,1610,[427 603 100 127 191],90,5,7000,4.345127250155183,20.0,40.0
31611,3,1611,[427 603 100 127 191],90,5,7005,4.3455334987593055,20.0,40.0
31612,3,1612,[427 603 100 127 191],650,4,7009,4.34531928084315,20.0,40.0
31613,3,1613,[427 603 100 127 191],664,4,7013,4.345105328376704,20.0,40.0
31614,3,1614,[427 603 100 127 191],7,5,7018,4.345510835913313,20.0,40.0
31615,3,1615,[427 603 100 127 191],7,5,7023,4.345915841584159,20.0,40.0
31616,3,1616,[427 603 100 127 191],59,5,7028,4.346320346320346,20.0,40.0
31617,3,1617,[186   8 302 216 100],315,4,7032,4.34610630407911,0.0,20.0
31618,3,1618,[427 603 100 127 191],13,4,7036,4.345892526250772,20.0,40.0
31619,3,1619,[153 515 269 568 135],13,2,7038,4.344444444444444,0.0,0.0
31620,3,1620,[427 603 100 127 191],59,5,7043,4.344848858729179,20.0,40.0
31621,3,1621,[427 603 100 127 191],664,4,7047,4.344636251541307,20.0,40.0
31622,3,1622,[427 603 100 127 258],234,4,7051,4.344423906346273,20.0,40.0
31623,3,1623,[427 603 100 127 302],664,5,7056,4.344827586206897,20.0,40.0
31624,3,1624,[427 603 100 127 302],666,5,7061,4.34523076923077,20.0,40.0
31625,3,1625,[427 603 100 127 302],339,5,7066,4.345633456334563,20.0,40.0
31626,3,1626,[427 603 100 127 302],339,5,7071,4.346035648432698,20.0,40.0
31627,3,1627,[427 603 100 127 302],334,5,7076,4.346437346437346,20.0,40.0
31628,3,1628,[427 603 100 127 302],334,5,7081,4.346838551258441,20.0,40.0
31629,3,1629,[427 603 100 127 302],458,5,7086,4.347239263803681,20.0,40.0
31630,3,1630,[427 603 100 127 302],664,5,7091,4.347639484978541,20.0,40.0
31631,3,1631,[427 603 100 127 302],90,5,7096,4.348039215686274,20.0,40.0
31632,3,1632,[427 603 100 302 127],537,5,7101,4.348438456827924,20.0,40.0
31633,3,1633,[ 70 289   9   4 385],788,3,7104,4.347613219094248,0.0,0.0
31634,3,1634,[427 603 100 302 127],334,5,7109,4.348012232415902,20.0,40.0
31635,3,1635,[181 173 151 318 483],892,5,7114,4.34841075794621,40.0,0.0
31636,3,1636,[427 603 100 302 127],90,5,7119,4.3488087965791085,20.0,40.0
31637,3,1637,[496   4 202  11   9],64,4,7123,4.348595848595848,0.0,0.0
31638,3,1638,[427 603 100 302 127],458,5,7128,4.348993288590604,20.0,40.0
31639,3,1639,[427 603 302 100 127],664,5,7133,4.349390243902439,20.0,40.0
31640,3,1640,[427 603 302 100 127],271,5,7138,4.349786715417428,20.0,40.0
31641,3,1641,[427 603 302 100 127],458,5,7143,4.350182704019488,20.0,40.0
31642,3,1642,[294  25   8 186 195],533,3,7146,4.349360925136945,0.0,0.0
31643,3,1643,[427 603 302 100 127],537,5,7151,4.349756690997567,20.0,40.0
31644,3,1644,[427 603 302 100 127],271,5,7156,4.3501519756838904,20.0,40.0
31645,3,1645,[483 168 194  88 237],298,5,7161,4.350546780072904,20.0,0.0
31646,3,1646,[427 603 302 100 127],271,5,7166,4.350941105039466,20.0,40.0
31647,3,1647,[135 222  50   4 186],774,1,7167,4.348907766990291,0.0,20.0
31648,3,1648,[427 603 302 100 127],271,5,7172,4.349302607640994,20.0,40.0
31649,3,1649,[  1  56 117  22 300],533,4,7176,4.349090909090909,0.0,0.0
31650,3,1650,[357 180 127 655 603],213,5,7181,4.349485160508783,40.0,20.0
31651,3,1651,[ 89  64  56 271 385],883,3,7184,4.348668280871671,0.0,0.0
31652,3,1652,[427 603 302 100 127],13,5,7189,4.349062310949789,20.0,40.0
31653,3,1653,[ 11  88 328 216 300],653,2,7191,4.34764207980653,0.0,0.0
31654,3,1654,[427 603 302 100 127],666,5,7196,4.348036253776435,20.0,40.0
31655,3,1655,[121 182 210 118   8],92,4,7200,4.3478260869565215,0.0,0.0
31656,3,1656,[427 603 302 100 127],13,5,7205,4.348219674109837,20.0,40.0
31657,3,1657,[300 222 286 546 313],378,3,7208,4.347406513872135,0.0,0.0
31658,3,1658,[427 603 302 100 127],537,5,7213,4.347799879445449,20.0,40.0
31659,3,1659,[427 302 603 100 127],666,5,7218,4.348192771084338,20.0,40.0
31660,3,1660,[427 302 603 100 127],339,5,7223,4.348585189644792,20.0,40.0
31661,3,1661,[427 302 603 100 127],90,5,7228,4.348977135980746,20.0,40.0
31662,3,1662,[427 302 603 100 127],537,5,7233,4.349368610944077,20.0,40.0
31663,3,1663,[  8 182 179  98 135],234,3,7236,4.3485576923076925,0.0,20.0
31664,3,1664,[427 302 603 100 127],271,5,7241,4.348948948948949,20.0,40.0
31665,3,1665,[427 302 603 100 127],339,5,7246,4.3493397358943575,20.0,40.0
31666,3,1666,[183  98 265 403  79],60,4,7250,4.349130173965207,0.0,20.0
31667,3,1667,[427 302 603 100 127],13,5,7255,4.349520383693045,20.0,40.0
31668,3,1668,[427 302 603 100 127],458,5,7260,4.349910125823847,20.0,40.0
31669,3,1669,[427 302 603 100 127],458,5,7265,4.350299401197605,20.0,40.0
31670,3,1670,[427 302 603 100 127],14,4,7269,4.350089766606822,20.0,40.0
31671,3,1671,[427 302 603 100 127],537,5,7274,4.350478468899522,20.0,40.0
31672,3,1672,[427 302 603 100 127],745,4,7278,4.35026897788404,20.0,40.0
31673,3,1673,[427 302 603 100 127],14,4,7282,4.350059737156512,20.0,40.0
31674,3,1674,[427 302 603 100 127],14,4,7286,4.349850746268657,20.0,40.0
31675,3,1675,[427 302 603 100 127],13,5,7291,4.350238663484487,20.0,40.0
31676,3,1676,[427 302 603 100 127],14,4,7295,4.350029815146094,20.0,40.0
31677,3,1677,[427 302 603 100 127],537,5,7300,4.350417163289631,20.0,40.0
31678,3,1678,[588 496 168 294  71],234,1,7301,4.348421679571174,0.0,0.0
31679,3,1679,[427 302 603 100 127],666,5,7306,4.348809523809524,20.0,40.0
31680,3,1680,[427 302 603 100 127],745,4,7310,4.348602022605592,20.0,40.0
31681,3,1681,[ 97 269 182  82 185],488,3,7313,4.3478002378121285,0.0,0.0
31682,3,1682,[427 302 603 100 127],339,5,7318,4.348187759952466,20.0,40.0
31683,3,1683,[ 97 228   7 269 655],7,4,7322,4.3479809976247035,0.0,0.0
31684,3,1684,[427 302 603 100 127],339,5,7327,4.348367952522255,20.0,40.0
31685,3,1685,[427 302 603 100 127],537,5,7332,4.3487544483985765,20.0,40.0
31686,3,1686,[427 302 603 100 127],745,4,7336,4.348547717842323,20.0,40.0
31687,3,1687,[ 79 216 228 483  95],295,5,7341,4.3489336492890995,20.0,0.0
31688,3,1688,[427 302 603 100 127],474,5,7346,4.349319123741859,20.0,40.0
31689,3,1689,[427 302 603 100 127],664,5,7351,4.349704142011834,20.0,40.0
31690,3,1690,[427 302 603 100 127],664,5,7356,4.350088704908338,20.0,40.0
31691,3,1691,[427 302 603 100 127],474,5,7361,4.35047281323877,20.0,40.0
31692,3,1692,[427 302 603 100 127],339,5,7366,4.350856467808624,20.0,40.0
31693,3,1693,[427 302 603 100 127],14,4,7370,4.35064935064935,20.0,40.0
31694,3,1694,[151 318 197   1  56],82,3,7373,4.3498525073746315,20.0,0.0
31695,3,1695,[427 302 603 100 127],271,5,7378,4.350235849056604,20.0,40.0
31696,3,1696,[179 496 202  50 204],749,5,7383,4.35061873895109,0.0,20.0
31697,3,1697,[427 302 603 100 127],334,5,7388,4.351001177856301,20.0,40.0
31698,3,1698,[427 302 603 100 127],14,4,7392,4.350794585050029,20.0,40.0
31699,3,1699,[427 302 603 100 127],458,5,7397,4.351176470588236,20.0,40.0
31700,3,1700,[427 302 603 100 127],664,5,7402,4.351557907113462,20.0,40.0
31701,3,1701,[427 302 603 100 127],90,5,7407,4.351938895417156,20.0,40.0
31702,3,1702,[427 302 603 100 127],458,5,7412,4.3523194362889015,20.0,40.0
31703,3,1703,[427 302 603 100 127],666,5,7417,4.352699530516432,20.0,40.0
31704,3,1704,[427 302 603 100 127],666,5,7422,4.353079178885631,20.0,40.0
31705,3,1705,[427 302 603 100 127],537,5,7427,4.3534583821805395,20.0,40.0
31706,3,1706,[427 302 603 100 127],745,4,7431,4.353251318101933,20.0,40.0
31707,3,1707,[174 265 282  50  89],95,3,7434,4.352459016393443,0.0,40.0
31708,3,1708,[427 302 603 100 127],458,5,7439,4.352837916910474,20.0,40.0
31709,3,1709,[427 302 603 100 127],271,5,7444,4.353216374269006,20.0,40.0
31710,3,1710,[427 302 603 100 127],334,5,7449,4.353594389246055,20.0,40.0
31711,3,1711,[427 302 603 100 127],745,4,7453,4.35338785046729,20.0,40.0
31712,3,1712,[427 302 603 100 127],664,5,7458,4.353765323992994,20.0,40.0
31713,3,1713,[427 302 603 100 127],271,5,7463,4.35414235705951,20.0,40.0
31714,3,1714,[111 204 313   1 132],454,2,7465,4.352769679300292,0.0,0.0
31715,3,1715,[168 185 215 182 195],537,3,7468,4.351981351981352,0.0,0.0
31716,3,1716,[ 56 176 172  69 173],398,5,7473,4.352358765288294,0.0,0.0
31717,3,1717,[258 143 238 286 508],59,2,7475,4.350989522700815,0.0,0.0
31718,3,1718,[427 302 603 100 127],666,5,7480,4.351367073880163,20.0,40.0
31719,3,1719,[508 385  28 496 191],653,3,7483,4.350581395348837,0.0,0.0
31720,3,1720,[427 302 603 100 127],666,5,7488,4.350958744915746,20.0,40.0
31721,3,1721,[216 151 234 265 210],379,5,7493,4.351335656213705,0.0,0.0
31722,3,1722,[427 302 603 100 127],14,4,7497,4.351131746952989,20.0,40.0
31723,3,1723,[204  97 483  56 195],840,4,7501,4.35092807424594,20.0,0.0
31724,3,1724,[427 302 603 100 127],537,5,7506,4.351304347826087,20.0,40.0
31725,3,1725,[427 302 603 100 127],14,4,7510,4.351100811123986,20.0,40.0
31726,3,1726,[427 302 603 100 127],537,5,7515,4.351476548928778,20.0,40.0
31727,3,1727,[427 302 603 100 127],14,4,7519,4.351273148148148,20.0,40.0
31728,3,1728,[427 302 603 100 127],664,5,7524,4.351648351648351,20.0,40.0
31729,3,1729,[235 597 111 194 238],82,2,7526,4.350289017341041,0.0,0.0
31730,3,1730,[427 302 603 100 127],745,4,7530,4.350086655112651,20.0,40.0
31731,3,1731,[427 302 603 100 127],14,4,7534,4.349884526558891,20.0,40.0
31732,3,1732,[ 11 294 168  70 748],881,1,7535,4.347951529140219,0.0,0.0
31733,3,1733,[427 302 603 100 127],537,5,7540,4.348327566320646,20.0,40.0
31734,3,1734,[427 302 603 100 127],339,5,7545,4.348703170028818,20.0,40.0
31735,3,1735,[ 56  25 179  71 276],92,4,7549,4.348502304147465,0.0,0.0
31736,3,1736,[427 302 603 100 127],666,5,7554,4.34887737478411,20.0,40.0
31737,3,1737,[257 143 175 185 357],339,5,7559,4.349252013808976,20.0,0.0
31738,3,1738,[427 302 603 100 127],271,5,7564,4.3496262219666475,20.0,40.0
31739,3,1739,[427 302 603 100 127],474,5,7569,4.35,20.0,40.0
31740,3,1740,[427 302 603 100 127],334,5,7574,4.350373348650201,20.0,40.0
31741,3,1741,[427 302 603 100 127],745,4,7578,4.350172215843858,20.0,40.0
31742,3,1742,[  7 210  69 182 135],194,1,7579,4.3482501434308665,0.0,0.0
31743,3,1743,[568  56 176  70 471],213,3,7582,4.347477064220183,0.0,0.0
31744,3,1744,[172 143 182   1 515],308,4,7586,4.347277936962751,0.0,0.0
31745,3,1745,[322 127 265 181 405],881,5,7591,4.347651775486827,0.0,20.0
31746,3,1746,[427 302 603 100 127],271,5,7596,4.3480251860332,20.0,40.0
31747,3,1747,[427 302 603 100 127],666,5,7601,4.3483981693363845,20.0,40.0
31748,3,1748,[427 302 603 100 127],664,5,7606,4.348770726129216,20.0,40.0
31749,3,1749,[427 302 603 100 127],13,5,7611,4.349142857142857,20.0,40.0
31750,3,1750,[427 302 603 100 127],271,5,7616,4.349514563106796,20.0,40.0
31751,3,1751,[300 265 403 183 294],378,4,7620,4.3493150684931505,0.0,0.0
31752,3,1752,[427 302 603 100 127],14,4,7624,4.349115801483172,20.0,40.0
31753,3,1753,[427 302 603 100 127],474,5,7629,4.349486887115165,20.0,40.0
31754,3,1754,[427 302 603 100 127],334,5,7634,4.34985754985755,20.0,40.0
31755,3,1755,[427 302 603 100 127],666,5,7639,4.350227790432802,20.0,40.0
31756,3,1756,[318  98  28 300 515],666,3,7642,4.349459305634604,20.0,20.0
31757,3,1757,[ 64  97 186 276 475],13,4,7646,4.349260523321957,0.0,0.0
31758,3,1758,[427 302 603 100 127],334,5,7651,4.349630471859011,20.0,40.0
31759,3,1759,[546 423 183 135 118],749,3,7654,4.348863636363636,0.0,0.0
31760,3,1760,[111 204 132 153 117],454,1,7655,4.346961953435548,0.0,0.0
31761,3,1761,[427 302 603 100 127],458,5,7660,4.34733257661748,20.0,40.0
31762,3,1762,[427 302 603 100 127],271,5,7665,4.347702779353375,20.0,40.0
31763,3,1763,[427 302 603 100 127],14,4,7669,4.34750566893424,20.0,40.0
31764,3,1764,[427 302 603 100 127],745,4,7673,4.347308781869688,20.0,40.0
31765,3,1765,[427 302 603 100 127],474,5,7678,4.347678369195923,20.0,40.0
31766,3,1766,[427 302 603 100 127],745,4,7682,4.347481607243917,20.0,40.0
31767,3,1767,[427 302 603 100 127],14,4,7686,4.347285067873303,20.0,40.0
31768,3,1768,[427 302 603 100 127],271,5,7691,4.347654041831543,20.0,40.0
31769,3,1769,[427 302 603 100 127],458,5,7696,4.348022598870057,20.0,40.0
31770,3,1770,[427 302 603 100 127],537,5,7701,4.348390739695088,20.0,40.0
31771,3,1771,[210 202 508 228 121],537,1,7702,4.346501128668171,0.0,0.0
31772,3,1772,[427 302 603 100 127],537,5,7707,4.346869712351946,20.0,40.0
31773,3,1773,[245 211 257  97 181],804,5,7712,4.3472378804960545,0.0,0.0
31774,3,1774,[427 302 603 100 127],14,4,7716,4.347042253521127,20.0,40.0
31775,3,1775,[427 302 603 100 127],14,4,7720,4.346846846846847,20.0,40.0
31776,3,1776,[427 302 603 100 127],13,5,7725,4.347214406302758,20.0,40.0
31777,3,1777,[427 302 603 100 127],339,5,7730,4.347581552305962,20.0,40.0
31778,3,1778,[423 127 204  56  12],374,4,7734,4.347386172006745,20.0,20.0
31779,3,1779,[427 302 603 100 127],745,4,7738,4.347191011235955,20.0,40.0
31780,3,1780,[427 302 603 100 127],339,5,7743,4.347557551937114,20.0,40.0
31781,3,1781,[427 302 603 100 127],339,5,7748,4.347923681257015,20.0,40.0
31782,3,1782,[427 302 603 100 127],13,5,7753,4.34828939988783,20.0,40.0
31783,3,1783,[427 302 603 100 127],14,4,7757,4.348094170403588,20.0,40.0
31784,3,1784,[144 427 151 118  79],308,3,7760,4.347338935574229,0.0,0.0
31785,3,1785,[161   4 265  88 423],533,3,7763,4.346584546472564,0.0,0.0
31786,3,1786,[427 302 603 100 127],745,4,7767,4.3463905987688864,20.0,40.0
31787,3,1787,[286  98  70  25 187],452,3,7770,4.345637583892618,0.0,20.0
31788,3,1788,[427 302 603 100 127],537,5,7775,4.346003353828955,20.0,40.0
31789,3,1789,[427 302 603 100 127],14,4,7779,4.345810055865922,20.0,40.0
31790,3,1790,[427 302 603 100 127],745,4,7783,4.345616973757677,20.0,40.0
31791,3,1791,[427 302 603 100 127],271,5,7788,4.345982142857143,20.0,40.0
31792,3,1792,[427 302 603 100 127],537,5,7793,4.346346904629113,20.0,40.0
31793,3,1793,[  1 405 234  25 403],881,2,7795,4.345039018952062,0.0,0.0
31794,3,1794,[405   8  95 294   1],406,3,7798,4.344289693593315,0.0,0.0
31795,3,1795,[216 471 144 318 135],653,2,7800,4.342984409799555,20.0,0.0
31796,3,1796,[216  82 286  97 168],233,4,7804,4.3427935447968835,0.0,0.0
31797,3,1797,[427 302 603 100 127],745,4,7808,4.342602892102336,20.0,40.0
31798,3,1798,[568  50 678 275  28],308,3,7811,4.341856586992773,0.0,20.0
31799,3,1799,[427 302 603 100 127],13,5,7816,4.342222222222222,20.0,40.0
31800,3,1800,[427 302 603 100 127],458,5,7821,4.34258745141588,20.0,40.0
31801,3,1801,[427 302 603 100 127],664,5,7826,4.342952275249723,20.0,40.0
31802,3,1802,[427 302 603 100 127],14,4,7830,4.342762063227953,20.0,40.0
31803,3,1803,[427 302 603 100 127],334,5,7835,4.343126385809312,20.0,40.0
31804,3,1804,[  4 211 194 288 238],666,3,7838,4.342382271468144,0.0,0.0
31805,3,1805,[427 302 603 100 127],14,4,7842,4.342192691029901,20.0,40.0
31806,3,1806,[427 302 603 100 127],537,5,7847,4.342556723851688,20.0,40.0
31807,3,1807,[427 302 603 100 127],666,5,7852,4.342920353982301,20.0,40.0
31808,3,1808,[427 302 603 100 127],664,5,7857,4.343283582089552,20.0,40.0
31809,3,1809,[  9 546 125 282 265],271,2,7859,4.341988950276243,0.0,0.0
31810,3,1810,[313 546  22 211 181],308,3,7862,4.341247929320817,0.0,0.0
31811,3,1811,[427 302 603 100 127],90,5,7867,4.341611479028698,20.0,40.0
31812,3,1812,[427 302 603 100 127],458,5,7872,4.341974627688914,20.0,40.0
31813,3,1813,[427 302 603 100 127],90,5,7877,4.342337375964719,20.0,40.0
31814,3,1814,[423 144  98 435 318],263,5,7882,4.342699724517907,20.0,20.0
31815,3,1815,[427 302 603 100 127],666,5,7887,4.34306167400881,20.0,40.0
31816,3,1816,[427 302 603 100 127],339,5,7892,4.343423225096313,20.0,40.0
31817,3,1817,[427 302 603 100 127],334,5,7897,4.343784378437844,20.0,40.0
31818,3,1818,[427 302 603 100 127],339,5,7902,4.34414513468939,20.0,40.0
31819,3,1819,[427 302 603 100 127],666,5,7907,4.344505494505494,20.0,40.0
31820,3,1820,[427 302 603 100 127],334,5,7912,4.344865458539264,20.0,40.0
31821,3,1821,[427 302 603 100 127],90,5,7917,4.345225027442371,20.0,40.0
31822,3,1822,[427 302 603 100 127],13,5,7922,4.345584201865058,20.0,40.0
31823,3,1823,[427 302 603 100 127],334,5,7927,4.34594298245614,20.0,40.0
31824,3,1824,[427 302 603 100 127],14,4,7931,4.345753424657534,20.0,40.0
31825,3,1825,[427 302 603 100 127],271,5,7936,4.3461117196056955,20.0,40.0
31826,3,1826,[ 69 313  88  98 202],533,5,7941,4.346469622331691,0.0,20.0
31827,3,1827,[ 71 568 435 275  70],648,3,7944,4.3457330415754925,0.0,0.0
31828,3,1828,[427 302 603 100 127],339,5,7949,4.34609075997813,20.0,40.0
31829,3,1829,[228 302 288 483  70],334,3,7952,4.3453551912568305,20.0,0.0
31830,3,1830,[427 302 603 100 127],90,5,7957,4.345712725286728,20.0,40.0
31831,3,1831,[427 302 603 100 127],13,5,7962,4.346069868995633,20.0,40.0
31832,3,1832,[427 302 603 100 127],474,5,7967,4.346426623022368,20.0,40.0
31833,3,1833,[427 302 603 100 127],334,5,7972,4.346782988004362,20.0,40.0
31834,3,1834,[427 302 603 100 127],537,5,7977,4.347138964577657,20.0,40.0
31835,3,1835,[210  11  89   9 222],13,1,7978,4.345315904139434,0.0,0.0
31836,3,1836,[427 302 603 100 127],537,5,7983,4.345672291780076,20.0,40.0
31837,3,1837,[427 302 603 100 127],474,5,7988,4.3460282916213275,20.0,40.0
31838,3,1838,[427 302 603 100 127],474,5,7993,4.346383904295813,20.0,40.0
31839,3,1839,[427 302 603 100 127],90,5,7998,4.346739130434782,20.0,40.0
31840,3,1840,[168 235  89 496 302],271,2,8000,4.345464421510049,0.0,0.0
31841,3,1841,[121 176 748 655 168],313,3,8003,4.344733984799132,0.0,0.0
31842,3,1842,[211  64 323  82  98],13,3,8006,4.344004340748779,0.0,20.0
31843,3,1843,[427 302 603 100 127],537,5,8011,4.344360086767896,20.0,40.0
31844,3,1844,[427 302 603 100 127],90,5,8016,4.3447154471544716,20.0,40.0
31845,3,1845,[323 333 172  11  56],13,2,8018,4.343445287107259,0.0,0.0
31846,3,1846,[427 302 603 100 127],537,5,8023,4.343800757985923,20.0,40.0
31847,3,1847,[427 302 603 100 127],745,4,8027,4.3436147186147185,20.0,40.0
31848,3,1848,[427 302 603 100 127],90,5,8032,4.343969713358573,20.0,40.0
31849,3,1849,[427 302 603 100 127],537,5,8037,4.344324324324324,20.0,40.0
31850,3,1850,[427 302 603 100 127],745,4,8041,4.3441383036196655,20.0,40.0
31851,3,1851,[427 302 603 100 127],537,5,8046,4.344492440604752,20.0,40.0
31852,3,1852,[313 196 234 265 655],738,4,8050,4.34430652995143,0.0,0.0
31853,3,1853,[427 302 603 100 127],745,4,8054,4.344120819848976,20.0,40.0
31854,3,1854,[427 302 603 100 127],271,5,8059,4.344474393530997,20.0,40.0
31855,3,1855,[427 302 603 100 127],334,5,8064,4.344827586206897,20.0,40.0
31856,3,1856,[427 302 603 100 127],537,5,8069,4.345180398492191,20.0,40.0
31857,3,1857,[435 508   4 235 182],406,4,8073,4.344994617868676,0.0,0.0
31858,3,1858,[180 135 275 118  50],271,4,8077,4.34480903711673,0.0,20.0
31859,3,1859,[427 302 603 100 127],666,5,8082,4.34516129032258,20.0,40.0
31860,3,1860,[427 302 603 100 127],334,5,8087,4.345513164965072,20.0,40.0
31861,3,1861,[427 302 603 100 127],666,5,8092,4.345864661654136,20.0,40.0
31862,3,1862,[ 97  22 475 301  89],537,2,8094,4.344605475040257,0.0,0.0
31863,3,1863,[427 302 603 100 127],458,5,8099,4.344957081545064,20.0,40.0
31864,3,1864,[427 302 603 100 127],745,4,8103,4.344772117962466,20.0,40.0
31865,3,1865,[427 302 603 100 127],13,5,8108,4.345123258306538,20.0,40.0
31866,3,1866,[ 97 172 168  89  71],313,4,8112,4.344938403856454,0.0,0.0
31867,3,1867,[427 302 603 100 127],458,5,8117,4.345289079229122,20.0,40.0
31868,3,1868,[ 98 237  56   7 204],653,2,8119,4.344034242910648,0.0,20.0
31869,3,1869,[427 302 603 100 127],664,5,8124,4.344385026737968,20.0,40.0
31870,3,1870,[427 302 603 100 127],13,5,8129,4.344735435595938,20.0,40.0
31871,3,1871,[427 302 603 100 127],271,5,8134,4.34508547008547,20.0,40.0
31872,3,1872,[427 302 603 100 127],271,5,8139,4.345435130806194,20.0,40.0
31873,3,1873,[427 302 603 100 127],666,5,8144,4.345784418356457,20.0,40.0
31874,3,1874,[427 302 603 100 127],537,5,8149,4.346133333333333,20.0,40.0
31875,3,1875,[427 302 603 100 127],90,5,8154,4.346481876332622,20.0,40.0
31876,3,1876,[427 302 603 100 127],458,5,8159,4.346830047948854,20.0,40.0
31877,3,1877,[ 50 385  64 294 275],328,3,8162,4.346112886048989,0.0,20.0
31878,3,1878,[427 302 603 100 127],271,5,8167,4.346460883448643,20.0,40.0
31879,3,1879,[427 302 603 100 127],537,5,8172,4.346808510638298,20.0,40.0
31880,3,1880,[427 302 603 100 127],334,5,8177,4.3471557682084,20.0,40.0
31881,3,1881,[245   4 471 234  50],653,2,8179,4.345908607863975,0.0,20.0
31882,3,1882,[427 302 603 100 127],271,5,8184,4.346255974508763,20.0,40.0
31883,3,1883,[427 302 603 100 127],14,4,8188,4.346072186836518,20.0,40.0
31884,3,1884,[427 302 603 100 127],474,5,8193,4.346419098143236,20.0,40.0
31885,3,1885,[271 204   9 603 100],379,4,8197,4.346235418875928,20.0,20.0
31886,3,1886,[427 302 603 100 127],458,5,8202,4.346581875993641,20.0,40.0
31887,3,1887,[234 121 333 546 245],328,3,8205,4.345868644067797,0.0,0.0
31888,3,1888,[427 302 603 100 127],14,4,8209,4.345685547908946,20.0,40.0
31889,3,1889,[222  79  96  12 215],328,3,8212,4.344973544973545,20.0,0.0
31890,3,1890,[427 302 603 100 127],334,5,8217,4.345319936541513,20.0,40.0
31891,3,1891,[427 302 603 100 127],14,4,8221,4.3451374207188165,20.0,40.0
31892,3,1892,[427 302 603 100 127],14,4,8225,4.344955097728473,20.0,40.0
31893,3,1893,[427 302 603 100 127],14,4,8229,4.3447729672650475,20.0,40.0
31894,3,1894,[427 302 603 100 127],90,5,8234,4.345118733509235,20.0,40.0
31895,3,1895,[ 56 483 181   4  70],210,5,8239,4.345464135021097,20.0,0.0
31896,3,1896,[427 302 603 100 127],458,5,8244,4.345809172377438,20.0,40.0
31897,3,1897,[427 302 603 100 127],13,5,8249,4.346153846153846,20.0,40.0
31898,3,1898,[427 302 603 100 127],537,5,8254,4.346498156924697,20.0,40.0
31899,3,1899,[427 302 603 100 127],339,5,8259,4.346842105263158,20.0,40.0
31900,3,1900,[427 302 603 100 127],14,4,8263,4.346659652814308,20.0,40.0
31901,3,1901,[427 302 603 100 127],745,4,8267,4.346477392218717,20.0,40.0
31902,3,1902,[427 302 603 100 127],537,5,8272,4.3468208092485545,20.0,40.0
31903,3,1903,[427 302 603 100 127],664,5,8277,4.347163865546219,20.0,40.0
31904,3,1904,[427 302 603 100 127],334,5,8282,4.34750656167979,20.0,40.0
31905,3,1905,[121 427  79 194  97],295,5,8287,4.347848898216159,0.0,0.0
31906,3,1906,[427 302 603 100 127],339,5,8292,4.348190875721028,20.0,40.0
31907,3,1907,[186 265  88  79 195],194,2,8294,4.346960167714885,0.0,0.0
31908,3,1908,[427 302 603 100 127],271,5,8299,4.3473022524882134,20.0,40.0
31909,3,1909,[427 302 603 100 127],90,5,8304,4.347643979057592,20.0,40.0
31910,3,1910,[427 302 603 100 127],90,5,8309,4.347985347985348,20.0,40.0
31911,3,1911,[427 302 603 100 127],458,5,8314,4.348326359832636,20.0,40.0
31912,3,1912,[427 302 603 100 127],474,5,8319,4.348667015159435,20.0,40.0
31913,3,1913,[427 302 603 100 127],339,5,8324,4.349007314524556,20.0,40.0
31914,3,1914,[288 385 121  22  15],59,5,8329,4.34934725848564,0.0,0.0
31915,3,1915,[ 11 423   9  70 483],90,5,8334,4.349686847599165,20.0,0.0
31916,3,1916,[427 302 603 100 127],458,5,8339,4.350026082420449,20.0,40.0
31917,3,1917,[427 302 603 100 127],458,5,8344,4.350364963503649,20.0,40.0
31918,3,1918,[427 302 603 100 127],334,5,8349,4.350703491401772,20.0,40.0
31919,3,1919,[ 82 144 423  97 173],479,3,8352,4.35,0.0,0.0
31920,3,1920,[427 302 603 100 127],339,5,8357,4.350338365434669,20.0,40.0
31921,3,1921,[427 302 603 100 127],14,4,8361,4.350156087408949,20.0,40.0
31922,3,1922,[427 302 603 100 127],666,5,8366,4.350494019760791,20.0,40.0
31923,3,1923,[427 302 603 100 127],664,5,8371,4.350831600831601,20.0,40.0
31924,3,1924,[197  22 168 153 588],298,4,8375,4.35064935064935,0.0,0.0
31925,3,1925,[427 302 603 100 127],745,4,8379,4.350467289719626,20.0,40.0
31926,3,1926,[546   9 289 121 181],455,3,8382,4.349766476388168,0.0,0.0
31927,3,1927,[435 546  88 176 234],102,0,8382,4.347510373443983,0.0,0.0
31928,3,1928,[588  79 318 515 323],804,5,8387,4.347848626231208,20.0,0.0
31929,3,1929,[427 302 603 100 127],14,4,8391,4.347668393782383,20.0,40.0
31930,3,1930,[427 302 603 100 127],90,5,8396,4.348006214396686,20.0,40.0
31931,3,1931,[194  89 288 234 603],537,2,8398,4.346790890269151,20.0,0.0
31932,3,1932,[427 302 603 100 127],666,5,8403,4.347128815312985,20.0,40.0
31933,3,1933,[427 302 603 100 127],13,5,8408,4.347466390899689,20.0,40.0
31934,3,1934,[427 302 603 100 127],339,5,8413,4.347803617571059,20.0,40.0
31935,3,1935,[427 302 603 100 127],90,5,8418,4.348140495867769,20.0,40.0
31936,3,1936,[427 302 603 100 127],537,5,8423,4.348477026329375,20.0,40.0
31937,3,1937,[427 302 603 100 127],14,4,8427,4.348297213622291,20.0,40.0
31938,3,1938,[427 302 603 100 127],14,4,8431,4.348117586384735,20.0,40.0
31939,3,1939,[ 69  98 180 405 182],59,4,8435,4.347938144329897,0.0,20.0
31940,3,1940,[427 302 603 100 127],271,5,8440,4.3482740855229265,20.0,40.0
31941,3,1941,[427 302 603 100 127],14,4,8444,4.348094747682802,20.0,40.0
31942,3,1942,[427 302 603 100 127],537,5,8449,4.3484302624807,20.0,40.0
31943,3,1943,[427 302 603 100 127],339,5,8454,4.348765432098766,20.0,40.0
31944,3,1944,[427 302 603 100 127],537,5,8459,4.349100257069408,20.0,40.0
31945,3,1945,[385 265 172  56  50],7,5,8464,4.349434737923946,0.0,20.0
31946,3,1946,[403  97 234 216 742],346,2,8466,4.348228043143298,0.0,0.0
31947,3,1947,[427 302 603 100 127],474,5,8471,4.348562628336755,20.0,40.0
31948,3,1948,[175 210 135 161  22],92,3,8474,4.347870702924577,0.0,0.0
31949,3,1949,[ 22 471 185 496 186],7,5,8479,4.348205128205128,0.0,0.0
31950,3,1950,[427 302 603 100 127],537,5,8484,4.348539210661199,20.0,40.0
31951,3,1951,[427 302 603 100 127],339,5,8489,4.348872950819672,20.0,40.0
31952,3,1952,[427 302 603 100 127],90,5,8494,4.349206349206349,20.0,40.0
31953,3,1953,[427 302 603 100 127],334,5,8499,4.349539406345957,20.0,40.0
31954,3,1954,[  9 204  98  15 185],474,5,8504,4.349872122762148,0.0,20.0
31955,3,1955,[168 183 187 172 215],897,4,8508,4.3496932515337425,0.0,0.0
31956,3,1956,[127  89 173 313 282],144,4,8512,4.349514563106796,0.0,20.0
31957,3,1957,[427 302 603 100 127],664,5,8517,4.349846782431052,20.0,40.0
31958,3,1958,[427 302 603 100 127],13,5,8522,4.350178662582951,20.0,40.0
31959,3,1959,[742  71 322  15 191],454,1,8523,4.348469387755102,0.0,0.0
31960,3,1960,[204 174 403 483 125],398,4,8527,4.34829168791433,20.0,20.0
31961,3,1961,[427 302 603 100 127],13,5,8532,4.348623853211009,20.0,40.0
31962,3,1962,[427 302 603 100 127],14,4,8536,4.348446255731024,20.0,40.0
31963,3,1963,[427 302 603 100 127],14,4,8540,4.34826883910387,20.0,40.0
31964,3,1964,[427 302 603 100 127],745,4,8544,4.348091603053435,20.0,40.0
31965,3,1965,[427 302 603 100 127],474,5,8549,4.3484231943031535,20.0,40.0
31966,3,1966,[427 302 603 100 127],90,5,8554,4.3487544483985765,20.0,40.0
31967,3,1967,[427 302 603 100 127],14,4,8558,4.348577235772358,20.0,40.0
31968,3,1968,[427 302 603 100 127],458,5,8563,4.348908075165059,20.0,40.0
31969,3,1969,[144 515 328 176 258],234,1,8564,4.3472081218274115,0.0,0.0
31970,3,1970,[427 302 603 100 127],339,5,8569,4.34753932014206,20.0,40.0
31971,3,1971,[427 302 603 100 127],334,5,8574,4.347870182555781,20.0,40.0
31972,3,1972,[427 302 603 100 127],474,5,8579,4.348200709579321,20.0,40.0
31973,3,1973,[427 302 603 100 127],14,4,8583,4.348024316109423,20.0,40.0
31974,3,1974,[427 302 603 100 127],458,5,8588,4.348354430379747,20.0,40.0
31975,3,1975,[427 302 603 100 127],334,5,8593,4.348684210526316,20.0,40.0
31976,3,1976,[ 12   4 174 202 176],664,5,8598,4.349013657056146,20.0,20.0
31977,3,1977,[427 302 603 100 127],334,5,8603,4.349342770475228,20.0,40.0
31978,3,1978,[215 197 234   4  64],881,1,8604,4.347650328448712,0.0,0.0
31979,3,1979,[215 318 475 187 603],13,3,8607,4.346969696969697,40.0,0.0
31980,3,1980,[427 302 603 100 127],537,5,8612,4.3472993437657745,20.0,40.0
31981,3,1981,[268 185  22 127 153],334,5,8617,4.347628657921292,0.0,20.0
31982,3,1982,[ 69 268 100  98 748],13,5,8622,4.3479576399394855,0.0,40.0
31983,3,1983,[ 50 194  95 275 202],406,3,8625,4.347278225806452,0.0,20.0
31984,3,1984,[ 28 496 568 405  15],42,5,8630,4.347607052896725,0.0,0.0
31985,3,1985,[268 427 302 603 100],90,5,8635,4.347935548841893,20.0,20.0
31986,3,1986,[258 211 172 179  22],64,4,8639,4.3477604428787116,0.0,0.0
31987,3,1987,[275  22 427 235 168],406,2,8641,4.346579476861167,0.0,0.0
31988,3,1988,[268 427 302 603 100],13,5,8646,4.346907993966817,20.0,20.0
31989,3,1989,[  1 200 180 117 182],788,3,8649,4.346231155778894,0.0,0.0
31990,3,1990,[568 588 357 235 403],194,2,8651,4.345052737317931,20.0,0.0
31991,3,1991,[268 427 302 603 100],664,4,8655,4.344879518072289,20.0,20.0
31992,3,1992,[427 302 603 100 127],666,5,8660,4.345208228800803,20.0,40.0
31993,3,1993,[182 234  88   4 204],650,2,8662,4.344032096288867,0.0,0.0
31994,3,1994,[427 302 603 100 127],271,5,8667,4.344360902255639,20.0,40.0
31995,3,1995,[427 302 603 100 127],271,5,8672,4.344689378757515,20.0,40.0
31996,3,1996,[275 127  25 333 405],486,4,8676,4.344516775162744,0.0,20.0
31997,3,1997,[427 302 603 100 127],666,5,8681,4.344844844844845,20.0,40.0
31998,3,1998,[111  64 405 195 197],374,3,8684,4.344172086043021,0.0,0.0
31999,3,1999,[427 302 603 100 127],271,5,8689,4.3445,20.0,40.0
32000,3,2000,[427 302 603 100 127],537,5,8694,4.344827586206897,20.0,40.0
32001,3,2001,[  9 258 271 328 302],13,2,8696,4.343656343656344,0.0,0.0
32002,3,2002,[427 302 603 100 127],334,5,8701,4.343984023964054,20.0,40.0
32003,3,2003,[427 302 603 100 127],666,5,8706,4.344311377245509,20.0,40.0
32004,3,2004,[427 302 603 100 127],334,5,8711,4.344638403990025,20.0,40.0
32005,3,2005,[427 302 603 100 127],664,5,8716,4.344965104685942,20.0,40.0
32006,3,2006,[427 302 603 100 127],334,5,8721,4.345291479820628,20.0,40.0
32007,3,2007,[427 302 603 100 127],745,4,8725,4.34511952191235,20.0,40.0
32008,3,2008,[427 302 603 100 127],458,5,8730,4.345445495271279,20.0,40.0
32009,3,2009,[655 568 125 121  97],313,4,8734,4.345273631840796,0.0,0.0
32010,3,2010,[427 302 603 100 127],745,4,8738,4.345101939333665,20.0,40.0
32011,3,2011,[282 403 215 234 168],479,3,8741,4.344433399602385,0.0,0.0
32012,3,2012,[427 302 603 100 127],537,5,8746,4.344759066070542,20.0,40.0
32013,3,2013,[427 302 603 100 127],271,5,8751,4.345084409136048,20.0,40.0
32014,3,2014,[427 302 603 100 127],271,5,8756,4.345409429280397,20.0,40.0
32015,3,2015,[427 302 603 100 127],334,5,8761,4.345734126984127,20.0,40.0
32016,3,2016,[385 435 173 176 286],650,4,8765,4.345562716906296,0.0,0.0
32017,3,2017,[ 28 216  71 187 228],85,3,8768,4.344895936570862,0.0,0.0
32018,3,2018,[427 302 603 100 127],664,5,8773,4.345220406141654,20.0,40.0
32019,3,2019,[202 403  15  69 423],881,2,8775,4.344059405940594,0.0,0.0
32020,3,2020,[ 25 191  89 245  71],455,1,8776,4.342404750123701,0.0,0.0
32021,3,2021,[405 173  96 546 235],200,2,8778,4.341246290801187,0.0,0.0
32022,3,2022,[427 302 603 100 127],664,5,8783,4.341571922886802,20.0,40.0
32023,3,2023,[427 302 603 100 127],90,5,8788,4.341897233201581,20.0,40.0
32024,3,2024,[427 302 603 100 127],745,4,8792,4.341728395061728,20.0,40.0
32025,3,2025,[ 15 286 135 100 194],161,1,8793,4.340078973346496,0.0,20.0
32026,3,2026,[427 302 603 100 127],90,5,8798,4.340404538727183,20.0,40.0
32027,3,2027,[  9 143 238  70 423],234,1,8799,4.338757396449704,0.0,0.0
32028,3,2028,[427 302 603 100 127],13,5,8804,4.339083292262198,20.0,40.0
32029,3,2029,[427 302 603 100 127],458,5,8809,4.339408866995074,20.0,40.0
32030,3,2030,[427 302 603 100 127],13,5,8814,4.3397341211226,20.0,40.0
32031,3,2031,[427 302 603 100 127],14,4,8818,4.339566929133858,20.0,40.0
32032,3,2032,[427 302 603 100 127],14,4,8822,4.339399901623217,20.0,40.0
32033,3,2033,[427 302 603 100 127],90,5,8827,4.339724680432645,20.0,40.0
32034,3,2034,[427 302 603 100 127],90,5,8832,4.34004914004914,20.0,40.0
32035,3,2035,[427 302 603 100 127],334,5,8837,4.340373280943026,20.0,40.0
32036,3,2036,[427 302 603 100 127],271,5,8842,4.340697103583701,20.0,40.0
32037,3,2037,[427 302 603 100 127],14,4,8846,4.340529931305201,20.0,40.0
32038,3,2038,[427 302 603 100 127],664,5,8851,4.340853359489946,20.0,40.0
32039,3,2039,[427 302 603 100 127],13,5,8856,4.341176470588235,20.0,40.0
32040,3,2040,[427 302 603 100 127],339,5,8861,4.341499265066144,20.0,40.0
32041,3,2041,[427 302 603 100 127],458,5,8866,4.341821743388834,20.0,40.0
32042,3,2042,[ 28  82 603  15 300],537,1,8867,4.340186000978952,20.0,0.0
32043,3,2043,[427 302 603 100 127],13,5,8872,4.340508806262231,20.0,40.0
32044,3,2044,[427 302 603 100 127],334,5,8877,4.340831295843521,20.0,40.0
32045,3,2045,[143   4 161 588 258],13,4,8881,4.340664711632454,0.0,0.0
32046,3,2046,[427 302 603 100 127],474,5,8886,4.340986809965804,20.0,40.0
32047,3,2047,[427 302 603 100 127],458,5,8891,4.34130859375,20.0,40.0
32048,3,2048,[ 64 111 597 100 302],13,4,8895,4.341142020497804,0.0,20.0
32049,3,2049,[427 302 603 100 127],474,5,8900,4.341463414634147,20.0,40.0
32050,3,2050,[427 302 603 100 127],458,5,8905,4.341784495368113,20.0,40.0
32051,3,2051,[427 302 603 100 127],458,5,8910,4.342105263157895,20.0,40.0
32052,3,2052,[173 191 121 172  28],64,4,8914,4.34193862640039,0.0,0.0
32053,3,2053,[ 22 496 144 211 191],313,4,8918,4.341772151898734,0.0,0.0
32054,3,2054,[427 302 603 100 127],271,5,8923,4.342092457420924,20.0,40.0
32055,3,2055,[427 302 603 100 127],13,5,8928,4.342412451361867,20.0,40.0
32056,3,2056,[427 302 603 100 127],537,5,8933,4.342732134175985,20.0,40.0
32057,3,2057,[427 302 603 100 127],90,5,8938,4.3430515063168125,20.0,40.0
32058,3,2058,[427 302 603 100 127],14,4,8942,4.3428848955803785,20.0,40.0
32059,3,2059,[427 302 603 100 127],537,5,8947,4.343203883495145,20.0,40.0
32060,3,2060,[427 302 603 100 127],271,5,8952,4.343522561863173,20.0,40.0
32061,3,2061,[427 302 603 100 127],90,5,8957,4.343840931134821,20.0,40.0
32062,3,2062,[211 118 403  97  89],59,5,8962,4.344158991759573,0.0,0.0
32063,3,2063,[301 117 265 174   4],102,1,8963,4.342538759689923,0.0,20.0
32064,3,2064,[195 222  79  88 257],279,2,8965,4.341404358353511,0.0,0.0
32065,3,2065,[427 302 603 100 127],664,5,8970,4.341723136495644,20.0,40.0
32066,3,2066,[427 302 603 100 127],13,5,8975,4.3420416061925495,20.0,40.0
32067,3,2067,[427 302 603 100 127],664,5,8980,4.342359767891683,20.0,40.0
32068,3,2068,[427 302 603 100 127],537,5,8985,4.342677622039632,20.0,40.0
32069,3,2069,[427 302 603 100 127],745,4,8989,4.342512077294686,20.0,40.0
32070,3,2070,[427 302 603 100 127],664,5,8994,4.342829550941574,20.0,40.0
32071,3,2071,[427 302 603 100 127],271,5,8999,4.343146718146718,20.0,40.0
32072,3,2072,[427 302 603 100 127],334,5,9004,4.343463579353593,20.0,40.0
32073,3,2073,[427 302 603 100 127],745,4,9008,4.343297974927676,20.0,40.0
32074,3,2074,[427 302 603 100 127],271,5,9013,4.343614457831325,20.0,40.0
32075,3,2075,[427 302 603 100 127],474,5,9018,4.34393063583815,20.0,40.0
32076,3,2076,[427 302 603 100 127],537,5,9023,4.344246509388541,20.0,40.0
32077,3,2077,[427 302 603 100 127],745,4,9027,4.344080846968239,20.0,40.0
32078,3,2078,[515 153 118 301 289],13,2,9029,4.342953342953343,0.0,0.0
32079,3,2079,[427 302 603 100 127],537,5,9034,4.343269230769231,20.0,40.0
32080,3,2080,[ 79 211 132 143 235],537,1,9035,4.341662662181643,0.0,0.0
32081,3,2081,[427 302 603 100 127],13,5,9040,4.341978866474544,20.0,40.0
32082,3,2082,[183 197 286 182  15],881,1,9041,4.340374459913586,0.0,0.0
32083,3,2083,[427 302 603 100 127],537,5,9046,4.340690978886756,20.0,40.0
32084,3,2084,[258  56 111  97 211],125,1,9047,4.339088729016787,0.0,0.0
32085,3,2085,[427 302 603 100 127],745,4,9051,4.3389261744966445,20.0,40.0
32086,3,2086,[427 302 603 100 127],271,5,9056,4.339242932438908,20.0,40.0
32087,3,2087,[427 302 603 100 127],271,5,9061,4.33955938697318,20.0,40.0
32088,3,2088,[427 302 603 100 127],339,5,9066,4.339875538535185,20.0,40.0
32089,3,2089,[427 302 603 100 127],745,4,9070,4.339712918660287,20.0,40.0
32090,3,2090,[427 302 603 100 127],745,4,9074,4.339550454328073,20.0,40.0
32091,3,2091,[427 302 603 100 127],14,4,9078,4.339388145315487,20.0,40.0
32092,3,2092,[427 302 603 100 127],537,5,9083,4.339703774486384,20.0,40.0
32093,3,2093,[427 302 603 100 127],474,5,9088,4.340019102196752,20.0,40.0
32094,3,2094,[427 302 603 100 127],90,5,9093,4.340334128878282,20.0,40.0
32095,3,2095,[597 195 568   4 197],374,3,9096,4.3396946564885495,0.0,0.0
32096,3,2096,[185 186  79  64 211],326,5,9101,4.3400095374344305,0.0,0.0
32097,3,2097,[427 302 603 100 127],14,4,9105,4.339847473784557,20.0,40.0
32098,3,2098,[427 302 603 100 127],14,4,9109,4.33968556455455,20.0,40.0
32099,3,2099,[427 302 603 100 127],13,5,9114,4.34,20.0,40.0
32100,3,2100,[427 302 603 100 127],474,5,9119,4.340314136125654,20.0,40.0
32101,3,2101,[427 302 603 100 127],745,4,9123,4.340152235965747,20.0,40.0
32102,3,2102,[427 302 603 100 127],474,5,9128,4.3404660009510225,20.0,40.0
32103,3,2103,[603 173 191 144 121],7,5,9133,4.340779467680608,20.0,0.0
32104,3,2104,[286 483 496 179 318],648,3,9136,4.340142517814727,40.0,0.0
32105,3,2105,[ 64  56 405 161 265],59,3,9139,4.339506172839506,0.0,0.0
32106,3,2106,[427 302 603 100 127],271,5,9144,4.3398196487897485,20.0,40.0
32107,3,2107,[427 302 603 100 127],666,5,9149,4.340132827324478,20.0,40.0
32108,3,2108,[427 302 603 100 127],13,5,9154,4.340445708866762,20.0,40.0
32109,3,2109,[427 302 603 100 127],666,5,9159,4.340758293838863,20.0,40.0
32110,3,2110,[427 302 603 100 127],537,5,9164,4.341070582662246,20.0,40.0
32111,3,2111,[427 302 603 100 127],14,4,9168,4.340909090909091,20.0,40.0
32112,3,2112,[385 568   1 294 176],13,0,9168,4.338854708944629,0.0,0.0
32113,3,2113,[289 742 144 100 234],92,3,9171,4.338221381267739,0.0,20.0
32114,3,2114,[427 302 603 100 127],474,5,9176,4.338534278959811,20.0,40.0
32115,3,2115,[  7 323 194 197 273],883,4,9180,4.338374291115312,0.0,0.0
32116,3,2116,[300 173 144  96 276],13,3,9183,4.337742087860179,0.0,0.0
32117,3,2117,[ 64  79 234 471  88],454,3,9186,4.337110481586402,0.0,0.0
32118,3,2118,[515  69 286  96  22],537,1,9187,4.335535630014157,0.0,0.0
32119,3,2119,[197 357  89 127 121],749,4,9191,4.335377358490566,20.0,20.0
32120,3,2120,[427 302 603 100 127],664,5,9196,4.335690711928335,20.0,40.0
32121,3,2121,[483 286  97 234 496],488,3,9199,4.3350612629594725,20.0,0.0
32122,3,2122,[427 302 603 100 127],664,5,9204,4.335374470089496,20.0,40.0
32123,3,2123,[427 302 603 100 127],334,5,9209,4.335687382297552,20.0,40.0
32124,3,2124,[ 95 471 333 588 423],537,0,9209,4.333647058823529,0.0,0.0
32125,3,2125,[427 302 603 100 127],474,5,9214,4.333960489181561,20.0,40.0
32126,3,2126,[111 301 471  97 187],234,1,9215,4.3323930418429715,0.0,0.0
32127,3,2127,[427 302 603 100 127],14,4,9219,4.332236842105263,20.0,40.0
32128,3,2128,[258 300 204 289 403],533,3,9222,4.33161108501644,0.0,0.0
32129,3,2129,[427 302 603 100 127],537,5,9227,4.331924882629108,20.0,40.0
32130,3,2130,[427 302 603 100 127],334,5,9232,4.332238385734397,20.0,40.0
32131,3,2131,[427 302 603 100 127],745,4,9236,4.3320825515947465,20.0,40.0
32132,3,2132,[427 302 603 100 127],334,5,9241,4.332395686826066,20.0,40.0
32133,3,2133,[427 302 603 100 127],13,5,9246,4.332708528584817,20.0,40.0
32134,3,2134,[603 237  25  15 427],313,2,9248,4.331615925058548,20.0,0.0
32135,3,2135,[427 302 603 100 127],271,5,9253,4.331928838951311,20.0,40.0
32136,3,2136,[427 302 603 100 127],474,5,9258,4.332241459990641,20.0,40.0
32137,3,2137,[427 302 603 100 127],90,5,9263,4.3325537885874645,20.0,40.0
32138,3,2138,[427 302 603 100 127],745,4,9267,4.332398316970547,20.0,40.0
32139,3,2139,[427 302 603 100 127],334,5,9272,4.332710280373832,20.0,40.0
32140,3,2140,[117 289 202 194 237],13,3,9275,4.332087809434843,0.0,0.0
32141,3,2141,[427 302 603 100 127],334,5,9280,4.332399626517273,20.0,40.0
32142,3,2142,[427 302 603 100 127],334,5,9285,4.332711152589828,20.0,40.0
32143,3,2143,[427 302 603 100 127],334,5,9290,4.333022388059701,20.0,40.0
32144,3,2144,[286 403 174  98  70],194,2,9292,4.331934731934732,0.0,40.0
32145,3,2145,[427 302 603 100 127],13,5,9297,4.332246039142591,20.0,40.0
32146,3,2146,[427 302 603 100 127],664,5,9302,4.332557056357708,20.0,40.0
32147,3,2147,[427 302 603 100 127],664,5,9307,4.332867783985103,20.0,40.0
32148,3,2148,[427 302 603 100 127],271,5,9312,4.333178222429037,20.0,40.0
32149,3,2149,[427 302 603 100 127],745,4,9316,4.333023255813954,20.0,40.0
32150,3,2150,[427 302 603 100 127],474,5,9321,4.333333333333333,20.0,40.0
32151,3,2151,[483 385 496 187 121],85,3,9324,4.33271375464684,20.0,0.0
32152,3,2152,[427 302 603 100 127],666,5,9329,4.333023687877381,20.0,40.0
32153,3,2153,[427 302 603 100 127],474,5,9334,4.333333333333333,20.0,40.0
32154,3,2154,[568 143 322 153 237],313,1,9335,4.3317865429234335,0.0,0.0
32155,3,2155,[187 435  95 423 185],271,4,9339,4.331632653061225,0.0,0.0
32156,3,2156,[ 95  70 483  82  64],892,4,9343,4.331478905887807,20.0,0.0
32157,3,2157,[427 302 603 100  64],90,5,9348,4.3317886932344765,20.0,20.0
32158,3,2158,[427 302 603 100  64],666,5,9353,4.332098193608152,20.0,20.0
32159,3,2159,[427 302 603 100  64],271,5,9358,4.332407407407407,20.0,20.0
32160,3,2160,[427 302 603 100  64],13,5,9363,4.332716335030079,20.0,20.0
32161,3,2161,[427 302 603 100  64],537,4,9367,4.332562442183164,20.0,20.0
32162,3,2162,[427 302 603 100 127],90,5,9372,4.332871012482663,20.0,40.0
32163,3,2163,[427 302 603 100 127],666,5,9377,4.3331792975970425,20.0,40.0
32164,3,2164,[427 302 603 100 127],666,5,9382,4.3334872979214785,20.0,40.0
32165,3,2165,[427 302 603 100 127],458,5,9387,4.333795013850415,20.0,40.0
32166,3,2166,[301 176 496  64 187],184,4,9391,4.3336409783110295,0.0,0.0
32167,3,2167,[427 302 603 100 127],745,4,9395,4.333487084870849,20.0,40.0
32168,3,2168,[427 302 603 100 127],458,5,9400,4.333794375288151,20.0,40.0
32169,3,2169,[427 302 603 100 127],537,5,9405,4.3341013824884795,20.0,40.0
32170,3,2170,[427 302 603 100 127],334,5,9410,4.334408106863196,20.0,40.0
32171,3,2171,[427 302 603 100 127],745,4,9414,4.334254143646409,20.0,40.0
32172,3,2172,[427 302 603 100 127],14,4,9418,4.3341003221352965,20.0,40.0
32173,3,2173,[427 302 603 100 127],271,5,9423,4.334406623735051,20.0,40.0
32174,3,2174,[427 302 603 100 127],458,5,9428,4.334712643678161,20.0,40.0
32175,3,2175,[427 302 603 100 127],474,5,9433,4.335018382352941,20.0,40.0
32176,3,2176,[496 258 483 357 143],6,3,9436,4.334405144694534,40.0,0.0
32177,3,2177,[276  25 172 173 328],537,2,9438,4.333333333333333,0.0,0.0
32178,3,2178,[117 215 182 471 181],308,2,9440,4.332262505736576,0.0,0.0
32179,3,2179,[118   7 228  98 546],774,2,9442,4.3311926605504585,0.0,20.0
32180,3,2180,[427 302 603 100 127],666,5,9447,4.331499312242091,20.0,40.0
32181,3,2181,[ 97 127 427  82 234],650,2,9449,4.330430797433547,0.0,20.0
32182,3,2182,[427 302 603 100 127],664,5,9454,4.330737517178195,20.0,40.0
32183,3,2183,[427 302 603 100 127],474,5,9459,4.331043956043956,20.0,40.0
32184,3,2184,[176 603 118 568 235],213,4,9463,4.330892448512586,20.0,0.0
32185,3,2185,[427 302 603 100 127],537,5,9468,4.331198536139067,20.0,40.0
32186,3,2186,[427 302 603 100 127],334,5,9473,4.331504343850023,20.0,40.0
32187,3,2187,[427 302 603 100 127],14,4,9477,4.331352833638026,20.0,40.0
32188,3,2188,[427 302 603 100 127],474,5,9482,4.331658291457287,20.0,40.0
32189,3,2189,[427 302 603 100 127],474,5,9487,4.331963470319635,20.0,40.0
32190,3,2190,[427 302 603 100 127],334,5,9492,4.332268370607029,20.0,40.0
32191,3,2191,[135 269  71 435 195],524,2,9494,4.331204379562044,0.0,0.0
32192,3,2192,[427 302 603 100 127],537,5,9499,4.331509347925216,20.0,40.0
32193,3,2193,[496  70 216 294 175],194,2,9501,4.330446672743847,0.0,0.0
32194,3,2194,[427 302 603 100 127],339,5,9506,4.330751708428246,20.0,40.0
32195,3,2195,[161  50 228 117 172],234,1,9507,4.329234972677596,0.0,20.0
32196,3,2196,[222 597 191 234 168],804,4,9511,4.329085116067365,0.0,0.0
32197,3,2197,[427 302 603 100 127],537,5,9516,4.329390354868062,20.0,40.0
32198,3,2198,[427 302 603 100 127],537,5,9521,4.329695316052751,20.0,40.0
32199,3,2199,[427 302 603 100 127],474,5,9526,4.33,20.0,40.0
32200,3,2200,[427 302 603 100 127],13,5,9531,4.330304407087687,20.0,40.0
32201,3,2201,[427 302 603 100 127],458,5,9536,4.330608537693006,20.0,40.0
32202,3,2202,[427 302 603 100 127],666,5,9541,4.330912392192465,20.0,40.0
32203,3,2203,[427 302 603 100 127],666,5,9546,4.331215970961887,20.0,40.0
32204,3,2204,[200 132 228 268  50],537,2,9548,4.33015873015873,0.0,20.0
32205,3,2205,[127 121  97 496 174],59,5,9553,4.330462375339982,0.0,40.0
32206,3,2206,[483  89 197 202 153],694,5,9558,4.330765745355686,20.0,0.0
32207,3,2207,[427 302 603 100 127],666,5,9563,4.33106884057971,20.0,40.0
32208,3,2208,[117 151   8 127 176],313,3,9566,4.330466274332277,0.0,20.0
32209,3,2209,[427 302 603 100 127],458,5,9571,4.3307692307692305,20.0,40.0
32210,3,2210,[427 302 603 100 127],474,5,9576,4.331071913161465,20.0,40.0
32211,3,2211,[427 302 603 100 127],664,5,9581,4.331374321880651,20.0,40.0
32212,3,2212,[423 515 427 132 161],334,3,9584,4.330772706732942,0.0,0.0
32213,3,2213,[427 302 603 100 127],90,5,9589,4.331074977416441,20.0,40.0
32214,3,2214,[427 302 603 100 127],664,5,9594,4.3313769751693005,20.0,40.0
32215,3,2215,[427 302 603 100 127],537,5,9599,4.331678700361011,20.0,40.0
32216,3,2216,[197 286 385 215 275],7,5,9604,4.331980153360397,0.0,0.0
32217,3,2217,[427 302 603 100 127],339,5,9609,4.332281334535618,20.0,40.0
32218,3,2218,[427 302 603 100 127],458,5,9614,4.332582244254168,20.0,40.0
32219,3,2219,[427 302 603 100 127],664,5,9619,4.332882882882883,20.0,40.0
32220,3,2220,[ 22 135  69 176 197],313,4,9623,4.332733003151733,0.0,0.0
32221,3,2221,[427 302 603 100 127],339,5,9628,4.333033303330333,20.0,40.0
32222,3,2222,[427 302 603 100 127],14,4,9632,4.332883490778228,20.0,40.0
32223,3,2223,[427 302 603 100 127],14,4,9636,4.33273381294964,20.0,40.0
32224,3,2224,[185 132 211 496  15],234,2,9638,4.331685393258427,0.0,0.0
32225,3,2225,[175  69 235  28 568],378,4,9642,4.331536388140162,0.0,0.0
32226,3,2226,[427 302 603 100 127],334,5,9647,4.331836551414459,20.0,40.0
32227,3,2227,[427 302 603 100 127],339,5,9652,4.332136445242369,20.0,40.0
32228,3,2228,[427 302 603 100 127],90,5,9657,4.332436069986541,20.0,40.0
32229,3,2229,[427 302 603 100 127],13,5,9662,4.332735426008969,20.0,40.0
32230,3,2230,[427 302 603 100 127],271,5,9667,4.333034513671,20.0,40.0
32231,3,2231,[427 302 603 100 127],90,5,9672,4.333333333333333,20.0,40.0
32232,3,2232,[427 302 603 100 127],90,5,9677,4.333631885356024,20.0,40.0
32233,3,2233,[427 302 603 100 127],90,5,9682,4.333930170098478,20.0,40.0
32234,3,2234,[427 302 603 100 127],13,5,9687,4.3342281879194635,20.0,40.0
32235,3,2235,[427 302 603 100 127],339,5,9692,4.334525939177102,20.0,40.0
32236,3,2236,[427 302 603 100 127],664,5,9697,4.334823424228878,20.0,40.0
32237,3,2237,[427 302 603 100 127],339,5,9702,4.335120643431635,20.0,40.0
32238,3,2238,[427 302 603 100 127],13,5,9707,4.335417597141581,20.0,40.0
32239,3,2239,[427 302 603 100 127],334,5,9712,4.335714285714285,20.0,40.0
32240,3,2240,[427 302 603 100 127],537,5,9717,4.336010709504685,20.0,40.0
32241,3,2241,[427 302 603 100 127],334,5,9722,4.336306868867083,20.0,40.0
32242,3,2242,[427 302 603 100 127],664,5,9727,4.336602764155149,20.0,40.0
32243,3,2243,[427 302 603 100 127],474,5,9732,4.336898395721925,20.0,40.0
32244,3,2244,[427 302 603 100 127],537,5,9737,4.337193763919822,20.0,40.0
32245,3,2245,[179 483 202 496   7],666,5,9742,4.337488869100623,20.0,0.0
32246,3,2246,[427 302 603 100 496],339,5,9747,4.337783711615487,20.0,20.0
32247,3,2247,[427 302 603 100 496],474,5,9752,4.338078291814947,20.0,20.0
32248,3,2248,[318 237 515 238 385],524,3,9755,4.337483325922633,20.0,0.0
32249,3,2249,[427 302 603 100 496],666,5,9760,4.337777777777778,20.0,20.0
32250,3,2250,[322 161 435 117  79],328,4,9764,4.3376277210128835,0.0,0.0
32251,3,2251,[427 302 603 100 496],271,5,9769,4.337921847246892,20.0,20.0
32252,3,2252,[427 302 603 100 496],271,5,9774,4.338215712383489,20.0,20.0
32253,3,2253,[655  89  79 180  56],378,4,9778,4.338065661047027,0.0,0.0
32254,3,2254,[427 302 603 100 496],664,5,9783,4.3383592017738355,20.0,20.0
32255,3,2255,[ 56 172 210 269 185],883,4,9787,4.338209219858156,0.0,0.0
32256,3,2256,[427 302 603 100 496],474,5,9792,4.3385024368630924,20.0,20.0
32257,3,2257,[427 302 603 100 496],666,5,9797,4.338795394154118,20.0,20.0
32258,3,2258,[323 172 258 111 181],13,4,9801,4.338645418326693,0.0,0.0
32259,3,2259,[427 302 603 100 496],666,5,9806,4.338938053097345,20.0,20.0
32260,3,2260,[427 302 603 100 496],383,5,9811,4.3392304290137105,20.0,20.0
32261,3,2261,[427 302 603 100 496],90,5,9816,4.339522546419098,20.0,20.0
32262,3,2262,[427 302 603 100 496],474,5,9821,4.339814405656209,20.0,20.0
32263,3,2263,[427 302 603 100 496],271,5,9826,4.340106007067138,20.0,20.0
32264,3,2264,[176 289  11  96 655],234,1,9827,4.338631346578366,0.0,0.0
32265,3,2265,[427 302 603 100 496],537,5,9832,4.338923212709621,20.0,20.0
32266,3,2266,[ 89 191 144 195 185],749,5,9837,4.339214821349802,0.0,0.0
32267,3,2267,[427 302 603 100 496],90,5,9842,4.339506172839506,20.0,20.0
32268,3,2268,[427 302 603 100 496],383,5,9847,4.339797267518731,20.0,20.0
32269,3,2269,[238  56  88 153 121],184,1,9848,4.338325991189428,0.0,0.0
32270,3,2270,[176  89  95  28  12],279,1,9849,4.336856010568032,20.0,0.0
32271,3,2271,[748 483 211 117 183],788,4,9853,4.336707746478873,20.0,0.0
32272,3,2272,[427 302 603 100 496],458,4,9857,4.336559612846458,20.0,20.0
32273,3,2273,[269 322 127 275 427],13,2,9859,4.335532102022867,0.0,20.0
32274,3,2274,[427 302 603 100 496],271,5,9864,4.335824175824176,20.0,20.0
32275,3,2275,[427 302 603 100 496],458,4,9868,4.335676625659051,20.0,20.0
32276,3,2276,[121 275 211 301   1],537,2,9870,4.334650856389987,0.0,0.0
32277,3,2277,[427 302 603 100 127],666,5,9875,4.33494293239684,20.0,40.0
32278,3,2278,[427 302 603 100 127],271,5,9880,4.335234752084247,20.0,40.0
32279,3,2279,[427 302 603 100 127],339,5,9885,4.3355263157894735,20.0,40.0
32280,3,2280,[427 302 603 100 127],458,5,9890,4.335817623849189,20.0,40.0
32281,3,2281,[196 185 173 588 194],59,3,9893,4.335232252410167,0.0,0.0
32282,3,2282,[197 385 181 496 265],64,4,9897,4.335085413929041,0.0,0.0
32283,3,2283,[ 25 118 204 258 496],533,5,9902,4.3353765323993,0.0,0.0
32284,3,2284,[427 302 603 100 496],474,5,9907,4.335667396061269,20.0,20.0
32285,3,2285,[427 302 603 100 496],454,5,9912,4.335958005249344,20.0,20.0
32286,3,2286,[ 69 168 222 258 176],474,4,9916,4.3358111062527325,0.0,0.0
32287,3,2287,[301 302 216  97 328],145,5,9921,4.336101398601398,0.0,0.0
32288,3,2288,[ 12 238 286 135 318],454,1,9922,4.334643949322849,40.0,0.0
32289,3,2289,[ 82 294 144 125 117],92,3,9925,4.334061135371179,0.0,0.0
32290,3,2290,[427 302 603 100 496],454,5,9930,4.334351811436054,20.0,20.0
32291,3,2291,[  1 286 204 496   9],648,3,9933,4.3337696335078535,0.0,0.0
32292,3,2292,[181 289  64 151 269],524,2,9935,4.332751853467074,0.0,0.0
32293,3,2293,[427 302 603 100 496],334,4,9939,4.332606800348736,20.0,20.0
32294,3,2294,[228 111  71  98  22],334,3,9942,4.332026143790849,0.0,20.0
32295,3,2295,[427 302 603 100 127],334,5,9947,4.3323170731707314,20.0,40.0
32296,3,2296,[ 95  12 111  82  71],334,2,9949,4.331301697866783,20.0,0.0
32297,3,2297,[427 302 603 100 127],666,5,9954,4.331592689295039,20.0,40.0
32298,3,2298,[427 302 603 100 127],474,5,9959,4.331883427577208,20.0,40.0
32299,3,2299,[427 302 603 100 127],334,5,9964,4.332173913043478,20.0,40.0
32300,3,2300,[427 302 603 100 127],537,5,9969,4.332464146023468,20.0,40.0
32301,3,2301,[427 302 603 100 127],666,5,9974,4.332754126846221,20.0,40.0
32302,3,2302,[427 302 603 100 127],664,5,9979,4.3330438558402085,20.0,40.0
32303,3,2303,[435 196  28 182 546],271,3,9982,4.332465277777778,0.0,0.0
32304,3,2304,[427 302 603 100 127],664,5,9987,4.332754880694143,20.0,40.0
32305,3,2305,[  4 135   1 427 143],374,2,9989,4.331743278404163,0.0,0.0
32306,3,2306,[302 427 603 100 127],14,4,9993,4.331599479843953,20.0,40.0
32307,3,2307,[273 215 265 294 117],774,0,9993,4.329722703639515,0.0,0.0
32308,3,2308,[302 427 603 100 127],14,4,9997,4.329579904720658,20.0,40.0
32309,3,2309,[276 588  97 185 678],82,3,10000,4.329004329004329,0.0,0.0
32310,3,2310,[235 385  98 200 323],788,2,10002,4.32799653829511,0.0,20.0
32311,3,2311,[302 427 603 100 127],334,5,10007,4.328287197231834,20.0,40.0
32312,3,2312,[180  79 289 176  95],92,3,10010,4.3277129269347165,0.0,0.0
32313,3,2313,[302 427 603 100 127],664,5,10015,4.328003457216941,20.0,40.0
32314,3,2314,[302 427 603 100 127],664,5,10020,4.32829373650108,20.0,40.0
32315,3,2315,[302 427 603 100 127],537,5,10025,4.3285837651122625,20.0,40.0
32316,3,2316,[302 427 603 100 127],271,5,10030,4.328873543375054,20.0,40.0
32317,3,2317,[302 427 603 100 127],271,5,10035,4.3291630716134595,20.0,40.0
32318,3,2318,[302 427 603 100 127],14,4,10039,4.329021129797327,20.0,40.0
32319,3,2319,[302 427 603 100 127],666,5,10044,4.3293103448275865,20.0,40.0
32320,3,2320,[132 235 176 257 265],92,2,10046,4.328306764325721,0.0,0.0
32321,3,2321,[302 427 603 100 127],745,4,10050,4.328165374677003,20.0,40.0
32322,3,2322,[ 28 187 471 216 435],308,2,10052,4.327163151097719,0.0,0.0
32323,3,2323,[302 427 603 100 127],90,5,10057,4.327452667814113,20.0,40.0
32324,3,2324,[302 427 603 100 127],474,5,10062,4.327741935483871,20.0,40.0
32325,3,2325,[302 427 603 100 127],90,5,10067,4.328030954428203,20.0,40.0
32326,3,2326,[302 427 603 100 127],537,5,10072,4.32831972496777,20.0,40.0
32327,3,2327,[302 427 603 100 127],339,5,10077,4.328608247422681,20.0,40.0
32328,3,2328,[302 427 603 100 127],458,5,10082,4.328896522112495,20.0,40.0
32329,3,2329,[302 427 603 100 127],14,4,10086,4.328755364806867,20.0,40.0
32330,3,2330,[302 427 603 100 127],13,5,10091,4.329043329043329,20.0,40.0
32331,3,2331,[588 215 328 496 234],537,1,10092,4.327615780445969,0.0,0.0
32332,3,2332,[302 427 603 100 127],334,5,10097,4.327903986283755,20.0,40.0
32333,3,2333,[302 427 603 100 127],537,5,10102,4.328191945158526,20.0,40.0
32334,3,2334,[302 427 603 100 127],13,5,10107,4.328479657387581,20.0,40.0
32335,3,2335,[302 427 603 100 127],458,5,10112,4.328767123287672,20.0,40.0
32336,3,2336,[302 427 603 100 127],664,5,10117,4.32905434317501,20.0,40.0
32337,3,2337,[302 427 603 100 127],745,4,10121,4.328913601368691,20.0,40.0
32338,3,2338,[302 427 603 100 127],13,5,10126,4.32920051303976,20.0,40.0
32339,3,2339,[302 427 603 100 127],334,5,10131,4.329487179487179,20.0,40.0
32340,3,2340,[302 427 603 100 127],458,5,10136,4.329773601025203,20.0,40.0
32341,3,2341,[302 427 603 100 127],474,5,10141,4.330059777967549,20.0,40.0
32342,3,2342,[257 275 216 175 405],334,3,10144,4.329492104139992,0.0,0.0
32343,3,2343,[302 427 603 100 127],458,5,10149,4.329778156996587,20.0,40.0
32344,3,2344,[302 427 603 100 127],474,5,10154,4.330063965884861,20.0,40.0
32345,3,2345,[302 427 603 100 127],90,5,10159,4.330349531116794,20.0,40.0
32346,3,2346,[302 427 603 100 127],271,5,10164,4.3306348530038346,20.0,40.0
32347,3,2347,[302 427 603 100 127],14,4,10168,4.330494037478705,20.0,40.0
32348,3,2348,[302 427 603 100 127],474,5,10173,4.330779054916986,20.0,40.0
32349,3,2349,[197  70 118  88  64],308,3,10176,4.330212765957447,0.0,0.0
32350,3,2350,[238 273 515 186   4],13,2,10178,4.329221607826457,0.0,0.0
32351,3,2351,[302 427 603 100 127],271,5,10183,4.329506802721088,20.0,40.0
32352,3,2352,[302 427 603 100 127],13,5,10188,4.32979175520612,20.0,40.0
32353,3,2353,[302 427 603 100 127],13,5,10193,4.330076465590484,20.0,40.0
32354,3,2354,[196   8 235 405 100],87,4,10197,4.329936305732484,0.0,20.0
32355,3,2355,[302 427 603 100 127],90,5,10202,4.330220713073005,20.0,40.0
32356,3,2356,[302 427 603 100 127],334,5,10207,4.3305048790835805,20.0,40.0
32357,3,2357,[302 427 603 100 127],664,5,10212,4.330788804071247,20.0,40.0
32358,3,2358,[176 195 385 179 483],932,4,10216,4.3306485799067405,20.0,0.0
32359,3,2359,[216 132 588 168 423],843,0,10216,4.328813559322034,0.0,0.0
32360,3,2360,[302 427 603 100 127],537,5,10221,4.329097839898348,20.0,40.0
32361,3,2361,[302 427 603 100 127],666,5,10226,4.329381879762913,20.0,40.0
32362,3,2362,[191  98 302 118 187],543,4,10230,4.329242488362252,0.0,20.0
32363,3,2363,[302 427 603 100 127],14,4,10234,4.329103214890017,20.0,40.0
32364,3,2364,[302 427 603 100 127],666,5,10239,4.32938689217759,20.0,40.0
32365,3,2365,[302 427 603 100 127],14,4,10243,4.329247675401522,20.0,40.0
32366,3,2366,[271 185 202 328 111],13,2,10245,4.328263624841572,0.0,0.0
32367,3,2367,[302 427 603 100 127],334,5,10250,4.328547297297297,20.0,40.0
32368,3,2368,[183 597 357 273 210],774,1,10251,4.32714225411566,20.0,0.0
32369,3,2369,[302 427 603 100 127],271,5,10256,4.327426160337553,20.0,40.0
32370,3,2370,[302 427 603 100 127],745,4,10260,4.327288064107972,20.0,40.0
32371,3,2371,[  8   4 222 202 475],13,3,10263,4.32672849915683,0.0,0.0
32372,3,2372,[302 427 603 100 127],271,5,10268,4.32701222081753,20.0,40.0
32373,3,2373,[302 427 603 100 127],745,4,10272,4.32687447346251,20.0,40.0
32374,3,2374,[742 423 245  50 300],454,3,10275,4.326315789473684,0.0,20.0
32375,3,2375,[302 427 603 100 127],339,5,10280,4.326599326599327,20.0,40.0
32376,3,2376,[302 427 603 100 127],458,5,10285,4.3268826251577615,20.0,40.0
32377,3,2377,[302 427 603 100 127],664,5,10290,4.327165685449958,20.0,40.0
32378,3,2378,[302 427 603 100 127],339,5,10295,4.327448507776377,20.0,40.0
32379,3,2379,[302 427 603 100 127],745,4,10299,4.327310924369748,20.0,40.0
32380,3,2380,[302 427 603 100 127],271,5,10304,4.327593448131037,20.0,40.0
32381,3,2381,[302 427 603 100 127],334,5,10309,4.327875734676742,20.0,40.0
32382,3,2382,[302 427 603 100 127],458,5,10314,4.328157784305497,20.0,40.0
32383,3,2383,[302 427 603 100 127],745,4,10318,4.328020134228188,20.0,40.0
32384,3,2384,[182 197   7 483  97],881,2,10320,4.327044025157233,20.0,0.0
32385,3,2385,[302 427 603 100 127],13,5,10325,4.327326068734283,20.0,40.0
32386,3,2386,[302 427 603 100 127],666,5,10330,4.327607875994973,20.0,40.0
32387,3,2387,[302 427 603 100 127],458,5,10335,4.327889447236181,20.0,40.0
32388,3,2388,[302 427 603 100 127],339,5,10340,4.328170782754291,20.0,40.0
32389,3,2389,[258 403  79  12 153],788,3,10343,4.327615062761506,20.0,0.0
32390,3,2390,[302 427 603 100 127],664,5,10348,4.327896277708072,20.0,40.0
32391,3,2391,[302 427 603 100 127],664,5,10353,4.328177257525083,20.0,40.0
32392,3,2392,[496  98 127 405 173],666,4,10357,4.32804011700794,0.0,40.0
32393,3,2393,[515  56 202   9  69],308,3,10360,4.3274853801169595,0.0,0.0
32394,3,2394,[302 427 603 100 127],90,5,10365,4.32776617954071,20.0,40.0
32395,3,2395,[302 427 603 100 127],339,5,10370,4.328046744574291,20.0,40.0
32396,3,2396,[191  50 127  70 282],334,4,10374,4.327909887359199,0.0,40.0
32397,3,2397,[302 427 603 100 127],271,5,10379,4.328190158465388,20.0,40.0
32398,3,2398,[276 597 153 118 111],92,2,10381,4.327219674864527,0.0,0.0
32399,3,2399,[302 427 603 100 127],339,5,10386,4.3275,20.0,40.0
32400,3,2400,[302 427 603 100 127],334,5,10391,4.3277800916284885,20.0,40.0
32401,3,2401,[302 427 603 100 127],664,5,10396,4.328059950041632,20.0,40.0
32402,3,2402,[302 427 603 100 127],90,5,10401,4.3283395755305865,20.0,40.0
32403,3,2403,[302 427 603 100 127],474,5,10406,4.3286189683860234,20.0,40.0
32404,3,2404,[302 427 603 100 127],537,5,10411,4.328898128898129,20.0,40.0
32405,3,2405,[302 427 603 100 127],666,5,10416,4.329177057356609,20.0,40.0
32406,3,2406,[302 427 603 100 127],334,5,10421,4.329455754050685,20.0,40.0
32407,3,2407,[302 427 603 100 127],334,5,10426,4.329734219269103,20.0,40.0
32408,3,2408,[302 427 603 100 127],458,5,10431,4.3300124533001245,20.0,40.0
32409,3,2409,[211 118  82 125 403],788,1,10432,4.328630705394191,0.0,0.0
32410,3,2410,[302 427 603 100 127],745,4,10436,4.328494400663625,20.0,40.0
32411,3,2411,[496 427 181 204 183],7,4,10440,4.3283582089552235,0.0,0.0
32412,3,2412,[302 427 603 100 127],474,5,10445,4.328636552009946,20.0,40.0
32413,3,2413,[257 175  98 121  11],666,3,10448,4.328086164043082,0.0,20.0
32414,3,2414,[302 427 603 100 127],745,4,10452,4.3279503105590065,20.0,40.0
32415,3,2415,[302 427 603 100 127],474,5,10457,4.3282284768211925,20.0,40.0
32416,3,2416,[125 143 117 179 191],200,5,10462,4.328506412908564,0.0,0.0
32417,3,2417,[302 427 603 100 127],664,5,10467,4.328784119106699,20.0,40.0
32418,3,2418,[302 427 603 100 127],474,5,10472,4.329061595700702,20.0,40.0
32419,3,2419,[302 427 603 100 127],271,5,10477,4.329338842975207,20.0,40.0
32420,3,2420,[302 427 603 100 127],458,5,10482,4.329615861214374,20.0,40.0
32421,3,2421,[748 172 483  71  11],13,4,10486,4.329479768786127,20.0,0.0
32422,3,2422,[302 427 603 100 127],90,5,10491,4.329756500206356,20.0,40.0
32423,3,2423,[302 427 603 100 127],458,5,10496,4.33003300330033,20.0,40.0
32424,3,2424,[301 318 655 182 172],328,3,10499,4.329484536082474,20.0,0.0
32425,3,2425,[ 22 265 176 496 210],533,3,10502,4.328936521022259,0.0,0.0
32426,3,2426,[302 427 603 100 496],271,5,10507,4.329213020189535,20.0,20.0
32427,3,2427,[121 202 328 245 183],313,4,10511,4.329077429983526,0.0,0.0
32428,3,2428,[302 427 603 100 496],339,5,10516,4.329353643474681,20.0,20.0
32429,3,2429,[186 204  82   9  70],13,2,10518,4.328395061728395,0.0,0.0
32430,3,2430,[302 427 603 100 496],537,5,10523,4.328671328671328,20.0,20.0
32431,3,2431,[302 427 603 100 496],334,4,10527,4.3285361842105265,20.0,20.0
32432,3,2432,[302 427 603 100 127],666,5,10532,4.3288121660501435,20.0,40.0
32433,3,2433,[235 127 496 588  97],406,5,10537,4.329087921117502,0.0,20.0
32434,3,2434,[302 427 603 100 127],339,5,10542,4.329363449691992,20.0,40.0
32435,3,2435,[302 427 603 100 127],90,5,10547,4.329638752052545,20.0,40.0
32436,3,2436,[302 427 603 100 127],339,5,10552,4.329913828477636,20.0,40.0
32437,3,2437,[302 427 603 100 127],271,5,10557,4.330188679245283,20.0,40.0
32438,3,2438,[302 427 603 100 127],664,5,10562,4.330463304633047,20.0,40.0
32439,3,2439,[568 238 385 182  50],95,4,10566,4.330327868852459,0.0,20.0
32440,3,2440,[302 427 603 100 127],458,5,10571,4.330602212208111,20.0,40.0
32441,3,2441,[302 427 603 100 127],334,5,10576,4.330876330876331,20.0,40.0
32442,3,2442,[302 427 603 100 127],537,5,10581,4.331150225133033,20.0,40.0
32443,3,2443,[302 427 603 100 127],745,4,10585,4.3310147299509,20.0,40.0
32444,3,2444,[257 588 385  89  28],899,3,10588,4.330470347648261,0.0,0.0
32445,3,2445,[  1 265 173 176 161],804,5,10593,4.330744071954211,0.0,0.0
32446,3,2446,[302 427 603 100 127],334,5,10598,4.331017572537801,20.0,40.0
32447,3,2447,[302 427 603 100 127],537,5,10603,4.331290849673203,20.0,40.0
32448,3,2448,[  8 234 603 216  95],308,3,10606,4.330747243772969,20.0,0.0
32449,3,2449,[302 427 603 100 127],334,5,10611,4.3310204081632655,20.0,40.0
32450,3,2450,[302 427 603 100 127],339,5,10616,4.331293349653203,20.0,40.0
32451,3,2451,[302 427 603 100 127],745,4,10620,4.33115823817292,20.0,40.0
32452,3,2452,[302 427 603 100 127],13,5,10625,4.331430900937628,20.0,40.0
32453,3,2453,[302 427 603 100 127],14,4,10629,4.331295843520782,20.0,40.0
32454,3,2454,[302 427 603 100 127],537,5,10634,4.3315682281059065,20.0,40.0
32455,3,2455,[302 427 603 100 127],90,5,10639,4.331840390879479,20.0,40.0
32456,3,2456,[282 515 257 100 313],92,4,10643,4.331705331705332,0.0,20.0
32457,3,2457,[302 427 603 100 127],474,5,10648,4.331977217249797,20.0,40.0
32458,3,2458,[302 427 603 100 127],271,5,10653,4.332248881659211,20.0,40.0
32459,3,2459,[302 427 603 100 127],745,4,10657,4.332113821138211,20.0,40.0
32460,3,2460,[302 427 603 100 127],14,4,10661,4.331978870377895,20.0,40.0
32461,3,2461,[742 202  22 118  28],533,5,10666,4.332250203086921,0.0,0.0
32462,3,2462,[302 427 603 100 127],666,5,10671,4.332521315468941,20.0,40.0
32463,3,2463,[302 427 603 100 127],339,5,10676,4.332792207792208,20.0,40.0
32464,3,2464,[302 427 603 100 127],666,5,10681,4.333062880324544,20.0,40.0
32465,3,2465,[302 127  98 151 423],6,3,10684,4.332522303325223,0.0,40.0
32466,3,2466,[301   4 197 288 173],650,2,10686,4.331576813944062,0.0,0.0
32467,3,2467,[204   1 176 742  88],881,4,10690,4.331442463533225,0.0,0.0
32468,3,2468,[302 427 603 100 127],474,5,10695,4.331713244228433,20.0,40.0
32469,3,2469,[257 173 175   1  79],339,5,10700,4.331983805668016,0.0,0.0
32470,3,2470,[302 427 603 100 127],745,4,10704,4.3318494536624845,20.0,40.0
32471,3,2471,[302 427 603 100 127],458,5,10709,4.332119741100324,20.0,40.0
32472,3,2472,[302 427 603 100 127],13,5,10714,4.332389809947432,20.0,40.0
32473,3,2473,[546 181 151 153  50],795,1,10715,4.33104284559418,0.0,20.0
32474,3,2474,[302 427 603 100 127],334,5,10720,4.331313131313132,20.0,40.0
32475,3,2475,[302 427 603 100 127],14,4,10724,4.331179321486268,20.0,40.0
32476,3,2476,[302 427 603 100 127],474,5,10729,4.3314493338716185,20.0,40.0
32477,3,2477,[302 427 603 100 127],13,5,10734,4.331719128329298,20.0,40.0
32478,3,2478,[302 427 603 100 127],334,5,10739,4.331988705123034,20.0,40.0
32479,3,2479,[302 427 603 100 127],474,5,10744,4.332258064516129,20.0,40.0
32480,3,2480,[302 427 603 100 127],474,5,10749,4.332527206771463,20.0,40.0
32481,3,2481,[302 427 603 100 127],14,4,10753,4.332393231265109,20.0,40.0
32482,3,2482,[174 265 202 153 742],374,4,10757,4.332259363672976,0.0,20.0
32483,3,2483,[302 427 603 100 127],14,4,10761,4.332125603864735,20.0,40.0
32484,3,2484,[475 742 597 275 282],533,3,10764,4.33158953722334,0.0,0.0
32485,3,2485,[588 127 176   7 194],10,5,10769,4.331858407079646,0.0,20.0
32486,3,2486,[302 427 603 100 127],334,5,10774,4.332127060715722,20.0,40.0
32487,3,2487,[302 427 603 100 127],537,5,10779,4.332395498392283,20.0,40.0
32488,3,2488,[302 427 603 100 127],474,5,10784,4.332663720369626,20.0,40.0
32489,3,2489,[302 427 603 100 127],13,5,10789,4.33293172690763,20.0,40.0
32490,3,2490,[302 427 603 100 127],666,5,10794,4.333199518265757,20.0,40.0
32491,3,2491,[ 89 144 403 742 173],387,2,10796,4.332263242375602,0.0,0.0
32492,3,2492,[302 427 603 100 127],666,5,10801,4.332531087043723,20.0,40.0
32493,3,2493,[302 427 603 100 127],458,5,10806,4.3327987169206095,20.0,40.0
32494,3,2494,[302 427 603 100 127],666,5,10811,4.333066132264529,20.0,40.0
32495,3,2495,[ 11 508 179 286   9],334,4,10815,4.3329326923076925,0.0,0.0
32496,3,2496,[302 427 603 100 127],14,4,10819,4.332799359231077,20.0,40.0
32497,3,2497,[195  96 153 568  98],28,4,10823,4.332666132906325,0.0,20.0
32498,3,2498,[302 427 603 100 127],745,4,10827,4.332533013205282,20.0,40.0
32499,3,2499,[597 405   8 265 655],328,3,10830,4.332,0.0,0.0
32500,3,2500,[181 294 234 423  88],897,3,10833,4.331467413034786,0.0,0.0
32501,3,2501,[202 215 222 127 143],479,3,10836,4.330935251798561,0.0,20.0
32502,3,2502,[222  64 258  56  88],234,1,10837,4.329604474630443,0.0,0.0
32503,3,2503,[302 427 603 100 127],339,5,10842,4.329872204472843,20.0,40.0
32504,3,2504,[302 427 603 100 127],666,5,10847,4.330139720558882,20.0,40.0
32505,3,2505,[302 427 603 100 127],14,4,10851,4.33000798084597,20.0,40.0
32506,3,2506,[302 427 603 100 127],339,5,10856,4.330275229357798,20.0,40.0
32507,3,2507,[174 496 265 216 483],848,4,10860,4.330143540669856,20.0,20.0
32508,3,2508,[302 427 603 100 127],745,4,10864,4.330011956954962,20.0,40.0
32509,3,2509,[179 273 175 176 603],308,4,10868,4.32988047808765,20.0,0.0
32510,3,2510,[302 427 603 100 127],90,5,10873,4.330147351652728,20.0,40.0
32511,3,2511,[302 427 603 100 127],90,5,10878,4.330414012738854,20.0,40.0
32512,3,2512,[302 427 603 100 127],666,5,10883,4.330680461599681,20.0,40.0
32513,3,2513,[302 427 603 100 127],14,4,10887,4.33054892601432,20.0,40.0
32514,3,2514,[302 427 603 100 127],458,5,10892,4.330815109343936,20.0,40.0
32515,3,2515,[302 427 603 100 127],13,5,10897,4.331081081081081,20.0,40.0
32516,3,2516,[302 427 603 100 127],474,5,10902,4.33134684147795,20.0,40.0
32517,3,2517,[302 427 603 100 127],334,5,10907,4.331612390786338,20.0,40.0
32518,3,2518,[ 98 237 132  71 204],378,5,10912,4.331877729257642,0.0,20.0
32519,3,2519,[185 195 216 357 161],210,5,10917,4.332142857142857,20.0,0.0
32520,3,2520,[275 132 423   9 111],334,3,10920,4.331614438714796,0.0,0.0
32521,3,2521,[302 427 603 100 127],334,5,10925,4.33187946074544,20.0,40.0
32522,3,2522,[302 427 603 100 127],664,5,10930,4.332144272691241,20.0,40.0
32523,3,2523,[302 427 603 100 127],90,5,10935,4.332408874801902,20.0,40.0
32524,3,2524,[210  56  95 228  98],374,5,10940,4.332673267326733,0.0,20.0
32525,3,2525,[302 427 603 100 127],14,4,10944,4.332541567695962,20.0,40.0
32526,3,2526,[302 427 603 100 127],537,5,10949,4.332805698456668,20.0,40.0
32527,3,2527,[168   7 588 161   8],387,3,10952,4.332278481012659,0.0,0.0
32528,3,2528,[100 405  69 118  97],7,3,10955,4.3317516805061285,0.0,20.0
32529,3,2529,[603  79  82 238 144],749,4,10959,4.331620553359683,20.0,0.0
32530,3,2530,[302 427 603 100 127],474,5,10964,4.331884630580798,20.0,40.0
32531,3,2531,[302 427 603 100 127],537,5,10969,4.332148499210111,20.0,40.0
32532,3,2532,[302 427 603 100 127],271,5,10974,4.3324121594946705,20.0,40.0
32533,3,2533,[302 427 603 100 127],474,5,10979,4.332675611681137,20.0,40.0
32534,3,2534,[302 427 603 100 127],13,5,10984,4.332938856015779,20.0,40.0
32535,3,2535,[302 427 603 100 127],14,4,10988,4.332807570977918,20.0,40.0
32536,3,2536,[302 427 603 100 127],13,5,10993,4.333070555774537,20.0,40.0
32537,3,2537,[302 427 603 100 127],90,5,10998,4.333333333333333,20.0,40.0
32538,3,2538,[302 427 603 100 127],745,4,11002,4.333202048050413,20.0,40.0
32539,3,2539,[302 427 603 100 127],474,5,11007,4.333464566929134,20.0,40.0
32540,3,2540,[302 427 603 100 127],339,5,11012,4.333726879181425,20.0,40.0
32541,3,2541,[302 427 603 100 127],458,5,11017,4.333988985051141,20.0,40.0
32542,3,2542,[302 427 603 100 127],474,5,11022,4.334250884781754,20.0,40.0
32543,3,2543,[ 28 228 182 273  64],774,2,11024,4.333333333333333,0.0,0.0
32544,3,2544,[302 427 603 100 127],90,5,11029,4.333595284872299,20.0,40.0
32545,3,2545,[302 427 603 100 127],339,5,11034,4.333857030636292,20.0,40.0
32546,3,2546,[302 427 603 100 127],90,5,11039,4.3341185708676875,20.0,40.0
32547,3,2547,[302 427 603 100 127],666,5,11044,4.334379905808477,20.0,40.0
32548,3,2548,[435 403 187 194 176],64,5,11049,4.334641035700274,0.0,0.0
32549,3,2549,[302 427 603 100 127],458,5,11054,4.334901960784314,20.0,40.0
32550,3,2550,[302 427 603 100 127],90,5,11059,4.33516268130145,20.0,40.0
32551,3,2551,[302 427 603 100 127],458,5,11064,4.335423197492163,20.0,40.0
32552,3,2552,[302 427 603 100 127],90,5,11069,4.335683509596553,20.0,40.0
32553,3,2553,[568 195 196 282  11],881,4,11073,4.335552075176194,0.0,0.0
32554,3,2554,[603  56  50 300 597],13,3,11076,4.335029354207436,20.0,20.0
32555,3,2555,[174  95 289 288  28],537,0,11076,4.333333333333333,0.0,20.0
32556,3,2556,[194 144 597 423 153],7,4,11080,4.333202972233086,0.0,0.0
32557,3,2557,[302 427 603 100 127],339,5,11085,4.333463643471462,20.0,40.0
32558,3,2558,[302 427 603 100 127],474,5,11090,4.333724110980852,20.0,40.0
32559,3,2559,[  4 385 496 204 191],379,4,11094,4.33359375,0.0,0.0
32560,3,2560,[588 204  56 211  82],311,4,11098,4.333463490823897,0.0,0.0
32561,3,2561,[202 748 161 294 435],102,1,11099,4.332162373145979,0.0,0.0
32562,3,2562,[302 427 603 100 127],474,5,11104,4.332422941865002,20.0,40.0
32563,3,2563,[302 427 603 100 127],537,5,11109,4.332683307332293,20.0,40.0
32564,3,2564,[302 427 603 100 127],90,5,11114,4.332943469785575,20.0,40.0
32565,3,2565,[302 427 603 100 127],474,5,11119,4.333203429462198,20.0,40.0
32566,3,2566,[302 427 603 100 127],745,4,11123,4.333073626801714,20.0,40.0
32567,3,2567,[ 28 202 200 588 276],378,3,11126,4.332554517133956,0.0,0.0
32568,3,2568,[302 427 603 100 127],664,5,11131,4.332814324639938,20.0,40.0
32569,3,2569,[302 427 603 100 127],664,5,11136,4.333073929961089,20.0,40.0
32570,3,2570,[302 427 603 100 127],339,5,11141,4.333333333333333,20.0,40.0
32571,3,2571,[302 427 603 100 127],458,5,11146,4.333592534992224,20.0,40.0
32572,3,2572,[302 427 603 100 127],664,5,11151,4.33385153517295,20.0,40.0
32573,3,2573,[302 427 603 100 127],90,5,11156,4.334110334110334,20.0,40.0
32574,3,2574,[302 427 603 100 127],14,4,11160,4.333980582524272,20.0,40.0
32575,3,2575,[302 427 603 100 127],745,4,11164,4.333850931677019,20.0,40.0
32576,3,2576,[238  28 216 286 318],488,2,11166,4.3329452852153665,20.0,0.0
32577,3,2577,[597 185 228  95 269],13,2,11168,4.332040341349884,0.0,0.0
32578,3,2578,[302 427 603 100 127],666,5,11173,4.332299340829779,20.0,40.0
32579,3,2579,[302 427 603 100 127],334,5,11178,4.332558139534884,20.0,40.0
32580,3,2580,[302 427 603 100 127],537,5,11183,4.3328167376985665,20.0,40.0
32581,3,2581,[302 427 603 100 127],745,4,11187,4.332687838884586,20.0,40.0
32582,3,2582,[302 427 603 100 127],458,5,11192,4.332946186604723,20.0,40.0
32583,3,2583,[302 427 603 100 127],334,5,11197,4.333204334365325,20.0,40.0
32584,3,2584,[302 427 603 100 127],664,5,11202,4.333462282398453,20.0,40.0
32585,3,2585,[ 12  95 496 182 153],406,4,11206,4.333333333333333,20.0,0.0
32586,3,2586,[302 427 603 100 127],458,5,11211,4.333591032083494,20.0,40.0
32587,3,2587,[302 427 603 100 127],271,5,11216,4.333848531684699,20.0,40.0
32588,3,2588,[302 427 603 100 127],666,5,11221,4.33410583236771,20.0,40.0
32589,3,2589,[302 427 603 100 127],14,4,11225,4.333976833976834,20.0,40.0
32590,3,2590,[302 427 603 100 127],90,5,11230,4.334233886530297,20.0,40.0
32591,3,2591,[302 427 603 100 127],537,5,11235,4.3344907407407405,20.0,40.0
32592,3,2592,[302 427 603 100 127],745,4,11239,4.3343617431546475,20.0,40.0
32593,3,2593,[302 427 603 100 127],666,5,11244,4.334618350038551,20.0,40.0
32594,3,2594,[302 427 603 100 127],745,4,11248,4.334489402697495,20.0,40.0
32595,3,2595,[483  88  97 179 194],95,3,11251,4.333975346687211,20.0,0.0
32596,3,2596,[196 300 174  11 515],271,4,11255,4.333846746245668,0.0,20.0
32597,3,2597,[302 427 603 100 127],458,5,11260,4.334103156274057,20.0,40.0
32598,3,2598,[302 427 603 100 127],334,5,11265,4.334359368988072,20.0,40.0
32599,3,2599,[258 175 269 179  95],738,3,11268,4.333846153846154,0.0,0.0
32600,3,2600,[302 427 603 100 127],458,5,11273,4.334102268358324,20.0,40.0
32601,3,2601,[302 427 603 100 127],666,5,11278,4.334358186010761,20.0,40.0
32602,3,2602,[302 427 603 100 127],339,5,11283,4.3346139070303495,20.0,40.0
32603,3,2603,[302 427 603 100 127],13,5,11288,4.334869431643625,20.0,40.0
32604,3,2604,[302 427 603 100 127],13,5,11293,4.335124760076775,20.0,40.0
32605,3,2605,[302 427 603 100 127],745,4,11297,4.334996162701458,20.0,40.0
32606,3,2606,[302 427 603 100 127],334,5,11302,4.335251246643652,20.0,40.0
32607,3,2607,[ 88 117 180 168 234],313,3,11305,4.334739263803681,0.0,0.0
32608,3,2608,[ 96 132 202   4 405],881,2,11307,4.333844384821771,0.0,0.0
32609,3,2609,[302 427 603 100 127],664,5,11312,4.3340996168582375,20.0,40.0
32610,3,2610,[302 427 603 100 127],334,5,11317,4.334354653389506,20.0,40.0
32611,3,2611,[276  56  82 508  95],59,4,11321,4.334226646248085,0.0,0.0
32612,3,2612,[180 237 215 144 238],378,3,11324,4.333716035208573,0.0,0.0
32613,3,2613,[ 98 357 483 195 111],899,5,11329,4.3339709257842385,40.0,20.0
32614,3,2614,[302 427 603 100 127],13,5,11334,4.334225621414914,20.0,40.0
32615,3,2615,[118 546   8  89  71],13,4,11338,4.334097859327217,0.0,0.0
32616,3,2616,[302 427 603 100 127],664,5,11343,4.334352311807413,20.0,40.0
32617,3,2617,[302 427 603 100 127],271,5,11348,4.3346065699006875,20.0,40.0
32618,3,2618,[302 427 603 100 127],13,5,11353,4.334860633829706,20.0,40.0
32619,3,2619,[172 144 588 288 185],13,3,11356,4.334351145038168,0.0,0.0
32620,3,2620,[302 427 603 100 127],339,5,11361,4.3346051125524605,20.0,40.0
32621,3,2621,[302 427 603 100 127],271,5,11366,4.334858886346301,20.0,40.0
32622,3,2622,[302 427 603 100 127],745,4,11370,4.334731223789554,20.0,40.0
32623,3,2623,[302 427 603 100 127],339,5,11375,4.334984756097561,20.0,40.0
32624,3,2624,[100  97 121 135 185],653,3,11378,4.334476190476191,0.0,20.0
32625,3,2625,[179 132 265 182 235],378,4,11382,4.334348819497334,0.0,0.0
32626,3,2626,[302 427 603 100 127],271,5,11387,4.334602207841645,20.0,40.0
32627,3,2627,[302 427 603 100 127],90,5,11392,4.334855403348554,20.0,40.0
32628,3,2628,[302 427 603 100 127],13,5,11397,4.335108406238113,20.0,40.0
32629,3,2629,[302 427 603 100 127],334,5,11402,4.335361216730038,20.0,40.0
32630,3,2630,[302 427 603 100 127],271,5,11407,4.335613835043709,20.0,40.0
32631,3,2631,[302 427 603 100 127],13,5,11412,4.335866261398176,20.0,40.0
32632,3,2632,[302 427 603 100 127],339,5,11417,4.336118496012153,20.0,40.0
32633,3,2633,[302 427 603 100 127],334,5,11422,4.336370539104024,20.0,40.0
32634,3,2634,[405 111 197   1 210],374,4,11426,4.336242884250474,0.0,0.0
32635,3,2635,[302 427 603 100 127],271,5,11431,4.33649468892261,20.0,40.0
32636,3,2636,[302 427 603 100 127],474,5,11436,4.33674630261661,20.0,40.0
32637,3,2637,[ 79 269 655 118 181],666,2,11438,4.335860500379075,0.0,0.0
32638,3,2638,[302 427 603 100 127],271,5,11443,4.33611216369837,20.0,40.0
32639,3,2639,[302 427 603 100 127],745,4,11447,4.335984848484848,20.0,40.0
32640,3,2640,[  4 258  71 135 603],387,3,11450,4.335478985232866,20.0,0.0
32641,3,2641,[302 427 603 100 127],271,5,11455,4.3357305071915215,20.0,40.0
32642,3,2642,[302 427 603 100 127],13,5,11460,4.3359818388195235,20.0,40.0
32643,3,2643,[427 323 125 301 597],788,0,11460,4.334341906202723,0.0,0.0
32644,3,2644,[302 427 603 100 127],666,5,11465,4.334593572778828,20.0,40.0
32645,3,2645,[234  79  56  98 235],200,4,11469,4.334467120181406,0.0,20.0
32646,3,2646,[302 427 603 100 127],271,5,11474,4.334718549301096,20.0,40.0
32647,3,2647,[546 318 216 678 195],648,3,11477,4.334214501510574,20.0,0.0
32648,3,2648,[302 427 603 100 127],537,5,11482,4.334465836164591,20.0,40.0
32649,3,2649,[302 427 603 100 127],271,5,11487,4.334716981132075,20.0,40.0
32650,3,2650,[228 289 168 742 161],533,4,11491,4.3345907204828364,0.0,0.0
32651,3,2651,[302 427 603 100 127],334,5,11496,4.334841628959276,20.0,40.0
32652,3,2652,[302 427 603 100 127],13,5,11501,4.33509234828496,20.0,40.0
32653,3,2653,[302 427 603 100 127],537,5,11506,4.3353428786737,20.0,40.0
32654,3,2654,[302 427 603 100 127],339,5,11511,4.335593220338983,20.0,40.0
32655,3,2655,[302 427 603 100 127],339,5,11516,4.335843373493976,20.0,40.0
32656,3,2656,[508  82 301 125 175],334,2,11518,4.334964245389537,0.0,0.0
32657,3,2657,[302 427 603 100 127],537,5,11523,4.3352144469525955,20.0,40.0
32658,3,2658,[302 427 603 100 127],745,4,11527,4.335088379089884,20.0,40.0
32659,3,2659,[748 302 286 276 175],883,4,11531,4.334962406015038,0.0,0.0
32660,3,2660,[132 273 238 174   7],59,4,11535,4.334836527621195,0.0,20.0
32661,3,2661,[302 427 603 100 127],666,5,11540,4.335086401202104,20.0,40.0
32662,3,2662,[302 427 603 100 127],90,5,11545,4.3353360871197895,20.0,40.0
32663,3,2663,[302 427 603 100 127],14,4,11549,4.33521021021021,20.0,40.0
32664,3,2664,[302 427 603 100 127],90,5,11554,4.3354596622889305,20.0,40.0
32665,3,2665,[  1 144   9 588 568],194,4,11558,4.335333833458365,0.0,0.0
32666,3,2666,[302 427 603 100 127],334,5,11563,4.335583052118485,20.0,40.0
32667,3,2667,[427  64  82 289  28],85,2,11565,4.334707646176912,0.0,0.0
32668,3,2668,[302 427 603 100 127],339,5,11570,4.3349569127013865,20.0,40.0
32669,3,2669,[302 427 603 100 127],537,5,11575,4.335205992509363,20.0,40.0
32670,3,2670,[302 427 603 100 127],334,5,11580,4.335454885810558,20.0,40.0
32671,3,2671,[302 427 603 100 127],271,5,11585,4.3357035928143715,20.0,40.0
32672,3,2672,[302 427 603 100 127],334,5,11590,4.335952113729891,20.0,40.0
32673,3,2673,[302 427 603 100 127],458,5,11595,4.336200448765894,20.0,40.0
32674,3,2674,[302 427 603 100 127],458,5,11600,4.336448598130841,20.0,40.0
32675,3,2675,[302 427 603 100 127],458,5,11605,4.336696562032885,20.0,40.0
32676,3,2676,[302 427 603 100 127],90,5,11610,4.336944340679866,20.0,40.0
32677,3,2677,[  7 471 191  12  25],343,4,11614,4.336818521284541,20.0,0.0
32678,3,2678,[302 427 603 100 127],90,5,11619,4.337066069428891,20.0,40.0
32679,3,2679,[302 427 603 100 127],90,5,11624,4.3373134328358205,20.0,40.0
32680,3,2680,[423 200  50 179   7],815,4,11628,4.337187616560985,0.0,20.0
32681,3,2681,[302 427 603 100 127],334,5,11633,4.337434750186428,20.0,40.0
32682,3,2682,[302 427 603 100 127],664,5,11638,4.337681699590012,20.0,40.0
32683,3,2683,[302 427 603 100 127],14,4,11642,4.337555886736214,20.0,40.0
32684,3,2684,[302 427 603 100 127],664,5,11647,4.33780260707635,20.0,40.0
32685,3,2685,[168 235 153 328 423],479,3,11650,4.337304542069993,0.0,0.0
32686,3,2686,[302 427 603 100 127],745,4,11654,4.337179010048381,20.0,40.0
32687,3,2687,[302 427 603 100 127],271,5,11659,4.337425595238095,20.0,40.0
32688,3,2688,[302 427 603 100 127],14,4,11663,4.3373001115656376,20.0,40.0
32689,3,2689,[323  12  22  88  97],474,4,11667,4.337174721189591,20.0,0.0
32690,3,2690,[302 427 603 100 127],334,5,11672,4.337421033073207,20.0,40.0
32691,3,2691,[302 427 603 100 127],90,5,11677,4.337667161961367,20.0,40.0
32692,3,2692,[302 427 603 100 127],666,5,11682,4.337913108057928,20.0,40.0
32693,3,2693,[302 427 603 100 127],271,5,11687,4.338158871566444,20.0,40.0
32694,3,2694,[302 427 603 100 127],474,5,11692,4.338404452690167,20.0,40.0
32695,3,2695,[302 427 603 100 127],664,5,11697,4.338649851632048,20.0,40.0
32696,3,2696,[302 427 603 100 127],664,5,11702,4.338895068594735,20.0,40.0
32697,3,2697,[302 427 603 100 127],339,5,11707,4.339140103780578,20.0,40.0
32698,3,2698,[ 64  15 118 197 515],271,3,11710,4.338643942200815,0.0,0.0
32699,3,2699,[302 427 603 100 127],664,5,11715,4.338888888888889,20.0,40.0
32700,3,2700,[ 50 237 135 194 258],263,3,11718,4.338393187708256,0.0,20.0
32701,3,2701,[302 427 603 100 127],458,5,11723,4.338638045891932,20.0,40.0
32702,3,2702,[302 427 603 100 127],745,4,11727,4.338512763596005,20.0,40.0
32703,3,2703,[302 427 603 100 127],474,5,11732,4.338757396449704,20.0,40.0
32704,3,2704,[302 427 603 100 127],271,5,11737,4.339001848428835,20.0,40.0
32705,3,2705,[385  69 151 435 173],883,3,11740,4.338507021433851,0.0,0.0
32706,3,2706,[ 56   1 222 182 328],653,3,11743,4.338012560029553,0.0,0.0
32707,3,2707,[186 211 228  12 603],506,5,11748,4.3382570162481535,40.0,0.0
32708,3,2708,[302 427 603 100 127],537,5,11753,4.338501291989664,20.0,40.0
32709,3,2709,[302 427 603 100 127],271,5,11758,4.338745387453875,20.0,40.0
32710,3,2710,[302 427 603 100 127],90,5,11763,4.338989302840281,20.0,40.0
32711,3,2711,[302 427 603 100 127],14,4,11767,4.338864306784661,20.0,40.0
32712,3,2712,[302 427 603 100 127],458,5,11772,4.339107998525617,20.0,40.0
32713,3,2713,[302 427 603 100 127],271,5,11777,4.3393515106853355,20.0,40.0
32714,3,2714,[151 357 180 302  79],666,3,11780,4.338858195211786,20.0,0.0
32715,3,2715,[302 427 603 100 127],458,5,11785,4.339101620029455,20.0,40.0
32716,3,2716,[302 427 603 100 127],90,5,11790,4.339344865660655,20.0,40.0
32717,3,2717,[302 427 603 100 127],664,5,11795,4.339587932303164,20.0,40.0
32718,3,2718,[302 427 603 100 127],666,5,11800,4.339830820154469,20.0,40.0
32719,3,2719,[238 289  50   7 132],334,3,11803,4.339338235294117,0.0,20.0
32720,3,2720,[302 427 603 100 127],537,5,11808,4.339581036383683,20.0,40.0
32721,3,2721,[302 427 603 100 127],745,4,11812,4.339456282145481,20.0,40.0
32722,3,2722,[302 427 603 100 127],271,5,11817,4.339698861549762,20.0,40.0
32723,3,2723,[302 427 603 100 127],334,5,11822,4.339941262848752,20.0,40.0
32724,3,2724,[568 273  82  79 508],774,0,11822,4.338348623853211,0.0,0.0
32725,3,2725,[302 427 603 100 127],334,5,11827,4.338591342626559,20.0,40.0
32726,3,2726,[302 427 603 100 127],271,5,11832,4.338833883388339,20.0,40.0
32727,3,2727,[302 427 603 100 127],666,5,11837,4.339076246334311,20.0,40.0
32728,3,2728,[289 211 228 168 181],524,2,11839,4.338219127885672,0.0,0.0
32729,3,2729,[302 427 603 100 127],458,5,11844,4.338461538461538,20.0,40.0
32730,3,2730,[302 427 603 100 127],474,5,11849,4.338703771512266,20.0,40.0
32731,3,2731,[328   8 222 121 118],313,3,11852,4.338213762811128,0.0,0.0
32732,3,2732,[302 427 603 100 127],474,5,11857,4.338455909257227,20.0,40.0
32733,3,2733,[302 427 603 100 127],537,5,11862,4.338697878566204,20.0,40.0
32734,3,2734,[302 427 603 100 127],334,5,11867,4.338939670932358,20.0,40.0
32735,3,2735,[302 427 603 100 127],339,5,11872,4.3391812865497075,20.0,40.0
32736,3,2736,[  4 357 174 222 655],474,5,11877,4.339422725611984,20.0,20.0
32737,3,2737,[302 427 603 100 127],745,4,11881,4.339298758217677,20.0,40.0
32738,3,2738,[302 427 603 100 127],745,4,11885,4.339174881343556,20.0,40.0
32739,3,2739,[ 98  28 748   1 195],92,3,11888,4.338686131386861,0.0,20.0
32740,3,2740,[302 427 603 100 127],474,5,11893,4.3389273987595764,20.0,40.0
32741,3,2741,[168 121 318  11 125],271,2,11895,4.338074398249453,20.0,0.0
32742,3,2742,[302 427 603 100 127],339,5,11900,4.338315712723296,20.0,40.0
32743,3,2743,[302 427 603 100 127],458,5,11905,4.338556851311953,20.0,40.0
32744,3,2744,[302 427 603 100 127],13,5,11910,4.33879781420765,20.0,40.0
32745,3,2745,[ 56  98   7 202   4],378,3,11913,4.338310269482884,0.0,20.0
32746,3,2746,[204 174  82 176 187],7,3,11916,4.337823079723335,0.0,20.0
32747,3,2747,[172  98 186 191 235],833,2,11918,4.336972343522562,0.0,20.0
32748,3,2748,[282 568  50  96 174],119,5,11923,4.337213532193525,0.0,40.0
32749,3,2749,[302 427 603 100 127],271,5,11928,4.337454545454546,20.0,40.0
32750,3,2750,[ 12 385  82 118 151],42,5,11933,4.33769538349691,20.0,0.0
32751,3,2751,[302 427 603 100 127],14,4,11937,4.337572674418604,20.0,40.0
32752,3,2752,[302 427 603 100 127],339,5,11942,4.337813294587723,20.0,40.0
32753,3,2753,[302 427 603 100 127],339,5,11947,4.338053740014525,20.0,40.0
32754,3,2754,[435   8 216 238  97],194,2,11949,4.337205081669691,0.0,0.0
32755,3,2755,[234 515 118 238 174],343,3,11952,4.336719883889695,0.0,20.0
32756,3,2756,[302 427 603 100 127],537,5,11957,4.33696046427276,20.0,40.0
32757,3,2757,[197 174 127 173  56],339,5,11962,4.337200870195794,0.0,40.0
32758,3,2758,[118 173  89  56 210],804,4,11966,4.337078651685394,0.0,0.0
32759,3,2759,[302 427 603 100 127],664,5,11971,4.3373188405797105,20.0,40.0
32760,3,2760,[423 210 258 496 427],533,5,11976,4.337558855487142,0.0,0.0
32761,3,2761,[302 427 603 100 127],474,5,11981,4.3377986965966695,20.0,40.0
32762,3,2762,[302 427 603 100 127],271,5,11986,4.338038364096996,20.0,40.0
32763,3,2763,[302 427 603 100 127],745,4,11990,4.3379160636758325,20.0,40.0
32764,3,2764,[302 427 603 100 127],745,4,11994,4.337793851717902,20.0,40.0
32765,3,2765,[135 180 235 546 435],897,2,11996,4.336948662328272,0.0,0.0
32766,3,2766,[302 427 603 100 127],666,5,12001,4.3371882905674015,20.0,40.0
32767,3,2767,[ 22 258 302  69 174],334,4,12005,4.33706647398844,0.0,20.0
32768,3,2768,[302 427 603 100 127],271,5,12010,4.337305886601661,20.0,40.0
32769,3,2769,[302 427 603 100 127],537,5,12015,4.337545126353791,20.0,40.0
32770,3,2770,[302 427 603 100 127],14,4,12019,4.337423312883436,20.0,40.0
32771,3,2771,[302 427 603 100 127],334,5,12024,4.337662337662338,20.0,40.0
32772,3,2772,[176  70 286 127 222],479,4,12028,4.337540569780022,0.0,20.0
32773,3,2773,[302 427 603 100 127],14,4,12032,4.337418889689978,20.0,40.0
32774,3,2774,[265   1 588 132 216],42,4,12036,4.337297297297297,0.0,0.0
32775,3,2775,[302 427 603 100 127],666,5,12041,4.337536023054755,20.0,40.0
32776,3,2776,[302 427 603 100 127],458,5,12046,4.337774576881527,20.0,40.0
32777,3,2777,[302 427 603 100 127],458,5,12051,4.338012958963283,20.0,40.0
32778,3,2778,[ 56 200 403  96 268],7,4,12055,4.337891327815761,0.0,0.0
32779,3,2779,[302 427 603 100 127],90,5,12060,4.338129496402877,20.0,40.0
32780,3,2780,[ 64 135 174 100 187],90,5,12065,4.3383674937073,0.0,40.0
32781,3,2781,[302 427 603 100 127],458,5,12070,4.338605319913731,20.0,40.0
32782,3,2782,[302 427 603 100 127],745,4,12074,4.338483650736615,20.0,40.0
32783,3,2783,[302 427 603 100 127],90,5,12079,4.338721264367816,20.0,40.0
32784,3,2784,[302 427 603 100 127],339,5,12084,4.338958707360862,20.0,40.0
32785,3,2785,[302 427 603 100 127],271,5,12089,4.339195979899498,20.0,40.0
32786,3,2786,[302 427 603 100 127],745,4,12093,4.339074273412272,20.0,40.0
32787,3,2787,[313   8 286 204 546],234,2,12095,4.338235294117647,0.0,0.0
32788,3,2788,[302 427 603 100 127],474,5,12100,4.338472570813912,20.0,40.0
32789,3,2789,[216 234 603 179  88],474,5,12105,4.338709677419355,20.0,0.0
32790,3,2790,[302 427 603 100 127],90,5,12110,4.338946614116804,20.0,40.0
32791,3,2791,[302 427 603 100 127],745,4,12114,4.338825214899713,20.0,40.0
32792,3,2792,[302 427 603 100 127],271,5,12119,4.3390619405657,20.0,40.0
32793,3,2793,[302 427 603 100 127],458,5,12124,4.339298496778811,20.0,40.0
32794,3,2794,[200 405  12  50 216],92,2,12126,4.338461538461538,20.0,20.0
32795,3,2795,[302 427 603 100 127],666,5,12131,4.338698140200286,20.0,40.0
32796,3,2796,[302 427 603 100 127],90,5,12136,4.338934572756525,20.0,40.0
32797,3,2797,[302 427 603 100 127],271,5,12141,4.339170836311651,20.0,40.0
32798,3,2798,[245 144 322  82 135],749,5,12146,4.339406931046803,0.0,0.0
32799,3,2799,[302 427 603 100 127],664,5,12151,4.339642857142858,20.0,40.0
32800,3,2800,[302 427 603 100 127],474,5,12156,4.339878614780435,20.0,40.0
32801,3,2801,[135 197  96 187 228],653,4,12160,4.3397573162027125,0.0,0.0
32802,3,2802,[302 427 603 100 127],537,5,12165,4.339992864787727,20.0,40.0
32803,3,2803,[ 64 322 294 216  71],328,2,12167,4.339158345221112,0.0,0.0
32804,3,2804,[302 427 603 100 127],334,5,12172,4.33939393939394,20.0,40.0
32805,3,2805,[302 427 603 100 127],334,5,12177,4.339629365645046,20.0,40.0
32806,3,2806,[ 69 181 161 385 234],766,3,12180,4.339152119700748,0.0,0.0
32807,3,2807,[302 427 603 100 127],666,5,12185,4.339387464387465,20.0,40.0
32808,3,2808,[ 64 222 210 200  15],537,0,12185,4.3378426486294055,0.0,0.0
32809,3,2809,[302 427 603 100 127],666,5,12190,4.338078291814947,20.0,40.0
32810,3,2810,[302 427 603 100 127],339,5,12195,4.338313767342583,20.0,40.0
32811,3,2811,[302 427 603 100 127],537,5,12200,4.338549075391181,20.0,40.0
32812,3,2812,[302 427 603 100 127],458,5,12205,4.338784216139353,20.0,40.0
32813,3,2813,[302 427 603 100 127],13,5,12210,4.339019189765459,20.0,40.0
32814,3,2814,[302 427 603 100 127],334,5,12215,4.339253996447602,20.0,40.0
32815,3,2815,[302 427 603 100 127],90,5,12220,4.339488636363637,20.0,40.0
32816,3,2816,[302 427 603 100 127],339,5,12225,4.33972310969116,20.0,40.0
32817,3,2817,[302 427 603 100 127],745,4,12229,4.339602555003548,20.0,40.0
32818,3,2818,[302 427 603 100 127],666,5,12234,4.339836821567932,20.0,40.0
32819,3,2819,[302 427 603 100 127],745,4,12238,4.339716312056738,20.0,40.0
32820,3,2820,[302 427 603 100 127],474,5,12243,4.3399503722084365,20.0,40.0
32821,3,2821,[175  11 427 194 237],406,4,12247,4.339829907866761,0.0,0.0
32822,3,2822,[588 182 427 125 172],7,5,12252,4.340063761955367,0.0,0.0
32823,3,2823,[302 427 603 100 127],537,5,12257,4.340297450424929,20.0,40.0
32824,3,2824,[302 427 603 100 127],474,5,12262,4.340530973451328,20.0,40.0
32825,3,2825,[302 427 603 100 127],537,5,12267,4.340764331210191,20.0,40.0
32826,3,2826,[302 427 603 100 127],664,5,12272,4.340997523876902,20.0,40.0
32827,3,2827,[508   4 289 196 322],92,3,12275,4.34052333804809,0.0,0.0
32828,3,2828,[302 427 603 100 127],458,5,12280,4.340756451042771,20.0,40.0
32829,3,2829,[302 427 603 100 127],13,5,12285,4.340989399293286,20.0,40.0
32830,3,2830,[515 181 202 191 435],308,4,12289,4.340868950900742,0.0,0.0
32831,3,2831,[302 427 603 100 127],339,5,12294,4.341101694915254,20.0,40.0
32832,3,2832,[275  70 176 301 153],279,2,12296,4.340275326509001,0.0,0.0
32833,3,2833,[302 427 603 100 127],664,5,12301,4.340508115737474,20.0,40.0
32834,3,2834,[302 427 603 100 127],458,5,12306,4.340740740740741,20.0,40.0
32835,3,2835,[302 427 603 100 127],474,5,12311,4.340973201692525,20.0,40.0
32836,3,2836,[302 427 603 100 127],334,5,12316,4.3412054987663025,20.0,40.0
32837,3,2837,[302 427 603 100 127],339,5,12321,4.341437632135307,20.0,40.0
32838,3,2838,[508 127 234 435 181],533,4,12325,4.341317365269461,0.0,20.0
32839,3,2839,[286 265 597 117 215],328,3,12328,4.340845070422535,0.0,0.0
32840,3,2840,[423 234 176 323 748],200,3,12331,4.340373108060542,0.0,0.0
32841,3,2841,[302 427 603 100 127],474,5,12336,4.340605207600282,20.0,40.0
32842,3,2842,[302 427 603 100 127],474,5,12341,4.340837143862117,20.0,40.0
32843,3,2843,[302 427 603 100 127],745,4,12345,4.340717299578059,20.0,40.0
32844,3,2844,[302 427 603 100 127],339,5,12350,4.340949033391916,20.0,40.0
32845,3,2845,[174 127 181 496 204],524,2,12352,4.340126493323964,0.0,40.0
32846,3,2846,[302 427 603 100 127],13,5,12357,4.340358271865121,20.0,40.0
32847,3,2847,[302 427 603 100 127],14,4,12361,4.340238764044944,20.0,40.0
32848,3,2848,[269 323   8 181 121],378,4,12365,4.34011934011934,0.0,0.0
32849,3,2849,[302 427 603 100 127],458,5,12370,4.340350877192982,20.0,40.0
32850,3,2850,[211 173 271 300 496],537,3,12373,4.339880743598737,0.0,0.0
32851,3,2851,[302 427 603 100 127],334,5,12378,4.340112201963534,20.0,40.0
32852,3,2852,[302 427 603 100 127],666,5,12383,4.340343498072205,20.0,40.0
32853,3,2853,[302 427 603 100 127],90,5,12388,4.340574632095305,20.0,40.0
32854,3,2854,[302 427 603 100 127],339,5,12393,4.340805604203152,20.0,40.0
32855,3,2855,[302 427 603 100 127],13,5,12398,4.341036414565826,20.0,40.0
32856,3,2856,[302 427 603 100 127],90,5,12403,4.341267063353167,20.0,40.0
32857,3,2857,[302 427 603 100 127],90,5,12408,4.34149755073478,20.0,40.0
32858,3,2858,[302 427 603 100 127],14,4,12412,4.341378104232249,20.0,40.0
32859,3,2859,[216  97 153  56 357],666,4,12416,4.341258741258741,20.0,0.0
32860,3,2860,[302 427 603 100 127],666,5,12421,4.341488989863684,20.0,40.0
32861,3,2861,[302 427 603 100 127],664,5,12426,4.3417190775681345,20.0,40.0
32862,3,2862,[302 427 603 100 127],537,5,12431,4.341949004540692,20.0,40.0
32863,3,2863,[302 427 603 100 127],666,5,12436,4.342178770949721,20.0,40.0
32864,3,2864,[302 427 603 100 127],666,5,12441,4.342408376963351,20.0,40.0
32865,3,2865,[302 427 603 100 127],339,5,12446,4.342637822749476,20.0,40.0
32866,3,2866,[302 427 603 100 127],90,5,12451,4.342867108475759,20.0,40.0
32867,3,2867,[302 427 603 100 127],271,5,12456,4.343096234309623,20.0,40.0
32868,3,2868,[302 427 603 100 127],14,4,12460,4.342976646915302,20.0,40.0
32869,3,2869,[302 427 603 100 127],13,5,12465,4.343205574912892,20.0,40.0
32870,3,2870,[ 28 271 328 161 202],479,3,12468,4.342737722048067,0.0,0.0
32871,3,2871,[ 98 143 301 161 318],184,2,12470,4.341922005571031,20.0,20.0
32872,3,2872,[302 427 603 100 127],90,5,12475,4.342151061608075,20.0,40.0
32873,3,2873,[173  15  70 197 151],406,2,12477,4.34133611691023,0.0,0.0
32874,3,2874,[588 276 265 100 597],13,4,12481,4.3412173913043475,0.0,20.0
32875,3,2875,[302 427 603 100 276],339,5,12486,4.34144645340751,20.0,20.0
32876,3,2876,[302 427 603 100 276],458,5,12491,4.341675356273896,20.0,20.0
32877,3,2877,[302 427 603 100 276],13,5,12496,4.341904100069493,20.0,20.0
32878,3,2878,[302 427 603 100 276],664,5,12501,4.342132684960055,20.0,20.0
32879,3,2879,[302 427 603 100 276],537,5,12506,4.342361111111111,20.0,20.0
32880,3,2880,[302 427 603 100 276],334,5,12511,4.342589378687956,20.0,20.0
32881,3,2881,[302 427 603 100 276],664,5,12516,4.342817487855656,20.0,20.0
32882,3,2882,[302 427 603 100 276],474,5,12521,4.34304543877905,20.0,20.0
32883,3,2883,[302 546 176 125  28],271,2,12523,4.342233009708738,0.0,0.0
32884,3,2884,[302 427 603 100 276],13,5,12528,4.342461005199307,20.0,20.0
32885,3,2885,[302 427 603 100 276],271,4,12532,4.342342342342342,20.0,20.0
32886,3,2886,[318 269 748 194 111],524,4,12536,4.342223761690336,20.0,0.0
32887,3,2887,[302 427 603 100 276],90,5,12541,4.342451523545706,20.0,20.0
32888,3,2888,[302 427 603 100 276],334,5,12546,4.342679127725857,20.0,20.0
32889,3,2889,[302 427 603 100 276],664,5,12551,4.342906574394464,20.0,20.0
32890,3,2890,[ 96 210  25 175  12],207,1,12552,4.341750259425805,20.0,0.0
32891,3,2891,[186 121  82 508 183],643,4,12556,4.341632088520055,0.0,0.0
32892,3,2892,[127 515  71  69 121],815,3,12559,4.341168337366056,0.0,20.0
32893,3,2893,[748 282  50 117 121],311,5,12564,4.34139599170698,0.0,20.0
32894,3,2894,[427 174 286 302  79],454,4,12568,4.341278065630397,0.0,20.0
32895,3,2895,[302 427 603 100 276],334,5,12573,4.341505524861878,20.0,20.0
32896,3,2896,[302 427 603 100 276],537,5,12578,4.341732827062478,20.0,20.0
32897,3,2897,[302 427 603 100 276],271,4,12582,4.341614906832298,20.0,20.0
32898,3,2898,[172 121 268 200 111],145,3,12585,4.34115212142118,0.0,0.0
32899,3,2899,[276 111 196 176 185],271,2,12587,4.340344827586207,0.0,0.0
32900,3,2900,[302 427 603 100 127],474,5,12592,4.340572216477077,20.0,40.0
32901,3,2901,[302 427 603 100 127],666,5,12597,4.3407994486560995,20.0,40.0
32902,3,2902,[302 427 603 100 127],334,5,12602,4.341026524285223,20.0,40.0
32903,3,2903,[302 427 603 100 127],745,4,12606,4.340909090909091,20.0,40.0
32904,3,2904,[328 234 322  15 111],533,4,12610,4.3407917383821,0.0,0.0
32905,3,2905,[302 427 603 100 127],13,5,12615,4.341018582243634,20.0,40.0
32906,3,2906,[302 427 603 100 127],664,5,12620,4.34124527003784,20.0,40.0
32907,3,2907,[302 427 603 100 127],90,5,12625,4.341471801925723,20.0,40.0
32908,3,2908,[302 427 603 100 127],745,4,12629,4.341354417325541,20.0,40.0
32909,3,2909,[302 427 603 100 127],664,5,12634,4.341580756013745,20.0,40.0
32910,3,2910,[302 427 603 100 127],334,5,12639,4.341806939196153,20.0,40.0
32911,3,2911,[302 427 603 100 127],14,4,12643,4.34168956043956,20.0,40.0
32912,3,2912,[302 427 603 100  50],664,5,12648,4.3419155509783725,20.0,40.0
32913,3,2913,[302 427 603 100  50],14,5,12653,4.342141386410432,20.0,40.0
32914,3,2914,[ 69 121 322 496 210],749,4,12657,4.342024013722127,0.0,0.0
32915,3,2915,[302 427 603 100  50],664,5,12662,4.342249657064472,20.0,40.0
32916,3,2916,[302 427 603 100  50],370,5,12667,4.342475145697635,20.0,40.0
32917,3,2917,[302 427 603 100  50],271,5,12672,4.342700479780672,20.0,40.0
32918,3,2918,[302 427 603 100  50],454,5,12677,4.342925659472422,20.0,40.0
32919,3,2919,[302 427 603 100  50],474,5,12682,4.343150684931507,20.0,40.0
32920,3,2920,[302 427 603 100  50],745,4,12686,4.343033207805546,20.0,40.0
32921,3,2921,[302 427 603 100 127],474,5,12691,4.343258042436688,20.0,40.0
32922,3,2922,[302 427 603 100 127],14,4,12695,4.3431406089633935,20.0,40.0
32923,3,2923,[175 161  89  22   9],64,3,12698,4.3426812585499315,0.0,0.0
32924,3,2924,[302 427 603 100 127],666,5,12703,4.342905982905983,20.0,40.0
32925,3,2925,[302 427 603 100 127],537,5,12708,4.343130553656869,20.0,40.0
32926,3,2926,[302 427 603 100 127],745,4,12712,4.3430133242227535,20.0,40.0
32927,3,2927,[302 427 603 100 127],90,5,12717,4.343237704918033,20.0,40.0
32928,3,2928,[302 427 603 100 127],458,5,12722,4.343461932400136,20.0,40.0
32929,3,2929,[ 64  28 655 183 191],738,4,12726,4.343344709897611,0.0,0.0
32930,3,2930,[302 427 603 100 127],474,5,12731,4.343568747867622,20.0,40.0
32931,3,2931,[161 427 222  96 328],234,1,12732,4.342428376534788,0.0,0.0
32932,3,2932,[302 427 603 100 127],458,5,12737,4.342652574156154,20.0,40.0
32933,3,2933,[302 427 603 100 127],14,4,12741,4.342535787321063,20.0,40.0
32934,3,2934,[302 427 603 100 127],271,5,12746,4.342759795570698,20.0,40.0
32935,3,2935,[ 97 135  12 385 161],379,2,12748,4.3419618528610355,20.0,0.0
32936,3,2936,[302 427 603 100 127],90,5,12753,4.342185903983657,20.0,40.0
32937,3,2937,[302 427 603 100 127],474,5,12758,4.342409802586793,20.0,40.0
32938,3,2938,[187  96 385 568 216],59,5,12763,4.342633548826131,0.0,0.0
32939,3,2939,[302 427 603 100 127],666,5,12768,4.3428571428571425,20.0,40.0
32940,3,2940,[302 427 603 100 127],745,4,12772,4.342740564433866,20.0,40.0
32941,3,2941,[302 427 603 100 127],271,5,12777,4.342963970088375,20.0,40.0
32942,3,2942,[302 427 603 100 127],271,5,12782,4.343187223921169,20.0,40.0
32943,3,2943,[302 427 603 100 127],664,5,12787,4.343410326086956,20.0,40.0
32944,3,2944,[302 427 603 100 127],90,5,12792,4.3436332767402375,20.0,40.0
32945,3,2945,[302 427 603 100 127],458,5,12797,4.343856076035302,20.0,40.0
32946,3,2946,[222 322 302 427  11],474,5,12802,4.34407872412623,0.0,0.0
32947,3,2947,[302 427 603 100 127],90,5,12807,4.3443012211668925,20.0,40.0
32948,3,2948,[222 328  22  25 125],804,5,12812,4.344523567310953,0.0,0.0
32949,3,2949,[302 427 603 100 127],13,5,12817,4.344745762711864,20.0,40.0
32950,3,2950,[237  71 276  88 200],298,3,12820,4.344290071162318,0.0,0.0
32951,3,2951,[302 427 603 100 127],339,5,12825,4.344512195121951,20.0,40.0
32952,3,2952,[405 275 216  79 748],328,3,12828,4.344056891296986,0.0,0.0
32953,3,2953,[597 215 268 475  88],13,3,12831,4.343601895734597,0.0,0.0
32954,3,2954,[302 427 603 100 127],339,5,12836,4.343824027072758,20.0,40.0
32955,3,2955,[302 427 603 100 127],90,5,12841,4.34404600811908,20.0,40.0
32956,3,2956,[302 427 603 100 127],458,5,12846,4.34426783902604,20.0,40.0
32957,3,2957,[302 427 603 100 127],666,5,12851,4.34448951994591,20.0,40.0
32958,3,2958,[269 196 483   9 179],339,5,12856,4.344711051030754,20.0,0.0
32959,3,2959,[302 427 603 100 127],745,4,12860,4.344594594594595,20.0,40.0
32960,3,2960,[302 427 603 100 127],271,5,12865,4.344815940560621,20.0,40.0
32961,3,2961,[302 427 603 100 127],14,4,12869,4.344699527346387,20.0,40.0
32962,3,2962,[302 427 603 100 127],271,5,12874,4.344920688491394,20.0,40.0
32963,3,2963,[302 427 603 100 127],458,5,12879,4.3451417004048585,20.0,40.0
32964,3,2964,[302 427 603 100 127],271,5,12884,4.345362563237774,20.0,40.0
32965,3,2965,[302 427 603 100 127],745,4,12888,4.345246122724208,20.0,40.0
32966,3,2966,[302 427 603 100 127],14,4,12892,4.345129760701044,20.0,40.0
32967,3,2967,[302 427 603 100 127],90,5,12897,4.3453504043126685,20.0,40.0
32968,3,2968,[180 172 191  64 204],92,5,12902,4.345570899292691,0.0,0.0
32969,3,2969,[302 427 603 100 127],14,4,12906,4.345454545454546,20.0,40.0
32970,3,2970,[302 427 603 100 127],90,5,12911,4.345674856950522,20.0,40.0
32971,3,2971,[144 289 496 748 215],488,3,12914,4.3452220726783315,0.0,0.0
32972,3,2972,[302 427 603 100 127],458,5,12919,4.34544231416078,20.0,40.0
32973,3,2973,[302 427 603 100 127],90,5,12924,4.345662407531943,20.0,40.0
32974,3,2974,[121 496 127 271  50],890,3,12927,4.345210084033614,0.0,40.0
32975,3,2975,[302 427 603 100  50],13,5,12932,4.345430107526882,20.0,40.0
32976,3,2976,[302 427 603 100  50],13,5,12937,4.345649983204568,20.0,40.0
32977,3,2977,[302 427 603 100  50],334,5,12942,4.345869711215581,20.0,40.0
32978,3,2978,[302 427 603 100  50],537,5,12947,4.346089291708627,20.0,40.0
32979,3,2979,[302 427 603 100  50],537,5,12952,4.346308724832215,20.0,40.0
32980,3,2980,[286 210 742  12 269],119,3,12955,4.345857094934586,20.0,0.0
32981,3,2981,[302 427 603 100  50],537,5,12960,4.346076458752515,20.0,40.0
32982,3,2982,[302 427 603 100  50],745,4,12964,4.345960442507542,20.0,40.0
32983,3,2983,[100  56 196   1 179],738,3,12967,4.345509383378016,0.0,20.0
32984,3,2984,[288 515  50 235  12],643,5,12972,4.345728643216081,20.0,20.0
32985,3,2985,[302 427 603 100 127],666,5,12977,4.34594775619558,20.0,40.0
32986,3,2986,[302 427 603 100 127],13,5,12982,4.346166722464011,20.0,40.0
32987,3,2987,[302 427 603 100 127],458,5,12987,4.346385542168675,20.0,40.0
32988,3,2988,[ 70 588 202 216 111],378,3,12990,4.345935095349615,0.0,0.0
32989,3,2989,[302 427 603 100 127],666,5,12995,4.346153846153846,20.0,40.0
32990,3,2990,[302 427 603 100 127],666,5,13000,4.346372450685389,20.0,40.0
32991,3,2991,[302 427 603 100 127],339,5,13005,4.346590909090909,20.0,40.0
32992,3,2992,[302 427 603 100 127],339,5,13010,4.346809221516873,20.0,40.0
32993,3,2993,[135  96 238 237 181],653,3,13013,4.346359385437542,0.0,0.0
32994,3,2994,[302 427 603 100 127],664,5,13018,4.3465776293823035,20.0,40.0
32995,3,2995,[121 357 200 185 238],643,3,13021,4.346128170894526,20.0,0.0
32996,3,2996,[302 427 603 100 127],14,4,13025,4.346012679346012,20.0,40.0
32997,3,2997,[302 427 603 100 127],664,5,13030,4.3462308205470315,20.0,40.0
32998,3,2998,[302 427 603 100 127],14,4,13034,4.346115371790597,20.0,40.0
32999,3,2999,[302 427 603 100 127],664,5,13039,4.346333333333333,20.0,40.0
33000,3,3000,[483  98  69 258 182],184,3,13042,4.3458847050983005,20.0,20.0
33001,3,3001,[168  98 228  50 151],387,4,13046,4.345769487008661,0.0,40.0
33002,3,3002,[302 427 603 100  50],13,5,13051,4.345987345987346,20.0,40.0
33003,3,3003,[302 427 603 100  50],666,4,13055,4.3458721704394145,20.0,40.0
33004,3,3004,[302 427 603 100 127],458,5,13060,4.346089850249584,20.0,40.0
33005,3,3005,[302 427 603 100 127],745,4,13064,4.3459747172322025,20.0,40.0
33006,3,3006,[302 427 603 100 127],14,4,13068,4.345859660791486,20.0,40.0
33007,3,3007,[ 79 546 196 144 121],455,3,13071,4.345412234042553,0.0,0.0
33008,3,3008,[302 427 603 100 127],334,5,13076,4.345629777334663,20.0,40.0
33009,3,3009,[302 427 603 100 127],666,5,13081,4.345847176079734,20.0,40.0
33010,3,3010,[ 50 182 322   1 228],488,2,13083,4.345068083693125,0.0,20.0
33011,3,3011,[302 427 603 100 127],271,5,13088,4.345285524568393,20.0,40.0
33012,3,3012,[302 427 603 100 127],537,5,13093,4.345502821108529,20.0,40.0
33013,3,3013,[302 427 603 100 127],339,5,13098,4.3457199734572,20.0,40.0
33014,3,3014,[302 427 603 100 127],334,5,13103,4.345936981757878,20.0,40.0
33015,3,3015,[302 427 603 100 127],474,5,13108,4.346153846153846,20.0,40.0
33016,3,3016,[302 427 603 100 127],339,5,13113,4.3463705667882,20.0,40.0
33017,3,3017,[222  28 176 588 568],64,5,13118,4.346587143803844,0.0,0.0
33018,3,3018,[302 427 603 100 127],745,4,13122,4.346472341835045,20.0,40.0
33019,3,3019,[302 427 603 100 127],14,4,13126,4.34635761589404,20.0,40.0
33020,3,3020,[ 12  22  70 195 427],13,3,13129,4.345911949685535,20.0,0.0
33021,3,3021,[302 427 603 100 127],334,5,13134,4.346128391793514,20.0,40.0
33022,3,3022,[302 427 603 100 127],666,5,13139,4.346344690704598,20.0,40.0
33023,3,3023,[302 427 603 100 127],90,5,13144,4.3465608465608465,20.0,40.0
33024,3,3024,[211 187 121 300 483],749,3,13147,4.346115702479339,20.0,0.0
33025,3,3025,[302 427 603 100 127],90,5,13152,4.346331791143424,20.0,40.0
33026,3,3026,[  4 475 181  56 202],92,4,13156,4.346217376940865,0.0,0.0
33027,3,3027,[302 427 603 100 127],271,5,13161,4.346433289299868,20.0,40.0
33028,3,3028,[302 427 603 100 127],664,5,13166,4.346649059095411,20.0,40.0
33029,3,3029,[302 427 603 100 127],271,5,13171,4.346864686468646,20.0,40.0
33030,3,3030,[302 427 603 100 127],474,5,13176,4.347080171560541,20.0,40.0
33031,3,3031,[302 427 603 100 127],90,5,13181,4.347295514511873,20.0,40.0
33032,3,3032,[302 427 603 100 127],664,5,13186,4.347510715463238,20.0,40.0
33033,3,3033,[302 427 603 100 127],474,5,13191,4.347725774555043,20.0,40.0
33034,3,3034,[302 427 603 100 127],745,4,13195,4.347611202635914,20.0,40.0
33035,3,3035,[302 427 603 100 127],14,4,13199,4.347496706192358,20.0,40.0
33036,3,3036,[302 427 603 100 127],14,4,13203,4.347382285149819,20.0,40.0
33037,3,3037,[228 546 182 132 176],64,4,13207,4.347267939433838,0.0,0.0
33038,3,3038,[302 427 603 100 127],666,5,13212,4.347482724580454,20.0,40.0
33039,3,3039,[282 125 117  97  28],378,3,13215,4.347039473684211,0.0,0.0
33040,3,3040,[172 181 173 197  11],59,5,13220,4.347254192699769,0.0,0.0
33041,3,3041,[302 427 603 100 127],13,5,13225,4.347468770545694,20.0,40.0
33042,3,3042,[357  70 117 202   4],406,2,13227,4.346697338153138,20.0,0.0
33043,3,3043,[185 191 173 508 172],13,1,13228,4.345597897503285,0.0,0.0
33044,3,3044,[302 427 603 100 127],664,5,13233,4.3458128078817735,20.0,40.0
33045,3,3045,[118 265  22 238 204],881,4,13237,4.3456992777413,0.0,0.0
33046,3,3046,[302 427 603 100 127],664,5,13242,4.34591401378405,20.0,40.0
33047,3,3047,[302 427 603 100 127],458,5,13247,4.346128608923885,20.0,40.0
33048,3,3048,[748 328  89  69  98],13,4,13251,4.346015086913742,0.0,20.0
33049,3,3049,[302 427 603 100 127],271,5,13256,4.346229508196721,20.0,40.0
33050,3,3050,[302 427 603 100 127],664,5,13261,4.346443788921665,20.0,40.0
33051,3,3051,[302 427 603 100 127],745,4,13265,4.3463302752293576,20.0,40.0
33052,3,3052,[302 427 603 100 127],745,4,13269,4.346216835899115,20.0,40.0
33053,3,3053,[ 71 127 234 200 179],474,4,13273,4.346103470857892,0.0,20.0
33054,3,3054,[302 427 603 100 127],745,4,13277,4.345990180032733,20.0,40.0
33055,3,3055,[302 427 603 100 127],666,5,13282,4.346204188481676,20.0,40.0
33056,3,3056,[302 427 603 100 127],271,5,13287,4.346418056918548,20.0,40.0
33057,3,3057,[302 427 603 100 127],458,5,13292,4.346631785480707,20.0,40.0
33058,3,3058,[204   7 187 127 597],804,3,13295,4.3461915658712,0.0,20.0
33059,3,3059,[302 427 603 100 127],271,5,13300,4.34640522875817,20.0,40.0
33060,3,3060,[265 357 423 546 483],479,3,13303,4.345965370793858,40.0,0.0
33061,3,3061,[302 427 603 100 127],13,5,13308,4.346178967994775,20.0,40.0
33062,3,3062,[323  98 546 288 357],13,1,13309,4.345086516487104,20.0,20.0
33063,3,3063,[302 427 603 100 127],458,5,13314,4.345300261096606,20.0,40.0
33064,3,3064,[302 427 603 100 127],13,5,13319,4.345513866231648,20.0,40.0
33065,3,3065,[121 100 174  25 202],537,1,13320,4.344422700587084,0.0,40.0
33066,3,3066,[302 427 603 100 127],666,5,13325,4.344636452559504,20.0,40.0
33067,3,3067,[302 427 603 100 127],90,5,13330,4.344850065189048,20.0,40.0
33068,3,3068,[302 427 603 100 127],271,5,13335,4.345063538611925,20.0,40.0
33069,3,3069,[302 427 603 100 127],14,4,13339,4.344951140065146,20.0,40.0
33070,3,3070,[302 427 603 100 127],745,4,13343,4.344838814718333,20.0,40.0
33071,3,3071,[302 427 603 100  98],334,5,13348,4.345052083333333,20.0,40.0
33072,3,3072,[302 427 603 100  98],454,4,13352,4.344939798242759,20.0,40.0
33073,3,3073,[302 427 603 100 127],334,5,13357,4.345152895250488,20.0,40.0
33074,3,3074,[302 427 603 100 127],334,5,13362,4.345365853658537,20.0,40.0
33075,3,3075,[197  96 435 144 546],536,2,13364,4.344603381014304,0.0,0.0
33076,3,3076,[302 427 603 100 127],458,5,13369,4.34481637959051,20.0,40.0
33077,3,3077,[302 427 603 100 127],334,5,13374,4.345029239766082,20.0,40.0
33078,3,3078,[302 427 603 100 127],90,5,13379,4.345241961675868,20.0,40.0
33079,3,3079,[302 427 603 100 127],664,5,13384,4.345454545454546,20.0,40.0
33080,3,3080,[ 22  79 403 235  97],774,0,13384,4.344044141512496,0.0,0.0
33081,3,3081,[302 427 603 100 127],745,4,13388,4.343932511356262,20.0,40.0
33082,3,3082,[302 427 603 100 127],745,4,13392,4.343820953616607,20.0,40.0
33083,3,3083,[302 427 603 100 127],14,4,13396,4.343709468223087,20.0,40.0
33084,3,3084,[302 427 603 100 127],664,5,13401,4.343922204213938,20.0,40.0
33085,3,3085,[302 427 603 100 127],745,4,13405,4.343810758263124,20.0,40.0
33086,3,3086,[302 427 603 100 127],271,5,13410,4.34402332361516,20.0,40.0
33087,3,3087,[161 153 204  70 258],234,0,13410,4.342616580310881,0.0,0.0
33088,3,3088,[210 483 496 153 235],385,3,13413,4.3421819359015865,20.0,0.0
33089,3,3089,[161 286 269 195 186],13,2,13415,4.341423948220065,0.0,0.0
33090,3,3090,[302 427 603 100 127],271,5,13420,4.341637010676156,20.0,40.0
33091,3,3091,[302 427 603 100 127],474,5,13425,4.341849935316947,20.0,40.0
33092,3,3092,[302 427 603 100 127],664,5,13430,4.342062722276108,20.0,40.0
33093,3,3093,[302 427 603 100 127],334,5,13435,4.342275371687136,20.0,40.0
33094,3,3094,[302 427 603 100 127],13,5,13440,4.3424878836833605,20.0,40.0
33095,3,3095,[313 173 194 294 286],474,4,13444,4.3423772609819125,0.0,0.0
33096,3,3096,[302 427 603 100 127],745,4,13448,4.342266709719083,20.0,40.0
33097,3,3097,[302 427 603 100 127],334,5,13453,4.342479018721756,20.0,40.0
33098,3,3098,[  1 222 748  96  15],653,3,13456,4.342045821232656,0.0,0.0
33099,3,3099,[302 427 603 100 127],537,5,13461,4.342258064516129,20.0,40.0
33100,3,3100,[302 427 603 100 127],474,5,13466,4.342470170912609,20.0,40.0
33101,3,3101,[302 427 603 100 127],458,5,13471,4.342682140554481,20.0,40.0
33102,3,3102,[302 427 603 100 127],271,5,13476,4.342893973573961,20.0,40.0
33103,3,3103,[302 427 603 100 127],271,5,13481,4.343105670103093,20.0,40.0
33104,3,3104,[302 427 603 100 127],13,5,13486,4.343317230273752,20.0,40.0
33105,3,3105,[ 64 180  71  50 202],804,5,13491,4.343528654217644,0.0,20.0
33106,3,3106,[302 427 603 100 127],14,4,13495,4.3434180881879625,20.0,40.0
33107,3,3107,[302 427 603 100 127],474,5,13500,4.343629343629344,20.0,40.0
33108,3,3108,[302 427 603 100 127],339,5,13505,4.343840463171437,20.0,40.0
33109,3,3109,[302 427 603 100 127],334,5,13510,4.344051446945338,20.0,40.0
33110,3,3110,[302 427 603 100 127],537,5,13515,4.344262295081967,20.0,40.0
33111,3,3111,[302 427 603 100 127],458,5,13520,4.344473007712082,20.0,40.0
33112,3,3112,[288 181 318  69 143],308,4,13524,4.344362351429489,20.0,0.0
33113,3,3113,[273 237 182 215 117],892,5,13529,4.344572896596018,0.0,0.0
33114,3,3114,[ 64  56 185 200 655],488,3,13532,4.344141252006421,0.0,0.0
33115,3,3115,[302 427 603 100 127],537,5,13537,4.344351732991014,20.0,40.0
33116,3,3116,[302 427 603 100 127],666,5,13542,4.34456207892204,20.0,40.0
33117,3,3117,[302 427 603 100 127],271,5,13547,4.344772289929442,20.0,40.0
33118,3,3118,[302 427 603 100 127],666,5,13552,4.344982366142995,20.0,40.0
33119,3,3119,[302 427 603 100 127],13,5,13557,4.345192307692308,20.0,40.0
33120,3,3120,[302 427 603 100 127],745,4,13561,4.345081704581864,20.0,40.0
33121,3,3121,[302 427 603 100 127],458,5,13566,4.345291479820628,20.0,40.0
33122,3,3122,[302 427 603 100 127],474,5,13571,4.345501120717259,20.0,40.0
33123,3,3123,[ 11  98 276 655 333],537,1,13572,4.344430217669654,0.0,20.0
33124,3,3124,[143  82 181 216 118],7,1,13573,4.34336,0.0,0.0
33125,3,3125,[302 427 603 100 127],474,5,13578,4.343570057581574,20.0,40.0
33126,3,3126,[302 427 603 100 127],458,5,13583,4.34377998081228,20.0,40.0
33127,3,3127,[302 427 603 100 127],334,5,13588,4.343989769820972,20.0,40.0
33128,3,3128,[435 117 603   9 196],749,4,13592,4.34387983381272,20.0,0.0
33129,3,3129,[302 427 603 100 127],474,5,13597,4.34408945686901,20.0,40.0
33130,3,3130,[302 427 603 100 127],458,5,13602,4.344298946023635,20.0,40.0
33131,3,3131,[302 427 603 100 127],334,5,13607,4.344508301404853,20.0,40.0
33132,3,3132,[302 427 603 100 127],13,5,13612,4.344717523140759,20.0,40.0
33133,3,3133,[302 427 603 100 127],271,5,13617,4.344926611359285,20.0,40.0
33134,3,3134,[302 427 603 100 127],664,5,13622,4.345135566188198,20.0,40.0
33135,3,3135,[302 427 603 100 127],666,5,13627,4.345344387755102,20.0,40.0
33136,3,3136,[ 79   7 143 237  64],378,5,13632,4.34555307618744,0.0,0.0
33137,3,3137,[302 427 603 100 127],666,5,13637,4.345761631612492,20.0,40.0
33138,3,3138,[302 427 603 100 127],537,5,13642,4.345970054157375,20.0,40.0
33139,3,3139,[302 427 603 100 127],537,5,13647,4.3461783439490445,20.0,40.0
33140,3,3140,[ 89 257 276 328 515],334,4,13651,4.346068131168417,0.0,0.0
33141,3,3141,[302 427 603 100 127],14,4,13655,4.34595798854233,20.0,40.0
33142,3,3142,[302 427 603 100 127],666,5,13660,4.346166083359847,20.0,40.0
33143,3,3143,[302 427 603 100 127],271,5,13665,4.346374045801527,20.0,40.0
33144,3,3144,[302 427 603 100 127],664,5,13670,4.346581875993641,20.0,40.0
33145,3,3145,[302 427 603 100 127],745,4,13674,4.346471710108074,20.0,40.0
33146,3,3146,[302 427 603 100 127],664,5,13679,4.34667937718462,20.0,40.0
33147,3,3147,[302 427 603 100 127],666,5,13684,4.346886912325286,20.0,40.0
33148,3,3148,[302 427 603 100 127],14,4,13688,4.346776754525246,20.0,40.0
33149,3,3149,[302 427 603 100 127],339,5,13693,4.346984126984127,20.0,40.0
33150,3,3150,[302 427 603 100 127],666,5,13698,4.34719136781974,20.0,40.0
33151,3,3151,[302 427 603 100 127],339,5,13703,4.347398477157361,20.0,40.0
33152,3,3152,[302 427 603 100 127],271,5,13708,4.347605455122106,20.0,40.0
33153,3,3153,[ 12 258  96 276 187],533,4,13712,4.347495244134432,20.0,0.0
33154,3,3154,[183  56 194  89  79],843,2,13714,4.346751188589541,0.0,0.0
33155,3,3155,[302 427 603 100 127],334,5,13719,4.346958174904943,20.0,40.0
33156,3,3156,[302 427 603 100 127],334,5,13724,4.347165030091859,20.0,40.0
33157,3,3157,[215 195 294 172 197],144,5,13729,4.347371754274858,0.0,0.0
33158,3,3158,[302 427 603 100 127],90,5,13734,4.347578347578348,20.0,40.0
33159,3,3159,[302 427 603 100 127],664,5,13739,4.347784810126583,20.0,40.0
33160,3,3160,[302 427 603 100 127],339,5,13744,4.347991142043657,20.0,40.0
33161,3,3161,[302 427 603 100 127],339,5,13749,4.348197343453511,20.0,40.0
33162,3,3162,[302 427 603 100 127],13,5,13754,4.348403414479924,20.0,40.0
33163,3,3163,[ 95 234 588 117 282],28,3,13757,4.347977243994943,0.0,0.0
33164,3,3164,[302 427 603 100 127],339,5,13762,4.3481832543443915,20.0,40.0
33165,3,3165,[302 427 603 100 127],90,5,13767,4.348389134554643,20.0,40.0
33166,3,3166,[302 427 603 100 127],458,5,13772,4.348594884748974,20.0,40.0
33167,3,3167,[302 427 603 100 127],474,5,13777,4.348800505050505,20.0,40.0
33168,3,3168,[302 427 603 100 127],14,4,13781,4.348690438624172,20.0,40.0
33169,3,3169,[302 427 603 100 127],13,5,13786,4.348895899053628,20.0,40.0
33170,3,3170,[302 427 603 100 127],745,4,13790,4.3487858719646795,20.0,40.0
33171,3,3171,[302 427 603 100 127],334,5,13795,4.348991172761664,20.0,40.0
33172,3,3172,[302 427 603 100 127],271,5,13800,4.349196344153798,20.0,40.0
33173,3,3173,[302 427 603 100 127],339,5,13805,4.3494013862633905,20.0,40.0
33174,3,3174,[302 427 603 100 127],14,4,13809,4.3492913385826775,20.0,40.0
33175,3,3175,[183 172 175  79 210],346,5,13814,4.349496221662468,0.0,0.0
33176,3,3176,[127 286 313 211 222],13,3,13817,4.349071451054454,0.0,20.0
33177,3,3177,[195 265 144  89  98],13,4,13821,4.348961611076149,0.0,20.0
33178,3,3178,[302 427 603 100 127],271,5,13826,4.3491664045297265,20.0,40.0
33179,3,3179,[302 427 603 100 127],458,5,13831,4.34937106918239,20.0,40.0
33180,3,3180,[302 427 603 100 127],13,5,13836,4.349575605155612,20.0,40.0
33181,3,3181,[302 427 603 100 127],339,5,13841,4.349780012570711,20.0,40.0
33182,3,3182,[237 195 125 508 182],144,4,13845,4.349670122525919,0.0,0.0
33183,3,3183,[302 427 603 100 127],271,5,13850,4.349874371859296,20.0,40.0
33184,3,3184,[302 427 603 100 127],458,5,13855,4.350078492935636,20.0,40.0
33185,3,3185,[302 427 603 100 127],14,4,13859,4.3499686126804775,20.0,40.0
33186,3,3186,[302 427 603 100 127],339,5,13864,4.350172576090367,20.0,40.0
33187,3,3187,[ 98 180 234 427 282],458,3,13867,4.349749058971142,0.0,20.0
33188,3,3188,[302 427 603 100 127],664,5,13872,4.349952963311383,20.0,40.0
33189,3,3189,[302 427 603 100 127],90,5,13877,4.350156739811912,20.0,40.0
33190,3,3190,[302 427 603 100 127],458,5,13882,4.350360388592917,20.0,40.0
33191,3,3191,[ 96 186 168 183 195],804,5,13887,4.350563909774436,0.0,0.0
33192,3,3192,[302 427 603 100 127],666,5,13892,4.3507673034763545,20.0,40.0
33193,3,3193,[302 427 603 100 127],13,5,13897,4.35097056981841,20.0,40.0
33194,3,3194,[603  95 143  89 276],233,4,13901,4.350860719874804,20.0,0.0
33195,3,3195,[153 496 175  95 180],648,2,13903,4.350125156445557,0.0,0.0
33196,3,3196,[302 427 603 100 127],537,5,13908,4.350328432905849,20.0,40.0
33197,3,3197,[161  71 200 294 423],7,3,13911,4.349906191369606,0.0,0.0
33198,3,3198,[196 435  98 173 471],815,4,13915,4.3497968115035945,0.0,20.0
33199,3,3199,[302 427 603 100 127],339,5,13920,4.35,20.0,40.0
33200,3,3200,[121 265  64  97 202],13,5,13925,4.350203061543268,0.0,0.0
33201,3,3201,[302 427 603 100 127],745,4,13929,4.350093691442848,20.0,40.0
33202,3,3202,[ 96 127 194 603 483],326,3,13932,4.3496721823290665,40.0,20.0
33203,3,3203,[302 427 603 100 127],13,5,13937,4.349875156054932,20.0,40.0
33204,3,3204,[302 427 603 100 127],334,5,13942,4.3500780031201245,20.0,40.0
33205,3,3205,[302 427 603 100 127],339,5,13947,4.350280723643169,20.0,40.0
33206,3,3206,[  8 176 135 313  11],234,3,13950,4.349859681945744,0.0,0.0
33207,3,3207,[302 427 603 100 127],664,5,13955,4.350062344139651,20.0,40.0
33208,3,3208,[678 238 603  82  95],804,4,13959,4.349953256466189,20.0,0.0
33209,3,3209,[302 427 603 100 127],271,5,13964,4.350155763239876,20.0,40.0
33210,3,3210,[302 427 603 100 127],334,5,13969,4.350358143880411,20.0,40.0
33211,3,3211,[127 276 210 234  70],690,2,13971,4.349626400996264,0.0,20.0
33212,3,3212,[302 427 603 100 127],745,4,13975,4.349517584811703,20.0,40.0
33213,3,3213,[  1 211 183 215 174],406,4,13979,4.349408836341008,0.0,20.0
33214,3,3214,[ 22 179 655 173 182],537,3,13982,4.348989113530327,0.0,0.0
33215,3,3215,[302 427 603 100 127],664,5,13987,4.349191542288557,20.0,40.0
33216,3,3216,[ 56 176 121 127 288],537,2,13989,4.348461299347218,0.0,20.0
33217,3,3217,[302 427 603 100 127],666,5,13994,4.348663766314481,20.0,40.0
33218,3,3218,[ 22  11 678 135  69],749,4,13998,4.348555452003728,0.0,0.0
33219,3,3219,[302 427 603 100 127],339,5,14003,4.348757763975155,20.0,40.0
33220,3,3220,[302 427 603 100 127],90,5,14008,4.348959950325986,20.0,40.0
33221,3,3221,[173 183  82  11 215],538,4,14012,4.34885164494103,0.0,0.0
33222,3,3222,[302 427 603 100 127],458,5,14017,4.349053676698728,20.0,40.0
33223,3,3223,[302 427 603 100 127],13,5,14022,4.349255583126551,20.0,40.0
33224,3,3224,[302 427 603 100 127],271,5,14027,4.349457364341085,20.0,40.0
33225,3,3225,[302 427 603 100 127],664,5,14032,4.349659020458772,20.0,40.0
33226,3,3226,[302 427 603 100 127],458,5,14037,4.34986055159591,20.0,40.0
33227,3,3227,[195 435 215  56 289],85,3,14040,4.349442379182156,0.0,0.0
33228,3,3228,[318 385  95 435 183],13,3,14043,4.349024465778879,20.0,0.0
33229,3,3229,[302 427 603 100 127],537,5,14048,4.349226006191951,20.0,40.0
33230,3,3230,[302 427 603 100 127],664,5,14053,4.34942742185082,20.0,40.0
33231,3,3231,[302 427 603 100 127],334,5,14058,4.349628712871287,20.0,40.0
33232,3,3232,[302 427 603 100 127],745,4,14062,4.3495205691308385,20.0,40.0
33233,3,3233,[121 496 568 181 204],897,4,14066,4.349412492269635,0.0,0.0
33234,3,3234,[302 427 603 100 127],458,5,14071,4.349613601236476,20.0,40.0
33235,3,3235,[302 427 603 100 127],745,4,14075,4.3495055624227446,20.0,40.0
33236,3,3236,[403 271 323 182 172],788,0,14075,4.34816187828236,0.0,0.0
33237,3,3237,[302 427 603 100 127],90,5,14080,4.348363187152564,20.0,40.0
33238,3,3238,[483 318   7 117 173],194,3,14083,4.347946897190491,40.0,0.0
33239,3,3239,[222 322 186 294 328],92,2,14085,4.347222222222222,0.0,0.0
33240,3,3240,[302 427 603 100 127],14,4,14089,4.347115087935823,20.0,40.0
33241,3,3241,[302 427 603 100 127],666,5,14094,4.347316471314004,20.0,40.0
33242,3,3242,[302 427 603 100 127],334,5,14099,4.347517730496454,20.0,40.0
33243,3,3243,[302 427 603 100 127],745,4,14103,4.347410604192355,20.0,40.0
33244,3,3244,[302 427 603 100 127],537,5,14108,4.347611710323575,20.0,40.0
33245,3,3245,[302 427 603 100 127],745,4,14112,4.347504621072089,20.0,40.0
33246,3,3246,[302 427 603 100 127],334,5,14117,4.347705574376348,20.0,40.0
33247,3,3247,[302 427 603 100 127],537,5,14122,4.347906403940887,20.0,40.0
33248,3,3248,[302 427 603 100 127],90,5,14127,4.348107109879963,20.0,40.0
33249,3,3249,[196 151 742 194 265],804,4,14131,4.348,0.0,0.0
33250,3,3250,[ 28  11 238 132 172],64,5,14136,4.348200553675792,0.0,0.0
33251,3,3251,[302 427 603 100 127],90,5,14141,4.3484009840098405,20.0,40.0
33252,3,3252,[204 174 180 385 265],474,5,14146,4.348601291115893,0.0,20.0
33253,3,3253,[302 427 603 100 127],339,5,14151,4.34880147510756,20.0,40.0
33254,3,3254,[302 427 603 100 127],339,5,14156,4.34900153609831,20.0,40.0
33255,3,3255,[302 427 603 100 127],339,5,14161,4.349201474201474,20.0,40.0
33256,3,3256,[194 385 204  98 161],833,0,14161,4.347866134479583,0.0,20.0
33257,3,3257,[302 427 603 100 127],339,5,14166,4.348066298342541,20.0,40.0
33258,3,3258,[211  15 748 186  50],488,5,14171,4.348266339367904,0.0,20.0
33259,3,3259,[302 427 603 100 127],13,5,14176,4.348466257668711,20.0,40.0
33260,3,3260,[  1  28 597   9 202],308,3,14179,4.348052744556885,0.0,0.0
33261,3,3261,[302 427 603 100 127],664,5,14184,4.348252605763335,20.0,40.0
33262,3,3262,[302 427 603 100 127],90,5,14189,4.3484523444682806,20.0,40.0
33263,3,3263,[302 427 603 100 127],537,5,14194,4.348651960784314,20.0,40.0
33264,3,3264,[302 427 603 100 127],537,5,14199,4.3488514548238895,20.0,40.0
33265,3,3265,[302 427 603 100 127],474,5,14204,4.349050826699326,20.0,40.0
33266,3,3266,[302 427 603 100 127],13,5,14209,4.349250076522804,20.0,40.0
33267,3,3267,[546 132 403 181  89],64,3,14212,4.348837209302325,0.0,0.0
33268,3,3268,[496 151 173 215  96],479,3,14215,4.3484245946772715,0.0,0.0
33269,3,3269,[100 185 176   9 117],749,3,14218,4.348012232415902,0.0,20.0
33270,3,3270,[ 98 423 328 117 435],263,4,14222,4.347905839192907,0.0,20.0
33271,3,3271,[ 22 328 117 423 546],788,4,14226,4.347799511002445,0.0,0.0
33272,3,3272,[302 427 603 100 127],334,5,14231,4.347998777879621,20.0,40.0
33273,3,3273,[302 427 603 100 127],334,5,14236,4.348197923029933,20.0,40.0
33274,3,3274,[  7 515 144 121 678],7,3,14239,4.3477862595419845,0.0,0.0
33275,3,3275,[302 427 603 100 127],90,5,14244,4.347985347985348,20.0,40.0
33276,3,3276,[302 427 603 100 127],14,4,14248,4.34787915776625,20.0,40.0
33277,3,3277,[302 427 603 100 127],334,5,14253,4.348078096400244,20.0,40.0
33278,3,3278,[302 427 603 100 127],666,5,14258,4.3482769136932,20.0,40.0
33279,3,3279,[302 427 603 100 127],664,5,14263,4.348475609756098,20.0,40.0
33280,3,3280,[302 427 603 100 127],334,5,14268,4.348674184699787,20.0,40.0
33281,3,3281,[302 427 603 100 127],271,5,14273,4.348872638634979,20.0,40.0
33282,3,3282,[302 427 603 100 127],334,5,14278,4.349070971672251,20.0,40.0
33283,3,3283,[302 427 603 100 127],474,5,14283,4.349269183922046,20.0,40.0
33284,3,3284,[302 427 603 100 127],745,4,14287,4.349162861491629,20.0,40.0
33285,3,3285,[210 385 172 508 186],378,4,14291,4.349056603773585,0.0,0.0
33286,3,3286,[302 427 603 100 127],339,5,14296,4.349254639488896,20.0,40.0
33287,3,3287,[302 427 603 100 127],537,5,14301,4.349452554744525,20.0,40.0
33288,3,3288,[302 427 603 100 127],339,5,14306,4.34965034965035,20.0,40.0
33289,3,3289,[302 427 603 100 127],458,5,14311,4.34984802431611,20.0,40.0
33290,3,3290,[588 183  89 655 597],95,2,14313,4.349134001823154,0.0,0.0
33291,3,3291,[302 427 603 100 127],745,4,14317,4.34902794653706,20.0,40.0
33292,3,3292,[302 427 603 100 127],334,5,14322,4.349225630124507,20.0,40.0
33293,3,3293,[302 427 603 100 127],537,5,14327,4.349423193685489,20.0,40.0
33294,3,3294,[302 427 603 100 127],334,5,14332,4.349620637329287,20.0,40.0
33295,3,3295,[302 427 603 100 127],458,5,14337,4.349817961165049,20.0,40.0
33296,3,3296,[194 546 197 271 200],833,2,14339,4.349105247194419,0.0,0.0
33297,3,3297,[ 95  28 257 271 313],334,2,14341,4.348392965433596,0.0,0.0
33298,3,3298,[302 427 603 100 127],666,5,14346,4.348590481964232,20.0,40.0
33299,3,3299,[302 427 603 100 127],664,5,14351,4.348787878787879,20.0,40.0
33300,3,3300,[302 427 603 100 127],745,4,14355,4.348682217509846,20.0,40.0
33301,3,3301,[302 427 603 100 127],537,5,14360,4.348879466989703,20.0,40.0
33302,3,3302,[302 427 603 100 127],745,4,14364,4.348773841961853,20.0,40.0
33303,3,3303,[302 427 603 100 127],458,5,14369,4.348970944309928,20.0,40.0
33304,3,3304,[302 427 603 100 127],334,5,14374,4.349167927382753,20.0,40.0
33305,3,3305,[302 427 603 100 127],474,5,14379,4.349364791288567,20.0,40.0
33306,3,3306,[302 427 603 100 127],666,5,14384,4.34956153613547,20.0,40.0
33307,3,3307,[302 427 603 100 127],90,5,14389,4.3497581620314385,20.0,40.0
33308,3,3308,[302 427 603 100 127],334,5,14394,4.349954669084315,20.0,40.0
33309,3,3309,[302 427 603 100 127],458,5,14399,4.3501510574018125,20.0,40.0
33310,3,3310,[302 427 603 100 127],14,4,14403,4.350045303533675,20.0,40.0
33311,3,3311,[302 427 603 100 127],14,4,14407,4.34993961352657,20.0,40.0
33312,3,3312,[117 181 655  28   4],194,3,14410,4.349532146091156,0.0,0.0
33313,3,3313,[423 161 257 182 235],271,2,14412,4.348823174411587,0.0,0.0
33314,3,3314,[302 427 603 100  50],474,5,14417,4.349019607843137,20.0,40.0
33315,3,3315,[302 427 603 100  50],14,5,14422,4.349215922798552,20.0,40.0
33316,3,3316,[172 427  88  50 186],194,2,14424,4.3485076876695805,0.0,20.0
33317,3,3317,[302 427 603 100 127],745,4,14428,4.348402652200121,20.0,40.0
33318,3,3318,[ 96  12  69 153 245],92,5,14433,4.348598975595059,20.0,0.0
33319,3,3319,[302 427 603 100 127],537,5,14438,4.348795180722892,20.0,40.0
33320,3,3320,[302 427 603 100 127],90,5,14443,4.3489912676904545,20.0,40.0
33321,3,3321,[302 427 603 100 127],14,4,14447,4.348886213124624,20.0,40.0
33322,3,3322,[ 82 180 172 202  12],194,1,14448,4.347878423111646,20.0,0.0
33323,3,3323,[302 427 603 100 127],14,4,14452,4.34777376654633,20.0,40.0
33324,3,3324,[302 427 603 100 127],664,5,14457,4.3479699248120305,20.0,40.0
33325,3,3325,[ 69  12 313 194 271],64,4,14461,4.34786530366807,20.0,0.0
33326,3,3326,[302 427 603 100 127],339,5,14466,4.348061316501353,20.0,40.0
33327,3,3327,[173 237 496 195 200],234,2,14468,4.347355769230769,0.0,0.0
33328,3,3328,[302 427 603 100 127],474,5,14473,4.347551817362572,20.0,40.0
33329,3,3329,[302 427 603 100 127],537,5,14478,4.347747747747747,20.0,40.0
33330,3,3330,[302 427 603 100 127],664,5,14483,4.347943560492345,20.0,40.0
33331,3,3331,[ 89 191 483 234 216],7,5,14488,4.348139255702281,20.0,0.0
33332,3,3332,[302 427 603 100 483],13,5,14493,4.3483348334833485,40.0,20.0
33333,3,3333,[302 427 603 100 483],745,4,14497,4.348230353929214,40.0,20.0
33334,3,3334,[302 427 603 100 127],537,5,14502,4.3484257871064464,20.0,40.0
33335,3,3335,[302 427 603 100 127],271,5,14507,4.348621103117506,20.0,40.0
33336,3,3336,[265  56 135 121 423],774,0,14507,4.34731795025472,0.0,0.0
33337,3,3337,[405 286  70 210 568],59,2,14509,4.346614739364889,0.0,0.0
33338,3,3338,[121 423  82 185 180],308,4,14513,4.346510931416592,0.0,0.0
33339,3,3339,[302 427 603 100 127],339,5,14518,4.346706586826348,20.0,40.0
33340,3,3340,[  9 187 135 328  70],234,2,14520,4.346004190362167,0.0,0.0
33341,3,3341,[276 195  95  50 235],537,2,14522,4.3453022142429685,0.0,20.0
33342,3,3342,[302 427 603 100 127],537,5,14527,4.3454980556386475,20.0,40.0
33343,3,3343,[302 427 603 100 127],537,5,14532,4.345693779904306,20.0,40.0
33344,3,3344,[302 427 603 100 127],458,5,14537,4.345889387144992,20.0,40.0
33345,3,3345,[302 427 603 100 127],537,5,14542,4.34608487746563,20.0,40.0
33346,3,3346,[117 197 385 282 211],643,2,14544,4.3453839259037945,0.0,0.0
33347,3,3347,[302 427 603 100 127],458,5,14549,4.34557945041816,20.0,40.0
33348,3,3348,[302 427 603 100 127],14,4,14553,4.345476261570618,20.0,40.0
33349,3,3349,[302 427 603 100 127],271,5,14558,4.345671641791045,20.0,40.0
33350,3,3350,[302 427 603 100 127],334,5,14563,4.3458669054013725,20.0,40.0
33351,3,3351,[302 427 603 100 127],334,5,14568,4.3460620525059666,20.0,40.0
33352,3,3352,[302 427 603 100 127],666,5,14573,4.346257083209067,20.0,40.0
33353,3,3353,[302 427 603 100 127],271,5,14578,4.346451997614788,20.0,40.0
33354,3,3354,[302 427 603 100 127],14,4,14582,4.346348733233979,20.0,40.0
33355,3,3355,[302 427 603 100 127],745,4,14586,4.346245530393325,20.0,40.0
33356,3,3356,[302 427 603 100 127],339,5,14591,4.346440274054215,20.0,40.0
33357,3,3357,[302 427 603 100 127],537,5,14596,4.346634901727219,20.0,40.0
33358,3,3358,[302 427 603 100 127],271,5,14601,4.346829413515928,20.0,40.0
33359,3,3359,[215 515 655 258 328],92,4,14605,4.346726190476191,0.0,0.0
33360,3,3360,[185 322  12 195 276],207,1,14606,4.345730437369831,20.0,0.0
33361,3,3361,[302 427 603 100 127],745,4,14610,4.34562760261749,20.0,40.0
33362,3,3362,[302 427 603 100 127],664,5,14615,4.345822182575081,20.0,40.0
33363,3,3363,[302 427 603 100 127],13,5,14620,4.346016646848989,20.0,40.0
33364,3,3364,[515  96 234 265  70],524,5,14625,4.346210995542347,0.0,0.0
33365,3,3365,[302 427 603 100 127],90,5,14630,4.34640522875817,20.0,40.0
33366,3,3366,[ 12  98 200 197  70],271,5,14635,4.346599346599347,20.0,20.0
33367,3,3367,[302 427 603 100 127],745,4,14639,4.346496437054632,20.0,40.0
33368,3,3368,[ 69 143 175 204 151],312,3,14642,4.346096764618581,0.0,0.0
33369,3,3369,[168   7 176  71 196],738,3,14645,4.345697329376854,0.0,0.0
33370,3,3370,[302 427 603 100 127],339,5,14650,4.345891426876298,20.0,40.0
33371,3,3371,[271 179 288 742 210],650,0,14650,4.344602609727165,0.0,0.0
33372,3,3372,[302 427 603 100 127],334,5,14655,4.344796916691372,20.0,40.0
33373,3,3373,[ 98 496 258 176 180],882,4,14659,4.344694724362774,0.0,20.0
33374,3,3374,[302 427 603 100 127],474,5,14664,4.344888888888889,20.0,40.0
33375,3,3375,[302 427 603 100 127],537,5,14669,4.345082938388626,20.0,40.0
33376,3,3376,[302 427 603 100 127],271,5,14674,4.3452768729641695,20.0,40.0
33377,3,3377,[302 427 603 100 127],334,5,14679,4.345470692717584,20.0,40.0
33378,3,3378,[302 427 603 100 127],271,5,14684,4.345664397750814,20.0,40.0
33379,3,3379,[302 427 603 100 127],339,5,14689,4.3458579881656805,20.0,40.0
33380,3,3380,[302 427 603 100 127],474,5,14694,4.346051464063886,20.0,40.0
33381,3,3381,[302 427 603 100 127],13,5,14699,4.346244825547013,20.0,40.0
33382,3,3382,[302 427 603 100 127],334,5,14704,4.3464380727165235,20.0,40.0
33383,3,3383,[302 427 603 100 127],334,5,14709,4.346631205673759,20.0,40.0
33384,3,3384,[302 427 603 100 127],14,4,14713,4.346528803545052,20.0,40.0
33385,3,3385,[302 427 603 100 127],664,5,14718,4.346721795629061,20.0,40.0
33386,3,3386,[302 427 603 100 127],339,5,14723,4.3469146737525834,20.0,40.0
33387,3,3387,[302 427 603 100 127],664,5,14728,4.347107438016529,20.0,40.0
33388,3,3388,[302 427 603 100 127],271,5,14733,4.3473000885216875,20.0,40.0
33389,3,3389,[302 427 603 100 127],664,5,14738,4.347492625368732,20.0,40.0
33390,3,3390,[302 427 603 100 127],339,5,14743,4.347685048658213,20.0,40.0
33391,3,3391,[  4  56 269 100 471],7,4,14747,4.347582547169812,0.0,20.0
33392,3,3392,[237 222 179  95 288],374,4,14751,4.347480106100796,0.0,0.0
33393,3,3393,[302 427 603 100 127],90,5,14756,4.347672362993518,20.0,40.0
33394,3,3394,[302 427 603 100 127],14,4,14760,4.347569955817378,20.0,40.0
33395,3,3395,[302 427 603 100 127],334,5,14765,4.3477620730270905,20.0,40.0
33396,3,3396,[174 173  70 328 127],537,3,14768,4.3473653223432445,0.0,40.0
33397,3,3397,[180  11 153 135 182],92,5,14773,4.347557386698058,0.0,0.0
33398,3,3398,[302 427 603 100 127],90,5,14778,4.3477493380406,20.0,40.0
33399,3,3399,[302 427 603 100 127],458,5,14783,4.347941176470588,20.0,40.0
33400,3,3400,[151 742 313   8  50],533,3,14786,4.347544839753014,0.0,20.0
33401,3,3401,[475 301 180 186 318],315,4,14790,4.347442680776014,20.0,0.0
33402,3,3402,[302 427 603 100 313],13,5,14795,4.3476344401998235,20.0,20.0
33403,3,3403,[302 427 603 100 313],383,4,14799,4.347532314923619,20.0,20.0
33404,3,3404,[302 427 603 100 127],13,5,14804,4.3477239353891335,20.0,40.0
33405,3,3405,[302 427 603 100 127],666,5,14809,4.347915443335291,20.0,40.0
33406,3,3406,[302 427 603 100 127],334,5,14814,4.3481068388611686,20.0,40.0
33407,3,3407,[ 82  71  89 153 185],60,2,14816,4.347417840375587,0.0,0.0
33408,3,3408,[210 194  56 181  96],774,0,14816,4.346142563801702,0.0,0.0
33409,3,3409,[302 427 603 100 127],13,5,14821,4.34633431085044,20.0,40.0
33410,3,3410,[333 187 215   1 172],387,3,14824,4.345939607153327,0.0,0.0
33411,3,3411,[ 71 333 318 313  64],13,3,14827,4.3455451348182885,20.0,0.0
33412,3,3412,[302 427 603 100 127],90,5,14832,4.3457368883680045,20.0,40.0
33413,3,3413,[302 427 603 100 127],339,5,14837,4.345928529584065,20.0,40.0
33414,3,3414,[302 427 603 100 127],474,5,14842,4.346120058565154,20.0,40.0
33415,3,3415,[ 70 496 211 471 228],454,2,14844,4.345433255269321,0.0,0.0
33416,3,3416,[302 427 603 100 127],339,5,14849,4.345624817091015,20.0,40.0
33417,3,3417,[257 182 357  69 588],499,4,14853,4.345523698069046,20.0,0.0
33418,3,3418,[275 168 194 471 127],311,5,14858,4.345715121380521,0.0,20.0
33419,3,3419,[302 427 603 100 127],666,5,14863,4.345906432748538,20.0,40.0
33420,3,3420,[302 427 603 100 127],13,5,14868,4.346097632271266,20.0,40.0
33421,3,3421,[302 427 603 100 127],334,5,14873,4.346288720046756,20.0,40.0
33422,3,3422,[302 427 603 100 127],664,5,14878,4.346479696172947,20.0,40.0
33423,3,3423,[  9  25   4 286  15],234,1,14879,4.3455023364485985,0.0,0.0
33424,3,3424,[302 427 603 100 127],271,5,14884,4.345693430656934,20.0,40.0
33425,3,3425,[302 427 603 100 127],339,5,14889,4.3458844133099825,20.0,40.0
33426,3,3426,[302 427 603 100 127],13,5,14894,4.346075284505399,20.0,40.0
33427,3,3427,[302 427 603 100 127],474,5,14899,4.346266044340723,20.0,40.0
33428,3,3428,[302 427 603 100 127],334,5,14904,4.346456692913386,20.0,40.0
33429,3,3429,[302 427 603 100 127],664,5,14909,4.346647230320699,20.0,40.0
33430,3,3430,[302 427 603 100 127],90,5,14914,4.346837656659866,20.0,40.0
33431,3,3431,[302 427 603 100 127],745,4,14918,4.346736596736597,20.0,40.0
33432,3,3432,[302 427 603 100 127],339,5,14923,4.3469268861054475,20.0,40.0
33433,3,3433,[302 427 603 100 127],664,5,14928,4.347117064647641,20.0,40.0
33434,3,3434,[ 79  71 216 195  95],804,4,14932,4.347016011644833,0.0,0.0
33435,3,3435,[ 69 175 204 176  70],13,3,14935,4.34662398137369,0.0,0.0
33436,3,3436,[197 191 204 508 301],524,4,14939,4.346523130637183,0.0,0.0
33437,3,3437,[302 427 603 100 127],334,5,14944,4.346713205351949,20.0,40.0
33438,3,3438,[302 427 603 100 127],334,5,14949,4.346903169526025,20.0,40.0
33439,3,3439,[211  28 508 273 318],774,0,14949,4.345639534883721,20.0,0.0
33440,3,3440,[302 427 603 100 127],474,5,14954,4.345829700668411,20.0,40.0
33441,3,3441,[  1 210 211 196 318],13,2,14956,4.345148169668797,20.0,0.0
33442,3,3442,[ 96 496  12 161  79],454,4,14960,4.345047923322683,20.0,0.0
33443,3,3443,[302 427 603 100 127],334,5,14965,4.345238095238095,20.0,40.0
33444,3,3444,[302 427 603 100 127],13,5,14970,4.345428156748912,20.0,40.0
33445,3,3445,[302 427 603 100 127],14,4,14974,4.34532791642484,20.0,40.0
33446,3,3446,[302 427 603 100 127],537,5,14979,4.345517841601392,20.0,40.0
33447,3,3447,[302 427 603 100 127],474,5,14984,4.345707656612529,20.0,40.0
33448,3,3448,[302 427 603 100 127],745,4,14988,4.3456074224412875,20.0,40.0
33449,3,3449,[302 427 603 100 127],666,5,14993,4.345797101449276,20.0,40.0
33450,3,3450,[111  89 186 245 143],378,2,14995,4.345117357287743,0.0,0.0
33451,3,3451,[302 427 603 100 127],458,5,15000,4.345307068366164,20.0,40.0
33452,3,3452,[302 427 603 100 127],666,5,15005,4.345496669562699,20.0,40.0
33453,3,3453,[302 427 603 100 127],90,5,15010,4.345686160972785,20.0,40.0
33454,3,3454,[302 427 603 100 127],14,4,15014,4.345586107091172,20.0,40.0
33455,3,3455,[286 117 276   7 603],234,1,15015,4.344618055555555,20.0,0.0
33456,3,3456,[302 427 603 100 127],14,4,15019,4.344518368527625,20.0,40.0
33457,3,3457,[  8 211 172 191 288],215,3,15022,4.34412955465587,0.0,0.0
33458,3,3458,[121 168 187 194 181],308,4,15026,4.3440300664932066,0.0,0.0
33459,3,3459,[302 427 603 100 127],13,5,15031,4.344219653179191,20.0,40.0
33460,3,3460,[302 427 603 100 127],90,5,15036,4.344409130309159,20.0,40.0
33461,3,3461,[302 427 603 100 127],664,5,15041,4.344598497978048,20.0,40.0
33462,3,3462,[144 483  89 275 216],60,5,15046,4.344787756280682,20.0,0.0
33463,3,3463,[258 515 286 603 300],294,4,15050,4.344688221709007,20.0,0.0
33464,3,3464,[302 427 603 100 127],664,5,15055,4.344877344877345,20.0,40.0
33465,3,3465,[302 427 603 100 127],537,5,15060,4.345066358915176,20.0,40.0
33466,3,3466,[302 427 603 100 127],339,5,15065,4.345255263916931,20.0,40.0
33467,3,3467,[174  95 180 127 118],749,3,15068,4.344867358708189,0.0,40.0
33468,3,3468,[302 427 603 100 127],339,5,15073,4.345056212164889,20.0,40.0
33469,3,3469,[185 135 183 186 197],194,3,15076,4.344668587896254,0.0,0.0
33470,3,3470,[302 427 603 100 127],90,5,15081,4.34485738980121,20.0,40.0
33471,3,3471,[302 427 603 100 127],339,5,15086,4.345046082949309,20.0,40.0
33472,3,3472,[222  70   4 282 181],533,4,15090,4.344946731932048,0.0,0.0
33473,3,3473,[194 111  25  28  15],42,3,15093,4.344559585492228,0.0,0.0
33474,3,3474,[302 427 603 100 127],14,4,15097,4.344460431654676,20.0,40.0
33475,3,3475,[302 427 603 100 127],90,5,15102,4.344649021864211,20.0,40.0
33476,3,3476,[302 427 603 100 127],90,5,15107,4.344837503595053,20.0,40.0
33477,3,3477,[ 95 313  64 194 333],85,4,15111,4.344738355376653,0.0,0.0
33478,3,3478,[302 427 603 100 127],334,5,15116,4.344926703075596,20.0,40.0
33479,3,3479,[258 546 257 179 282],479,3,15119,4.344540229885057,0.0,0.0
33480,3,3480,[302 427 603 100 127],537,5,15124,4.34472852628555,20.0,40.0
33481,3,3481,[302 427 603 100 127],474,5,15129,4.3449167145318786,20.0,40.0
33482,3,3482,[196 286 216 186 197],488,1,15130,4.343956359460235,0.0,0.0
33483,3,3483,[302 427 603 100 127],271,5,15135,4.344144661308841,20.0,40.0
33484,3,3484,[302 427 603 100 127],14,4,15139,4.3440459110473455,20.0,40.0
33485,3,3485,[302 427 603 100 127],339,5,15144,4.344234079173838,20.0,40.0
33486,3,3486,[269  69 185 179 318],207,5,15149,4.344422139374821,20.0,0.0
33487,3,3487,[302 427 603 100 127],13,5,15154,4.344610091743119,20.0,40.0
33488,3,3488,[302 427 603 100 127],458,5,15159,4.344797936371453,20.0,40.0
33489,3,3489,[302 427 603 100 127],474,5,15164,4.3449856733524355,20.0,40.0
33490,3,3490,[302 427 603 100 127],90,5,15169,4.345173302778574,20.0,40.0
33491,3,3491,[302 427 603 100 127],90,5,15174,4.345360824742268,20.0,40.0
33492,3,3492,[302 427 603 100 127],271,5,15179,4.345548239335814,20.0,40.0
33493,3,3493,[302 427 603 100 127],271,5,15184,4.345735546651403,20.0,40.0
33494,3,3494,[168 151 276 100   7],308,5,15189,4.345922746781116,0.0,20.0
33495,3,3495,[294 483 176 182 174],881,3,15192,4.345537757437071,20.0,20.0
33496,3,3496,[302 427 603 100 127],666,5,15197,4.345724907063197,20.0,40.0
33497,3,3497,[245 202 176 228 182],313,3,15200,4.345340194396798,0.0,0.0
33498,3,3498,[302 427 603 100 127],90,5,15205,4.345527293512432,20.0,40.0
33499,3,3499,[302 427 603 100 127],537,5,15210,4.345714285714286,20.0,40.0
33500,3,3500,[302 427 603 100 127],664,5,15215,4.345901171093973,20.0,40.0
33501,3,3501,[302 427 603 100 127],90,5,15220,4.346087949743004,20.0,40.0
33502,3,3502,[302 427 603 100 127],458,5,15225,4.346274621752784,20.0,40.0
33503,3,3503,[302 427 603 100 127],271,5,15230,4.3464611872146115,20.0,40.0
33504,3,3504,[302 427 603 100 127],14,4,15234,4.346362339514979,20.0,40.0
33505,3,3505,[302 427 603 100 127],666,5,15239,4.346548773531089,20.0,40.0
33506,3,3506,[302 427 603 100 127],474,5,15244,4.346735101226119,20.0,40.0
33507,3,3507,[183  28 117 181 238],406,3,15247,4.346351197263398,0.0,0.0
33508,3,3508,[302 427 603 100 127],334,5,15252,4.346537475064121,20.0,40.0
33509,3,3509,[302 427 603 100 127],745,4,15256,4.346438746438746,20.0,40.0
33510,3,3510,[ 82 135 328 118   1],92,2,15258,4.345770435773284,0.0,0.0
33511,3,3511,[302 427 603 100 127],14,4,15262,4.345671981776765,20.0,40.0
33512,3,3512,[302 427 603 100 127],474,5,15267,4.345858240819812,20.0,40.0
33513,3,3513,[135 597 268 385 216],7,3,15270,4.345475241889584,0.0,0.0
33514,3,3514,[302 427 603 100 127],474,5,15275,4.3456614509246085,20.0,40.0
33515,3,3515,[302 427 603 100 127],334,5,15280,4.345847554038681,20.0,40.0
33516,3,3516,[302 427 603 100 127],664,5,15285,4.34603355132215,20.0,40.0
33517,3,3517,[302 427 603 100 127],537,5,15290,4.346219442865264,20.0,40.0
33518,3,3518,[302 427 603 100 127],14,4,15294,4.346121057118499,20.0,40.0
33519,3,3519,[302 427 603 100 127],537,5,15299,4.3463068181818185,20.0,40.0
33520,3,3520,[302 427 603 100 127],90,5,15304,4.346492473729055,20.0,40.0
33521,3,3521,[302 427 603 100 127],474,5,15309,4.346678023850085,20.0,40.0
33522,3,3522,[302 427 603 100 127],339,5,15314,4.3468634686346865,20.0,40.0
33523,3,3523,[302 427 603 100 127],339,5,15319,4.347048808172532,20.0,40.0
33524,3,3524,[435 180 423 286  22],648,3,15322,4.346666666666667,0.0,0.0
33525,3,3525,[302 427 603 100 127],339,5,15327,4.346851956891662,20.0,40.0
33526,3,3526,[302 427 603 100 127],537,5,15332,4.347037142047066,20.0,40.0
33527,3,3527,[302 427 603 100 127],666,5,15337,4.347222222222222,20.0,40.0
33528,3,3528,[173  79 678 275  69],648,3,15340,4.346840464720884,0.0,0.0
33529,3,3529,[257 118 181 385 515],308,3,15343,4.346458923512748,0.0,0.0
33530,3,3530,[176  98 496  88 195],379,4,15347,4.346360804304729,0.0,20.0
33531,3,3531,[302 427 603 100 127],90,5,15352,4.346545866364666,20.0,40.0
33532,3,3532,[191 211 183 182 288],387,4,15356,4.346447778092273,0.0,0.0
33533,3,3533,[302 427 603 100 127],537,5,15361,4.346632710809281,20.0,40.0
33534,3,3534,[302 427 603 100 127],271,5,15366,4.3468175388967465,20.0,40.0
33535,3,3535,[302 427 603 100 127],474,5,15371,4.347002262443439,20.0,40.0
33536,3,3536,[302 427 603 100 127],271,5,15376,4.347186881538026,20.0,40.0
33537,3,3537,[302 427 603 100 127],537,5,15381,4.347371396269079,20.0,40.0
33538,3,3538,[238 204 282 210 100],406,3,15384,4.346990675332015,0.0,20.0
33539,3,3539,[257 508 173 174 483],334,4,15388,4.346892655367232,20.0,20.0
33540,3,3540,[302 427 603 100 127],474,5,15393,4.347077096865292,20.0,40.0
33541,3,3541,[302 427 603 100 127],458,5,15398,4.347261434217956,20.0,40.0
33542,3,3542,[302 427 603 100 127],537,5,15403,4.347445667513407,20.0,40.0
33543,3,3543,[302 427 603 100 127],664,5,15408,4.347629796839729,20.0,40.0
33544,3,3544,[302 427 603 100 127],458,5,15413,4.347813822284908,20.0,40.0
33545,3,3545,[186 183 211  89 168],380,3,15416,4.347433728144388,0.0,0.0
33546,3,3546,[302 427 603 100 127],14,4,15420,4.347335776712715,20.0,40.0
33547,3,3547,[143   9 228 427 181],533,5,15425,4.347519729425028,0.0,0.0
33548,3,3548,[302 427 603 100 127],271,5,15430,4.347703578472809,20.0,40.0
33549,3,3549,[302 427 603 100 127],474,5,15435,4.347887323943662,20.0,40.0
33550,3,3550,[173 161 200 181 238],334,4,15439,4.347789355111236,0.0,0.0
33551,3,3551,[302 427 603 100 127],13,5,15444,4.347972972972973,20.0,40.0
33552,3,3552,[302 427 603 100 127],90,5,15449,4.348156487475373,20.0,40.0
33553,3,3553,[427 276  12 289 185],334,4,15453,4.348058525604952,20.0,0.0
33554,3,3554,[435  28  82 176 204],643,3,15456,4.347679324894515,0.0,0.0
33555,3,3555,[302 427 603 100 127],537,5,15461,4.347862767154106,20.0,40.0
33556,3,3556,[302 427 603 100 127],339,5,15466,4.3480461062693285,20.0,40.0
33557,3,3557,[302 427 603 100 127],458,5,15471,4.3482293423271505,20.0,40.0
33558,3,3558,[742  82 182 357  98],313,3,15474,4.347850519808935,20.0,20.0
33559,3,3559,[302 427 603 100 127],271,5,15479,4.348033707865168,20.0,40.0
33560,3,3560,[182 180 194  22 135],13,5,15484,4.3482167930356646,0.0,0.0
33561,3,3561,[323 173  98 175 222],13,2,15486,4.347557551937114,0.0,20.0
33562,3,3562,[302 427 603 100 127],334,5,15491,4.347740667976424,20.0,40.0
33563,3,3563,[ 25 271 125 294  22],92,1,15492,4.346801346801347,0.0,0.0
33564,3,3564,[302 427 603 100 127],664,5,15497,4.346984572230014,20.0,40.0
33565,3,3565,[302 427 603 100 127],666,5,15502,4.3471676948962426,20.0,40.0
33566,3,3566,[302 427 603 100 127],271,5,15507,4.347350714886459,20.0,40.0
33567,3,3567,[302 427 603 100 127],458,5,15512,4.3475336322869955,20.0,40.0
33568,3,3568,[153  12  98 179 176],379,5,15517,4.3477164471840855,20.0,20.0
33569,3,3569,[302 427 603 100 127],537,5,15522,4.347899159663865,20.0,40.0
33570,3,3570,[200 135 151 195 215],7,5,15527,4.348081769812378,0.0,0.0
33571,3,3571,[302 427 603 100 127],14,4,15531,4.347984322508399,20.0,40.0
33572,3,3572,[302 427 603 100 127],664,5,15536,4.348166806605094,20.0,40.0
33573,3,3573,[302 427 603 100 127],13,5,15541,4.348349188584219,20.0,40.0
33574,3,3574,[302 427 603 100 127],666,5,15546,4.348531468531468,20.0,40.0
33575,3,3575,[302 427 603 100 127],664,5,15551,4.348713646532438,20.0,40.0
33576,3,3576,[302 427 603 100 127],745,4,15555,4.348616158792284,20.0,40.0
33577,3,3577,[302 427 603 100 127],271,5,15560,4.348798211291224,20.0,40.0
33578,3,3578,[302 427 603 100 127],334,5,15565,4.34898016205644,20.0,40.0
33579,3,3579,[302 427 603 100 127],334,5,15570,4.349162011173185,20.0,40.0
33580,3,3580,[  9  28 196 132 161],234,2,15572,4.348506003909523,0.0,0.0
33581,3,3581,[357 483 168 191 186],833,4,15576,4.348408710217756,40.0,0.0
33582,3,3582,[302 427 603 100 127],666,5,15581,4.348590566564331,20.0,40.0
33583,3,3583,[302 427 603 100 127],664,5,15586,4.348772321428571,20.0,40.0
33584,3,3584,[302 427 603 100 127],664,5,15591,4.348953974895397,20.0,40.0
33585,3,3585,[302 427 603 100 127],339,5,15596,4.349135527049637,20.0,40.0
33586,3,3586,[302 427 603 100 127],13,5,15601,4.349316977976025,20.0,40.0
33587,3,3587,[302 427 603 100 127],334,5,15606,4.349498327759197,20.0,40.0
33588,3,3588,[302 427 603 100 127],666,5,15611,4.3496795764837,20.0,40.0
33589,3,3589,[302 427 603 100 127],13,5,15616,4.3498607242339835,20.0,40.0
33590,3,3590,[196 269 288 300   4],334,1,15617,4.348927875243665,0.0,0.0
33591,3,3591,[  7 204  96 238  95],308,5,15622,4.349109131403118,0.0,0.0
33592,3,3592,[194 313 742  11 161],271,3,15625,4.34873364876148,0.0,0.0
33593,3,3593,[302 427 603 100 127],537,5,15630,4.348914858096828,20.0,40.0
33594,3,3594,[161   4 403 117  71],749,4,15634,4.348817802503477,0.0,0.0
33595,3,3595,[161 275 210 153  70],7,3,15637,4.348442714126808,0.0,0.0
33596,3,3596,[228 568 603 127  82],897,5,15642,4.348623853211009,20.0,20.0
33597,3,3597,[ 95  82 196 289  28],881,3,15645,4.348249027237354,0.0,0.0
33598,3,3598,[302 427 603 100 127],271,5,15650,4.348430119477633,20.0,40.0
33599,3,3599,[302 427 603 100 127],13,5,15655,4.348611111111111,20.0,40.0
33600,3,3600,[302 427 603 100 127],458,5,15660,4.348792002221605,20.0,40.0
33601,3,3601,[ 56 228 181  11  50],447,5,15665,4.3489727928928374,0.0,20.0
33602,3,3602,[302 427 603 100 127],664,5,15670,4.349153483208437,20.0,40.0
33603,3,3603,[302 427 603 100 127],745,4,15674,4.349056603773585,20.0,40.0
33604,3,3604,[302 427 603 100 127],745,4,15678,4.348959778085992,20.0,40.0
33605,3,3605,[302 427 603 100 127],537,5,15683,4.349140321686079,20.0,40.0
33606,3,3606,[302 427 603 100 127],666,5,15688,4.349320765178819,20.0,40.0
33607,3,3607,[302 427 603 100 127],271,5,15693,4.34950110864745,20.0,40.0
33608,3,3608,[302 427 603 100 127],664,5,15698,4.349681352175118,20.0,40.0
33609,3,3609,[143 202 153  97 275],499,3,15701,4.349307479224377,0.0,0.0
33610,3,3610,[302 427 603 100 127],90,5,15706,4.349487676543894,20.0,40.0
33611,3,3611,[302 427 603 100 127],334,5,15711,4.349667774086379,20.0,40.0
33612,3,3612,[127 135  11 216 174],537,2,15713,4.349017437032937,0.0,40.0
33613,3,3613,[302 427 603 100 127],90,5,15718,4.3491975650249035,20.0,40.0
33614,3,3614,[302 427 603 100 127],666,5,15723,4.3493775933609955,20.0,40.0
33615,3,3615,[302 427 603 100 127],14,4,15727,4.349280973451328,20.0,40.0
33616,3,3616,[302 427 603 100 127],474,5,15732,4.349460879181642,20.0,40.0
33617,3,3617,[302 427 603 100 127],339,5,15737,4.349640685461581,20.0,40.0
33618,3,3618,[234 121 322 655 132],313,4,15741,4.349544072948328,0.0,0.0
33619,3,3619,[302 427 603 100 127],664,5,15746,4.349723756906077,20.0,40.0
33620,3,3620,[191 235  12 215 216],537,1,15747,4.348798674399337,20.0,0.0
33621,3,3621,[357 211 515 179 294],774,1,15748,4.3478741027056875,20.0,0.0
33622,3,3622,[265  82 405 742   4],334,1,15749,4.346950041402153,0.0,0.0
33623,3,3623,[302 427 603 100 127],474,5,15754,4.347130242825607,20.0,40.0
33624,3,3624,[302 427 603 100 127],90,5,15759,4.347310344827586,20.0,40.0
33625,3,3625,[286 302 273  98 168],537,2,15761,4.346662989520133,0.0,20.0
33626,3,3626,[216   4 127 483 117],537,2,15763,4.346015991177281,20.0,20.0
33627,3,3627,[302 427 603 100 127],664,5,15768,4.34619625137817,20.0,40.0
33628,3,3628,[302 427 603 100 127],745,4,15772,4.346100854229816,20.0,40.0
33629,3,3629,[302 427 603 100 127],474,5,15777,4.346280991735537,20.0,40.0
33630,3,3630,[302 427 603 100 127],664,5,15782,4.346461030019278,20.0,40.0
33631,3,3631,[302 427 603 100 127],13,5,15787,4.346640969162996,20.0,40.0
33632,3,3632,[286 357 268 289  50],288,4,15791,4.34654555463804,20.0,20.0
33633,3,3633,[302 427 603 100 127],664,5,15796,4.34672537149147,20.0,40.0
33634,3,3634,[302 427 603 100 127],271,5,15801,4.346905089408528,20.0,40.0
33635,3,3635,[302 427 603 100 127],666,5,15806,4.347084708470847,20.0,40.0
33636,3,3636,[302 427 603 100 127],666,5,15811,4.347264228759967,20.0,40.0
33637,3,3637,[302 427 603 100 127],334,5,15816,4.347443650357339,20.0,40.0
33638,3,3638,[515 678 300 100 132],537,2,15818,4.346798571035999,0.0,20.0
33639,3,3639,[302 427 603 100 127],13,5,15823,4.346978021978022,20.0,40.0
33640,3,3640,[302 427 603 100 127],474,5,15828,4.347157374347707,20.0,40.0
33641,3,3641,[302 427 603 100 127],458,5,15833,4.347336628226249,20.0,40.0
33642,3,3642,[302 427 603 100 127],13,5,15838,4.347515783694757,20.0,40.0
33643,3,3643,[302 427 603 100 127],90,5,15843,4.347694840834248,20.0,40.0
33644,3,3644,[302 427 603 100 127],334,5,15848,4.347873799725652,20.0,40.0
33645,3,3645,[180   7 655 175 385],833,2,15850,4.347229840921558,0.0,0.0
33646,3,3646,[245 216  56 132  71],554,3,15853,4.346860433232794,0.0,0.0
33647,3,3647,[234 435  70 268 288],643,4,15857,4.346765350877193,0.0,0.0
33648,3,3648,[302 427 603 100 127],666,5,15862,4.346944368320088,20.0,40.0
33649,3,3649,[ 64   1 100 179 200],380,3,15865,4.346575342465753,0.0,20.0
33650,3,3650,[302 427 603 100 127],90,5,15870,4.346754313886606,20.0,40.0
33651,3,3651,[117 475 483 132  79],13,2,15872,4.3461117196056955,20.0,0.0
33652,3,3652,[302 427 603 100 127],14,4,15876,4.346016972351492,20.0,40.0
33653,3,3653,[302 427 603 100 127],334,5,15881,4.346195949644225,20.0,40.0
33654,3,3654,[302 427 603 100 127],537,5,15886,4.346374829001368,20.0,40.0
33655,3,3655,[302 427 603 100 127],664,5,15891,4.346553610503283,20.0,40.0
33656,3,3656,[302 427 603 100 127],271,5,15896,4.346732294230243,20.0,40.0
33657,3,3657,[302 427 603 100 127],339,5,15901,4.346910880262438,20.0,40.0
33658,3,3658,[302 427 603 100 127],745,4,15905,4.346816069964471,20.0,40.0
33659,3,3659,[302 427 603 100 127],664,5,15910,4.3469945355191255,20.0,40.0
33660,3,3660,[302 427 603 100 127],14,4,15914,4.346899754165529,20.0,40.0
33661,3,3661,[302 427 603 100 127],458,5,15919,4.347078099399235,20.0,40.0
33662,3,3662,[302 427 603 100 127],474,5,15924,4.347256347256347,20.0,40.0
33663,3,3663,[302 427 603 100 127],666,5,15929,4.347434497816594,20.0,40.0
33664,3,3664,[286   7 194 179  98],458,3,15932,4.347066848567531,0.0,20.0
33665,3,3665,[143   7 132 204 144],843,1,15933,4.346153846153846,0.0,0.0
33666,3,3666,[302 427 603 100 127],13,5,15938,4.34633215162258,20.0,40.0
33667,3,3667,[200 161 403 196 186],59,4,15942,4.346237731733915,0.0,0.0
33668,3,3668,[302 427 603 100 127],339,5,15947,4.346415917143636,20.0,40.0
33669,3,3669,[ 96 172 427 588 100],454,3,15950,4.346049046321526,0.0,20.0
33670,3,3670,[302 427 603 100 127],664,5,15955,4.346227186052847,20.0,40.0
33671,3,3671,[302 427 603 100 127],474,5,15960,4.34640522875817,20.0,40.0
33672,3,3672,[302 427 603 100 127],271,5,15965,4.346583174516744,20.0,40.0
33673,3,3673,[286 172 179  95 238],85,4,15969,4.346488840500816,0.0,0.0
33674,3,3674,[302 427 603 100 127],537,5,15974,4.346666666666667,20.0,40.0
33675,3,3675,[ 56 179 228 186 176],215,5,15979,4.346844396082699,0.0,0.0
33676,3,3676,[302 427 603 100 127],474,5,15984,4.3470220288278485,20.0,40.0
33677,3,3677,[302 427 603 100 127],458,5,15989,4.347199564980968,20.0,40.0
33678,3,3678,[302 427 603 100 127],334,5,15994,4.347377004620821,20.0,40.0
33679,3,3679,[302 427 603 100 127],458,5,15999,4.347554347826087,20.0,40.0
33680,3,3680,[302 427 603 100 127],474,5,16004,4.34773159467536,20.0,40.0
33681,3,3681,[100  11 222 176 483],474,5,16009,4.347908745247148,20.0,20.0
33682,3,3682,[302 427 603 100 483],664,5,16014,4.348085799619875,40.0,20.0
33683,3,3683,[302 427 603 100 483],666,5,16019,4.348262757871878,40.0,20.0
33684,3,3684,[302 427 603 100 483],664,5,16024,4.348439620081411,40.0,20.0
33685,3,3685,[ 97 181  69 127 265],537,1,16025,4.347531199131851,0.0,20.0
33686,3,3686,[302 427 603 100 483],13,5,16030,4.347708163818823,40.0,20.0
33687,3,3687,[302 427 603 100 483],745,4,16034,4.347613882863341,40.0,20.0
33688,3,3688,[302 427 603 100 127],339,5,16039,4.347790729194903,20.0,40.0
33689,3,3689,[151 597 289 135 185],833,3,16042,4.3474254742547425,0.0,0.0
33690,3,3690,[302 427 603 100 127],537,5,16047,4.347602275806015,20.0,40.0
33691,3,3691,[302 427 603 100 127],14,4,16051,4.34750812567714,20.0,40.0
33692,3,3692,[302 179 181   1  15],210,4,16055,4.347414026536691,0.0,0.0
33693,3,3693,[ 97 427 282   9 234],374,3,16058,4.347049269085002,0.0,0.0
33694,3,3694,[302 427 603 100 127],745,4,16062,4.346955345060893,20.0,40.0
33695,3,3695,[172 197 153  28 151],666,2,16064,4.346320346320346,0.0,0.0
33696,3,3696,[302 427 603 100 127],90,5,16069,4.346497159859346,20.0,40.0
33697,3,3697,[302 427 603 100 127],664,5,16074,4.346673877771768,20.0,40.0
33698,3,3698,[302 427 603 100 127],13,5,16079,4.346850500135171,20.0,40.0
33699,3,3699,[302 427 603 100 127],13,5,16084,4.347027027027027,20.0,40.0
33700,3,3700,[302 427 603 100 127],664,5,16089,4.3472034585247235,20.0,40.0
33701,3,3701,[215 216 173 100 174],840,5,16094,4.347379794705565,0.0,40.0
33702,3,3702,[742 385 215 405  28],897,3,16097,4.347015933027275,0.0,0.0
33703,3,3703,[302 427 603 100 127],745,4,16101,4.346922246220302,20.0,40.0
33704,3,3704,[302 427 603 100 127],745,4,16105,4.346828609986504,20.0,40.0
33705,3,3705,[182  95 357 132 135],843,1,16106,4.345925526173772,20.0,0.0
33706,3,3706,[302 427 603 100 127],458,5,16111,4.3461019692473695,20.0,40.0
33707,3,3707,[302 427 603 100 127],537,5,16116,4.3462783171521036,20.0,40.0
33708,3,3708,[302 427 603 100 127],666,5,16121,4.34645456996495,20.0,40.0
33709,3,3709,[302 427 603 100 127],474,5,16126,4.346630727762803,20.0,40.0
33710,3,3710,[ 25 568 294   9 194],207,4,16130,4.346537321476691,0.0,0.0
33711,3,3711,[302 427 603 100 127],339,5,16135,4.346713362068965,20.0,40.0
33712,3,3712,[302 427 603 100 127],14,4,16139,4.346619983840561,20.0,40.0
33713,3,3713,[173 318   1 117 197],13,1,16140,4.345718901453958,20.0,0.0
33714,3,3714,[182 181 742 183 323],897,3,16143,4.34535666218035,0.0,0.0
33715,3,3715,[302 427 603 100 127],537,5,16148,4.345532831001076,20.0,40.0
33716,3,3716,[228 300 237  28  56],454,3,16151,4.34517083669626,0.0,0.0
33717,3,3717,[302 427 603 100 127],458,5,16156,4.345346960731576,20.0,40.0
33718,3,3718,[173 187  98  89   7],648,3,16159,4.344985211078247,0.0,20.0
33719,3,3719,[302 427 603 100 127],334,5,16164,4.34516129032258,20.0,40.0
33720,3,3720,[302 427 603 100 127],14,4,16168,4.345068529965063,20.0,40.0
33721,3,3721,[302 427 603 100 127],90,5,16173,4.34524449220849,20.0,40.0
33722,3,3722,[302 427 603 100 127],90,5,16178,4.345420359924792,20.0,40.0
33723,3,3723,[302 427 603 100 127],745,4,16182,4.345327604726101,20.0,40.0
33724,3,3724,[302 427 603 100 127],664,5,16187,4.345503355704698,20.0,40.0
33725,3,3725,[179  71 196   1  56],897,2,16189,4.344873859366613,0.0,0.0
33726,3,3726,[483 318  25 515 143],458,4,16193,4.344781325462839,40.0,0.0
33727,3,3727,[302 427 603 100 127],90,5,16198,4.344957081545064,20.0,40.0
33728,3,3728,[175 179 183  98 210],664,4,16202,4.34486457495307,0.0,20.0
33729,3,3729,[515 313 195 276  96],669,2,16204,4.344235924932976,0.0,0.0
33730,3,3730,[302 427 603 100 127],90,5,16209,4.344411685875101,20.0,40.0
33731,3,3731,[302 427 603 100 127],339,5,16214,4.344587352625938,20.0,40.0
33732,3,3732,[302 427 603 100 127],90,5,16219,4.344762925261184,20.0,40.0
33733,3,3733,[302 427 603 100 127],537,5,16224,4.344938403856454,20.0,40.0
33734,3,3734,[302 427 603 100 127],537,5,16229,4.345113788487282,20.0,40.0
33735,3,3735,[302 427 603 100 127],13,5,16234,4.345289079229122,20.0,40.0
33736,3,3736,[302 427 603 100 127],334,5,16239,4.345464276157346,20.0,40.0
33737,3,3737,[302 427 603 100 127],458,5,16244,4.3456393793472445,20.0,40.0
33738,3,3738,[302 427 603 100 127],745,4,16248,4.3455469376838725,20.0,40.0
33739,3,3739,[302 427 603 100 127],537,5,16253,4.34572192513369,20.0,40.0
33740,3,3740,[302 427 603 100 127],745,4,16257,4.345629510825982,20.0,40.0
33741,3,3741,[302 427 603 100 127],334,5,16262,4.345804382683057,20.0,40.0
33742,3,3742,[302 427 603 100 127],90,5,16267,4.345979161100721,20.0,40.0
33743,3,3743,[302 427 603 100 127],339,5,16272,4.346153846153846,20.0,40.0
33744,3,3744,[302 427 603 100 127],664,5,16277,4.346328437917223,20.0,40.0
33745,3,3745,[588 153 222 204 238],378,3,16280,4.345969033635878,0.0,0.0
33746,3,3746,[210 185 483  98  22],308,3,16283,4.345609821190285,20.0,20.0
33747,3,3747,[405 568 234 318 135],313,4,16287,4.345517609391676,20.0,0.0
33748,3,3748,[302 427 603 100 127],90,5,16292,4.345692184582555,20.0,40.0
33749,3,3749,[323 196 289 127  79],488,2,16294,4.345066666666667,0.0,20.0
33750,3,3750,[182 238 234 180 318],488,2,16296,4.344441482271394,20.0,0.0
33751,3,3751,[197 135 174 515 222],334,5,16301,4.344616204690832,0.0,20.0
33752,3,3752,[427 186 182 118 127],328,2,16303,4.343991473487876,0.0,20.0
33753,3,3753,[271 210 300 286 187],479,2,16305,4.343367075119872,0.0,0.0
33754,3,3754,[ 11   1 265 237 186],295,5,16310,4.343541944074567,0.0,0.0
33755,3,3755,[197   4 135 405 313],738,4,16314,4.343450479233227,0.0,0.0
33756,3,3756,[302 427 603 100 127],664,5,16319,4.34362523289859,20.0,40.0
33757,3,3757,[302 427 603 100 127],666,5,16324,4.343799893560404,20.0,40.0
33758,3,3758,[588 234  70 405 168],804,5,16329,4.343974461292897,0.0,0.0
33759,3,3759,[302 427 603 100 127],537,5,16334,4.344148936170213,20.0,40.0
33760,3,3760,[302 427 603 100 127],13,5,16339,4.344323318266419,20.0,40.0
33761,3,3761,[257 508 235  28 132],92,1,16340,4.343434343434343,0.0,0.0
33762,3,3762,[302 427 603 100 127],745,4,16344,4.343343077331916,20.0,40.0
33763,3,3763,[ 12 318 588 427  70],7,4,16348,4.343251859723698,40.0,0.0
33764,3,3764,[179 228 196 127 313],13,4,16352,4.343160690571049,0.0,20.0
33765,3,3765,[302 427 603 100 127],537,5,16357,4.343335103558152,20.0,40.0
33766,3,3766,[302 427 603 100 127],664,5,16362,4.343509423944783,20.0,40.0
33767,3,3767,[268 333   8 172  69],387,2,16364,4.3428874734607215,0.0,0.0
33768,3,3768,[195 176 127 271  22],197,4,16368,4.34279649774476,0.0,20.0
33769,3,3769,[302 427 603 100 127],14,4,16372,4.342705570291777,20.0,40.0
33770,3,3770,[302 427 603 100 127],745,4,16376,4.342614691063378,20.0,40.0
33771,3,3771,[238 301 597 423 132],13,2,16378,4.341993637327677,0.0,0.0
33772,3,3772,[168 471  22  79 237],543,2,16380,4.341372912801484,0.0,0.0
33773,3,3773,[302 427 603 100 313],271,5,16385,4.341547429782724,20.0,20.0
33774,3,3774,[302 427 603 100 313],13,5,16390,4.341721854304636,20.0,20.0
33775,3,3775,[234 496 135  95 168],776,4,16394,4.341631355932203,0.0,0.0
33776,3,3776,[302 427 603 100 313],14,4,16398,4.3415409054805405,20.0,20.0
33777,3,3777,[302 427 603 100 127],745,4,16402,4.341450502911593,20.0,40.0
33778,3,3778,[302 427 603 100  50],474,5,16407,4.3416247684572635,20.0,40.0
33779,3,3779,[302 427 603 100  50],370,5,16412,4.341798941798942,20.0,40.0
33780,3,3780,[302 427 603 100  50],537,5,16417,4.3419730230097855,20.0,40.0
33781,3,3781,[302 427 603 100  50],271,5,16422,4.342147012162877,20.0,40.0
33782,3,3782,[273 173  70 132 286],234,1,16423,4.341263547449114,0.0,0.0
33783,3,3783,[515 269 302 173  50],6,5,16428,4.341437632135307,0.0,20.0
33784,3,3784,[357 323 385 196 204],804,5,16433,4.341611624834875,20.0,0.0
33785,3,3785,[302 427 603 100  50],334,5,16438,4.341785525620708,20.0,40.0
33786,3,3786,[302 427 603 100  50],537,5,16443,4.341959334565619,20.0,40.0
33787,3,3787,[302 427 603 100  50],537,5,16448,4.342133051742344,20.0,40.0
33788,3,3788,[302 427 603 100  50],13,5,16453,4.342306677223542,20.0,40.0
33789,3,3789,[302 427 603 100  50],334,5,16458,4.342480211081794,20.0,40.0
33790,3,3790,[302 427 603 100  50],13,5,16463,4.342653653389607,20.0,40.0
33791,3,3791,[302 427 603 100  50],666,4,16467,4.342563291139241,20.0,40.0
33792,3,3792,[273 168 318 603 748],64,2,16469,4.341945689427893,40.0,0.0
33793,3,3793,[  8 423 161 271 385],13,3,16472,4.341591987348445,0.0,0.0
33794,3,3794,[196 174 161 403 234],308,2,16474,4.340974967061924,0.0,20.0
33795,3,3795,[302 427 603 100  50],537,5,16479,4.341148577449947,20.0,40.0
33796,3,3796,[302 427 603 100  50],339,5,16484,4.341322096391888,20.0,40.0
33797,3,3797,[302 427 603 100  50],13,5,16489,4.341495523959979,20.0,40.0
33798,3,3798,[302 427 603 100  50],537,5,16494,4.341668860226376,20.0,40.0
33799,3,3799,[302 427 603 100  50],458,4,16498,4.341578947368421,20.0,40.0
33800,3,3800,[302 427 603 100  50],537,5,16503,4.341752170481453,20.0,40.0
33801,3,3801,[302 427 603 100  50],271,5,16508,4.341925302472383,20.0,40.0
33802,3,3802,[508  12 301 323  96],13,2,16510,4.341309492505917,20.0,0.0
33803,3,3803,[302 427 603 100  50],13,5,16515,4.341482649842272,20.0,40.0
33804,3,3804,[302 427 603 100  50],13,5,16520,4.341655716162943,20.0,40.0
33805,3,3805,[302 427 603 100  50],458,4,16524,4.341565948502365,20.0,40.0
33806,3,3806,[302 427 603 100 127],90,5,16529,4.34173890202259,20.0,40.0
33807,3,3807,[302 427 603 100 127],271,5,16534,4.341911764705882,20.0,40.0
33808,3,3808,[ 96 135 276  82  98],207,1,16535,4.341034392228932,0.0,20.0
33809,3,3809,[125 100  70 427 176],533,4,16539,4.340944881889763,0.0,20.0
33810,3,3810,[302 427 603 100 127],339,5,16544,4.341117816845972,20.0,40.0
33811,3,3811,[302 427 603 100 127],458,5,16549,4.341290661070304,20.0,40.0
33812,3,3812,[302 427 603 100 127],334,5,16554,4.341463414634147,20.0,40.0
33813,3,3813,[ 95 196  28  50 211],308,3,16557,4.341111693759832,0.0,20.0
33814,3,3814,[302 427 603 100 127],664,5,16562,4.341284403669725,20.0,40.0
33815,3,3815,[302 427 603 100 127],339,5,16567,4.341457023060797,20.0,40.0
33816,3,3816,[302 427 603 100 127],90,5,16572,4.341629552004192,20.0,40.0
33817,3,3817,[385  70 173 234  88],42,4,16576,4.341540073336826,0.0,0.0
33818,3,3818,[302 427 603 100 127],90,5,16581,4.341712490180676,20.0,40.0
33819,3,3819,[302 427 603 100 127],458,5,16586,4.341884816753927,20.0,40.0
33820,3,3820,[302 427 603 100 127],458,5,16591,4.342057053127453,20.0,40.0
33821,3,3821,[302 427 603 100 127],334,5,16596,4.342229199372056,20.0,40.0
33822,3,3822,[302 427 603 100 127],339,5,16601,4.342401255558462,20.0,40.0
33823,3,3823,[302 427 603 100 127],339,5,16606,4.3425732217573225,20.0,40.0
33824,3,3824,[302 427 603 100 127],13,5,16611,4.342745098039216,20.0,40.0
33825,3,3825,[294  56 182 286 210],474,4,16615,4.342655514898066,0.0,0.0
33826,3,3826,[302 427 603 100 127],458,5,16620,4.342827279853672,20.0,40.0
33827,3,3827,[135 202 515  50 176],537,3,16623,4.342476489028213,0.0,20.0
33828,3,3828,[302 427 603 100 127],537,5,16628,4.342648211021154,20.0,40.0
33829,3,3829,[194   7 153 302  95],13,4,16632,4.342558746736293,0.0,0.0
33830,3,3830,[302 427 603 100 127],537,5,16637,4.342730357608979,20.0,40.0
33831,3,3831,[302 427 603 100 127],334,5,16642,4.342901878914405,20.0,40.0
33832,3,3832,[302 427 603 100 127],664,5,16647,4.343073310722671,20.0,40.0
33833,3,3833,[403 132  15 125 216],290,2,16649,4.342462180490349,0.0,0.0
33834,3,3834,[302 427 603 100 127],271,5,16654,4.342633637548892,20.0,40.0
33835,3,3835,[302 427 603 100 127],664,5,16659,4.342805005213765,20.0,40.0
33836,3,3836,[286  64  70 405 235],59,1,16660,4.34193380244983,0.0,0.0
33837,3,3837,[302 427 603 100 127],458,5,16665,4.342105263157895,20.0,40.0
33838,3,3838,[302 427 603 100 127],13,5,16670,4.342276634540245,20.0,40.0
33839,3,3839,[302 427 603 100 127],334,5,16675,4.342447916666667,20.0,40.0
33840,3,3840,[302 427 603 100 127],13,5,16680,4.342619109606873,20.0,40.0
33841,3,3841,[302 427 603 100 127],271,5,16685,4.342790213430505,20.0,40.0
33842,3,3842,[302 427 603 100 127],745,4,16689,4.342701014832162,20.0,40.0
33843,3,3843,[186  97 121  79 568],387,1,16690,4.341831425598335,0.0,0.0
33844,3,3844,[302 427 603 100 127],339,5,16695,4.342002600780234,20.0,40.0
33845,3,3845,[385   9 176 153 191],749,3,16698,4.341653666146646,0.0,0.0
33846,3,3846,[302 427 603 100 127],666,5,16703,4.34182479854432,20.0,40.0
33847,3,3847,[302 427 603 100 127],13,5,16708,4.341995841995842,20.0,40.0
33848,3,3848,[302 427 603 100 127],90,5,16713,4.342166796570538,20.0,40.0
33849,3,3849,[508  79 318 111   4],92,3,16716,4.341818181818182,20.0,0.0
33850,3,3850,[176 175 222 323  88],537,1,16717,4.340950402492859,0.0,0.0
33851,3,3851,[302 427 603 100 127],664,5,16722,4.341121495327103,20.0,40.0
33852,3,3852,[302 427 603 100 127],664,5,16727,4.341292499351155,20.0,40.0
33853,3,3853,[302 427 603 100 127],458,5,16732,4.341463414634147,20.0,40.0
33854,3,3854,[302 427 603 100 127],90,5,16737,4.341634241245136,20.0,40.0
33855,3,3855,[302 427 603 100 127],664,5,16742,4.341804979253112,20.0,40.0
33856,3,3856,[742 245  50 200 153],666,2,16744,4.34119782214156,0.0,20.0
33857,3,3857,[302 427 603 100 127],339,5,16749,4.341368584758943,20.0,40.0
33858,3,3858,[135 202 405  82 286],59,3,16752,4.341020989893755,0.0,0.0
33859,3,3859,[302 427 603 100 127],13,5,16757,4.341191709844559,20.0,40.0
33860,3,3860,[302 427 603 100 127],334,5,16762,4.341362341362341,20.0,40.0
33861,3,3861,[302 427 603 100 127],334,5,16767,4.341532884515795,20.0,40.0
33862,3,3862,[ 71 117  98 151 196],378,3,16770,4.34118560704116,0.0,20.0
33863,3,3863,[234 173 318 385 258],538,1,16771,4.340320910973085,20.0,0.0
33864,3,3864,[302 427 603 100 127],271,5,16776,4.340491591203104,20.0,40.0
33865,3,3865,[302 427 603 100 127],271,5,16781,4.340662183135024,20.0,40.0
33866,3,3866,[196   7 127 185 194],13,3,16784,4.340315490043961,0.0,20.0
33867,3,3867,[302 427 603 100 127],14,4,16788,4.340227507755946,20.0,40.0
33868,3,3868,[302 427 603 100 127],458,5,16793,4.340398035668131,20.0,40.0
33869,3,3869,[  4 273 183 100  96],59,4,16797,4.34031007751938,0.0,20.0
33870,3,3870,[194 508 357 301 427],940,4,16801,4.340222164815293,20.0,0.0
33871,3,3871,[ 12 204  89 603  71],7,5,16806,4.340392561983471,40.0,0.0
33872,3,3872,[302 427 603 100 127],334,5,16811,4.340562871159308,20.0,40.0
33873,3,3873,[302 427 603 100 127],458,5,16816,4.340733092410945,20.0,40.0
33874,3,3874,[258 313 515 118 300],164,5,16821,4.340903225806452,0.0,0.0
33875,3,3875,[302 427 603 100 127],334,5,16826,4.341073271413829,20.0,40.0
33876,3,3876,[302 427 603 100 127],334,5,16831,4.341243229301006,20.0,40.0
33877,3,3877,[302 427 603 100 127],474,5,16836,4.341413099535843,20.0,40.0
33878,3,3878,[302 427 603 100 127],334,5,16841,4.34158288218613,20.0,40.0
33879,3,3879,[302 427 603 100 127],339,5,16846,4.341752577319587,20.0,40.0
33880,3,3880,[302 427 603 100 127],537,5,16851,4.341922185003865,20.0,40.0
33881,3,3881,[302 427 603 100 127],666,5,16856,4.342091705306543,20.0,40.0
33882,3,3882,[302 427 603 100 127],14,4,16860,4.342003605459696,20.0,40.0
33883,3,3883,[302 427 603 100 127],745,4,16864,4.3419155509783725,20.0,40.0
33884,3,3884,[302 427 603 100 127],271,5,16869,4.342084942084942,20.0,40.0
33885,3,3885,[323 508 100 333 183],537,2,16871,4.34148224395265,0.0,20.0
33886,3,3886,[302 427 603 100 127],271,5,16876,4.341651659377412,20.0,40.0
33887,3,3887,[302 427 603 100 127],90,5,16881,4.341820987654321,20.0,40.0
33888,3,3888,[197 257  70 597  97],653,1,16882,4.3409616868089484,0.0,0.0
33889,3,3889,[302 427 603 100 127],664,5,16887,4.341131105398458,20.0,40.0
33890,3,3890,[302 427 603 100 127],474,5,16892,4.34130043690568,20.0,40.0
33891,3,3891,[302 427 603 100 127],666,5,16897,4.341469681397739,20.0,40.0
33892,3,3892,[302 427 603 100 127],14,4,16901,4.341381967634216,20.0,40.0
33893,3,3893,[ 28 483 496 176 151],897,4,16905,4.341294298921418,20.0,0.0
33894,3,3894,[302 427 603 100 127],334,5,16910,4.341463414634147,20.0,40.0
33895,3,3895,[302 427 603 100 127],14,4,16914,4.341375770020534,20.0,40.0
33896,3,3896,[302 427 603 100 127],745,4,16918,4.341288170387478,20.0,40.0
33897,3,3897,[302 427 603 100 127],13,5,16923,4.341457157516675,20.0,40.0
33898,3,3898,[302 427 603 100 127],271,5,16928,4.34162605796358,20.0,40.0
33899,3,3899,[302 427 603 100 127],745,4,16932,4.341538461538462,20.0,40.0
33900,3,3900,[302 427 603 100 127],537,5,16937,4.341707254550116,20.0,40.0
33901,3,3901,[302 427 603 100 127],745,4,16941,4.341619682214249,20.0,40.0
33902,3,3902,[118 135 323 204 405],804,4,16945,4.341532154752755,0.0,0.0
33903,3,3903,[210  97 216 111 100],488,3,16948,4.341188524590164,0.0,20.0
33904,3,3904,[302 427 603 100 127],664,5,16953,4.341357234314981,20.0,40.0
33905,3,3905,[302 427 603 100 127],474,5,16958,4.34152585765489,20.0,40.0
33906,3,3906,[ 79 197  98 515  82],95,4,16962,4.341438443818787,0.0,20.0
33907,3,3907,[302 427 603 100 127],13,5,16967,4.341606960081883,20.0,40.0
33908,3,3908,[153 181 568 403 202],387,2,16969,4.341007930416986,0.0,0.0
33909,3,3909,[302 427 603 100 127],664,5,16974,4.341176470588235,20.0,40.0
33910,3,3910,[302 427 603 100 127],537,5,16979,4.341344924571721,20.0,40.0
33911,3,3911,[588 168 423 258 151],234,1,16980,4.340490797546012,0.0,0.0
33912,3,3912,[216   8 403  56 385],892,3,16983,4.340148223869154,0.0,0.0
33913,3,3913,[302 427 603 100 127],334,5,16988,4.340316811446091,20.0,40.0
33914,3,3914,[302 427 603 100 127],334,5,16993,4.340485312899106,20.0,40.0
33915,3,3915,[  4  56 211 546 143],648,3,16996,4.340143003064352,0.0,0.0
33916,3,3916,[302 427 603 100 127],13,5,17001,4.340311462854225,20.0,40.0
33917,3,3917,[302 427 603 100 127],664,5,17006,4.340479836651353,20.0,40.0
33918,3,3918,[302 427 603 100 127],334,5,17011,4.340648124521562,20.0,40.0
33919,3,3919,[302 427 603 100 127],271,5,17016,4.340816326530613,20.0,40.0
33920,3,3920,[204 197  64 318 181],194,4,17020,4.3407294057638355,20.0,0.0
33921,3,3921,[302 427 603 100 127],474,5,17025,4.34089750127486,20.0,40.0
33922,3,3922,[302 427 603 100 127],334,5,17030,4.341065511088453,20.0,40.0
33923,3,3923,[  1 748 245 185 357],804,5,17035,4.341233435270133,20.0,0.0
33924,3,3924,[191 323 200 276 678],455,3,17038,4.340891719745223,0.0,0.0
33925,3,3925,[302 427 603 100 127],339,5,17043,4.341059602649007,20.0,40.0
33926,3,3926,[ 96   1 176 427 588],882,5,17048,4.341227400050929,0.0,0.0
33927,3,3927,[302 427 603 100 127],537,5,17053,4.3413951120162935,20.0,40.0
33928,3,3928,[302 427 603 100 127],458,5,17058,4.3415627386103335,20.0,40.0
33929,3,3929,[302 427 603 100 127],458,5,17063,4.3417302798982185,20.0,40.0
33930,3,3930,[302 427 603 100 127],339,5,17068,4.341897735945052,20.0,40.0
33931,3,3931,[302 427 603 100 127],90,5,17073,4.34206510681587,20.0,40.0
33932,3,3932,[302 427 603 100 127],13,5,17078,4.342232392575642,20.0,40.0
33933,3,3933,[302 427 603 100 127],90,5,17083,4.342399593289273,20.0,40.0
33934,3,3934,[302 427 603 100 127],339,5,17088,4.342566709021601,20.0,40.0
33935,3,3935,[302 427 603 100 127],474,5,17093,4.342733739837398,20.0,40.0
33936,3,3936,[302 427 603 100 127],664,5,17098,4.3429006858013715,20.0,40.0
33937,3,3937,[187 118 471  70 176],13,2,17100,4.342305738953784,0.0,0.0
33938,3,3938,[302 427 603 100 127],666,5,17105,4.342472708809343,20.0,40.0
33939,3,3939,[302 427 603 100 127],90,5,17110,4.342639593908629,20.0,40.0
33940,3,3940,[508 132 546 655 423],343,4,17114,4.342552651611266,0.0,0.0
33941,3,3941,[258 496 237 427 357],6,3,17117,4.342212075088788,20.0,0.0
33942,3,3942,[302 427 603 100 127],458,5,17122,4.342378899315242,20.0,40.0
33943,3,3943,[186 183 678 200 234],13,3,17125,4.342038539553752,0.0,0.0
33944,3,3944,[302 427 603 100 127],474,5,17130,4.342205323193916,20.0,40.0
33945,3,3945,[302 427 603 100 127],13,5,17135,4.342372022301064,20.0,40.0
33946,3,3946,[ 12 168 121  70  56],334,3,17138,4.342031922979478,20.0,0.0
33947,3,3947,[302 427 603 100 127],664,5,17143,4.342198581560283,20.0,40.0
33948,3,3948,[302 427 603 100 127],458,5,17148,4.342365155735629,20.0,40.0
33949,3,3949,[302 427 603 100 127],271,5,17153,4.34253164556962,20.0,40.0
33950,3,3950,[302 427 603 100 127],14,4,17157,4.342444950645406,20.0,40.0
33951,3,3951,[318 228 196 222   7],343,5,17162,4.342611336032388,20.0,0.0
33952,3,3952,[ 98 427 161  88 194],650,3,17165,4.34227169238553,0.0,20.0
33953,3,3953,[302 427 603 100 127],745,4,17169,4.342185128983308,20.0,40.0
33954,3,3954,[302 427 603 100 127],537,5,17174,4.342351453855879,20.0,40.0
33955,3,3955,[302 427 603 100 127],458,5,17179,4.342517694641051,20.0,40.0
33956,3,3956,[111 172 357 405 186],488,3,17182,4.34217841799343,20.0,0.0
33957,3,3957,[204 655 322 546 161],308,2,17184,4.341586659929257,0.0,0.0
33958,3,3958,[302 427 603 100 127],664,5,17189,4.341752967921193,20.0,40.0
33959,3,3959,[302 427 603 100 127],745,4,17193,4.341666666666667,20.0,40.0
33960,3,3960,[302 427 603 100 127],14,4,17197,4.341580408987629,20.0,40.0
33961,3,3961,[302 427 603 100 127],666,5,17202,4.341746592629985,20.0,40.0
33962,3,3962,[143   7  22 546 403],650,2,17204,4.341155690133737,0.0,0.0
33963,3,3963,[302 427 603 100 127],745,4,17208,4.341069626639758,20.0,40.0
33964,3,3964,[121 333  11 197  22],64,2,17210,4.34047919293821,0.0,0.0
33965,3,3965,[194  71  97 427 175],788,1,17211,4.33963691376702,0.0,0.0
33966,3,3966,[  9 174 427 176 603],271,4,17215,4.339551298210234,20.0,20.0
33967,3,3967,[302 427 603 100 127],664,5,17220,4.339717741935484,20.0,40.0
33968,3,3968,[302 427 603 100 127],334,5,17225,4.339884101788864,20.0,40.0
33969,3,3969,[132 288 179 222  25],537,1,17226,4.33904282115869,0.0,0.0
33970,3,3970,[302 427 603 100 127],14,4,17230,4.338957441450516,20.0,40.0
33971,3,3971,[302 427 603 100 127],474,5,17235,4.339123867069486,20.0,40.0
33972,3,3972,[302 427 603 100 127],271,5,17240,4.3392902089101435,20.0,40.0
33973,3,3973,[302 427 603 100 127],13,5,17245,4.339456467035732,20.0,40.0
33974,3,3974,[302 427 603 100 127],666,5,17250,4.339622641509434,20.0,40.0
33975,3,3975,[302 427 603 100 127],339,5,17255,4.339788732394366,20.0,40.0
33976,3,3976,[302 427 603 100 127],474,5,17260,4.339954739753583,20.0,40.0
33977,3,3977,[  7 183 286  12 211],387,4,17264,4.339869281045751,20.0,0.0
33978,3,3978,[302 427 603 100 127],271,5,17269,4.3400351847197784,20.0,40.0
33979,3,3979,[200 748 318 228 435],328,3,17272,4.339698492462311,20.0,0.0
33980,3,3980,[302 427 603 100 127],13,5,17277,4.339864355689525,20.0,40.0
33981,3,3981,[265  70 182  22 186],7,4,17281,4.3397790055248615,0.0,0.0
33982,3,3982,[222 597 237   7 568],13,1,17282,4.338940497112729,0.0,0.0
33983,3,3983,[302 427 603 100 127],474,5,17287,4.339106425702811,20.0,40.0
33984,3,3984,[187   8 144 515  89],312,4,17291,4.339021329987453,0.0,0.0
33985,3,3985,[302 427 603 100 127],13,5,17296,4.339187155042649,20.0,40.0
33986,3,3986,[302 427 603 100 127],666,5,17301,4.339352896914973,20.0,40.0
33987,3,3987,[302 427 603 100 127],474,5,17306,4.339518555667001,20.0,40.0
33988,3,3988,[302 427 603 100 127],271,5,17311,4.339684131361244,20.0,40.0
33989,3,3989,[302 427 603 100 127],664,5,17316,4.33984962406015,20.0,40.0
33990,3,3990,[302 427 603 100 127],537,5,17321,4.340015033826108,20.0,40.0
33991,3,3991,[302 427 603 100 127],666,5,17326,4.340180360721443,20.0,40.0
33992,3,3992,[302 427 603 100 127],13,5,17331,4.340345604808415,20.0,40.0
33993,3,3993,[ 70 194 333 204  69],328,2,17333,4.339759639459189,0.0,0.0
33994,3,3994,[302 427 603 100 127],745,4,17337,4.339674593241552,20.0,40.0
33995,3,3995,[302 427 603 100 127],745,4,17341,4.33958958958959,20.0,40.0
33996,3,3996,[302 427 603 100 127],537,5,17346,4.339754816112084,20.0,40.0
33997,3,3997,[302 427 603 100 127],664,5,17351,4.33991995997999,20.0,40.0
33998,3,3998,[302 427 603 100 127],474,5,17356,4.340085021255314,20.0,40.0
33999,3,3999,[302 427 603 100 127],14,4,17360,4.34,20.0,40.0
34000,3,4000,[302 427 603 100 127],537,5,17365,4.34016495876031,20.0,40.0
34001,3,4001,[302 427 603 100 127],13,5,17370,4.340329835082459,20.0,40.0
34002,3,4002,[302 427 603 100 127],666,5,17375,4.340494629028229,20.0,40.0
34003,3,4003,[302 427 603 100 127],14,4,17379,4.340409590409591,20.0,40.0
34004,3,4004,[302 427 603 100 127],271,5,17384,4.340574282147315,20.0,40.0
34005,3,4005,[302 427 603 100 127],664,5,17389,4.3407388916625065,20.0,40.0
34006,3,4006,[302 427 603 100 127],339,5,17394,4.340903419016721,20.0,40.0
34007,3,4007,[302 427 603 100 127],745,4,17398,4.340818363273453,20.0,40.0
34008,3,4008,[302 427 603 100 127],13,5,17403,4.340982788725368,20.0,40.0
34009,3,4009,[200  70 215 427 403],234,2,17405,4.340399002493766,0.0,0.0
34010,3,4010,[302 427 603 100 127],458,5,17410,4.340563450511095,20.0,40.0
34011,3,4011,[174 216 211 180  64],474,5,17415,4.340727816550349,0.0,20.0
34012,3,4012,[ 70 185 172 546 318],479,4,17419,4.340642910540742,20.0,0.0
34013,3,4013,[302 427 603 100 127],339,5,17424,4.3408071748878925,20.0,40.0
34014,3,4014,[435  79 508  69 216],207,5,17429,4.340971357409714,0.0,0.0
34015,3,4015,[318 173   8  56 197],271,4,17433,4.340886454183267,20.0,0.0
34016,3,4016,[302 427 603 100 127],458,5,17438,4.341050535225293,20.0,40.0
34017,3,4017,[302 427 603 100 127],271,5,17443,4.341214534594325,20.0,40.0
34018,3,4018,[288 175 655  82 200],804,3,17446,4.340880816123414,0.0,0.0
34019,3,4019,[176 191 186 117 405],378,2,17448,4.340298507462687,0.0,0.0
34020,3,4020,[302 427 603 100 127],537,5,17453,4.340462571499627,20.0,40.0
34021,3,4021,[183 385 118 403 235],788,1,17454,4.339632023868722,0.0,0.0
34022,3,4022,[302 427 603 100 127],339,5,17459,4.339796172010937,20.0,40.0
34023,3,4023,[302 427 603 100 127],271,5,17464,4.3399602385685885,20.0,40.0
34024,3,4024,[302 427 603 100 127],666,5,17469,4.340124223602484,20.0,40.0
34025,3,4025,[302 427 603 100 127],13,5,17474,4.340288127173373,20.0,40.0
34026,3,4026,[302 427 603 100 127],474,5,17479,4.340451949341942,20.0,40.0
34027,3,4027,[302 427 603 100 127],334,5,17484,4.340615690168819,20.0,40.0
34028,3,4028,[435 273 182 180 204],378,4,17488,4.340531149168529,0.0,0.0
34029,3,4029,[302 427 603 100 127],745,4,17492,4.340446650124069,20.0,40.0
34030,3,4030,[302 427 603 100 127],458,5,17497,4.340610270404366,20.0,40.0
34031,3,4031,[302 427 603 100 127],474,5,17502,4.340773809523809,20.0,40.0
34032,3,4032,[302 427 603 100 127],14,4,17506,4.3406893131663775,20.0,40.0
34033,3,4033,[183 257  11  69 301],666,3,17509,4.340356965790779,0.0,0.0
34034,3,4034,[302 427 603 100 127],13,5,17514,4.340520446096654,20.0,40.0
34035,3,4035,[302 427 603 100 127],664,5,17519,4.340683845391477,20.0,40.0
34036,3,4036,[302  89  56 286 175],788,3,17522,4.340351746346297,0.0,0.0
34037,3,4037,[568 216 385 180  22],650,2,17524,4.33977216443784,0.0,0.0
34038,3,4038,[302 427 603 100 127],666,5,17529,4.339935627630601,20.0,40.0
34039,3,4039,[302 427 603 100 127],14,4,17533,4.339851485148515,20.0,40.0
34040,3,4040,[302 427 603 100 127],14,4,17537,4.339767384310814,20.0,40.0
34041,3,4041,[302 427 603 100 127],474,5,17542,4.339930727362692,20.0,40.0
34042,3,4042,[168  12 173  88 403],883,5,17547,4.340093989611675,20.0,0.0
34043,3,4043,[302 427 603 100 127],90,5,17552,4.340257171117705,20.0,40.0
34044,3,4044,[302 427 603 100 127],13,5,17557,4.340420271940667,20.0,40.0
34045,3,4045,[  9 265 180  28 288],308,3,17560,4.340088976767177,0.0,0.0
34046,3,4046,[302 427 603 100 127],474,5,17565,4.340252038547072,20.0,40.0
34047,3,4047,[302 427 603 100 127],474,5,17570,4.340415019762846,20.0,40.0
34048,3,4048,[302 427 603 100 127],339,5,17575,4.340577920474191,20.0,40.0
34049,3,4049,[ 12 175 182  64 185],7,5,17580,4.340740740740741,20.0,0.0
34050,3,4050,[127 234 475  71 385],13,3,17583,4.340409775364107,0.0,20.0
34051,3,4051,[302 427 603 100 127],664,5,17588,4.340572556762093,20.0,40.0
34052,3,4052,[302 427 603 100 127],271,5,17593,4.340735257833703,20.0,40.0
34053,3,4053,[302 427 603 100 127],334,5,17598,4.340897878638382,20.0,40.0
34054,3,4054,[302 427 603 100 127],458,5,17603,4.341060419235512,20.0,40.0
34055,3,4055,[302 427 603 100 127],339,5,17608,4.341222879684418,20.0,40.0
34056,3,4056,[302 427 603 100 127],13,5,17613,4.341385260044368,20.0,40.0
34057,3,4057,[195 568 185  15 174],42,5,17618,4.341547560374568,0.0,20.0
34058,3,4058,[302 427 603 100 127],745,4,17622,4.341463414634147,20.0,40.0
34059,3,4059,[153 403 186 202 288],374,3,17625,4.3411330049261085,0.0,0.0
34060,3,4060,[228   8 357 168 191],313,2,17627,4.340556513174095,20.0,0.0
34061,3,4061,[125 300 161 173 186],234,0,17627,4.339487936976859,0.0,0.0
34062,3,4062,[181 286 100 182 222],666,3,17630,4.339158257445238,0.0,20.0
34063,3,4063,[302 427 603 100 127],334,5,17635,4.339320866141732,20.0,40.0
34064,3,4064,[302 427 603 100 127],334,5,17640,4.339483394833948,20.0,40.0
34065,3,4065,[302 427 603 100 127],745,4,17644,4.339399901623217,20.0,40.0
34066,3,4066,[302 427 603 100 127],474,5,17649,4.339562330956479,20.0,40.0
34067,3,4067,[132  28 174 435  50],843,1,17650,4.33874139626352,0.0,40.0
34068,3,4068,[302 427 603 100 127],666,5,17655,4.338903907594004,20.0,40.0
34069,3,4069,[187 196 245 300 237],533,3,17658,4.338574938574938,0.0,0.0
34070,3,4070,[302 427 603 100 127],666,5,17663,4.338737410955539,20.0,40.0
34071,3,4071,[302 427 603 100 127],334,5,17668,4.3388998035363455,20.0,40.0
34072,3,4072,[302 427 603 100 127],334,5,17673,4.339062116376136,20.0,40.0
34073,3,4073,[179 546 204 168 200],650,3,17676,4.338733431516936,0.0,0.0
34074,3,4074,[302 427 603 100 127],339,5,17681,4.338895705521472,20.0,40.0
34075,3,4075,[302 427 603 100 127],271,5,17686,4.3390578999018645,20.0,40.0
34076,3,4076,[302 427 603 100 127],745,4,17690,4.33897473632573,20.0,40.0
34077,3,4077,[302 427 603 100 127],745,4,17694,4.338891613536047,20.0,40.0
34078,3,4078,[302 427 603 100 127],745,4,17698,4.33880853150282,20.0,40.0
34079,3,4079,[302 427 603 100 127],664,5,17703,4.338970588235294,20.0,40.0
34080,3,4080,[302 427 603 100 127],474,5,17708,4.33913256554766,20.0,40.0
34081,3,4081,[302 427 603 100 127],271,5,17713,4.339294463498285,20.0,40.0
34082,3,4082,[179  11  70  50 435],64,5,17718,4.339456282145481,0.0,20.0
34083,3,4083,[ 79 403 237  89  50],749,4,17722,4.339373163565132,0.0,20.0
34084,3,4084,[302 427 603 100 127],474,5,17727,4.339534883720931,20.0,40.0
34085,3,4085,[302 427 603 100 127],13,5,17732,4.339696524718551,20.0,40.0
34086,3,4086,[302 427 603 100 127],13,5,17737,4.3398580866161,20.0,40.0
34087,3,4087,[302 427 603 100 127],271,5,17742,4.340019569471624,20.0,40.0
34088,3,4088,[302 427 603 100 127],90,5,17747,4.340180973343116,20.0,40.0
34089,3,4089,[655 127 237 191 183],184,4,17751,4.340097799511002,0.0,20.0
34090,3,4090,[302 427 603 100 127],339,5,17756,4.340259105353215,20.0,40.0
34091,3,4091,[ 79  11 216 237 202],378,3,17759,4.3399315738025415,0.0,0.0
34092,3,4092,[302 427 603 100 127],271,5,17764,4.340092841436599,20.0,40.0
34093,3,4093,[302 427 603 100 127],271,5,17769,4.340254030288227,20.0,40.0
34094,3,4094,[144 121 151 597 275],308,2,17771,4.339682539682539,0.0,0.0
34095,3,4095,[302 427 603 100 127],537,5,17776,4.33984375,20.0,40.0
34096,3,4096,[118 132  82  96 204],308,3,17779,4.339516719550891,0.0,0.0
34097,3,4097,[471 496 403 357  22],533,3,17782,4.3391898487066864,20.0,0.0
34098,3,4098,[302 427 603 100 127],334,5,17787,4.3393510612344475,20.0,40.0
34099,3,4099,[302 427 603 100 127],334,5,17792,4.3395121951219515,20.0,40.0
34100,3,4100,[302 427 603 100 127],537,5,17797,4.339673250426725,20.0,40.0
34101,3,4101,[195  79 121  71  96],200,5,17802,4.339834227206241,0.0,0.0
34102,3,4102,[302 427 603 100 127],666,5,17807,4.339995125517913,20.0,40.0
34103,3,4103,[ 79 748  96 121  69],328,4,17811,4.339912280701754,0.0,0.0
34104,3,4104,[302 427 603 100 127],458,5,17816,4.3400730816077955,20.0,40.0
34105,3,4105,[302 427 603 100 127],664,5,17821,4.340233804188991,20.0,40.0
34106,3,4106,[211 202 185 588 234],537,2,17823,4.339663988312637,0.0,0.0
34107,3,4107,[302 427 603 100 127],666,5,17828,4.339824732229795,20.0,40.0
34108,3,4108,[302 427 603 100 127],13,5,17833,4.339985397907033,20.0,40.0
34109,3,4109,[  1 185 144 143  56],379,5,17838,4.34014598540146,0.0,0.0
34110,3,4110,[302 427 603 100 127],271,5,17843,4.340306494770129,20.0,40.0
34111,3,4111,[302 427 603 100 127],271,5,17848,4.340466926070039,20.0,40.0
34112,3,4112,[357 194 471  50 111],899,5,17853,4.340627279358133,20.0,20.0
34113,3,4113,[302 427 603 100 127],745,4,17857,4.340544482255712,20.0,40.0
34114,3,4114,[302 427 603 100 127],339,5,17862,4.340704738760632,20.0,40.0
34115,3,4115,[ 64 276 405 222 357],474,5,17867,4.34086491739553,20.0,0.0
34116,3,4116,[288  70 181 742 269],378,4,17871,4.340782122905028,0.0,0.0
34117,3,4117,[ 79  50  64   7 161],87,5,17876,4.340942204953861,0.0,20.0
34118,3,4118,[302 427 603 100 127],271,5,17881,4.341102209274096,20.0,40.0
34119,3,4119,[323 172 222 180 135],788,1,17882,4.340291262135922,0.0,0.0
34120,3,4120,[302 427 603 100 127],339,5,17887,4.340451346760495,20.0,40.0
34121,3,4121,[302 427 603 100 127],666,5,17892,4.3406113537117905,20.0,40.0
34122,3,4122,[302 427 603 100 127],458,5,17897,4.340771283046325,20.0,40.0
34123,3,4123,[302 427 603 100 127],90,5,17902,4.340931134820562,20.0,40.0
34124,3,4124,[302 427 603 100 127],90,5,17907,4.341090909090909,20.0,40.0
34125,3,4125,[302 427 603 100 127],666,5,17912,4.341250605913718,20.0,40.0
34126,3,4126,[176 271 655  97 182],479,3,17915,4.34092561182457,0.0,0.0
34127,3,4127,[302 427 603 100 127],339,5,17920,4.341085271317829,20.0,40.0
34128,3,4128,[ 11 117 237 132 508],343,4,17924,4.341002664083313,0.0,0.0
34129,3,4129,[302 427 603 100 127],458,5,17929,4.341162227602905,20.0,40.0
34130,3,4130,[302 427 603 100 127],474,5,17934,4.341321713870734,20.0,40.0
34131,3,4131,[ 11 742   8 515 195],200,5,17939,4.341481122942885,0.0,0.0
34132,3,4132,[211   9 423 222 179],13,2,17941,4.340914589886281,0.0,0.0
34133,3,4133,[ 22 405 483  96  28],406,2,17943,4.3403483309143684,20.0,0.0
34134,3,4134,[ 69  71 100 228 210],59,4,17947,4.340266021765417,0.0,20.0
34135,3,4135,[302 427 603 100 127],745,4,17951,4.340183752417795,20.0,40.0
34136,3,4136,[302 427 603 100 127],458,5,17956,4.340343243896544,20.0,40.0
34137,3,4137,[302 427 603 100 127],664,5,17961,4.3405026582890285,20.0,40.0
34138,3,4138,[302 427 603 100 127],666,5,17966,4.340661995651123,20.0,40.0
34139,3,4139,[302 427 603 100 127],13,5,17971,4.340821256038647,20.0,40.0
34140,3,4140,[302 427 603 100 127],666,5,17976,4.340980439507366,20.0,40.0
34141,3,4141,[302 427 603 100 127],666,5,17981,4.341139546112989,20.0,40.0
34142,3,4142,[302 427 603 100 127],474,5,17986,4.341298575911176,20.0,40.0
34143,3,4143,[302 427 603 100 127],458,5,17991,4.341457528957529,20.0,40.0
34144,3,4144,[302 427 603 100 127],666,5,17996,4.341616405307599,20.0,40.0
34145,3,4145,[588 202 222 748 678],454,1,17997,4.34081041968162,0.0,0.0
34146,3,4146,[302 427 603 100 127],14,4,18001,4.340728237279961,20.0,40.0
34147,3,4147,[216 546  82 333 172],666,1,18002,4.339922854387657,0.0,0.0
34148,3,4148,[174 186  89 143 423],308,5,18007,4.340081947457219,0.0,20.0
34149,3,4149,[234 286  79 427 173],271,5,18012,4.340240963855422,0.0,0.0
34150,3,4150,[ 95 302 185 118 200],271,3,18015,4.339918092026018,0.0,0.0
34151,3,4151,[302 427 603 100 127],90,5,18020,4.340077071290944,20.0,40.0
34152,3,4152,[302 427 603 100 127],664,5,18025,4.3402359739947025,20.0,40.0
34153,3,4153,[204 143  97  70 211],653,1,18026,4.339431872893597,0.0,0.0
34154,3,4154,[302 427 603 100 127],334,5,18031,4.3395908543922985,20.0,40.0
34155,3,4155,[302 427 603 100 127],334,5,18036,4.3397497593840235,20.0,40.0
34156,3,4156,[286 238 182 237 215],13,3,18039,4.339427471734424,0.0,0.0
34157,3,4157,[ 89 215  25 191 161],194,2,18041,4.338864838864839,0.0,0.0
34158,3,4158,[ 64 182   1 294 215],533,4,18045,4.338783361384948,0.0,0.0
34159,3,4159,[302 427 603 100 127],474,5,18050,4.3389423076923075,20.0,40.0
34160,3,4160,[302 427 603 100 127],666,5,18055,4.339101177601538,20.0,40.0
34161,3,4161,[405 423  79 323  71],13,2,18057,4.338539163863527,0.0,0.0
34162,3,4162,[302 427 603 100 127],271,5,18062,4.338698054287773,20.0,40.0
34163,3,4163,[302 427 603 100 127],14,4,18066,4.338616714697406,20.0,40.0
34164,3,4164,[302 427 603 100 127],334,5,18071,4.338775510204082,20.0,40.0
34165,3,4165,[302 427 603 100 127],474,5,18076,4.338934229476716,20.0,40.0
34166,3,4166,[302 427 603 100 127],13,5,18081,4.339092872570195,20.0,40.0
34167,3,4167,[ 89 265  50  11 318],200,5,18086,4.339251439539347,20.0,20.0
34168,3,4168,[302 427 603 100 127],666,5,18091,4.339409930438954,20.0,40.0
34169,3,4169,[302 427 603 100 127],339,5,18096,4.339568345323741,20.0,40.0
34170,3,4170,[302 427 603 100 127],14,4,18100,4.339486933589067,20.0,40.0
34171,3,4171,[302 427 603 100 127],334,5,18105,4.339645254074784,20.0,40.0
34172,3,4172,[302 427 603 100 127],13,5,18110,4.339803498682003,20.0,40.0
34173,3,4173,[ 28 268 161 313 111],334,2,18112,4.339242932438908,0.0,0.0
34174,3,4174,[ 50 172  96 435 204],537,1,18113,4.338443113772455,0.0,20.0
34175,3,4175,[302 427 603 100 127],664,5,18118,4.33860153256705,20.0,40.0
34176,3,4176,[302 427 603 100 127],458,5,18123,4.338759875508738,20.0,40.0
34177,3,4177,[302 427 603 100 127],474,5,18128,4.338918142651987,20.0,40.0
34178,3,4178,[302 427 603 100 127],90,5,18133,4.339076334051208,20.0,40.0
34179,3,4179,[302 427 603 100 127],334,5,18138,4.339234449760766,20.0,40.0
34180,3,4180,[302 427 603 100 127],458,5,18143,4.339392489834967,20.0,40.0
34181,3,4181,[294  28 153 282 144],92,3,18146,4.339072214251554,0.0,0.0
34182,3,4182,[302 427 603 100 127],14,4,18150,4.338991154673679,20.0,40.0
34183,3,4183,[302 427 603 100 127],666,5,18155,4.33914913957935,20.0,40.0
34184,3,4184,[302 427 603 100 127],537,5,18160,4.339307048984469,20.0,40.0
34185,3,4185,[302 427 603 100 127],666,5,18165,4.339464882943144,20.0,40.0
34186,3,4186,[237 185 144 187 174],207,4,18169,4.339383807021734,0.0,20.0
34187,3,4187,[302 427 603 100 127],14,4,18173,4.339302769818529,20.0,40.0
34188,3,4188,[100 216  50 237 185],328,4,18177,4.339221771305801,0.0,40.0
34189,3,4189,[302 427 603 100 127],745,4,18181,4.339140811455847,20.0,40.0
34190,3,4190,[302 427 603 100 127],339,5,18186,4.339298496778811,20.0,40.0
34191,3,4191,[302 427 603 100 127],458,5,18191,4.339456106870229,20.0,40.0
34192,3,4192,[302 427 603 100 127],664,5,18196,4.3396136417839255,20.0,40.0
34193,3,4193,[508 187 471 748 196],13,3,18199,4.33929422985217,0.0,0.0
34194,3,4194,[302 427 603 100 127],90,5,18204,4.339451728247914,20.0,40.0
34195,3,4195,[302 427 603 100 127],458,5,18209,4.339609151572927,20.0,40.0
34196,3,4196,[135 423 427 238  64],537,3,18212,4.3392899690254945,0.0,0.0
34197,3,4197,[302 427 603 100 127],458,5,18217,4.339447355883754,20.0,40.0
34198,3,4198,[302 427 603 100 127],271,5,18222,4.339604667778042,20.0,40.0
34199,3,4199,[302 427 603 100 127],13,5,18227,4.339761904761905,20.0,40.0
34200,3,4200,[302 427 603 100 127],745,4,18231,4.339681028326589,20.0,40.0
34201,3,4201,[328 238 197 216 210],653,2,18233,4.3391242265587815,0.0,0.0
34202,3,4202,[302 427 603 100 127],458,5,18238,4.339281465619796,20.0,40.0
34203,3,4203,[302 427 603 100 127],474,5,18243,4.339438629876308,20.0,40.0
34204,3,4204,[302 427 603 100 127],271,5,18248,4.3395957193816885,20.0,40.0
34205,3,4205,[302 427 603 100 127],745,4,18252,4.339514978601997,20.0,40.0
34206,3,4206,[286 496 161 173 180],271,4,18256,4.3394342762063225,0.0,0.0
34207,3,4207,[302 427 603 100 127],14,4,18260,4.3393536121673,20.0,40.0
34208,3,4208,[187 269 186 168 196],666,3,18263,4.33903540033262,0.0,0.0
34209,3,4209,[302 427 603 100 127],664,5,18268,4.339192399049881,20.0,40.0
34210,3,4210,[302 427 603 100 127],537,5,18273,4.33934932320114,20.0,40.0
34211,3,4211,[302 427 603 100 127],474,5,18278,4.339506172839506,20.0,40.0
34212,3,4212,[ 79 127  11 286 597],82,2,18280,4.33895086636601,0.0,20.0
34213,3,4213,[196  70 143 210 423],804,3,18283,4.338633127669673,0.0,0.0
34214,3,4214,[302 427 603 100 127],537,5,18288,4.338790035587189,20.0,40.0
34215,3,4215,[302 427 603 100 127],90,5,18293,4.338946869070209,20.0,40.0
34216,3,4216,[302 427 603 100 127],474,5,18298,4.339103628171686,20.0,40.0
34217,3,4217,[302 427 603 100 127],334,5,18303,4.339260312944523,20.0,40.0
34218,3,4218,[302 427 603 100 127],664,5,18308,4.339416923441574,20.0,40.0
34219,3,4219,[568 151 175 181 196],892,5,18313,4.3395734597156395,0.0,0.0
34220,3,4220,[302 427 603 100 127],14,4,18317,4.3394930111348025,20.0,40.0
34221,3,4221,[302 427 603 100 127],90,5,18322,4.339649455234486,20.0,40.0
34222,3,4222,[300  11 191  69  95],749,4,18326,4.3395690267582285,0.0,0.0
34223,3,4223,[318 187 176 143 211],804,4,18330,4.339488636363637,20.0,0.0
34224,3,4224,[302 427 603 100 127],537,5,18335,4.339644970414201,20.0,40.0
34225,3,4225,[111 202 237 588   7],378,3,18338,4.339327969711311,0.0,0.0
34226,3,4226,[302 427 603 100 127],474,5,18343,4.339484267802224,20.0,40.0
34227,3,4227,[176 174 289 286 294],488,3,18346,4.339167455061495,0.0,20.0
34228,3,4228,[302 427 603 100 127],745,4,18350,4.339087254670135,20.0,40.0
34229,3,4229,[268  70  71 238 237],7,3,18353,4.338770685579196,0.0,0.0
34230,3,4230,[302 427 603 100 127],339,5,18358,4.338926967619948,20.0,40.0
34231,3,4231,[302 427 603 100 127],339,5,18363,4.3390831758034025,20.0,40.0
34232,3,4232,[302 427 603 100 127],537,5,18368,4.339239310181904,20.0,40.0
34233,3,4233,[194  98  89 546 435],343,3,18371,4.338923004251299,0.0,20.0
34234,3,4234,[302 427 603 100 127],537,5,18376,4.339079102715466,20.0,40.0
34235,3,4235,[289 121 427 200 183],374,3,18379,4.33876298394712,0.0,0.0
34236,3,4236,[302 427 603 100 127],339,5,18384,4.338919046495161,20.0,40.0
34237,3,4237,[302 427 603 100 127],745,4,18388,4.338839075035394,20.0,40.0
34238,3,4238,[257 273 151  50  89],279,3,18391,4.338523236612408,0.0,20.0
34239,3,4239,[181 161  28 322  96],454,3,18394,4.338207547169811,0.0,0.0
34240,3,4240,[302 427 603 100 127],13,5,18399,4.338363593492101,20.0,40.0
34241,3,4241,[302 427 603 100 127],334,5,18404,4.338519566242338,20.0,40.0
34242,3,4242,[302 427 603 100 127],537,5,18409,4.338675465472543,20.0,40.0
34243,3,4243,[302 427 603 100 127],14,4,18413,4.3385956644674835,20.0,40.0
34244,3,4244,[302 427 603 100 127],745,4,18417,4.33851590106007,20.0,40.0
34245,3,4245,[238  11 318 271 211],64,4,18421,4.33843617522374,20.0,0.0
34246,3,4246,[271 186 405 211  98],749,4,18425,4.338356486931952,0.0,20.0
34247,3,4247,[302 427 603 100 127],666,5,18430,4.338512241054614,20.0,40.0
34248,3,4248,[302 427 603 100 127],90,5,18435,4.338667921863968,20.0,40.0
34249,3,4249,[302 427 603 100 127],745,4,18439,4.338588235294118,20.0,40.0
34250,3,4250,[302 427 603 100 127],666,5,18444,4.338743824982357,20.0,40.0
34251,3,4251,[245  69 197 168 211],488,3,18447,4.3384289746001885,0.0,0.0
34252,3,4252,[302 427 603 100 127],474,5,18452,4.338584528568069,20.0,40.0
34253,3,4253,[302 427 603 100 127],664,5,18457,4.3387400094029145,20.0,40.0
34254,3,4254,[302 427 603 100 127],666,5,18462,4.338895417156286,20.0,40.0
34255,3,4255,[302 427 603 100 127],271,5,18467,4.339050751879699,20.0,40.0
34256,3,4256,[302 427 603 100 127],458,5,18472,4.339206013624619,20.0,40.0
34257,3,4257,[302 427 603 100 127],745,4,18476,4.3391263503992485,20.0,40.0
34258,3,4258,[588 282 238  88  22],311,5,18481,4.339281521483916,0.0,0.0
34259,3,4259,[302 427 603 100 127],13,5,18486,4.33943661971831,20.0,40.0
34260,3,4260,[302 427 603 100 127],664,5,18491,4.33959164515372,20.0,40.0
34261,3,4261,[302 427 603 100 127],13,5,18496,4.339746597841389,20.0,40.0
34262,3,4262,[302 427 603 100 127],664,5,18501,4.3399014778325125,20.0,40.0
34263,3,4263,[568 172 135 234 405],738,3,18504,4.3395872420262664,0.0,0.0
34264,3,4264,[302 427 603 100 127],458,5,18509,4.339742086752638,20.0,40.0
34265,3,4265,[302 427 603 100 127],334,5,18514,4.339896858884201,20.0,40.0
34266,3,4266,[302 427 603 100 127],537,5,18519,4.340051558471995,20.0,40.0
34267,3,4267,[405 172  98 153  22],749,4,18523,4.339971883786316,0.0,20.0
34268,3,4268,[302 427 603 100 127],537,5,18528,4.340126493323964,20.0,40.0
34269,3,4269,[194  56  25 179  71],194,4,18532,4.340046838407494,0.0,0.0
34270,3,4270,[302 427 603 100 127],271,5,18537,4.340201357995785,20.0,40.0
34271,3,4271,[302 427 603 100 127],90,5,18542,4.340355805243446,20.0,40.0
34272,3,4272,[302 427 603 100 127],745,4,18546,4.340276152586005,20.0,40.0
34273,3,4273,[302 427 603 100 127],745,4,18550,4.340196537201685,20.0,40.0
34274,3,4274,[302 427 603 100 127],14,4,18554,4.340116959064328,20.0,40.0
34275,3,4275,[603 200   4  11 181],474,4,18558,4.340037418147801,20.0,0.0
34276,3,4276,[302 427 603 100 127],271,5,18563,4.340191723170447,20.0,40.0
34277,3,4277,[302 427 603 100 127],666,5,18568,4.340345956054231,20.0,40.0
34278,3,4278,[302 427 603 100 127],13,5,18573,4.340500116849731,20.0,40.0
34279,3,4279,[496  82 588  56 117],234,1,18574,4.3397196261682245,0.0,0.0
34280,3,4280,[183 143 204 222 121],254,4,18578,4.339640270964728,0.0,0.0
34281,3,4281,[211 143 265 427 515],59,4,18582,4.339560952825782,0.0,0.0
34282,3,4282,[302 427 603 100 127],339,5,18587,4.339715152930189,20.0,40.0
34283,3,4283,[302 427 603 100 127],745,4,18591,4.339635854341736,20.0,40.0
34284,3,4284,[302 427 603 100 127],339,5,18596,4.339789964994166,20.0,40.0
34285,3,4285,[302 427 603 100 127],458,5,18601,4.339944003733084,20.0,40.0
34286,3,4286,[385 135 655 237 117],474,5,18606,4.340097970608817,0.0,0.0
34287,3,4287,[302 427 603 100 127],664,5,18611,4.340251865671642,20.0,40.0
34288,3,4288,[302 427 603 100 127],537,5,18616,4.340405688971789,20.0,40.0
34289,3,4289,[302 427 603 100 127],271,5,18621,4.34055944055944,20.0,40.0
34290,3,4290,[302 427 603 100 127],271,5,18626,4.340713120484735,20.0,40.0
34291,3,4291,[191 748 127 202  64],311,5,18631,4.340866728797764,0.0,20.0
34292,3,4292,[302 427 603 100 127],90,5,18636,4.3410202655485675,20.0,40.0
34293,3,4293,[202  69 313 235 275],537,2,18638,4.340475081509083,0.0,0.0
34294,3,4294,[302 427 603 100 127],90,5,18643,4.340628637951106,20.0,40.0
34295,3,4295,[302 427 603 100 127],458,5,18648,4.340782122905028,20.0,40.0
34296,3,4296,[302 427 603 100 127],664,5,18653,4.3409355364207585,20.0,40.0
34297,3,4297,[302 427 603 100 127],664,5,18658,4.341088878548162,20.0,40.0
34298,3,4298,[302 427 603 100 127],666,5,18663,4.341242149337055,20.0,40.0
34299,3,4299,[265 100 175 195 234],7,5,18668,4.341395348837209,0.0,20.0
34300,3,4300,[125 328 427   1 322],313,3,18671,4.341083468960707,0.0,0.0
34301,3,4301,[302 427 603 100 127],474,5,18676,4.341236634123663,20.0,40.0
34302,3,4302,[302 427 603 100 127],745,4,18680,4.341157332093888,20.0,40.0
34303,3,4303,[302 427 603 100 127],474,5,18685,4.341310408921933,20.0,40.0
34304,3,4304,[302 427 603 100 127],14,4,18689,4.3412311265969805,20.0,40.0
34305,3,4305,[176 151 301 435 185],537,1,18690,4.340455178820251,0.0,0.0
34306,3,4306,[302 427 603 100 127],90,5,18695,4.340608312050151,20.0,40.0
34307,3,4307,[302 427 603 100 127],458,5,18700,4.340761374187558,20.0,40.0
34308,3,4308,[302 427 603 100 127],334,5,18705,4.340914365281968,20.0,40.0
34309,3,4309,[302 427 603 100 127],474,5,18710,4.341067285382831,20.0,40.0
34310,3,4310,[176 135 603 271 300],334,2,18712,4.340524240315472,20.0,0.0
34311,3,4311,[302 427 603 100 127],334,5,18717,4.340677179962894,20.0,40.0
34312,3,4312,[302 427 603 100 127],474,5,18722,4.340830048690007,20.0,40.0
34313,3,4313,[302 427 603 100 127],537,5,18727,4.340982846546129,20.0,40.0
34314,3,4314,[302 427 603 100 127],271,5,18732,4.341135573580533,20.0,40.0
34315,3,4315,[302 427 603 100 127],537,5,18737,4.341288229842447,20.0,40.0
34316,3,4316,[302 427 603 100 127],537,5,18742,4.341440815381052,20.0,40.0
34317,3,4317,[302 427 603 100 127],537,5,18747,4.341593330245484,20.0,40.0
34318,3,4318,[302 427 603 100 127],666,5,18752,4.341745774484834,20.0,40.0
34319,3,4319,[302 427 603 100 127],339,5,18757,4.3418981481481485,20.0,40.0
34320,3,4320,[302 427 603 100 127],458,5,18762,4.3420504512844245,20.0,40.0
34321,3,4321,[302 427 603 100 127],666,5,18767,4.342202683942619,20.0,40.0
34322,3,4322,[302 427 603 100 127],458,5,18772,4.34235484617164,20.0,40.0
34323,3,4323,[302 427 603 100 127],474,5,18777,4.342506938020351,20.0,40.0
34324,3,4324,[302 427 603 100 127],474,5,18782,4.342658959537572,20.0,40.0
34325,3,4325,[302 427 603 100 127],339,5,18787,4.342810910772076,20.0,40.0
34326,3,4326,[191  56 125 265 132],92,4,18791,4.342731684770048,0.0,0.0
34327,3,4327,[185 597 100 288 496],650,2,18793,4.342190388170056,0.0,20.0
34328,3,4328,[302 427 603 100 127],458,5,18798,4.342342342342342,20.0,40.0
34329,3,4329,[302 427 603 100 127],664,5,18803,4.342494226327944,20.0,40.0
34330,3,4330,[427 435 568 144 302],339,3,18806,4.342184253059339,0.0,0.0
34331,3,4331,[302 427 603 100 127],745,4,18810,4.342105263157895,20.0,40.0
34332,3,4332,[302 427 603 100 127],666,5,18815,4.342257096699746,20.0,40.0
34333,3,4333,[313 144   4  95 135],92,4,18819,4.342178126442086,0.0,0.0
34334,3,4334,[302 427 603 100 313],537,5,18824,4.3423298731257205,20.0,20.0
34335,3,4335,[210 195 655  95 185],308,5,18829,4.342481549815498,0.0,0.0
34336,3,4336,[222 496 475 186 655],506,4,18833,4.3424025824302515,0.0,0.0
34337,3,4337,[302 427 603 100 313],13,5,18838,4.342554172429691,20.0,20.0
34338,3,4338,[161 186   9  28 194],64,4,18842,4.3424752247061535,0.0,0.0
34339,3,4339,[ 82 191 135 161 183],455,5,18847,4.3426267281105995,0.0,0.0
34340,3,4340,[302 427 603 100 313],383,4,18851,4.342547800046073,20.0,20.0
34341,3,4341,[302 427 603 100 127],14,4,18855,4.342468908337172,20.0,40.0
34342,3,4342,[302 427 603 100 127],664,5,18860,4.342620308542482,20.0,40.0
34343,3,4343,[302 427 603 100 127],339,5,18865,4.342771639042358,20.0,40.0
34344,3,4344,[302 427 603 100 127],339,5,18870,4.342922899884925,20.0,40.0
34345,3,4345,[245  96  15 111 271],749,4,18874,4.342843994477681,0.0,0.0
34346,3,4346,[302 427 603 100 127],13,5,18879,4.342995169082125,20.0,40.0
34347,3,4347,[302 427 603 100 127],339,5,18884,4.343146274149034,20.0,40.0
34348,3,4348,[ 69  71  95 269 179],13,3,18887,4.342837433892849,0.0,0.0
34349,3,4349,[301 323 286 135 216],537,1,18888,4.3420689655172415,0.0,0.0
34350,3,4350,[302 427 603 100 127],271,5,18893,4.342220179269134,20.0,40.0
34351,3,4351,[302 427 603 100 127],474,5,18898,4.342371323529412,20.0,40.0
34352,3,4352,[302 427 603 100 127],14,4,18902,4.342292671720652,20.0,40.0
34353,3,4353,[302 427 603 100 127],458,5,18907,4.342443729903537,20.0,40.0
34354,3,4354,[546 179 180 515 182],92,4,18911,4.342365097588978,0.0,0.0
34355,3,4355,[302 427 603 100 127],90,5,18916,4.342516069788797,20.0,40.0
34356,3,4356,[423 603 357   7 175],659,4,18920,4.342437456965802,40.0,0.0
34357,3,4357,[302 427 603 100 127],339,5,18925,4.3425883432767325,20.0,40.0
34358,3,4358,[302 427 603 100 127],664,5,18930,4.342739160357881,20.0,40.0
34359,3,4359,[302 427 603 100 127],90,5,18935,4.342889908256881,20.0,40.0
34360,3,4360,[302 427 603 100 127],537,5,18940,4.343040587021325,20.0,40.0
34361,3,4361,[302 427 603 100 127],666,5,18945,4.343191196698762,20.0,40.0
34362,3,4362,[185 181 195 588  25],95,2,18947,4.342654137061655,0.0,0.0
34363,3,4363,[302 427 603 100 127],666,5,18952,4.342804766269477,20.0,40.0
34364,3,4364,[302 427 603 100 127],474,5,18957,4.342955326460481,20.0,40.0
34365,3,4365,[302 427 603 100 127],664,5,18962,4.343105817682089,20.0,40.0
34366,3,4366,[302 427 603 100 127],664,5,18967,4.343256239981681,20.0,40.0
34367,3,4367,[302 427 603 100 127],537,5,18972,4.343406593406593,20.0,40.0
34368,3,4368,[302 427 603 100 127],474,5,18977,4.34355687800412,20.0,40.0
34369,3,4369,[302 427 603 100 127],339,5,18982,4.34370709382151,20.0,40.0
34370,3,4370,[118 289  89 135  15],455,2,18984,4.343170899107756,0.0,0.0
34371,3,4371,[302 427 603 100 127],537,5,18989,4.343321134492223,20.0,40.0
34372,3,4372,[302 427 603 100 127],90,5,18994,4.343471301166248,20.0,40.0
34373,3,4373,[186 403 405  71 135],328,3,18997,4.3431641518061275,0.0,0.0
34374,3,4374,[302 427 603 100 127],474,5,19002,4.3433142857142855,20.0,40.0
34375,3,4375,[302 427 603 100 127],334,5,19007,4.343464351005484,20.0,40.0
34376,3,4376,[302 427 603 100 127],339,5,19012,4.343614347726754,20.0,40.0
34377,3,4377,[483 294   1 546 168],194,4,19016,4.343535861123801,20.0,0.0
34378,3,4378,[302 427 603 100 127],474,5,19021,4.343685773007536,20.0,40.0
34379,3,4379,[302 427 603 100 127],90,5,19026,4.343835616438356,20.0,40.0
34380,3,4380,[245 405 181  89 403],313,2,19028,4.343300616297649,0.0,0.0
34381,3,4381,[302 427 603 100 127],339,5,19033,4.343450479233227,20.0,40.0
34382,3,4382,[302 427 603 100 127],537,5,19038,4.3436002737850785,20.0,40.0
34383,3,4383,[302 427 603 100 127],14,4,19042,4.343521897810219,20.0,40.0
34384,3,4384,[302 427 603 100 127],458,5,19047,4.343671607753706,20.0,40.0
34385,3,4385,[302 427 603 100 127],745,4,19051,4.34359325125399,20.0,40.0
34386,3,4386,[216 181 195 318 100],92,3,19054,4.343286984271712,20.0,20.0
34387,3,4387,[302 427 603 100 127],271,5,19059,4.343436645396536,20.0,40.0
34388,3,4388,[302 427 603 100 127],14,4,19063,4.343358395989975,20.0,40.0
34389,3,4389,[302 427 603 100 127],339,5,19068,4.343507972665148,20.0,40.0
34390,3,4390,[302 427 603 100 127],537,5,19073,4.343657481211569,20.0,40.0
34391,3,4391,[302 427 603 100 127],458,5,19078,4.343806921675774,20.0,40.0
34392,3,4392,[302 427 603 100 127],666,5,19083,4.343956294104257,20.0,40.0
34393,3,4393,[211 183 174 202 172],59,5,19088,4.344105598543468,0.0,20.0
34394,3,4394,[144  56  96  82  22],328,5,19093,4.344254835039818,0.0,0.0
34395,3,4395,[302 427 603 100 127],334,5,19098,4.3444040036396725,20.0,40.0
34396,3,4396,[302 427 603 100 127],537,5,19103,4.344553104389356,20.0,40.0
34397,3,4397,[173 175 655 328 211],479,5,19108,4.344702137335152,0.0,0.0
34398,3,4398,[196 197  88 603  70],234,2,19110,4.344169129347579,20.0,0.0
34399,3,4399,[302 427 603 100 127],13,5,19115,4.344318181818182,20.0,40.0
34400,3,4400,[302 427 603 100 127],334,5,19120,4.3444671665530565,20.0,40.0
34401,3,4401,[ 64   9 127 196 125],455,4,19124,4.344388914129941,0.0,20.0
34402,3,4402,[302 427 603 100 127],334,5,19129,4.34453781512605,20.0,40.0
34403,3,4403,[302 427 603 100 127],745,4,19133,4.344459582198001,20.0,40.0
34404,3,4404,[302 427 603 100 127],14,4,19137,4.344381384790012,20.0,40.0
34405,3,4405,[ 70 161 211 204 294],653,2,19139,4.343849296413981,0.0,0.0
34406,3,4406,[603 168 269 143 210],524,1,19140,4.343090537780803,20.0,0.0
34407,3,4407,[302 427 603 100 127],90,5,19145,4.343239564428312,20.0,40.0
34408,3,4408,[302 427 603 100 127],339,5,19150,4.343388523474711,20.0,40.0
34409,3,4409,[302 427 603 100 127],90,5,19155,4.343537414965986,20.0,40.0
34410,3,4410,[302 427 603 100 127],13,5,19160,4.343686238948084,20.0,40.0
34411,3,4411,[302 427 603 100 127],339,5,19165,4.343834995466908,20.0,40.0
34412,3,4412,[302 427 603 100 127],474,5,19170,4.343983684568321,20.0,40.0
34413,3,4413,[302 427 603 100 127],334,5,19175,4.3441323062981425,20.0,40.0
34414,3,4414,[200  97 173 185 210],59,5,19180,4.344280860702152,0.0,0.0
34415,3,4415,[302 427 603 100 127],664,5,19185,4.344429347826087,20.0,40.0
34416,3,4416,[302 427 603 100 127],537,5,19190,4.344577767715644,20.0,40.0
34417,3,4417,[302 427 603 100 127],666,5,19195,4.344726120416478,20.0,40.0
34418,3,4418,[276 210 742 496 135],533,3,19198,4.3444218148902465,0.0,0.0
34419,3,4419,[323  50 301   4 603],650,2,19200,4.343891402714932,20.0,20.0
34420,3,4420,[153 144 237  56 185],666,3,19203,4.343587423659805,0.0,0.0
34421,3,4421,[302 427 603 100 127],537,5,19208,4.343735866123926,20.0,40.0
34422,3,4422,[234 182 427 265 483],7,5,19213,4.343884241465069,20.0,0.0
34423,3,4423,[289 403 300  28  98],788,4,19217,4.34380650994575,0.0,20.0
34424,3,4424,[204 435 216  79  95],524,3,19220,4.343502824858757,0.0,0.0
34425,3,4425,[302 427 603 100 127],339,5,19225,4.3436511522819705,20.0,40.0
34426,3,4426,[302 427 603 100 127],666,5,19230,4.343799412694827,20.0,40.0
34427,3,4427,[302 427 603 100 127],474,5,19235,4.343947606142728,20.0,40.0
34428,3,4428,[302 427 603 100 127],664,5,19240,4.344095732671032,20.0,40.0
34429,3,4429,[179  97 183 182 121],374,4,19244,4.344018058690745,0.0,0.0
34430,3,4430,[302 427 603 100 127],271,5,19249,4.344166102459941,20.0,40.0
34431,3,4431,[302 427 603 100 127],537,5,19254,4.344314079422382,20.0,40.0
34432,3,4432,[427 237 161  97 210],533,3,19257,4.344010827881796,0.0,0.0
34433,3,4433,[302 427 603 100 127],666,5,19262,4.344158773116825,20.0,40.0
34434,3,4434,[302 427 603 100 127],664,5,19267,4.3443066516347235,20.0,40.0
34435,3,4435,[302 427 603 100 127],339,5,19272,4.344454463480613,20.0,40.0
34436,3,4436,[276 100 257 111 282],119,4,19276,4.344376831192247,0.0,20.0
34437,3,4437,[ 96 180 132  69 173],311,5,19281,4.344524560612888,0.0,0.0
34438,3,4438,[302 427 603 100 127],339,5,19286,4.344672223473755,20.0,40.0
34439,3,4439,[302 427 603 100 127],474,5,19291,4.34481981981982,20.0,40.0
34440,3,4440,[302 427 603 100 127],90,5,19296,4.344967349696015,20.0,40.0
34441,3,4441,[216 328  11 127 100],90,4,19300,4.344889689329131,0.0,40.0
34442,3,4442,[302 427 603 100 127],537,5,19305,4.345037137069547,20.0,40.0
34443,3,4443,[302 427 603 100 127],537,5,19310,4.345184518451846,20.0,40.0
34444,3,4444,[302 427 603 100 127],271,5,19315,4.3453318335208095,20.0,40.0
34445,3,4445,[302 427 603 100 127],664,5,19320,4.345479082321187,20.0,40.0
34446,3,4446,[302 427 603 100 127],271,5,19325,4.3456262648976836,20.0,40.0
34447,3,4447,[302 427 603 100 127],745,4,19329,4.345548561151079,20.0,40.0
34448,3,4448,[302 427 603 100 127],90,5,19334,4.345695661946505,20.0,40.0
34449,3,4449,[302 427 603 100 127],537,5,19339,4.345842696629213,20.0,40.0
34450,3,4450,[385 151   7 153 173],650,4,19343,4.3457649966299705,0.0,0.0
34451,3,4451,[302 427 603 100 127],745,4,19347,4.345687331536388,20.0,40.0
34452,3,4452,[302 427 603 100 127],537,5,19352,4.345834269032113,20.0,40.0
34453,3,4453,[427 200   7 289 322],537,2,19354,4.345307588684329,0.0,0.0
34454,3,4454,[300 215 275 180 179],85,3,19357,4.345005611672279,0.0,0.0
34455,3,4455,[302 427 603 100 127],666,5,19362,4.345152603231598,20.0,40.0
34456,3,4456,[302 427 603 100 127],13,5,19367,4.3452995288310525,20.0,40.0
34457,3,4457,[235 215 237 742 118],92,2,19369,4.344773441004935,0.0,0.0
34458,3,4458,[302 427 603 100 127],90,5,19374,4.344920385736712,20.0,40.0
34459,3,4459,[302 427 603 100 127],458,5,19379,4.345067264573991,20.0,40.0
34460,3,4460,[302 427 603 100 127],339,5,19384,4.345214077561085,20.0,40.0
34461,3,4461,[302 427 603 100 127],537,5,19389,4.345360824742268,20.0,40.0
34462,3,4462,[ 50 238 196 588  15],308,3,19392,4.345059377100605,0.0,20.0
34463,3,4463,[302 427 603 100 127],14,4,19396,4.344982078853047,20.0,40.0
34464,3,4464,[237 435 117  64 210],378,4,19400,4.3449048152295635,0.0,0.0
34465,3,4465,[302 427 603 100 127],664,5,19405,4.345051500223914,20.0,40.0
34466,3,4466,[302 427 603 100 127],90,5,19410,4.345198119543317,20.0,40.0
34467,3,4467,[ 95 182  89 357 172],479,5,19415,4.345344673231871,20.0,0.0
34468,3,4468,[168 265  56 215  50],653,3,19418,4.345043633922578,0.0,20.0
34469,3,4469,[302 427 603 100 127],666,5,19423,4.3451901565995525,20.0,40.0
34470,3,4470,[302 427 603 100 127],334,5,19428,4.345336613732946,20.0,40.0
34471,3,4471,[302 427 603 100 127],537,5,19433,4.345483005366726,20.0,40.0
34472,3,4472,[742  88 121 125  69],92,3,19436,4.345182204337134,0.0,0.0
34473,3,4473,[435 302 153   1  82],883,3,19439,4.344881537773804,0.0,0.0
34474,3,4474,[302 427 603 100 127],339,5,19444,4.345027932960894,20.0,40.0
34475,3,4475,[302 427 603 100 127],666,5,19449,4.345174262734584,20.0,40.0
34476,3,4476,[302 427 603 100 127],339,5,19454,4.345320527138709,20.0,40.0
34477,3,4477,[ 69  50 678 215 197],263,4,19458,4.345243412237606,0.0,20.0
34478,3,4478,[125 196 132 286 181],378,4,19462,4.345166331770485,0.0,0.0
34479,3,4479,[302 427 603 100 127],458,5,19467,4.3453125,20.0,40.0
34480,3,4480,[302 427 603 100 127],664,5,19472,4.345458602990404,20.0,40.0
34481,3,4481,[385 427 318 323 294],788,1,19473,4.3447121820615795,20.0,0.0
34482,3,4482,[269 181  22 168 302],334,4,19477,4.3446352888690605,0.0,0.0
34483,3,4483,[302 427 603 100 127],334,5,19482,4.34478144513827,20.0,40.0
34484,3,4484,[302 427 603 100 127],664,5,19487,4.344927536231884,20.0,40.0
34485,3,4485,[302 427 603 100 127],271,5,19492,4.345073562193491,20.0,40.0
34486,3,4486,[302 427 603 100 127],458,5,19497,4.345219523066637,20.0,40.0
34487,3,4487,[302 427 603 100 127],666,5,19502,4.345365418894831,20.0,40.0
34488,3,4488,[302 427 603 100 127],13,5,19507,4.345511249721541,20.0,40.0
34489,3,4489,[302 427 603 100 127],271,5,19512,4.3456570155902,20.0,40.0
34490,3,4490,[302 427 603 100 127],458,5,19517,4.3458027165442,20.0,40.0
34491,3,4491,[302 427 603 100 127],458,5,19522,4.345948352626892,20.0,40.0
34492,3,4492,[302 427 603 100 127],14,4,19526,4.3458713554417985,20.0,40.0
34493,3,4493,[302 427 603 100 127],334,5,19531,4.346016911437472,20.0,40.0
34494,3,4494,[215 742 403 144 176],804,4,19535,4.345939933259177,0.0,0.0
34495,3,4495,[302 427 603 100 127],90,5,19540,4.346085409252669,20.0,40.0
34496,3,4496,[273 265 435  82  69],524,4,19544,4.3460084500778295,0.0,0.0
34497,3,4497,[328 496 742 195 100],533,5,19549,4.346153846153846,0.0,20.0
34498,3,4498,[302 427 603 100 127],537,5,19554,4.3462991775950215,20.0,40.0
34499,3,4499,[302 427 603 100 127],339,5,19559,4.346444444444445,20.0,40.0
34500,3,4500,[196  28 153  12 588],378,5,19564,4.3465896467451675,20.0,0.0
34501,3,4501,[302 427 603 100 127],14,4,19568,4.346512661039538,20.0,40.0
34502,3,4502,[302 427 603 100 127],13,5,19573,4.346657783699755,20.0,40.0
34503,3,4503,[302 427 603 100 127],537,5,19578,4.3468028419182945,20.0,40.0
34504,3,4504,[302 427 603 100 127],474,5,19583,4.346947835738069,20.0,40.0
34505,3,4505,[302 427 603 100 127],458,5,19588,4.347092765201953,20.0,40.0
34506,3,4506,[302 427 603 100 127],666,5,19593,4.347237630352785,20.0,40.0
34507,3,4507,[302 427 603 100 127],90,5,19598,4.347382431233363,20.0,40.0
34508,3,4508,[302 427 603 100 127],334,5,19603,4.347527167886449,20.0,40.0
34509,3,4509,[302 427 603 100 127],537,5,19608,4.347671840354767,20.0,40.0
34510,3,4510,[302 427 603 100 127],271,5,19613,4.347816448681002,20.0,40.0
34511,3,4511,[302 427 603 100 127],339,5,19618,4.347960992907802,20.0,40.0
34512,3,4512,[302 427 603 100 127],666,5,19623,4.3481054730777755,20.0,40.0
34513,3,4513,[302 427 603 100 127],666,5,19628,4.348249889233496,20.0,40.0
34514,3,4514,[496 186 211 127 546],749,4,19632,4.3481727574750835,0.0,20.0
34515,3,4515,[302 427 603 100 127],458,5,19637,4.348317094774137,20.0,40.0
34516,3,4516,[ 12 405 234 210 302],378,4,19641,4.34823998228913,20.0,0.0
34517,3,4517,[302 427 603 100 127],664,5,19646,4.34838424081452,20.0,40.0
34518,3,4518,[302 427 603 100 127],458,5,19651,4.348528435494578,20.0,40.0
34519,3,4519,[302 427 603 100 127],339,5,19656,4.348672566371682,20.0,40.0
34520,3,4520,[302 427 603 100 127],666,5,19661,4.348816633488166,20.0,40.0
34521,3,4521,[302 427 603 100 127],458,5,19666,4.348960636886334,20.0,40.0
34522,3,4522,[302 427 603 100 127],339,5,19671,4.349104576608446,20.0,40.0
34523,3,4523,[302 427 603 100 127],474,5,19676,4.349248452696728,20.0,40.0
34524,3,4524,[ 98 132 144 655 318],7,5,19681,4.34939226519337,20.0,20.0
34525,3,4525,[302 427 603 100 127],664,5,19686,4.349536014140521,20.0,40.0
34526,3,4526,[282 173 197 182 742],334,3,19689,4.349237905897946,0.0,0.0
34527,3,4527,[302 427 603 100 127],90,5,19694,4.349381625441696,20.0,40.0
34528,3,4528,[655 475  22 234 322],92,3,19697,4.349083682932215,0.0,0.0
34529,3,4529,[302 427 603 100 127],90,5,19702,4.349227373068433,20.0,40.0
34530,3,4530,[302 427 603 100 127],537,5,19707,4.349370999779298,20.0,40.0
34531,3,4531,[ 96 328   4 210 143],537,0,19707,4.348411297440424,0.0,0.0
34532,3,4532,[ 56 515 174 216 151],59,5,19712,4.348555040811824,0.0,20.0
34533,3,4533,[100 515 546 210  56],87,4,19716,4.348478164975739,0.0,20.0
34534,3,4534,[197 655 196 181 222],488,2,19718,4.347960308710033,0.0,0.0
34535,3,4535,[302 427 603 100 127],334,5,19723,4.34810405643739,20.0,40.0
34536,3,4536,[302 427 603 100 127],13,5,19728,4.348247740797884,20.0,40.0
34537,3,4537,[151 111 265 100 180],234,1,19729,4.347509916262671,0.0,20.0
34538,3,4538,[655 121 588 153 385],95,4,19733,4.347433355364617,0.0,0.0
34539,3,4539,[100 318  11  79 173],892,4,19737,4.347356828193832,20.0,20.0
34540,3,4540,[302 427 603 100 127],537,5,19742,4.347500550539529,20.0,40.0
34541,3,4541,[302 427 603 100 127],666,5,19747,4.347644209599295,20.0,40.0
34542,3,4542,[302 427 603 100 127],271,5,19752,4.347787805414924,20.0,40.0
34543,3,4543,[302 427 603 100 127],339,5,19757,4.347931338028169,20.0,40.0
34544,3,4544,[302 427 603 100 127],537,5,19762,4.3480748074807485,20.0,40.0
34545,3,4545,[222 435 117 742 161],158,2,19764,4.347558293004839,0.0,0.0
34546,3,4546,[302 427 603 100 127],14,4,19768,4.347481856168902,20.0,40.0
34547,3,4547,[427 215   9 238 135],308,4,19772,4.34740545294635,0.0,0.0
34548,3,4548,[ 97 271  98 175 423],738,4,19776,4.347329083315015,0.0,20.0
34549,3,4549,[302 427 603 100 127],474,5,19781,4.347472527472528,20.0,40.0
34550,3,4550,[265 257 471  88 276],378,4,19785,4.3473961766644695,0.0,0.0
34551,3,4551,[302 427 603 100 127],271,5,19790,4.347539543057996,20.0,40.0
34552,3,4552,[195 222 182 151 435],533,3,19793,4.347243575664397,0.0,0.0
34553,3,4553,[100 211 322 237 323],90,4,19797,4.347167325428195,0.0,20.0
34554,3,4554,[302 427 603 100 127],666,5,19802,4.347310647639956,20.0,40.0
34555,3,4555,[215 195  28 268 289],234,2,19804,4.346795434591747,0.0,0.0
34556,3,4556,[302 427 603 100 127],745,4,19808,4.346719332894448,20.0,40.0
34557,3,4557,[ 56 423  50 185 144],374,3,19811,4.346423870118473,0.0,20.0
34558,3,4558,[151 300 328  11  97],788,2,19813,4.345909190611977,0.0,0.0
34559,3,4559,[302 427 603 100 127],474,5,19818,4.346052631578948,20.0,40.0
34560,3,4560,[ 56 265 202 176 196],882,5,19823,4.346196009647008,0.0,0.0
34561,3,4561,[222 294 187  22 111],234,2,19825,4.345681718544498,0.0,0.0
34562,3,4562,[302 427 603 100 127],339,5,19830,4.345825115055884,20.0,40.0
34563,3,4563,[603 117 313  71   9],543,3,19833,4.345530236634531,20.0,0.0
34564,3,4564,[302 427 603 100 127],666,5,19838,4.345673603504928,20.0,40.0
34565,3,4565,[302 427 603 100 127],13,5,19843,4.345816907577748,20.0,40.0
34566,3,4566,[302 427 603 100 127],14,4,19847,4.345741186774688,20.0,40.0
34567,3,4567,[302 427 603 100 127],537,5,19852,4.3458844133099825,20.0,40.0
34568,3,4568,[302 427 603 100 127],537,5,19857,4.346027577150361,20.0,40.0
34569,3,4569,[302 427 603 100 127],271,5,19862,4.34617067833698,20.0,40.0
34570,3,4570,[181 111 187 117 742],158,3,19865,4.3458761758914894,0.0,0.0
34571,3,4571,[302 427 603 100 127],334,5,19870,4.346019247594051,20.0,40.0
34572,3,4572,[302 427 603 100 127],666,5,19875,4.346162256724251,20.0,40.0
34573,3,4573,[302 427 603 100 127],474,5,19880,4.346305203323131,20.0,40.0
34574,3,4574,[302 427 603 100 127],14,4,19884,4.346229508196721,20.0,40.0
34575,3,4575,[ 22  28 132   8 318],488,3,19887,4.345935314685315,20.0,0.0
34576,3,4576,[302 427 603 100 127],745,4,19891,4.345859733449858,20.0,40.0
34577,3,4577,[302 427 603 100 127],666,5,19896,4.346002621231979,20.0,40.0
34578,3,4578,[302 427 603 100 127],339,5,19901,4.346145446604062,20.0,40.0
34579,3,4579,[302 427 603 100 127],745,4,19905,4.346069868995633,20.0,40.0
34580,3,4580,[302 427 603 100 127],537,5,19910,4.34621261733246,20.0,40.0
34581,3,4581,[175 174 318   7  97],738,5,19915,4.346355303360978,20.0,20.0
34582,3,4582,[302 427 603 100 127],666,5,19920,4.346497927121972,20.0,40.0
34583,3,4583,[302 427 603 100 127],458,5,19925,4.346640488656195,20.0,40.0
34584,3,4584,[302 427 603 100 127],339,5,19930,4.346782988004362,20.0,40.0
34585,3,4585,[302 427 603 100 127],745,4,19934,4.346707370257305,20.0,40.0
34586,3,4586,[302 427 603 100 127],458,5,19939,4.346849792892958,20.0,40.0
34587,3,4587,[258 237  82 216 245],313,1,19940,4.346120313862249,0.0,0.0
34588,3,4588,[302 427 603 100 127],745,4,19944,4.346044889954238,20.0,40.0
34589,3,4589,[302 427 603 100 127],664,5,19949,4.346187363834423,20.0,40.0
34590,3,4590,[302 427 603 100 127],664,5,19954,4.346329775648007,20.0,40.0
34591,3,4591,[302 427 603 100 127],14,4,19958,4.3462543554006965,20.0,40.0
34592,3,4592,[143   8 423  64 282],92,3,19961,4.3459612453733945,0.0,0.0
34593,3,4593,[302 427 603 100 127],745,4,19965,4.345885938180235,20.0,40.0
34594,3,4594,[302 427 603 100 127],339,5,19970,4.3460282916213275,20.0,40.0
34595,3,4595,[302 427 603 100 127],474,5,19975,4.346170583115753,20.0,40.0
34596,3,4596,[302 427 603 100 127],90,5,19980,4.346312812703937,20.0,40.0
34597,3,4597,[302 427 603 100 127],537,5,19985,4.346454980426272,20.0,40.0
34598,3,4598,[111 234 183 276  82],385,0,19985,4.345509893455099,0.0,0.0
34599,3,4599,[302 427 603 100 127],334,5,19990,4.345652173913043,20.0,40.0
34600,3,4600,[195 161 322   1   8],92,3,19993,4.345359704412084,0.0,0.0
34601,3,4601,[176   1 143 211 175],537,2,19995,4.344850065189048,0.0,0.0
34602,3,4602,[302 427 603 100 127],334,5,20000,4.344992396263306,20.0,40.0
34603,3,4603,[302 427 603 100 127],666,5,20005,4.345134665508254,20.0,40.0
34604,3,4604,[655 265 200  11   1],308,4,20009,4.345059717698154,0.0,0.0
34605,3,4605,[302 427 603 100 127],334,5,20014,4.345201910551455,20.0,40.0
34606,3,4606,[168 385  28  95 211],804,4,20018,4.345126980681571,0.0,0.0
34607,3,4607,[302 427 603 100 127],13,5,20023,4.345269097222222,20.0,40.0
34608,3,4608,[302 427 603 100 127],13,5,20028,4.34541115209373,20.0,40.0
34609,3,4609,[302 427 603 100 127],458,5,20033,4.3455531453362255,20.0,40.0
34610,3,4610,[302 427 603 100 127],13,5,20038,4.345695076989807,20.0,40.0
34611,3,4611,[ 64 603 322 182  71],234,2,20040,4.345186470078057,20.0,0.0
34612,3,4612,[302 427 603 100 127],458,5,20045,4.345328419683503,20.0,40.0
34613,3,4613,[302 427 603 100 127],745,4,20049,4.345253576072822,20.0,40.0
34614,3,4614,[238 496 183 117 100],378,2,20051,4.344745395449621,0.0,20.0
34615,3,4615,[302 427 603 100 127],664,5,20056,4.344887348353553,20.0,40.0
34616,3,4616,[318 228 385   1 211],488,4,20060,4.344812648906216,20.0,0.0
34617,3,4617,[302 427 603 100 127],537,5,20065,4.344954525768731,20.0,40.0
34618,3,4618,[302 427 603 100 127],664,5,20070,4.345096341199394,20.0,40.0
34619,3,4619,[302 427 603 100 127],14,4,20074,4.345021645021645,20.0,40.0
34620,3,4620,[302 427 603 100 127],13,5,20079,4.345163384548799,20.0,40.0
34621,3,4621,[302 427 603 100 127],339,5,20084,4.345305062743401,20.0,40.0
34622,3,4622,[302 427 603 100 127],474,5,20089,4.345446679645252,20.0,40.0
34623,3,4623,[302 427 603 100 127],537,5,20094,4.345588235294118,20.0,40.0
34624,3,4624,[  7 222 286 385 172],881,4,20098,4.345513513513514,0.0,0.0
34625,3,4625,[  4 228 111  25  98],374,3,20101,4.345222654561176,0.0,20.0
34626,3,4626,[302 427 603 100 127],745,4,20105,4.345148044089043,20.0,40.0
34627,3,4627,[302 427 603 100 127],666,5,20110,4.345289541918755,20.0,40.0
34628,3,4628,[385 187 185 313 597],207,3,20113,4.3449989198531,0.0,0.0
34629,3,4629,[302 427 603 100 127],271,5,20118,4.345140388768899,20.0,40.0
34630,3,4630,[302 427 603 100 127],664,5,20123,4.34528179658821,20.0,40.0
34631,3,4631,[302 427 603 100 127],339,5,20128,4.3454231433506045,20.0,40.0
34632,3,4632,[302 427 603 100 127],339,5,20133,4.345564429095618,20.0,40.0
34633,3,4633,[302 427 603 100 127],537,5,20138,4.345705653862754,20.0,40.0
34634,3,4634,[222 483 282  96 195],881,4,20142,4.345631067961165,20.0,0.0
34635,3,4635,[302 427 603 100 127],474,5,20147,4.345772217428818,20.0,40.0
34636,3,4636,[300 191  28 153 288],188,3,20150,4.345481992667673,0.0,0.0
34637,3,4637,[302 427 603 100 127],664,5,20155,4.345623113410953,20.0,40.0
34638,3,4638,[302 427 603 100 127],14,4,20159,4.345548609614141,20.0,40.0
34639,3,4639,[302 427 603 100 127],271,5,20164,4.345689655172414,20.0,40.0
34640,3,4640,[200 185 151 172 313],234,2,20166,4.345184227537168,0.0,0.0
34641,3,4641,[275 117 153  28 496],378,3,20169,4.34489444205084,0.0,0.0
34642,3,4642,[302 427 603 100 127],13,5,20174,4.345035537368081,20.0,40.0
34643,3,4643,[302 427 603 100 127],13,5,20179,4.345176571920758,20.0,40.0
34644,3,4644,[302 427 603 100 127],458,5,20184,4.345317545748117,20.0,40.0
34645,3,4645,[302 427 603 100 127],14,4,20188,4.345243219974171,20.0,40.0
34646,3,4646,[302 427 603 100 127],90,5,20193,4.345384118786313,20.0,40.0
34647,3,4647,[302 427 603 100 127],745,4,20197,4.345309810671257,20.0,40.0
34648,3,4648,[302 427 603 100 127],666,5,20202,4.345450634545063,20.0,40.0
34649,3,4649,[302 427 603 100 127],339,5,20207,4.3455913978494625,20.0,40.0
34650,3,4650,[302 427 603 100 127],458,5,20212,4.345732100623522,20.0,40.0
34651,3,4651,[302 427 603 100 127],271,5,20217,4.345872742906277,20.0,40.0
34652,3,4652,[302 427 603 100 127],474,5,20222,4.346013324736729,20.0,40.0
34653,3,4653,[302 427 603 100 127],339,5,20227,4.346153846153846,20.0,40.0
34654,3,4654,[302 427 603 100 127],666,5,20232,4.346294307196563,20.0,40.0
34655,3,4655,[ 95 357 111 588 135],398,3,20235,4.346005154639175,20.0,0.0
34656,3,4656,[185 238 471 235  11],213,3,20238,4.345716126261542,0.0,0.0
34657,3,4657,[302 427 603 100 127],458,5,20243,4.345856590811507,20.0,40.0
34658,3,4658,[302 427 603 100 127],458,5,20248,4.345996995063318,20.0,40.0
34659,3,4659,[302 427 603 100 127],334,5,20253,4.346137339055794,20.0,40.0
34660,3,4660,[ 50 127 313 144 385],738,5,20258,4.34627762282772,0.0,40.0
34661,3,4661,[302 427 603 100 127],664,5,20263,4.346417846417847,20.0,40.0
34662,3,4662,[302 427 603 100 127],666,5,20268,4.346558009864894,20.0,40.0
34663,3,4663,[302 427 603 100 127],334,5,20273,4.346698113207547,20.0,40.0
34664,3,4664,[302 427 603 100 127],664,5,20278,4.346838156484459,20.0,40.0
34665,3,4665,[282 118  98 172 742],298,4,20282,4.346763823403343,0.0,20.0
34666,3,4666,[302 427 603 100 127],339,5,20287,4.346903792586244,20.0,40.0
34667,3,4667,[302 427 603 100 127],271,5,20292,4.347043701799486,20.0,40.0
34668,3,4668,[302 427 603 100 127],745,4,20296,4.346969372456629,20.0,40.0
34669,3,4669,[ 64  56 195  98 655],234,2,20298,4.346466809421842,0.0,20.0
34670,3,4670,[302 427 603 100 127],745,4,20302,4.346392635409977,20.0,40.0
34671,3,4671,[302 427 603 100 127],666,5,20307,4.346532534246576,20.0,40.0
34672,3,4672,[238 117 204 288 423],892,5,20312,4.346672373207789,0.0,0.0
34673,3,4673,[427 265 333 176 237],334,3,20315,4.346384253316217,0.0,0.0
34674,3,4674,[302 427 603 100 127],90,5,20320,4.346524064171123,20.0,40.0
34675,3,4675,[265 132 286 423 322],334,2,20322,4.346022241231822,0.0,0.0
34676,3,4676,[ 96 144 257 357 234],738,4,20326,4.345948257429977,20.0,0.0
34677,3,4677,[435  69 195   7 742],458,4,20330,4.345874305258658,0.0,0.0
34678,3,4678,[302 427 603 100 127],339,5,20335,4.346014105578115,20.0,40.0
34679,3,4679,[143 423 168  25  82],13,2,20337,4.345512820512821,0.0,0.0
34680,3,4680,[302 427 603 100 127],458,5,20342,4.345652638325144,20.0,40.0
34681,3,4681,[302 427 603 100 127],474,5,20347,4.34579239641179,20.0,40.0
34682,3,4682,[238  96  98 117 403],881,2,20349,4.345291479820628,0.0,20.0
34683,3,4683,[302 427 603 100 127],90,5,20354,4.345431255337319,20.0,40.0
34684,3,4684,[302 427 603 100 127],458,5,20359,4.345570971184632,20.0,40.0
34685,3,4685,[302 427 603 100 127],339,5,20364,4.345710627400768,20.0,40.0
34686,3,4686,[302 427 603 100 127],474,5,20369,4.345850224023896,20.0,40.0
34687,3,4687,[117 655 182 186 143],334,1,20370,4.345136518771331,0.0,0.0
34688,3,4688,[302 427 603 100 127],271,5,20375,4.345276178289614,20.0,40.0
34689,3,4689,[302 427 603 100 127],666,5,20380,4.345415778251599,20.0,40.0
34690,3,4690,[204  50 135 483 191],406,5,20385,4.345555318695374,20.0,20.0
34691,3,4691,[302 427 603 100 127],14,4,20389,4.345481670929241,20.0,40.0
34692,3,4692,[302 427 603 100 127],664,5,20394,4.345621137864905,20.0,40.0
34693,3,4693,[302 427 603 100 127],13,5,20399,4.345760545377077,20.0,40.0
34694,3,4694,[302 427 603 100 127],458,5,20404,4.345899893503727,20.0,40.0
34695,3,4695,[302 427 603 100 127],666,5,20409,4.3460391822827935,20.0,40.0
34696,3,4696,[204 475  71 742 121],374,4,20413,4.345965509899936,0.0,0.0
34697,3,4697,[302 427 603 100 127],664,5,20418,4.346104725415071,20.0,40.0
34698,3,4698,[238  28 175 289 100],194,3,20421,4.345818259204086,0.0,20.0
34699,3,4699,[132 475  22  98 117],308,2,20423,4.34531914893617,0.0,20.0
34700,3,4700,[302 427 603 100 127],334,5,20428,4.345458413103595,20.0,40.0
34701,3,4701,[302 427 603 100 127],271,5,20433,4.345597618034879,20.0,40.0
34702,3,4702,[302 427 603 100 127],14,4,20437,4.3455241335317885,20.0,40.0
34703,3,4703,[302 427 603 100 127],745,4,20441,4.3454506802721085,20.0,40.0
34704,3,4704,[302 427 603 100 127],666,5,20446,4.345589798087142,20.0,40.0
34705,3,4705,[357 100  64 197 202],7,4,20450,4.345516362090947,20.0,20.0
34706,3,4706,[302 427 603 100 127],537,5,20455,4.3456554068408755,20.0,40.0
34707,3,4707,[302 427 603 100 127],90,5,20460,4.345794392523365,20.0,40.0
34708,3,4708,[302 427 603 100 127],537,5,20465,4.345933319176046,20.0,40.0
34709,3,4709,[302 427 603 100 127],745,4,20469,4.345859872611465,20.0,40.0
34710,3,4710,[302 427 603 100 127],14,4,20473,4.3457864572277645,20.0,40.0
34711,3,4711,[302 427 603 100 127],339,5,20478,4.3459252971137525,20.0,40.0
34712,3,4712,[302 427 603 100 127],458,5,20483,4.346064078081901,20.0,40.0
34713,3,4713,[302 427 603 100 127],339,5,20488,4.346202800169707,20.0,40.0
34714,3,4714,[302 427 603 100 127],14,4,20492,4.346129374337222,20.0,40.0
34715,3,4715,[302 427 603 100 127],458,5,20497,4.34626802374894,20.0,40.0
34716,3,4716,[302 427 603 100 127],458,5,20502,4.346406614373542,20.0,40.0
34717,3,4717,[302 427 603 100 127],666,5,20507,4.346545146248411,20.0,40.0
34718,3,4718,[302 427 603 100 127],14,4,20511,4.346471710108074,20.0,40.0
34719,3,4719,[302 427 603 100 127],90,5,20516,4.346610169491526,20.0,40.0
34720,3,4720,[143  28  96  97  64],379,4,20520,4.346536750688413,0.0,0.0
34721,3,4721,[597  22  82 471 181],119,4,20524,4.346463362981788,0.0,0.0
34722,3,4722,[302 427 603 100 127],90,5,20529,4.3466017361846285,20.0,40.0
34723,3,4723,[423 175   7 121 144],343,4,20533,4.346528365791702,0.0,0.0
34724,3,4724,[302 427 603 100 127],474,5,20538,4.346666666666667,20.0,40.0
34725,3,4725,[302 427 603 100 127],90,5,20543,4.346804909013965,20.0,40.0
34726,3,4726,[302 427 603 100 127],90,5,20548,4.346943092870743,20.0,40.0
34727,3,4727,[302 427 603 100 127],90,5,20553,4.347081218274112,20.0,40.0
34728,3,4728,[ 25 215 515 183 181],843,1,20554,4.346373440473673,0.0,0.0
34729,3,4729,[302 427 603 100 127],745,4,20558,4.346300211416491,20.0,40.0
34730,3,4730,[302 427 603 100 127],339,5,20563,4.346438385119425,20.0,40.0
34731,3,4731,[228 202 143 258   7],92,3,20566,4.346153846153846,0.0,0.0
34732,3,4732,[302 427 603 100 127],537,5,20571,4.34629199239383,20.0,40.0
34733,3,4733,[302 427 603 100 127],271,5,20576,4.346430080270385,20.0,40.0
34734,3,4734,[302 427 603 100 127],664,5,20581,4.346568109820486,20.0,40.0
34735,3,4735,[302 427 603 100 127],664,5,20586,4.346706081081081,20.0,40.0
34736,3,4736,[302 427 603 100 127],745,4,20590,4.346632890014777,20.0,40.0
34737,3,4737,[302 427 603 100 127],458,5,20595,4.3467707893626,20.0,40.0
34738,3,4738,[  1 202 204 180 118],738,4,20599,4.346697615530703,0.0,0.0
34739,3,4739,[302 427 603 100 127],13,5,20604,4.346835443037975,20.0,40.0
34740,3,4740,[302 427 603 100 127],334,5,20609,4.346973212402447,20.0,40.0
34741,3,4741,[302 427 603 100 127],271,5,20614,4.347110923660902,20.0,40.0
34742,3,4742,[302 427 603 100 127],537,5,20619,4.347248576850095,20.0,40.0
34743,3,4743,[435 289 328 323   9],90,2,20621,4.346753794266442,0.0,0.0
34744,3,4744,[302 427 603 100 127],339,5,20626,4.3468914646996835,20.0,40.0
34745,3,4745,[302 427 603 100 127],664,5,20631,4.347029077117573,20.0,40.0
34746,3,4746,[195 328 176 185 187],102,1,20632,4.346323994101538,0.0,0.0
34747,3,4747,[302 427 603 100 127],90,5,20637,4.346461668070766,20.0,40.0
34748,3,4748,[302 427 603 100 127],339,5,20642,4.346599284059802,20.0,40.0
34749,3,4749,[176  28   9 273 318],234,2,20644,4.346105263157895,20.0,0.0
34750,3,4750,[302 427 603 100 127],271,5,20649,4.346242896232372,20.0,40.0
34751,3,4751,[302 427 603 100 127],745,4,20653,4.346170033670034,20.0,40.0
34752,3,4752,[302 427 603 100 127],745,4,20657,4.3460972017673045,20.0,40.0
34753,3,4753,[302 427 603 100 127],474,5,20662,4.346234749684476,20.0,40.0
34754,3,4754,[302 427 603 100 127],537,5,20667,4.346372239747634,20.0,40.0
34755,3,4755,[357 196 135 127 153],892,5,20672,4.346509671993272,20.0,20.0
34756,3,4756,[ 88 175 289   9 405],13,2,20674,4.346016396888795,0.0,0.0
34757,3,4757,[302 427 603 100 127],474,5,20679,4.346153846153846,20.0,40.0
34758,3,4758,[302 427 603 100 127],664,5,20684,4.346291237654969,20.0,40.0
34759,3,4759,[302 427 603 100 127],14,4,20688,4.346218487394958,20.0,40.0
34760,3,4760,[302 427 603 100 127],14,4,20692,4.346145767695862,20.0,40.0
34761,3,4761,[302 427 603 100 127],745,4,20696,4.34607307853843,20.0,40.0
34762,3,4762,[302 427 603 100 127],271,5,20701,4.346210371614529,20.0,40.0
34763,3,4763,[302 427 603 100 127],271,5,20706,4.346347607052897,20.0,40.0
34764,3,4764,[302 427 603 100 127],537,5,20711,4.346484784889822,20.0,40.0
34765,3,4765,[496  56 197 191 385],738,5,20716,4.346621905161561,0.0,0.0
34766,3,4766,[302 427 603 100 127],458,5,20721,4.346758967904343,20.0,40.0
34767,3,4767,[127 300 200 180 222],774,2,20723,4.34626677852349,0.0,20.0
34768,3,4768,[302 427 603 100 127],334,5,20728,4.346403858251206,20.0,40.0
34769,3,4769,[174  70 273 265 121],64,3,20731,4.346121593291405,0.0,20.0
34770,3,4770,[302 427 603 100 127],13,5,20736,4.3462586459861665,20.0,40.0
34771,3,4771,[200 222  88 546 111],749,2,20738,4.345766974015088,0.0,0.0
34772,3,4772,[302 427 603 100 127],664,5,20743,4.345904043578463,20.0,40.0
34773,3,4773,[  1  89 496 135  82],95,2,20745,4.345412651864264,0.0,0.0
34774,3,4774,[228 195 288  97 435],59,5,20750,4.345549738219895,0.0,0.0
34775,3,4775,[302 427 603 100 127],339,5,20755,4.3456867671691795,20.0,40.0
34776,3,4776,[302 427 603 100 127],14,4,20759,4.345614402344568,20.0,40.0
34777,3,4777,[302 427 603 100 127],664,5,20764,4.345751360401842,20.0,40.0
34778,3,4778,[385 175   4 265 258],59,4,20768,4.345679012345679,0.0,0.0
34779,3,4779,[302 427 603 100 127],339,5,20773,4.34581589958159,20.0,40.0
34780,3,4780,[302 427 603 100 127],271,5,20778,4.345952729554487,20.0,40.0
34781,3,4781,[302 427 603 100 127],334,5,20783,4.346089502300293,20.0,40.0
34782,3,4782,[302 427 603 100 127],271,5,20788,4.346226217854903,20.0,40.0
34783,3,4783,[302 427 603 100 127],13,5,20793,4.34636287625418,20.0,40.0
34784,3,4784,[302 427 603 100 127],334,5,20798,4.3464994775339605,20.0,40.0
34785,3,4785,[302 427 603 100 127],745,4,20802,4.346427078980359,20.0,40.0
34786,3,4786,[302 427 603 100 127],271,5,20807,4.346563609776478,20.0,40.0
34787,3,4787,[302 427 603 100 127],474,5,20812,4.3467000835421885,20.0,40.0
34788,3,4788,[143 748 176 200 161],92,1,20813,4.346001252871163,0.0,0.0
34789,3,4789,[435   7 176 515 196],537,2,20815,4.345511482254698,0.0,0.0
34790,3,4790,[603 265 515 333 180],313,5,20820,4.345648090169067,20.0,0.0
34791,3,4791,[302 427 603 100 127],334,5,20825,4.345784641068447,20.0,40.0
34792,3,4792,[302 427 603 100 127],334,5,20830,4.345921134988525,20.0,40.0
34793,3,4793,[302 427 603 100 127],271,5,20835,4.346057571964956,20.0,40.0
34794,3,4794,[302 427 603 100 127],90,5,20840,4.346193952033368,20.0,40.0
34795,3,4795,[302 427 603 100 127],14,4,20844,4.346121768140117,20.0,40.0
34796,3,4796,[302 427 603 100 127],334,5,20849,4.346258077965395,20.0,40.0
34797,3,4797,[302 427 603 100 127],271,5,20854,4.346394330971238,20.0,40.0
34798,3,4798,[302 427 603 100 127],666,5,20859,4.346530527193165,20.0,40.0
34799,3,4799,[100 423 357 483 132],474,5,20864,4.346666666666667,40.0,20.0
34800,3,4800,[302 427 603 100 127],13,5,20869,4.346802749427202,20.0,40.0
34801,3,4801,[210   7 313  69 144],234,2,20871,4.346314035818409,0.0,0.0
34802,3,4802,[302 427 603 100 127],334,5,20876,4.346450135332084,20.0,40.0
34803,3,4803,[302 427 603 100 127],339,5,20881,4.346586178184846,20.0,40.0
34804,3,4804,[302 427 603 100 127],537,5,20886,4.34672216441207,20.0,40.0
34805,3,4805,[ 22 153  96 286  79],90,5,20891,4.3468580940491055,0.0,0.0
34806,3,4806,[276 216 187 195  12],346,2,20893,4.346369877262326,20.0,0.0
34807,3,4807,[302 427 603 100 127],666,5,20898,4.346505823627288,20.0,40.0
34808,3,4808,[302 427 603 100 127],339,5,20903,4.34664171345394,20.0,40.0
34809,3,4809,[ 89 318 496 313  97],271,4,20907,4.346569646569646,20.0,0.0
34810,3,4810,[302 427 603 100 127],458,5,20912,4.346705466638952,20.0,40.0
34811,3,4811,[302 427 603 100 127],745,4,20916,4.346633416458853,20.0,40.0
34812,3,4812,[385 568  97 655  70],454,3,20919,4.346353625597341,0.0,0.0
34813,3,4813,[302 427 603 100 127],90,5,20924,4.34648940589946,20.0,40.0
34814,3,4814,[302 427 603 100 127],339,5,20929,4.3466251298027,20.0,40.0
34815,3,4815,[302 427 603 100 127],90,5,20934,4.346760797342193,20.0,40.0
34816,3,4816,[302 427 603 100 127],666,5,20939,4.346896408553041,20.0,40.0
34817,3,4817,[302 427 603 100 127],474,5,20944,4.34703196347032,20.0,40.0
34818,3,4818,[302 427 603 100 127],745,4,20948,4.346959950197136,20.0,40.0
34819,3,4819,[302 427 603 100 127],745,4,20952,4.346887966804979,20.0,40.0
34820,3,4820,[302 427 603 100 127],13,5,20957,4.347023439120514,20.0,40.0
34821,3,4821,[302 427 603 100 127],271,5,20962,4.347158855246786,20.0,40.0
34822,3,4822,[302 427 603 100 127],458,5,20967,4.347294215218744,20.0,40.0
34823,3,4823,[302 427 603 100 127],458,5,20972,4.34742951907131,20.0,40.0
34824,3,4824,[215  15   1 435 186],537,1,20973,4.346735751295337,0.0,0.0
34825,3,4825,[302 427 603 100 127],14,4,20977,4.3466639038541235,20.0,40.0
34826,3,4826,[271 143 385 135 238],479,2,20979,4.346177750155376,0.0,0.0
34827,3,4827,[302 427 603 100 127],14,4,20983,4.346106048053024,20.0,40.0
34828,3,4828,[302 427 603 100 127],339,5,20988,4.34624145785877,20.0,40.0
34829,3,4829,[322   1  28 179 151],374,3,20991,4.345962732919254,0.0,0.0
34830,3,4830,[ 28 603 194 265   9],543,4,20995,4.345891119850963,20.0,0.0
34831,3,4831,[302 427 603 100 127],339,5,21000,4.346026490066225,20.0,40.0
34832,3,4832,[245  96 322 235 496],313,2,21002,4.345541071798055,0.0,0.0
34833,3,4833,[302 427 603 100 127],334,5,21007,4.345676458419528,20.0,40.0
34834,3,4834,[302 427 603 100 127],745,4,21011,4.3456049638055845,20.0,40.0
34835,3,4835,[302 427 603 100 127],339,5,21016,4.345740281224153,20.0,40.0
34836,3,4836,[302 427 603 100 127],745,4,21020,4.345668802977052,20.0,40.0
34837,3,4837,[ 25 121 546 385 180],533,3,21023,4.345390657296403,0.0,0.0
34838,3,4838,[302 427 603 100 127],14,4,21027,4.34531928084315,20.0,40.0
34839,3,4839,[302 427 603 100 127],666,5,21032,4.345454545454546,20.0,40.0
34840,3,4840,[302 427 603 100 127],474,5,21037,4.34558975418302,20.0,40.0
34841,3,4841,[515 143 328 301 127],537,2,21039,4.345105328376704,0.0,20.0
34842,3,4842,[302 427 603 100 127],271,5,21044,4.345240553376007,20.0,40.0
34843,3,4843,[302 427 603 100 127],664,5,21049,4.345375722543353,20.0,40.0
34844,3,4844,[302 427 603 100 127],90,5,21054,4.345510835913313,20.0,40.0
34845,3,4845,[302 427 603 100 127],14,4,21058,4.345439537763103,20.0,40.0
34846,3,4846,[ 89 568 151 202 655],738,3,21061,4.345161955848979,0.0,0.0
34847,3,4847,[302 427 603 100 127],474,5,21066,4.34529702970297,20.0,40.0
34848,3,4848,[302 427 603 100 127],13,5,21071,4.345432047844916,20.0,40.0
34849,3,4849,[302 427 603 100 127],271,5,21076,4.345567010309279,20.0,40.0
34850,3,4850,[302 427 603 100 127],334,5,21081,4.345701917130489,20.0,40.0
34851,3,4851,[121 200   1 172 173],455,5,21086,4.345836768342951,0.0,0.0
34852,3,4852,[435 176 144 423 175],326,1,21087,4.345147331547496,0.0,0.0
34853,3,4853,[183  89 385  56 273],897,2,21089,4.3446641944787805,0.0,0.0
34854,3,4854,[302 427 603 100 127],339,5,21094,4.344799176107106,20.0,40.0
34855,3,4855,[302 427 603 100 127],537,5,21099,4.34493410214168,20.0,40.0
34856,3,4856,[ 96 423 191 742 405],648,5,21104,4.345068972616842,0.0,0.0
34857,3,4857,[196 515  25 132 427],666,3,21107,4.344792095512557,0.0,0.0
34858,3,4858,[268 127 276   4 121],189,3,21110,4.344515332372916,0.0,20.0
34859,3,4859,[302 427 603 100 127],14,4,21114,4.344444444444444,20.0,40.0
34860,3,4860,[568 215  12 144  11],892,4,21118,4.344373585681958,20.0,0.0
34861,3,4861,[302 427 603 100 127],664,5,21123,4.3445084327437264,20.0,40.0
34862,3,4862,[655   8 174   7  50],940,5,21128,4.344643224347111,0.0,40.0
34863,3,4863,[302 427 603 100 127],271,5,21133,4.344777960526316,20.0,40.0
34864,3,4864,[302 427 603 100 127],13,5,21138,4.344912641315519,20.0,40.0
34865,3,4865,[302 427 603 100 127],14,4,21142,4.344841759145089,20.0,40.0
34866,3,4866,[228 117 257 238 403],881,2,21144,4.344359975344155,0.0,0.0
34867,3,4867,[302 427 603 100 127],271,5,21149,4.344494658997535,20.0,40.0
34868,3,4868,[302 427 603 100 127],90,5,21154,4.344629287327994,20.0,40.0
34869,3,4869,[276 235   7  50 179],13,2,21156,4.344147843942505,0.0,20.0
34870,3,4870,[302 427 603 100 127],14,4,21160,4.3440771915417775,20.0,40.0
34871,3,4871,[302 427 603 100 127],14,4,21164,4.344006568144499,20.0,40.0
34872,3,4872,[302 427 603 100 127],90,5,21169,4.344141186127642,20.0,40.0
34873,3,4873,[161 196 153 202   7],87,5,21174,4.3442757488715635,0.0,0.0
34874,3,4874,[302 427 603 100 127],474,5,21179,4.3444102564102565,20.0,40.0
34875,3,4875,[302 427 603 100 127],13,5,21184,4.344544708777686,20.0,40.0
34876,3,4876,[302 427 603 100 127],458,5,21189,4.344679106007792,20.0,40.0
34877,3,4877,[302 427 603 100 127],745,4,21193,4.344608446084461,20.0,40.0
34878,3,4878,[302 427 603 100 127],664,5,21198,4.344742775158844,20.0,40.0
34879,3,4879,[ 88 143  79 111 197],207,3,21201,4.344467213114754,0.0,0.0
34880,3,4880,[302 427 603 100 127],537,5,21206,4.34460151608277,20.0,40.0
34881,3,4881,[173 678 127 603 222],387,4,21210,4.344530929946743,20.0,20.0
34882,3,4882,[302 427 603 100 127],339,5,21215,4.34466516485767,20.0,40.0
34883,3,4883,[302 427 603 100 127],334,5,21220,4.344799344799345,20.0,40.0
34884,3,4884,[302 427 603 100 127],271,5,21225,4.344933469805527,20.0,40.0
34885,3,4885,[302 427 603 100 127],13,5,21230,4.345067539909947,20.0,40.0
34886,3,4886,[302 427 603 100 127],664,5,21235,4.345201555146306,20.0,40.0
34887,3,4887,[302 427 603 100 127],664,5,21240,4.345335515548282,20.0,40.0
34888,3,4888,[302 427 603 100 127],745,4,21244,4.3452648803436285,20.0,40.0
34889,3,4889,[302 427 603 100 127],271,5,21249,4.345398773006135,20.0,40.0
34890,3,4890,[302 427 603 100 127],334,5,21254,4.345532610918013,20.0,40.0
34891,3,4891,[302 427 603 100 127],664,5,21259,4.345666394112837,20.0,40.0
34892,3,4892,[302 427 603 100 127],664,5,21264,4.345800122624157,20.0,40.0
34893,3,4893,[  1 117  79 204 111],374,4,21268,4.345729464650592,0.0,0.0
34894,3,4894,[302 427 603 100 127],666,5,21273,4.345863125638407,20.0,40.0
34895,3,4895,[302 427 603 100 127],90,5,21278,4.345996732026144,20.0,40.0
34896,3,4896,[302 427 603 100 127],339,5,21283,4.346130283847254,20.0,40.0
34897,3,4897,[302 427 603 100 127],537,5,21288,4.346263781135157,20.0,40.0
34898,3,4898,[202  97 172 237 132],454,2,21290,4.345784854051847,0.0,0.0
34899,3,4899,[302 427 603 100 127],666,5,21295,4.345918367346939,20.0,40.0
34900,3,4900,[302 427 603 100 127],474,5,21300,4.346051826157927,20.0,40.0
34901,3,4901,[302 427 603 100 127],271,5,21305,4.346185230518156,20.0,40.0
34902,3,4902,[302 427 603 100 127],271,5,21310,4.3463185804609425,20.0,40.0
34903,3,4903,[302 427 603 100 127],666,5,21315,4.346451876019576,20.0,40.0
34904,3,4904,[435 216  56 196  28],308,2,21317,4.345973496432212,0.0,0.0
34905,3,4905,[302 427 603 100 127],664,5,21322,4.346106807990216,20.0,40.0
34906,3,4906,[302 427 603 100 127],334,5,21327,4.346240065212961,20.0,40.0
34907,3,4907,[302 427 603 100 127],458,5,21332,4.346373268133659,20.0,40.0
34908,3,4908,[302 427 603 100 127],14,4,21336,4.346302709309431,20.0,40.0
34909,3,4909,[ 82 161 216 294 275],328,3,21339,4.34602851323829,0.0,0.0
34910,3,4910,[302 427 603 100 127],666,5,21344,4.346161677866015,20.0,40.0
34911,3,4911,[302 427 603 100 127],666,5,21349,4.346294788273616,20.0,40.0
34912,3,4912,[302 427 603 100 127],664,5,21354,4.346427844494199,20.0,40.0
34913,3,4913,[302 427 603 100 127],271,5,21359,4.3465608465608465,20.0,40.0
34914,3,4914,[302 427 603 100 127],90,5,21364,4.346693794506613,20.0,40.0
34915,3,4915,[237 313  69 161 144],92,4,21368,4.346623270951993,0.0,0.0
34916,3,4916,[302 427 603 100 127],14,4,21372,4.346552776082977,20.0,40.0
34917,3,4917,[302 427 603 100 127],339,5,21377,4.346685644570964,20.0,40.0
34918,3,4918,[302 427 603 100 127],666,5,21382,4.346818459036389,20.0,40.0
34919,3,4919,[302 427 603 100 127],13,5,21387,4.346951219512195,20.0,40.0
34920,3,4920,[234  96 597 204 588],200,5,21392,4.347083926031295,0.0,0.0
34921,3,4921,[302 427 603 100 127],271,5,21397,4.347216578626575,20.0,40.0
34922,3,4922,[302 427 603 100 127],458,5,21402,4.347349177330896,20.0,40.0
34923,3,4923,[234 186 265 204 176],380,0,21402,4.34646628757108,0.0,0.0
34924,3,4924,[302 427 603 100 127],90,5,21407,4.346598984771574,20.0,40.0
34925,3,4925,[302 427 603 100 127],334,5,21412,4.346731628095818,20.0,40.0
34926,3,4926,[302 427 603 100 127],90,5,21417,4.346864217576619,20.0,40.0
34927,3,4927,[302 427 603 100 127],666,5,21422,4.346996753246753,20.0,40.0
34928,3,4928,[302 427 603 100 127],458,5,21427,4.347129235138973,20.0,40.0
34929,3,4929,[210 187 588 235  71],194,3,21430,4.346855983772819,0.0,0.0
34930,3,4930,[302 427 603 100 127],271,5,21435,4.346988440478604,20.0,40.0
34931,3,4931,[302 427 603 100 127],339,5,21440,4.347120843471209,20.0,40.0
34932,3,4932,[210 182  22 427  12],13,4,21444,4.347050476383539,20.0,0.0
34933,3,4933,[302 427 603 100 127],664,5,21449,4.347182813133361,20.0,40.0
34934,3,4934,[302 427 603 100 127],271,5,21454,4.3473150962512666,20.0,40.0
34935,3,4935,[302 427 603 100 127],339,5,21459,4.3474473257698545,20.0,40.0
34936,3,4936,[228 515 186 200  79],380,3,21462,4.347174397407333,0.0,0.0
34937,3,4937,[302 427 603 100 127],271,5,21467,4.347306601863102,20.0,40.0
34938,3,4938,[302 427 603 100 127],13,5,21472,4.347438752783964,20.0,40.0
34939,3,4939,[302 427 603 100 127],664,5,21477,4.3475708502024295,20.0,40.0
34940,3,4940,[302 427 603 100 127],537,5,21482,4.347702894150982,20.0,40.0
34941,3,4941,[302 427 603 100 127],664,5,21487,4.34783488466208,20.0,40.0
34942,3,4942,[191 271   4 385 172],64,3,21490,4.347562209184706,0.0,0.0
34943,3,4943,[302 427 603 100 127],474,5,21495,4.347694174757281,20.0,40.0
34944,3,4944,[302 427 603 100 127],666,5,21500,4.3478260869565215,20.0,40.0
34945,3,4945,[302 427 603 100 127],13,5,21505,4.3479579458148,20.0,40.0
34946,3,4946,[100 237 186 180  95],263,4,21509,4.347887608651708,0.0,20.0
34947,3,4947,[ 12 202 215 276  22],892,5,21514,4.3480194017784966,20.0,0.0
34948,3,4948,[302 427 603 100 127],666,5,21519,4.3481511416447765,20.0,40.0
34949,3,4949,[ 97 403 222  89 265],843,1,21520,4.347474747474747,0.0,0.0
34950,3,4950,[302 427 603 100 127],271,5,21525,4.347606544132499,20.0,40.0
34951,3,4951,[121  28 186 100 588],308,3,21528,4.347334410339257,0.0,20.0
34952,3,4952,[200  96 135 186 204],387,3,21531,4.347062386432465,0.0,0.0
34953,3,4953,[302 427 603 100 127],474,5,21536,4.347194186515947,20.0,40.0
34954,3,4954,[678 197 187  97 175],339,4,21540,4.347124117053482,0.0,0.0
34955,3,4955,[302 427 603 100 127],537,5,21545,4.34725585149314,20.0,40.0
34956,3,4956,[302 427 603 100 127],666,5,21550,4.347387532781925,20.0,40.0
34957,3,4957,[302 427 603 100 127],14,4,21554,4.347317466720452,20.0,40.0
34958,3,4958,[302 427 603 100 127],745,4,21558,4.347247428917121,20.0,40.0
34959,3,4959,[302 427 603 100 127],13,5,21563,4.347379032258065,20.0,40.0
34960,3,4960,[183  97 127 483   1],339,5,21568,4.347510582543842,20.0,20.0
34961,3,4961,[ 95 228 173 323 655],13,3,21571,4.347239016525594,0.0,0.0
34962,3,4962,[302 427 603 100 127],745,4,21575,4.347169050977231,20.0,40.0
34963,3,4963,[302 427 603 100 127],271,5,21580,4.347300564061241,20.0,40.0
34964,3,4964,[302 427 603 100 127],14,4,21584,4.3472306143001,20.0,40.0
34965,3,4965,[302 427 603 100 127],334,5,21589,4.347362062021748,20.0,40.0
34966,3,4966,[302 427 603 100 127],334,5,21594,4.347493456814979,20.0,40.0
34967,3,4967,[302 427 603 100 127],664,5,21599,4.347624798711755,20.0,40.0
34968,3,4968,[181  95  79 187 215],479,4,21603,4.3475548400080495,0.0,0.0
34969,3,4969,[302 427 603 100 127],537,5,21608,4.347686116700201,20.0,40.0
34970,3,4970,[302 427 603 100 127],334,5,21613,4.347817340575337,20.0,40.0
34971,3,4971,[435  89  50 222 322],313,3,21616,4.3475462590506835,0.0,20.0
34972,3,4972,[302 427 603 100 127],334,5,21621,4.347677458274683,20.0,40.0
34973,3,4973,[302 427 603 100 127],339,5,21626,4.347808604744673,20.0,40.0
34974,3,4974,[302 427 603 100 127],339,5,21631,4.347939698492462,20.0,40.0
34975,3,4975,[265  82  71  22 546],290,4,21635,4.347869774919614,0.0,0.0
34976,3,4976,[302 427 603 100 127],339,5,21640,4.348000803697007,20.0,40.0
34977,3,4977,[238 483 288 196 357],488,1,21641,4.347328244274809,40.0,0.0
34978,3,4978,[127  69 288 357 100],488,3,21644,4.347057642096806,20.0,40.0
34979,3,4979,[302 427 603 100 127],458,5,21649,4.34718875502008,20.0,40.0
34980,3,4980,[302 427 603 100 127],664,5,21654,4.347319815298133,20.0,40.0
34981,3,4981,[175 186 215 483   4],664,5,21659,4.347450822962665,20.0,0.0
34982,3,4982,[ 71  79 318 275 282],311,5,21664,4.347581778045354,20.0,0.0
34983,3,4983,[302 427 603 100 127],90,5,21669,4.347712680577849,20.0,40.0
34984,3,4984,[143  22 210 168  64],234,2,21671,4.347241725175526,0.0,0.0
34985,3,4985,[302 427 603 100 127],339,5,21676,4.347372643401524,20.0,40.0
34986,3,4986,[302 427 603 100 127],474,5,21681,4.3475035091237215,20.0,40.0
34987,3,4987,[483  56  79 294 121],308,2,21683,4.347032878909382,20.0,0.0
34988,3,4988,[302 427 603 100 127],271,5,21688,4.3471637602726,20.0,40.0
34989,3,4989,[302 427 603 100 127],537,5,21693,4.3472945891783565,20.0,40.0
34990,3,4990,[ 22 179 185  64   1],749,5,21698,4.347425365658185,0.0,0.0
34991,3,4991,[302 427 603 100 127],13,5,21703,4.347556089743589,20.0,40.0
34992,3,4992,[302 427 603 100 127],664,5,21708,4.347686761466052,20.0,40.0
34993,3,4993,[302 427 603 100 127],745,4,21712,4.3476171405686825,20.0,40.0
34994,3,4994,[302 427 603 100 127],90,5,21717,4.347747747747747,20.0,40.0
34995,3,4995,[168  96  22 234 180],653,3,21720,4.347477982385909,0.0,0.0
34996,3,4996,[302 427 603 100 127],339,5,21725,4.347608565139083,20.0,40.0
34997,3,4997,[302 427 603 100 127],537,5,21730,4.347739095638255,20.0,40.0
34998,3,4998,[302 427 603 100 127],13,5,21735,4.347869573914783,20.0,40.0
34999,3,4999,[288 197  64 275 655],343,4,21739,4.3478,0.0,0.0
35000,3,5000,[302 427 603 100  64],537,4,21743,4.347730453909218,20.0,20.0
35001,3,5001,[302 427 603 100 127],90,5,21748,4.3478608556577365,20.0,40.0
35002,3,5002,[302 427 603 100 127],271,5,21753,4.347991205276834,20.0,40.0
35003,3,5003,[302 427 603 100 127],334,5,21758,4.3481215027977616,20.0,40.0
35004,3,5004,[302 427 603 100 127],745,4,21762,4.348051948051948,20.0,40.0
35005,3,5005,[234 100  15 173 118],749,3,21765,4.347782660807032,0.0,20.0
35006,3,5006,[435 483  89 405 568],13,3,21768,4.347513481126423,20.0,0.0
35007,3,5007,[302 427 603 100 127],334,5,21773,4.347643769968051,20.0,40.0
35008,3,5008,[302 427 603 100 127],339,5,21778,4.347774006787782,20.0,40.0
35009,3,5009,[302 427 603 100 127],537,5,21783,4.347904191616767,20.0,40.0
35010,3,5010,[302 427 603 100 127],664,5,21788,4.348034324486131,20.0,40.0
35011,3,5011,[302 427 603 100 127],13,5,21793,4.348164405426975,20.0,40.0
35012,3,5012,[302 427 603 100 127],474,5,21798,4.348294434470377,20.0,40.0
35013,3,5013,[302 427 603 100 127],334,5,21803,4.348424411647387,20.0,40.0
35014,3,5014,[302 427 603 100 127],474,5,21808,4.348554336989033,20.0,40.0
35015,3,5015,[302 427 603 100 127],745,4,21812,4.348484848484849,20.0,40.0
35016,3,5016,[245 405 269 100 182],378,3,21815,4.3482160653777155,0.0,20.0
35017,3,5017,[265 515 176 655  96],13,3,21818,4.347947389398167,0.0,0.0
35018,3,5018,[302 427 603 100 127],14,4,21822,4.347878063359235,20.0,40.0
35019,3,5019,[302 427 603 100 127],14,4,21826,4.347808764940239,20.0,40.0
35020,3,5020,[302 427 603 100 127],14,4,21830,4.347739494124676,20.0,40.0
35021,3,5021,[302 427 603 100 127],339,5,21835,4.347869374751095,20.0,40.0
35022,3,5022,[302 427 603 100 127],458,5,21840,4.347999203663149,20.0,40.0
35023,3,5023,[195 238  69 210 174],538,4,21844,4.347929936305732,0.0,20.0
35024,3,5024,[302 427 603 100 127],14,4,21848,4.347860696517413,20.0,40.0
35025,3,5025,[302 427 603 100 127],14,4,21852,4.347791484281735,20.0,40.0
35026,3,5026,[302 427 603 100 127],90,5,21857,4.347921225382932,20.0,40.0
35027,3,5027,[302 427 603 100 127],664,5,21862,4.348050914876691,20.0,40.0
35028,3,5028,[302 427 603 100 127],90,5,21867,4.348180552793796,20.0,40.0
35029,3,5029,[180 185  98 496 276],311,4,21871,4.348111332007952,0.0,20.0
35030,3,5030,[302 427 603 100 127],664,5,21876,4.3482409063804415,20.0,40.0
35031,3,5031,[302 427 603 100 127],90,5,21881,4.348370429252782,20.0,40.0
35032,3,5032,[302 427 603 100 127],458,5,21886,4.348499900655672,20.0,40.0
35033,3,5033,[302 427 603 100 127],14,4,21890,4.348430671434247,20.0,40.0
35034,3,5034,[302 427 603 100 127],664,5,21895,4.348560079443892,20.0,40.0
35035,3,5035,[302 427 603 100 127],90,5,21900,4.348689436060365,20.0,40.0
35036,3,5036,[302 427 603 100 127],271,5,21905,4.3488187413142745,20.0,40.0
35037,3,5037,[302 427 603 100 127],458,5,21910,4.3489479952362045,20.0,40.0
35038,3,5038,[302 427 603 100 127],474,5,21915,4.349077197856718,20.0,40.0
35039,3,5039,[302 427 603 100 127],474,5,21920,4.349206349206349,20.0,40.0
35040,3,5040,[186 228 197 132 153],843,1,21921,4.348541955961119,0.0,0.0
35041,3,5041,[216 100  15 195  82],479,2,21923,4.348076160253868,0.0,20.0
35042,3,5042,[265 204  28 471 168],666,2,21925,4.347610549276224,0.0,0.0
35043,3,5043,[302 427 603 100 127],339,5,21930,4.347739888977002,20.0,40.0
35044,3,5044,[302 427 603 100 127],474,5,21935,4.3478691774033695,20.0,40.0
35045,3,5045,[132 181 111 172 588],378,4,21939,4.3478002378121285,0.0,0.0
35046,3,5046,[216 597 357 117   1],533,3,21942,4.347533188032495,20.0,0.0
35047,3,5047,[ 69 196 483   4  22],533,4,21946,4.3474643423137875,20.0,0.0
35048,3,5048,[ 79 357  50  56  89],659,4,21950,4.347395523866112,20.0,20.0
35049,3,5049,[302 427 603 100 127],458,5,21955,4.347524752475247,20.0,40.0
35050,3,5050,[302 427 603 100 127],339,5,21960,4.347653929914868,20.0,40.0
35051,3,5051,[ 28 423 125  22   9],881,4,21964,4.347585114806018,0.0,0.0
35052,3,5052,[302 427 603 100 127],13,5,21969,4.34771422917079,20.0,40.0
35053,3,5053,[302 427 603 100 127],474,5,21974,4.34784329244163,20.0,40.0
35054,3,5054,[300 181  98 194 289],271,4,21978,4.347774480712166,0.0,20.0
35055,3,5055,[302 427 603 100 127],474,5,21983,4.347903481012659,20.0,40.0
35056,3,5056,[286 333 127 258 313],537,3,21986,4.347636938896579,0.0,20.0
35057,3,5057,[302 427 603 100 127],90,5,21991,4.347765915381574,20.0,40.0
35058,3,5058,[ 64 186 496 515  71],194,5,21996,4.347894840877644,0.0,0.0
35059,3,5059,[302 427 603 100 127],664,5,22001,4.34802371541502,20.0,40.0
35060,3,5060,[302 427 603 100 127],334,5,22006,4.348152539023908,20.0,40.0
35061,3,5061,[302 427 603 100 127],13,5,22011,4.3482813117344925,20.0,40.0
35062,3,5062,[302 427 603 100 127],664,5,22016,4.348410033576931,20.0,40.0
35063,3,5063,[100 172 176 186 286],271,4,22020,4.348341232227488,0.0,20.0
35064,3,5064,[302 427 603 100 127],537,5,22025,4.348469891411648,20.0,40.0
35065,3,5065,[302 427 603 100 127],13,5,22030,4.3485984998026055,20.0,40.0
35066,3,5066,[302 427 603 100 127],458,5,22035,4.348727057430432,20.0,40.0
35067,3,5067,[302 427 603 100 127],666,5,22040,4.348855564325177,20.0,40.0
35068,3,5068,[302 427 603 100 127],13,5,22045,4.348984020516867,20.0,40.0
35069,3,5069,[302 427 603 100 127],14,4,22049,4.3489151873767256,20.0,40.0
35070,3,5070,[302 427 603 100 127],271,5,22054,4.349043581147702,20.0,40.0
35071,3,5071,[302 427 603 100 127],664,5,22059,4.3491719242902205,20.0,40.0
35072,3,5072,[302 427 603 100 127],339,5,22064,4.34930021683422,20.0,40.0
35073,3,5073,[ 12 405  71 161 257],378,4,22068,4.34923137564052,20.0,0.0
35074,3,5074,[302 427 603 100 127],664,5,22073,4.34935960591133,20.0,40.0
35075,3,5075,[302 427 603 100 127],458,5,22078,4.349487785657998,20.0,40.0
35076,3,5076,[117  25 333 655 196],537,0,22078,4.348631081347253,0.0,0.0
35077,3,5077,[185 496  70  69 216],64,5,22083,4.3487593540764085,0.0,0.0
35078,3,5078,[302 427 603 100 127],458,5,22088,4.348887576294546,20.0,40.0
35079,3,5079,[  8 174 182  98 172],892,5,22093,4.349015748031496,0.0,40.0
35080,3,5080,[302 427 603 100 127],13,5,22098,4.349143869317063,20.0,40.0
35081,3,5081,[302 427 603 100 127],334,5,22103,4.349271940181031,20.0,40.0
35082,3,5082,[302 427 603 100 127],664,5,22108,4.349399960653158,20.0,40.0
35083,3,5083,[118 100 313 318 276],378,5,22113,4.349527930763179,20.0,20.0
35084,3,5084,[302 427 603 100 127],339,5,22118,4.349655850540806,20.0,40.0
35085,3,5085,[302 427 603 100 127],271,5,22123,4.349783720015729,20.0,40.0
35086,3,5086,[302 427 603 100 127],339,5,22128,4.349911539217613,20.0,40.0
35087,3,5087,[237 323 176 211 235],788,3,22131,4.349646226415095,0.0,0.0
35088,3,5088,[187  71  22 121  88],452,2,22133,4.349184515621929,0.0,0.0
35089,3,5089,[ 56 174  25  79 427],666,2,22135,4.3487229862475445,0.0,20.0
35090,3,5090,[302 427 603 100 127],664,5,22140,4.3488509133765465,20.0,40.0
35091,3,5091,[195  25 238  50 276],308,5,22145,4.34897879025923,0.0,20.0
35092,3,5092,[603 200 423  88 357],749,5,22150,4.349106616925192,40.0,0.0
35093,3,5093,[302 427 603 100 127],474,5,22155,4.3492343934040045,20.0,40.0
35094,3,5094,[288 215 286 655  69],144,4,22159,4.349165848871443,0.0,0.0
35095,3,5095,[302 427 603 100 127],537,5,22164,4.349293563579278,20.0,40.0
35096,3,5096,[302 427 603 100 127],666,5,22169,4.349421228173435,20.0,40.0
35097,3,5097,[215  15 385 265  71],313,4,22173,4.349352687328364,0.0,0.0
35098,3,5098,[286 111  71 168 179],474,4,22177,4.349284173367327,0.0,0.0
35099,3,5099,[302 427 603 100 127],666,5,22182,4.3494117647058825,20.0,40.0
35100,3,5100,[302 427 603 100 127],334,5,22187,4.3495393060184275,20.0,40.0
35101,3,5101,[302 427 603 100 127],90,5,22192,4.349666797334379,20.0,40.0
35102,3,5102,[302 427 603 100 127],334,5,22197,4.349794238683128,20.0,40.0
35103,3,5103,[302 427 603 100 127],745,4,22201,4.349725705329154,20.0,40.0
35104,3,5104,[302 427 603 100 127],666,5,22206,4.349853085210578,20.0,40.0
35105,3,5105,[302 427 603 100 127],339,5,22211,4.349980415197806,20.0,40.0
35106,3,5106,[302 427 603 100 127],537,5,22216,4.3501076953201485,20.0,40.0
35107,3,5107,[302 427 603 100 127],13,5,22221,4.350234925606891,20.0,40.0
35108,3,5108,[302 427 603 100 127],474,5,22226,4.350362106087297,20.0,40.0
35109,3,5109,[302 427 603 100 127],474,5,22231,4.350489236790606,20.0,40.0
35110,3,5110,[161 117  50 176  69],234,2,22233,4.350029348464097,0.0,20.0
35111,3,5111,[302 427 603 100 127],13,5,22238,4.350156494522691,20.0,40.0
35112,3,5112,[302 427 603 100 127],474,5,22243,4.350283590846861,20.0,40.0
35113,3,5113,[195  97 127  98 302],537,2,22245,4.349824012514666,0.0,40.0
35114,3,5114,[568 175 318  79 144],13,2,22247,4.349364613880743,20.0,0.0
35115,3,5115,[302 427 603 100 127],13,5,22252,4.349491790461298,20.0,40.0
35116,3,5116,[302 427 603 100 127],474,5,22257,4.349618917334376,20.0,40.0
35117,3,5117,[302 427 603 100 127],537,5,22262,4.349745994529113,20.0,40.0
35118,3,5118,[302 427 603 100 127],745,4,22266,4.349677671420199,20.0,40.0
35119,3,5119,[302 427 603 100 127],745,4,22270,4.349609375,20.0,40.0
35120,3,5120,[302 427 603 100 127],334,5,22275,4.349736379613357,20.0,40.0
35121,3,5121,[302 427 603 100 127],14,4,22279,4.3496680983990625,20.0,40.0
35122,3,5122,[302 427 603 100 127],474,5,22284,4.349795041967597,20.0,40.0
35123,3,5123,[302 427 603 100 127],90,5,22289,4.34992193598751,20.0,40.0
35124,3,5124,[302 427 603 100 127],474,5,22294,4.350048780487805,20.0,40.0
35125,3,5125,[302 427 603 100 127],334,5,22299,4.350175575497464,20.0,40.0
35126,3,5126,[ 89 748  82 215 132],454,3,22302,4.349912229373903,0.0,0.0
35127,3,5127,[302 427 603 100 127],474,5,22307,4.350039001560062,20.0,40.0
35128,3,5128,[302 427 603 100 127],90,5,22312,4.350165724312731,20.0,40.0
35129,3,5129,[302 427 603 100 127],664,5,22317,4.3502923976608185,20.0,40.0
35130,3,5130,[302 427 603 100 127],14,4,22321,4.350224127850321,20.0,40.0
35131,3,5131,[302 427 603 100 127],458,5,22326,4.350350740452066,20.0,40.0
35132,3,5132,[328 357 185 215 748],653,3,22329,4.350087668030391,20.0,0.0
35133,3,5133,[302 427 603 100 127],745,4,22333,4.350019477989871,20.0,40.0
35134,3,5134,[302 427 603 100 127],13,5,22338,4.350146056475171,20.0,40.0
35135,3,5135,[302 427 603 100 127],664,5,22343,4.350272585669782,20.0,40.0
35136,3,5136,[302 427 603 100 127],339,5,22348,4.350399065602492,20.0,40.0
35137,3,5137,[302 427 603 100 127],13,5,22353,4.350525496302063,20.0,40.0
35138,3,5138,[302 427 603 100 127],13,5,22358,4.350651877797237,20.0,40.0
35139,3,5139,[302 427 603 100 127],666,5,22363,4.350778210116731,20.0,40.0
35140,3,5140,[265 245 202 161 655],207,2,22365,4.350320949231667,0.0,0.0
35141,3,5141,[302 427 603 100 127],13,5,22370,4.3504472967716845,20.0,40.0
35142,3,5142,[302 427 603 100 127],458,5,22375,4.350573595177912,20.0,40.0
35143,3,5143,[302 427 603 100 127],474,5,22380,4.350699844479005,20.0,40.0
35144,3,5144,[302 427 603 100 127],13,5,22385,4.350826044703596,20.0,40.0
35145,3,5145,[302 427 603 100 127],458,5,22390,4.3509521958802955,20.0,40.0
35146,3,5146,[302 427 603 100 127],14,4,22394,4.350884010102972,20.0,40.0
35147,3,5147,[302 427 603 100 127],666,5,22399,4.351010101010101,20.0,40.0
35148,3,5148,[  1 144 215   7  82],843,1,22400,4.350359293066615,0.0,0.0
35149,3,5149,[302 427 603 100 127],339,5,22405,4.350485436893204,20.0,40.0
35150,3,5150,[302 427 603 100 127],90,5,22410,4.35061153174141,20.0,40.0
35151,3,5151,[302 427 603 100 127],339,5,22415,4.350737577639752,20.0,40.0
35152,3,5152,[181 318 258 100  15],234,2,22417,4.3502813894818555,20.0,20.0
35153,3,5153,[302 427 603 100 127],339,5,22422,4.350407450523865,20.0,40.0
35154,3,5154,[568 185 265 211 200],95,1,22423,4.349757516973812,0.0,0.0
35155,3,5155,[302 427 603 100 127],458,5,22428,4.349883630721489,20.0,40.0
35156,3,5156,[302 427 603 100 127],339,5,22433,4.350009695559434,20.0,40.0
35157,3,5157,[302 427 603 100 127],339,5,22438,4.350135711516091,20.0,40.0
35158,3,5158,[302 427 603 100 127],90,5,22443,4.350261678619888,20.0,40.0
35159,3,5159,[183 182 202 127 181],87,5,22448,4.350387596899225,0.0,20.0
35160,3,5160,[302 427 603 100 127],90,5,22453,4.350513466382484,20.0,40.0
35161,3,5161,[302 427 603 100 127],13,5,22458,4.350639287098024,20.0,40.0
35162,3,5162,[302 427 603 100 127],458,5,22463,4.350765059074182,20.0,40.0
35163,3,5163,[318 222 678 127 546],13,1,22464,4.350116189000775,20.0,20.0
35164,3,5164,[302 427 603 100 127],90,5,22469,4.350242013552759,20.0,40.0
35165,3,5165,[302 427 603 100 127],537,5,22474,4.3503677893921795,20.0,40.0
35166,3,5166,[302 427 603 100 127],13,5,22479,4.35049351654732,20.0,40.0
35167,3,5167,[302 427 603 100 127],271,5,22484,4.3506191950464395,20.0,40.0
35168,3,5168,[ 69 168 100 405 118],653,2,22486,4.3501644418649645,0.0,20.0
35169,3,5169,[302 427 603 100 127],14,4,22490,4.350096711798839,20.0,40.0
35170,3,5170,[302 427 603 100 127],339,5,22495,4.35022239412106,20.0,40.0
35171,3,5171,[302 427 603 100 127],13,5,22500,4.3503480278422275,20.0,40.0
35172,3,5172,[302 427 603 100 127],334,5,22505,4.350473612990528,20.0,40.0
35173,3,5173,[302 427 603 100 127],745,4,22509,4.350405875531504,20.0,40.0
35174,3,5174,[302 427 603 100 127],474,5,22514,4.350531400966184,20.0,40.0
35175,3,5175,[302 427 603 100 127],458,5,22519,4.350656877897991,20.0,40.0
35176,3,5176,[302 427 603 100 127],339,5,22524,4.350782306355032,20.0,40.0
35177,3,5177,[ 71 265 496 143  22],313,3,22527,4.350521436848204,0.0,0.0
35178,3,5178,[ 28 228 423 216  15],901,5,22532,4.350646843019888,0.0,0.0
35179,3,5179,[143 210 483 173 168],650,4,22536,4.350579150579151,20.0,0.0
35180,3,5180,[ 89 603 135  96 357],234,3,22539,4.350318471337579,40.0,0.0
35181,3,5181,[  7 323 268  25   9],637,1,22540,4.349671941335392,0.0,0.0
35182,3,5182,[302 427 603 100 127],664,5,22545,4.349797414624735,20.0,40.0
35183,3,5183,[302 427 603 100 127],334,5,22550,4.349922839506172,20.0,40.0
35184,3,5184,[302 427 603 100 127],334,5,22555,4.350048216007715,20.0,40.0
35185,3,5185,[302 427 603 100 127],339,5,22560,4.350173544157347,20.0,40.0
35186,3,5186,[302 427 603 100 127],664,5,22565,4.350298823983034,20.0,40.0
35187,3,5187,[302 427 603 100 127],745,4,22569,4.3502313030069395,20.0,40.0
35188,3,5188,[135 204 471 200 300],653,4,22573,4.350163808055502,0.0,0.0
35189,3,5189,[302 427 603 100 127],271,5,22578,4.350289017341041,20.0,40.0
35190,3,5190,[302 427 603 100 127],339,5,22583,4.350414178385668,20.0,40.0
35191,3,5191,[302 427 603 100 127],666,5,22588,4.350539291217257,20.0,40.0
35192,3,5192,[302 427 603 100 127],271,5,22593,4.350664355863662,20.0,40.0
35193,3,5193,[302 427 603 100 127],474,5,22598,4.350789372352715,20.0,40.0
35194,3,5194,[302 427 603 100 127],474,5,22603,4.350914340712223,20.0,40.0
35195,3,5195,[302 427 603 100 127],14,4,22607,4.350846805234796,20.0,40.0
35196,3,5196,[176  97 121 655 195],774,1,22608,4.350202039638253,0.0,0.0
35197,3,5197,[302 427 603 100 127],14,4,22612,4.3501346671796846,20.0,40.0
35198,3,5198,[302 427 603 100 127],458,5,22617,4.350259665320254,20.0,40.0
35199,3,5199,[302 427 603 100 127],339,5,22622,4.350384615384615,20.0,40.0
35200,3,5200,[302 427 603 100 127],537,5,22627,4.3505095174005,20.0,40.0
35201,3,5201,[302 427 603 100 127],458,5,22632,4.350634371395617,20.0,40.0
35202,3,5202,[302 427 603 100 127],474,5,22637,4.350759177397655,20.0,40.0
35203,3,5203,[302 427 603 100 127],664,5,22642,4.350883935434282,20.0,40.0
35204,3,5204,[176 179 496  89   9],343,4,22646,4.350816522574448,0.0,0.0
35205,3,5205,[302 427 603 100 127],458,5,22651,4.350941221667307,20.0,40.0
35206,3,5206,[302 427 603 100 127],474,5,22656,4.351065872863453,20.0,40.0
35207,3,5207,[302 427 603 100 127],474,5,22661,4.351190476190476,20.0,40.0
35208,3,5208,[302 427 603 100 127],474,5,22666,4.351315031675946,20.0,40.0
35209,3,5209,[210 173 118 273  82],524,3,22669,4.3510556621881,0.0,0.0
35210,3,5210,[302 427 603 100 127],458,5,22674,4.351180195739781,20.0,40.0
35211,3,5211,[302 427 603 100 127],474,5,22679,4.351304681504221,20.0,40.0
35212,3,5212,[ 88  50 235 202 117],648,4,22683,4.3512372913869175,0.0,20.0
35213,3,5213,[302 427 603 100 127],664,5,22688,4.351361718450326,20.0,40.0
35214,3,5214,[302 427 603 100 127],13,5,22693,4.351486097794822,20.0,40.0
35215,3,5215,[269 423 216 588 117],13,2,22695,4.3510352760736195,0.0,0.0
35216,3,5216,[302 427 603 100 127],339,5,22700,4.351159670308607,20.0,40.0
35217,3,5217,[302 427 603 100 127],271,5,22705,4.351284016864699,20.0,40.0
35218,3,5218,[302 427 603 100 127],745,4,22709,4.351216708181644,20.0,40.0
35219,3,5219,[245 385 597 423 546],346,4,22713,4.351149425287356,0.0,0.0
35220,3,5220,[302 427 603 100 127],745,4,22717,4.351082168167018,20.0,40.0
35221,3,5221,[302 427 603 100 127],666,5,22722,4.351206434316354,20.0,40.0
35222,3,5222,[302 427 603 100 127],458,5,22727,4.351330652881486,20.0,40.0
35223,3,5223,[302 427 603 100 127],14,4,22731,4.351263399693721,20.0,40.0
35224,3,5224,[302 427 603 100 127],334,5,22736,4.351387559808613,20.0,40.0
35225,3,5225,[302 427 603 100 127],271,5,22741,4.351511672407195,20.0,40.0
35226,3,5226,[302 427 603 100 127],537,5,22746,4.35163573751674,20.0,40.0
35227,3,5227,[302 427 603 100 127],339,5,22751,4.351759755164498,20.0,40.0
35228,3,5228,[302 427 603 100 127],474,5,22756,4.351883725377701,20.0,40.0
35229,3,5229,[302 427 603 100 127],458,5,22761,4.352007648183556,20.0,40.0
35230,3,5230,[302 427 603 100 127],537,5,22766,4.352131523609253,20.0,40.0
35231,3,5231,[302 427 603 100 127],537,5,22771,4.352255351681957,20.0,40.0
35232,3,5232,[302 427 603 100 127],474,5,22776,4.352379132428817,20.0,40.0
35233,3,5233,[357 403 234 183 678],648,3,22779,4.352120748949178,20.0,0.0
35234,3,5234,[302 427 603 100 127],271,5,22784,4.352244508118433,20.0,40.0
35235,3,5235,[302 427 603 100 127],271,5,22789,4.352368220015279,20.0,40.0
35236,3,5236,[302 427 603 100 127],271,5,22794,4.352491884666794,20.0,40.0
35237,3,5237,[302 427 603 100 127],745,4,22798,4.352424589537992,20.0,40.0
35238,3,5238,[302 427 603 100 127],537,5,22803,4.352548196220653,20.0,40.0
35239,3,5239,[302 427 603 100 127],474,5,22808,4.352671755725191,20.0,40.0
35240,3,5240,[302 427 603 100 127],90,5,22813,4.352795268078611,20.0,40.0
35241,3,5241,[302 427 603 100 127],339,5,22818,4.352918733307898,20.0,40.0
35242,3,5242,[183   7 258 228 405],145,4,22822,4.3528514209422084,0.0,0.0
35243,3,5243,[302 427 603 100 127],474,5,22827,4.352974828375286,20.0,40.0
35244,3,5244,[302 427 603 100 127],664,5,22832,4.353098188751192,20.0,40.0
35245,3,5245,[302 427 603 100 127],90,5,22837,4.353221502096836,20.0,40.0
35246,3,5246,[302 427 603 100 127],271,5,22842,4.353344768439108,20.0,40.0
35247,3,5247,[302 427 603 100 127],13,5,22847,4.353467987804878,20.0,40.0
35248,3,5248,[302 427 603 100 127],458,5,22852,4.3535911602209945,20.0,40.0
35249,3,5249,[302 427 603 100 127],90,5,22857,4.353714285714286,20.0,40.0
35250,3,5250,[302 427 603 100 127],339,5,22862,4.35383736431156,20.0,40.0
35251,3,5251,[182 174 175 121  89],804,5,22867,4.353960396039604,0.0,20.0
35252,3,5252,[302 427 603 100 127],14,4,22871,4.353893013516086,20.0,40.0
35253,3,5253,[302 427 603 100 127],474,5,22876,4.354015987818805,20.0,40.0
35254,3,5254,[302 427 603 100 127],666,5,22881,4.354138915318744,20.0,40.0
35255,3,5255,[302 427 603 100 127],458,5,22886,4.354261796042618,20.0,40.0
35256,3,5256,[  4  22 568   8  82],326,3,22889,4.354004184896329,0.0,0.0
35257,3,5257,[302 427 603 100 127],458,5,22894,4.354127044503613,20.0,40.0
35258,3,5258,[302 427 603 100 127],90,5,22899,4.354249857387336,20.0,40.0
35259,3,5259,[302 427 603 100 127],666,5,22904,4.354372623574145,20.0,40.0
35260,3,5260,[216 151 385 427 144],295,5,22909,4.354495343090667,0.0,0.0
35261,3,5261,[302 427 603 100 127],666,5,22914,4.354618015963512,20.0,40.0
35262,3,5262,[302 427 603 100 127],13,5,22919,4.354740642219267,20.0,40.0
35263,3,5263,[302 427 603 100 127],474,5,22924,4.354863221884498,20.0,40.0
35264,3,5264,[302 427 603 100 127],474,5,22929,4.354985754985755,20.0,40.0
35265,3,5265,[257 294   4 405 111],474,3,22932,4.354728446638815,0.0,0.0
35266,3,5266,[302 427 603 100 127],271,5,22937,4.354850958800076,20.0,40.0
35267,3,5267,[186 257 195  88 294],379,3,22940,4.35459377372817,0.0,0.0
35268,3,5268,[302 427 603 100 127],474,5,22945,4.35471626494591,20.0,40.0
35269,3,5269,[483  28 121 111 182],454,2,22947,4.35426944971537,20.0,0.0
35270,3,5270,[302 427 603 100 127],90,5,22952,4.354391955985581,20.0,40.0
35271,3,5271,[302 427 603 100 127],664,5,22957,4.3545144157814875,20.0,40.0
35272,3,5272,[216 385 125 258 168],899,3,22960,4.354257538403186,0.0,0.0
35273,3,5273,[302 427 603 100 127],14,4,22964,4.354190367842245,20.0,40.0
35274,3,5274,[568 216 546  69   8],882,4,22968,4.354123222748815,0.0,0.0
35275,3,5275,[ 64 333 655 153 748],13,4,22972,4.354056103108415,0.0,0.0
35276,3,5276,[302 427 603 100 127],474,5,22977,4.35417851051734,20.0,40.0
35277,3,5277,[302 427 603 100 127],664,5,22982,4.354300871542251,20.0,40.0
35278,3,5278,[302 427 603 100 127],474,5,22987,4.35442318620951,20.0,40.0
35279,3,5279,[200 471 405  12 496],474,3,22990,4.354166666666667,20.0,0.0
35280,3,5280,[302 427 603 100 127],14,4,22994,4.3540996023480405,20.0,40.0
35281,3,5281,[302 427 603 100 127],339,5,22999,4.354221885649375,20.0,40.0
35282,3,5282,[302 427 603 100 127],14,4,23003,4.354154836267273,20.0,40.0
35283,3,5283,[302 427 603 100 127],334,5,23008,4.354277062831189,20.0,40.0
35284,3,5284,[302 427 603 100 127],458,5,23013,4.354399243140965,20.0,40.0
35285,3,5285,[302 427 603 100 127],90,5,23018,4.354521377222853,20.0,40.0
35286,3,5286,[302 427 603 100 127],458,5,23023,4.354643465103083,20.0,40.0
35287,3,5287,[302 427 603 100 127],90,5,23028,4.354765506807867,20.0,40.0
35288,3,5288,[302 427 603 100 127],537,5,23033,4.354887502363396,20.0,40.0
35289,3,5289,[302 427 603 100 127],537,5,23038,4.3550094517958415,20.0,40.0
35290,3,5290,[302 427 603 100 127],474,5,23043,4.3551313551313555,20.0,40.0
35291,3,5291,[302 427 603 100 127],458,5,23048,4.35525321239607,20.0,40.0
35292,3,5292,[302 427 603 100 127],664,5,23053,4.355375023616097,20.0,40.0
35293,3,5293,[302 427 603 100 127],458,5,23058,4.355496788817529,20.0,40.0
35294,3,5294,[  9 318 144  88 483],815,5,23063,4.35561850802644,40.0,0.0
35295,3,5295,[302 427 603 100 127],13,5,23068,4.3557401812688825,20.0,40.0
35296,3,5296,[302 427 603 100 127],745,4,23072,4.355673022465546,20.0,40.0
35297,3,5297,[175 195 202 196 313],738,5,23077,4.355794639486598,0.0,0.0
35298,3,5298,[302 427 603 100 127],474,5,23082,4.355916210605774,20.0,40.0
35299,3,5299,[302 427 603 100 127],474,5,23087,4.356037735849057,20.0,40.0
35300,3,5300,[302 427 603 100 127],666,5,23092,4.356159215242407,20.0,40.0
35301,3,5301,[302 427 603 100 127],664,5,23097,4.35628064881177,20.0,40.0
35302,3,5302,[302 427 603 100 127],474,5,23102,4.3564020365830665,20.0,40.0
35303,3,5303,[302 427 603 100 127],745,4,23106,4.356334841628959,20.0,40.0
35304,3,5304,[302 427 603 100 127],537,5,23111,4.356456173421301,20.0,40.0
35305,3,5305,[302 427 603 100 127],14,4,23115,4.35638899359216,20.0,40.0
35306,3,5306,[144 211 333 423 568],328,3,23118,4.3561334087054835,0.0,0.0
35307,3,5307,[302 427 603 100 127],14,4,23122,4.356066314996232,20.0,40.0
35308,3,5308,[302 427 603 100 127],666,5,23127,4.356187605952157,20.0,40.0
35309,3,5309,[235 174 100 318 185],59,4,23131,4.356120527306968,20.0,40.0
35310,3,5310,[302 427 603 100 127],339,5,23136,4.356241762379966,20.0,40.0
35311,3,5311,[238  56 197 215 655],59,5,23141,4.356362951807229,0.0,0.0
35312,3,5312,[302 427 603 100 127],666,5,23146,4.3564840956145305,20.0,40.0
35313,3,5313,[302 427 603 100 127],271,5,23151,4.356605193827625,20.0,40.0
35314,3,5314,[302 427 603 100 127],745,4,23155,4.35653809971778,20.0,40.0
35315,3,5315,[302 427 603 100 127],458,5,23160,4.356659142212189,20.0,40.0
35316,3,5316,[302 427 603 100 127],458,5,23165,4.3567801391762275,20.0,40.0
35317,3,5317,[302 427 603 100 127],14,4,23169,4.356713050018804,20.0,40.0
35318,3,5318,[302 427 603 100 127],339,5,23174,4.356833991351758,20.0,40.0
35319,3,5319,[302 427 603 100 127],13,5,23179,4.356954887218045,20.0,40.0
35320,3,5320,[302 427 603 100 127],474,5,23184,4.3570757376433,20.0,40.0
35321,3,5321,[222  82 144 288 546],64,2,23186,4.35663284479519,0.0,0.0
35322,3,5322,[302 427 603 100 127],13,5,23191,4.356753710313733,20.0,40.0
35323,3,5323,[302 427 603 100 127],339,5,23196,4.356874530428249,20.0,40.0
35324,3,5324,[ 96  88 302  12 276],207,1,23197,4.356244131455399,20.0,0.0
35325,3,5325,[302 427 603 100 127],14,4,23201,4.356177243710102,20.0,40.0
35326,3,5326,[ 88   1  97  96 257],479,4,23205,4.35611038107753,0.0,0.0
35327,3,5327,[302 427 603 100 127],90,5,23210,4.356231231231231,20.0,40.0
35328,3,5328,[655 197 211 333 289],10,5,23215,4.356352036029274,0.0,0.0
35329,3,5329,[302 427 603 100 127],745,4,23219,4.356285178236398,20.0,40.0
35330,3,5330,[302 427 603 100 127],90,5,23224,4.356405927593322,20.0,40.0
35331,3,5331,[302 427 603 100 127],13,5,23229,4.356526631657914,20.0,40.0
35332,3,5332,[302 427 603 100 127],13,5,23234,4.356647290455654,20.0,40.0
35333,3,5333,[302 427 603 100 127],334,5,23239,4.356767904011998,20.0,40.0
35334,3,5334,[302 427 603 100 127],745,4,23243,4.356701030927835,20.0,40.0
35335,3,5335,[423  64  70 118 357],194,2,23245,4.3562593703148424,20.0,0.0
35336,3,5336,[302 427 603 100 127],474,5,23250,4.3563799887577295,20.0,40.0
35337,3,5337,[357   4 127 153 245],207,4,23254,4.356313225927313,20.0,20.0
35338,3,5338,[302 427 603 100 127],664,5,23259,4.356433789099082,20.0,40.0
35339,3,5339,[302 427 603 100 127],537,5,23264,4.356554307116105,20.0,40.0
35340,3,5340,[302 427 603 100 127],339,5,23269,4.356674780003744,20.0,40.0
35341,3,5341,[ 50 174 172 202  15],311,5,23274,4.3567952077873455,0.0,40.0
35342,3,5342,[302 427 603 100 127],271,5,23279,4.356915590492233,20.0,40.0
35343,3,5343,[302 427 603 100 127],271,5,23284,4.357035928143713,20.0,40.0
35344,3,5344,[302 427 603 100 127],334,5,23289,4.357156220767072,20.0,40.0
35345,3,5345,[302 427 603 100 127],666,5,23294,4.357276468387579,20.0,40.0
35346,3,5346,[603 276 475 357  70],474,5,23299,4.357396671030484,40.0,0.0
35347,3,5347,[302 427 603 100 127],14,4,23303,4.357329842931938,20.0,40.0
35348,3,5348,[302 427 603 100 127],271,5,23308,4.357449990652459,20.0,40.0
35349,3,5349,[302 427 603 100 127],90,5,23313,4.3575700934579435,20.0,40.0
35350,3,5350,[ 71   8  95 234  70],398,4,23317,4.3575032704167445,0.0,0.0
35351,3,5351,[435 228 210 215 100],313,4,23321,4.357436472346786,0.0,20.0
35352,3,5352,[302 427 603 100 127],13,5,23326,4.357556510368018,20.0,40.0
35353,3,5353,[302 427 603 100 127],745,4,23330,4.357489727306686,20.0,40.0
35354,3,5354,[300 237 483 318 161],85,3,23333,4.357236227824463,40.0,0.0
35355,3,5355,[302 427 603 100 127],745,4,23337,4.357169529499626,20.0,40.0
35356,3,5356,[181 515 172  64 127],326,4,23341,4.357102856076162,0.0,20.0
35357,3,5357,[302 427 603 100 127],339,5,23346,4.357222844344905,20.0,40.0
35358,3,5358,[302 427 603 100 127],666,5,23351,4.357342787833551,20.0,40.0
35359,3,5359,[ 56 180 427 288 357],343,4,23355,4.357276119402985,20.0,0.0
35360,3,5360,[302 427 603 100 127],474,5,23360,4.357396008207424,20.0,40.0
35361,3,5361,[302 427 603 100 127],334,5,23365,4.35751585229392,20.0,40.0
35362,3,5362,[302 427 603 100 127],537,5,23370,4.357635651687488,20.0,40.0
35363,3,5363,[302 427 603 100 127],537,5,23375,4.3577554064131245,20.0,40.0
35364,3,5364,[302 427 603 100 127],13,5,23380,4.357875116495806,20.0,40.0
35365,3,5365,[302 427 603 100 127],90,5,23385,4.357994781960492,20.0,40.0
35366,3,5366,[302 427 603 100 127],666,5,23390,4.358114402832122,20.0,40.0
35367,3,5367,[302 427 603 100 127],90,5,23395,4.358233979135618,20.0,40.0
35368,3,5368,[302 427 603 100 127],90,5,23400,4.358353510895884,20.0,40.0
35369,3,5369,[302 427 603 100 127],334,5,23405,4.3584729981378025,20.0,40.0
35370,3,5370,[302 427 603 100 127],745,4,23409,4.3584062558182834,20.0,40.0
35371,3,5371,[302 427 603 100 127],271,5,23414,4.358525688756515,20.0,40.0
35372,3,5372,[302 427 603 100 127],537,5,23419,4.358645077238042,20.0,40.0
35373,3,5373,[302 427 603 100 127],745,4,23423,4.358578340156308,20.0,40.0
35374,3,5374,[302 427 603 100 127],458,5,23428,4.358697674418605,20.0,40.0
35375,3,5375,[ 96 275 357  69 403],328,4,23432,4.3586309523809526,20.0,0.0
35376,3,5376,[302 427 603 100 127],271,5,23437,4.358750232471638,20.0,40.0
35377,3,5377,[302 427 603 100 127],745,4,23441,4.358683525474154,20.0,40.0
35378,3,5378,[302 427 603 100 127],334,5,23446,4.3588027514407885,20.0,40.0
35379,3,5379,[144 318  89 234  88],543,4,23450,4.358736059479554,20.0,0.0
35380,3,5380,[302 427 603 100 127],458,5,23455,4.358855231369634,20.0,40.0
35381,3,5381,[302 427 603 100 127],334,5,23460,4.358974358974359,20.0,40.0
35382,3,5382,[302 427 603 100 127],339,5,23465,4.35909344231841,20.0,40.0
35383,3,5383,[475 181 185 151 197],374,2,23467,4.358655274888559,0.0,0.0
35384,3,5384,[302 427 603 100 127],271,5,23472,4.3587743732590525,20.0,40.0
35385,3,5385,[302 427 603 100 127],666,5,23477,4.358893427404381,20.0,40.0
35386,3,5386,[302 427 603 100 127],745,4,23481,4.358826805271951,20.0,40.0
35387,3,5387,[302 427 603 100 127],458,5,23486,4.35894580549369,20.0,40.0
35388,3,5388,[302 427 603 100 127],745,4,23490,4.358879198367044,20.0,40.0
35389,3,5389,[ 70 276  69 197   4],664,3,23493,4.358627087198515,0.0,0.0
35390,3,5390,[302 427 603 100 127],458,5,23498,4.358746058245224,20.0,40.0
35391,3,5391,[302 427 603 100 127],14,4,23502,4.358679525222552,20.0,40.0
35392,3,5392,[258 117 357   8 515],311,5,23507,4.358798442425366,20.0,0.0
35393,3,5393,[302 427 603 100 127],13,5,23512,4.3589173155357805,20.0,40.0
35394,3,5394,[302 427 603 100 127],339,5,23517,4.3590361445783135,20.0,40.0
35395,3,5395,[302 427 603 100 127],14,4,23521,4.358969607116382,20.0,40.0
35396,3,5396,[302 427 603 100 127],90,5,23526,4.3590883824346855,20.0,40.0
35397,3,5397,[302 427 603 100 127],339,5,23531,4.359207113745832,20.0,40.0
35398,3,5398,[302 427 603 100 127],13,5,23536,4.359325801074273,20.0,40.0
35399,3,5399,[302 427 603 100 127],339,5,23541,4.359444444444445,20.0,40.0
35400,3,5400,[ 11 313  12  69 294],378,2,23543,4.359007591186817,20.0,0.0
35401,3,5401,[302 427 603 100 313],13,5,23548,4.3591262495372085,20.0,20.0
35402,3,5402,[302 427 603 100 313],14,4,23552,4.359059781602813,20.0,20.0
35403,3,5403,[302 427 603 100 127],666,5,23557,4.359178386380459,20.0,40.0
35404,3,5404,[302 427 603 100 127],666,5,23562,4.359296947271045,20.0,40.0
35405,3,5405,[302 427 603 100 127],334,5,23567,4.359415464298927,20.0,40.0
35406,3,5406,[483 588 117  71 176],308,3,23570,4.359164046606251,20.0,0.0
35407,3,5407,[302 427 603 100 127],90,5,23575,4.359282544378698,20.0,40.0
35408,3,5408,[302 427 603 100 127],664,5,23580,4.359400998336106,20.0,40.0
35409,3,5409,[210   4 282 143 179],378,3,23583,4.359149722735674,0.0,0.0
35410,3,5410,[302 427 603 100 127],339,5,23588,4.359268157457032,20.0,40.0
35411,3,5411,[302 427 603 100 127],334,5,23593,4.359386548410939,20.0,40.0
35412,3,5412,[302 427 603 100 127],271,5,23598,4.359504895621652,20.0,40.0
35413,3,5413,[302 427 603 100 127],458,5,23603,4.359623199113409,20.0,40.0
35414,3,5414,[ 28 186 322 568 427],313,2,23605,4.359187442289936,0.0,0.0
35415,3,5415,[196 143 269 132 435],650,5,23610,4.35930576070901,0.0,0.0
35416,3,5416,[302 427 603 100 127],745,4,23614,4.359239431419605,20.0,40.0
35417,3,5417,[302 427 603 100 127],664,5,23619,4.359357696566999,20.0,40.0
35418,3,5418,[302 427 603 100 127],664,5,23624,4.359475918066064,20.0,40.0
35419,3,5419,[302 427 603 100 127],458,5,23629,4.35959409594096,20.0,40.0
35420,3,5420,[302 427 603 100 127],339,5,23634,4.359712230215828,20.0,40.0
35421,3,5421,[ 70 100  11 200 182],7,3,23637,4.359461453338252,0.0,20.0
35422,3,5422,[302 427 603 100 127],90,5,23642,4.359579568504518,20.0,40.0
35423,3,5423,[302 427 603 100 127],13,5,23647,4.359697640117994,20.0,40.0
35424,3,5424,[302 427 603 100 127],666,5,23652,4.359815668202765,20.0,40.0
35425,3,5425,[ 96 568 181  70 125],378,4,23656,4.359749354957612,0.0,0.0
35426,3,5426,[302 427 603 100 127],14,4,23660,4.359683066150728,20.0,40.0
35427,3,5427,[302 427 603 100 127],664,5,23665,4.359801031687546,20.0,40.0
35428,3,5428,[302 427 603 100 127],745,4,23669,4.35973475778228,20.0,40.0
35429,3,5429,[302 427 603 100 127],666,5,23674,4.359852670349908,20.0,40.0
35430,3,5430,[302 427 603 100 127],745,4,23678,4.359786411342294,20.0,40.0
35431,3,5431,[302 427 603 100 127],339,5,23683,4.359904270986745,20.0,40.0
35432,3,5432,[302 427 603 100 127],271,5,23688,4.360022087244616,20.0,40.0
35433,3,5433,[186 121 603 180 143],804,4,23692,4.359955833640044,20.0,0.0
35434,3,5434,[302 427 603 100 127],664,5,23697,4.360073597056118,20.0,40.0
35435,3,5435,[302 427 603 100 127],458,5,23702,4.3601913171449596,20.0,40.0
35436,3,5436,[302 427 603 100 127],334,5,23707,4.360308993930476,20.0,40.0
35437,3,5437,[302 427 603 100 127],458,5,23712,4.360426627436557,20.0,40.0
35438,3,5438,[302 427 603 100 127],666,5,23717,4.360544217687075,20.0,40.0
35439,3,5439,[302 427 603 100 127],664,5,23722,4.360661764705882,20.0,40.0
35440,3,5440,[302 427 603 100 127],271,5,23727,4.360779268516817,20.0,40.0
35441,3,5441,[235 204  98 597 135],774,1,23728,4.360161705255421,0.0,20.0
35442,3,5442,[161  15 597 318 475],308,2,23730,4.359728091126217,20.0,0.0
35443,3,5443,[302 427 603 100 127],14,4,23734,4.359662013225569,20.0,40.0
35444,3,5444,[302 427 603 100 127],474,5,23739,4.359779614325069,20.0,40.0
35445,3,5445,[603 300 176  69   4],7,4,23743,4.359713551230261,20.0,0.0
35446,3,5446,[302 427 603 100 127],334,5,23748,4.359831099687901,20.0,40.0
35447,3,5447,[302 427 603 100 127],666,5,23753,4.359948604992658,20.0,40.0
35448,3,5448,[403 222  64 515 216],290,3,23756,4.359699027344467,0.0,0.0
35449,3,5449,[302 427 603 100 127],271,5,23761,4.3598165137614675,20.0,40.0
35450,3,5450,[ 28 121 175 125  95],378,4,23765,4.359750504494588,0.0,0.0
35451,3,5451,[187 211 194 121 204],308,4,23769,4.359684519442406,0.0,0.0
35452,3,5452,[302 427 603 100 127],339,5,23774,4.359801943884101,20.0,40.0
35453,3,5453,[302 427 603 100 127],745,4,23778,4.35973597359736,20.0,40.0
35454,3,5454,[302 427 603 100 127],271,5,23783,4.359853345554537,20.0,40.0
35455,3,5455,[ 56 742  50 269 111],524,4,23787,4.359787390029325,0.0,20.0
35456,3,5456,[302 427 603 100 127],13,5,23792,4.35990470954737,20.0,40.0
35457,3,5457,[302 427 603 100 127],666,5,23797,4.360021986075486,20.0,40.0
35458,3,5458,[302 427 603 100 127],271,5,23802,4.360139219637296,20.0,40.0
35459,3,5459,[302 427 603 100 127],458,5,23807,4.36025641025641,20.0,40.0
35460,3,5460,[ 82 144 173 603  70],398,5,23812,4.360373557956418,20.0,0.0
35461,3,5461,[222  71 322 515 318],328,3,23815,4.36012449652142,20.0,0.0
35462,3,5462,[302 427 603 100 127],666,5,23820,4.360241625480505,20.0,40.0
35463,3,5463,[302 427 603 100 127],474,5,23825,4.360358711566618,20.0,40.0
35464,3,5464,[302 427 603 100 127],13,5,23830,4.360475754803294,20.0,40.0
35465,3,5465,[302 427 603 100 127],474,5,23835,4.360592755214051,20.0,40.0
35466,3,5466,[ 69 121   1  89 153],343,3,23838,4.360343881470642,0.0,0.0
35467,3,5467,[302 427 603 100 127],458,5,23843,4.360460863204096,20.0,40.0
35468,3,5468,[302 427 603 100 127],664,5,23848,4.360577802157616,20.0,40.0
35469,3,5469,[302 427 603 100 127],14,4,23852,4.360511882998172,20.0,40.0
35470,3,5470,[173  69 286   4 197],334,3,23855,4.360263205995247,0.0,0.0
35471,3,5471,[302 427 603 100 127],14,4,23859,4.360197368421052,20.0,40.0
35472,3,5472,[302 427 603 100 127],271,5,23864,4.360314270052988,20.0,40.0
35473,3,5473,[302 427 603 100 127],339,5,23869,4.360431128973328,20.0,40.0
35474,3,5474,[ 88 568 153  79 603],659,4,23873,4.360365296803653,20.0,0.0
35475,3,5475,[302 427 603 100 127],537,5,23878,4.360482103725347,20.0,40.0
35476,3,5476,[302 427 603 100 127],14,4,23882,4.360416286288114,20.0,40.0
35477,3,5477,[302 427 603 100 127],339,5,23887,4.360533041255933,20.0,40.0
35478,3,5478,[195  82 271 117 318],536,4,23891,4.36046723854718,20.0,0.0
35479,3,5479,[302 427 603 100 127],14,4,23895,4.360401459854015,20.0,40.0
35480,3,5480,[276 151 289  79 173],374,2,23897,4.35997080824667,0.0,0.0
35481,3,5481,[302 427 603 100 127],339,5,23902,4.360087559284932,20.0,40.0
35482,3,5482,[302 427 603 100 127],458,5,23907,4.36020426773664,20.0,40.0
35483,3,5483,[302 427 603 100 127],664,5,23912,4.360320933625091,20.0,40.0
35484,3,5484,[302 427 603 100 127],13,5,23917,4.360437556973564,20.0,40.0
35485,3,5485,[302 427 603 100 127],458,5,23922,4.360554137805322,20.0,40.0
35486,3,5486,[302 427 603 100 127],14,4,23926,4.360488427191544,20.0,40.0
35487,3,5487,[302 427 603 100 127],474,5,23931,4.360604956268221,20.0,40.0
35488,3,5488,[111 197 228 187 204],334,4,23935,4.36053926033886,0.0,0.0
35489,3,5489,[174 237 515 748 385],543,3,23938,4.360291438979964,0.0,20.0
35490,3,5490,[302 427 603 100 127],664,5,23943,4.3604079402658895,20.0,40.0
35491,3,5491,[302 427 603 100 127],14,4,23947,4.36034231609614,20.0,40.0
35492,3,5492,[302 427 603 100 127],90,5,23952,4.360458765701802,20.0,40.0
35493,3,5493,[302 427 603 100 127],334,5,23957,4.360575172915908,20.0,40.0
35494,3,5494,[176  50   8 288 333],13,2,23959,4.360145586897179,0.0,20.0
35495,3,5495,[302 427 603 100 127],271,5,23964,4.360262008733624,20.0,40.0
35496,3,5496,[  8 174 181  12 161],13,5,23969,4.3603783882117515,20.0,20.0
35497,3,5497,[234 210 181 117 588],650,3,23972,4.360130956711531,0.0,0.0
35498,3,5498,[ 15 257 234 496 405],95,3,23975,4.359883615202764,0.0,0.0
35499,3,5499,[302 427 603 100 127],458,5,23980,4.36,20.0,40.0
35500,3,5500,[302 427 603 100 127],745,4,23984,4.359934557353209,20.0,40.0
35501,3,5501,[302 427 603 100  64],271,5,23989,4.360050890585241,20.0,20.0
35502,3,5502,[215  56 742  95  28],804,3,23992,4.359803743412684,0.0,0.0
35503,3,5503,[302 427 603 100  64],537,4,23996,4.359738372093023,20.0,20.0
35504,3,5504,[210 515  69 423 294],275,3,23999,4.359491371480472,0.0,0.0
35505,3,5505,[302 427 603 100 127],458,5,24004,4.359607700690156,20.0,40.0
35506,3,5506,[302 427 603 100 127],90,5,24009,4.359723987652079,20.0,40.0
35507,3,5507,[302 427 603 100 127],339,5,24014,4.359840232389252,20.0,40.0
35508,3,5508,[ 97 161  88 265 222],13,4,24018,4.359774913777455,0.0,0.0
35509,3,5509,[302 427 603 100 127],334,5,24023,4.35989110707804,20.0,40.0
35510,3,5510,[302 427 603 100 127],664,5,24028,4.360007258210851,20.0,40.0
35511,3,5511,[302 427 603 100 127],664,5,24033,4.360123367198839,20.0,40.0
35512,3,5512,[302 427 603 100 127],537,5,24038,4.360239434064938,20.0,40.0
35513,3,5513,[302 427 603 100 127],474,5,24043,4.360355458832064,20.0,40.0
35514,3,5514,[238 204  15  25 174],474,5,24048,4.360471441523119,0.0,20.0
35515,3,5515,[288 194 216   8 385],13,2,24050,4.360043509789703,0.0,0.0
35516,3,5516,[748  82 258  69 234],13,4,24054,4.359978249048396,0.0,0.0
35517,3,5517,[515  28  89 273 204],13,3,24057,4.359731786879304,0.0,0.0
35518,3,5518,[302 427 603 100 127],458,5,24062,4.359847798514224,20.0,40.0
35519,3,5519,[302 427 603 100 127],664,5,24067,4.359963768115942,20.0,40.0
35520,3,5520,[568 179 211  82 238],543,3,24070,4.359717442492302,0.0,0.0
35521,3,5521,[302 427 603 100 127],666,5,24075,4.359833393697936,20.0,40.0
35522,3,5522,[302 427 603 100 127],745,4,24079,4.35976824189752,20.0,40.0
35523,3,5523,[302 427 603 100 127],666,5,24084,4.35988414192614,20.0,40.0
35524,3,5524,[153 273 182 568  64],207,4,24088,4.359819004524887,0.0,0.0
35525,3,5525,[300 196  98 496  22],488,4,24092,4.359753890698516,0.0,20.0
35526,3,5526,[302 427 603 100 127],334,5,24097,4.35986973041433,20.0,40.0
35527,3,5527,[302 427 603 100 127],745,4,24101,4.3598046309696095,20.0,40.0
35528,3,5528,[302 427 603 100 127],745,4,24105,4.35973955507325,20.0,40.0
35529,3,5529,[289  71 211 100 435],82,4,24109,4.359674502712477,0.0,20.0
35530,3,5530,[302 427 603 100 127],458,5,24114,4.3597902730066895,20.0,40.0
35531,3,5531,[302 427 603 100 127],458,5,24119,4.359906001446132,20.0,40.0
35532,3,5532,[216 168 180  12  96],346,4,24123,4.359840954274354,20.0,0.0
35533,3,5533,[302 427 603 100 127],13,5,24128,4.359956631731117,20.0,40.0
35534,3,5534,[ 56 475 174 210 423],387,3,24131,4.359710930442637,0.0,20.0
35535,3,5535,[302 427 603 100 127],339,5,24136,4.359826589595376,20.0,40.0
35536,3,5536,[302 427 603 100 127],474,5,24141,4.359942206971284,20.0,40.0
35537,3,5537,[302 427 603 100 127],13,5,24146,4.360057782592994,20.0,40.0
35538,3,5538,[302 427 603 100 127],339,5,24151,4.360173316483119,20.0,40.0
35539,3,5539,[302 427 603 100 127],666,5,24156,4.36028880866426,20.0,40.0
35540,3,5540,[302 427 603 100 127],745,4,24160,4.360223786320159,20.0,40.0
35541,3,5541,[179 265 258 100 748],13,4,24164,4.360158787441357,0.0,20.0
35542,3,5542,[302 427 603 100 127],334,5,24169,4.3602742197366045,20.0,40.0
35543,3,5543,[173   7  11 268 237],92,4,24173,4.360209235209235,0.0,0.0
35544,3,5544,[302 427 603 100 127],458,5,24178,4.360324616771867,20.0,40.0
35545,3,5545,[302 427 603 100 127],458,5,24183,4.360439956725568,20.0,40.0
35546,3,5546,[302 427 603 100 127],339,5,24188,4.360555255092843,20.0,40.0
35547,3,5547,[302 427 603 100 127],90,5,24193,4.360670511896179,20.0,40.0
35548,3,5548,[302 427 603 100 127],334,5,24198,4.360785727158047,20.0,40.0
35549,3,5549,[200  79  50 196 508],774,1,24199,4.36018018018018,0.0,20.0
35550,3,5550,[ 97  50 318  70 118],295,4,24203,4.360115294541524,20.0,20.0
35551,3,5551,[302 427 603 100 127],271,5,24208,4.360230547550432,20.0,40.0
35552,3,5552,[302 427 603 100 127],334,5,24213,4.360345759049163,20.0,40.0
35553,3,5553,[568 180 168  22  96],749,5,24218,4.360460929060137,0.0,0.0
35554,3,5554,[302 427 603 100 127],664,5,24223,4.36057605760576,20.0,40.0
35555,3,5555,[302 427 603 100 127],664,5,24228,4.360691144708423,20.0,40.0
35556,3,5556,[  7   9  64 423 132],7,5,24233,4.360806190390498,0.0,0.0
35557,3,5557,[302 427 603 100 127],745,4,24237,4.360741273839511,20.0,40.0
35558,3,5558,[111 234  71 127 216],95,4,24241,4.3606763806440005,0.0,20.0
35559,3,5559,[302 427 603 100 127],745,4,24245,4.360611510791367,20.0,40.0
35560,3,5560,[742  97 286 187 202],881,3,24248,4.360366840496313,0.0,0.0
35561,3,5561,[302 427 603 100 127],13,5,24253,4.360481841064366,20.0,40.0
35562,3,5562,[ 50  89 328 588 385],804,5,24258,4.360596800287615,0.0,20.0
35563,3,5563,[302 427 603 100 127],474,5,24263,4.3607117181883535,20.0,40.0
35564,3,5564,[144 181 483  97 294],650,2,24265,4.360287511230908,20.0,0.0
35565,3,5565,[302 427 603 100 127],339,5,24270,4.360402443406396,20.0,40.0
35566,3,5566,[302 427 603 100 127],664,5,24275,4.36051733429136,20.0,40.0
35567,3,5567,[302 427 603 100 127],13,5,24280,4.360632183908046,20.0,40.0
35568,3,5568,[125 191  98 588 322],804,5,24285,4.360746992278686,0.0,20.0
35569,3,5569,[302 427 603 100 127],90,5,24290,4.360861759425494,20.0,40.0
35570,3,5570,[302 427 603 100 127],474,5,24295,4.36097648537067,20.0,40.0
35571,3,5571,[302 427 603 100 127],664,5,24300,4.361091170136397,20.0,40.0
35572,3,5572,[302 427 603 100 127],14,4,24304,4.361026377175668,20.0,40.0
35573,3,5573,[302 427 603 100 127],745,4,24308,4.3609616074632225,20.0,40.0
35574,3,5574,[302 427 603 100 127],458,5,24313,4.361076233183857,20.0,40.0
35575,3,5575,[302 427 603 100 127],458,5,24318,4.361190817790531,20.0,40.0
35576,3,5576,[302 427 603 100 127],458,5,24323,4.361305361305361,20.0,40.0
35577,3,5577,[302 427 603 100 127],664,5,24328,4.361419863750448,20.0,40.0
35578,3,5578,[302 427 603 100 127],537,5,24333,4.3615343251478755,20.0,40.0
35579,3,5579,[302 427 603 100 127],14,4,24337,4.361469534050179,20.0,40.0
35580,3,5580,[403 405 215  95 100],804,3,24340,4.361225586812399,0.0,20.0
35581,3,5581,[302 427 603 100 127],13,5,24345,4.361340021497671,20.0,40.0
35582,3,5582,[132 187 100  11 210],271,5,24350,4.361454415188967,0.0,20.0
35583,3,5583,[  9 175 168 176 174],14,4,24354,4.361389684813753,0.0,20.0
35584,3,5584,[302 427 603 100 127],745,4,24358,4.361324977618621,20.0,40.0
35585,3,5585,[180 125 196 153 403],290,1,24359,4.360723236663087,0.0,0.0
35586,3,5586,[302 427 603 100 127],271,5,24364,4.360837658850904,20.0,40.0
35587,3,5587,[568 172 276  56 182],92,4,24368,4.360773085182534,0.0,0.0
35588,3,5588,[302 427 603 100 127],666,5,24373,4.360887457505815,20.0,40.0
35589,3,5589,[182 286  89  50  97],13,4,24377,4.3608228980322,0.0,20.0
35590,3,5590,[302 427 603 100 127],474,5,24382,4.360937220533,20.0,40.0
35591,3,5591,[ 89 183 258   4 176],64,2,24384,4.360515021459228,0.0,0.0
35592,3,5592,[118 228  82   1 385],653,4,24388,4.360450563204005,0.0,0.0
35593,3,5593,[302 427 603 100 127],537,5,24393,4.360564890954594,20.0,40.0
35594,3,5594,[302 427 603 100 127],664,5,24398,4.360679177837355,20.0,40.0
35595,3,5595,[302 427 603 100 127],458,5,24403,4.360793423874195,20.0,40.0
35596,3,5596,[302 427 603 100 127],271,5,24408,4.360907629087011,20.0,40.0
35597,3,5597,[238 121 471  12  69],666,3,24411,4.360664523043944,20.0,0.0
35598,3,5598,[302 427 603 100 127],90,5,24416,4.360778710484015,20.0,40.0
35599,3,5599,[435  12 186 132  15],60,5,24421,4.360892857142857,20.0,0.0
35600,3,5600,[210 405 271 204 258],119,4,24425,4.360828423495804,0.0,0.0
35601,3,5601,[302 427 603 100 127],90,5,24430,4.360942520528383,20.0,40.0
35602,3,5602,[302 427 603 100 127],13,5,24435,4.361056576833839,20.0,40.0
35603,3,5603,[302 427 603 100 127],666,5,24440,4.361170592433976,20.0,40.0
35604,3,5604,[176 286  95  25 471],95,2,24442,4.360749330954505,0.0,0.0
35605,3,5605,[302 427 603 100 127],271,5,24447,4.360863360684981,20.0,40.0
35606,3,5606,[302 427 603 100 127],90,5,24452,4.360977349741395,20.0,40.0
35607,3,5607,[182 153 117 183 294],346,3,24455,4.360734664764622,0.0,0.0
35608,3,5608,[302 427 603 100 127],14,4,24459,4.360670351221252,20.0,40.0
35609,3,5609,[  1 211 427 238 176],380,2,24461,4.3602495543672015,0.0,0.0
35610,3,5610,[302 427 603 100 127],745,4,24465,4.360185350204954,20.0,40.0
35611,3,5611,[302 427 603 100 127],745,4,24469,4.360121168923735,20.0,40.0
35612,3,5612,[302 427 603 100 127],334,5,24474,4.360235168359166,20.0,40.0
35613,3,5613,[302 427 603 100 127],271,5,24479,4.360349127182045,20.0,40.0
35614,3,5614,[302 427 603 100 127],14,4,24483,4.360284951024043,20.0,40.0
35615,3,5615,[302 427 603 100 127],666,5,24488,4.360398860398861,20.0,40.0
35616,3,5616,[302 427 603 100 127],537,5,24493,4.360512729214883,20.0,40.0
35617,3,5617,[  8 195 245 508 175],378,3,24496,4.360270558917764,0.0,0.0
35618,3,5618,[302 427 603 100 127],271,5,24501,4.360384410037373,20.0,40.0
35619,3,5619,[302 427 603 100 127],537,5,24506,4.36049822064057,20.0,40.0
35620,3,5620,[302 427 603 100 127],271,5,24511,4.360611990748977,20.0,40.0
35621,3,5621,[302 427 603 100 127],13,5,24516,4.360725720384205,20.0,40.0
35622,3,5622,[302 427 603 100 127],664,5,24521,4.360839409567847,20.0,40.0
35623,3,5623,[302 427 603 100 127],339,5,24526,4.3609530583214795,20.0,40.0
35624,3,5624,[302 427 603 100 127],90,5,24531,4.361066666666667,20.0,40.0
35625,3,5625,[302 427 603 100 127],13,5,24536,4.361180234624956,20.0,40.0
35626,3,5626,[302 427 603 100 127],13,5,24541,4.361293762217878,20.0,40.0
35627,3,5627,[302 427 603 100 127],474,5,24546,4.361407249466951,20.0,40.0
35628,3,5628,[302 427 603 100 127],271,5,24551,4.361520696393676,20.0,40.0
35629,3,5629,[302 427 603 100 127],14,4,24555,4.36145648312611,20.0,40.0
35630,3,5630,[  4 546 237 211 185],788,3,24558,4.361214704315397,0.0,0.0
35631,3,5631,[302 427 603 100 127],537,5,24563,4.361328125,20.0,40.0
35632,3,5632,[302 427 603 100 127],537,5,24568,4.361441505414522,20.0,40.0
35633,3,5633,[302 427 603 100 127],474,5,24573,4.361554845580405,20.0,40.0
35634,3,5634,[302 427 603 100 127],271,5,24578,4.3616681455190776,20.0,40.0
35635,3,5635,[302 427 603 100 127],458,5,24583,4.361781405251952,20.0,40.0
35636,3,5636,[302 427 603 100 127],90,5,24588,4.361894624800426,20.0,40.0
35637,3,5637,[ 28 216  15 385 181],95,5,24593,4.362007804185882,0.0,0.0
35638,3,5638,[302 427 603 100 127],474,5,24598,4.362120943429686,20.0,40.0
35639,3,5639,[265 300 168 143 186],379,4,24602,4.362056737588652,0.0,0.0
35640,3,5640,[302 427 603 100 127],666,5,24607,4.362169828044673,20.0,40.0
35641,3,5641,[179 483 200  82 273],537,2,24609,4.361751152073733,20.0,0.0
35642,3,5642,[ 69 197 423  96 471],90,4,24613,4.361687045897572,0.0,0.0
35643,3,5643,[588 168  64 568 143],85,3,24616,4.36144578313253,0.0,0.0
35644,3,5644,[302 427 603 100 127],745,4,24620,4.361381753764393,20.0,40.0
35645,3,5645,[302 427 603 100 127],13,5,24625,4.361494863620262,20.0,40.0
35646,3,5646,[302 427 603 100 127],664,5,24630,4.361607933415973,20.0,40.0
35647,3,5647,[117 121 151 475 508],669,1,24631,4.361012747875354,0.0,0.0
35648,3,5648,[302 427 603 100 127],745,4,24635,4.3609488405027435,20.0,40.0
35649,3,5649,[ 71 403 286 333  28],334,3,24638,4.36070796460177,0.0,0.0
35650,3,5650,[302 427 603 100 127],90,5,24643,4.36082109361175,20.0,40.0
35651,3,5651,[302 427 603 100 127],14,4,24647,4.360757254069356,20.0,40.0
35652,3,5652,[302 427 603 100 127],666,5,24652,4.360870334335751,20.0,40.0
35653,3,5653,[197 191 405 318 132],406,4,24656,4.360806508666431,20.0,0.0
35654,3,5654,[302 427 603 100 127],745,4,24660,4.360742705570292,20.0,40.0
35655,3,5655,[302 427 603 100 127],271,5,24665,4.360855728429986,20.0,40.0
35656,3,5656,[180  98 135 143 161],207,3,24668,4.360615167049673,0.0,20.0
35657,3,5657,[302 427 603 100 127],13,5,24673,4.360728172499116,20.0,40.0
35658,3,5658,[302 427 603 100 127],334,5,24678,4.360841138010249,20.0,40.0
35659,3,5659,[302 427 603 100 127],458,5,24683,4.3609540636042405,20.0,40.0
35660,3,5660,[302 427 603 100 127],745,4,24687,4.360890302066773,20.0,40.0
35661,3,5661,[302 427 603 100 127],664,5,24692,4.361003179088661,20.0,40.0
35662,3,5662,[144 118  79 276  70],194,1,24693,4.360409676849726,0.0,0.0
35663,3,5663,[302 427 603 100 127],664,5,24698,4.360522598870056,20.0,40.0
35664,3,5664,[187   1  28 427  64],343,5,24703,4.360635481023831,0.0,0.0
35665,3,5665,[302 427 603 100 127],537,5,24708,4.360748323332157,20.0,40.0
35666,3,5666,[302 427 603 100 127],537,5,24713,4.360861125816128,20.0,40.0
35667,3,5667,[302 427 603 100 127],334,5,24718,4.360973888496824,20.0,40.0
35668,3,5668,[ 88  95 168  82 144],543,3,24721,4.36073381548774,0.0,0.0
35669,3,5669,[302 427 603 100 127],90,5,24726,4.360846560846561,20.0,40.0
35670,3,5670,[302 427 603 100 127],339,5,24731,4.360959266443308,20.0,40.0
35671,3,5671,[ 96 194 202 313 435],64,5,24736,4.361071932299013,0.0,0.0
35672,3,5672,[302 427 603 100 127],537,5,24741,4.36118455843469,20.0,40.0
35673,3,5673,[ 22  97 427  12 180],406,4,24745,4.36112090236165,20.0,0.0
35674,3,5674,[302 427 603 100 127],339,5,24750,4.361233480176211,20.0,40.0
35675,3,5675,[302 427 603 100 127],13,5,24755,4.361346018322762,20.0,40.0
35676,3,5676,[678 211 357 202 323],454,0,24755,4.360577769948916,20.0,0.0
35677,3,5677,[288 181 568  25 144],213,5,24760,4.360690383938007,0.0,0.0
35678,3,5678,[302 427 603 100 127],14,4,24764,4.36062687092798,20.0,40.0
35679,3,5679,[302 427 603 100 127],537,5,24769,4.360739436619719,20.0,40.0
35680,3,5680,[302 427 603 100 127],14,4,24773,4.360675937334976,20.0,40.0
35681,3,5681,[302 427 603 100 127],271,5,24778,4.360788454769447,20.0,40.0
35682,3,5682,[302 427 603 100 127],339,5,24783,4.360900932606018,20.0,40.0
35683,3,5683,[234 427 121 357 204],406,5,24788,4.361013370865588,20.0,0.0
35684,3,5684,[302 427 603 100 127],664,5,24793,4.361125769569042,20.0,40.0
35685,3,5685,[302 427 603 100 127],474,5,24798,4.3612381287372495,20.0,40.0
35686,3,5686,[302 427 603 100 127],271,5,24803,4.361350448391067,20.0,40.0
35687,3,5687,[302 427 603 100 127],537,5,24808,4.361462728551336,20.0,40.0
35688,3,5688,[302 427 603 100 127],90,5,24813,4.361574969238882,20.0,40.0
35689,3,5689,[302 427 603 100 127],14,4,24817,4.361511423550088,20.0,40.0
35690,3,5690,[302 427 603 100 127],339,5,24822,4.361623616236162,20.0,40.0
35691,3,5691,[302 427 603 100 127],90,5,24827,4.361735769501054,20.0,40.0
35692,3,5692,[302 427 603 100 127],458,5,24832,4.361847883365536,20.0,40.0
35693,3,5693,[302 427 603 100 127],745,4,24836,4.361784334387074,20.0,40.0
35694,3,5694,[302 427 603 100 127],745,4,24840,4.361720807726075,20.0,40.0
35695,3,5695,[186 168 183 471 258],234,1,24841,4.361130617977528,0.0,0.0
35696,3,5696,[302 427 603 100 127],271,5,24846,4.361242759347025,20.0,40.0
35697,3,5697,[302 427 603 100 127],339,5,24851,4.361354861354862,20.0,40.0
35698,3,5698,[302 427 603 100 127],339,5,24856,4.361466924021758,20.0,40.0
35699,3,5699,[302 427 603 100 127],339,5,24861,4.361578947368421,20.0,40.0
35700,3,5700,[302 427 603 100 127],666,5,24866,4.361690931415541,20.0,40.0
35701,3,5701,[302 427 603 100 127],745,4,24870,4.361627499123115,20.0,40.0
35702,3,5702,[200 173 204 135 143],650,5,24875,4.3617394353848855,0.0,0.0
35703,3,5703,[302 427 603 100 127],90,5,24880,4.361851332398317,20.0,40.0
35704,3,5704,[435 275 132 222 238],312,3,24883,4.361612620508326,0.0,0.0
35705,3,5705,[302 427 603 100 127],458,5,24888,4.361724500525763,20.0,40.0
35706,3,5706,[302 427 603 100 127],664,5,24893,4.361836341335202,20.0,40.0
35707,3,5707,[121   7  98 183 322],346,2,24895,4.361422564821304,0.0,20.0
35708,3,5708,[  9 144 100 282 194],788,5,24900,4.361534419337888,0.0,20.0
35709,3,5709,[302 427 603 100 127],339,5,24905,4.361646234676007,20.0,40.0
35710,3,5710,[302 427 603 100 127],474,5,24910,4.361758010856242,20.0,40.0
35711,3,5711,[302 427 603 100 127],14,4,24914,4.3616946778711485,20.0,40.0
35712,3,5712,[302 427 603 100 127],90,5,24919,4.361806406441449,20.0,40.0
35713,3,5713,[302 427 603 100 127],666,5,24924,4.361918095904795,20.0,40.0
35714,3,5714,[302 427 603 100 127],666,5,24929,4.362029746281714,20.0,40.0
35715,3,5715,[302 427 603 100 127],745,4,24933,4.361966410076977,20.0,40.0
35716,3,5716,[289 196 195  88 265],378,4,24937,4.361903096029386,0.0,0.0
35717,3,5717,[302 427 603 100 127],745,4,24941,4.361839804127317,20.0,40.0
35718,3,5718,[302 427 603 100 127],14,4,24945,4.361776534359154,20.0,40.0
35719,3,5719,[302 427 603 100 127],664,5,24950,4.361888111888112,20.0,40.0
35720,3,5720,[302 427 603 100 127],745,4,24954,4.361824855794442,20.0,40.0
35721,3,5721,[302 427 603 100  50],458,4,24958,4.3617616218105555,20.0,40.0
35722,3,5722,[302 427 603 100 127],474,5,24963,4.361873143456229,20.0,40.0
35723,3,5723,[302 427 603 100 127],90,5,24968,4.36198462613557,20.0,40.0
35724,3,5724,[302 427 603 100 127],537,5,24973,4.362096069868995,20.0,40.0
35725,3,5725,[302 427 603 100 127],474,5,24978,4.362207474676913,20.0,40.0
35726,3,5726,[210 182 235 179 588],308,4,24982,4.3621442290902745,0.0,0.0
35727,3,5727,[288 182 257  15   8],92,2,24984,4.361731843575419,0.0,0.0
35728,3,5728,[302 427 603 100 127],13,5,24989,4.361843253621924,20.0,40.0
35729,3,5729,[197 483  82 127 161],479,4,24993,4.361780104712042,20.0,20.0
35730,3,5730,[302 427 603 100 127],90,5,24998,4.361891467457686,20.0,40.0
35731,3,5731,[302 427 603 100 127],664,5,25003,4.362002791346825,20.0,40.0
35732,3,5732,[302 427 603 100 127],271,5,25008,4.3621140763997905,20.0,40.0
35733,3,5733,[302 427 603 100 127],14,4,25012,4.362050924311126,20.0,40.0
35734,3,5734,[302 427 603 100 127],90,5,25017,4.3621621621621625,20.0,40.0
35735,3,5735,[302 427 603 100 127],14,4,25021,4.362099023709902,20.0,40.0
35736,3,5736,[302 427 603 100 127],666,5,25026,4.362210214397769,20.0,40.0
35737,3,5737,[302 427 603 100 127],13,5,25031,4.3623213663297316,20.0,40.0
35738,3,5738,[210   9 496  22 234],488,5,25036,4.36243247952605,0.0,0.0
35739,3,5739,[302 427 603 100 496],339,5,25041,4.362543554006969,20.0,20.0
35740,3,5740,[302 427 603 100 496],664,5,25046,4.362654589792719,20.0,20.0
35741,3,5741,[ 98 210 228 125 187],804,5,25051,4.362765586903518,0.0,20.0
35742,3,5742,[302 427 603 100 496],474,5,25056,4.362876545359568,20.0,20.0
35743,3,5743,[302 427 603 100 496],271,5,25061,4.3629874651810585,20.0,20.0
35744,3,5744,[302 427 603 100 496],339,5,25066,4.363098346388163,20.0,20.0
35745,3,5745,[302 427 603 100 496],664,5,25071,4.3632091890010445,20.0,20.0
35746,3,5746,[302 427 603 100 496],90,5,25076,4.3633199930398465,20.0,20.0
35747,3,5747,[182 183   7  64 117],194,1,25077,4.362734864300626,0.0,0.0
35748,3,5748,[302 427 603 100 496],90,5,25082,4.362845712297791,20.0,20.0
35749,3,5749,[216 191 405  56 100],538,4,25086,4.362782608695652,0.0,20.0
35750,3,5750,[237  96 216   8 496],398,3,25089,4.3625456442357855,0.0,0.0
35751,3,5751,[302 427 603 100 496],339,5,25094,4.362656467315716,20.0,20.0
35752,3,5752,[302 427 603 100 496],666,5,25099,4.362767251868591,20.0,20.0
35753,3,5753,[655  97  79  28 179],843,1,25100,4.362182829336114,0.0,0.0
35754,3,5754,[302 427 603 100 496],537,5,25105,4.362293657688966,20.0,20.0
35755,3,5755,[302 427 603 100 496],334,4,25109,4.362230715774843,20.0,20.0
35756,3,5756,[302 427 603 100 496],474,5,25114,4.362341497307625,20.0,20.0
35757,3,5757,[302 427 603 100 496],271,5,25119,4.362452240361237,20.0,20.0
35758,3,5758,[302 427 603 100 496],339,5,25124,4.362562944955721,20.0,20.0
35759,3,5759,[302 427 603 100 496],474,5,25129,4.362673611111111,20.0,20.0
35760,3,5760,[302 427 603 100 496],383,5,25134,4.362784238847422,20.0,20.0
35761,3,5761,[302 427 603 100 496],454,5,25139,4.3628948281846585,20.0,20.0
35762,3,5762,[302 427 603 100 496],339,5,25144,4.363005379142807,20.0,20.0
35763,3,5763,[302 427 603 100 496],334,4,25148,4.36294240111034,20.0,20.0
35764,3,5764,[144 603 111 258  96],749,4,25152,4.362879444926279,20.0,0.0
35765,3,5765,[302 427 603 100 496],666,5,25157,4.3629899410336455,20.0,20.0
35766,3,5766,[302 427 603 100 496],458,4,25161,4.362926998439397,20.0,20.0
35767,3,5767,[302 427 603 100  64],370,5,25166,4.363037447988904,20.0,20.0
35768,3,5768,[302 427 603 100  64],454,5,25171,4.363147859247703,20.0,20.0
35769,3,5769,[302 427 603 100  64],664,5,25176,4.363258232235702,20.0,20.0
35770,3,5770,[318 678 143 269  12],537,1,25177,4.3626754461965,40.0,0.0
35771,3,5771,[302 427 603 100  64],370,5,25182,4.362785862785863,20.0,20.0
35772,3,5772,[195 118 216 180 546],533,3,25185,4.362549800796812,0.0,0.0
35773,3,5773,[302 427 603 100  64],271,5,25190,4.362660200900589,20.0,20.0
35774,3,5774,[302 427 603 100  64],339,5,25195,4.362770562770563,20.0,20.0
35775,3,5775,[302 427 603 100  64],454,5,25200,4.362880886426593,20.0,20.0
35776,3,5776,[302 427 603 100  64],666,5,25205,4.362991171888523,20.0,20.0
35777,3,5777,[302 427 603 100  64],271,5,25210,4.363101419176186,20.0,20.0
35778,3,5778,[302 427 603 100  64],745,5,25215,4.363211628309396,20.0,20.0
35779,3,5779,[ 89 508 427 202 215],406,3,25218,4.362975778546713,0.0,0.0
35780,3,5780,[302 427 603 100  64],745,5,25223,4.363085971285245,20.0,20.0
35781,3,5781,[302 427 603 100  64],90,5,25228,4.36319612590799,20.0,20.0
35782,3,5782,[302 427 603 100  64],537,4,25232,4.363133321805291,20.0,20.0
35783,3,5783,[302 427 603 100  64],90,5,25237,4.363243430152144,20.0,20.0
35784,3,5784,[302 427 603 100  64],745,5,25242,4.363353500432152,20.0,20.0
35785,3,5785,[302 427 603 100  64],474,5,25247,4.363463532665054,20.0,20.0
35786,3,5786,[302 427 603 100  64],13,5,25252,4.363573526870572,20.0,20.0
35787,3,5787,[302 427 603 100  64],537,4,25256,4.363510711817553,20.0,20.0
35788,3,5788,[302 427 603 100  64],90,5,25261,4.363620659872171,20.0,20.0
35789,3,5789,[302 427 603 100  64],90,5,25266,4.363730569948187,20.0,20.0
35790,3,5790,[127 153 168 271  98],890,3,25269,4.363495078570195,0.0,40.0
35791,3,5791,[ 12 121 313   1  70],894,3,25272,4.363259668508287,20.0,0.0
35792,3,5792,[302 427 603 100  64],537,4,25276,4.363196961850509,20.0,20.0
35793,3,5793,[302 427 603 100 496],454,5,25281,4.363306869175009,20.0,20.0
35794,3,5794,[475 301 191 172 127],13,2,25283,4.362899050905954,0.0,20.0
35795,3,5795,[302 427 603 100 496],664,5,25288,4.363008971704624,20.0,20.0
35796,3,5796,[302 427 603 100 496],339,5,25293,4.363118854579955,20.0,20.0
35797,3,5797,[302 427 603 100 496],474,5,25298,4.36322869955157,20.0,20.0
35798,3,5798,[302 427 603 100 496],454,5,25303,4.363338506639075,20.0,20.0
35799,3,5799,[302 427 603 100 496],90,5,25308,4.363448275862069,20.0,20.0
35800,3,5800,[302 427 603 100 496],458,4,25312,4.363385623168419,20.0,20.0
35801,3,5801,[302 427 603 100 496],271,5,25317,4.3634953464322646,20.0,20.0
35802,3,5802,[302 427 603 100 496],458,4,25321,4.3634327072204036,20.0,20.0
35803,3,5803,[302 427 603 100 127],339,5,25326,4.363542384562371,20.0,40.0
35804,3,5804,[302 427 603 100 127],90,5,25331,4.36365202411714,20.0,40.0
35805,3,5805,[302 427 603 100 127],339,5,25336,4.363761625904237,20.0,40.0
35806,3,5806,[143 200  71  22 228],7,4,25340,4.363698983984846,0.0,0.0
35807,3,5807,[302 427 603 100 127],13,5,25345,4.363808539944904,20.0,40.0
35808,3,5808,[302 427 603 100 127],271,5,25350,4.3639180581855745,20.0,40.0
35809,3,5809,[302 427 603 100 127],664,5,25355,4.364027538726334,20.0,40.0
35810,3,5810,[302 427 603 100 127],537,5,25360,4.364136981586646,20.0,40.0
35811,3,5811,[302 427 603 100 127],666,5,25365,4.36424638678596,20.0,40.0
35812,3,5812,[222 588 237  25 423],804,4,25369,4.364183726131086,0.0,0.0
35813,3,5813,[302 427 603 100 127],90,5,25374,4.364293085655315,20.0,40.0
35814,3,5814,[143 135  97  96 202],479,3,25377,4.364058469475494,0.0,0.0
35815,3,5815,[273 322 191 268  15],699,1,25378,4.3634800550206325,0.0,0.0
35816,3,5816,[302 427 603 100 127],474,5,25383,4.363589479112945,20.0,40.0
35817,3,5817,[302 427 603 100 127],13,5,25388,4.36369886558955,20.0,40.0
35818,3,5818,[302 427 603 100 127],339,5,25393,4.36380821446984,20.0,40.0
35819,3,5819,[302 427 603 100 127],339,5,25398,4.3639175257731955,20.0,40.0
35820,3,5820,[302 427 603 100 127],458,5,25403,4.364026799518983,20.0,40.0
35821,3,5821,[302 427 603 100 127],664,5,25408,4.364136035726554,20.0,40.0
35822,3,5822,[302 427 603 100 127],664,5,25413,4.36424523441525,20.0,40.0
35823,3,5823,[302 427 603 100 127],90,5,25418,4.364354395604396,20.0,40.0
35824,3,5824,[302 427 603 100 127],334,5,25423,4.364463519313305,20.0,40.0
35825,3,5825,[176 172   7 100 496],537,3,25426,4.364229316855475,0.0,20.0
35826,3,5826,[ 12 313 273 172 265],883,3,25429,4.363995194782907,20.0,0.0
35827,3,5827,[302 427 603 100 127],474,5,25434,4.364104323953328,20.0,40.0
35828,3,5828,[302 427 603 100 127],271,5,25439,4.3642134156802195,20.0,40.0
35829,3,5829,[302 427 603 100 127],474,5,25444,4.364322469982848,20.0,40.0
35830,3,5830,[302 427 603 100 127],664,5,25449,4.364431486880466,20.0,40.0
35831,3,5831,[302 427 603 100 127],666,5,25454,4.364540466392318,20.0,40.0
35832,3,5832,[302 427 603 100 127],334,5,25459,4.36464940853763,20.0,40.0
35833,3,5833,[302 427 603 100 127],458,5,25464,4.364758313335619,20.0,40.0
35834,3,5834,[302 427 603 100 127],474,5,25469,4.364867180805484,20.0,40.0
35835,3,5835,[302 427 603 100 127],666,5,25474,4.364976010966416,20.0,40.0
35836,3,5836,[ 96 117  56 183 323],537,1,25475,4.364399520301525,0.0,0.0
35837,3,5837,[302 427 603 100 127],458,5,25480,4.364508393285372,20.0,40.0
35838,3,5838,[302 427 603 100 127],666,5,25485,4.364617228977565,20.0,40.0
35839,3,5839,[302 427 603 100 127],666,5,25490,4.364726027397261,20.0,40.0
35840,3,5840,[302 427 603 100 127],14,4,25494,4.364663585002568,20.0,40.0
35841,3,5841,[179 215 568   9  56],59,5,25499,4.3647723382403285,0.0,0.0
35842,3,5842,[302 427 603 100 127],13,5,25504,4.364881054252952,20.0,40.0
35843,3,5843,[302 427 603 100 127],537,5,25509,4.364989733059549,20.0,40.0
35844,3,5844,[182  11   7 238 257],499,2,25511,4.364585115483319,0.0,0.0
35845,3,5845,[200 185 302 144 173],102,0,25511,4.36383852206637,0.0,0.0
35846,3,5846,[302 427 603 100 127],745,4,25515,4.363776295536172,20.0,40.0
35847,3,5847,[195 180 216 176 271],144,4,25519,4.363714090287278,0.0,0.0
35848,3,5848,[302 427 603 100 127],745,4,25523,4.363651906308771,20.0,40.0
35849,3,5849,[302 427 603 100 127],271,5,25528,4.363760683760684,20.0,40.0
35850,3,5850,[265   1  96  97 294],13,3,25531,4.363527602119296,0.0,0.0
35851,3,5851,[302 427 603 100 127],666,5,25536,4.363636363636363,20.0,40.0
35852,3,5852,[302 427 603 100 127],13,5,25541,4.363745087989066,20.0,40.0
35853,3,5853,[302 427 603 100 127],474,5,25546,4.363853775196447,20.0,40.0
35854,3,5854,[197 322 568 204  56],881,3,25549,4.3636208368915455,0.0,0.0
35855,3,5855,[302 427 603 100 127],271,5,25554,4.363729508196721,20.0,40.0
35856,3,5856,[302 427 603 100 127],458,5,25559,4.363838142393717,20.0,40.0
35857,3,5857,[302 427 603 100 127],271,5,25564,4.363946739501537,20.0,40.0
35858,3,5858,[302 427 603 100 127],90,5,25569,4.364055299539171,20.0,40.0
35859,3,5859,[302 427 603 100 127],537,5,25574,4.364163822525597,20.0,40.0
35860,3,5860,[302 427 603 100 127],458,5,25579,4.364272308479782,20.0,40.0
35861,3,5861,[302 427 603 100 127],334,5,25584,4.364380757420675,20.0,40.0
35862,3,5862,[302 427 603 100 127],537,5,25589,4.364489169367218,20.0,40.0
35863,3,5863,[151 125  96 210 568],59,4,25593,4.364427012278308,0.0,0.0
35864,3,5864,[ 70  64 483  69 403],892,4,25597,4.364364876385337,20.0,0.0
35865,3,5865,[238  50  69 322 276],308,3,25600,4.364132287759973,0.0,20.0
35866,3,5866,[302 427 603 100 127],334,5,25605,4.3642406681438555,20.0,40.0
35867,3,5867,[302 427 603 100 127],14,4,25609,4.364178595773688,20.0,40.0
35868,3,5868,[302 427 603 100 127],339,5,25614,4.364286931334129,20.0,40.0
35869,3,5869,[302 427 603 100 127],537,5,25619,4.364395229982964,20.0,40.0
35870,3,5870,[302 427 603 100 127],334,5,25624,4.364503491739057,20.0,40.0
35871,3,5871,[222 202 568  70 172],892,5,25629,4.364611716621253,0.0,0.0
35872,3,5872,[302 427 603 100 127],745,4,25633,4.36454963391793,20.0,40.0
35873,3,5873,[302 427 603 100 127],537,5,25638,4.364657814096017,20.0,40.0
35874,3,5874,[302 427 603 100 127],474,5,25643,4.364765957446808,20.0,40.0
35875,3,5875,[302 427 603 100 127],666,5,25648,4.364874063989109,20.0,40.0
35876,3,5876,[302 427 603 100 127],271,5,25653,4.364982133741705,20.0,40.0
35877,3,5877,[302 427 603 100 127],666,5,25658,4.365090166723375,20.0,40.0
35878,3,5878,[302 427 603 100 127],537,5,25663,4.3651981629528835,20.0,40.0
35879,3,5879,[302 427 603 100 127],334,5,25668,4.365306122448979,20.0,40.0
35880,3,5880,[302 427 603 100 127],474,5,25673,4.365414045230403,20.0,40.0
35881,3,5881,[ 28 483 289 197 153],454,2,25675,4.365011900714043,20.0,0.0
35882,3,5882,[302 427 603 100 127],271,5,25680,4.36511983681795,20.0,40.0
35883,3,5883,[302 427 603 100 127],13,5,25685,4.365227736233854,20.0,40.0
35884,3,5884,[302 427 603 100 127],14,4,25689,4.3651656754460495,20.0,40.0
35885,3,5885,[302 427 603 100 127],745,4,25693,4.365103635745838,20.0,40.0
35886,3,5886,[234  95 435 183  25],398,5,25698,4.365211482928487,0.0,0.0
35887,3,5887,[302 427 603 100 127],334,5,25703,4.365319293478261,20.0,40.0
35888,3,5888,[302 427 603 100 127],664,5,25708,4.3654270674138225,20.0,40.0
35889,3,5889,[302 427 603 100 127],339,5,25713,4.36553480475382,20.0,40.0
35890,3,5890,[302 427 603 100 127],14,4,25717,4.365472755050076,20.0,40.0
35891,3,5891,[302 427 603 100 127],666,5,25722,4.365580448065173,20.0,40.0
35892,3,5892,[302 427 603 100 127],13,5,25727,4.3656881045308,20.0,40.0
35893,3,5893,[302 427 603 100 127],745,4,25731,4.365626060400407,20.0,40.0
35894,3,5894,[748 471 215  22 117],648,2,25733,4.365224766751484,0.0,0.0
35895,3,5895,[302 427 603 100 127],339,5,25738,4.365332428765265,20.0,40.0
35896,3,5896,[302 427 603 100 127],90,5,25743,4.36544005426488,20.0,40.0
35897,3,5897,[ 12 202 435 174 222],406,3,25746,4.365208545269583,20.0,20.0
35898,3,5898,[302 427 603 100 127],339,5,25751,4.365316155280556,20.0,40.0
35899,3,5899,[302 427 603 100 127],271,5,25756,4.36542372881356,20.0,40.0
35900,3,5900,[302 427 603 100 127],339,5,25761,4.365531265887138,20.0,40.0
35901,3,5901,[196 191   1 435   9],194,4,25765,4.365469332429685,0.0,0.0
35902,3,5902,[302 427 603 100 127],14,4,25769,4.365407419955955,20.0,40.0
35903,3,5903,[302 427 603 100 127],537,5,25774,4.365514905149052,20.0,40.0
35904,3,5904,[302 427 603 100 127],334,5,25779,4.365622353937341,20.0,40.0
35905,3,5905,[144  70 180 655 300],13,3,25782,4.365391127666779,0.0,0.0
35906,3,5906,[302 427 603 100 127],745,4,25786,4.365329270357203,20.0,40.0
35907,3,5907,[302 427 603 100 127],666,5,25791,4.365436696005417,20.0,40.0
35908,3,5908,[118 161 117  15 678],455,2,25793,4.365036385175157,0.0,0.0
35909,3,5909,[302 427 603 100 127],90,5,25798,4.365143824027073,20.0,40.0
35910,3,5910,[333 405 328 273  71],328,3,25801,4.364912874302148,0.0,0.0
35911,3,5911,[302 427 603 100 127],13,5,25806,4.365020297699594,20.0,40.0
35912,3,5912,[302 427 603 100 127],13,5,25811,4.365127684762388,20.0,40.0
35913,3,5913,[302 427 603 100 127],90,5,25816,4.365235035508962,20.0,40.0
35914,3,5914,[302 427 603 100 127],745,4,25820,4.365173288250212,20.0,40.0
35915,3,5915,[483  89 289  70  79],524,5,25825,4.365280594996619,20.0,0.0
35916,3,5916,[302 427 603 100 127],14,4,25829,4.365218860909245,20.0,40.0
35917,3,5917,[302 427 603 100  64],13,5,25834,4.365326123690436,20.0,20.0
35918,3,5918,[302 427 603 100  64],458,5,25839,4.365433350228079,20.0,20.0
35919,3,5919,[197 176 181 288  56],215,4,25843,4.365371621621621,0.0,0.0
35920,3,5920,[302 427 603 100  64],90,5,25848,4.365478804256038,20.0,20.0
35921,3,5921,[302 427 603 100  64],474,5,25853,4.365585950692334,20.0,20.0
35922,3,5922,[302 427 603 100  64],666,5,25858,4.365693060948844,20.0,20.0
35923,3,5923,[302 427 603 100  64],474,5,25863,4.365800135043889,20.0,20.0
35924,3,5924,[302 427 603 100  64],271,5,25868,4.36590717299578,20.0,20.0
35925,3,5925,[302 427 603 100  64],458,5,25873,4.366014174822815,20.0,20.0
35926,3,5926,[302 427 603 100  64],537,4,25877,4.365952421123671,20.0,20.0
35927,3,5927,[302 427 603 100  64],13,5,25882,4.366059379217274,20.0,20.0
35928,3,5928,[302 427 603 100  64],454,5,25887,4.366166301231236,20.0,20.0
35929,3,5929,[268 313 258 273  70],90,3,25890,4.365935919055649,0.0,0.0
35930,3,5930,[302 427 603 100  64],454,5,25895,4.366042825830383,20.0,20.0
35931,3,5931,[302 427 603 100  64],666,5,25900,4.366149696561025,20.0,20.0
35932,3,5932,[302 427 603 100  64],90,5,25905,4.366256531265801,20.0,20.0
35933,3,5933,[302 427 603 100  64],664,5,25910,4.366363329962925,20.0,20.0
35934,3,5934,[204 234 179 182 127],843,2,25912,4.365964616680707,0.0,20.0
35935,3,5935,[302 427 603 100  64],537,4,25916,4.365902964959568,20.0,20.0
35936,3,5936,[302 427 603 100  64],664,5,25921,4.366009769243726,20.0,20.0
35937,3,5937,[302 427 603 100  64],271,5,25926,4.366116537554732,20.0,20.0
35938,3,5938,[302 427 603 100  64],271,5,25931,4.366223269910759,20.0,20.0
35939,3,5939,[302 427 603 100  64],474,5,25936,4.366329966329967,20.0,20.0
35940,3,5940,[302 427 603 100  64],537,4,25940,4.366268304999158,20.0,20.0
35941,3,5941,[302 427 603 100 127],664,5,25945,4.366374957926624,20.0,40.0
35942,3,5942,[302 427 603 100 127],13,5,25950,4.36648157496214,20.0,40.0
35943,3,5943,[603  22 286 121 568],454,4,25954,4.366419919246299,20.0,0.0
35944,3,5944,[302 427 603 100 127],474,5,25959,4.366526492851135,20.0,40.0
35945,3,5945,[302 427 603 100 127],745,4,25963,4.3664648503195425,20.0,40.0
35946,3,5946,[271 427   7 195 269],650,4,25967,4.366403228518581,0.0,0.0
35947,3,5947,[302 427 603 100 127],537,5,25972,4.366509751176866,20.0,40.0
35948,3,5948,[302 427 603 100 127],666,5,25977,4.366616238023197,20.0,40.0
35949,3,5949,[302 427 603 100 127],334,5,25982,4.3667226890756305,20.0,40.0
35950,3,5950,[302 427 603 100 127],13,5,25987,4.36682910435221,20.0,40.0
35951,3,5951,[173 179 234 323   1],13,1,25988,4.366263440860215,0.0,0.0
35952,3,5952,[215  11  97  15 546],271,3,25991,4.366033932471023,0.0,0.0
35953,3,5953,[302 427 603 100 127],14,4,25995,4.365972455492106,20.0,40.0
35954,3,5954,[302 427 603 100 127],271,5,26000,4.3660789252728796,20.0,40.0
35955,3,5955,[185  88  11 111 125],271,3,26003,4.365849563465413,0.0,0.0
35956,3,5956,[302 427 603 100 127],14,4,26007,4.365788148396844,20.0,40.0
35957,3,5957,[196 132 121  98  12],346,3,26010,4.365558912386707,20.0,20.0
35958,3,5958,[302 427 603 100 127],745,4,26014,4.365497566705823,20.0,40.0
35959,3,5959,[302 427 603 100 127],666,5,26019,4.365604026845638,20.0,40.0
35960,3,5960,[302 427 603 100 127],334,5,26024,4.365710451266566,20.0,40.0
35961,3,5961,[302 427 603 100 127],474,5,26029,4.365816839986581,20.0,40.0
35962,3,5962,[302 427 603 100 127],458,5,26034,4.3659231930236455,20.0,40.0
35963,3,5963,[302 427 603 100 127],664,5,26039,4.366029510395707,20.0,40.0
35964,3,5964,[302 427 603 100 127],666,5,26044,4.366135792120704,20.0,40.0
35965,3,5965,[302 427 603 100 127],13,5,26049,4.36624203821656,20.0,40.0
35966,3,5966,[748 121 282  11 588],200,4,26053,4.3661806602983075,0.0,0.0
35967,3,5967,[302 427 603 100 127],13,5,26058,4.366286863270777,20.0,40.0
35968,3,5968,[302 427 603 100 127],745,4,26062,4.366225498408443,20.0,40.0
35969,3,5969,[302 427 603 100 127],474,5,26067,4.3663316582914575,20.0,40.0
35970,3,5970,[302 427 603 100 127],474,5,26072,4.366437782615977,20.0,40.0
35971,3,5971,[302 427 603 100 127],334,5,26077,4.366543871399866,20.0,40.0
35972,3,5972,[302 427 603 100 127],13,5,26082,4.366649924660974,20.0,40.0
35973,3,5973,[302 427 603 100 127],474,5,26087,4.366755942417141,20.0,40.0
35974,3,5974,[127 211 202 168  98],315,4,26091,4.3666945606694565,0.0,40.0
35975,3,5975,[301  15  70 186 121],318,4,26095,4.366633199464525,0.0,0.0
35976,3,5976,[302 427 603 100 127],537,5,26100,4.36673916680609,20.0,40.0
35977,3,5977,[302 427 603 100 127],745,4,26104,4.366677818668451,20.0,40.0
35978,3,5978,[302 427 603 100 127],90,5,26109,4.366783743100853,20.0,40.0
35979,3,5979,[302 427 603 100 127],339,5,26114,4.366889632107023,20.0,40.0
35980,3,5980,[302 427 603 100 127],458,5,26119,4.366995485704732,20.0,40.0
35981,3,5981,[302 427 603 100 127],339,5,26124,4.367101303911735,20.0,40.0
35982,3,5982,[302 427 603 100 127],537,5,26129,4.36720708674578,20.0,40.0
35983,3,5983,[302 427 603 100 127],14,4,26133,4.367145721925134,20.0,40.0
35984,3,5984,[302 427 603 100 127],339,5,26138,4.367251461988304,20.0,40.0
35985,3,5985,[302 427 603 100 127],339,5,26143,4.3673571667223525,20.0,40.0
35986,3,5986,[302 427 603 100 127],13,5,26148,4.3674628361449805,20.0,40.0
35987,3,5987,[302 427 603 100 127],334,5,26153,4.3675684702738815,20.0,40.0
35988,3,5988,[302 427 603 100 127],537,5,26158,4.367674069126732,20.0,40.0
35989,3,5989,[302 427 603 100 127],537,5,26163,4.367779632721202,20.0,40.0
35990,3,5990,[302 427 603 100 127],666,5,26168,4.367885161074946,20.0,40.0
35991,3,5991,[302 427 603 100 127],666,5,26173,4.367990654205608,20.0,40.0
35992,3,5992,[302 427 603 100 127],474,5,26178,4.36809611213082,20.0,40.0
35993,3,5993,[288 196 655 228 132],92,3,26181,4.367867867867868,0.0,0.0
35994,3,5994,[153 143 185 172  69],815,4,26185,4.367806505421185,0.0,0.0
35995,3,5995,[302 427 603 100 127],474,5,26190,4.367911941294196,20.0,40.0
35996,3,5996,[302 427 603 100 127],666,5,26195,4.368017342004335,20.0,40.0
35997,3,5997,[245 100 234 180 748],488,2,26197,4.367622540846949,0.0,20.0
35998,3,5998,[125 748 117 153  15],207,3,26200,4.36739456576096,0.0,0.0
35999,3,5999,[302 427 603 100 127],745,4,26204,4.367333333333334,20.0,40.0
36000,3,6000,[258 234 318  64 176],343,4,26208,4.367272121313114,20.0,0.0
36001,3,6001,[302 427 603 100 127],14,4,26212,4.367210929690104,20.0,40.0
36002,3,6002,[100 215 228 318 323],788,2,26214,4.366816591704148,20.0,20.0
36003,3,6003,[302 427 603 100  64],90,5,26219,4.366922051965356,20.0,20.0
36004,3,6004,[302 427 603 100  64],339,5,26224,4.367027477102415,20.0,20.0
36005,3,6005,[302 427 603 100  64],454,5,26229,4.3671328671328675,20.0,20.0
36006,3,6006,[302 427 603 100  64],454,5,26234,4.3672382220742465,20.0,20.0
36007,3,6007,[302 427 603 100  64],537,4,26238,4.3671770972037285,20.0,20.0
36008,3,6008,[302 427 603 100 127],339,5,26243,4.367282409718755,20.0,40.0
36009,3,6009,[302 427 603 100 127],14,4,26247,4.367221297836938,20.0,40.0
36010,3,6010,[302 427 603 100 127],664,5,26252,4.3673265679587425,20.0,40.0
36011,3,6011,[258 588 333  11 183],387,2,26254,4.366932801064538,0.0,0.0
36012,3,6012,[302 427 603 100 127],339,5,26259,4.367038084151006,20.0,40.0
36013,3,6013,[302 427 603 100 127],90,5,26264,4.367143332224809,20.0,40.0
36014,3,6014,[302 427 603 100 127],271,5,26269,4.367248545303408,20.0,40.0
36015,3,6015,[302 427 603 100 127],339,5,26274,4.367353723404255,20.0,40.0
36016,3,6016,[302 427 603 100 127],458,5,26279,4.36745886654479,20.0,40.0
36017,3,6017,[302 427 603 100 127],14,4,26283,4.367397806580259,20.0,40.0
36018,3,6018,[302 427 603 100 127],537,5,26288,4.367502907459711,20.0,40.0
36019,3,6019,[300   1 174 742 603],454,3,26291,4.367275747508305,20.0,20.0
36020,3,6020,[302 427 603 100 127],745,4,26295,4.367214748380667,20.0,40.0
36021,3,6021,[322  64  25  69 191],83,3,26298,4.36698771172368,0.0,0.0
36022,3,6022,[276 187 135 655 100],334,5,26303,4.367092810891582,0.0,20.0
36023,3,6023,[302 427 603 100 127],13,5,26308,4.367197875166003,20.0,40.0
36024,3,6024,[191  97 100 173 161],524,5,26313,4.3673029045643155,0.0,20.0
36025,3,6025,[302 427 603 100 127],13,5,26318,4.367407899103883,20.0,40.0
36026,3,6026,[302 427 603 100 127],664,5,26323,4.3675128588020575,20.0,40.0
36027,3,6027,[121  82 235 568 216],339,1,26324,4.366954213669542,0.0,0.0
36028,3,6028,[302 427 603 100 127],13,5,26329,4.367059213799966,20.0,40.0
36029,3,6029,[302 427 603 100 127],666,5,26334,4.367164179104478,20.0,40.0
36030,3,6030,[302 427 603 100 127],13,5,26339,4.367269109600398,20.0,40.0
36031,3,6031,[204 175 302 286 173],524,3,26342,4.367042440318302,0.0,0.0
36032,3,6032,[302 427 603 100 127],90,5,26347,4.367147356207525,20.0,40.0
36033,3,6033,[294  82  22 385 282],804,5,26352,4.367252237321843,0.0,0.0
36034,3,6034,[302 427 603 100 127],14,4,26356,4.367191383595692,20.0,40.0
36035,3,6035,[302 427 603 100 127],13,5,26361,4.367296222664016,20.0,40.0
36036,3,6036,[222   9   8  70  88],87,5,26366,4.367401027000166,0.0,0.0
36037,3,6037,[302 427 603 100 127],90,5,26371,4.367505796621398,20.0,40.0
36038,3,6038,[117  95 153 174 143],184,1,26372,4.366948170226859,0.0,20.0
36039,3,6039,[302 427 603 100 127],458,5,26377,4.36705298013245,20.0,40.0
36040,3,6040,[  1 237   8 179 180],194,2,26379,4.366661148816421,0.0,0.0
36041,3,6041,[302 427 603 100 127],458,5,26384,4.3667659715326055,20.0,40.0
36042,3,6042,[496 405  56   8 237],892,5,26389,4.3668707595565115,0.0,0.0
36043,3,6043,[302 427 603 100 127],537,5,26394,4.366975512905361,20.0,40.0
36044,3,6044,[215 196 195  69  98],59,5,26399,4.36708023159636,0.0,20.0
36045,3,6045,[302 427 603 100 127],537,5,26404,4.367184915646709,20.0,40.0
36046,3,6046,[302 427 603 100 127],745,4,26408,4.367124193815115,20.0,40.0
36047,3,6047,[238  64 655  11 483],308,4,26412,4.367063492063492,20.0,0.0
36048,3,6048,[302 427 603 100 127],664,5,26417,4.367168126963135,20.0,40.0
36049,3,6049,[168 235 182 423   4],59,4,26421,4.367107438016529,0.0,0.0
36050,3,6050,[302 427 603 100 127],271,5,26426,4.367212031069244,20.0,40.0
36051,3,6051,[125 265 300  28 121],271,2,26428,4.366820885657634,0.0,0.0
36052,3,6052,[471 195 597  96  50],92,4,26432,4.366760284156617,0.0,20.0
36053,3,6053,[302 427 603 100 127],334,5,26437,4.366864882722167,20.0,40.0
36054,3,6054,[302 427 603 100 127],664,5,26442,4.366969446738233,20.0,40.0
36055,3,6055,[302 427 603 100 127],334,5,26447,4.367073976221929,20.0,40.0
36056,3,6056,[302 427 603 100 127],474,5,26452,4.367178471190358,20.0,40.0
36057,3,6057,[ 11 286 228  79 313],334,5,26457,4.367282931660614,0.0,0.0
36058,3,6058,[302 427 603 100 127],745,4,26461,4.367222313913187,20.0,40.0
36059,3,6059,[302 427 603 100 127],537,5,26466,4.367326732673267,20.0,40.0
36060,3,6060,[496 211 161 210 357],379,4,26470,4.3672661277017,20.0,0.0
36061,3,6061,[302 427 603 100 127],13,5,26475,4.367370504783899,20.0,40.0
36062,3,6062,[302 427 603 100 127],745,4,26479,4.367309912584529,20.0,40.0
36063,3,6063,[302 427 603 100 127],90,5,26484,4.367414248021108,20.0,40.0
36064,3,6064,[302 427 603 100 127],745,4,26488,4.367353668590272,20.0,40.0
36065,3,6065,[302 427 603 100  64],454,5,26493,4.367457962413452,20.0,20.0
36066,3,6066,[302 427 603 100  64],454,5,26498,4.367562221855942,20.0,20.0
36067,3,6067,[302 427 603 100  64],458,5,26503,4.36766644693474,20.0,20.0
36068,3,6068,[ 50 211 210 286 275],537,3,26506,4.367441094084692,0.0,20.0
36069,3,6069,[191 173 286 228 588],13,2,26508,4.367051070840198,0.0,0.0
36070,3,6070,[435 546 200  96 603],897,4,26512,4.3669906111019605,20.0,0.0
36071,3,6071,[302 427 603 100  64],90,5,26517,4.367094861660079,20.0,20.0
36072,3,6072,[302 427 603 100  64],474,5,26522,4.367199077885724,20.0,20.0
36073,3,6073,[302 427 603 100  64],90,5,26527,4.367303259795851,20.0,20.0
36074,3,6074,[302 427 603 100  64],745,5,26532,4.367407407407407,20.0,20.0
36075,3,6075,[ 28  98  88 357 210],298,5,26537,4.367511520737327,20.0,20.0
36076,3,6076,[135  82 215  70 588],378,4,26541,4.367451044923482,0.0,0.0
36077,3,6077,[302 427 603 100  64],458,5,26546,4.367555116814741,20.0,20.0
36078,3,6078,[385 276 100 318 678],474,4,26550,4.367494653725942,20.0,20.0
36079,3,6079,[191 234 127   9 132],90,5,26555,4.3675986842105265,0.0,20.0
36080,3,6080,[302 427 603 100  64],370,5,26560,4.367702680480185,20.0,20.0
36081,3,6081,[302 427 603 100  64],458,5,26565,4.367806642551792,20.0,20.0
36082,3,6082,[302 427 603 100  64],271,5,26570,4.367910570442216,20.0,20.0
36083,3,6083,[302 427 603 100  64],745,5,26575,4.3680144641683105,20.0,20.0
36084,3,6084,[302 427 603 100  64],370,5,26580,4.368118323746919,20.0,20.0
36085,3,6085,[302 427 603 100  64],745,5,26585,4.368222149194874,20.0,20.0
36086,3,6086,[302 427 603 100  64],370,5,26590,4.3683259405289965,20.0,20.0
36087,3,6087,[234 173 222  98  15],210,5,26595,4.368429697766097,0.0,20.0
36088,3,6088,[302 427 603 100  64],666,5,26600,4.368533420922976,20.0,20.0
36089,3,6089,[302 427 603 100  64],474,5,26605,4.3686371100164205,20.0,20.0
36090,3,6090,[302 427 603 100  64],454,5,26610,4.368740765063208,20.0,20.0
36091,3,6091,[302 427 603 100  64],664,5,26615,4.368844386080105,20.0,20.0
36092,3,6092,[282  56   9  71  11],328,3,26618,4.368619727556212,0.0,0.0
36093,3,6093,[302 427 603 100  64],537,4,26622,4.368559238595339,20.0,20.0
36094,3,6094,[302 427 603 100  64],745,5,26627,4.368662838392125,20.0,20.0
36095,3,6095,[302 427 603 100  64],454,5,26632,4.368766404199475,20.0,20.0
36096,3,6096,[153 471 144  15 197],207,3,26635,4.368541905855339,0.0,0.0
36097,3,6097,[302 427 603 100  64],339,5,26640,4.368645457527058,20.0,20.0
36098,3,6098,[302 427 603 100  64],90,5,26645,4.368748975241843,20.0,20.0
36099,3,6099,[302 427 603 100  64],745,5,26650,4.368852459016393,20.0,20.0
36100,3,6100,[302 427 603 100  64],13,5,26655,4.368955908867399,20.0,20.0
36101,3,6101,[286  88 180 475 121],474,5,26660,4.369059324811537,0.0,0.0
36102,3,6102,[302 427 603 100  64],90,5,26665,4.369162706865476,20.0,20.0
36103,3,6103,[302 427 603 100  64],664,5,26670,4.3692660550458715,20.0,20.0
36104,3,6104,[302 427 603 100  64],271,5,26675,4.36936936936937,20.0,20.0
36105,3,6105,[302 427 603 100  64],271,5,26680,4.369472649852604,20.0,20.0
36106,3,6106,[302 427 603 100  64],370,5,26685,4.369575896512199,20.0,20.0
36107,3,6107,[483  98 127 427 186],7,5,26690,4.3696791093647676,20.0,40.0
36108,3,6108,[302 427 603 100  64],745,5,26695,4.3697822884269115,20.0,20.0
36109,3,6109,[257 238 118 135 197],840,3,26698,4.369558101472995,0.0,0.0
36110,3,6110,[302 427 603 100  64],745,5,26703,4.369661266568483,20.0,20.0
36111,3,6111,[302 427 603 100  64],537,4,26707,4.369600785340314,20.0,20.0
36112,3,6112,[302 427 603 100  64],370,5,26712,4.369703909700638,20.0,20.0
36113,3,6113,[302 427 603 100  64],90,5,26717,4.369807000327118,20.0,20.0
36114,3,6114,[302 427 603 100  64],537,4,26721,4.369746524938676,20.0,20.0
36115,3,6115,[302 427 603 100  64],458,5,26726,4.369849574885546,20.0,20.0
36116,3,6116,[161 174 210 151 132],42,5,26731,4.369952591139447,0.0,20.0
36117,3,6117,[302 427 603 100  64],90,5,26736,4.370055573716901,20.0,20.0
36118,3,6118,[302 427 603 100  64],13,5,26741,4.3701585226344175,20.0,20.0
36119,3,6119,[302 427 603 100  64],474,5,26746,4.370261437908496,20.0,20.0
36120,3,6120,[302 427 603 100  64],13,5,26751,4.3703643195556285,20.0,20.0
36121,3,6121,[588 237 546  98  89],64,3,26754,4.370140476968311,0.0,20.0
36122,3,6122,[302 427 603 100  64],664,5,26759,4.370243344765638,20.0,20.0
36123,3,6123,[302 427 603 100  64],271,5,26764,4.370346178967995,20.0,20.0
36124,3,6124,[302 427 603 100  64],474,5,26769,4.370448979591837,20.0,20.0
36125,3,6125,[302 427 603 100  64],339,5,26774,4.370551746653607,20.0,20.0
36126,3,6126,[302 427 603 100  64],664,5,26779,4.3706544801697405,20.0,20.0
36127,3,6127,[302 427 603 100  64],370,5,26784,4.370757180156658,20.0,20.0
36128,3,6128,[302 427 603 100  64],458,5,26789,4.370859846630772,20.0,20.0
36129,3,6129,[742  98 385 597 265],59,3,26792,4.370636215334421,0.0,20.0
36130,3,6130,[135 200 168 194  82],10,5,26797,4.370738868047627,0.0,0.0
36131,3,6131,[  4 197 294 135 318],474,4,26801,4.370678408349641,20.0,0.0
36132,3,6132,[302 427 603 100  64],745,5,26806,4.370781020707647,20.0,20.0
36133,3,6133,[302 427 603 100  64],90,5,26811,4.370883599608738,20.0,20.0
36134,3,6134,[ 71 181  88   7 273],374,1,26812,4.370334148329258,0.0,0.0
36135,3,6135,[185 132 179  56 186],406,4,26816,4.370273794002608,0.0,0.0
36136,3,6136,[302 427 603 100  64],370,5,26821,4.370376405409809,20.0,20.0
36137,3,6137,[302 427 603 100  64],454,5,26826,4.370478983382209,20.0,20.0
36138,3,6138,[161  22   9  11 238],13,2,26828,4.370092848998208,0.0,0.0
36139,3,6139,[ 95 323 215   7 258],378,4,26832,4.370032573289902,0.0,0.0
36140,3,6140,[302 427 603 100  64],370,5,26837,4.370135157140531,20.0,20.0
36141,3,6141,[302 427 603 100  64],13,5,26842,4.370237707587105,20.0,20.0
36142,3,6142,[302 427 603 100  64],458,5,26847,4.370340224645939,20.0,20.0
36143,3,6143,[302 427 603 100  64],537,4,26851,4.370279947916667,20.0,20.0
36144,3,6144,[302 427 603 100  64],745,5,26856,4.370382424735557,20.0,20.0
36145,3,6145,[228 210 195   8  88],533,4,26860,4.370322160754963,0.0,0.0
36146,3,6146,[322 125 194  69 187],313,3,26863,4.3700992353993815,0.0,0.0
36147,3,6147,[302 427 603 100  64],454,5,26868,4.3702016916070265,20.0,20.0
36148,3,6148,[302 427 603 100  64],454,5,26873,4.370304114490161,20.0,20.0
36149,3,6149,[  1 151 588 603   9],815,4,26877,4.370243902439024,20.0,0.0
36150,3,6150,[302 427 603 100  64],666,5,26882,4.370346285156885,20.0,20.0
36151,3,6151,[132 111  28 127  56],234,3,26885,4.370123537061119,0.0,20.0
36152,3,6152,[302 427 603 100  64],339,5,26890,4.370225906062084,20.0,20.0
36153,3,6153,[302 427 603 100  64],664,5,26895,4.370328241793955,20.0,20.0
36154,3,6154,[302 427 603 100  64],474,5,26900,4.370430544272949,20.0,20.0
36155,3,6155,[302 427 603 100  64],271,5,26905,4.370532813515269,20.0,20.0
36156,3,6156,[153  12 168  70 144],892,5,26910,4.370635049537112,20.0,0.0
36157,3,6157,[302 427 603 100  64],458,5,26915,4.370737252354661,20.0,20.0
36158,3,6158,[302 427 603 100  64],458,5,26920,4.370839421984089,20.0,20.0
36159,3,6159,[ 89 435 183 333 185],13,3,26923,4.370616883116883,0.0,0.0
36160,3,6160,[302 427 603 100  64],370,5,26928,4.370719039117026,20.0,20.0
36161,3,6161,[302 427 603 100  64],474,5,26933,4.370821161960403,20.0,20.0
36162,3,6162,[496 185 222 204 235],537,2,26935,4.370436475742333,0.0,0.0
36163,3,6163,[302 427 603 100  64],271,5,26940,4.370538611291369,20.0,20.0
36164,3,6164,[302 427 603 100  64],458,5,26945,4.370640713706407,20.0,20.0
36165,3,6165,[302 427 603 100  64],666,5,26950,4.370742783003568,20.0,20.0
36166,3,6166,[ 88 121 288 483 176],648,5,26955,4.370844819198962,20.0,0.0
36167,3,6167,[237 174 194 182 135],788,2,26957,4.370460440985733,0.0,20.0
36168,3,6168,[181  69 294 357 546],653,3,26960,4.37023828821527,20.0,0.0
36169,3,6169,[302 427 603 100  64],454,5,26965,4.37034035656402,20.0,20.0
36170,3,6170,[302 427 603 100  64],13,5,26970,4.370442391832766,20.0,20.0
36171,3,6171,[286  71 222 172 161],194,2,26972,4.370058327932599,0.0,0.0
36172,3,6172,[168 286 204 202 100],379,5,26977,4.3701603758302285,0.0,20.0
36173,3,6173,[302 427 603 100  64],454,5,26982,4.370262390670554,20.0,20.0
36174,3,6174,[302 427 603 100  64],666,5,26987,4.370364372469636,20.0,20.0
36175,3,6175,[302 427 603 100  64],90,5,26992,4.370466321243524,20.0,20.0
36176,3,6176,[302 427 603 100  64],458,5,26997,4.370568237008256,20.0,20.0
36177,3,6177,[302 427 603 100  64],666,5,27002,4.370670119779864,20.0,20.0
36178,3,6178,[302 427 603 100  64],458,5,27007,4.370771969574365,20.0,20.0
36179,3,6179,[271 176 228 427  97],536,2,27009,4.370388349514563,0.0,0.0
36180,3,6180,[302 427 603 100  64],13,5,27014,4.370490211939815,20.0,20.0
36181,3,6181,[405  56 186 423  79],897,4,27018,4.37043028146231,0.0,0.0
36182,3,6182,[302 427 603 100  64],13,5,27023,4.370532104156558,20.0,20.0
36183,3,6183,[302 427 603 100  64],454,5,27028,4.370633893919793,20.0,20.0
36184,3,6184,[302 427 603 100  64],13,5,27033,4.370735650767987,20.0,20.0
36185,3,6185,[302 427 603 100  64],474,5,27038,4.370837374717103,20.0,20.0
36186,3,6186,[302 427 603 100  64],454,5,27043,4.3709390657830935,20.0,20.0
36187,3,6187,[302 427 603 100  64],474,5,27048,4.3710407239819,20.0,20.0
36188,3,6188,[121 302 357 191 202],454,3,27051,4.3708191953465825,20.0,0.0
36189,3,6189,[302 427 603 100  64],458,5,27056,4.3709208400646204,20.0,20.0
36190,3,6190,[302 427 603 100  64],745,5,27061,4.371022451946374,20.0,20.0
36191,3,6191,[302 427 603 100  64],339,5,27066,4.371124031007752,20.0,20.0
36192,3,6192,[302 427 603 100  64],666,5,27071,4.371225577264654,20.0,20.0
36193,3,6193,[183 289 195 194 204],378,4,27075,4.371165644171779,0.0,0.0
36194,3,6194,[176 427  28 546 588],234,2,27077,4.370782889426957,0.0,0.0
36195,3,6195,[508 172 471 275 483],537,3,27080,4.3705616526791475,20.0,0.0
36196,3,6196,[176 117 597 175  56],774,1,27081,4.370017750524448,0.0,0.0
36197,3,6197,[302 427 603 100  64],454,5,27086,4.370119393352694,20.0,20.0
36198,3,6198,[302 427 603 100  64],537,4,27090,4.3700596870462975,20.0,20.0
36199,3,6199,[302 427 603 100  64],370,5,27095,4.370161290322581,20.0,20.0
36200,3,6200,[234 180 175 168 235],833,4,27099,4.370101596516691,0.0,0.0
36201,3,6201,[302 427 603 100  64],666,5,27104,4.37020316027088,20.0,20.0
36202,3,6202,[405 234 222  70 215],13,2,27106,4.3698210543285505,0.0,0.0
36203,3,6203,[302 427 603 100  64],745,5,27111,4.369922630560929,20.0,20.0
36204,3,6204,[143 483  70  96 191],892,4,27115,4.36986301369863,20.0,0.0
36205,3,6205,[ 22  88 194 100  56],537,2,27117,4.3694811472768285,0.0,20.0
36206,3,6206,[302 427 603 100  64],458,5,27122,4.369582729176736,20.0,20.0
36207,3,6207,[302 427 603 100  64],339,5,27127,4.369684278350515,20.0,20.0
36208,3,6208,[302 427 603 100  64],90,5,27132,4.369785794813979,20.0,20.0
36209,3,6209,[302 427 603 100  64],13,5,27137,4.36988727858293,20.0,20.0
36210,3,6210,[121 237 174 186 117],313,3,27140,4.36966672033489,0.0,20.0
36211,3,6211,[302 427 603 100  64],664,5,27145,4.369768190598841,20.0,20.0
36212,3,6212,[  7 132 118 175 546],447,3,27148,4.369547722517303,0.0,0.0
36213,3,6213,[302 427 603 100  64],666,5,27153,4.36964917927261,20.0,20.0
36214,3,6214,[302 427 603 100  64],745,5,27158,4.369750603378922,20.0,20.0
36215,3,6215,[302 427 603 100  64],664,5,27163,4.369851994851995,20.0,20.0
36216,3,6216,[302 427 603 100  64],13,5,27168,4.369953353707576,20.0,20.0
36217,3,6217,[302 427 603 100  64],666,5,27173,4.370054679961402,20.0,20.0
36218,3,6218,[302 427 603 100  64],664,5,27178,4.370155973629201,20.0,20.0
36219,3,6219,[302 427 603 100  64],474,5,27183,4.370257234726688,20.0,20.0
36220,3,6220,[ 50   7 471 197 423],6,2,27185,4.369876225687189,0.0,20.0
36221,3,6221,[302 427 603 100  64],454,5,27190,4.3699774991964,20.0,20.0
36222,3,6222,[ 12 204 423 216  71],328,3,27193,4.369757351759602,20.0,0.0
36223,3,6223,[302 427 603 100  64],745,5,27198,4.369858611825193,20.0,20.0
36224,3,6224,[302 427 603 100  64],745,5,27203,4.3699598393574295,20.0,20.0
36225,3,6225,[302 427 603 100  64],339,5,27208,4.370061034371989,20.0,20.0
36226,3,6226,[302 427 603 100  64],458,5,27213,4.370162196884535,20.0,20.0
36227,3,6227,[302 427 603 100  64],537,4,27217,4.370102761721259,20.0,20.0
36228,3,6228,[222  89 313  88 153],815,5,27222,4.3702038850537805,0.0,0.0
36229,3,6229,[568 405 322 288 597],92,0,27222,4.369502407704655,0.0,0.0
36230,3,6230,[302 427 603 100  64],339,5,27227,4.3696035949285825,20.0,20.0
36231,3,6231,[302 427 603 100  64],13,5,27232,4.369704749679076,20.0,20.0
36232,3,6232,[111 132 100 748   1],533,4,27236,4.369645435584791,0.0,20.0
36233,3,6233,[258 237 153 655  69],144,5,27241,4.369746551170998,0.0,0.0
36234,3,6234,[ 69   4 222  88   9],13,3,27244,4.369526864474739,0.0,0.0
36235,3,6235,[ 88  64 288 191 323],537,1,27245,4.368986529826812,0.0,0.0
36236,3,6236,[197 318 496 286 132],271,5,27250,4.3690877024210355,20.0,0.0
36237,3,6237,[302 427 603 100  64],90,5,27255,4.369188842577749,20.0,20.0
36238,3,6238,[302 427 603 100  64],454,5,27260,4.36928995031255,20.0,20.0
36239,3,6239,[302 427 603 100  64],271,5,27265,4.3693910256410255,20.0,20.0
36240,3,6240,[302 427 603 100  64],745,5,27270,4.3694920685787535,20.0,20.0
36241,3,6241,[302 427 603 100  64],666,5,27275,4.369593079141301,20.0,20.0
36242,3,6242,[302 427 603 100  64],90,5,27280,4.369694057344225,20.0,20.0
36243,3,6243,[302 427 603 100  64],537,4,27284,4.369634849455477,20.0,20.0
36244,3,6244,[515 546 185 127 435],207,4,27288,4.369575660528422,0.0,20.0
36245,3,6245,[318 172 204 196 174],87,5,27293,4.369676593019532,20.0,20.0
36246,3,6246,[118 742 222 603 286],145,3,27296,4.369457339522971,20.0,0.0
36247,3,6247,[302 427 603 100  64],271,5,27301,4.3695582586427655,20.0,20.0
36248,3,6248,[302 427 603 100  64],664,5,27306,4.369659145463274,20.0,20.0
36249,3,6249,[302 427 603 100  64],474,5,27311,4.36976,20.0,20.0
36250,3,6250,[161  95  70 237  82],374,5,27316,4.369860822268437,0.0,0.0
36251,3,6251,[597 269 286 423 234],378,4,27320,4.36980166346769,0.0,0.0
36252,3,6252,[302 427 603 100  64],664,5,27325,4.369902446825524,20.0,20.0
36253,3,6253,[302 427 603 100  64],90,5,27330,4.37000319795331,20.0,20.0
36254,3,6254,[302 427 603 100  64],339,5,27335,4.370103916866507,20.0,20.0
36255,3,6255,[302 427 603 100  64],271,5,27340,4.370204603580563,20.0,20.0
36256,3,6256,[302 427 603 100  64],454,5,27345,4.370305258110916,20.0,20.0
36257,3,6257,[302 427 603 100  64],664,5,27350,4.370405880472995,20.0,20.0
36258,3,6258,[742 161  22  56 202],749,3,27353,4.37018693081962,0.0,0.0
36259,3,6259,[302 427 603 100  64],339,5,27358,4.370287539936102,20.0,20.0
36260,3,6260,[302 427 603 100  64],90,5,27363,4.370388116914231,20.0,20.0
36261,3,6261,[ 70 405  28 237 187],533,3,27366,4.370169274992016,0.0,0.0
36262,3,6262,[302 427 603 100  64],537,4,27370,4.370110170844643,20.0,20.0
36263,3,6263,[302 427 603 100  64],271,5,27375,4.370210727969349,20.0,20.0
36264,3,6264,[ 71 483 265  25 294],95,1,27376,4.3696727853152435,20.0,0.0
36265,3,6265,[302 427 603 100  64],370,5,27381,4.369773380146824,20.0,20.0
36266,3,6266,[302 427 603 100  64],271,5,27386,4.369873942875379,20.0,20.0
36267,3,6267,[302 427 603 100  64],664,5,27391,4.369974473516273,20.0,20.0
36268,3,6268,[194 195   4  69 435],648,3,27394,4.369755941936513,0.0,0.0
36269,3,6269,[302 427 603 100  64],271,5,27399,4.369856459330143,20.0,20.0
36270,3,6270,[302 427 603 100  64],474,5,27404,4.3699569446659225,20.0,20.0
36271,3,6271,[302 427 603 100  64],271,5,27409,4.370057397959184,20.0,20.0
36272,3,6272,[435 187 179 172 655],387,3,27412,4.369838992507572,0.0,0.0
36273,3,6273,[302 427 603 100  64],664,5,27417,4.369939432578897,20.0,20.0
36274,3,6274,[ 28 173 186  69  56],59,5,27422,4.3700398406374505,0.0,0.0
36275,3,6275,[302 427 603 100  64],537,4,27426,4.369980879541109,20.0,20.0
36276,3,6276,[302 427 603 100  64],271,5,27431,4.3700812490043015,20.0,20.0
36277,3,6277,[302 427 603 100  64],666,5,27436,4.370181586492514,20.0,20.0
36278,3,6278,[302 427 603 100  64],271,5,27441,4.370281892021023,20.0,20.0
36279,3,6279,[302 427 603 100  64],474,5,27446,4.370382165605095,20.0,20.0
36280,3,6280,[302 427 603 100  64],664,5,27451,4.37048240725999,20.0,20.0
36281,3,6281,[ 97  96 282 197 118],378,4,27455,4.370423432028017,0.0,0.0
36282,3,6282,[302 427 603 100  64],458,5,27460,4.370523635206112,20.0,20.0
36283,3,6283,[302 427 603 100  64],90,5,27465,4.37062380649268,20.0,20.0
36284,3,6284,[302 427 603 100  64],666,5,27470,4.370723945902943,20.0,20.0
36285,3,6285,[302 427 603 100  64],664,5,27475,4.370824053452115,20.0,20.0
36286,3,6286,[302 427 603 100  64],537,4,27479,4.370765070780976,20.0,20.0
36287,3,6287,[302 427 603 100  64],454,5,27484,4.370865139949109,20.0,20.0
36288,3,6288,[302 427 603 100  64],271,5,27489,4.370965177293687,20.0,20.0
36289,3,6289,[204 200 182 211 127],308,5,27494,4.371065182829889,0.0,20.0
36290,3,6290,[302 427 603 100  64],537,4,27498,4.371006199332379,20.0,20.0
36291,3,6291,[302 427 603 100  64],454,5,27503,4.371106166560712,20.0,20.0
36292,3,6292,[302 427 603 100  64],90,5,27508,4.371206102018116,20.0,20.0
36293,3,6293,[302 427 603 100  64],664,5,27513,4.371306005719733,20.0,20.0
36294,3,6294,[302 427 603 100  64],537,4,27517,4.371247021445591,20.0,20.0
36295,3,6295,[302 427 603 100  64],474,5,27522,4.371346886912325,20.0,20.0
36296,3,6296,[302 427 603 100  64],537,4,27526,4.371287914880102,20.0,20.0
36297,3,6297,[302 427 603 100  64],745,5,27531,4.371387742140362,20.0,20.0
36298,3,6298,[302 427 603 100  64],454,5,27536,4.371487537704398,20.0,20.0
36299,3,6299,[333 568 197 173 603],387,2,27538,4.371111111111111,20.0,0.0
36300,3,6300,[302 427 603 100  64],745,5,27543,4.371210918901761,20.0,20.0
36301,3,6301,[302 427 603 100  64],454,5,27548,4.3713106950174545,20.0,20.0
36302,3,6302,[286 258 496 197 185],90,4,27552,4.37125178486435,0.0,0.0
36303,3,6303,[302 427 603 100  64],339,5,27557,4.371351522842639,20.0,20.0
36304,3,6304,[302 427 603 100  64],474,5,27562,4.3714512291831875,20.0,20.0
36305,3,6305,[197 318 427 234 117],474,5,27567,4.3715509039010465,20.0,0.0
36306,3,6306,[302 427 603 100  64],13,5,27572,4.371650547011257,20.0,20.0
36307,3,6307,[302 427 603 100  64],370,5,27577,4.371750158528852,20.0,20.0
36308,3,6308,[302 427 603 100  64],454,5,27582,4.371849738468854,20.0,20.0
36309,3,6309,[302 427 603 100  64],13,5,27587,4.3719492868462755,20.0,20.0
36310,3,6310,[302 427 603 100  64],454,5,27592,4.372048803676121,20.0,20.0
36311,3,6311,[302 427 603 100  64],666,5,27597,4.372148288973384,20.0,20.0
36312,3,6312,[302 427 603 100  64],664,5,27602,4.372247742753049,20.0,20.0
36313,3,6313,[302 427 603 100  64],454,5,27607,4.372347165030092,20.0,20.0
36314,3,6314,[194 313 603  12 135],883,3,27610,4.372129849564529,40.0,0.0
36315,3,6315,[435 151 222 118 271],749,3,27613,4.371912602913236,0.0,0.0
36316,3,6316,[483   7 191 403 265],524,4,27617,4.37185372803546,20.0,0.0
36317,3,6317,[ 69 183 496  11   4],59,5,27622,4.371953149730928,0.0,0.0
36318,3,6318,[302 427 603 100  64],90,5,27627,4.372052539958855,20.0,20.0
36319,3,6319,[302 427 603 100  64],537,4,27631,4.371993670886076,20.0,20.0
36320,3,6320,[302 427 603 100  64],664,5,27636,4.372093023255814,20.0,20.0
36321,3,6321,[302 427 603 100  64],537,4,27640,4.372034166403037,20.0,20.0
36322,3,6322,[302 427 603 100  64],745,5,27645,4.3721334809425905,20.0,20.0
36323,3,6323,[302 427 603 100  64],13,5,27650,4.372232764073371,20.0,20.0
36324,3,6324,[302 427 603 100  64],474,5,27655,4.372332015810277,20.0,20.0
36325,3,6325,[302 427 603 100  64],454,5,27660,4.372431236168195,20.0,20.0
36326,3,6326,[302 427 603 100  64],454,5,27665,4.3725304251620045,20.0,20.0
36327,3,6327,[302 427 603 100  64],458,5,27670,4.3726295828065735,20.0,20.0
36328,3,6328,[ 22  71 204 257 183],290,5,27675,4.372728709116764,0.0,0.0
36329,3,6329,[302 427 603 100  64],13,5,27680,4.372827804107425,20.0,20.0
36330,3,6330,[ 89 403 153 265  56],60,3,27683,4.3726109619333435,0.0,0.0
36331,3,6331,[302 427 603 100  64],458,5,27688,4.3727100442198354,20.0,20.0
36332,3,6332,[302 427 603 100  64],474,5,27693,4.372809095215538,20.0,20.0
36333,3,6333,[275 515 258 234  12],537,3,27696,4.372592358699085,20.0,0.0
36334,3,6334,[302 427 603 100  64],537,4,27700,4.372533543804262,20.0,20.0
36335,3,6335,[302 427 603 100  64],664,5,27705,4.372632575757576,20.0,20.0
36336,3,6336,[483  71 405 471 228],95,3,27708,4.372415969701752,20.0,0.0
36337,3,6337,[302 427 603 100  64],666,5,27713,4.372514988955507,20.0,20.0
36338,3,6338,[302 427 603 100  64],537,4,27717,4.372456223379082,20.0,20.0
36339,3,6339,[302 427 603 100  64],664,5,27722,4.372555205047319,20.0,20.0
36340,3,6340,[175 195 181 286 197],648,2,27724,4.372181043999369,0.0,0.0
36341,3,6341,[286 111 403 173 471],378,3,27727,4.3719646799117,0.0,0.0
36342,3,6342,[597 435 117 204 294],308,2,27729,4.371590729938515,0.0,0.0
36343,3,6343,[302 427 603 100  64],666,5,27734,4.371689785624212,20.0,20.0
36344,3,6344,[210   8 427 143 161],452,4,27738,4.371631205673759,0.0,0.0
36345,3,6345,[302 427 603 100  64],537,4,27742,4.3715726441853135,20.0,20.0
36346,3,6346,[302 427 603 100  64],745,5,27747,4.371671655900426,20.0,20.0
36347,3,6347,[302 427 603 100  64],666,5,27752,4.37177063642092,20.0,20.0
36348,3,6348,[302 427 603 100  64],666,5,27757,4.371869585761537,20.0,20.0
36349,3,6349,[302 427 603 100  64],13,5,27762,4.3719685039370075,20.0,20.0
36350,3,6350,[174   1 187 180 173],664,5,27767,4.372067390962053,0.0,20.0
36351,3,6351,[302 427 603 100  64],370,5,27772,4.3721662468513856,20.0,20.0
36352,3,6352,[302 427 603 100  64],339,5,27777,4.372265071619707,20.0,20.0
36353,3,6353,[302 427 603 100  64],458,5,27782,4.372363865281712,20.0,20.0
36354,3,6354,[302 427 603 100  64],454,5,27787,4.372462627852085,20.0,20.0
36355,3,6355,[302 427 603 100  64],90,5,27792,4.3725613593455,20.0,20.0
36356,3,6356,[302 427 603 100  64],370,5,27797,4.372660059776624,20.0,20.0
36357,3,6357,[302 427 603 100  64],90,5,27802,4.372758729160113,20.0,20.0
36358,3,6358,[302 427 603 100  64],666,5,27807,4.372857367510615,20.0,20.0
36359,3,6359,[302 427 603 100  64],454,5,27812,4.3729559748427675,20.0,20.0
36360,3,6360,[302 427 603 100  64],454,5,27817,4.373054551171199,20.0,20.0
36361,3,6361,[302 427 603 100  64],745,5,27822,4.373153096510531,20.0,20.0
36362,3,6362,[302 427 603 100  64],90,5,27827,4.373251610875373,20.0,20.0
36363,3,6363,[302 427 603 100  64],666,5,27832,4.373350094280327,20.0,20.0
36364,3,6364,[302 427 603 100  64],664,5,27837,4.373448546739985,20.0,20.0
36365,3,6365,[302 427 603 100  64],458,5,27842,4.373546968268928,20.0,20.0
36366,3,6366,[302 427 603 100  64],90,5,27847,4.373645358881734,20.0,20.0
36367,3,6367,[196 655  95 143   8],308,4,27851,4.373586683417085,0.0,0.0
36368,3,6368,[302 427 603 100  64],666,5,27856,4.373685036897472,20.0,20.0
36369,3,6369,[302 427 603 100  64],370,5,27861,4.373783359497645,20.0,20.0
36370,3,6370,[302 427 603 100  64],664,5,27866,4.3738816512321455,20.0,20.0
36371,3,6371,[302 427 603 100  64],474,5,27871,4.373979912115505,20.0,20.0
36372,3,6372,[302 427 603 100  64],454,5,27876,4.374078142162247,20.0,20.0
36373,3,6373,[302 427 603 100  64],339,5,27881,4.374176341386884,20.0,20.0
36374,3,6374,[546 204 471 294 276],119,3,27884,4.373960784313725,0.0,0.0
36375,3,6375,[118 197 235 238 271],650,3,27887,4.373745294855709,0.0,0.0
36376,3,6376,[117  89  22 300 742],653,4,27891,4.373686686529716,0.0,0.0
36377,3,6377,[302 427 603 100  64],666,5,27896,4.373784885544057,20.0,20.0
36378,3,6378,[ 50  69  88 174 132],650,3,27899,4.373569525003919,0.0,40.0
36379,3,6379,[405  64 588 200 286],378,3,27902,4.373354231974922,0.0,0.0
36380,3,6380,[  8 271 179  96 546],64,3,27905,4.373139006425325,0.0,0.0
36381,3,6381,[435 196 118  25   7],295,4,27909,4.373080539015983,0.0,0.0
36382,3,6382,[302 427 603 100  64],13,5,27914,4.373178756070813,20.0,20.0
36383,3,6383,[144 423 515 168 597],92,3,27917,4.37296365914787,0.0,0.0
36384,3,6384,[302 427 603 100  64],745,5,27922,4.373061863743148,20.0,20.0
36385,3,6385,[302 427 603 100  64],90,5,27927,4.3731600375822115,20.0,20.0
36386,3,6386,[302 427 603 100  64],666,5,27932,4.373258180679505,20.0,20.0
36387,3,6387,[302 427 603 100  64],90,5,27937,4.373356293049468,20.0,20.0
36388,3,6388,[ 95 143  96  11 471],537,0,27937,4.372671779621224,0.0,0.0
36389,3,6389,[143 135 276  88 597],452,1,27938,4.372143974960877,0.0,0.0
36390,3,6390,[302 427 603 100  64],339,5,27943,4.372242215615709,20.0,20.0
36391,3,6391,[  4 357 172  64   1],398,4,27947,4.372183979974968,20.0,0.0
36392,3,6392,[302 427 603 100  64],537,4,27951,4.372125762552792,20.0,20.0
36393,3,6393,[168 172  89  50 185],374,1,27952,4.371598373475133,0.0,20.0
36394,3,6394,[302 427 603 100  64],370,5,27957,4.371696637998436,20.0,20.0
36395,3,6395,[172   4 515  25 216],92,3,27960,4.371482176360225,0.0,0.0
36396,3,6396,[182  79  64 135 357],454,2,27962,4.37111145849617,20.0,0.0
36397,3,6397,[302 427 603 100  64],271,5,27967,4.371209753047827,20.0,20.0
36398,3,6398,[302 427 603 100  64],90,5,27972,4.371308016877637,20.0,20.0
36399,3,6399,[302 427 603 100  64],370,5,27977,4.37140625,20.0,20.0
36400,3,6400,[302 427 603 100  64],537,4,27981,4.371348226839556,20.0,20.0
36401,3,6401,[302 427 603 100  64],271,5,27986,4.371446422992815,20.0,20.0
36402,3,6402,[302 427 603 100  64],339,5,27991,4.371544588474153,20.0,20.0
36403,3,6403,[302 427 603 100  64],664,5,27996,4.3716427232979385,20.0,20.0
36404,3,6404,[302 427 603 100  64],664,5,28001,4.371740827478533,20.0,20.0
36405,3,6405,[323  25 125 603  22],804,5,28006,4.3718389010302845,20.0,0.0
36406,3,6406,[202 175 153 143 173],749,4,28010,4.371780864679257,0.0,0.0
36407,3,6407,[302 427 603 100  64],90,5,28015,4.371878901373283,20.0,20.0
36408,3,6408,[175  82  96 302 357],207,2,28017,4.371508815727883,20.0,0.0
36409,3,6409,[302 427 603 100  64],474,5,28022,4.371606864274571,20.0,20.0
36410,3,6410,[427 471 174  64 117],90,4,28026,4.371548900327562,0.0,20.0
36411,3,6411,[302 427 603 100  64],271,5,28031,4.3716469120399255,20.0,20.0
36412,3,6412,[302 427 603 100  64],666,5,28036,4.371744893185716,20.0,20.0
36413,3,6413,[568 121 127 385 302],343,2,28038,4.371375116931712,0.0,20.0
36414,3,6414,[302 427 603 100  64],458,5,28043,4.371473109898675,20.0,20.0
36415,3,6415,[302 427 603 100  64],13,5,28048,4.371571072319202,20.0,20.0
36416,3,6416,[238 508 153 385 191],559,2,28050,4.37120149602618,0.0,0.0
36417,3,6417,[302 427 603 100  64],271,5,28055,4.371299470239951,20.0,20.0
36418,3,6418,[302 427 603 100  64],454,5,28060,4.371397413927403,20.0,20.0
36419,3,6419,[172 161 655 403 568],506,5,28065,4.371495327102804,0.0,0.0
36420,3,6420,[302 427 603 100  64],370,5,28070,4.371593209780408,20.0,20.0
36421,3,6421,[302 427 603 100  64],666,5,28075,4.371691061974463,20.0,20.0
36422,3,6422,[302 427 603 100  64],454,5,28080,4.371788883699206,20.0,20.0
36423,3,6423,[333  22 183 168 135],653,3,28083,4.3715753424657535,0.0,0.0
36424,3,6424,[302 427 603 100  64],745,5,28088,4.371673151750973,20.0,20.0
36425,3,6425,[302 427 603 100  64],339,5,28093,4.37177093059446,20.0,20.0
36426,3,6426,[302 427 603 100  64],370,5,28098,4.371868679010425,20.0,20.0
36427,3,6427,[ 69 144  50 300 568],455,4,28102,4.3718108276291225,0.0,20.0
36428,3,6428,[161  98 238 144 118],738,4,28106,4.3717529942448285,0.0,20.0
36429,3,6429,[302 427 603 100  64],458,5,28111,4.371850699844479,20.0,20.0
36430,3,6430,[269 678 153 271 202],263,2,28113,4.371481884621366,0.0,0.0
36431,3,6431,[176 172  97 403 258],774,1,28114,4.370957711442786,0.0,0.0
36432,3,6432,[161 323 568 257 180],650,0,28114,4.37027825275921,0.0,0.0
36433,3,6433,[302 427 603 100  64],13,5,28119,4.370376126826236,20.0,20.0
36434,3,6434,[302 427 603 100  64],664,5,28124,4.37047397047397,20.0,20.0
36435,3,6435,[302 427 603 100  64],745,5,28129,4.370571783716594,20.0,20.0
36436,3,6436,[  8 496 385 748  70],488,3,28132,4.370358862824297,0.0,0.0
36437,3,6437,[385 211 294 357 186],379,3,28135,4.370146008077042,20.0,0.0
36438,3,6438,[302 427 603 100  64],90,5,28140,4.370243826681162,20.0,20.0
36439,3,6439,[302 427 603 100  64],537,4,28144,4.3701863354037265,20.0,20.0
36440,3,6440,[ 70 483 257 357 197],533,4,28148,4.370128861977954,40.0,0.0
36441,3,6441,[302 427 603 100  64],370,5,28153,4.370226637690158,20.0,20.0
36442,3,6442,[302 427 603 100  64],90,5,28158,4.370324383051374,20.0,20.0
36443,3,6443,[302 427 603 100  64],745,5,28163,4.370422098075729,20.0,20.0
36444,3,6444,[302 427 603 100  64],454,5,28168,4.370519782777347,20.0,20.0
36445,3,6445,[302 427 603 100  64],664,5,28173,4.370617437170338,20.0,20.0
36446,3,6446,[302 427 603 100  64],370,5,28178,4.3707150612688075,20.0,20.0
36447,3,6447,[546 183 265   1   8],92,4,28182,4.370657568238213,0.0,0.0
36448,3,6448,[186  25  69 168 288],650,2,28184,4.370289967436812,0.0,0.0
36449,3,6449,[300 117 185 153 191],653,3,28187,4.370077519379845,0.0,0.0
36450,3,6450,[302 427 603 100  64],454,5,28192,4.370175166640831,20.0,20.0
36451,3,6451,[302 427 603 100  64],339,5,28197,4.370272783632982,20.0,20.0
36452,3,6452,[302 427 603 100  64],339,5,28202,4.37037037037037,20.0,20.0
36453,3,6453,[302 427 603 100  64],370,5,28207,4.370467926867059,20.0,20.0
36454,3,6454,[603 286 288  22 301],739,3,28210,4.370255615801704,20.0,0.0
36455,3,6455,[302 427 603 100  64],745,5,28215,4.370353159851301,20.0,20.0
36456,3,6456,[302 427 603 100  64],454,5,28220,4.370450673687471,20.0,20.0
36457,3,6457,[302 427 603 100  64],664,5,28225,4.370548157324249,20.0,20.0
36458,3,6458,[302 427 603 100  64],664,5,28230,4.370645610775662,20.0,20.0
36459,3,6459,[302 427 603 100  64],666,5,28235,4.370743034055727,20.0,20.0
36460,3,6460,[302 427 603 100  64],90,5,28240,4.370840427178456,20.0,20.0
36461,3,6461,[197 127  22 322 228],881,3,28243,4.3706282884555865,0.0,20.0
36462,3,6462,[197 210 265 546 289],95,2,28245,4.3702614884728455,0.0,0.0
36463,3,6463,[302 427 603 100  64],90,5,28250,4.370358910891089,20.0,20.0
36464,3,6464,[302 427 603 100  64],454,5,28255,4.37045630317092,20.0,20.0
36465,3,6465,[211 265 204 333 121],346,5,28260,4.370553665326322,0.0,0.0
36466,3,6466,[302 427 603 100  64],271,5,28265,4.3706509973712695,20.0,20.0
36467,3,6467,[302 427 603 100  64],370,5,28270,4.370748299319728,20.0,20.0
36468,3,6468,[302 427 603 100  64],666,5,28275,4.370845571185654,20.0,20.0
36469,3,6469,[302 427 603 100  64],664,5,28280,4.370942812982999,20.0,20.0
36470,3,6470,[603 748 385 100 333],533,4,28284,4.370885489105238,20.0,20.0
36471,3,6471,[302 427 603 100  64],271,5,28289,4.370982694684796,20.0,20.0
36472,3,6472,[302 427 603 100  64],745,5,28294,4.3710798702301865,20.0,20.0
36473,3,6473,[ 79  69 196 238 216],667,2,28296,4.370713623725672,0.0,0.0
36474,3,6474,[302 427 603 100  64],339,5,28301,4.370810810810811,20.0,20.0
36475,3,6475,[302 427 603 100  64],537,4,28305,4.370753551575047,20.0,20.0
36476,3,6476,[302 427 603 100  64],271,5,28310,4.370850702485718,20.0,20.0
36477,3,6477,[302 427 603 100  64],454,5,28315,4.370947823402284,20.0,20.0
36478,3,6478,[302 427 603 100  64],370,5,28320,4.371044914338633,20.0,20.0
36479,3,6479,[302 427 603 100  64],666,5,28325,4.371141975308642,20.0,20.0
36480,3,6480,[302 427 603 100  64],666,5,28330,4.371239006326184,20.0,20.0
36481,3,6481,[302 427 603 100  64],537,4,28334,4.371181734032706,20.0,20.0
36482,3,6482,[302 427 603 100  64],271,5,28339,4.371278728983495,20.0,20.0
36483,3,6483,[151 222  95   1  79],843,0,28339,4.370604565083282,0.0,0.0
36484,3,6484,[143 197 323 211   4],474,4,28343,4.3705474171164225,0.0,0.0
36485,3,6485,[302 427 603 100  64],474,5,28348,4.370644465001542,20.0,20.0
36486,3,6486,[302 427 603 100  64],745,5,28353,4.370741482965932,20.0,20.0
36487,3,6487,[302 427 603 100  64],745,5,28358,4.370838471023428,20.0,20.0
36488,3,6488,[302 427 603 100  64],271,5,28363,4.370935429187856,20.0,20.0
36489,3,6489,[151 496 238 180  98],650,3,28366,4.370724191063174,0.0,20.0
36490,3,6490,[302 427 603 100  64],370,5,28371,4.370821136958866,20.0,20.0
36491,3,6491,[302 427 603 100  64],537,4,28375,4.370764017252003,20.0,20.0
36492,3,6492,[ 15 174 186 211 210],194,4,28379,4.3707069151393805,0.0,20.0
36493,3,6493,[302 427 603 100  64],458,5,28384,4.370803818909763,20.0,20.0
36494,3,6494,[196 121  64 313  82],454,4,28388,4.370746728252502,0.0,0.0
36495,3,6495,[302 427 603 100  64],90,5,28393,4.370843596059113,20.0,20.0
36496,3,6496,[302 427 603 100  64],370,5,28398,4.370940434046483,20.0,20.0
36497,3,6497,[515 211 423 385 127],387,3,28401,4.37072945521699,0.0,20.0
36498,3,6498,[302 427 603 100  64],13,5,28406,4.370826280966303,20.0,20.0
36499,3,6499,[ 95  69 143 258  71],92,3,28409,4.370615384615385,0.0,0.0
36500,3,6500,[302 427 603 100  64],339,5,28414,4.370712198123366,20.0,20.0
36501,3,6501,[302 427 603 100  64],370,5,28419,4.370808981851738,20.0,20.0
36502,3,6502,[302 427 603 100  64],745,5,28424,4.370905735814239,20.0,20.0
36503,3,6503,[202 172 288 100 179],7,4,28428,4.370848708487085,0.0,20.0
36504,3,6504,[302 427 603 100  64],370,5,28433,4.370945426594927,20.0,20.0
36505,3,6505,[111 318 234 181 289],524,4,28437,4.370888410697817,20.0,0.0
36506,3,6506,[302 427 603 100  64],664,5,28442,4.370985092976794,20.0,20.0
36507,3,6507,[176 322 111 483  98],575,2,28444,4.370620774431469,20.0,20.0
36508,3,6508,[302 427 603 100  64],454,5,28449,4.370717468121063,20.0,20.0
36509,3,6509,[183 289 276 403  98],92,4,28453,4.370660522273425,0.0,20.0
36510,3,6510,[302 427 603 100  64],474,5,28458,4.370757180156658,20.0,20.0
36511,3,6511,[302 427 603 100  64],90,5,28463,4.370853808353808,20.0,20.0
36512,3,6512,[302 427 603 100  64],90,5,28468,4.370950406878551,20.0,20.0
36513,3,6513,[153 515  79 183   4],7,4,28472,4.370893460239484,0.0,0.0
36514,3,6514,[302 427 603 100  64],454,5,28477,4.370990023023792,20.0,20.0
36515,3,6515,[302 427 603 100  64],339,5,28482,4.371086556169429,20.0,20.0
36516,3,6516,[302 427 603 100  64],271,5,28487,4.371183059690042,20.0,20.0
36517,3,6517,[135 234 185 132  28],64,5,28492,4.371279533599264,0.0,0.0
36518,3,6518,[234 135 288 286 405],213,3,28495,4.371069182389937,0.0,0.0
36519,3,6519,[302 427 603 100  64],454,5,28500,4.371165644171779,20.0,20.0
36520,3,6520,[302 427 603 100  64],454,5,28505,4.371262076368655,20.0,20.0
36521,3,6521,[302 427 603 100  64],90,5,28510,4.371358478994174,20.0,20.0
36522,3,6522,[302 427 603 100  64],458,5,28515,4.371454852061935,20.0,20.0
36523,3,6523,[117 588  82 135  12],537,1,28516,4.370938074800736,20.0,0.0
36524,3,6524,[496 111 204 323 245],454,2,28518,4.370574712643678,0.0,0.0
36525,3,6525,[191  70 588 496 385],311,5,28523,4.370671161507815,0.0,0.0
36526,3,6526,[302 427 603 100  64],664,5,28528,4.37076758081814,20.0,20.0
36527,3,6527,[ 89 286 300   4 191],144,3,28531,4.370557598039215,0.0,0.0
36528,3,6528,[302 427 603 100  64],90,5,28536,4.370654005207536,20.0,20.0
36529,3,6529,[655  25 588 127 191],848,3,28539,4.370444104134763,0.0,20.0
36530,3,6530,[405 135 568 678 258],92,2,28541,4.370081151431633,0.0,0.0
36531,3,6531,[302 427 603 100  64],454,5,28546,4.370177587262707,20.0,20.0
36532,3,6532,[302 427 603 100  64],666,5,28551,4.3702739935711,20.0,20.0
36533,3,6533,[185 302  12   9 111],6,4,28555,4.37021732476278,20.0,0.0
36534,3,6534,[302 427 603 100  64],90,5,28560,4.370313695485845,20.0,20.0
36535,3,6535,[195 276 132 181 176],234,1,28561,4.369798041615667,0.0,0.0
36536,3,6536,[302 427 603 100  64],664,5,28566,4.369894446994034,20.0,20.0
36537,3,6537,[302 427 603 100  64],370,5,28571,4.369990822881615,20.0,20.0
36538,3,6538,[302 427 603 100  64],454,5,28576,4.37008716929194,20.0,20.0
36539,3,6539,[302 427 603 100  64],666,5,28581,4.370183486238532,20.0,20.0
36540,3,6540,[302 427 603 100  64],474,5,28586,4.370279773734903,20.0,20.0
36541,3,6541,[302 427 603 100  64],458,5,28591,4.370376031794558,20.0,20.0
36542,3,6542,[302 427 603 100  64],664,5,28596,4.370472260430995,20.0,20.0
36543,3,6543,[302 427 603 100  64],474,5,28601,4.370568459657702,20.0,20.0
36544,3,6544,[302 427 603 100  64],474,5,28606,4.370664629488159,20.0,20.0
36545,3,6545,[302 427 603 100  64],271,5,28611,4.370760769935838,20.0,20.0
36546,3,6546,[302 427 603 100  64],339,5,28616,4.3708568810142046,20.0,20.0
36547,3,6547,[403 385  71 153 182],650,2,28618,4.370494807574832,0.0,0.0
36548,3,6548,[302 427 603 100  64],370,5,28623,4.3705909299129635,20.0,20.0
36549,3,6549,[302 427 603 100  64],13,5,28628,4.370687022900763,20.0,20.0
36550,3,6550,[302 427 603 100  64],13,5,28633,4.370783086551672,20.0,20.0
36551,3,6551,[228 210  25 183 187],537,1,28634,4.37026862026862,0.0,0.0
36552,3,6552,[302 427 603 100  64],370,5,28639,4.370364718449565,20.0,20.0
36553,3,6553,[302 427 603 100  64],745,5,28644,4.370460787305462,20.0,20.0
36554,3,6554,[302 427 603 100  64],339,5,28649,4.370556826849733,20.0,20.0
36555,3,6555,[302 427 603 100  64],13,5,28654,4.37065283709579,20.0,20.0
36556,3,6556,[302 427 603 100  64],13,5,28659,4.370748818057038,20.0,20.0
36557,3,6557,[655 568 197 318 204],311,5,28664,4.370844769746874,20.0,0.0
36558,3,6558,[302 427 603 100  64],13,5,28669,4.370940692178686,20.0,20.0
36559,3,6559,[302 427 603 100  64],537,4,28673,4.370884146341464,20.0,20.0
36560,3,6560,[302 427 603 100  64],666,5,28678,4.370980033531474,20.0,20.0
36561,3,6561,[302 427 603 100  64],13,5,28683,4.371075891496495,20.0,20.0
36562,3,6562,[302 427 603 100  64],664,5,28688,4.371171720249886,20.0,20.0
36563,3,6563,[302 427 603 100  64],271,5,28693,4.371267519804997,20.0,20.0
36564,3,6564,[302 427 603 100  64],454,5,28698,4.371363290175172,20.0,20.0
36565,3,6565,[302 427 603 100  64],666,5,28703,4.371459031373743,20.0,20.0
36566,3,6566,[302 427 603 100  64],666,5,28708,4.37155474341404,20.0,20.0
36567,3,6567,[302 427 603 100  64],664,5,28713,4.371650426309379,20.0,20.0
36568,3,6568,[302 427 603 100  64],370,5,28718,4.371746080073071,20.0,20.0
36569,3,6569,[302 427 603 100  64],271,5,28723,4.371841704718417,20.0,20.0
36570,3,6570,[302 427 603 100  64],458,5,28728,4.371937300258713,20.0,20.0
36571,3,6571,[302 427 603 100  64],458,5,28733,4.372032866707243,20.0,20.0
36572,3,6572,[302 427 603 100  64],339,5,28738,4.372128404077285,20.0,20.0
36573,3,6573,[302 427 603 100  64],537,4,28742,4.37207179799209,20.0,20.0
36574,3,6574,[151   8 168 210 257],308,5,28747,4.372167300380228,0.0,0.0
36575,3,6575,[302 427 603 100  64],745,5,28752,4.372262773722627,20.0,20.0
36576,3,6576,[302 427 603 100  64],664,5,28757,4.372358218032538,20.0,20.0
36577,3,6577,[302 427 603 100  64],370,5,28762,4.3724536333231985,20.0,20.0
36578,3,6578,[302 427 603 100  64],339,5,28767,4.372549019607843,20.0,20.0
36579,3,6579,[302 427 603 100  64],458,5,28772,4.372644376899696,20.0,20.0
36580,3,6580,[302 427 603 100  64],271,5,28777,4.372739705211974,20.0,20.0
36581,3,6581,[546 238 237 228   4],653,1,28778,4.3722272865390455,0.0,0.0
36582,3,6582,[302 427 603 100  64],90,5,28783,4.372322649248063,20.0,20.0
36583,3,6583,[302 427 603 100  64],666,5,28788,4.372417982989065,20.0,20.0
36584,3,6584,[302 427 603 100  64],454,5,28793,4.372513287775247,20.0,20.0
36585,3,6585,[302 427 603 100  64],474,5,28798,4.372608563619799,20.0,20.0
36586,3,6586,[302 427 603 100  64],666,5,28803,4.372703810535904,20.0,20.0
36587,3,6587,[265 323 258 187 176],328,4,28807,4.372647237401336,0.0,0.0
36588,3,6588,[172 289 271 328 187],788,3,28810,4.372438913340416,0.0,0.0
36589,3,6589,[302 427 603 100  64],474,5,28815,4.372534142640364,20.0,20.0
36590,3,6590,[302 427 603 100  64],474,5,28820,4.372629343043545,20.0,20.0
36591,3,6591,[302 427 603 100  64],474,5,28825,4.372724514563107,20.0,20.0
36592,3,6592,[302 427 603 100  64],458,5,28830,4.372819657212195,20.0,20.0
36593,3,6593,[302 427 603 100  64],454,5,28835,4.372914771003943,20.0,20.0
36594,3,6594,[302 427 603 100  64],474,5,28840,4.373009855951478,20.0,20.0
36595,3,6595,[302 427 603 100  64],458,5,28845,4.3731049120679195,20.0,20.0
36596,3,6596,[302 427 603 100  64],458,5,28850,4.373199939366379,20.0,20.0
36597,3,6597,[471 183 210  50 132],13,3,28853,4.372991815701728,0.0,20.0
36598,3,6598,[302 427 603 100  64],271,5,28858,4.373086831338082,20.0,20.0
36599,3,6599,[302 427 603 100  64],13,5,28863,4.373181818181818,20.0,20.0
36600,3,6600,[302 427 603 100  64],537,4,28867,4.373125284047871,20.0,20.0
36601,3,6601,[302 427 603 100  64],537,4,28871,4.373068767040291,20.0,20.0
36602,3,6602,[302 427 603 100  64],370,5,28876,4.373163713463577,20.0,20.0
36603,3,6603,[302 427 603 100  64],90,5,28881,4.3732586311326465,20.0,20.0
36604,3,6604,[302 427 603 100  64],745,5,28886,4.37335352006056,20.0,20.0
36605,3,6605,[168  28 237 655 173],59,4,28890,4.3732970027247955,0.0,0.0
36606,3,6606,[302 427 603 100  64],745,5,28895,4.373391857121235,20.0,20.0
36607,3,6607,[302 427 603 100  64],666,5,28900,4.373486682808717,20.0,20.0
36608,3,6608,[302 427 603 100  64],458,5,28905,4.373581479800272,20.0,20.0
36609,3,6609,[302 427 603 100  64],13,5,28910,4.373676248108926,20.0,20.0
36610,3,6610,[302 427 603 100  64],13,5,28915,4.373770987747693,20.0,20.0
36611,3,6611,[302 427 603 100  64],664,5,28920,4.373865698729583,20.0,20.0
36612,3,6612,[302 427 603 100  64],339,5,28925,4.373960381067594,20.0,20.0
36613,3,6613,[302 427 603 100  64],13,5,28930,4.37405503477472,20.0,20.0
36614,3,6614,[302 427 603 100  64],458,5,28935,4.374149659863946,20.0,20.0
36615,3,6615,[276   4 515  11 318],308,4,28939,4.374093107617896,20.0,0.0
36616,3,6616,[302 427 603 100  64],474,5,28944,4.374187698352728,20.0,20.0
36617,3,6617,[302 427 603 100  64],339,5,28949,4.374282260501662,20.0,20.0
36618,3,6618,[435  70 144 161 515],643,3,28952,4.374074633630458,0.0,0.0
36619,3,6619,[655  15 151 195 276],308,4,28956,4.374018126888218,0.0,0.0
36620,3,6620,[302 427 603 100  64],339,5,28961,4.374112671801843,20.0,20.0
36621,3,6621,[302 427 603 100  64],458,5,28966,4.3742071881606766,20.0,20.0
36622,3,6622,[302 427 603 100  64],666,5,28971,4.374301675977653,20.0,20.0
36623,3,6623,[302 427 603 100  64],666,5,28976,4.374396135265701,20.0,20.0
36624,3,6624,[302 427 603 100  64],90,5,28981,4.374490566037736,20.0,20.0
36625,3,6625,[302 427 603 100  64],458,5,28986,4.374584968306671,20.0,20.0
36626,3,6626,[302 427 603 100  64],339,5,28991,4.374679342085408,20.0,20.0
36627,3,6627,[185  89 245 301 161],334,2,28993,4.374321062160531,0.0,0.0
36628,3,6628,[302 427 603 100  64],271,5,28998,4.374415447277116,20.0,20.0
36629,3,6629,[302 427 603 100  64],664,5,29003,4.374509803921568,20.0,20.0
36630,3,6630,[302 427 603 100  64],664,5,29008,4.3746041321067715,20.0,20.0
36631,3,6631,[302 427 603 100  64],458,5,29013,4.374698431845597,20.0,20.0
36632,3,6632,[302 427 603 100  64],537,4,29017,4.374641941806121,20.0,20.0
36633,3,6633,[ 71 318  12 211 323],13,3,29020,4.374434730177872,40.0,0.0
36634,3,6634,[302 427 603 100  64],339,5,29025,4.374529012810852,20.0,20.0
36635,3,6635,[742 475 174 216 258],207,4,29029,4.374472573839663,0.0,20.0
36636,3,6636,[ 89  56  12 427 125],194,3,29032,4.374265481392195,20.0,0.0
36637,3,6637,[302 427 603 100  64],271,5,29037,4.37435974691172,20.0,20.0
36638,3,6638,[302 427 603 100  64],370,5,29042,4.37445398403374,20.0,20.0
36639,3,6639,[302 427 603 100  64],745,5,29047,4.374548192771084,20.0,20.0
36640,3,6640,[302 427 603 100  64],664,5,29052,4.374642373136576,20.0,20.0
36641,3,6641,[173 435 186  88 182],897,3,29055,4.374435411020777,0.0,0.0
36642,3,6642,[302 427 603 100  64],454,5,29060,4.374529580009032,20.0,20.0
36643,3,6643,[ 98 202 215  56 276],538,4,29064,4.374473208910295,0.0,20.0
36644,3,6644,[302 427 603 100  64],474,5,29069,4.37456734386757,20.0,20.0
36645,3,6645,[302 427 603 100  64],745,5,29074,4.374661450496539,20.0,20.0
36646,3,6646,[302 427 603 100  64],271,5,29079,4.374755528809989,20.0,20.0
36647,3,6647,[302 427 603 100  64],339,5,29084,4.374849578820698,20.0,20.0
36648,3,6648,[302 427 603 100  64],458,5,29089,4.374943600541434,20.0,20.0
36649,3,6649,[302 427 603 100  64],745,5,29094,4.375037593984962,20.0,20.0
36650,3,6650,[302 427 603 100  64],474,5,29099,4.375131559164036,20.0,20.0
36651,3,6651,[302 427 603 100  64],537,4,29103,4.375075165363801,20.0,20.0
36652,3,6652,[302 427 603 100  64],339,5,29108,4.375169096648128,20.0,20.0
36653,3,6653,[302 427 603 100  64],454,5,29113,4.375262999699429,20.0,20.0
36654,3,6654,[302 427 603 100  64],537,4,29117,4.375206611570248,20.0,20.0
36655,3,6655,[302 427 603 100  64],13,5,29122,4.375300480769231,20.0,20.0
36656,3,6656,[302 427 603 100  64],271,5,29127,4.375394321766562,20.0,20.0
36657,3,6657,[302 427 603 100  64],90,5,29132,4.3754881345749475,20.0,20.0
36658,3,6658,[302 427 603 100  64],271,5,29137,4.375581919207088,20.0,20.0
36659,3,6659,[302 427 603 100  64],474,5,29142,4.375675675675676,20.0,20.0
36660,3,6660,[ 79 328 176 268 173],664,3,29145,4.37546914877646,0.0,0.0
36661,3,6661,[302 427 603 100  64],370,5,29150,4.375562894025818,20.0,20.0
36662,3,6662,[ 97 405  82 655 257],343,4,29154,4.375506528590725,0.0,0.0
36663,3,6663,[  1   9 174 597 265],378,4,29158,4.375450180072029,0.0,20.0
36664,3,6664,[302 427 603 100  64],90,5,29163,4.375543885971493,20.0,20.0
36665,3,6665,[302 427 603 100  64],664,5,29168,4.375637563756376,20.0,20.0
36666,3,6666,[302 427 603 100  64],537,4,29172,4.375581220938953,20.0,20.0
36667,3,6667,[302 427 603 100  64],537,4,29176,4.3755248950209955,20.0,20.0
36668,3,6668,[302 427 603 100  64],370,5,29181,4.37561853351327,20.0,20.0
36669,3,6669,[302 427 603 100  64],339,5,29186,4.375712143928036,20.0,20.0
36670,3,6670,[185 183  15  69 172],59,5,29191,4.375805726277919,0.0,0.0
36671,3,6671,[135 197 202  96 117],543,4,29195,4.3757494004796165,0.0,0.0
36672,3,6672,[302 427 603 100  64],474,5,29200,4.375842949198262,20.0,20.0
36673,3,6673,[302 427 603 100  64],664,5,29205,4.375936469883128,20.0,20.0
36674,3,6674,[302 427 603 100  64],474,5,29210,4.376029962546816,20.0,20.0
36675,3,6675,[302 427 603 100  64],458,5,29215,4.376123427201917,20.0,20.0
36676,3,6676,[302 427 603 100  64],370,5,29220,4.376216863861015,20.0,20.0
36677,3,6677,[302 427 603 100  64],474,5,29225,4.376310272536688,20.0,20.0
36678,3,6678,[302 427 603 100  64],454,5,29230,4.376403653241503,20.0,20.0
36679,3,6679,[302 427 603 100  64],537,4,29234,4.3763473053892215,20.0,20.0
36680,3,6680,[302 427 603 100  64],666,5,29239,4.376440652596917,20.0,20.0
36681,3,6681,[302 427 603 100  64],474,5,29244,4.376533971864712,20.0,20.0
36682,3,6682,[385  88 176 173 483],60,5,29249,4.3766272632051475,20.0,0.0
36683,3,6683,[302 427 603 100  64],90,5,29254,4.37672052663076,20.0,20.0
36684,3,6684,[ 12   8  71   9 435],328,4,29258,4.376664173522812,20.0,0.0
36685,3,6685,[302 427 603 100  64],13,5,29263,4.376757403529764,20.0,20.0
36686,3,6686,[182 265 135  64 228],59,5,29268,4.376850605652759,0.0,0.0
36687,3,6687,[302 427 603 100  64],13,5,29273,4.376943779904306,20.0,20.0
36688,3,6688,[302 427 603 100  64],90,5,29278,4.377036926296905,20.0,20.0
36689,3,6689,[ 98  79  97 301 328],328,3,29281,4.3768310911808666,0.0,20.0
36690,3,6690,[302 427 603 100  64],370,5,29286,4.376924226573008,20.0,20.0
36691,3,6691,[302 427 603 100  64],90,5,29291,4.377017334130305,20.0,20.0
36692,3,6692,[172 121 405 258   4],59,3,29294,4.3768115942028984,0.0,0.0
36693,3,6693,[222 328 302 197 237],13,3,29297,4.3766059157454436,0.0,0.0
36694,3,6694,[302 427 603 100  64],90,5,29302,4.376699029126214,20.0,20.0
36695,3,6695,[302 427 603 100  64],339,5,29307,4.37679211469534,20.0,20.0
36696,3,6696,[302 427 603 100  64],370,5,29312,4.376885172465283,20.0,20.0
36697,3,6697,[238 228 175 168 515],881,1,29313,4.3763810092564945,0.0,0.0
36698,3,6698,[118 235 276  28 483],308,1,29314,4.375876996566651,20.0,0.0
36699,3,6699,[302 427 603 100  64],664,5,29319,4.375970149253732,20.0,20.0
36700,3,6700,[302 427 603 100  64],666,5,29324,4.376063274138188,20.0,20.0
36701,3,6701,[302 427 603 100  64],474,5,29329,4.376156371232468,20.0,20.0
36702,3,6702,[228 182 678 403 187],749,2,29331,4.3758018797553335,0.0,0.0
36703,3,6703,[302 427 603 100  64],458,5,29336,4.375894988066825,20.0,20.0
36704,3,6704,[100   8 127 172 568],328,3,29339,4.375689783743475,0.0,40.0
36705,3,6705,[300 182 588 195 186],313,4,29343,4.375633760811214,0.0,0.0
36706,3,6706,[302 427 603 100  64],458,5,29348,4.37572685254212,20.0,20.0
36707,3,6707,[302 427 603 100  64],339,5,29353,4.375819916517591,20.0,20.0
36708,3,6708,[302 427 603 100  64],458,5,29358,4.3759129527500376,20.0,20.0
36709,3,6709,[302 427 603 100  64],745,5,29363,4.376005961251863,20.0,20.0
36710,3,6710,[302 427 603 100  64],474,5,29368,4.376098942035465,20.0,20.0
36711,3,6711,[302 427 603 100  64],339,5,29373,4.37619189511323,20.0,20.0
36712,3,6712,[144 195 202 655 597],13,3,29376,4.375986891106808,0.0,0.0
36713,3,6713,[302 427 603 100  64],537,4,29380,4.375930890676199,20.0,20.0
36714,3,6714,[302 427 603 100  64],454,5,29385,4.37602382725242,20.0,20.0
36715,3,6715,[302 427 603 100  64],271,5,29390,4.376116736152472,20.0,20.0
36716,3,6716,[  1 216 403 328 546],92,2,29392,4.375762989429805,0.0,0.0
36717,3,6717,[302 427 603 100  64],664,5,29397,4.375855909496874,20.0,20.0
36718,3,6718,[302 427 603 100  64],537,4,29401,4.375799970233666,20.0,20.0
36719,3,6719,[288 222 234 179 403],648,5,29406,4.3758928571428575,0.0,0.0
36720,3,6720,[288  56 302   7   4],343,4,29410,4.375836929028418,0.0,0.0
36721,3,6721,[300 323 187  15 483],537,2,29412,4.375483487057424,20.0,0.0
36722,3,6722,[302 427 603 100  64],745,5,29417,4.375576379592444,20.0,20.0
36723,3,6723,[302 427 603 100  64],458,5,29422,4.375669244497323,20.0,20.0
36724,3,6724,[121  82 174  79 435],897,4,29426,4.375613382899628,0.0,20.0
36725,3,6725,[302 427 603 100  64],454,5,29431,4.375706214689266,20.0,20.0
36726,3,6726,[161  71 179  82 597],95,1,29432,4.375204400178386,0.0,0.0
36727,3,6727,[301 183 318 153   9],184,3,29435,4.375,20.0,0.0
36728,3,6728,[302 427 603 100  64],271,5,29440,4.375092881557438,20.0,20.0
36729,3,6729,[302 427 603 100  64],537,4,29444,4.3750371471025264,20.0,20.0
36730,3,6730,[302 427 603 100  64],474,5,29449,4.37512999554301,20.0,20.0
36731,3,6731,[302 427 603 100  64],537,4,29453,4.375074272133095,20.0,20.0
36732,3,6732,[302 427 603 100  64],90,5,29458,4.3751670874795785,20.0,20.0
36733,3,6733,[302 427 603 100  64],454,5,29463,4.375259875259875,20.0,20.0
36734,3,6734,[234 215 322 302 210],454,3,29466,4.375055679287305,0.0,0.0
36735,3,6735,[302 427 603 100  64],13,5,29471,4.3751484560570075,20.0,20.0
36736,3,6736,[302 427 603 100  64],271,5,29476,4.375241205284251,20.0,20.0
36737,3,6737,[302 427 603 100  64],745,5,29481,4.3753339269813,20.0,20.0
36738,3,6738,[302 427 603 100  64],666,5,29486,4.375426621160409,20.0,20.0
36739,3,6739,[302 427 603 100  64],339,5,29491,4.375519287833828,20.0,20.0
36740,3,6740,[302 427 603 100  64],271,5,29496,4.3756119270137965,20.0,20.0
36741,3,6741,[302 427 603 100  64],474,5,29501,4.375704538712548,20.0,20.0
36742,3,6742,[302 427 603 100  64],454,5,29506,4.375797122942311,20.0,20.0
36743,3,6743,[302 427 603 100  64],458,5,29511,4.375889679715303,20.0,20.0
36744,3,6744,[302 427 603 100  64],13,5,29516,4.375982209043736,20.0,20.0
36745,3,6745,[302 427 603 100  64],271,5,29521,4.376074710939816,20.0,20.0
36746,3,6746,[185 183 294 100 191],379,4,29525,4.376018971394694,0.0,20.0
36747,3,6747,[144 403   1  50 475],343,5,29530,4.376111440426794,0.0,20.0
36748,3,6748,[302 427 603 100  64],664,5,29535,4.376203882056601,20.0,20.0
36749,3,6749,[ 88 135 168 194 191],537,3,29538,4.376,0.0,0.0
36750,3,6750,[302 427 603 100  64],458,5,29543,4.376092430751,20.0,20.0
36751,3,6751,[302 427 603 100  64],745,5,29548,4.376184834123222,20.0,20.0
36752,3,6752,[302 427 603 100  64],90,5,29553,4.376277210128832,20.0,20.0
36753,3,6753,[302 427 603 100  64],90,5,29558,4.376369558779982,20.0,20.0
36754,3,6754,[302 427 603 100  64],271,5,29563,4.376461880088823,20.0,20.0
36755,3,6755,[302 427 603 100  64],537,4,29567,4.3764061574896385,20.0,20.0
36756,3,6756,[302 427 603 100  64],370,5,29572,4.376498446055942,20.0,20.0
36757,3,6757,[302 427 603 100  64],474,5,29577,4.376590707309855,20.0,20.0
36758,3,6758,[588  89 238 143 603],13,3,29580,4.376387039502885,20.0,0.0
36759,3,6759,[132  50 216 179  12],92,3,29583,4.376183431952663,20.0,20.0
36760,3,6760,[302 427 603 100  64],745,5,29588,4.376275698861115,20.0,20.0
36761,3,6761,[302 427 603 100  64],90,5,29593,4.376367938479739,20.0,20.0
36762,3,6762,[187 174 175  82 597],308,4,29597,4.3763122874463996,0.0,20.0
36763,3,6763,[302 427 603 100  64],664,5,29602,4.376404494382022,20.0,20.0
36764,3,6764,[302 427 603 100  64],13,5,29607,4.37649667405765,20.0,20.0
36765,3,6765,[302 427 603 100  64],664,5,29612,4.376588826485368,20.0,20.0
36766,3,6766,[302 427 603 100  64],537,4,29616,4.37653317570563,20.0,20.0
36767,3,6767,[302 427 603 100  64],271,5,29621,4.3766252955082745,20.0,20.0
36768,3,6768,[333 245  96 210 144],263,3,29624,4.3764219234746635,0.0,0.0
36769,3,6769,[302 427 603 100  64],90,5,29629,4.376514032496307,20.0,20.0
36770,3,6770,[302 427 603 100  64],745,5,29634,4.376606114311032,20.0,20.0
36771,3,6771,[328 546 435 183 234],788,2,29636,4.376255168340225,0.0,0.0
36772,3,6772,[302 427 603 100  64],370,5,29641,4.376347261184113,20.0,20.0
36773,3,6773,[302 427 603 100  64],13,5,29646,4.37643932683791,20.0,20.0
36774,3,6774,[302 427 603 100  64],370,5,29651,4.376531365313653,20.0,20.0
36775,3,6775,[302 427 603 100  64],454,5,29656,4.376623376623376,20.0,20.0
36776,3,6776,[ 12 597 273 742  56],374,4,29660,4.376567802862623,20.0,0.0
36777,3,6777,[286 257  71 435 496],298,5,29665,4.376659781646503,0.0,0.0
36778,3,6778,[194 275 181 187  98],64,5,29670,4.376751733293996,0.0,20.0
36779,3,6779,[174 435 173  88  89],848,4,29674,4.37669616519174,0.0,20.0
36780,3,6780,[302 427 603 100  64],458,5,29679,4.376788084353341,20.0,20.0
36781,3,6781,[302 427 603 100  64],454,5,29684,4.376879976408139,20.0,20.0
36782,3,6782,[302 427 603 100  64],454,5,29689,4.3769718413681264,20.0,20.0
36783,3,6783,[302 427 603 100  64],271,5,29694,4.377063679245283,20.0,20.0
36784,3,6784,[302 427 603 100  64],90,5,29699,4.377155490051584,20.0,20.0
36785,3,6785,[302 427 603 100  64],454,5,29704,4.377247273798998,20.0,20.0
36786,3,6786,[144 200 216 183  79],650,3,29707,4.377044349491675,0.0,0.0
36787,3,6787,[302 427 603 100  64],537,4,29711,4.376988803771361,20.0,20.0
36788,3,6788,[302 427 603 100  64],271,5,29716,4.377080571512741,20.0,20.0
36789,3,6789,[302 427 603 100  64],537,4,29720,4.377025036818852,20.0,20.0
36790,3,6790,[302 427 603 100  64],13,5,29725,4.377116772198498,20.0,20.0
36791,3,6791,[302 427 603 100  64],745,5,29730,4.377208480565371,20.0,20.0
36792,3,6792,[302 427 603 100  64],666,5,29735,4.3773001619314,20.0,20.0
36793,3,6793,[168 222 228 423 496],85,3,29738,4.3770974389166915,0.0,0.0
36794,3,6794,[302 427 603 100  64],271,5,29743,4.377189109639441,20.0,20.0
36795,3,6795,[276 211  25 100   8],398,3,29746,4.376986462625074,0.0,20.0
36796,3,6796,[302 427 603 100  64],474,5,29751,4.3770781227011915,20.0,20.0
36797,3,6797,[423 197 117  28 200],643,3,29754,4.376875551632833,0.0,0.0
36798,3,6798,[302 427 603 100  64],271,5,29759,4.376967201058979,20.0,20.0
36799,3,6799,[302 427 603 100  64],458,5,29764,4.377058823529412,20.0,20.0
36800,3,6800,[302 427 603 100  64],271,5,29769,4.377150419056021,20.0,20.0
36801,3,6801,[302 427 603 100  64],90,5,29774,4.377241987650691,20.0,20.0
36802,3,6802,[302 427 603 100  64],458,5,29779,4.3773335293252975,20.0,20.0
36803,3,6803,[ 50 265 182 275  79],145,4,29783,4.377278071722516,0.0,20.0
36804,3,6804,[357 172  79  22 275],537,2,29785,4.376928728875827,20.0,0.0
36805,3,6805,[302 427 603 100  64],537,4,29789,4.376873347046724,20.0,20.0
36806,3,6806,[228  70 265 269  97],7,3,29792,4.376671073894521,0.0,0.0
36807,3,6807,[302 427 603 100  64],458,5,29797,4.376762632197415,20.0,20.0
36808,3,6808,[302 427 603 100  64],339,5,29802,4.376854163606991,20.0,20.0
36809,3,6809,[302 427 603 100  64],458,5,29807,4.376945668135096,20.0,20.0
36810,3,6810,[202  95 423 313 603],234,3,29810,4.376743503156658,20.0,0.0
36811,3,6811,[302 427 603 100  64],666,5,29815,4.376834997064004,20.0,20.0
36812,3,6812,[302 427 603 100  64],474,5,29820,4.376926464112725,20.0,20.0
36813,3,6813,[302 427 603 100  64],458,5,29825,4.377017904314647,20.0,20.0
36814,3,6814,[ 12  98 186 174 546],194,4,29829,4.376962582538518,20.0,40.0
36815,3,6815,[144  64 176 302 180],343,5,29834,4.377053990610329,0.0,0.0
36816,3,6816,[302 427 603 100  64],13,5,29839,4.377145371864456,20.0,20.0
36817,3,6817,[  1  98  25 237 235],537,0,29839,4.376503373423291,0.0,20.0
36818,3,6818,[302 427 603 100  64],13,5,29844,4.376594808622965,20.0,20.0
36819,3,6819,[302 427 603 100  64],90,5,29849,4.376686217008798,20.0,20.0
36820,3,6820,[302 427 603 100  64],271,5,29854,4.376777598592581,20.0,20.0
36821,3,6821,[302 427 603 100  64],339,5,29859,4.376868953386103,20.0,20.0
36822,3,6822,[302 427 603 100  64],13,5,29864,4.376960281401143,20.0,20.0
36823,3,6823,[121 161 194 127  50],881,2,29866,4.376611957796014,0.0,40.0
36824,3,6824,[302 427 603 100  64],90,5,29871,4.376703296703297,20.0,20.0
36825,3,6825,[302 427 603 100  64],454,5,29876,4.37679460884852,20.0,20.0
36826,3,6826,[245  50   7 423 276],455,4,29880,4.376739417020653,0.0,20.0
36827,3,6827,[302 427 603 100  64],745,5,29885,4.376830697129467,20.0,20.0
36828,3,6828,[496  64   9 191 597],59,4,29889,4.3767755161809925,0.0,0.0
36829,3,6829,[302 427 603 100  64],666,5,29894,4.376866764275256,20.0,20.0
36830,3,6830,[301  28 181 175 111],334,2,29896,4.37651881130142,0.0,0.0
36831,3,6831,[302 427 603 100  64],664,5,29901,4.376610070257612,20.0,20.0
36832,3,6832,[302 427 603 100  64],458,5,29906,4.376701302502561,20.0,20.0
36833,3,6833,[187 200 173 258 282],311,5,29911,4.376792508047996,0.0,0.0
36834,3,6834,[435 194 245 204 183],749,5,29916,4.376883686905633,0.0,0.0
36835,3,6835,[302 427 603 100  64],474,5,29921,4.376974839087185,20.0,20.0
36836,3,6836,[302 427 603 100  64],90,5,29926,4.377065964604359,20.0,20.0
36837,3,6837,[302 427 603 100  64],339,5,29931,4.37715706346885,20.0,20.0
36838,3,6838,[302 427 603 100  64],370,5,29936,4.377248135692352,20.0,20.0
36839,3,6839,[302 427 603 100  64],13,5,29941,4.377339181286549,20.0,20.0
36840,3,6840,[302 427 603 100  64],13,5,29946,4.377430200263119,20.0,20.0
36841,3,6841,[302 427 603 100  64],664,5,29951,4.377521192633733,20.0,20.0
36842,3,6842,[302 427 603 100  64],454,5,29956,4.377612158410054,20.0,20.0
36843,3,6843,[302 427 603 100  64],537,4,29960,4.377556984219755,20.0,20.0
36844,3,6844,[302 427 603 100  64],458,5,29965,4.377647918188459,20.0,20.0
36845,3,6845,[302 427 603 100  64],90,5,29970,4.377738825591586,20.0,20.0
36846,3,6846,[302 427 603 100  64],537,4,29974,4.3776836570760915,20.0,20.0
36847,3,6847,[302 427 603 100  64],666,5,29979,4.37777453271028,20.0,20.0
36848,3,6848,[302 427 603 100  64],664,5,29984,4.377865381807563,20.0,20.0
36849,3,6849,[302 427 603 100  64],745,5,29989,4.377956204379562,20.0,20.0
36850,3,6850,[302 427 603 100  64],537,4,29993,4.377901036345059,20.0,20.0
36851,3,6851,[  4  71 185 265 161],59,3,29996,4.3776999416228835,0.0,0.0
36852,3,6852,[  8 323 132  12  64],474,4,30000,4.37764482708303,20.0,0.0
36853,3,6853,[302 427 603 100  64],454,5,30005,4.37773562882988,20.0,20.0
36854,3,6854,[302 427 603 100  64],370,5,30010,4.37782640408461,20.0,20.0
36855,3,6855,[ 64  71 118 588 655],378,5,30015,4.37791715285881,0.0,0.0
36856,3,6856,[ 82 568 132   1 222],378,4,30019,4.3778620387924745,0.0,0.0
36857,3,6857,[302 427 603 100  64],458,5,30024,4.377952755905512,20.0,20.0
36858,3,6858,[100   9 282 237 568],455,3,30027,4.377751858871556,0.0,20.0
36859,3,6859,[180 508  96 100 204],447,4,30031,4.377696793002915,0.0,20.0
36860,3,6860,[302 427 603 100  64],271,5,30036,4.377787494534324,20.0,20.0
36861,3,6861,[194 179 357 328 187],234,3,30039,4.377586709414165,20.0,0.0
36862,3,6862,[135 153 196 258 187],13,5,30044,4.377677400553694,0.0,0.0
36863,3,6863,[302 427 603 100  64],339,5,30049,4.377768065268065,20.0,20.0
36864,3,6864,[302 427 603 100  64],339,5,30054,4.377858703568827,20.0,20.0
36865,3,6865,[302 427 603 100  64],537,4,30058,4.377803670259248,20.0,20.0
36866,3,6866,[210 405  97  89 748],479,3,30061,4.377603028979176,0.0,0.0
36867,3,6867,[302 427 603 100  64],370,5,30066,4.377693651718113,20.0,20.0
36868,3,6868,[302 427 603 100  64],454,5,30071,4.377784248071044,20.0,20.0
36869,3,6869,[302 427 603 100  64],664,5,30076,4.377874818049491,20.0,20.0
36870,3,6870,[302 427 603 100  64],13,5,30081,4.377965361664969,20.0,20.0
36871,3,6871,[603 273   4 234 276],10,5,30086,4.378055878928987,20.0,0.0
36872,3,6872,[302 427 603 100  64],271,5,30091,4.378146369853048,20.0,20.0
36873,3,6873,[302 427 603 100  64],745,5,30096,4.378236834448647,20.0,20.0
36874,3,6874,[196 204 435 276 357],59,5,30101,4.378327272727272,20.0,0.0
36875,3,6875,[302 427 603 100  64],664,5,30106,4.378417684700407,20.0,20.0
36876,3,6876,[302 427 603 100  64],666,5,30111,4.378508070379526,20.0,20.0
36877,3,6877,[302 427 603 100  64],90,5,30116,4.378598429776098,20.0,20.0
36878,3,6878,[302 427 603 100  64],370,5,30121,4.378688762901585,20.0,20.0
36879,3,6879,[302 427 603 100  64],339,5,30126,4.378779069767442,20.0,20.0
36880,3,6880,[302 427 603 100  64],537,4,30130,4.378724022671124,20.0,20.0
36881,3,6881,[302 427 603 100  64],13,5,30135,4.378814298169137,20.0,20.0
36882,3,6882,[180 111 125 237 100],749,2,30137,4.378468690977772,0.0,20.0
36883,3,6883,[302 427 603 100  64],90,5,30142,4.3785589773387565,20.0,20.0
36884,3,6884,[302 427 603 100  64],370,5,30147,4.378649237472767,20.0,20.0
36885,3,6885,[302 427 603 100  64],666,5,30152,4.378739471391229,20.0,20.0
36886,3,6886,[ 96 603 215 271 143],749,5,30157,4.378829679105562,20.0,0.0
36887,3,6887,[302 427 603 100  64],666,5,30162,4.378919860627177,20.0,20.0
36888,3,6888,[302 427 603 100  64],474,5,30167,4.379010015967484,20.0,20.0
36889,3,6889,[ 89 181 427 238 172],7,4,30171,4.378955007256894,0.0,0.0
36890,3,6890,[302 427 603 100  64],666,5,30176,4.379045131330721,20.0,20.0
36891,3,6891,[302 427 603 100  64],745,5,30181,4.379135229251306,20.0,20.0
36892,3,6892,[302 427 603 100  64],339,5,30186,4.37922530103003,20.0,20.0
36893,3,6893,[302 427 603 100  64],339,5,30191,4.379315346678271,20.0,20.0
36894,3,6894,[322 276 333 191  28],533,4,30195,4.379260333575054,0.0,0.0
36895,3,6895,[302 427 603 100  64],339,5,30200,4.379350348027843,20.0,20.0
36896,3,6896,[302 427 603 100  64],271,5,30205,4.379440336378136,20.0,20.0
36897,3,6897,[302 427 603 100  64],454,5,30210,4.379530298637286,20.0,20.0
36898,3,6898,[302 427 603 100  64],454,5,30215,4.37962023481664,20.0,20.0
36899,3,6899,[471 127  70  95 118],374,5,30220,4.379710144927536,0.0,20.0
36900,3,6900,[168 496  64   7 288],387,2,30222,4.379365309375453,0.0,0.0
36901,3,6901,[302 427 603 100  64],13,5,30227,4.379455230368009,20.0,20.0
36902,3,6902,[302 427 603 100  64],664,5,30232,4.379545125307837,20.0,20.0
36903,3,6903,[301 222 328 385 546],119,5,30237,4.379634994206257,0.0,0.0
36904,3,6904,[ 22 216 127 143 275],648,4,30241,4.37958001448226,0.0,20.0
36905,3,6905,[302 427 603 100  64],745,5,30246,4.379669852302346,20.0,20.0
36906,3,6906,[475 111 282 276 100],92,4,30250,4.379614883451571,0.0,20.0
36907,3,6907,[302 427 603 100  64],666,5,30255,4.379704690214244,20.0,20.0
36908,3,6908,[302 427 603 100  64],664,5,30260,4.379794470979881,20.0,20.0
36909,3,6909,[ 82 210 215  25 176],804,5,30265,4.379884225759769,0.0,0.0
36910,3,6910,[185  70 258 173 179],537,5,30270,4.379973954565186,0.0,0.0
36911,3,6911,[302 427 603 100  64],339,5,30275,4.380063657407407,20.0,20.0
36912,3,6912,[302 427 603 100  64],664,5,30280,4.3801533342977,20.0,20.0
36913,3,6913,[302 427 603 100  64],90,5,30285,4.380242985247325,20.0,20.0
36914,3,6914,[302 427 603 100  64],454,5,30290,4.380332610267534,20.0,20.0
36915,3,6915,[302 427 603 100  64],271,5,30295,4.380422209369578,20.0,20.0
36916,3,6916,[302 427 603 100  64],474,5,30300,4.380511782564696,20.0,20.0
36917,3,6917,[302 427 603 100  64],370,5,30305,4.380601329864122,20.0,20.0
36918,3,6918,[302 427 603 100  64],666,5,30310,4.380690851279087,20.0,20.0
36919,3,6919,[302 427 603 100  64],454,5,30315,4.380780346820809,20.0,20.0
36920,3,6920,[302 427 603 100  64],458,5,30320,4.380869816500506,20.0,20.0
36921,3,6921,[302 427 603 100  64],271,5,30325,4.3809592603293845,20.0,20.0
36922,3,6922,[302 427 603 100  64],474,5,30330,4.381048678318648,20.0,20.0
36923,3,6923,[125 194 435 228 144],64,3,30333,4.380849220103986,0.0,0.0
36924,3,6924,[235 168 172  71 194],398,3,30336,4.380649819494585,0.0,0.0
36925,3,6925,[302 427 603 100  64],454,5,30341,4.380739243430551,20.0,20.0
36926,3,6926,[ 88 435 168 182 515],326,1,30342,4.380251190991771,0.0,0.0
36927,3,6927,[302 427 603 100  64],13,5,30347,4.38034064665127,20.0,20.0
36928,3,6928,[ 96 210 655 161 194],387,2,30349,4.379997113580603,0.0,0.0
36929,3,6929,[118 202 234 135 282],42,5,30354,4.38008658008658,0.0,0.0
36930,3,6930,[302 427 603 100  64],745,5,30359,4.380176020776223,20.0,20.0
36931,3,6931,[302 427 603 100  64],339,5,30364,4.380265435660704,20.0,20.0
36932,3,6932,[302 427 603 100  64],458,5,30369,4.38035482475119,20.0,20.0
36933,3,6933,[302 427 603 100  64],339,5,30374,4.38044418805884,20.0,20.0
36934,3,6934,[302 427 603 100  64],370,5,30379,4.380533525594809,20.0,20.0
36935,3,6935,[302 427 603 100  64],664,5,30384,4.380622837370242,20.0,20.0
36936,3,6936,[302 427 603 100  64],454,5,30389,4.380712123396281,20.0,20.0
36937,3,6937,[302 427 603 100  64],537,4,30393,4.380657249927933,20.0,20.0
36938,3,6938,[302 427 603 100  64],90,5,30398,4.380746505260124,20.0,20.0
36939,3,6939,[302 427 603 100  64],458,5,30403,4.380835734870317,20.0,20.0
36940,3,6940,[302 427 603 100  64],370,5,30408,4.380924938769629,20.0,20.0
36941,3,6941,[302 427 603 100  64],458,5,30413,4.381014116969173,20.0,20.0
36942,3,6942,[302 427 603 100  64],90,5,30418,4.381103269480052,20.0,20.0
36943,3,6943,[302 427 603 100  64],271,5,30423,4.381192396313364,20.0,20.0
36944,3,6944,[302 427 603 100  64],666,5,30428,4.3812814974802015,20.0,20.0
36945,3,6945,[222 588 100  56 118],881,3,30431,4.381082637489202,0.0,20.0
36946,3,6946,[302 427 603 100  64],370,5,30436,4.381171728803801,20.0,20.0
36947,3,6947,[302 427 603 100  64],271,5,30441,4.38126079447323,20.0,20.0
36948,3,6948,[ 56 288 588 385 357],13,2,30443,4.380918117714779,20.0,0.0
36949,3,6949,[302 427 603 100  64],339,5,30448,4.381007194244605,20.0,20.0
36950,3,6950,[127 179 176 186 181],210,4,30452,4.380952380952381,0.0,20.0
36951,3,6951,[302 427 603 100  64],13,5,30457,4.381041426927503,20.0,20.0
36952,3,6952,[ 95 475 483 748 245],402,2,30459,4.380698978858047,20.0,0.0
36953,3,6953,[302 427 603 100  64],13,5,30464,4.380788035662928,20.0,20.0
36954,3,6954,[302 427 603 100  64],339,5,30469,4.380877066858376,20.0,20.0
36955,3,6955,[302 427 603 100  64],90,5,30474,4.3809660724554345,20.0,20.0
36956,3,6956,[302 427 603 100  64],13,5,30479,4.381055052465143,20.0,20.0
36957,3,6957,[302 427 603 100  64],458,5,30484,4.381144006898534,20.0,20.0
36958,3,6958,[302 427 603 100  64],458,5,30489,4.381232935766633,20.0,20.0
36959,3,6959,[179 403 185 200 161],339,3,30492,4.38103448275862,0.0,0.0
36960,3,6960,[302 427 603 100  64],745,5,30497,4.381123401810084,20.0,20.0
36961,3,6961,[302 427 603 100  64],537,4,30501,4.381068658431485,20.0,20.0
36962,3,6962,[  1 180 111 196 302],378,3,30504,4.380870314519604,0.0,0.0
36963,3,6963,[176 405 151  25  56],533,1,30505,4.380384836300976,0.0,0.0
36964,3,6964,[302 427 603 100  64],13,5,30510,4.380473797559224,20.0,20.0
36965,3,6965,[302 427 603 100  64],474,5,30515,4.380562733275911,20.0,20.0
36966,3,6966,[302 427 603 100  64],271,5,30520,4.380651643462035,20.0,20.0
36967,3,6967,[271 175 678 328 313],334,2,30522,4.380309988518944,0.0,0.0
36968,3,6968,[ 69 568 118 180 204],804,5,30527,4.380398909456163,0.0,0.0
36969,3,6969,[302 427 603 100  64],745,5,30532,4.380487804878049,20.0,20.0
36970,3,6970,[191  96 546 132 135],882,4,30536,4.3804332233538945,0.0,0.0
36971,3,6971,[302 427 603 100  64],370,5,30541,4.3805220883534135,20.0,20.0
36972,3,6972,[302 427 603 100  64],13,5,30546,4.380610927864621,20.0,20.0
36973,3,6973,[302 427 603 100  64],271,5,30551,4.38069974189848,20.0,20.0
36974,3,6974,[302 427 603 100  64],339,5,30556,4.38078853046595,20.0,20.0
36975,3,6975,[302 427 603 100  64],454,5,30561,4.380877293577981,20.0,20.0
36976,3,6976,[302 427 603 100  64],474,5,30566,4.380966031245521,20.0,20.0
36977,3,6977,[302 427 603 100  64],454,5,30571,4.381054743479507,20.0,20.0
36978,3,6978,[302 427 603 100  64],666,5,30576,4.381143430290873,20.0,20.0
36979,3,6979,[588 403  98 294 185],311,4,30580,4.3810888252149,0.0,20.0
36980,3,6980,[302 427 603 100  64],370,5,30585,4.381177481736141,20.0,20.0
36981,3,6981,[302 427 603 100  64],474,5,30590,4.381266112861645,20.0,20.0
36982,3,6982,[302 427 603 100  64],666,5,30595,4.38135471860232,20.0,20.0
36983,3,6983,[302 427 603 100  64],370,5,30600,4.381443298969073,20.0,20.0
36984,3,6984,[302 427 603 100  64],271,5,30605,4.381531853972799,20.0,20.0
36985,3,6985,[302 427 603 100  64],474,5,30610,4.381620383624392,20.0,20.0
36986,3,6986,[302 427 603 100  64],370,5,30615,4.381708887934736,20.0,20.0
36987,3,6987,[302 427 603 100  64],745,5,30620,4.381797366914711,20.0,20.0
36988,3,6988,[302 427 603 100  64],339,5,30625,4.38188582057519,20.0,20.0
36989,3,6989,[302 427 603 100  64],454,5,30630,4.381974248927039,20.0,20.0
36990,3,6990,[302 427 603 100  64],13,5,30635,4.382062651981118,20.0,20.0
36991,3,6991,[ 15 194 496 127 172],694,5,30640,4.382151029748284,0.0,20.0
36992,3,6992,[302 427 603 100  64],370,5,30645,4.382239382239383,20.0,20.0
36993,3,6993,[302 427 603 100  64],271,5,30650,4.3823277094652555,20.0,20.0
36994,3,6994,[302 427 603 100  64],458,5,30655,4.3824160114367405,20.0,20.0
36995,3,6995,[302 427 603 100  64],13,5,30660,4.382504288164665,20.0,20.0
36996,3,6996,[302 427 603 100  64],458,5,30665,4.382592539659854,20.0,20.0
36997,3,6997,[302 427 603 100  64],474,5,30670,4.382680765933124,20.0,20.0
36998,3,6998,[302 427 603 100  64],666,5,30675,4.382768966995285,20.0,20.0
36999,3,6999,[405 237 748  82  88],749,2,30677,4.382428571428571,0.0,0.0
37000,3,7000,[302 427 603 100  64],745,5,30682,4.382516783316669,20.0,20.0
37001,3,7001,[191 603 435  25   7],474,5,30687,4.382604970008569,20.0,0.0
37002,3,7002,[302 427 603 100  64],666,5,30692,4.382693131515065,20.0,20.0
37003,3,7003,[302 427 603 100  64],13,5,30697,4.382781267846944,20.0,20.0
37004,3,7004,[302 427 603 100  64],664,5,30702,4.3828693790149895,20.0,20.0
37005,3,7005,[302 427 603 100  64],474,5,30707,4.382957465029975,20.0,20.0
37006,3,7006,[302 427 603 100  64],458,5,30712,4.383045525902669,20.0,20.0
37007,3,7007,[302 427 603 100  64],458,5,30717,4.383133561643835,20.0,20.0
37008,3,7008,[271 176 273 228   4],158,4,30721,4.3830788985589955,0.0,0.0
37009,3,7009,[302 427 603 100  64],537,4,30725,4.3830242510699,20.0,20.0
37010,3,7010,[302 427 603 100  64],474,5,30730,4.383112252175153,20.0,20.0
37011,3,7011,[302 427 603 100  64],474,5,30735,4.383200228180263,20.0,20.0
37012,3,7012,[302 427 603 100  64],664,5,30740,4.383288179095965,20.0,20.0
37013,3,7013,[302 427 603 100  64],454,5,30745,4.383376104932991,20.0,20.0
37014,3,7014,[ 25 132  15 483  88],210,5,30750,4.383464005702067,20.0,0.0
37015,3,7015,[742 237 405 216 222],554,2,30752,4.3831242873432155,0.0,0.0
37016,3,7016,[302 427 603 100  64],90,5,30757,4.383212198945419,20.0,20.0
37017,3,7017,[302 427 603 100  64],370,5,30762,4.383300085494443,20.0,20.0
37018,3,7018,[302 427 603 100  64],458,5,30767,4.3833879470009975,20.0,20.0
37019,3,7019,[302 427 603 100  64],666,5,30772,4.383475783475784,20.0,20.0
37020,3,7020,[508  88 237 182  69],13,4,30776,4.3834211650762,0.0,0.0
37021,3,7021,[302 427 603 100  64],745,5,30781,4.383508971802905,20.0,20.0
37022,3,7022,[302 427 603 100  64],537,4,30785,4.38345436423181,20.0,20.0
37023,3,7023,[302 427 603 100  64],271,5,30790,4.383542141230068,20.0,20.0
37024,3,7024,[302 427 603 100  64],474,5,30795,4.383629893238434,20.0,20.0
37025,3,7025,[302 427 603 100  64],454,5,30800,4.383717620267578,20.0,20.0
37026,3,7026,[302 427 603 100  64],664,5,30805,4.383805322328163,20.0,20.0
37027,3,7027,[302 427 603 100  64],13,5,30810,4.383892999430848,20.0,20.0
37028,3,7028,[655 257 234 186 202],840,4,30814,4.383838383838384,0.0,0.0
37029,3,7029,[302 427 603 100  64],745,5,30819,4.383926031294452,20.0,20.0
37030,3,7030,[302 427 603 100  64],90,5,30824,4.384013653818802,20.0,20.0
37031,3,7031,[117 655   7  28 268],13,3,30827,4.3838168373151305,0.0,0.0
37032,3,7032,[302 427 603 100  64],13,5,30832,4.383904450447888,20.0,20.0
37033,3,7033,[302 427 603 100  64],370,5,30837,4.38399203866932,20.0,20.0
37034,3,7034,[302 427 603 100  64],745,5,30842,4.38407960199005,20.0,20.0
37035,3,7035,[215   8  70 333  95],506,5,30847,4.384167140420693,0.0,0.0
37036,3,7036,[302 427 603 100  64],90,5,30852,4.384254653971863,20.0,20.0
37037,3,7037,[423 100 268 186  56],7,4,30856,4.384200056834328,0.0,20.0
37038,3,7038,[302 427 603 100  64],664,5,30861,4.38428754084387,20.0,20.0
37039,3,7039,[302 427 603 100  64],13,5,30866,4.384375,20.0,20.0
37040,3,7040,[143 588 118 257 132],650,3,30869,4.384178383752308,0.0,0.0
37041,3,7041,[302 427 603 100  64],666,5,30874,4.384265833570009,20.0,20.0
37042,3,7042,[302 427 603 100  64],458,5,30879,4.384353258554593,20.0,20.0
37043,3,7043,[302 427 603 100  64],537,4,30883,4.384298693923907,20.0,20.0
37044,3,7044,[302 427 603 100  64],474,5,30888,4.384386089425124,20.0,20.0
37045,3,7045,[302 427 603 100  64],13,5,30893,4.384473460119216,20.0,20.0
37046,3,7046,[ 11 294 100 471   4],474,3,30896,4.384276997303817,0.0,20.0
37047,3,7047,[302 427 603 100  64],271,5,30901,4.384364358683315,20.0,20.0
37048,3,7048,[302 427 603 100  64],13,5,30906,4.384451695275926,20.0,20.0
37049,3,7049,[151 111 187 191 204],334,4,30910,4.384397163120568,0.0,0.0
37050,3,7050,[ 88 313 161 238 153],653,2,30912,4.384058998723585,0.0,0.0
37051,3,7051,[302 427 603 100  64],745,5,30917,4.384146341463414,20.0,20.0
37052,3,7052,[302 427 603 100  64],666,5,30922,4.384233659435701,20.0,20.0
37053,3,7053,[302 427 603 100  64],370,5,30927,4.384320952650978,20.0,20.0
37054,3,7054,[302 427 603 100  64],458,5,30932,4.384408221119773,20.0,20.0
37055,3,7055,[302 427 603 100  64],370,5,30937,4.384495464852607,20.0,20.0
37056,3,7056,[302 427 603 100  64],537,4,30941,4.3844409805866515,20.0,20.0
37057,3,7057,[302 427 603 100  64],666,5,30946,4.384528194956078,20.0,20.0
37058,3,7058,[302 427 603 100  64],370,5,30951,4.384615384615385,20.0,20.0
37059,3,7059,[302 427 603 100  64],370,5,30956,4.384702549575071,20.0,20.0
37060,3,7060,[132 245 172 496 294],488,2,30958,4.384364820846906,0.0,0.0
37061,3,7061,[302 427 603 100  64],474,5,30963,4.38445199660153,20.0,20.0
37062,3,7062,[302 427 603 100  64],664,5,30968,4.384539147670961,20.0,20.0
37063,3,7063,[302 427 603 100  64],537,4,30972,4.384484711211778,20.0,20.0
37064,3,7064,[302 427 603 100  64],666,5,30977,4.384571832979477,20.0,20.0
37065,3,7065,[302 427 603 100  64],370,5,30982,4.3846589300877445,20.0,20.0
37066,3,7066,[302 427 603 100  64],90,5,30987,4.3847460025470495,20.0,20.0
37067,3,7067,[302 427 603 100  64],666,5,30992,4.384833050367855,20.0,20.0
37068,3,7068,[258 603 496 182 151],334,3,30995,4.384637148111473,20.0,0.0
37069,3,7069,[195 135 289 204 405],537,1,30996,4.3841584158415845,0.0,0.0
37070,3,7070,[ 98 194   7 357 125],295,5,31001,4.384245509828879,20.0,20.0
37071,3,7071,[302 427 603 100  64],664,5,31006,4.3843325791855206,20.0,20.0
37072,3,7072,[302 427 603 100  64],537,4,31010,4.384278241198926,20.0,20.0
37073,3,7073,[302 427 603 100  64],537,4,31014,4.3842239185750635,20.0,20.0
37074,3,7074,[ 97 175 168  71 195],650,3,31017,4.384028268551237,0.0,0.0
37075,3,7075,[302 427 603 100  64],13,5,31022,4.384115319389486,20.0,20.0
37076,3,7076,[302 427 603 100  64],370,5,31027,4.384202345626678,20.0,20.0
37077,3,7077,[302 427 603 100  64],339,5,31032,4.384289347273241,20.0,20.0
37078,3,7078,[302 427 603 100  64],537,4,31036,4.384235061449357,20.0,20.0
37079,3,7079,[302 427 603 100  64],271,5,31041,4.384322033898305,20.0,20.0
37080,3,7080,[302 427 603 100  64],90,5,31046,4.384408981782234,20.0,20.0
37081,3,7081,[302 427 603 100  64],474,5,31051,4.38449590511155,20.0,20.0
37082,3,7082,[302 427 603 100  64],474,5,31056,4.384582803896654,20.0,20.0
37083,3,7083,[302 427 603 100  64],664,5,31061,4.384669678147939,20.0,20.0
37084,3,7084,[302 427 603 100  64],271,5,31066,4.384756527875794,20.0,20.0
37085,3,7085,[151   7  12   4 197],378,2,31068,4.384419983065199,20.0,0.0
37086,3,7086,[302 427 603 100  64],271,5,31073,4.384506843516298,20.0,20.0
37087,3,7087,[302 427 603 100  64],666,5,31078,4.38459367945824,20.0,20.0
37088,3,7088,[294 200  95  98  88],95,2,31080,4.384257300042319,0.0,20.0
37089,3,7089,[302 427 603 100  64],666,5,31085,4.384344146685472,20.0,20.0
37090,3,7090,[302 427 603 100  64],474,5,31090,4.384430968833733,20.0,20.0
37091,3,7091,[ 96 143  71 161 210],374,4,31094,4.384376762549351,0.0,0.0
37092,3,7092,[302 427 603 100  64],454,5,31099,4.384463555618215,20.0,20.0
37093,3,7093,[302 427 603 100  64],370,5,31104,4.384550324217649,20.0,20.0
37094,3,7094,[215  70 271 121  79],479,3,31107,4.384355179704017,0.0,0.0
37095,3,7095,[302 427 603 100  64],666,5,31112,4.384441939120632,20.0,20.0
37096,3,7096,[302 427 603 100  64],474,5,31117,4.384528674087643,20.0,20.0
37097,3,7097,[302 427 603 100  64],271,5,31122,4.384615384615385,20.0,20.0
37098,3,7098,[302 427 603 100  64],745,5,31127,4.3847020707141855,20.0,20.0
37099,3,7099,[302 427 603 100  64],370,5,31132,4.384788732394366,20.0,20.0
37100,3,7100,[302 427 603 100  64],90,5,31137,4.384875369666244,20.0,20.0
37101,3,7101,[302 427 603 100  64],537,4,31141,4.384821177133202,20.0,20.0
37102,3,7102,[302 427 603 100  64],537,4,31145,4.384766999859214,20.0,20.0
37103,3,7103,[302 427 603 100  64],474,5,31150,4.384853603603603,20.0,20.0
37104,3,7104,[302 427 603 100  64],664,5,31155,4.384940182969739,20.0,20.0
37105,3,7105,[423 265 603 234 294],308,2,31157,4.38460455952716,20.0,0.0
37106,3,7106,[302 427 603 100  64],90,5,31162,4.384691149570846,20.0,20.0
37107,3,7107,[302 427 603 100  64],458,5,31167,4.384777715250422,20.0,20.0
37108,3,7108,[546 294 179 237 216],749,2,31169,4.384442256294838,0.0,0.0
37109,3,7109,[302 427 603 100  64],370,5,31174,4.384528832630099,20.0,20.0
37110,3,7110,[302 427 603 100  64],454,5,31179,4.384615384615385,20.0,20.0
37111,3,7111,[302 427 603 100  64],370,5,31184,4.384701912260967,20.0,20.0
37112,3,7112,[302 427 603 100  64],458,5,31189,4.384788415577113,20.0,20.0
37113,3,7113,[168 313 100 515 127],308,3,31192,4.384593758785494,0.0,40.0
37114,3,7114,[302 427 603 100  64],664,5,31197,4.384680252986648,20.0,20.0
37115,3,7115,[302 427 603 100  64],90,5,31202,4.384766722878021,20.0,20.0
37116,3,7116,[143 182   9  96 200],7,4,31206,4.38471265982858,0.0,0.0
37117,3,7117,[269 153  71 483 161],85,3,31209,4.384518123068277,20.0,0.0
37118,3,7118,[302 427 603 100  64],474,5,31214,4.3846045792948445,20.0,20.0
37119,3,7119,[302 427 603 100  64],664,5,31219,4.384691011235955,20.0,20.0
37120,3,7120,[200 237 258 172 185],788,4,31223,4.384636989186912,0.0,0.0
37121,3,7121,[302 427 603 100  64],271,5,31228,4.384723392305532,20.0,20.0
37122,3,7122,[427 168 194 174 202],343,5,31233,4.384809771163836,0.0,20.0
37123,3,7123,[ 97 423  79 435  88],378,5,31238,4.3848961257720385,0.0,0.0
37124,3,7124,[175 118 475 385 202],343,3,31241,4.384701754385965,0.0,0.0
37125,3,7125,[302 427 603 100  64],339,5,31246,4.384788099915801,20.0,20.0
37126,3,7126,[302 427 603 100  64],666,5,31251,4.384874421215097,20.0,20.0
37127,3,7127,[302 427 603 100  64],271,5,31256,4.384960718294051,20.0,20.0
37128,3,7128,[302 427 603 100  64],537,4,31260,4.384906719034928,20.0,20.0
37129,3,7129,[302 427 603 100  64],13,5,31265,4.384992987377279,20.0,20.0
37130,3,7130,[175 385 257  98   8],474,4,31269,4.384938998737905,0.0,20.0
37131,3,7131,[187 100  12 211 200],311,3,31272,4.3847448121144135,20.0,20.0
37132,3,7132,[302 427 603 100  64],664,5,31277,4.384831066872284,20.0,20.0
37133,3,7133,[302 427 603 100  64],537,4,31281,4.384777123633305,20.0,20.0
37134,3,7134,[302 427 603 100  64],13,5,31286,4.384863349684653,20.0,20.0
37135,3,7135,[ 71  89 173 182  88],506,5,31291,4.384949551569507,0.0,0.0
37136,3,7136,[302 427 603 100  64],458,5,31296,4.385035729298024,20.0,20.0
37137,3,7137,[423 117 144 175 471],479,3,31299,4.384841692350799,0.0,0.0
37138,3,7138,[385  89  25 588 143],7,3,31302,4.384647709763272,0.0,0.0
37139,3,7139,[ 97 191 135 471 176],271,3,31305,4.3844537815126055,0.0,0.0
37140,3,7140,[302 427 603 100  64],370,5,31310,4.384539980394902,20.0,20.0
37141,3,7141,[216 405 427 483  70],537,3,31313,4.384346121534584,20.0,0.0
37142,3,7142,[ 15  89 294 235 276],200,4,31317,4.384292314153717,0.0,0.0
37143,3,7143,[302 427 603 100  64],454,5,31322,4.384378499440089,20.0,20.0
37144,3,7144,[302 427 603 100  64],271,5,31327,4.38446466060182,20.0,20.0
37145,3,7145,[302 427 603 100  64],458,5,31332,4.384550797649035,20.0,20.0
37146,3,7146,[302 427 603 100  64],370,5,31337,4.384636910591857,20.0,20.0
37147,3,7147,[300  79 282 234 568],788,3,31340,4.3844432008953556,0.0,0.0
37148,3,7148,[302 427 603 100  64],271,5,31345,4.384529304797874,20.0,20.0
37149,3,7149,[302 427 603 100  64],745,5,31350,4.384615384615385,20.0,20.0
37150,3,7150,[302 427 603 100  64],664,5,31355,4.384701440357992,20.0,20.0
37151,3,7151,[302 427 603 100  64],458,5,31360,4.384787472035794,20.0,20.0
37152,3,7152,[302 427 603 100  64],271,5,31365,4.384873479658884,20.0,20.0
37153,3,7153,[302 427 603 100  64],664,5,31370,4.38495946323735,20.0,20.0
37154,3,7154,[302 427 603 100  64],474,5,31375,4.385045422781272,20.0,20.0
37155,3,7155,[302 427 603 100  64],454,5,31380,4.385131358300726,20.0,20.0
37156,3,7156,[302 427 603 100  64],458,5,31385,4.385217269805785,20.0,20.0
37157,3,7157,[405 508 143 302 181],524,2,31387,4.384884045822855,0.0,0.0
37158,3,7158,[200 235 132 597 300],378,3,31390,4.384690599245705,0.0,0.0
37159,3,7159,[302 427 603 100  64],90,5,31395,4.384776536312849,20.0,20.0
37160,3,7160,[302 427 603 100  64],454,5,31400,4.384862449378579,20.0,20.0
37161,3,7161,[302 427 603 100  64],370,5,31405,4.384948338452946,20.0,20.0
37162,3,7162,[302 427 603 100  64],537,4,31409,4.384894597235795,20.0,20.0
37163,3,7163,[302 427 603 100  64],13,5,31414,4.3849804578447795,20.0,20.0
37164,3,7164,[132 168 403  89 182],7,5,31419,4.38506629448709,0.0,0.0
37165,3,7165,[302 427 603 100  64],271,5,31424,4.38515210717276,20.0,20.0
37166,3,7166,[435 427 185 313 234],90,5,31429,4.385237895911818,0.0,0.0
37167,3,7167,[302 427 603 100  64],666,5,31434,4.385323660714286,20.0,20.0
37168,3,7168,[234 328 100 117 603],313,5,31439,4.38540940159018,20.0,20.0
37169,3,7169,[135 211 403 172  97],804,3,31442,4.385216178521618,0.0,0.0
37170,3,7170,[302 427 603 100  64],474,5,31447,4.385301910472737,20.0,20.0
37171,3,7171,[302 427 603 100  64],370,5,31452,4.385387618516453,20.0,20.0
37172,3,7172,[273 144 471 301   7],13,1,31453,4.384915655931967,0.0,0.0
37173,3,7173,[183  28 423 294 546],234,3,31456,4.384722609422916,0.0,0.0
37174,3,7174,[302 427 603 100  64],474,5,31461,4.384808362369338,20.0,20.0
37175,3,7175,[ 70 118 202 508 191],13,2,31463,4.384476031215161,0.0,0.0
37176,3,7176,[302 427 603 100  64],745,5,31468,4.384561794621709,20.0,20.0
37177,3,7177,[302 427 603 100  64],13,5,31473,4.38464753413207,20.0,20.0
37178,3,7178,[302 427 603 100  64],90,5,31478,4.384733249756233,20.0,20.0
37179,3,7179,[302 427 603 100  64],666,5,31483,4.384818941504178,20.0,20.0
37180,3,7180,[302 427 603 100  64],370,5,31488,4.384904609385879,20.0,20.0
37181,3,7181,[302 427 603 100  64],90,5,31493,4.384990253411306,20.0,20.0
37182,3,7182,[568   4 211 323 215],804,5,31498,4.385075873590422,0.0,0.0
37183,3,7183,[302 427 603 100  64],339,5,31503,4.385161469933185,20.0,20.0
37184,3,7184,[302 427 603 100  64],745,5,31508,4.3852470424495475,20.0,20.0
37185,3,7185,[302 427 603 100  64],458,5,31513,4.385332591149457,20.0,20.0
37186,3,7186,[302 427 603 100  64],339,5,31518,4.385418116042855,20.0,20.0
37187,3,7187,[182   7 385 471 282],194,0,31518,4.384808013355593,0.0,0.0
37188,3,7188,[ 98 313 435  79 333],64,4,31522,4.3847544860203085,0.0,20.0
37189,3,7189,[302 427 603 100  64],454,5,31527,4.384840055632823,20.0,20.0
37190,3,7190,[508 176  69 568 228],774,3,31530,4.384647476011681,0.0,0.0
37191,3,7191,[302 427 603 100  64],454,5,31535,4.384733036707453,20.0,20.0
37192,3,7192,[302 427 603 100  64],537,4,31539,4.384679549562074,20.0,20.0
37193,3,7193,[215 175 153  69  25],184,2,31541,4.384348067834306,0.0,0.0
37194,3,7194,[302 427 603 100  64],271,5,31546,4.3844336344683805,20.0,20.0
37195,3,7195,[302 427 603 100  64],745,5,31551,4.384519177320734,20.0,20.0
37196,3,7196,[405 174 333 196  70],334,3,31554,4.384326802834514,0.0,20.0
37197,3,7197,[175 288  98 265   7],804,4,31558,4.384273409280356,0.0,20.0
37198,3,7198,[302 427 603 100  64],745,5,31563,4.384358938741492,20.0,20.0
37199,3,7199,[302 427 603 100  64],370,5,31568,4.384444444444444,20.0,20.0
37200,3,7200,[302 427 603 100  64],454,5,31573,4.384529926399111,20.0,20.0
37201,3,7201,[204 275 100 211 172],883,5,31578,4.384615384615385,0.0,20.0
37202,3,7202,[302 427 603 100  64],474,5,31583,4.384700819103151,20.0,20.0
37203,3,7203,[302 427 603 100  64],271,5,31588,4.384786229872293,20.0,20.0
37204,3,7204,[302 427 603 100  64],664,5,31593,4.384871616932686,20.0,20.0
37205,3,7205,[302 427 603 100  64],666,5,31598,4.3849569802941994,20.0,20.0
37206,3,7206,[302 427 603 100  64],370,5,31603,4.385042319966699,20.0,20.0
37207,3,7207,[302 427 603 100  64],666,5,31608,4.385127635960044,20.0,20.0
37208,3,7208,[302 427 603 100  64],13,5,31613,4.38521292828409,20.0,20.0
37209,3,7209,[302 427 603 100  64],666,5,31618,4.385298196948682,20.0,20.0
37210,3,7210,[302 427 603 100  64],370,5,31623,4.385383441963667,20.0,20.0
37211,3,7211,[302 427 603 100  64],458,5,31628,4.385468663338879,20.0,20.0
37212,3,7212,[302 427 603 100  64],370,5,31633,4.385553861084154,20.0,20.0
37213,3,7213,[302 427 603 100  64],745,5,31638,4.385639035209315,20.0,20.0
37214,3,7214,[302 427 603 100  64],370,5,31643,4.385724185724186,20.0,20.0
37215,3,7215,[302 427 603 100  64],370,5,31648,4.385809312638581,20.0,20.0
37216,3,7216,[302 427 603 100  64],537,4,31652,4.385755854233061,20.0,20.0
37217,3,7217,[179 318 127 435 143],194,4,31656,4.385702410640066,20.0,20.0
37218,3,7218,[302 427 603 100  64],664,5,31661,4.385787505194625,20.0,20.0
37219,3,7219,[302 427 603 100  64],370,5,31666,4.385872576177285,20.0,20.0
37220,3,7220,[257  15 234   1 286],378,5,31671,4.3859576235978395,0.0,0.0
37221,3,7221,[302 427 603 100  64],339,5,31676,4.386042647466076,20.0,20.0
37222,3,7222,[302 427 603 100  64],666,5,31681,4.386127647791776,20.0,20.0
37223,3,7223,[302 427 603 100  64],13,5,31686,4.386212624584718,20.0,20.0
37224,3,7224,[302 427 603 100  64],271,5,31691,4.386297577854672,20.0,20.0
37225,3,7225,[302 427 603 100  64],454,5,31696,4.386382507611403,20.0,20.0
37226,3,7226,[196 143 195 228  71],374,2,31698,4.386052303860523,0.0,0.0
37227,3,7227,[302 427 603 100  64],664,5,31703,4.386137244050913,20.0,20.0
37228,3,7228,[322 357 185 234 588],537,2,31705,4.385807165583068,20.0,0.0
37229,3,7229,[302 427 603 100  64],664,5,31710,4.385892116182573,20.0,20.0
37230,3,7230,[302 427 603 100  64],271,5,31715,4.385977043285853,20.0,20.0
37231,3,7231,[302 427 603 100  64],271,5,31720,4.386061946902655,20.0,20.0
37232,3,7232,[301 181 215 144 172],328,3,31723,4.385870316604452,0.0,0.0
37233,3,7233,[302 427 603 100  64],13,5,31728,4.385955211501244,20.0,20.0
37234,3,7234,[302 427 603 100  64],474,5,31733,4.3860400829302,20.0,20.0
37235,3,7235,[302 427 603 100  64],271,5,31738,4.38612493090105,20.0,20.0
37236,3,7236,[144 197 748 427 328],13,4,31742,4.386071576620147,0.0,0.0
37237,3,7237,[302 427 603 100  64],454,5,31747,4.386156396794695,20.0,20.0
37238,3,7238,[302 427 603 100  64],745,5,31752,4.386241193535018,20.0,20.0
37239,3,7239,[302 427 603 100  64],90,5,31757,4.386325966850829,20.0,20.0
37240,3,7240,[302 427 603 100  64],271,5,31762,4.38641071675183,20.0,20.0
37241,3,7241,[302 427 603 100  64],339,5,31767,4.386495443247721,20.0,20.0
37242,3,7242,[302 427 603 100  64],474,5,31772,4.386580146348198,20.0,20.0
37243,3,7243,[175 200 357 235 143],339,4,31776,4.386526780784097,20.0,0.0
37244,3,7244,[168  88 265 132 174],474,4,31780,4.386473429951691,0.0,20.0
37245,3,7245,[234 655 118 288 328],102,0,31780,4.3858680651393875,0.0,0.0
37246,3,7246,[302 427 603 100  64],90,5,31785,4.385952808058507,20.0,20.0
37247,3,7247,[302 427 603 100  64],745,5,31790,4.386037527593819,20.0,20.0
37248,3,7248,[269  98 289 282   9],455,3,31793,4.385846323630846,0.0,20.0
37249,3,7249,[118 127   1 182 100],158,5,31798,4.385931034482758,0.0,40.0
37250,3,7250,[302 427 603 100  64],458,5,31803,4.386015721969383,20.0,20.0
37251,3,7251,[302 427 603 100  64],537,4,31807,4.3859624931053505,20.0,20.0
37252,3,7252,[302 427 603 100  64],13,5,31812,4.386047152902248,20.0,20.0
37253,3,7253,[302 427 603 100  64],666,5,31817,4.386131789357596,20.0,20.0
37254,3,7254,[302 427 603 100  64],339,5,31822,4.386216402481048,20.0,20.0
37255,3,7255,[302 427 603 100  64],271,5,31827,4.38630099228225,20.0,20.0
37256,3,7256,[302 427 603 100  64],474,5,31832,4.386385558770842,20.0,20.0
37257,3,7257,[302 427 603 100  64],474,5,31837,4.386470101956462,20.0,20.0
37258,3,7258,[ 71 235 181   7 275],524,0,31837,4.385865821738531,0.0,0.0
37259,3,7259,[302 427 603 100  64],745,5,31842,4.38595041322314,20.0,20.0
37260,3,7260,[ 97 313 176  69 117],455,3,31845,4.385759537253822,0.0,0.0
37261,3,7261,[302 427 603 100  64],458,5,31850,4.385844120077114,20.0,20.0
37262,3,7262,[100 197 275  97 276],406,4,31854,4.385790995456423,0.0,20.0
37263,3,7263,[302 427 603 100  64],13,5,31859,4.385875550660793,20.0,20.0
37264,3,7264,[302 427 603 100  64],458,5,31864,4.38596008258775,20.0,20.0
37265,3,7265,[302 427 603 100  64],537,4,31868,4.385906963941646,20.0,20.0
37266,3,7266,[302 427 603 100  64],454,5,31873,4.385991468281271,20.0,20.0
37267,3,7267,[302 427 603 100  64],13,5,31878,4.386075949367089,20.0,20.0
37268,3,7268,[302 427 603 100  64],13,5,31883,4.386160407208695,20.0,20.0
37269,3,7269,[302 427 603 100  64],745,5,31888,4.386244841815681,20.0,20.0
37270,3,7270,[302 427 603 100  64],339,5,31893,4.386329253197634,20.0,20.0
37271,3,7271,[302 427 603 100  64],745,5,31898,4.386413641364136,20.0,20.0
37272,3,7272,[302 427 603 100  64],370,5,31903,4.3864980063247625,20.0,20.0
37273,3,7273,[403   7  70 323  95],378,4,31907,4.386444872147374,0.0,0.0
37274,3,7274,[302 427 603 100  64],458,5,31912,4.386529209621993,20.0,20.0
37275,3,7275,[302 427 603 100  64],271,5,31917,4.386613523914239,20.0,20.0
37276,3,7276,[678   7 234   1 202],881,3,31920,4.386422976501305,0.0,0.0
37277,3,7277,[175 257  96 403 100],653,2,31922,4.386095081066227,0.0,20.0
37278,3,7278,[191  96  95 197 174],387,3,31925,4.385904657233136,0.0,20.0
37279,3,7279,[302 427 603 100  64],339,5,31930,4.385989010989011,20.0,20.0
37280,3,7280,[302   1 215 235 238],343,5,31935,4.38607334157396,0.0,0.0
37281,3,7281,[302 427 603 100  64],271,5,31940,4.3861576489975285,20.0,20.0
37282,3,7282,[302 427 603 100  64],664,5,31945,4.3862419332692575,20.0,20.0
37283,3,7283,[216 194 176 742 100],313,4,31949,4.38618890719385,0.0,20.0
37284,3,7284,[302 427 603 100  64],13,5,31954,4.38627316403569,20.0,20.0
37285,3,7285,[302 427 603 100  64],458,5,31959,4.386357397749108,20.0,20.0
37286,3,7286,[302 427 603 100  64],339,5,31964,4.386441608343626,20.0,20.0
37287,3,7287,[161 302 194 200   7],10,5,31969,4.38652579582876,0.0,0.0
37288,3,7288,[302 427 603 100  64],271,5,31974,4.386609960214021,20.0,20.0
37289,3,7289,[302 427 603 100  64],537,4,31978,4.386556927297668,20.0,20.0
37290,3,7290,[302 427 603 100  64],370,5,31983,4.3866410643258815,20.0,20.0
37291,3,7291,[302 427 603 100  64],13,5,31988,4.3867251782775645,20.0,20.0
37292,3,7292,[603 179 118 588 357],848,3,31991,4.386535033593857,40.0,0.0
37293,3,7293,[237 294 176  11  28],271,3,31994,4.386344941047437,0.0,0.0
37294,3,7294,[302 427 603 100  64],474,5,31999,4.386429061000685,20.0,20.0
37295,3,7295,[302 427 603 100  64],339,5,32004,4.386513157894737,20.0,20.0
37296,3,7296,[302 427 603 100  64],537,4,32008,4.386460189118816,20.0,20.0
37297,3,7297,[302 427 603 100  64],454,5,32013,4.386544258701014,20.0,20.0
37298,3,7298,[302 427 603 100  64],474,5,32018,4.386628305247294,20.0,20.0
37299,3,7299,[168  69 204  96 483],374,3,32021,4.386438356164383,20.0,0.0
37300,3,7300,[302 427 603 100  64],339,5,32026,4.386522394192577,20.0,20.0
37301,3,7301,[302 427 603 100  64],666,5,32031,4.386606409202958,20.0,20.0
37302,3,7302,[748 195 196 318 302],346,3,32034,4.386416541147474,20.0,0.0
37303,3,7303,[ 89 655 172 125   9],881,4,32038,4.386363636363637,0.0,0.0
37304,3,7304,[302 427 603 100  64],271,5,32043,4.386447638603696,20.0,20.0
37305,3,7305,[655 153  82 328   8],313,2,32045,4.3861209964412815,0.0,0.0
37306,3,7306,[302 427 603 100  64],271,5,32050,4.38620500889558,20.0,20.0
37307,3,7307,[302 427 603 100  64],474,5,32055,4.386288998357964,20.0,20.0
37308,3,7308,[302 427 603 100  64],13,5,32060,4.3863729648378715,20.0,20.0
37309,3,7309,[302 427 603 100  64],454,5,32065,4.386456908344734,20.0,20.0
37310,3,7310,[302 427 603 100  64],90,5,32070,4.386540828887977,20.0,20.0
37311,3,7311,[302 427 603 100  64],271,5,32075,4.386624726477024,20.0,20.0
37312,3,7312,[289 100 423  95 202],271,5,32080,4.386708601121291,0.0,20.0
37313,3,7313,[302 427 603 100  64],458,5,32085,4.386792452830188,20.0,20.0
37314,3,7314,[302 427 603 100  64],745,5,32090,4.386876281613124,20.0,20.0
37315,3,7315,[302 427 603 100  64],271,5,32095,4.386960087479497,20.0,20.0
37316,3,7316,[302 427 603 100  64],271,5,32100,4.3870438704387045,20.0,20.0
37317,3,7317,[302 427 603 100  64],454,5,32105,4.387127630500137,20.0,20.0
37318,3,7318,[302 427 603 100  64],271,5,32110,4.38721136767318,20.0,20.0
37319,3,7319,[302 427 603 100  64],537,4,32114,4.387158469945355,20.0,20.0
37320,3,7320,[302 427 603 100  64],13,5,32119,4.387242180030051,20.0,20.0
37321,3,7321,[179 172 322 132 237],308,2,32121,4.386916143130292,0.0,0.0
37322,3,7322,[427 204 100  69 237],308,3,32124,4.386726751331421,0.0,20.0
37323,3,7323,[302 427 603 100  64],458,5,32129,4.386810486073184,20.0,20.0
37324,3,7324,[302 427 603 100  64],664,5,32134,4.386894197952218,20.0,20.0
37325,3,7325,[302 427 603 100  64],454,5,32139,4.386977886977887,20.0,20.0
37326,3,7326,[302 427 603 100  64],666,5,32144,4.387061553159547,20.0,20.0
37327,3,7327,[302 427 603 100  64],474,5,32149,4.38714519650655,20.0,20.0
37328,3,7328,[302 427 603 100  64],339,5,32154,4.387228817028244,20.0,20.0
37329,3,7329,[302 427 603 100  64],370,5,32159,4.38731241473397,20.0,20.0
37330,3,7330,[471 175 318 313   4],474,4,32163,4.387259582594462,20.0,0.0
37331,3,7331,[302 427 603 100  64],370,5,32168,4.3873431533006,20.0,20.0
37332,3,7332,[302 427 603 100  64],454,5,32173,4.387426701213691,20.0,20.0
37333,3,7333,[302 427 603 100  64],271,5,32178,4.38751022634306,20.0,20.0
37334,3,7334,[302 427 603 100  64],271,5,32183,4.3875937286980236,20.0,20.0
37335,3,7335,[302 427 603 100  64],745,5,32188,4.387677208287895,20.0,20.0
37336,3,7336,[302 427 603 100  64],474,5,32193,4.387760665121984,20.0,20.0
37337,3,7337,[302 427 603 100  64],458,5,32198,4.387844099209594,20.0,20.0
37338,3,7338,[302 427 603 100  64],666,5,32203,4.387927510560022,20.0,20.0
37339,3,7339,[ 28 748 118 323 111],13,4,32207,4.387874659400545,0.0,0.0
37340,3,7340,[  8 211 405 132  71],313,3,32210,4.387685601416701,0.0,0.0
37341,3,7341,[197   9 174 323 183],374,3,32213,4.3874965949332605,0.0,20.0
37342,3,7342,[302 427 603 100  64],664,5,32218,4.387580008171048,20.0,20.0
37343,3,7343,[202 234 117 143 222],343,3,32221,4.387391067538126,0.0,0.0
37344,3,7344,[302 427 603 100  64],666,5,32226,4.387474472430225,20.0,20.0
37345,3,7345,[302 427 603 100  64],339,5,32231,4.387557854614756,20.0,20.0
37346,3,7346,[302 427 603 100  64],90,5,32236,4.387641214100993,20.0,20.0
37347,3,7347,[302 427 603 100  64],474,5,32241,4.387724550898204,20.0,20.0
37348,3,7348,[302 427 603 100  64],370,5,32246,4.387807865015648,20.0,20.0
37349,3,7349,[302 427 603 100  64],13,5,32251,4.387891156462585,20.0,20.0
37350,3,7350,[302 427 603 100  64],370,5,32256,4.387974425248266,20.0,20.0
37351,3,7351,[302 427 603 100  64],90,5,32261,4.388057671381937,20.0,20.0
37352,3,7352,[302 427 603 100  64],474,5,32266,4.388140894872841,20.0,20.0
37353,3,7353,[195  12  56 222 271],145,5,32271,4.388224095730215,20.0,0.0
37354,3,7354,[302 427 603 100  64],13,5,32276,4.3883072739632905,20.0,20.0
37355,3,7355,[323  28 180   1  89],59,4,32280,4.388254486133769,0.0,0.0
37356,3,7356,[302 427 603 100  64],458,5,32285,4.388337637624032,20.0,20.0
37357,3,7357,[  4  22 475 742 182],144,3,32288,4.388148953519979,0.0,0.0
37358,3,7358,[302 427 603 100  64],90,5,32293,4.388232096752276,20.0,20.0
37359,3,7359,[302 427 603 100  64],90,5,32298,4.3883152173913045,20.0,20.0
37360,3,7360,[302 427 603 100  64],13,5,32303,4.3883983154462705,20.0,20.0
37361,3,7361,[302 427 603 100  64],271,5,32308,4.388481390926379,20.0,20.0
37362,3,7362,[187  50 273  79 183],774,2,32310,4.388157001222328,0.0,20.0
37363,3,7363,[210 175 237 135 427],934,5,32315,4.388240086909288,0.0,0.0
37364,3,7364,[ 69 655 318 748  82],488,4,32319,4.3881873727087575,20.0,0.0
37365,3,7365,[302 427 603 100  64],271,5,32324,4.388270431713277,20.0,20.0
37366,3,7366,[302 427 603 100  64],458,5,32329,4.388353468168861,20.0,20.0
37367,3,7367,[385 588 195 357   7],650,4,32333,4.388300760043431,20.0,0.0
37368,3,7368,[302 427 603 100  64],339,5,32338,4.388383769846655,20.0,20.0
37369,3,7369,[302 427 603 100  64],454,5,32343,4.3884667571234734,20.0,20.0
37370,3,7370,[302 427 603 100  64],339,5,32348,4.388549721883055,20.0,20.0
37371,3,7371,[302 427 603 100  64],454,5,32353,4.388632664134564,20.0,20.0
37372,3,7372,[302 427 603 100  64],339,5,32358,4.388715583887156,20.0,20.0
37373,3,7373,[302 427 603 100  64],474,5,32363,4.388798481149986,20.0,20.0
37374,3,7374,[302 427 603 100  64],474,5,32368,4.388881355932203,20.0,20.0
37375,3,7375,[302 427 603 100  64],537,4,32372,4.38882863340564,20.0,20.0
37376,3,7376,[302 427 603 100  64],271,5,32377,4.3889114816321,20.0,20.0
37377,3,7377,[302 427 603 100  64],666,5,32382,4.388994307400379,20.0,20.0
37378,3,7378,[302 427 603 100  64],458,5,32387,4.38907711071961,20.0,20.0
37379,3,7379,[168 186 275  64 211],125,3,32390,4.388888888888889,0.0,0.0
37380,3,7380,[597  79 546 144   7],7,4,32394,4.388836201056767,0.0,0.0
37381,3,7381,[302 427 603 100  64],339,5,32399,4.388918992143051,20.0,20.0
37382,3,7382,[302 427 603 100  64],474,5,32404,4.389001760801842,20.0,20.0
37383,3,7383,[302 427 603 100  64],537,4,32408,4.388949079089924,20.0,20.0
37384,3,7384,[302 427 603 100  64],90,5,32413,4.38903182125931,20.0,20.0
37385,3,7385,[302 427 603 100  64],370,5,32418,4.389114541023558,20.0,20.0
37386,3,7386,[302 427 603 100  64],271,5,32423,4.38919723839177,20.0,20.0
37387,3,7387,[302 427 603 100  64],745,5,32428,4.389279913373038,20.0,20.0
37388,3,7388,[302 427 603 100  64],458,5,32433,4.389362565976452,20.0,20.0
37389,3,7389,[496 179 405 181 546],524,2,32435,4.389039242219215,0.0,0.0
37390,3,7390,[ 50  69 222  89  98],653,3,32438,4.388851305641997,0.0,40.0
37391,3,7391,[302 427 603 100  64],537,4,32442,4.388798701298701,20.0,20.0
37392,3,7392,[302 427 603 100  64],458,5,32447,4.388881374272961,20.0,20.0
37393,3,7393,[ 28  22 182 117 172],454,2,32449,4.388558290505816,0.0,0.0
37394,3,7394,[357 435 202 405 143],59,3,32452,4.388370520622042,20.0,0.0
37395,3,7395,[302 427 603 100  64],339,5,32457,4.388453217955652,20.0,20.0
37396,3,7396,[435 153   7 216 568],378,5,32462,4.388535892929566,0.0,0.0
37397,3,7397,[302 427 603 100  64],13,5,32467,4.388618545552852,20.0,20.0
37398,3,7398,[  8 333 302 245 318],328,3,32470,4.388430869036356,20.0,0.0
37399,3,7399,[302 427 603 100  64],454,5,32475,4.388513513513513,20.0,20.0
37400,3,7400,[302 427 603 100  64],474,5,32480,4.388596135657344,20.0,20.0
37401,3,7401,[302 427 603 100  64],666,5,32485,4.388678735476899,20.0,20.0
37402,3,7402,[302 427 603 100  64],458,5,32490,4.388761312981224,20.0,20.0
37403,3,7403,[302 427 603 100  64],537,4,32494,4.388708806050784,20.0,20.0
37404,3,7404,[302 427 603 100  64],13,5,32499,4.388791357191087,20.0,20.0
37405,3,7405,[302 427 603 100  64],666,5,32504,4.388873886038347,20.0,20.0
37406,3,7406,[302 427 603 100  64],474,5,32509,4.388956392601593,20.0,20.0
37407,3,7407,[302 427 603 100  64],370,5,32514,4.389038876889849,20.0,20.0
37408,3,7408,[302 427 603 100  64],13,5,32519,4.389121338912134,20.0,20.0
37409,3,7409,[302 427 603 100  64],90,5,32524,4.389203778677463,20.0,20.0
37410,3,7410,[302 427 603 100  64],458,5,32529,4.3892861961948455,20.0,20.0
37411,3,7411,[302 427 603 100  64],537,4,32533,4.3892336751214245,20.0,20.0
37412,3,7412,[302 427 603 100  64],474,5,32538,4.389316066369891,20.0,20.0
37413,3,7413,[302 427 603 100  64],458,5,32543,4.389398435392501,20.0,20.0
37414,3,7414,[302 427 603 100  64],745,5,32548,4.3894807821982464,20.0,20.0
37415,3,7415,[302 427 603 100  64],271,5,32553,4.389563106796117,20.0,20.0
37416,3,7416,[302 427 603 100  64],454,5,32558,4.389645409195093,20.0,20.0
37417,3,7417,[302 427 603 100  64],664,5,32563,4.389727689404152,20.0,20.0
37418,3,7418,[302 427 603 100  64],664,5,32568,4.389809947432268,20.0,20.0
37419,3,7419,[302 427 603 100  64],474,5,32573,4.38989218328841,20.0,20.0
37420,3,7420,[181 546 195 204 194],95,4,32577,4.389839644252796,0.0,0.0
37421,3,7421,[302 427 603 100  64],454,5,32582,4.389921853947723,20.0,20.0
37422,3,7422,[302 427 603 100  64],271,5,32587,4.3900040414926575,20.0,20.0
37423,3,7423,[302 427 603 100  64],458,5,32592,4.390086206896552,20.0,20.0
37424,3,7424,[302 427 603 100  64],13,5,32597,4.39016835016835,20.0,20.0
37425,3,7425,[302 427 603 100  64],90,5,32602,4.390250471316994,20.0,20.0
37426,3,7426,[302 427 603 100  64],537,4,32606,4.390197926484449,20.0,20.0
37427,3,7427,[302 427 603 100  64],13,5,32611,4.390280021540119,20.0,20.0
37428,3,7428,[ 96 228 194 403 187],804,4,32615,4.390227486875757,0.0,0.0
37429,3,7429,[302 427 603 100  64],339,5,32620,4.390309555854643,20.0,20.0
37430,3,7430,[302 427 603 100  64],666,5,32625,4.3903916027452565,20.0,20.0
37431,3,7431,[176 276  25 196 111],13,3,32628,4.390204520990312,0.0,0.0
37432,3,7432,[302 427 603 100  64],664,5,32633,4.390286559935423,20.0,20.0
37433,3,7433,[179   8 211 180 515],474,5,32638,4.390368576809255,0.0,0.0
37434,3,7434,[302 427 603 100  64],664,5,32643,4.390450571620713,20.0,20.0
37435,3,7435,[302 427 603 100  64],474,5,32648,4.390532544378698,20.0,20.0
37436,3,7436,[302 427 603 100  64],339,5,32653,4.390614495092107,20.0,20.0
37437,3,7437,[153 475  56 183  71],64,3,32656,4.390427534283409,0.0,0.0
37438,3,7438,[302 427 603 100  64],454,5,32661,4.390509477080252,20.0,20.0
37439,3,7439,[302 427 603 100  64],745,5,32666,4.390591397849462,20.0,20.0
37440,3,7440,[216 100 204 197 234],840,5,32671,4.390673296599919,0.0,20.0
37441,3,7441,[302 427 603 100  64],339,5,32676,4.3907551733405,20.0,20.0
37442,3,7442,[302 427 603 100  64],537,4,32680,4.390702673653097,20.0,20.0
37443,3,7443,[302 427 603 100  64],458,5,32685,4.390784524449221,20.0,20.0
37444,3,7444,[ 56  88 197 258  22],339,4,32689,4.390732034922767,0.0,0.0
37445,3,7445,[302 427 603 100  64],271,5,32694,4.390813859790492,20.0,20.0
37446,3,7446,[302 427 603 100  64],537,4,32698,4.3907613804216465,20.0,20.0
37447,3,7447,[302 427 603 100  64],90,5,32703,4.390843179377014,20.0,20.0
37448,3,7448,[302 427 603 100  64],370,5,32708,4.390924956369982,20.0,20.0
37449,3,7449,[118  15 748   7 181],881,3,32711,4.390738255033557,0.0,0.0
37450,3,7450,[302 427 603 100  64],90,5,32716,4.390820024157831,20.0,20.0
37451,3,7451,[302 427 603 100  64],370,5,32721,4.390901771336554,20.0,20.0
37452,3,7452,[302 427 603 100  64],454,5,32726,4.390983496578559,20.0,20.0
37453,3,7453,[195 318 202 271 385],883,3,32729,4.39079688757714,20.0,0.0
37454,3,7454,[ 95  96  56 294 135],406,4,32733,4.390744466800805,0.0,0.0
37455,3,7455,[183 289  70 288  98],537,1,32734,4.390289699570816,0.0,20.0
37456,3,7456,[302 427 603 100  64],537,4,32738,4.390237360868982,20.0,20.0
37457,3,7457,[269 271  97   1 168],738,2,32740,4.389916867792974,0.0,0.0
37458,3,7458,[302 427 603 100  64],339,5,32745,4.389998659337713,20.0,20.0
37459,3,7459,[302 427 603 100  64],271,5,32750,4.390080428954423,20.0,20.0
37460,3,7460,[302 427 603 100  64],339,5,32755,4.390162176651923,20.0,20.0
37461,3,7461,[186 357 483  95   9],59,4,32759,4.3901098901098905,40.0,0.0
37462,3,7462,[302 427 603 100  64],90,5,32764,4.390191611952298,20.0,20.0
37463,3,7463,[302 427 603 100  64],745,5,32769,4.390273311897106,20.0,20.0
37464,3,7464,[211  79 195 180  89],6,4,32773,4.390221031480241,0.0,0.0
37465,3,7465,[302 427 603 100  64],271,5,32778,4.390302705598714,20.0,20.0
37466,3,7466,[302 427 603 100  64],90,5,32783,4.390384357841167,20.0,20.0
37467,3,7467,[194 175 655 423 132],313,5,32788,4.39046598821639,0.0,0.0
37468,3,7468,[302 427 603 100  64],745,5,32793,4.390547596733164,20.0,20.0
37469,3,7469,[302 427 603 100  64],271,5,32798,4.390629183400268,20.0,20.0
37470,3,7470,[302 427 603 100  64],90,5,32803,4.390710748226476,20.0,20.0
37471,3,7471,[ 79 176  25 118 258],13,2,32805,4.39039079229122,0.0,0.0
37472,3,7472,[302 427 603 100  64],370,5,32810,4.390472367188545,20.0,20.0
37473,3,7473,[288 222 678 603 216],334,2,32812,4.39015252876639,20.0,0.0
37474,3,7474,[302 427 603 100  64],339,5,32817,4.390234113712374,20.0,20.0
37475,3,7475,[318 196  56 185  12],308,4,32821,4.390181915462814,40.0,0.0
37476,3,7476,[302 427 603 100  64],458,5,32826,4.390263474655611,20.0,20.0
37477,3,7477,[302 427 603 100  64],745,5,32831,4.390345012035303,20.0,20.0
37478,3,7478,[302 427 603 100  64],454,5,32836,4.390426527610643,20.0,20.0
37479,3,7479,[302 427 603 100  64],271,5,32841,4.390508021390374,20.0,20.0
37480,3,7480,[302 427 603 100  64],666,5,32846,4.390589493383238,20.0,20.0
37481,3,7481,[153 121 237 385 403],64,3,32849,4.390403635391607,0.0,0.0
37482,3,7482,[302 427 603 100  64],666,5,32854,4.390485099559,20.0,20.0
37483,3,7483,[302 427 603 100  64],370,5,32859,4.390566541956173,20.0,20.0
37484,3,7484,[302 427 603 100  64],474,5,32864,4.39064796259185,20.0,20.0
37485,3,7485,[302 427 603 100  64],666,5,32869,4.390729361474753,20.0,20.0
37486,3,7486,[302 427 603 100  64],474,5,32874,4.390810738613597,20.0,20.0
37487,3,7487,[302 427 603 100  64],537,4,32878,4.390758547008547,20.0,20.0
37488,3,7488,[302 427 603 100  64],90,5,32883,4.390839898517826,20.0,20.0
37489,3,7489,[302 427 603 100  64],474,5,32888,4.390921228304406,20.0,20.0
37490,3,7490,[302 427 603 100  64],666,5,32893,4.391002536376986,20.0,20.0
37491,3,7491,[153  88 385 100 117],207,1,32894,4.390549919914576,0.0,20.0
37492,3,7492,[302 427 603 100  64],458,5,32899,4.390631255838783,20.0,20.0
37493,3,7493,[302 427 603 100  64],458,5,32904,4.390712570056045,20.0,20.0
37494,3,7494,[ 82  11 435 183 161],881,3,32907,4.390527018012008,0.0,0.0
37495,3,7495,[302 427 603 100  64],271,5,32912,4.390608324439701,20.0,20.0
37496,3,7496,[515 195  89   8 423],543,4,32916,4.390556222488995,0.0,0.0
37497,3,7497,[302 427 603 100  64],458,5,32921,4.390637503334222,20.0,20.0
37498,3,7498,[161 546 423 202 234],648,4,32925,4.3905854113881855,0.0,0.0
37499,3,7499,[197 174 238 175 568],881,2,32927,4.390266666666666,0.0,20.0
37500,3,7500,[302 427 603 100  64],454,5,32932,4.390347953606186,20.0,20.0
37501,3,7501,[546 483  12  79 435],308,3,32935,4.390162623300453,40.0,0.0
37502,3,7502,[357 333  22  12 143],533,4,32939,4.3901106224177,40.0,0.0
37503,3,7503,[302 427 603 100  64],13,5,32944,4.390191897654584,20.0,20.0
37504,3,7504,[435 121  95 196 173],13,4,32948,4.390139906728847,0.0,0.0
37505,3,7505,[302 427 603 100  64],474,5,32953,4.390221156408207,20.0,20.0
37506,3,7506,[302 427 603 100  64],454,5,32958,4.390302384441188,20.0,20.0
37507,3,7507,[302 427 603 100  64],13,5,32963,4.390383590836441,20.0,20.0
37508,3,7508,[483  95 197 161 323],374,3,32966,4.390198428552404,20.0,0.0
37509,3,7509,[302 427 603 100  64],664,5,32971,4.390279627163782,20.0,20.0
37510,3,7510,[302 427 603 100  64],90,5,32976,4.390360804153907,20.0,20.0
37511,3,7511,[302 427 603 100  64],370,5,32981,4.390441959531416,20.0,20.0
37512,3,7512,[302 427 603 100  64],664,5,32986,4.390523093304938,20.0,20.0
37513,3,7513,[302 427 603 100  64],271,5,32991,4.390604205483098,20.0,20.0
37514,3,7514,[302 427 603 100  64],537,4,32995,4.390552228875582,20.0,20.0
37515,3,7515,[302 427 603 100  64],664,5,33000,4.3906333155934005,20.0,20.0
37516,3,7516,[302 427 603 100  64],745,5,33005,4.390714380736996,20.0,20.0
37517,3,7517,[302 427 603 100  64],90,5,33010,4.390795424314978,20.0,20.0
37518,3,7518,[180 210 176 144 475],92,5,33015,4.390876446335949,0.0,0.0
37519,3,7519,[ 89 515 175 173  50],650,5,33020,4.39095744680851,0.0,20.0
37520,3,7520,[302 427 603 100  64],370,5,33025,4.391038425741258,20.0,20.0
37521,3,7521,[302 427 603 100  64],474,5,33030,4.391119383142781,20.0,20.0
37522,3,7522,[302 427 603 100  64],458,5,33035,4.391200319021667,20.0,20.0
37523,3,7523,[180 200 187 427 175],650,3,33038,4.391015417331206,0.0,0.0
37524,3,7524,[302 427 603 100  64],454,5,33043,4.39109634551495,20.0,20.0
37525,3,7525,[302 427 603 100  64],13,5,33048,4.391177252192399,20.0,20.0
37526,3,7526,[302 427 603 100  64],370,5,33053,4.391258137372127,20.0,20.0
37527,3,7527,[302 427 603 100  64],271,5,33058,4.3913390010627,20.0,20.0
37528,3,7528,[302 427 603 100  64],13,5,33063,4.391419843272679,20.0,20.0
37529,3,7529,[294  82 323 183  50],804,5,33068,4.391500664010624,0.0,20.0
37530,3,7530,[302 427 603 100  64],271,5,33073,4.391581463285088,20.0,20.0
37531,3,7531,[302 427 603 100  64],666,5,33078,4.39166224110462,20.0,20.0
37532,3,7532,[302 427 603 100  64],474,5,33083,4.391742997477764,20.0,20.0
37533,3,7533,[  4 258 403 385 286],13,2,33085,4.391425537563047,0.0,0.0
37534,3,7534,[ 11 100 257 200 196],653,2,33087,4.391108161911082,0.0,20.0
37535,3,7535,[302 427 603 100  64],271,5,33092,4.3911889596602975,20.0,20.0
37536,3,7536,[153 546 161   4   9],328,2,33094,4.390871699615231,0.0,0.0
37537,3,7537,[182 174 471 204 427],666,3,33097,4.39068718492969,0.0,20.0
37538,3,7538,[302 427 603 100  64],666,5,33102,4.390768006366892,20.0,20.0
37539,3,7539,[302 427 603 100  64],537,4,33106,4.390716180371353,20.0,20.0
37540,3,7540,[238 237   8 515 100],474,5,33111,4.3907969765283115,0.0,20.0
37541,3,7541,[302 427 603 100  64],271,5,33116,4.390877751259612,20.0,20.0
37542,3,7542,[302 427 603 100  64],537,4,33120,4.390825931327059,20.0,20.0
37543,3,7543,[302 427 603 100  64],666,5,33125,4.390906680805939,20.0,20.0
37544,3,7544,[302 427 603 100  64],458,5,33130,4.390987408880053,20.0,20.0
37545,3,7545,[302 427 603 100  64],90,5,33135,4.391068115557911,20.0,20.0
37546,3,7546,[302 427 603 100  64],339,5,33140,4.391148800848019,20.0,20.0
37547,3,7547,[302 427 603 100  64],13,5,33145,4.391229464758877,20.0,20.0
37548,3,7548,[302 427 603 100  64],458,5,33150,4.39131010729898,20.0,20.0
37549,3,7549,[302 427 603 100  64],666,5,33155,4.391390728476821,20.0,20.0
37550,3,7550,[302 427 603 100  64],537,4,33159,4.391338895510528,20.0,20.0
37551,3,7551,[302 427 603 100  64],745,5,33164,4.391419491525424,20.0,20.0
37552,3,7552,[302 427 603 100  64],458,5,33169,4.391500066198861,20.0,20.0
37553,3,7553,[275 143 211 282  12],406,2,33171,4.3911834789515485,20.0,0.0
37554,3,7554,[515 200 405 269 180],343,4,33175,4.391131700860357,0.0,0.0
37555,3,7555,[117 151 423 678 238],749,3,33178,4.390947591318158,0.0,0.0
37556,3,7556,[302 427 603 100  64],339,5,33183,4.391028185788011,20.0,20.0
37557,3,7557,[302 427 603 100  64],537,4,33187,4.3909764487959775,20.0,20.0
37558,3,7558,[235 185 197 483 211],313,4,33191,4.39092472549279,20.0,0.0
37559,3,7559,[302 427 603 100  64],666,5,33196,4.391005291005291,20.0,20.0
37560,3,7560,[302 427 603 100  64],666,5,33201,4.391085835206983,20.0,20.0
37561,3,7561,[302 427 603 100  64],90,5,33206,4.391166358106321,20.0,20.0
37562,3,7562,[302 427 603 100  64],13,5,33211,4.391246859711755,20.0,20.0
37563,3,7563,[  4 603  69  28 181],308,3,33214,4.391062929666843,20.0,0.0
37564,3,7564,[302 427 603 100  64],458,5,33219,4.3911434236616,20.0,20.0
37565,3,7565,[302 427 603 100  64],474,5,33224,4.391223896378536,20.0,20.0
37566,3,7566,[215 161 427 118 222],533,5,33229,4.391304347826087,0.0,0.0
37567,3,7567,[302 427 603 100  64],271,5,33234,4.391384778012685,20.0,20.0
37568,3,7568,[302 427 603 100  64],666,5,33239,4.391465186946757,20.0,20.0
37569,3,7569,[302 427 603 100  64],370,5,33244,4.391545574636724,20.0,20.0
37570,3,7570,[302 427 603 100  64],664,5,33249,4.3916259410910055,20.0,20.0
37571,3,7571,[302 427 603 100  64],745,5,33254,4.391706286318014,20.0,20.0
37572,3,7572,[237 161 300 216 288],64,3,33257,4.3915225141951675,0.0,0.0
37573,3,7573,[302 427 603 100  64],454,5,33262,4.391602851861632,20.0,20.0
37574,3,7574,[153 273  79 118 318],308,3,33265,4.3914191419141915,20.0,0.0
37575,3,7575,[200  22 183 405 191],95,3,33268,4.391235480464625,0.0,0.0
37576,3,7576,[302 427 603 100  64],664,5,33273,4.39131582420483,20.0,20.0
37577,3,7577,[302 427 603 100  64],664,5,33278,4.391396146740565,20.0,20.0
37578,3,7578,[216 238 111 546 125],158,2,33280,4.391080617495712,0.0,0.0
37579,3,7579,[302 427 603 100  64],370,5,33285,4.391160949868074,20.0,20.0
37580,3,7580,[144 174  69 172 210],234,1,33286,4.39071362617069,0.0,20.0
37581,3,7581,[258 121  50 238 182],653,2,33288,4.390398311791084,0.0,20.0
37582,3,7582,[276  25 471 234  71],42,3,33291,4.390214954503494,0.0,0.0
37583,3,7583,[302 427 603 100  64],664,5,33296,4.390295358649789,20.0,20.0
37584,3,7584,[302 427 603 100  64],370,5,33301,4.390375741595254,20.0,20.0
37585,3,7585,[302 427 603 100  64],454,5,33306,4.390456103348273,20.0,20.0
37586,3,7586,[127  11 234 269 268],13,3,33309,4.390272835112693,0.0,20.0
37587,3,7587,[173 118 183  89 496],295,3,33312,4.390089615181866,0.0,0.0
37588,3,7588,[302 427 603 100  64],339,5,33317,4.390169982869943,20.0,20.0
37589,3,7589,[302 427 603 100  64],90,5,33322,4.390250329380764,20.0,20.0
37590,3,7590,[302 427 603 100  64],745,5,33327,4.390330654722698,20.0,20.0
37591,3,7591,[228 215  82 197 276],343,5,33332,4.390410958904109,0.0,0.0
37592,3,7592,[302 427 603 100  64],454,5,33337,4.3904912419333595,20.0,20.0
37593,3,7593,[302 427 603 100  64],474,5,33342,4.390571503818804,20.0,20.0
37594,3,7594,[302 427 603 100  64],339,5,33347,4.390651744568795,20.0,20.0
37595,3,7595,[ 64  97 125  82 276],892,4,33351,4.3906003159557665,0.0,0.0
37596,3,7596,[100 143 176 435 117],378,4,33355,4.390548900881927,0.0,20.0
37597,3,7597,[302 427 603 100  64],745,5,33360,4.3906291129244535,20.0,20.0
37598,3,7598,[302 427 603 100  64],454,5,33365,4.39070930385577,20.0,20.0
37599,3,7599,[286  64 100 515 597],458,4,33369,4.390657894736842,0.0,20.0
37600,3,7600,[302 427 603 100  64],339,5,33374,4.3907380607814765,20.0,20.0
37601,3,7601,[302 427 603 100  64],370,5,33379,4.390818205735333,20.0,20.0
37602,3,7602,[302 427 603 100  64],664,5,33384,4.390898329606734,20.0,20.0
37603,3,7603,[121 238  69 603 183],897,5,33389,4.3909784324039975,20.0,0.0
37604,3,7604,[  8 405  50 132 176],881,3,33392,4.390795529257067,0.0,20.0
37605,3,7605,[302 427 603 100  64],454,5,33397,4.390875624506968,20.0,20.0
37606,3,7606,[302 427 603 100  64],13,5,33402,4.390955698698567,20.0,20.0
37607,3,7607,[302 427 603 100  64],664,5,33407,4.391035751840168,20.0,20.0
37608,3,7608,[302 427 603 100  64],666,5,33412,4.391115783940071,20.0,20.0
37609,3,7609,[222 289 301  96 265],537,0,33412,4.39053876478318,0.0,0.0
37610,3,7610,[302 427 603 100  64],474,5,33417,4.390618841150966,20.0,20.0
37611,3,7611,[302 427 603 100  64],90,5,33422,4.390698896479243,20.0,20.0
37612,3,7612,[302 427 603 100  64],339,5,33427,4.390778930776304,20.0,20.0
37613,3,7613,[132  28  95  50  98],378,5,33432,4.390858944050433,0.0,40.0
37614,3,7614,[302 427 603 100  64],271,5,33437,4.390938936309914,20.0,20.0
37615,3,7615,[302 427 603 100  64],745,5,33442,4.3910189075630255,20.0,20.0
37616,3,7616,[ 95 191  56 204  70],892,5,33447,4.391098857818038,0.0,0.0
37617,3,7617,[302 427 603 100  64],458,5,33452,4.3911787870832235,20.0,20.0
37618,3,7618,[302 427 603 100  64],90,5,33457,4.391258695366846,20.0,20.0
37619,3,7619,[302 427 603 100  64],370,5,33462,4.391338582677165,20.0,20.0
37620,3,7620,[302 427 603 100  64],666,5,33467,4.391418449022438,20.0,20.0
37621,3,7621,[ 71  95 196  82 153],92,3,33470,4.391235896090265,0.0,0.0
37622,3,7622,[302 427 603 100  64],474,5,33475,4.391315754952118,20.0,20.0
37623,3,7623,[302 427 603 100  64],271,5,33480,4.3913955928646375,20.0,20.0
37624,3,7624,[302 427 603 100  64],666,5,33485,4.391475409836065,20.0,20.0
37625,3,7625,[302 427 603 100  64],454,5,33490,4.391555205874639,20.0,20.0
37626,3,7626,[301   1 265 655 204],378,4,33494,4.391503867837944,0.0,0.0
37627,3,7627,[302 427 603 100  64],664,5,33499,4.391583639223912,20.0,20.0
37628,3,7628,[302 427 603 100  64],474,5,33504,4.391663389697208,20.0,20.0
37629,3,7629,[302 427 603 100  64],454,5,33509,4.391743119266055,20.0,20.0
37630,3,7630,[302 427 603 100  64],339,5,33514,4.391822827938671,20.0,20.0
37631,3,7631,[302 427 603 100  64],666,5,33519,4.39190251572327,20.0,20.0
37632,3,7632,[302 427 603 100  64],458,5,33524,4.3919821826280625,20.0,20.0
37633,3,7633,[302 427 603 100  64],474,5,33529,4.3920618286612525,20.0,20.0
37634,3,7634,[216 471 118 200 100],653,2,33531,4.391748526522593,0.0,20.0
37635,3,7635,[ 15 313 111 423 678],92,1,33532,4.391304347826087,0.0,0.0
37636,3,7636,[302 427 603 100  64],458,5,33537,4.391384051329056,20.0,20.0
37637,3,7637,[302 427 603 100  64],90,5,33542,4.39146373396177,20.0,20.0
37638,3,7638,[302 427 603 100  64],339,5,33547,4.391543395732426,20.0,20.0
37639,3,7639,[183 215   9 176 385],64,5,33552,4.391623036649214,0.0,0.0
37640,3,7640,[ 88 196  56 174 603],398,5,33557,4.391702656720325,20.0,20.0
37641,3,7641,[435 183 180 194 191],207,3,33560,4.391520544360115,0.0,0.0
37642,3,7642,[302 427 603 100  64],13,5,33565,4.391600157006411,20.0,20.0
37643,3,7643,[286 151 496 515 322],524,3,33568,4.39141810570382,0.0,0.0
37644,3,7644,[302 427 603 100  64],666,5,33573,4.391497710922171,20.0,20.0
37645,3,7645,[100 179 111   7 655],59,5,33578,4.391577295317814,0.0,20.0
37646,3,7646,[302 427 603 100  64],474,5,33583,4.391656858898915,20.0,20.0
37647,3,7647,[302 427 603 100  64],664,5,33588,4.39173640167364,20.0,20.0
37648,3,7648,[302 427 603 100  64],666,5,33593,4.39181592365015,20.0,20.0
37649,3,7649,[302 427 603 100  64],458,5,33598,4.391895424836601,20.0,20.0
37650,3,7650,[302 427 603 100  64],90,5,33603,4.3919749052411445,20.0,20.0
37651,3,7651,[  9 245 143 597  82],378,3,33606,4.391792995295348,0.0,0.0
37652,3,7652,[302 427 603 100  64],537,4,33610,4.391741800601071,20.0,20.0
37653,3,7653,[302 427 603 100  64],13,5,33615,4.391821269924223,20.0,20.0
37654,3,7654,[302 427 603 100  64],90,5,33620,4.39190071848465,20.0,20.0
37655,3,7655,[  8 322 483 168  64],13,4,33624,4.391849529780564,20.0,0.0
37656,3,7656,[302 427 603 100  64],537,4,33628,4.3917983544469115,20.0,20.0
37657,3,7657,[302 427 603 100  64],370,5,33633,4.3918777748759465,20.0,20.0
37658,3,7658,[302 427 603 100  64],370,5,33638,4.39195717456587,20.0,20.0
37659,3,7659,[423 313 483 191 588],85,4,33642,4.391906005221932,20.0,0.0
37660,3,7660,[302 427 603 100  64],13,5,33647,4.391985380498629,20.0,20.0
37661,3,7661,[302 427 603 100  64],271,5,33652,4.392064735056121,20.0,20.0
37662,3,7662,[151 118 546   4 191],7,4,33656,4.392013571708208,0.0,0.0
37663,3,7663,[302 427 603 100  64],458,5,33661,4.3920929018789145,20.0,20.0
37664,3,7664,[302 427 603 100  64],271,5,33666,4.392172211350293,20.0,20.0
37665,3,7665,[302 427 603 100  64],474,5,33671,4.392251500130446,20.0,20.0
37666,3,7666,[  9 268 515 269 228],13,2,33673,4.391939480892135,0.0,0.0
37667,3,7667,[302 427 603 100  64],370,5,33678,4.392018779342723,20.0,20.0
37668,3,7668,[302 427 603 100  64],271,5,33683,4.392098057113053,20.0,20.0
37669,3,7669,[275 172 655 405 282],334,3,33686,4.391916558018253,0.0,0.0
37670,3,7670,[302 427 603 100  64],745,5,33691,4.391995828444792,20.0,20.0
37671,3,7671,[302 427 603 100  64],537,4,33695,4.391944734098018,20.0,20.0
37672,3,7672,[302 427 603 100  64],664,5,33700,4.392023980190277,20.0,20.0
37673,3,7673,[173 200 276 313 111],145,3,33703,4.391842585353141,0.0,0.0
37674,3,7674,[302 427 603 100  64],474,5,33708,4.391921824104235,20.0,20.0
37675,3,7675,[302 427 603 100  64],537,4,33712,4.39187076602397,20.0,20.0
37676,3,7676,[302 427 603 100  64],664,5,33717,4.391949980461118,20.0,20.0
37677,3,7677,[302 427 603 100  64],745,5,33722,4.392029174264131,20.0,20.0
37678,3,7678,[302 427 603 100  64],13,5,33727,4.392108347441073,20.0,20.0
37679,3,7679,[302 427 603 100  64],664,5,33732,4.3921875,20.0,20.0
37680,3,7680,[403 222  96   8 294],881,2,33734,4.391876057804973,0.0,0.0
37681,3,7681,[655 175 318  69 168],537,3,33737,4.391694871127311,20.0,0.0
37682,3,7682,[302 427 603 100  64],454,5,33742,4.391774046596382,20.0,20.0
37683,3,7683,[496 191 151 210 748],533,3,33745,4.3915929203539825,0.0,0.0
37684,3,7684,[302 427 603 100  64],666,5,33750,4.39167208848406,20.0,20.0
37685,3,7685,[302 427 603 100  64],90,5,33755,4.391751236013531,20.0,20.0
37686,3,7686,[  7 273  98 471 173],145,5,33760,4.391830362950436,0.0,20.0
37687,3,7687,[302 427 603 100  64],474,5,33765,4.39190946930281,20.0,20.0
37688,3,7688,[265 269 125  56 196],334,2,33767,4.391598387306542,0.0,0.0
37689,3,7689,[403 175  98  95 121],334,3,33770,4.391417425227568,0.0,20.0
37690,3,7690,[302 427 603 100  64],537,4,33774,4.391366532310493,20.0,20.0
37691,3,7691,[302 427 603 100  64],745,5,33779,4.3914456578263135,20.0,20.0
37692,3,7692,[302 427 603 100  64],271,5,33784,4.3915247627713505,20.0,20.0
37693,3,7693,[302 427 603 100  64],537,4,33788,4.3914738757473355,20.0,20.0
37694,3,7694,[273  88 216  95 173],279,1,33789,4.39103313840156,0.0,0.0
37695,3,7695,[302 427 603 100  64],271,5,33794,4.391112266112266,20.0,20.0
37696,3,7696,[210  89 187 195 127],694,5,33799,4.39119137326231,0.0,20.0
37697,3,7697,[302 427 603 100  64],666,5,33804,4.391270459859704,20.0,20.0
37698,3,7698,[302 427 603 100  64],474,5,33809,4.391349525912456,20.0,20.0
37699,3,7699,[294  79  82 100 186],653,4,33813,4.391298701298702,0.0,20.0
37700,3,7700,[302 427 603 100  64],745,5,33818,4.39137774315024,20.0,20.0
37701,3,7701,[302 427 603 100  64],90,5,33823,4.391456764476759,20.0,20.0
37702,3,7702,[  4 202  22 100 496],406,2,33825,4.391146306633779,0.0,20.0
37703,3,7703,[302 427 603 100  64],458,5,33830,4.39122533748702,20.0,20.0
37704,3,7704,[302 427 603 100  64],339,5,33835,4.391304347826087,20.0,20.0
37705,3,7705,[182  56 176 289 173],234,1,33836,4.390864261614326,0.0,0.0
37706,3,7706,[302 427 603 100  64],458,5,33841,4.390943298300247,20.0,20.0
37707,3,7707,[172 318 282 132 194],271,4,33845,4.390892579138558,20.0,0.0
37708,3,7708,[357 302 185 427 143],339,5,33850,4.390971591646128,20.0,0.0
37709,3,7709,[ 69 258 202  95  88],200,5,33855,4.391050583657588,0.0,0.0
37710,3,7710,[302 427 603 100  64],13,5,33860,4.39112955518091,20.0,20.0
37711,3,7711,[302 427 603 100  64],90,5,33865,4.391208506224066,20.0,20.0
37712,3,7712,[302 427 603 100  64],370,5,33870,4.391287436795022,20.0,20.0
37713,3,7713,[588 302 181 748 144],454,3,33873,4.391107078039927,0.0,0.0
37714,3,7714,[302 427 603 100  64],458,5,33878,4.391186001296176,20.0,20.0
37715,3,7715,[302 427 603 100  64],664,5,33883,4.391264904095387,20.0,20.0
37716,3,7716,[302 427 603 100  64],13,5,33888,4.39134378644551,20.0,20.0
37717,3,7717,[302 427 603 100  64],90,5,33893,4.391422648354496,20.0,20.0
37718,3,7718,[302 427 603 100  64],13,5,33898,4.391501489830289,20.0,20.0
37719,3,7719,[215 100 168 238 323],59,5,33903,4.391580310880829,0.0,20.0
37720,3,7720,[302 427 603 100  64],370,5,33908,4.391659111514053,20.0,20.0
37721,3,7721,[302 427 603 100  64],339,5,33913,4.3917378917378915,20.0,20.0
37722,3,7722,[ 98 191 313 322 275],334,4,33917,4.391687168198886,0.0,20.0
37723,3,7723,[302 427 603 100  64],370,5,33922,4.391765924391507,20.0,20.0
37724,3,7724,[302 427 603 100  64],13,5,33927,4.391844660194175,20.0,20.0
37725,3,7725,[302 427 603 100  64],90,5,33932,4.391923375614807,20.0,20.0
37726,3,7726,[357 403  88 496 238],339,4,33936,4.391872654328976,20.0,0.0
37727,3,7727,[302 427 603 100  64],458,5,33941,4.391951345755694,20.0,20.0
37728,3,7728,[183 144 100 435 385],804,4,33945,4.3919006339759346,0.0,20.0
37729,3,7729,[302 427 603 100  64],537,4,33949,4.391849935316947,20.0,20.0
37730,3,7730,[302 427 603 100  64],370,5,33954,4.391928599146294,20.0,20.0
37731,3,7731,[172 117 118  15 265],881,4,33958,4.39187790998448,0.0,0.0
37732,3,7732,[302 427 603 100  64],370,5,33963,4.391956549851287,20.0,20.0
37733,3,7733,[302 427 603 100  64],370,5,33968,4.39203516938195,20.0,20.0
37734,3,7734,[302 427 603 100  64],664,5,33973,4.392113768584357,20.0,20.0
37735,3,7735,[302 427 603 100  64],90,5,33978,4.392192347466391,20.0,20.0
37736,3,7736,[302 427 603 100  64],454,5,33983,4.3922709060359315,20.0,20.0
37737,3,7737,[302 427 603 100  64],370,5,33988,4.392349444300853,20.0,20.0
37738,3,7738,[655 117 234 210 237],308,2,33990,4.392040315286213,0.0,0.0
37739,3,7739,[302 427 603 100  64],664,5,33995,4.392118863049095,20.0,20.0
37740,3,7740,[ 89   1 435 187 182],6,5,34000,4.392197390518021,0.0,0.0
37741,3,7741,[302 427 603 100  64],454,5,34005,4.392275897700853,20.0,20.0
37742,3,7742,[195  89 288 238  95],650,3,34008,4.392096086788067,0.0,0.0
37743,3,7743,[302 427 603 100  64],745,5,34013,4.39217458677686,20.0,20.0
37744,3,7744,[302 427 603 100  64],339,5,34018,4.392253066494512,20.0,20.0
37745,3,7745,[302 427 603 100  64],13,5,34023,4.392331525948877,20.0,20.0
37746,3,7746,[302 427 603 100  64],745,5,34028,4.392409965147799,20.0,20.0
37747,3,7747,[302 427 603 100  64],664,5,34033,4.3924883840991225,20.0,20.0
37748,3,7748,[302 427 603 100  64],537,4,34037,4.392437733901149,20.0,20.0
37749,3,7749,[603  98 238 143   9],458,4,34041,4.392387096774193,20.0,20.0
37750,3,7750,[302 427 603 100  64],271,5,34046,4.3924654883240875,20.0,20.0
37751,3,7751,[ 95 228 588 185 301],234,0,34046,4.3918988648090815,0.0,0.0
37752,3,7752,[302 427 603 100  64],664,5,34051,4.391977299110022,20.0,20.0
37753,3,7753,[385  56  69  50 186],488,5,34056,4.392055713180294,0.0,20.0
37754,3,7754,[302 427 603 100  64],13,5,34061,4.392134107027724,20.0,20.0
37755,3,7755,[268 678 173 238 175],334,4,34065,4.392083548220732,0.0,0.0
37756,3,7756,[302 427 603 100  64],339,5,34070,4.392161918267371,20.0,20.0
37757,3,7757,[200  50   1 603 180],326,2,34072,4.3918535705078625,20.0,20.0
37758,3,7758,[302 427 603 100  64],454,5,34077,4.391931949993556,20.0,20.0
37759,3,7759,[302 427 603 100  64],454,5,34082,4.3920103092783505,20.0,20.0
37760,3,7760,[302 427 603 100  64],339,5,34087,4.392088648370056,20.0,20.0
37761,3,7761,[302 427 603 100  64],90,5,34092,4.392166967276475,20.0,20.0
37762,3,7762,[302 427 603 100  64],666,5,34097,4.3922452660054105,20.0,20.0
37763,3,7763,[ 64  15 132 228 597],653,3,34100,4.392065945388975,0.0,0.0
37764,3,7764,[302 427 603 100  64],90,5,34105,4.392144236960721,20.0,20.0
37765,3,7765,[100 182 127 174 172],527,5,34110,4.392222508369817,0.0,60.0
37766,3,7766,[302 427 603 100  64],664,5,34115,4.39230075962405,20.0,20.0
37767,3,7767,[302 427 603 100  64],537,4,34119,4.39225025746653,20.0,20.0
37768,3,7768,[302 427 603 100  64],666,5,34124,4.392328485004505,20.0,20.0
37769,3,7769,[302 427 603 100  64],13,5,34129,4.392406692406692,20.0,20.0
37770,3,7770,[302 427 603 100  64],537,4,34133,4.392356196113757,20.0,20.0
37771,3,7771,[288 222 328 161  28],533,4,34137,4.392305712815234,0.0,0.0
37772,3,7772,[302 427 603 100  64],271,5,34142,4.39238389296282,20.0,20.0
37773,3,7773,[222 210 742 265 111],378,3,34145,4.392204785181374,0.0,0.0
37774,3,7774,[302 427 603 100  64],537,4,34149,4.392154340836013,20.0,20.0
37775,3,7775,[302 427 603 100  64],666,5,34154,4.392232510288066,20.0,20.0
37776,3,7776,[302 427 603 100  64],90,5,34159,4.392310659637392,20.0,20.0
37777,3,7777,[172 258 204 496 202],738,5,34164,4.392388788891746,0.0,0.0
37778,3,7778,[100 144   1 161 427],295,5,34169,4.392466898058877,0.0,20.0
37779,3,7779,[302 427 603 100  64],474,5,34174,4.39254498714653,20.0,20.0
37780,3,7780,[302 427 603 100  64],370,5,34179,4.392623056162447,20.0,20.0
37781,3,7781,[302 427 603 100  64],13,5,34184,4.392701105114367,20.0,20.0
37782,3,7782,[204 200 423 185 313],271,4,34188,4.392650648850058,0.0,0.0
37783,3,7783,[302 427 603 100  64],339,5,34193,4.392728674203495,20.0,20.0
37784,3,7784,[302 427 603 100  64],13,5,34198,4.392806679511882,20.0,20.0
37785,3,7785,[  9 210 125 216 143],311,4,34202,4.392756229129207,0.0,0.0
37786,3,7786,[302 427 603 100  64],370,5,34207,4.392834210864261,20.0,20.0
37787,3,7787,[302 427 603 100  64],90,5,34212,4.3929121725731894,20.0,20.0
37788,3,7788,[302 427 603 100  64],370,5,34217,4.392990114263705,20.0,20.0
37789,3,7789,[302 427 603 100  64],458,5,34222,4.393068035943517,20.0,20.0
37790,3,7790,[302 427 603 100  64],454,5,34227,4.393145937620331,20.0,20.0
37791,3,7791,[302 427 603 100  64],458,5,34232,4.3932238193018485,20.0,20.0
37792,3,7792,[302 427 603 100  64],90,5,34237,4.393301680995766,20.0,20.0
37793,3,7793,[302 427 603 100  64],271,5,34242,4.393379522709777,20.0,20.0
37794,3,7794,[302 427 603 100  64],664,5,34247,4.393457344451572,20.0,20.0
37795,3,7795,[302 427 603 100  64],90,5,34252,4.393535146228835,20.0,20.0
37796,3,7796,[302 427 603 100  64],745,5,34257,4.39361292804925,20.0,20.0
37797,3,7797,[235  50 187 216 161],184,3,34260,4.393434213901,0.0,20.0
37798,3,7798,[ 79 153 151  89  95],279,3,34263,4.393255545582767,0.0,0.0
37799,3,7799,[302 427 603 100  64],664,5,34268,4.3933333333333335,20.0,20.0
37800,3,7800,[302 427 603 100  64],271,5,34273,4.393411101140879,20.0,20.0
37801,3,7801,[302 427 603 100  64],474,5,34278,4.393488849013074,20.0,20.0
37802,3,7802,[302 427 603 100  64],537,4,34282,4.393438421120082,20.0,20.0
37803,3,7803,[302 427 603 100  64],474,5,34287,4.393516145566376,20.0,20.0
37804,3,7804,[302 427 603 100  64],370,5,34292,4.393593850096092,20.0,20.0
37805,3,7805,[322 597 508 258 257],294,1,34293,4.39315910837817,0.0,0.0
37806,3,7806,[302 427 603 100  64],370,5,34298,4.393236838734469,20.0,20.0
37807,3,7807,[302 427 603 100  64],271,5,34303,4.393314549180328,20.0,20.0
37808,3,7808,[302 427 603 100  64],339,5,34308,4.393392239723396,20.0,20.0
37809,3,7809,[302 427 603 100  64],370,5,34313,4.393469910371318,20.0,20.0
37810,3,7810,[302 427 603 100  64],271,5,34318,4.393547561131737,20.0,20.0
37811,3,7811,[302 427 603 100  64],370,5,34323,4.393625192012289,20.0,20.0
37812,3,7812,[302 427 603 100  64],370,5,34328,4.393702803020607,20.0,20.0
37813,3,7813,[302 427 603 100  64],90,5,34333,4.39378039416432,20.0,20.0
37814,3,7814,[546 228  22 211  79],804,4,34337,4.393730006397953,0.0,0.0
37815,3,7815,[187  79   4 286 204],102,1,34338,4.393295803480041,0.0,0.0
37816,3,7816,[302 427 603 100  64],370,5,34343,4.393373416911858,20.0,20.0
37817,3,7817,[302 427 603 100  64],271,5,34348,4.393451010488616,20.0,20.0
37818,3,7818,[302 427 603 100  64],454,5,34353,4.393528584217931,20.0,20.0
37819,3,7819,[302 427 603 100  64],454,5,34358,4.393606138107417,20.0,20.0
37820,3,7820,[302 427 603 100  64],664,5,34363,4.393683672164685,20.0,20.0
37821,3,7821,[302 427 603 100  64],339,5,34368,4.393761186397341,20.0,20.0
37822,3,7822,[302 427 603 100  64],474,5,34373,4.393838680812987,20.0,20.0
37823,3,7823,[302 427 603 100  64],90,5,34378,4.393916155419223,20.0,20.0
37824,3,7824,[302 427 603 100  64],666,5,34383,4.393993610223642,20.0,20.0
37825,3,7825,[302 427 603 100  64],339,5,34388,4.394071045233836,20.0,20.0
37826,3,7826,[175 568 748 135  89],92,3,34391,4.393892934713173,0.0,0.0
37827,3,7827,[302 427 603 100  64],271,5,34396,4.3939703628002045,20.0,20.0
37828,3,7828,[ 88 132   4 202   1],13,4,34400,4.393920040873675,0.0,0.0
37829,3,7829,[302 427 603 100  64],454,5,34405,4.393997445721584,20.0,20.0
37830,3,7830,[118  88 210   4 301],102,0,34405,4.393436342740391,0.0,0.0
37831,3,7831,[405 183 200 175 179],334,4,34409,4.393386108273749,0.0,0.0
37832,3,7832,[302 427 603 100  64],271,5,34414,4.393463551640496,20.0,20.0
37833,3,7833,[302 427 603 100  64],454,5,34419,4.39354097523615,20.0,20.0
37834,3,7834,[172 168 202 265 183],882,5,34424,4.3936183790682835,0.0,0.0
37835,3,7835,[153  96 228   1 195],479,5,34429,4.3936957631444615,0.0,0.0
37836,3,7836,[302 427 603 100  64],664,5,34434,4.393773127472247,20.0,20.0
37837,3,7837,[302 427 603 100  64],90,5,34439,4.393850472059198,20.0,20.0
37838,3,7838,[302 427 603 100  64],90,5,34444,4.393927796912871,20.0,20.0
37839,3,7839,[196 238  88 313  98],378,4,34448,4.393877551020408,0.0,20.0
37840,3,7840,[  4  96 204 161 300],210,5,34453,4.39395485269736,0.0,0.0
37841,3,7841,[302 427 603 100  64],458,5,34458,4.3940321346595255,20.0,20.0
37842,3,7842,[302 427 603 100  64],745,5,34463,4.394109396914446,20.0,20.0
37843,3,7843,[302 427 603 100  64],90,5,34468,4.394186639469658,20.0,20.0
37844,3,7844,[302 427 603 100  64],745,5,34473,4.394263862332696,20.0,20.0
37845,3,7845,[302 427 603 100  64],13,5,34478,4.394341065511089,20.0,20.0
37846,3,7846,[121 194 186 269 333],666,1,34479,4.393908500063719,0.0,0.0
37847,3,7847,[302 427 603 100  64],537,4,34483,4.393858307849134,20.0,20.0
37848,3,7848,[302 427 603 100  64],339,5,34488,4.393935533188941,20.0,20.0
37849,3,7849,[302 427 603 100  64],454,5,34493,4.394012738853503,20.0,20.0
37850,3,7850,[302 427 603 100  64],271,5,34498,4.394089924850338,20.0,20.0
37851,3,7851,[302 427 603 100  64],90,5,34503,4.394167091186959,20.0,20.0
37852,3,7852,[  7 185 186 294 182],406,3,34506,4.3939895581306505,0.0,0.0
37853,3,7853,[302 427 603 100  64],666,5,34511,4.39406671759613,20.0,20.0
37854,3,7854,[302 427 603 100  64],458,5,34516,4.394143857415659,20.0,20.0
37855,3,7855,[181 153  98 151 195],7,4,34520,4.3940936863543785,0.0,20.0
37856,3,7856,[302  98 286 238 268],334,5,34525,4.394170803105511,0.0,20.0
37857,3,7857,[302 427 603 100  64],13,5,34530,4.3942479002290655,20.0,20.0
37858,3,7858,[302 427 603 100  64],370,5,34535,4.394324977732536,20.0,20.0
37859,3,7859,[302 427 603 100  64],666,5,34540,4.3944020356234095,20.0,20.0
37860,3,7860,[302 427 603 100  64],271,5,34545,4.394479073909172,20.0,20.0
37861,3,7861,[302 427 603 100  64],474,5,34550,4.394556092597304,20.0,20.0
37862,3,7862,[302 427 603 100  64],537,4,34554,4.394505913773369,20.0,20.0
37863,3,7863,[302 427 603 100  64],271,5,34559,4.394582909460834,20.0,20.0
37864,3,7864,[302 427 603 100  64],664,5,34564,4.394659885568976,20.0,20.0
37865,3,7865,[302 427 603 100  64],474,5,34569,4.394736842105263,20.0,20.0
37866,3,7866,[302 427 603 100  64],458,5,34574,4.3948137790771575,20.0,20.0
37867,3,7867,[597  64 211 282  25],804,4,34578,4.394763599389934,0.0,0.0
37868,3,7868,[302 427 603 100  64],458,5,34583,4.39484051340704,20.0,20.0
37869,3,7869,[ 97 269 471 144 118],666,3,34586,4.394663278271919,0.0,0.0
37870,3,7870,[302 427 603 100  64],474,5,34591,4.3947401854910435,20.0,20.0
37871,3,7871,[302 427 603 100  64],474,5,34596,4.3948170731707314,20.0,20.0
37872,3,7872,[302 427 603 100  64],90,5,34601,4.39489394131843,20.0,20.0
37873,3,7873,[  1 289 288 265 276],82,3,34604,4.394716789433579,0.0,0.0
37874,3,7874,[302 427 603 100  64],745,5,34609,4.394793650793651,20.0,20.0
37875,3,7875,[302 427 603 100  64],458,5,34614,4.394870492635856,20.0,20.0
37876,3,7876,[302 427 603 100  64],537,4,34618,4.394820363082392,20.0,20.0
37877,3,7877,[302 427 603 100  64],454,5,34623,4.394897182025895,20.0,20.0
37878,3,7878,[302 427 603 100  64],474,5,34628,4.39497398146973,20.0,20.0
37879,3,7879,[ 28 118  56 185 588],82,1,34629,4.394543147208122,0.0,0.0
37880,3,7880,[302 427 603 100  64],664,5,34634,4.394619972084761,20.0,20.0
37881,3,7881,[302 427 603 100  64],90,5,34639,4.394696777467648,20.0,20.0
37882,3,7882,[302 427 603 100  64],474,5,34644,4.394773563364201,20.0,20.0
37883,3,7883,[302 427 603 100  64],13,5,34649,4.394850329781836,20.0,20.0
37884,3,7884,[302 427 603 100  64],664,5,34654,4.3949270767279645,20.0,20.0
37885,3,7885,[302 427 603 100  64],458,5,34659,4.395003804209993,20.0,20.0
37886,3,7886,[185 172  12 268 655],334,4,34663,4.394953721313554,20.0,0.0
37887,3,7887,[302 427 603 100  64],271,5,34668,4.395030425963489,20.0,20.0
37888,3,7888,[235 318 405 194 204],13,2,34670,4.394726834833312,20.0,0.0
37889,3,7889,[302 427 603 100  64],90,5,34675,4.394803548795944,20.0,20.0
37890,3,7890,[302 427 603 100  64],745,5,34680,4.3948802433151695,20.0,20.0
37891,3,7891,[302 427 603 100  64],370,5,34685,4.394956918398378,20.0,20.0
37892,3,7892,[302 427 603 100  64],664,5,34690,4.395033574052959,20.0,20.0
37893,3,7893,[302 427 603 100  64],474,5,34695,4.395110210286293,20.0,20.0
37894,3,7894,[302 427 603 100  64],537,4,34699,4.395060164661178,20.0,20.0
37895,3,7895,[302 427 603 100  64],458,5,34704,4.395136778115502,20.0,20.0
37896,3,7896,[302 427 603 100  64],370,5,34709,4.395213372166646,20.0,20.0
37897,3,7897,[  4 275 286 333 427],328,2,34711,4.394910103823753,0.0,0.0
37898,3,7898,[302 427 603 100  64],271,5,34716,4.3949867071781235,20.0,20.0
37899,3,7899,[302 427 603 100  64],339,5,34721,4.39506329113924,20.0,20.0
37900,3,7900,[302 427 603 100  64],474,5,34726,4.395139855714467,20.0,20.0
37901,3,7901,[302 427 603 100  64],537,4,34730,4.395089850670717,20.0,20.0
37902,3,7902,[302 427 603 100  64],339,5,34735,4.395166392509173,20.0,20.0
37903,3,7903,[385  50 143 194 678],648,4,34739,4.395116396761134,0.0,20.0
37904,3,7904,[302 427 603 100  64],458,5,34744,4.395192915876028,20.0,20.0
37905,3,7905,[302 427 603 100  64],537,4,34748,4.395142929420693,20.0,20.0
37906,3,7906,[435 135  11 603  56],90,5,34753,4.395219425825218,20.0,0.0
37907,3,7907,[302 427 603 100  64],370,5,34758,4.395295902883157,20.0,20.0
37908,3,7908,[302 427 603 100  64],537,4,34762,4.395245922366923,20.0,20.0
37909,3,7909,[ 12 173  98 603 385],537,2,34764,4.3949431099873575,40.0,20.0
37910,3,7910,[302 427 603 100  64],745,5,34769,4.395019592971812,20.0,20.0
37911,3,7911,[121 135 271  69  50],145,4,34773,4.394969666329626,0.0,20.0
37912,3,7912,[302 427 603 100  64],474,5,34778,4.3950461266270695,20.0,20.0
37913,3,7913,[302 427 603 100  64],90,5,34783,4.395122567601718,20.0,20.0
37914,3,7914,[302 427 603 100  64],454,5,34788,4.395198989260897,20.0,20.0
37915,3,7915,[302 427 603 100  64],664,5,34793,4.395275391611925,20.0,20.0
37916,3,7916,[302 427 603 100  64],339,5,34798,4.395351774662119,20.0,20.0
37917,3,7917,[588 483 496 322 183],804,5,34803,4.395428138418793,20.0,0.0
37918,3,7918,[ 97 143 271 300 144],64,1,34804,4.394999368607148,0.0,0.0
37919,3,7919,[197 135 427 313 202],454,3,34807,4.394823232323232,0.0,0.0
37920,3,7920,[302 427 603 100  64],339,5,34812,4.39489963388461,20.0,20.0
37921,3,7921,[302 427 603 100  64],666,5,34817,4.394976016157536,20.0,20.0
37922,3,7922,[322 300 187  22 222],328,3,34820,4.394799949514073,0.0,0.0
37923,3,7923,[302 427 603 100  64],474,5,34825,4.394876325088339,20.0,20.0
37924,3,7924,[176 546 197 202 153],234,1,34826,4.394447949526814,0.0,0.0
37925,3,7925,[302 427 603 100  64],458,5,34831,4.394524350239718,20.0,20.0
37926,3,7926,[302 427 603 100  64],90,5,34836,4.394600731676548,20.0,20.0
37927,3,7927,[300   8  28 286 265],533,3,34839,4.394424823410696,0.0,0.0
37928,3,7928,[234 322 196 180 202],234,1,34840,4.393996720897969,0.0,0.0
37929,3,7929,[ 69 197  70 185  89],524,5,34845,4.394073139974779,0.0,0.0
37930,3,7930,[302 427 603 100  64],90,5,34850,4.394149539780607,20.0,20.0
37931,3,7931,[302 427 603 100  64],339,5,34855,4.394225920322743,20.0,20.0
37932,3,7932,[302 427 603 100  64],271,5,34860,4.394302281608471,20.0,20.0
37933,3,7933,[302 427 603 100  64],370,5,34865,4.394378623645072,20.0,20.0
37934,3,7934,[322 132  69 195 257],308,2,34867,4.394076874606175,0.0,0.0
37935,3,7935,[302 427 603 100  64],458,5,34872,4.394153225806452,20.0,20.0
37936,3,7936,[302 427 603 100  64],271,5,34877,4.394229557767418,20.0,20.0
37937,3,7937,[302 427 603 100  64],664,5,34882,4.394305870496346,20.0,20.0
37938,3,7938,[302 427 603 100  64],474,5,34887,4.394382164000504,20.0,20.0
37939,3,7939,[302 427 603 100  64],271,5,34892,4.394458438287153,20.0,20.0
37940,3,7940,[302 427 603 100  64],537,4,34896,4.3944087646392145,20.0,20.0
37941,3,7941,[302 427 603 100  64],745,5,34901,4.394485016368673,20.0,20.0
37942,3,7942,[302 427 603 100  64],745,5,34906,4.394561248898401,20.0,20.0
37943,3,7943,[302 427 603 100  64],458,5,34911,4.394637462235649,20.0,20.0
37944,3,7944,[174 132 187 175 100],339,5,34916,4.394713656387665,0.0,40.0
37945,3,7945,[216 588  12 176  69],64,5,34921,4.394789831361692,20.0,0.0
37946,3,7946,[302 427 603 100  64],745,5,34926,4.394865987164968,20.0,20.0
37947,3,7947,[471  56 197 235 185],213,3,34929,4.394690488173126,0.0,0.0
37948,3,7948,[302 427 603 100  64],454,5,34934,4.39476663731287,20.0,20.0
37949,3,7949,[ 97 132 161 175 210],524,3,34937,4.394591194968553,0.0,0.0
37950,3,7950,[318  22 191 546  12],194,4,34941,4.394541567098478,40.0,0.0
37951,3,7951,[302 427 603 100  64],370,5,34946,4.394617706237424,20.0,20.0
37952,3,7952,[302 427 603 100  64],90,5,34951,4.394693826229096,20.0,20.0
37953,3,7953,[302 427 603 100  64],90,5,34956,4.394769927080714,20.0,20.0
37954,3,7954,[302 427 603 100  64],13,5,34961,4.394846008799497,20.0,20.0
37955,3,7955,[302 427 603 100  64],90,5,34966,4.39492207139266,20.0,20.0
37956,3,7956,[302 427 603 100  64],339,5,34971,4.394998114867413,20.0,20.0
37957,3,7957,[302 427 603 100  64],537,4,34975,4.394948479517467,20.0,20.0
37958,3,7958,[318 471 328  98 187],788,4,34979,4.394898856640282,20.0,20.0
37959,3,7959,[302 427 603 100  64],90,5,34984,4.394974874371859,20.0,20.0
37960,3,7960,[302 427 603 100  64],666,5,34989,4.3950508730059035,20.0,20.0
37961,3,7961,[302 427 603 100  64],474,5,34994,4.395126852549611,20.0,20.0
37962,3,7962,[302 427 603 100  64],339,5,34999,4.395202813010172,20.0,20.0
37963,3,7963,[197  89 275 222 181],311,5,35004,4.395278754394776,0.0,0.0
37964,3,7964,[143 121 176   7 357],537,2,35006,4.394978028876334,20.0,0.0
37965,3,7965,[302 427 603 100  64],666,5,35011,4.395053979412503,20.0,20.0
37966,3,7966,[302 427 603 100  64],666,5,35016,4.39512991088239,20.0,20.0
37967,3,7967,[302 427 603 100  64],90,5,35021,4.395205823293173,20.0,20.0
37968,3,7968,[ 97 211 300  50 357],774,1,35022,4.394779771615008,20.0,20.0
37969,3,7969,[302 427 603 100  64],666,5,35027,4.394855708908406,20.0,20.0
37970,3,7970,[ 50 302 258 194 294],6,3,35030,4.394680717601305,0.0,20.0
37971,3,7971,[302 427 603 100  64],745,5,35035,4.394756648268941,20.0,20.0
37972,3,7972,[302 427 603 100  64],458,5,35040,4.394832559889627,20.0,20.0
37973,3,7973,[302 427 603 100  64],666,5,35045,4.3949084524705295,20.0,20.0
37974,3,7974,[302 427 603 100  64],666,5,35050,4.394984326018808,20.0,20.0
37975,3,7975,[187 405 174 194  25],648,3,35053,4.394809428284854,0.0,20.0
37976,3,7976,[302 427 603 100  64],370,5,35058,4.3948852952237685,20.0,20.0
37977,3,7977,[302 427 603 100  64],339,5,35063,4.394961143143645,20.0,20.0
37978,3,7978,[302 427 603 100  64],454,5,35068,4.395036972051636,20.0,20.0
37979,3,7979,[302 427 603 100  64],666,5,35073,4.395112781954888,20.0,20.0
37980,3,7980,[302 427 603 100  64],370,5,35078,4.395188572860544,20.0,20.0
37981,3,7981,[302 427 603 100  64],271,5,35083,4.395264344775746,20.0,20.0
37982,3,7982,[153   4 197 144 100],833,2,35085,4.394964299135664,0.0,20.0
37983,3,7983,[302 427 603 100  64],666,5,35090,4.395040080160321,20.0,20.0
37984,3,7984,[302 427 603 100  64],745,5,35095,4.395115842204133,20.0,20.0
37985,3,7985,[603 191  71 100  25],234,3,35098,4.394941147007263,20.0,20.0
37986,3,7986,[302 427 603 100  64],664,5,35103,4.395016902466508,20.0,20.0
37987,3,7987,[302 427 603 100  64],271,5,35108,4.395092638958437,20.0,20.0
37988,3,7988,[302 427 603 100  64],745,5,35113,4.395168356490174,20.0,20.0
37989,3,7989,[302 427 603 100  64],458,5,35118,4.395244055068836,20.0,20.0
37990,3,7990,[302 427 603 100  64],90,5,35123,4.395319734701539,20.0,20.0
37991,3,7991,[302 427 603 100  64],271,5,35128,4.395395395395395,20.0,20.0
37992,3,7992,[302 427 603 100  64],474,5,35133,4.395471037157513,20.0,20.0
37993,3,7993,[ 69  25 245 121  56],455,3,35136,4.395296472354266,0.0,0.0
37994,3,7994,[655 181  70 238  15],14,4,35140,4.395247029393371,0.0,0.0
37995,3,7995,[302 427 603 100  64],370,5,35145,4.395322661330665,20.0,20.0
37996,3,7996,[ 70  95 435 183 238],406,3,35148,4.395148180567713,0.0,0.0
37997,3,7997,[302 427 603 100  64],454,5,35153,4.395223805951487,20.0,20.0
37998,3,7998,[302 427 603 100  64],339,5,35158,4.395299412426553,20.0,20.0
37999,3,7999,[302 427 603 100  64],664,5,35163,4.395375,20.0,20.0
38000,3,8000,[302 427 603 100  64],271,5,35168,4.395450568678915,20.0,20.0
38001,3,8001,[  1 228 588 121 234],843,2,35170,4.395151212196951,0.0,0.0
38002,3,8002,[302 427 603 100  64],454,5,35175,4.395226789953767,20.0,20.0
38003,3,8003,[302 427 603 100  64],454,5,35180,4.395302348825587,20.0,20.0
38004,3,8004,[302 427 603 100  64],664,5,35185,4.395377888819488,20.0,20.0
38005,3,8005,[302 427 603 100  64],474,5,35190,4.395453409942543,20.0,20.0
38006,3,8006,[302 427 603 100  64],664,5,35195,4.395528912201823,20.0,20.0
38007,3,8007,[302 427 603 100  64],13,5,35200,4.395604395604396,20.0,20.0
38008,3,8008,[ 12  82  64 286 176],10,5,35205,4.395679860157323,20.0,0.0
38009,3,8009,[302 427 603 100  64],370,5,35210,4.395755305867666,20.0,20.0
38010,3,8010,[302 427 603 100  64],370,5,35215,4.395830732742479,20.0,20.0
38011,3,8011,[302 427 603 100  64],745,5,35220,4.395906140788817,20.0,20.0
38012,3,8012,[302 427 603 100  64],339,5,35225,4.395981530013728,20.0,20.0
38013,3,8013,[655  64  50  71 238],387,2,35227,4.395682555527826,0.0,20.0
38014,3,8014,[302 427 603 100  64],339,5,35232,4.395757953836556,20.0,20.0
38015,3,8015,[302 427 603 100  64],339,5,35237,4.395833333333333,20.0,20.0
38016,3,8016,[302 427 603 100  64],339,5,35242,4.395908694025197,20.0,20.0
38017,3,8017,[302 427 603 100  64],339,5,35247,4.395984035919182,20.0,20.0
38018,3,8018,[302 427 603 100  64],666,5,35252,4.396059359022322,20.0,20.0
38019,3,8019,[288 210 568 228 286],59,4,35256,4.396009975062344,0.0,0.0
38020,3,8020,[302 427 603 100  64],745,5,35261,4.396085276150106,20.0,20.0
38021,3,8021,[302 427 603 100  64],339,5,35266,4.396160558464223,20.0,20.0
38022,3,8022,[ 28  71 427 183   7],815,5,35271,4.396235822011716,0.0,0.0
38023,3,8023,[ 79 182 180  64  82],59,5,35276,4.396311066799601,0.0,0.0
38024,3,8024,[302 427 603 100  64],90,5,35281,4.396386292834891,20.0,20.0
38025,3,8025,[302 427 603 100  64],370,5,35286,4.3964615001245955,20.0,20.0
38026,3,8026,[302 427 603 100  64],537,4,35290,4.39641210913168,20.0,20.0
38027,3,8027,[175 483 135 197  56],308,3,35293,4.396238166417539,20.0,0.0
38028,3,8028,[302 427 603 100  64],474,5,35298,4.3963133640553,20.0,20.0
38029,3,8029,[258 118 210 173 748],882,4,35302,4.39626400996264,0.0,0.0
38030,3,8030,[302 427 603 100  64],90,5,35307,4.3963391856555845,20.0,20.0
38031,3,8031,[302 427 603 100  64],339,5,35312,4.396414342629482,20.0,20.0
38032,3,8032,[302 427 603 100  64],454,5,35317,4.396489480891323,20.0,20.0
38033,3,8033,[302 427 603 100  64],474,5,35322,4.396564600448095,20.0,20.0
38034,3,8034,[302 427 603 100  64],90,5,35327,4.396639701306783,20.0,20.0
38035,3,8035,[ 96 168  98 195  88],537,1,35328,4.3962170233947235,0.0,20.0
38036,3,8036,[302 427 603 100  64],13,5,35333,4.396292148811746,20.0,20.0
38037,3,8037,[ 25  11 265  95  56],537,1,35334,4.395869619308286,0.0,0.0
38038,3,8038,[191  15   4 187 508],207,5,35339,4.3959447692499065,0.0,0.0
38039,3,8039,[302 427 603 100  64],664,5,35344,4.396019900497512,20.0,20.0
38040,3,8040,[302 427 603 100  64],339,5,35349,4.396095013058077,20.0,20.0
38041,3,8041,[302 427 603 100  64],745,5,35354,4.396170106938572,20.0,20.0
38042,3,8042,[302 427 603 100  64],90,5,35359,4.396245182145965,20.0,20.0
38043,3,8043,[ 22 294  88 191 181],881,3,35362,4.396071606166086,0.0,0.0
38044,3,8044,[302 427 603 100  64],13,5,35367,4.396146674953387,20.0,20.0
38045,3,8045,[302 427 603 100  64],90,5,35372,4.396221725080785,20.0,20.0
38046,3,8046,[302 427 603 100  64],537,4,35376,4.396172486640984,20.0,20.0
38047,3,8047,[302 427 603 100  64],745,5,35381,4.396247514910537,20.0,20.0
38048,3,8048,[302 427 603 100  64],90,5,35386,4.39632252453721,20.0,20.0
38049,3,8049,[302 427 603 100  64],271,5,35391,4.39639751552795,20.0,20.0
38050,3,8050,[302 427 603 100  64],90,5,35396,4.396472487889703,20.0,20.0
38051,3,8051,[302 427 603 100  64],474,5,35401,4.396547441629409,20.0,20.0
38052,3,8052,[302 427 603 100  64],454,5,35406,4.396622376754005,20.0,20.0
38053,3,8053,[200 323 603 187 245],804,4,35410,4.396573131363298,20.0,0.0
38054,3,8054,[302 427 603 100  64],666,5,35415,4.396648044692737,20.0,20.0
38055,3,8055,[302 427 603 100  64],454,5,35420,4.3967229394240315,20.0,20.0
38056,3,8056,[302 427 603 100  64],339,5,35425,4.396797815564105,20.0,20.0
38057,3,8057,[302 427 603 100  64],745,5,35430,4.396872673119881,20.0,20.0
38058,3,8058,[302 427 603 100  64],458,5,35435,4.396947512098275,20.0,20.0
38059,3,8059,[322 179 143  71 235],308,3,35438,4.396774193548387,0.0,0.0
38060,3,8060,[302 427 603 100  64],537,4,35442,4.3967249720878305,20.0,20.0
38061,3,8061,[302 427 603 100  64],537,4,35446,4.396675762838005,20.0,20.0
38062,3,8062,[302 427 603 100  64],370,5,35451,4.396750589110753,20.0,20.0
38063,3,8063,[ 71 300   4 111 204],234,1,35452,4.396329365079365,0.0,0.0
38064,3,8064,[302 427 603 100  64],339,5,35457,4.396404215747055,20.0,20.0
38065,3,8065,[302 427 603 100  64],537,4,35461,4.396355070666997,20.0,20.0
38066,3,8066,[302 427 603 100  64],454,5,35466,4.396429899590926,20.0,20.0
38067,3,8067,[302 427 603 100  64],370,5,35471,4.396504709965295,20.0,20.0
38068,3,8068,[302 427 603 100  64],664,5,35476,4.396579501797001,20.0,20.0
38069,3,8069,[302 427 603 100  64],537,4,35480,4.396530359355638,20.0,20.0
38070,3,8070,[302 427 603 100  64],339,5,35485,4.396605129475901,20.0,20.0
38071,3,8071,[302 427 603 100  64],90,5,35490,4.396679881070367,20.0,20.0
38072,3,8072,[302 427 603 100  64],745,5,35495,4.396754614145919,20.0,20.0
38073,3,8073,[302 427 603 100  64],537,4,35499,4.39670547436215,20.0,20.0
38074,3,8074,[302 427 603 100  64],458,5,35504,4.396780185758514,20.0,20.0
38075,3,8075,[ 25 318 427   4 135],537,3,35507,4.396607231302625,20.0,0.0
38076,3,8076,[302 427 603 100  64],370,5,35512,4.396681936362511,20.0,20.0
38077,3,8077,[568 475 228 135 172],533,3,35515,4.396509036890319,0.0,0.0
38078,3,8078,[483 175  82 333 161],85,3,35518,4.396336180220325,20.0,0.0
38079,3,8079,[202 288 265 357 125],82,3,35521,4.3961633663366335,20.0,0.0
38080,3,8080,[302 427 603 100  64],537,4,35525,4.3961143422843705,20.0,20.0
38081,3,8081,[302 427 603 100  64],370,5,35530,4.396189062113338,20.0,20.0
38082,3,8082,[302 427 603 100  64],537,4,35534,4.396140047012248,20.0,20.0
38083,3,8083,[302 427 603 100  64],13,5,35539,4.396214745175656,20.0,20.0
38084,3,8084,[  4 286 496  97 427],650,2,35541,4.395918367346939,0.0,0.0
38085,3,8085,[222 174 195 125 423],42,5,35546,4.395993074449666,0.0,20.0
38086,3,8086,[302 427 603 100  64],458,5,35551,4.396067763076543,20.0,20.0
38087,3,8087,[302 427 603 100  64],537,4,35555,4.396018793273986,20.0,20.0
38088,3,8088,[302 427 603 100  64],13,5,35560,4.396093460254667,20.0,20.0
38089,3,8089,[302 427 603 100  64],745,5,35565,4.396168108776267,20.0,20.0
38090,3,8090,[  9  25 135   7 546],194,1,35566,4.395748362377951,0.0,0.0
38091,3,8091,[302 427 603 100  64],474,5,35571,4.395823035096392,20.0,20.0
38092,3,8092,[302 427 603 100  64],664,5,35576,4.395897689361177,20.0,20.0
38093,3,8093,[302 427 603 100  64],454,5,35581,4.395972325179145,20.0,20.0
38094,3,8094,[302 427 603 100  64],664,5,35586,4.396046942557134,20.0,20.0
38095,3,8095,[302 427 603 100  64],537,4,35590,4.395998023715415,20.0,20.0
38096,3,8096,[302 427 603 100  64],271,5,35595,4.3960726194887,20.0,20.0
38097,3,8097,[405 237 195 294 153],788,2,35597,4.3957767349962955,0.0,0.0
38098,3,8098,[302 427 603 100  64],666,5,35602,4.395851339671564,20.0,20.0
38099,3,8099,[302 427 603 100  64],271,5,35607,4.395925925925926,20.0,20.0
38100,3,8100,[435 258  71 168 508],6,3,35610,4.39575361066535,0.0,0.0
38101,3,8101,[302 427 603 100  64],666,5,35615,4.39582819057023,20.0,20.0
38102,3,8102,[144 258  70 265  95],455,3,35618,4.395655929902505,0.0,0.0
38103,3,8103,[302 427 603 100  64],90,5,35623,4.395730503455084,20.0,20.0
38104,3,8104,[258 275  25  22 125],7,4,35627,4.395681677976557,0.0,0.0
38105,3,8105,[302 427 603 100  64],90,5,35632,4.395756229953121,20.0,20.0
38106,3,8106,[ 12 289 176 515 135],271,4,35636,4.395707413346491,20.0,0.0
38107,3,8107,[302 427 603 100  64],664,5,35641,4.39578194375925,20.0,20.0
38108,3,8108,[302 427 603 100  64],90,5,35646,4.395856455789863,20.0,20.0
38109,3,8109,[302 427 603 100  64],90,5,35651,4.3959309494451295,20.0,20.0
38110,3,8110,[302 427 603 100  64],474,5,35656,4.396005424731846,20.0,20.0
38111,3,8111,[302 427 603 100  64],271,5,35661,4.396079881656805,20.0,20.0
38112,3,8112,[235 216 471 237  88],92,2,35663,4.395784543325527,0.0,0.0
38113,3,8113,[302 427 603 100  64],537,4,35667,4.39573576534385,20.0,20.0
38114,3,8114,[ 25 435  22 496 294],7,3,35670,4.3955637707948245,0.0,0.0
38115,3,8115,[  7 496 143  95 181],59,3,35673,4.395391818629867,0.0,0.0
38116,3,8116,[302 427 603 100  64],745,5,35678,4.395466305285204,20.0,20.0
38117,3,8117,[302 427 603 100  64],537,4,35682,4.395417590539542,20.0,20.0
38118,3,8118,[302 427 603 100  64],13,5,35687,4.39549205567188,20.0,20.0
38119,3,8119,[238 187 182 179  71],308,5,35692,4.395566502463054,0.0,0.0
38120,3,8120,[204 174 197  71 268],387,1,35693,4.395148380741288,0.0,20.0
38121,3,8121,[174 282 172  96 228],479,5,35698,4.395222851514405,0.0,20.0
38122,3,8122,[100 357 302 117 234],458,4,35702,4.395174196725348,20.0,20.0
38123,3,8123,[302 427 603 100  64],13,5,35707,4.395248645987198,20.0,20.0
38124,3,8124,[302 427 603 100  64],90,5,35712,4.395323076923077,20.0,20.0
38125,3,8125,[144 197  64 288  56],13,4,35716,4.395274427762737,0.0,0.0
38126,3,8126,[302 427 603 100  64],537,4,35720,4.395225790574628,20.0,20.0
38127,3,8127,[302 427 603 100  64],474,5,35725,4.3953001968503935,20.0,20.0
38128,3,8128,[183  97 222 204  89],406,4,35729,4.395251568458605,0.0,0.0
38129,3,8129,[286 173 121 328 423],13,2,35731,4.394956949569496,0.0,0.0
38130,3,8130,[302 427 603 100  64],13,5,35736,4.395031361456155,20.0,20.0
38131,3,8131,[302 427 603 100  64],664,5,35741,4.3951057550418104,20.0,20.0
38132,3,8132,[302 427 603 100  64],454,5,35746,4.395180130333211,20.0,20.0
38133,3,8133,[302 427 603 100  64],474,5,35751,4.3952544873371036,20.0,20.0
38134,3,8134,[235  15  96 357  98],59,4,35755,4.3952059004302395,20.0,20.0
38135,3,8135,[302 427 603 100  64],537,4,35759,4.39515732546706,20.0,20.0
38136,3,8136,[302 427 603 100  64],454,5,35764,4.395231657859162,20.0,20.0
38137,3,8137,[302 427 603 100  64],664,5,35769,4.395305971983288,20.0,20.0
38138,3,8138,[302 427 603 100  64],271,5,35774,4.395380267846173,20.0,20.0
38139,3,8139,[302 427 603 100  64],271,5,35779,4.3954545454545455,20.0,20.0
38140,3,8140,[175 385 181  89 515],313,5,35784,4.395528804815133,0.0,0.0
38141,3,8141,[302 427 603 100  64],339,5,35789,4.39560304593466,20.0,20.0
38142,3,8142,[302 427 603 100  64],458,5,35794,4.3956772688198456,20.0,20.0
38143,3,8143,[483 403  88 568 282],311,5,35799,4.395751473477406,20.0,0.0
38144,3,8144,[508 153  98 197 144],207,4,35803,4.3957028852056474,0.0,20.0
38145,3,8145,[265 200 187 204 183],313,4,35807,4.395654308863246,0.0,0.0
38146,3,8146,[302 427 603 100  64],370,5,35812,4.3957284890143615,20.0,20.0
38147,3,8147,[238 322 172 286  70],454,1,35813,4.395311732940599,0.0,0.0
38148,3,8148,[302 427 603 100  64],339,5,35818,4.395385936924776,20.0,20.0
38149,3,8149,[302 427 603 100  64],454,5,35823,4.395460122699387,20.0,20.0
38150,3,8150,[302 427 603 100  64],339,5,35828,4.395534290271132,20.0,20.0
38151,3,8151,[302 427 603 100  64],458,5,35833,4.395608439646712,20.0,20.0
38152,3,8152,[302 427 603 100  64],745,5,35838,4.395682570832823,20.0,20.0
38153,3,8153,[302 427 603 100  64],474,5,35843,4.395756683836154,20.0,20.0
38154,3,8154,[302 427 603 100  64],664,5,35848,4.395830778663397,20.0,20.0
38155,3,8155,[302 427 603 100  64],664,5,35853,4.395904855321236,20.0,20.0
38156,3,8156,[ 50 181 258  56 302],360,5,35858,4.395978913816354,0.0,20.0
38157,3,8157,[ 98 125  69 200 515],455,4,35862,4.395930375091934,0.0,20.0
38158,3,8158,[302 427 603 100  64],454,5,35867,4.396004412305429,20.0,20.0
38159,3,8159,[302 427 603 100  64],458,5,35872,4.396078431372549,20.0,20.0
38160,3,8160,[302 427 603 100  64],339,5,35877,4.396152432299964,20.0,20.0
38161,3,8161,[508 282 238 176 181],92,5,35882,4.39622641509434,0.0,0.0
38162,3,8162,[302 427 603 100  64],745,5,35887,4.396300379762343,20.0,20.0
38163,3,8163,[302 427 603 100  64],90,5,35892,4.396374326310632,20.0,20.0
38164,3,8164,[302 427 603 100  64],339,5,35897,4.3964482547458665,20.0,20.0
38165,3,8165,[302 427 603 100  64],339,5,35902,4.3965221650747,20.0,20.0
38166,3,8166,[302 427 603 100  64],13,5,35907,4.396596057303784,20.0,20.0
38167,3,8167,[257 132 186 182  64],474,4,35911,4.39654750244858,0.0,0.0
38168,3,8168,[302 427 603 100  64],537,4,35915,4.396498959480964,20.0,20.0
38169,3,8169,[  4 153  25 181 357],295,5,35920,4.396572827417381,20.0,0.0
38170,3,8170,[302 427 603 100  64],474,5,35925,4.396646677273283,20.0,20.0
38171,3,8171,[302 427 603 100  64],90,5,35930,4.396720509055311,20.0,20.0
38172,3,8172,[302 427 603 100  64],666,5,35935,4.396794322770097,20.0,20.0
38173,3,8173,[302 427 603 100  64],745,5,35940,4.396868118424272,20.0,20.0
38174,3,8174,[302 427 603 100  64],666,5,35945,4.396941896024464,20.0,20.0
38175,3,8175,[302 427 603 100  64],537,4,35949,4.396893346379648,20.0,20.0
38176,3,8176,[302 427 603 100  64],666,5,35954,4.396967102849456,20.0,20.0
38177,3,8177,[302 427 603 100  64],458,5,35959,4.397040841281487,20.0,20.0
38178,3,8178,[302 427 603 100  64],13,5,35964,4.397114561682357,20.0,20.0
38179,3,8179,[238  97 179 186 183],650,3,35967,4.396943765281174,0.0,0.0
38180,3,8180,[302 427 603 100  64],370,5,35972,4.39701747952573,20.0,20.0
38181,3,8181,[ 69 204  96 210 222],234,1,35973,4.396602297726718,0.0,0.0
38182,3,8182,[286 194 435   4  95],537,0,35973,4.39606501283148,0.0,0.0
38183,3,8183,[302 427 603 100  64],474,5,35978,4.39613880742913,20.0,20.0
38184,3,8184,[ 89 168 403 748 144],13,4,35982,4.396090409285278,0.0,0.0
38185,3,8185,[302 427 603 100  64],339,5,35987,4.396164182751038,20.0,20.0
38186,3,8186,[302 427 603 100  64],666,5,35992,4.396237938194699,20.0,20.0
38187,3,8187,[ 64 121 328 302 111],207,2,35994,4.395945285784074,0.0,0.0
38188,3,8188,[403 195 496 204  56],883,4,35998,4.395896934912688,0.0,0.0
38189,3,8189,[302 427 603 100  64],537,4,36002,4.395848595848596,20.0,20.0
38190,3,8190,[ 89 475 265  25 483],374,2,36004,4.395556098156513,20.0,0.0
38191,3,8191,[302 427 603 100  64],339,5,36009,4.3956298828125,20.0,20.0
38192,3,8192,[385 191 210 176 483],659,5,36014,4.395703649456854,20.0,0.0
38193,3,8193,[302 427 603 100  64],370,5,36019,4.395777398096168,20.0,20.0
38194,3,8194,[ 95 273 294 238 597],554,2,36021,4.395485051860891,0.0,0.0
38195,3,8195,[  8 194 117 275 216],308,3,36024,4.3953147877013174,0.0,0.0
38196,3,8196,[302 427 603 100  64],474,5,36029,4.39538855678907,20.0,20.0
38197,3,8197,[302 427 603 100  64],537,4,36033,4.395340326909002,20.0,20.0
38198,3,8198,[302 427 603 100  64],664,5,36038,4.3954140748871815,20.0,20.0
38199,3,8199,[302 427 603 100  64],13,5,36043,4.395487804878049,20.0,20.0
38200,3,8200,[302 427 603 100  64],745,5,36048,4.3955615168881845,20.0,20.0
38201,3,8201,[151 257 100 168 588],795,3,36051,4.395391367959034,0.0,20.0
38202,3,8202,[302 427 603 100  64],745,5,36056,4.395465073753505,20.0,20.0
38203,3,8203,[289   1 211 427 273],13,2,36058,4.3951730862993665,0.0,0.0
38204,3,8204,[211  22 172 100 196],749,4,36062,4.395124923826935,0.0,20.0
38205,3,8205,[269  22 117 546 183],207,1,36063,4.394711186936388,0.0,0.0
38206,3,8206,[302 427 603 100  64],90,5,36068,4.394784939685634,20.0,20.0
38207,3,8207,[222  96  88 546  11],145,4,36072,4.394736842105263,0.0,0.0
38208,3,8208,[302 427 603 100  64],90,5,36077,4.394810573760506,20.0,20.0
38209,3,8209,[135  70  79 568  98],882,4,36081,4.394762484774665,0.0,20.0
38210,3,8210,[302 427 603 100  64],458,5,36086,4.394836195347704,20.0,20.0
38211,3,8211,[302 427 603 100  64],13,5,36091,4.394909887968826,20.0,20.0
38212,3,8212,[210 288  28 176 179],666,2,36093,4.394618288079873,0.0,0.0
38213,3,8213,[194   7 300 258 222],843,2,36095,4.394326759191624,0.0,0.0
38214,3,8214,[302 427 603 100  64],271,5,36100,4.394400486914181,20.0,20.0
38215,3,8215,[302 427 603 100  64],666,5,36105,4.394474196689386,20.0,20.0
38216,3,8216,[302 427 603 100  64],271,5,36110,4.3945478885237925,20.0,20.0
38217,3,8217,[302 427 603 100  64],537,4,36114,4.394499878315892,20.0,20.0
38218,3,8218,[302 427 603 100  64],454,5,36119,4.394573549093564,20.0,20.0
38219,3,8219,[302 427 603 100  64],271,5,36124,4.394647201946472,20.0,20.0
38220,3,8220,[302 427 603 100  64],454,5,36129,4.394720836881158,20.0,20.0
38221,3,8221,[302 427 603 100  64],271,5,36134,4.39479445390416,20.0,20.0
38222,3,8222,[269 328 222 427 127],334,3,36137,4.3946248327860875,0.0,20.0
38223,3,8223,[302 427 603 100  64],370,5,36142,4.394698443579767,20.0,20.0
38224,3,8224,[302 427 603 100  64],90,5,36147,4.394772036474164,20.0,20.0
38225,3,8225,[195  89 234  79 132],406,4,36151,4.394724045708728,0.0,0.0
38226,3,8226,[302 427 603 100  64],370,5,36156,4.394797617600584,20.0,20.0
38227,3,8227,[302 427 603 100  64],458,5,36161,4.3948711716091395,20.0,20.0
38228,3,8228,[302 427 603 100  64],454,5,36166,4.394944707740916,20.0,20.0
38229,3,8229,[302 427 603 100  64],339,5,36171,4.39501822600243,20.0,20.0
38230,3,8230,[302 427 603 100  64],370,5,36176,4.395091726400194,20.0,20.0
38231,3,8231,[302 427 603 100  64],271,5,36181,4.395165208940719,20.0,20.0
38232,3,8232,[275 273 180 175 289],378,4,36185,4.395117211223126,0.0,0.0
38233,3,8233,[302 427 603 100  64],339,5,36190,4.395190672820014,20.0,20.0
38234,3,8234,[302 427 603 100  64],13,5,36195,4.395264116575592,20.0,20.0
38235,3,8235,[302 427 603 100  64],90,5,36200,4.395337542496358,20.0,20.0
38236,3,8236,[302 427 603 100  64],271,5,36205,4.395410950588807,20.0,20.0
38237,3,8237,[302 427 603 100  64],474,5,36210,4.395484340859432,20.0,20.0
38238,3,8238,[302 427 603 100  64],664,5,36215,4.395557713314723,20.0,20.0
38239,3,8239,[597 185  89  15  22],145,4,36219,4.3955097087378645,0.0,0.0
38240,3,8240,[302 427 603 100  64],454,5,36224,4.395583060308215,20.0,20.0
38241,3,8241,[ 69 210 180 313 427],271,5,36229,4.395656394079107,0.0,0.0
38242,3,8242,[183 568 403 125 132],59,4,36233,4.39560839500182,0.0,0.0
38243,3,8243,[302 427 603 100  64],90,5,36238,4.395681707908782,20.0,20.0
38244,3,8244,[302 427 603 100  64],666,5,36243,4.395755003032141,20.0,20.0
38245,3,8245,[302 427 603 100  64],664,5,36248,4.395828280378366,20.0,20.0
38246,3,8246,[302 427 603 100  64],664,5,36253,4.395901539953923,20.0,20.0
38247,3,8247,[302 427 603 100  64],271,5,36258,4.395974781765276,20.0,20.0
38248,3,8248,[302 427 603 100  64],271,5,36263,4.396048005818887,20.0,20.0
38249,3,8249,[302 427 603 100  64],370,5,36268,4.396121212121212,20.0,20.0
38250,3,8250,[ 79 276 176 268 423],189,3,36271,4.395952005817477,0.0,0.0
38251,3,8251,[302 427 603 100  64],745,5,36276,4.396025206010664,20.0,20.0
38252,3,8252,[302 427 603 100  64],13,5,36281,4.396098388464801,20.0,20.0
38253,3,8253,[144  88   4  69  28],883,3,36284,4.395929246425975,0.0,0.0
38254,3,8254,[302 427 603 100  64],664,5,36289,4.396002422774076,20.0,20.0
38255,3,8255,[302 427 603 100  64],537,4,36293,4.395954457364341,20.0,20.0
38256,3,8256,[302 427 603 100  64],271,5,36298,4.39602761293448,20.0,20.0
38257,3,8257,[302 427 603 100  64],664,5,36303,4.396100750787116,20.0,20.0
38258,3,8258,[302 427 603 100  64],454,5,36308,4.396173870928684,20.0,20.0
38259,3,8259,[475  70 588 275 302],10,5,36313,4.396246973365617,0.0,0.0
38260,3,8260,[302 427 603 100  64],664,5,36318,4.396320058104346,20.0,20.0
38261,3,8261,[302 427 603 100  64],13,5,36323,4.396393125151295,20.0,20.0
38262,3,8262,[302 427 603 100  64],90,5,36328,4.396466174512889,20.0,20.0
38263,3,8263,[  7  56  98  15 200],145,4,36332,4.396418199419167,0.0,20.0
38264,3,8264,[302 427 603 100  64],339,5,36337,4.396491228070175,20.0,20.0
38265,3,8265,[302 427 603 100  64],458,5,36342,4.3965642390515365,20.0,20.0
38266,3,8266,[302 427 603 100  64],666,5,36347,4.396637232369662,20.0,20.0
38267,3,8267,[151  96 185 204  69],650,2,36349,4.396347363328496,0.0,0.0
38268,3,8268,[ 50 546 405 197 286],82,3,36352,4.396178498004596,0.0,20.0
38269,3,8269,[302 427 603 100  64],90,5,36357,4.3962515114873035,20.0,20.0
38270,3,8270,[328 234 403 288 546],804,2,36359,4.395961794220772,0.0,0.0
38271,3,8271,[302 427 603 100  64],537,4,36363,4.395913926499033,20.0,20.0
38272,3,8272,[302 427 603 100  64],745,5,36368,4.395986945485314,20.0,20.0
38273,3,8273,[302 427 603 100  64],537,4,36372,4.395939086294416,20.0,20.0
38274,3,8274,[302 427 603 100  64],458,5,36377,4.396012084592145,20.0,20.0
38275,3,8275,[302 427 603 100  64],13,5,36382,4.396085065248912,20.0,20.0
38276,3,8276,[302 427 603 100  64],664,5,36387,4.396158028271112,20.0,20.0
38277,3,8277,[302 427 603 100  64],13,5,36392,4.396230973665136,20.0,20.0
38278,3,8278,[204 265 173 176  97],60,4,36396,4.396183113902645,0.0,0.0
38279,3,8279,[302 427 603 100  64],745,5,36401,4.396256038647343,20.0,20.0
38280,3,8280,[181 175  79 161 179],308,4,36405,4.3962081874169785,0.0,0.0
38281,3,8281,[302 427 603 100  64],370,5,36410,4.396281091523787,20.0,20.0
38282,3,8282,[302 427 603 100  64],90,5,36415,4.3963539780272844,20.0,20.0
38283,3,8283,[238 143 333 175 405],666,2,36417,4.396064703042009,0.0,0.0
38284,3,8284,[294 187 322 216  82],308,2,36419,4.395775497887749,0.0,0.0
38285,3,8285,[302 427 603 100  64],90,5,36424,4.395848419020034,20.0,20.0
38286,3,8286,[302 427 603 100  64],370,5,36429,4.395921322553397,20.0,20.0
38287,3,8287,[302 427 603 100  64],90,5,36434,4.3959942084942085,20.0,20.0
38288,3,8288,[302 427 603 100  64],458,5,36439,4.396067076848836,20.0,20.0
38289,3,8289,[302 427 603 100  64],458,5,36444,4.396139927623643,20.0,20.0
38290,3,8290,[568  96 269  69 496],263,5,36449,4.396212760824991,0.0,0.0
38291,3,8291,[302 427 603 100  64],666,5,36454,4.3962855764592375,20.0,20.0
38292,3,8292,[302 427 603 100  64],271,5,36459,4.396358374532738,20.0,20.0
38293,3,8293,[302 427 603 100  64],664,5,36464,4.396431155051845,20.0,20.0
38294,3,8294,[302 427 603 100  64],13,5,36469,4.396503918022906,20.0,20.0
38295,3,8295,[302 427 603 100  64],13,5,36474,4.396576663452266,20.0,20.0
38296,3,8296,[234  89 144 186 100],13,5,36479,4.39664939134627,0.0,20.0
38297,3,8297,[302 427 603 100  64],271,5,36484,4.396722101711256,20.0,20.0
38298,3,8298,[302 427 603 100  64],745,5,36489,4.396794794553561,20.0,20.0
38299,3,8299,[302 427 603 100  64],90,5,36494,4.396867469879518,20.0,20.0
38300,3,8300,[276 175  56 132   1],892,5,36499,4.3969401276954585,0.0,0.0
38301,3,8301,[302 427 603 100  64],339,5,36504,4.397012768007709,20.0,20.0
38302,3,8302,[302 427 603 100  64],13,5,36509,4.397085390822594,20.0,20.0
38303,3,8303,[302 427 603 100  64],745,5,36514,4.3971579961464355,20.0,20.0
38304,3,8304,[302 427 603 100  64],666,5,36519,4.397230583985551,20.0,20.0
38305,3,8305,[302 427 603 100  64],458,5,36524,4.397303154346256,20.0,20.0
38306,3,8306,[174 132  25  56 289],234,2,36526,4.39701456602865,0.0,20.0
38307,3,8307,[313 118 161  97 435],650,3,36529,4.396846413095811,0.0,0.0
38308,3,8308,[302 427 603 100  64],474,5,36534,4.396919003490192,20.0,20.0
38309,3,8309,[302 427 603 100  64],370,5,36539,4.396991576413959,20.0,20.0
38310,3,8310,[302 427 603 100  64],537,4,36543,4.396943809409216,20.0,20.0
38311,3,8311,[302 427 603 100  64],339,5,36548,4.397016361886429,20.0,20.0
38312,3,8312,[302 427 603 100  64],454,5,36553,4.397088896908457,20.0,20.0
38313,3,8313,[302 427 603 100  64],745,5,36558,4.397161414481597,20.0,20.0
38314,3,8314,[302 427 603 100  64],666,5,36563,4.397233914612147,20.0,20.0
38315,3,8315,[302 427 603 100  64],454,5,36568,4.397306397306397,20.0,20.0
38316,3,8316,[302 427 603 100  64],370,5,36573,4.397378862570639,20.0,20.0
38317,3,8317,[302 427 603 100  64],474,5,36578,4.3974513104111566,20.0,20.0
38318,3,8318,[302 427 603 100  64],90,5,36583,4.3975237408342345,20.0,20.0
38319,3,8319,[302 427 603 100  64],666,5,36588,4.397596153846154,20.0,20.0
38320,3,8320,[302 427 603 100  64],90,5,36593,4.397668549453191,20.0,20.0
38321,3,8321,[302 427 603 100  64],474,5,36598,4.39774092766162,20.0,20.0
38322,3,8322,[234 435 475 385 144],64,4,36602,4.397693139492971,0.0,0.0
38323,3,8323,[191  50  56 603  95],804,3,36605,4.397525228255646,20.0,20.0
38324,3,8324,[258 100 161  69 118],13,5,36610,4.397597597597597,0.0,20.0
38325,3,8325,[121 111 515 294 568],207,2,36612,4.3973096324765795,0.0,0.0
38326,3,8326,[176 273 323 186 655],328,3,36615,4.397141827789119,0.0,0.0
38327,3,8327,[121 100 179 183 151],934,1,36616,4.39673390970221,0.0,20.0
38328,3,8328,[302 427 603 100  64],454,5,36621,4.396806339296434,20.0,20.0
38329,3,8329,[302 427 603 100  64],370,5,36626,4.3968787515006005,20.0,20.0
38330,3,8330,[302 427 603 100  64],339,5,36631,4.39695114632097,20.0,20.0
38331,3,8331,[302 427 603 100  64],745,5,36636,4.397023523763802,20.0,20.0
38332,3,8332,[302 427 603 100  64],745,5,36641,4.3970958838353535,20.0,20.0
38333,3,8333,[302 427 603 100  64],474,5,36646,4.397168226541877,20.0,20.0
38334,3,8334,[302 427 603 100  64],370,5,36651,4.397240551889622,20.0,20.0
38335,3,8335,[302 427 603 100  64],370,5,36656,4.3973128598848366,20.0,20.0
38336,3,8336,[302 427 603 100  64],666,5,36661,4.397385150533765,20.0,20.0
38337,3,8337,[357 237  96 197 176],749,4,36665,4.397337491005037,20.0,0.0
38338,3,8338,[302 427 603 100  64],13,5,36670,4.397409761362273,20.0,20.0
38339,3,8339,[302 427 603 100  64],666,5,36675,4.39748201438849,20.0,20.0
38340,3,8340,[302 427 603 100  64],271,5,36680,4.397554250089917,20.0,20.0
38341,3,8341,[175 294 118  56 186],648,2,36682,4.397266842483817,0.0,0.0
38342,3,8342,[302 427 603 100  64],454,5,36687,4.397339086659475,20.0,20.0
38343,3,8343,[ 79 276  69 172  88],13,4,36691,4.397291466922339,0.0,0.0
38344,3,8344,[ 97  22 182 282 228],479,4,36695,4.397243858597963,0.0,0.0
38345,3,8345,[211 215  96 197  28],313,4,36699,4.397196261682243,0.0,0.0
38346,3,8346,[153   4  64  82 127],64,2,36701,4.396909069126632,0.0,20.0
38347,3,8347,[302 427 603 100  64],13,5,36706,4.396981312889315,20.0,20.0
38348,3,8348,[302 427 603 100  64],664,5,36711,4.39705353934603,20.0,20.0
38349,3,8349,[288 174 185   8 294],234,1,36712,4.396646706586826,0.0,20.0
38350,3,8350,[302 427 603 100  64],370,5,36717,4.396718955813675,20.0,20.0
38351,3,8351,[174 222 427 183 211],234,2,36719,4.396431992337165,0.0,20.0
38352,3,8352,[302 427 603 100  64],537,4,36723,4.396384532503292,20.0,20.0
38353,3,8353,[302 427 603 100  64],454,5,36728,4.396456787167824,20.0,20.0
38354,3,8354,[302 427 603 100  64],90,5,36733,4.396529024536206,20.0,20.0
38355,3,8355,[302 427 603 100  64],13,5,36738,4.396601244614648,20.0,20.0
38356,3,8356,[302 427 603 100  64],458,5,36743,4.396673447409357,20.0,20.0
38357,3,8357,[302 427 603 100  64],454,5,36748,4.396745632926537,20.0,20.0
38358,3,8358,[302 427 603 100  64],666,5,36753,4.396817801172389,20.0,20.0
38359,3,8359,[257  22 313 135 588],650,2,36755,4.396531100478469,0.0,0.0
38360,3,8360,[302 427 603 100  64],458,5,36760,4.3966032771199615,20.0,20.0
38361,3,8361,[302 427 603 100  64],664,5,36765,4.3966754364984455,20.0,20.0
38362,3,8362,[302 427 603 100  64],90,5,36770,4.396747578620112,20.0,20.0
38363,3,8363,[302 427 603 100  64],271,5,36775,4.396819703491152,20.0,20.0
38364,3,8364,[286 181  88 257  15],95,5,36780,4.396891811117753,0.0,0.0
38365,3,8365,[186 228  64 323 204],87,4,36784,4.396844370069328,0.0,0.0
38366,3,8366,[302 427 603 100  64],454,5,36789,4.396916457511653,20.0,20.0
38367,3,8367,[302 427 603 100  64],90,5,36794,4.396988527724665,20.0,20.0
38368,3,8368,[302 427 603 100  64],370,5,36799,4.397060580714542,20.0,20.0
38369,3,8369,[302 427 603 100  64],666,5,36804,4.397132616487455,20.0,20.0
38370,3,8370,[302 427 603 100  64],339,5,36809,4.397204635049576,20.0,20.0
38371,3,8371,[302 427 603 100  64],666,5,36814,4.397276636407071,20.0,20.0
38372,3,8372,[302 427 603 100  64],454,5,36819,4.397348620566105,20.0,20.0
38373,3,8373,[302 427 603 100  64],664,5,36824,4.39742058753284,20.0,20.0
38374,3,8374,[302 427 603 100  64],13,5,36829,4.397492537313433,20.0,20.0
38375,3,8375,[302 427 603 100  64],474,5,36834,4.39756446991404,20.0,20.0
38376,3,8376,[302 427 603 100  64],13,5,36839,4.397636385340814,20.0,20.0
38377,3,8377,[195 655   4 286 300],144,4,36843,4.397588923370733,0.0,0.0
38378,3,8378,[173 742 357  15 111],488,5,36848,4.39766081871345,20.0,0.0
38379,3,8379,[302 427 603 100  64],90,5,36853,4.397732696897375,20.0,20.0
38380,3,8380,[302 427 603 100  64],664,5,36858,4.397804557928648,20.0,20.0
38381,3,8381,[ 96  12  25  56 237],308,4,36862,4.3977570985445,20.0,0.0
38382,3,8382,[302 427 603 100  64],666,5,36867,4.397828939520458,20.0,20.0
38383,3,8383,[ 12 179 302 435 385],343,4,36871,4.397781488549619,20.0,0.0
38384,3,8384,[302 427 603 100  64],90,5,36876,4.397853309481216,20.0,20.0
38385,3,8385,[196 423 187 191 135],506,5,36881,4.397925113284045,0.0,0.0
38386,3,8386,[302 427 603 100  64],13,5,36886,4.39799689996423,20.0,20.0
38387,3,8387,[302 427 603 100  64],458,5,36891,4.398068669527897,20.0,20.0
38388,3,8388,[302 427 603 100  64],458,5,36896,4.398140421981166,20.0,20.0
38389,3,8389,[302 427 603 100  64],666,5,36901,4.398212157330155,20.0,20.0
38390,3,8390,[204  25   7 228 210],374,4,36905,4.398164700274103,0.0,0.0
38391,3,8391,[568 597 258 313  64],92,3,36908,4.397998093422307,0.0,0.0
38392,3,8392,[302 427 603 100  64],537,4,36912,4.397950673180031,20.0,20.0
38393,3,8393,[222  15 234  28  71],901,5,36917,4.398022396950203,0.0,0.0
38394,3,8394,[302 427 603 100  64],370,5,36922,4.398094103633115,20.0,20.0
38395,3,8395,[302 427 603 100  64],474,5,36927,4.398165793234874,20.0,20.0
38396,3,8396,[323 144 245  25 603],804,5,36932,4.398237465761581,20.0,0.0
38397,3,8397,[302 427 603 100  64],745,5,36937,4.398309121219338,20.0,20.0
38398,3,8398,[302 427 603 100  64],745,5,36942,4.3983807596142395,20.0,20.0
38399,3,8399,[655 161 496 174  56],749,3,36945,4.398214285714285,0.0,20.0
38400,3,8400,[302 427 603 100  64],666,5,36950,4.3982859183430545,20.0,20.0
38401,3,8401,[302 427 603 100  64],745,5,36955,4.398357533920495,20.0,20.0
38402,3,8402,[234 179 195  12 288],374,3,36958,4.398191122218256,20.0,0.0
38403,3,8403,[302 427 603 100  64],13,5,36963,4.398262732032365,20.0,20.0
38404,3,8404,[180 197 161 245  56],10,5,36968,4.398334324806663,0.0,0.0
38405,3,8405,[302 427 603 100  64],90,5,36973,4.398405900547228,20.0,20.0
38406,3,8406,[196  50 168 294 403],7,4,36977,4.398358510764838,0.0,20.0
38407,3,8407,[302 427 603 100  64],474,5,36982,4.398430066603235,20.0,20.0
38408,3,8408,[302 427 603 100  64],13,5,36987,4.398501605422761,20.0,20.0
38409,3,8409,[302 427 603 100  64],13,5,36992,4.398573127229489,20.0,20.0
38410,3,8410,[302 427 603 100  64],90,5,36997,4.398644632029486,20.0,20.0
38411,3,8411,[196 300 204 168 245],334,3,37000,4.3984783642415595,0.0,0.0
38412,3,8412,[302 427 603 100  64],90,5,37005,4.398549863306787,20.0,20.0
38413,3,8413,[302 427 603 100  64],666,5,37010,4.398621345376753,20.0,20.0
38414,3,8414,[302 427 603 100  64],474,5,37015,4.398692810457517,20.0,20.0
38415,3,8415,[405 100 187  89 111],334,3,37018,4.3985266159695815,0.0,20.0
38416,3,8416,[257 328 276   7 742],294,4,37022,4.398479268147796,0.0,0.0
38417,3,8417,[302 427 603 100  64],666,5,37027,4.398550724637682,20.0,20.0
38418,3,8418,[222  28 235 228 385],194,1,37028,4.398147048343033,0.0,0.0
38419,3,8419,[302 427 603 100  64],745,5,37033,4.3982185273159145,20.0,20.0
38420,3,8420,[302 427 603 100  64],339,5,37038,4.398289989312433,20.0,20.0
38421,3,8421,[302 427 603 100  64],90,5,37043,4.398361434338637,20.0,20.0
38422,3,8422,[302 427 603 100  64],745,5,37048,4.39843286240057,20.0,20.0
38423,3,8423,[173 191 269   7 204],738,4,37052,4.398385565052232,0.0,0.0
38424,3,8424,[302 427 603 100  64],454,5,37057,4.398456973293769,20.0,20.0
38425,3,8425,[302 427 603 100  64],370,5,37062,4.398528364585806,20.0,20.0
38426,3,8426,[302 427 603 100  64],90,5,37067,4.398599738934378,20.0,20.0
38427,3,8427,[302 427 603 100  64],666,5,37072,4.398671096345515,20.0,20.0
38428,3,8428,[302 427 603 100  64],474,5,37077,4.398742436825247,20.0,20.0
38429,3,8429,[125  25 357 135  71],194,2,37079,4.398457888493476,20.0,0.0
38430,3,8430,[ 50  69 228 603 318],234,4,37083,4.398410627446329,40.0,20.0
38431,3,8431,[318   8 301 144 204],455,2,37085,4.3981261859582546,20.0,0.0
38432,3,8432,[302 427 603 100  64],666,5,37090,4.3981975572157,20.0,20.0
38433,3,8433,[313 175   4 202 179],234,2,37092,4.39791320844202,0.0,0.0
38434,3,8434,[302 427 603 100  64],537,4,37096,4.397866034380558,20.0,20.0
38435,3,8435,[185 265 179 151 204],648,4,37100,4.397818871503082,0.0,0.0
38436,3,8436,[302 427 603 100  64],454,5,37105,4.397890245347872,20.0,20.0
38437,3,8437,[197 174 153 121 181],207,3,37108,4.397724579284191,0.0,20.0
38438,3,8438,[302 427 603 100  64],537,4,37112,4.397677449934826,20.0,20.0
38439,3,8439,[302 427 603 100  64],745,5,37117,4.397748815165877,20.0,20.0
38440,3,8440,[302 427 603 100  64],537,4,37121,4.397701694112072,20.0,20.0
38441,3,8441,[302 427 603 100  64],90,5,37126,4.397773039564084,20.0,20.0
38442,3,8442,[588  22  70 423 174],13,4,37130,4.397725926803269,0.0,20.0
38443,3,8443,[175 132 603 294 176],666,4,37134,4.397678825201327,20.0,0.0
38444,3,8444,[302 427 603 100  64],454,5,37139,4.397750148016578,20.0,20.0
38445,3,8445,[302 427 603 100  64],474,5,37144,4.3978214539426945,20.0,20.0
38446,3,8446,[302 427 603 100  64],458,5,37149,4.397892742985675,20.0,20.0
38447,3,8447,[302 427 603 100  64],666,5,37154,4.397964015151516,20.0,20.0
38448,3,8448,[302 427 603 100  64],454,5,37159,4.398035270446207,20.0,20.0
38449,3,8449,[302 427 603 100  64],13,5,37164,4.39810650887574,20.0,20.0
38450,3,8450,[302 427 603 100  64],339,5,37169,4.398177730446101,20.0,20.0
38451,3,8451,[302 427 603 100  64],370,5,37174,4.3982489351632745,20.0,20.0
38452,3,8452,[273 186   4 423  56],378,3,37177,4.398083520643558,0.0,0.0
38453,3,8453,[302 427 603 100  64],537,4,37181,4.398036432458008,20.0,20.0
38454,3,8454,[302 427 603 100  64],458,5,37186,4.3981076286221175,20.0,20.0
38455,3,8455,[302 427 603 100  64],666,5,37191,4.39817880794702,20.0,20.0
38456,3,8456,[302 427 603 100  64],745,5,37196,4.39824997043869,20.0,20.0
38457,3,8457,[302 427 603 100  64],458,5,37201,4.398321116103098,20.0,20.0
38458,3,8458,[302 427 603 100  64],458,5,37206,4.398392244946211,20.0,20.0
38459,3,8459,[302 427 603 100  64],454,5,37211,4.398463356973996,20.0,20.0
38460,3,8460,[302 427 603 100  64],90,5,37216,4.398534452192412,20.0,20.0
38461,3,8461,[302 427 603 100  64],454,5,37221,4.398605530607421,20.0,20.0
38462,3,8462,[302 427 603 100  64],339,5,37226,4.398676592224979,20.0,20.0
38463,3,8463,[302 427 603 100  64],745,5,37231,4.39874763705104,20.0,20.0
38464,3,8464,[302 427 603 100  64],458,5,37236,4.398818665091554,20.0,20.0
38465,3,8465,[302 427 603 100  64],454,5,37241,4.398889676352469,20.0,20.0
38466,3,8466,[302 427 603 100  64],454,5,37246,4.398960670839731,20.0,20.0
38467,3,8467,[302 427 603 100  64],458,5,37251,4.399031648559282,20.0,20.0
38468,3,8468,[ 97 174 238  69 385],474,5,37256,4.399102609517063,0.0,20.0
38469,3,8469,[302 427 603 100  64],271,5,37261,4.399173553719009,20.0,20.0
38470,3,8470,[185 568  79 328 238],95,4,37265,4.3991264313540315,0.0,0.0
38471,3,8471,[302 427 603 100  64],454,5,37270,4.399197355996223,20.0,20.0
38472,3,8472,[302 427 603 100  64],458,5,37275,4.399268263897085,20.0,20.0
38473,3,8473,[302 427 603 100  64],339,5,37280,4.3993391550625445,20.0,20.0
38474,3,8474,[302 427 603 100  64],666,5,37285,4.399410029498525,20.0,20.0
38475,3,8475,[302 427 603 100  64],339,5,37290,4.399480887210949,20.0,20.0
38476,3,8476,[  7 496 161  64 483],524,2,37292,4.399197829420785,20.0,0.0
38477,3,8477,[302 427 603 100  64],474,5,37297,4.39926869544704,20.0,20.0
38478,3,8478,[302 427 603 100  64],474,5,37302,4.399339544757637,20.0,20.0
38479,3,8479,[172 238 174 496 318],311,5,37307,4.399410377358491,20.0,20.0
38480,3,8480,[302 427 603 100  64],370,5,37312,4.399481193255513,20.0,20.0
38481,3,8481,[302 427 603 100  64],339,5,37317,4.39955199245461,20.0,20.0
38482,3,8482,[302 427 603 100  64],339,5,37322,4.3996227749616885,20.0,20.0
38483,3,8483,[ 50  25 125 181  70],378,4,37326,4.3995756718529,0.0,20.0
38484,3,8484,[302 427 603 100  64],90,5,37331,4.399646434885091,20.0,20.0
38485,3,8485,[302 427 603 100  64],370,5,37336,4.399717181239689,20.0,20.0
38486,3,8486,[302 427 603 100  64],454,5,37341,4.399787910922588,20.0,20.0
38487,3,8487,[195 161 100 191 423],194,3,37344,4.399622997172479,0.0,20.0
38488,3,8488,[302 427 603 100  64],13,5,37349,4.39969372128637,20.0,20.0
38489,3,8489,[302 427 603 100  64],664,5,37354,4.399764428739694,20.0,20.0
38490,3,8490,[302 427 603 100  64],666,5,37359,4.399835119538334,20.0,20.0
38491,3,8491,[ 56 210 385 597 333],346,4,37363,4.399788035798398,0.0,0.0
38492,3,8492,[302 427 603 100  64],537,4,37367,4.399740963146121,20.0,20.0
38493,3,8493,[135  98 121 276 186],210,5,37372,4.399811631740052,0.0,20.0
38494,3,8494,[302 427 603 100  64],537,4,37376,4.399764567392584,20.0,20.0
38495,3,8495,[302 427 603 100  64],474,5,37381,4.399835216572504,20.0,20.0
38496,3,8496,[302 427 603 100  64],664,5,37386,4.39990584912322,20.0,20.0
38497,3,8497,[ 79  12 328 385 121],833,1,37387,4.399505766062603,20.0,0.0
38498,3,8498,[302 427 603 100  64],666,5,37392,4.399576420755383,20.0,20.0
38499,3,8499,[302 427 603 100  64],666,5,37397,4.399647058823529,20.0,20.0
38500,3,8500,[153 179 181 257 176],749,4,37401,4.399600047053288,0.0,0.0
38501,3,8501,[302 427 603 100  64],666,5,37406,4.399670665725711,20.0,20.0
38502,3,8502,[302 427 603 100  64],271,5,37411,4.39974126778784,20.0,20.0
38503,3,8503,[302 427 603 100  64],664,5,37416,4.399811853245532,20.0,20.0
38504,3,8504,[302 427 603 100  64],745,5,37421,4.399882422104644,20.0,20.0
38505,3,8505,[302 427 603 100  64],90,5,37426,4.399952974371033,20.0,20.0
38506,3,8506,[153  64 403 258  11],788,2,37428,4.399670859292348,0.0,0.0
38507,3,8507,[211  96 168 423  82],308,5,37433,4.399741419840151,0.0,0.0
38508,3,8508,[302 427 603 100  64],13,5,37438,4.399811963803032,20.0,20.0
38509,3,8509,[271 742 276 323 222],119,4,37442,4.399764982373678,0.0,0.0
38510,3,8510,[302 427 603 100  64],474,5,37447,4.399835506990953,20.0,20.0
38511,3,8511,[211  50 427  64 597],452,4,37451,4.399788533834586,0.0,20.0
38512,3,8512,[603 168 187  11 202],59,5,37456,4.399859039116645,20.0,0.0
38513,3,8513,[182  50 238 117 176],387,3,37459,4.399694620624853,0.0,20.0
38514,3,8514,[427 191 151 195 174],833,3,37462,4.399530240751615,0.0,20.0
38515,3,8515,[302 427 603 100  64],271,5,37467,4.399600751526538,20.0,20.0
38516,3,8516,[211 423 111 286 603],452,3,37470,4.399436421275097,20.0,0.0
38517,3,8517,[ 12  64 144 302 182],144,3,37473,4.39927212960789,20.0,0.0
38518,3,8518,[302 427 603 100  64],664,5,37478,4.399342645850452,20.0,20.0
38519,3,8519,[302 427 603 100  64],537,4,37482,4.399295774647888,20.0,20.0
38520,3,8520,[302 427 603 100  64],664,5,37487,4.399366271564371,20.0,20.0
38521,3,8521,[302 427 603 100  64],13,5,37492,4.3994367519361655,20.0,20.0
38522,3,8522,[302 427 603 100  64],454,5,37497,4.399507215769096,20.0,20.0
38523,3,8523,[496  15  70  11 135],488,3,37500,4.3993430314406385,0.0,0.0
38524,3,8524,[302 427 603 100  64],474,5,37505,4.39941348973607,20.0,20.0
38525,3,8525,[318 181  89 168 333],387,3,37508,4.39924935491438,20.0,0.0
38526,3,8526,[302 427 603 100  64],90,5,37513,4.399319807669755,20.0,20.0
38527,3,8527,[302 427 603 100  64],370,5,37518,4.399390243902439,20.0,20.0
38528,3,8528,[302 427 603 100  64],664,5,37523,4.399460663618243,20.0,20.0
38529,3,8529,[302 427 603 100  64],745,5,37528,4.399531066822978,20.0,20.0
38530,3,8530,[302 427 603 100  64],90,5,37533,4.399601453522448,20.0,20.0
38531,3,8531,[302 427 603 100  64],474,5,37538,4.399671823722457,20.0,20.0
38532,3,8532,[302 427 603 100  64],664,5,37543,4.399742177428806,20.0,20.0
38533,3,8533,[234  12 288 200 300],13,2,37545,4.399460979610968,20.0,0.0
38534,3,8534,[302 427 603 100  64],745,5,37550,4.399531341534856,20.0,20.0
38535,3,8535,[302 427 603 100  64],664,5,37555,4.399601686972821,20.0,20.0
38536,3,8536,[302 427 603 100  64],537,4,37559,4.399554878763031,20.0,20.0
38537,3,8537,[185 168 180 204 127],271,3,37562,4.399390958069805,0.0,20.0
38538,3,8538,[302 427 603 100  64],370,5,37567,4.399461295233634,20.0,20.0
38539,3,8539,[302 427 603 100  64],271,5,37572,4.399531615925058,20.0,20.0
38540,3,8540,[302 427 603 100  64],458,5,37577,4.399601920149865,20.0,20.0
38541,3,8541,[302 427 603 100  64],271,5,37582,4.399672207913838,20.0,20.0
38542,3,8542,[302 427 603 100  64],458,5,37587,4.3997424792227555,20.0,20.0
38543,3,8543,[222 191 245 286 742],533,4,37591,4.3996956928838955,0.0,0.0
38544,3,8544,[302 427 603 100  64],370,5,37596,4.399765944997075,20.0,20.0
38545,3,8545,[302 427 603 100  64],370,5,37601,4.399836180669319,20.0,20.0
38546,3,8546,[302 427 603 100  64],666,5,37606,4.3999063999064,20.0,20.0
38547,3,8547,[302 427 603 100  64],666,5,37611,4.399976602714085,20.0,20.0
38548,3,8548,[302 427 603 100  64],370,5,37616,4.40004678909814,20.0,20.0
38549,3,8549,[302 427 603 100  64],339,5,37621,4.400116959064327,20.0,20.0
38550,3,8550,[302 427 603 100  64],339,5,37626,4.400187112618407,20.0,20.0
38551,3,8551,[302 427 603 100  64],370,5,37631,4.4002572497661365,20.0,20.0
38552,3,8552,[302 427 603 100  64],666,5,37636,4.400327370513271,20.0,20.0
38553,3,8553,[ 70 143 427 180  69],312,5,37641,4.40039747486556,0.0,0.0
38554,3,8554,[302 427 603 100  64],454,5,37646,4.400467562828755,20.0,20.0
38555,3,8555,[302 427 603 100  64],474,5,37651,4.400537634408602,20.0,20.0
38556,3,8556,[302 427 603 100  64],537,4,37655,4.400490826224144,20.0,20.0
38557,3,8557,[302 427 603 100  64],745,5,37660,4.400560878709979,20.0,20.0
38558,3,8558,[ 98 143  28  56 228],648,4,37664,4.400514078747517,0.0,20.0
38559,3,8559,[403 282 135 423 100],328,2,37666,4.400233644859813,0.0,20.0
38560,3,8560,[302 427 603 100  64],666,5,37671,4.400303702838453,20.0,20.0
38561,3,8561,[302 427 603 100  64],664,5,37676,4.400373744452231,20.0,20.0
38562,3,8562,[302 427 603 100  64],474,5,37681,4.400443769706879,20.0,20.0
38563,3,8563,[302 427 603 100  64],458,5,37686,4.400513778608127,20.0,20.0
38564,3,8564,[215 245 191  70   4],533,3,37689,4.400350262697023,0.0,0.0
38565,3,8565,[302 427 603 100  64],454,5,37694,4.400420266168574,20.0,20.0
38566,3,8566,[302 427 603 100  64],474,5,37699,4.400490253297537,20.0,20.0
38567,3,8567,[ 69 237 423   1 222],533,4,37703,4.400443510737628,0.0,0.0
38568,3,8568,[ 79 210  89  69   9],59,5,37708,4.400513478818999,0.0,0.0
38569,3,8569,[302 427 603 100  64],458,5,37713,4.400583430571762,20.0,20.0
38570,3,8570,[302 427 603 100  64],339,5,37718,4.400653366001634,20.0,20.0
38571,3,8571,[302 427 603 100  64],370,5,37723,4.400723285114326,20.0,20.0
38572,3,8572,[302 427 603 100  64],370,5,37728,4.400793187915549,20.0,20.0
38573,3,8573,[302 427 603 100  64],339,5,37733,4.40086307441101,20.0,20.0
38574,3,8574,[  8 168 174 515 496],326,4,37737,4.400816326530612,0.0,20.0
38575,3,8575,[302 427 603 100  64],474,5,37742,4.400886194029851,20.0,20.0
38576,3,8576,[302 427 603 100  64],474,5,37747,4.400956045237263,20.0,20.0
38577,3,8577,[302 427 603 100  64],339,5,37752,4.401025880158545,20.0,20.0
38578,3,8578,[302 427 603 100  64],474,5,37757,4.401095698799394,20.0,20.0
38579,3,8579,[302 427 603 100  64],90,5,37762,4.401165501165501,20.0,20.0
38580,3,8580,[302 427 603 100  64],474,5,37767,4.401235287262557,20.0,20.0
38581,3,8581,[302 427 603 100  64],745,5,37772,4.4013050570962475,20.0,20.0
38582,3,8582,[302 427 603 100  64],339,5,37777,4.401374810672259,20.0,20.0
38583,3,8583,[ 50  88 273 546 176],234,1,37778,4.400978564771668,0.0,20.0
38584,3,8584,[181 286 748 186 111],207,1,37779,4.400582411182294,0.0,0.0
38585,3,8585,[302 427 603 100  64],454,5,37784,4.400652224551596,20.0,20.0
38586,3,8586,[ 22 405 153 211 328],95,3,37787,4.400489111447537,0.0,0.0
38587,3,8587,[302 427 603 100  64],745,5,37792,4.40055891942245,20.0,20.0
38588,3,8588,[302 427 603 100  64],370,5,37797,4.400628711142159,20.0,20.0
38589,3,8589,[302 427 603 100  64],454,5,37802,4.40069848661234,20.0,20.0
38590,3,8590,[302 427 603 100  64],745,5,37807,4.400768245838669,20.0,20.0
38591,3,8591,[302 427 603 100  64],90,5,37812,4.400837988826815,20.0,20.0
38592,3,8592,[121   4 286 245 168],653,3,37815,4.400674967997207,0.0,0.0
38593,3,8593,[  4 194 588 568  22],650,1,37816,4.400279264603212,0.0,0.0
38594,3,8594,[ 15 546 276 258 294],486,2,37818,4.4,0.0,0.0
38595,3,8595,[302 427 603 100  64],13,5,37823,4.400069799906934,20.0,20.0
38596,3,8596,[302 427 603 100  64],666,5,37828,4.400139583575666,20.0,20.0
38597,3,8597,[302 427 603 100  64],474,5,37833,4.400209351011863,20.0,20.0
38598,3,8598,[127 275 483 172 174],452,5,37838,4.400279102221188,20.0,40.0
38599,3,8599,[302 427 603 100  64],339,5,37843,4.400348837209302,20.0,20.0
38600,3,8600,[302 427 603 100  64],537,4,37847,4.400302290431346,20.0,20.0
38601,3,8601,[302 427 603 100  64],13,5,37852,4.400372006510114,20.0,20.0
38602,3,8602,[302 427 603 100  64],666,5,37857,4.4004417063814945,20.0,20.0
38603,3,8603,[302 427 603 100  64],666,5,37862,4.400511390051139,20.0,20.0
38604,3,8604,[302 427 603 100  64],13,5,37867,4.400581057524695,20.0,20.0
38605,3,8605,[302 427 603 100  64],745,5,37872,4.400650708807809,20.0,20.0
38606,3,8606,[302 427 603 100  64],13,5,37877,4.400720343906123,20.0,20.0
38607,3,8607,[302 427 603 100  64],339,5,37882,4.400789962825279,20.0,20.0
38608,3,8608,[ 88 196  28 183 100],308,3,37885,4.400627250551748,0.0,20.0
38609,3,8609,[302 427 603 100  64],458,5,37890,4.400696864111498,20.0,20.0
38610,3,8610,[302 427 603 100  64],664,5,37895,4.400766461502729,20.0,20.0
38611,3,8611,[302 427 603 100  64],90,5,37900,4.400836042731073,20.0,20.0
38612,3,8612,[302 427 603 100  64],458,5,37905,4.40090560780216,20.0,20.0
38613,3,8613,[228 333  79 288 100],343,3,37908,4.400742976549803,0.0,20.0
38614,3,8614,[302 427 603 100  64],458,5,37913,4.400812536273941,20.0,20.0
38615,3,8615,[289 568 174 268 127],537,2,37915,4.400533890436398,0.0,40.0
38616,3,8616,[385 176 245  69  88],749,4,37919,4.400487408610886,0.0,0.0
38617,3,8617,[302 427 603 100  64],90,5,37924,4.400556973775818,20.0,20.0
38618,3,8618,[302 427 603 100  64],745,5,37929,4.400626522798468,20.0,20.0
38619,3,8619,[302 427 603 100  64],666,5,37934,4.400696055684454,20.0,20.0
38620,3,8620,[302 427 603 100  64],666,5,37939,4.400765572439393,20.0,20.0
38621,3,8621,[302 427 603 100  64],664,5,37944,4.400835073068894,20.0,20.0
38622,3,8622,[302 427 603 100  64],90,5,37949,4.400904557578569,20.0,20.0
38623,3,8623,[302 427 603 100  64],90,5,37954,4.400974025974026,20.0,20.0
38624,3,8624,[302 427 603 100  64],13,5,37959,4.40104347826087,20.0,20.0
38625,3,8625,[ 89  22 403 655 187],13,4,37963,4.400996985856712,0.0,0.0
38626,3,8626,[302 427 603 100  64],474,5,37968,4.401066419381013,20.0,20.0
38627,3,8627,[302 427 603 100  64],454,5,37973,4.401135836810385,20.0,20.0
38628,3,8628,[302 427 603 100  64],474,5,37978,4.401205238150423,20.0,20.0
38629,3,8629,[302 427 603 100  64],745,5,37983,4.401274623406721,20.0,20.0
38630,3,8630,[302 427 603 100  64],745,5,37988,4.401343992584868,20.0,20.0
38631,3,8631,[302 427 603 100  64],474,5,37993,4.401413345690454,20.0,20.0
38632,3,8632,[302 427 603 100  64],90,5,37998,4.401482682729063,20.0,20.0
38633,3,8633,[186 216 175  64 496],60,5,38003,4.401552003706278,0.0,0.0
38634,3,8634,[302 427 603 100  64],13,5,38008,4.401621308627678,20.0,20.0
38635,3,8635,[245 568 258 117 121],378,3,38011,4.40145900880037,0.0,0.0
38636,3,8636,[211  97 187 385  79],897,4,38015,4.401412527497974,0.0,0.0
38637,3,8637,[302 427 603 100  64],271,5,38020,4.401481824496411,20.0,20.0
38638,3,8638,[302 427 603 100  64],458,5,38025,4.40155110545202,20.0,20.0
38639,3,8639,[269 183 100 181 191],738,3,38028,4.401388888888889,0.0,20.0
38640,3,8640,[288 678 234 286 546],455,2,38030,4.401110982525171,0.0,0.0
38641,3,8641,[302 427 603 100  64],537,4,38034,4.401064568386947,20.0,20.0
38642,3,8642,[302 427 603 100  64],370,5,38039,4.401133865555941,20.0,20.0
38643,3,8643,[ 97 282 100 210 179],406,4,38043,4.401087459509486,0.0,20.0
38644,3,8644,[143  50 168 357 238],650,5,38048,4.401156737998844,20.0,20.0
38645,3,8645,[603 357 211 194 257],666,3,38051,4.400994679620633,40.0,0.0
38646,3,8646,[302 427 603 100  64],370,5,38056,4.401063952816005,20.0,20.0
38647,3,8647,[ 11 179 471 216   8],378,2,38058,4.400786308973173,0.0,0.0
38648,3,8648,[475 313 568 496 655],537,3,38061,4.400624349635796,0.0,0.0
38649,3,8649,[202 175 176 194 168],64,5,38066,4.400693641618497,0.0,0.0
38650,3,8650,[302 427 603 100  64],474,5,38071,4.400762917581782,20.0,20.0
38651,3,8651,[302 427 603 100  64],474,5,38076,4.400832177531207,20.0,20.0
38652,3,8652,[118 187 328 286 237],13,3,38079,4.40067028776147,0.0,0.0
38653,3,8653,[302 427 603 100  64],458,5,38084,4.400739542408135,20.0,20.0
38654,3,8654,[302 427 603 100  64],474,5,38089,4.400808781051415,20.0,20.0
38655,3,8655,[302 427 603 100  64],537,4,38093,4.40076247689464,20.0,20.0
38656,3,8656,[302 427 603 100  64],458,5,38098,4.400831696892688,20.0,20.0
38657,3,8657,[302 427 603 100  64],271,5,38103,4.400900900900901,20.0,20.0
38658,3,8658,[151 257 176 174 111],447,2,38105,4.400623628594526,0.0,20.0
38659,3,8659,[302 427 603 100  64],474,5,38110,4.400692840646651,20.0,20.0
38660,3,8660,[302 427 603 100  64],458,5,38115,4.400762036716315,20.0,20.0
38661,3,8661,[302 427 603 100  64],666,5,38120,4.400831216809051,20.0,20.0
38662,3,8662,[302 427 603 100  64],474,5,38125,4.400900380930394,20.0,20.0
38663,3,8663,[302 427 603 100  64],271,5,38130,4.400969529085873,20.0,20.0
38664,3,8664,[302 427 603 100  64],458,5,38135,4.4010386612810155,20.0,20.0
38665,3,8665,[302 427 603 100  64],666,5,38140,4.401107777521347,20.0,20.0
38666,3,8666,[302 427 603 100  64],458,5,38145,4.401176877812392,20.0,20.0
38667,3,8667,[302 427 603 100  64],454,5,38150,4.401245962159668,20.0,20.0
38668,3,8668,[127  28 195 172 238],210,4,38154,4.401199677010036,0.0,20.0
38669,3,8669,[302 427 603 100  64],474,5,38159,4.401268742791234,20.0,20.0
38670,3,8670,[302 427 603 100  64],271,5,38164,4.40133779264214,20.0,20.0
38671,3,8671,[302 427 603 100  64],90,5,38169,4.401406826568266,20.0,20.0
38672,3,8672,[302 427 603 100  64],474,5,38174,4.401475844575118,20.0,20.0
38673,3,8673,[302 427 603 100  64],13,5,38179,4.4015448466682034,20.0,20.0
38674,3,8674,[302 427 603 100  64],271,5,38184,4.401613832853026,20.0,20.0
38675,3,8675,[302 427 603 100  64],537,4,38188,4.401567542646381,20.0,20.0
38676,3,8676,[302 427 603 100  64],537,4,38192,4.40152126310937,20.0,20.0
38677,3,8677,[176 161 111 153 313],234,1,38193,4.401129292463701,0.0,0.0
38678,3,8678,[302 427 603 100  64],339,5,38198,4.401198294734416,20.0,20.0
38679,3,8679,[121 275  25   9  79],7,4,38202,4.401152073732719,0.0,0.0
38680,3,8680,[127 210 273 546 588],308,3,38205,4.400990669277733,0.0,20.0
38681,3,8681,[302 427 603 100  64],745,5,38210,4.4010596636719646,20.0,20.0
38682,3,8682,[ 50 228 161 195 273],374,2,38212,4.400783139467926,0.0,20.0
38683,3,8683,[ 70 174 471 135  98],882,4,38216,4.400736987563335,0.0,40.0
38684,3,8684,[471 176 568 200 405],313,3,38219,4.400575705238918,0.0,0.0
38685,3,8685,[302 427 603 100  64],339,5,38224,4.400644715634354,20.0,20.0
38686,3,8686,[ 28   8  50 191 471],455,5,38229,4.4007137101415905,0.0,20.0
38687,3,8687,[302 427 603 100  64],454,5,38234,4.400782688766114,20.0,20.0
38688,3,8688,[302 427 603 100  64],458,5,38239,4.400851651513408,20.0,20.0
38689,3,8689,[302 427 603 100  64],537,4,38243,4.400805523590334,20.0,20.0
38690,3,8690,[302 427 603 100  64],271,5,38248,4.4008744678402945,20.0,20.0
38691,3,8691,[176  89 151 135 655],666,4,38252,4.4008283479061205,0.0,0.0
38692,3,8692,[302 427 603 100  64],339,5,38257,4.400897273668469,20.0,20.0
38693,3,8693,[302 427 603 100  64],339,5,38262,4.400966183574879,20.0,20.0
38694,3,8694,[357 286 328  82 300],537,1,38263,4.400575043128234,20.0,0.0
38695,3,8695,[302 427 603 100  64],745,5,38268,4.400643974241031,20.0,20.0
38696,3,8696,[302 427 603 100  64],339,5,38273,4.4007128895021275,20.0,20.0
38697,3,8697,[ 70 257 153 286 496],95,5,38278,4.4007817889169925,0.0,0.0
38698,3,8698,[302 427 603 100  64],745,5,38283,4.4008506724910905,20.0,20.0
38699,3,8699,[302 427 603 100  64],339,5,38288,4.400919540229885,20.0,20.0
38700,3,8700,[302 427 603 100  64],745,5,38293,4.400988392138834,20.0,20.0
38701,3,8701,[302 427 603 100  64],664,5,38298,4.401057228223397,20.0,20.0
38702,3,8702,[302 427 603 100  64],745,5,38303,4.401126048489027,20.0,20.0
38703,3,8703,[302 427 603 100  64],454,5,38308,4.401194852941177,20.0,20.0
38704,3,8704,[302 427 603 100  64],666,5,38313,4.401263641585296,20.0,20.0
38705,3,8705,[215  22 546 135 121],92,3,38316,4.401102687801516,0.0,0.0
38706,3,8706,[302 427 603 100  64],271,5,38321,4.401171471230045,20.0,20.0
38707,3,8707,[100  96 216 179 333],537,2,38323,4.400895728066146,0.0,20.0
38708,3,8708,[302 427 603 100  64],90,5,38328,4.400964519462625,20.0,20.0
38709,3,8709,[302 427 603 100  64],664,5,38333,4.4010332950631454,20.0,20.0
38710,3,8710,[302 427 603 100  64],745,5,38338,4.4011020548731485,20.0,20.0
38711,3,8711,[588 211 195 237  15],59,3,38341,4.400941230486685,0.0,0.0
38712,3,8712,[483 111 173 265 151],59,5,38346,4.4010099850797655,20.0,0.0
38713,3,8713,[302 427 603 100  64],745,5,38351,4.401078723892587,20.0,20.0
38714,3,8714,[302 427 603 100  64],664,5,38356,4.40114744693058,20.0,20.0
38715,3,8715,[ 64 423  56   7 271],92,3,38359,4.400986691142726,0.0,0.0
38716,3,8716,[302 427 603 100  64],474,5,38364,4.401055408970977,20.0,20.0
38717,3,8717,[195 228  28 265  70],7,4,38368,4.401009405827025,0.0,0.0
38718,3,8718,[302 427 603 100  64],370,5,38373,4.401078105287303,20.0,20.0
38719,3,8719,[302 427 603 100  64],474,5,38378,4.401146788990825,20.0,20.0
38720,3,8720,[194 245  89 143 300],313,3,38381,4.40098612544433,0.0,0.0
38721,3,8721,[302 427 603 100  64],370,5,38386,4.401054803944049,20.0,20.0
38722,3,8722,[302 427 603 100  64],666,5,38391,4.401123466697237,20.0,20.0
38723,3,8723,[302 427 603 100  64],745,5,38396,4.401192113709308,20.0,20.0
38724,3,8724,[302 427 603 100  64],339,5,38401,4.401260744985674,20.0,20.0
38725,3,8725,[302 427 603 100  64],474,5,38406,4.4013293605317445,20.0,20.0
38726,3,8726,[302 427 603 100  64],474,5,38411,4.401397960352928,20.0,20.0
38727,3,8727,[302 427 603 100  64],458,5,38416,4.401466544454629,20.0,20.0
38728,3,8728,[216 135  79  69 196],474,5,38421,4.40153511284225,0.0,0.0
38729,3,8729,[302 427 603 100  64],13,5,38426,4.401603665521192,20.0,20.0
38730,3,8730,[302 427 603 100  64],458,5,38431,4.40167220249685,20.0,20.0
38731,3,8731,[302 427 603 100  64],745,5,38436,4.401740723774622,20.0,20.0
38732,3,8732,[135  71 237 257 182],95,2,38438,4.401465704797893,0.0,0.0
38733,3,8733,[289 742  79  98   9],881,3,38441,4.401305243874513,0.0,20.0
38734,3,8734,[  7  25 100 194   1],234,2,38443,4.401030337721809,0.0,20.0
38735,3,8735,[302 427 603 100  64],745,5,38448,4.4010989010989015,20.0,20.0
38736,3,8736,[302 427 603 100  64],339,5,38453,4.401167448781046,20.0,20.0
38737,3,8737,[302 427 603 100  64],370,5,38458,4.401235980773633,20.0,20.0
38738,3,8738,[ 69 100 546 483  70],881,3,38461,4.401075637944845,20.0,20.0
38739,3,8739,[302 427 603 100  64],474,5,38466,4.401144164759725,20.0,20.0
38740,3,8740,[302 427 603 100  64],370,5,38471,4.401212675895207,20.0,20.0
38741,3,8741,[302 427 603 100  64],666,5,38476,4.401281171356669,20.0,20.0
38742,3,8742,[302 427 603 100  64],90,5,38481,4.401349651149491,20.0,20.0
38743,3,8743,[216 294 100 228 194],82,4,38485,4.401303751143641,0.0,20.0
38744,3,8744,[302 427 603 100  64],370,5,38490,4.4013722126929675,20.0,20.0
38745,3,8745,[182 237 496 405 222],313,2,38492,4.401097644637549,0.0,0.0
38746,3,8746,[301 294 546  50  28],328,2,38494,4.400823139362067,0.0,20.0
38747,3,8747,[302 427 603 100  64],666,5,38499,4.4008916323731135,20.0,20.0
38748,3,8748,[302 427 603 100  64],370,5,38504,4.400960109726826,20.0,20.0
38749,3,8749,[302 427 603 100  64],745,5,38509,4.401028571428571,20.0,20.0
38750,3,8750,[302 427 603 100  64],474,5,38514,4.401097017483716,20.0,20.0
38751,3,8751,[ 25  88  69  71 423],648,2,38516,4.400822669104205,0.0,0.0
38752,3,8752,[ 28 258   8 183 588],64,4,38520,4.400776876499486,0.0,0.0
38753,3,8753,[302 427 603 100  64],745,5,38525,4.400845327850126,20.0,20.0
38754,3,8754,[302 427 603 100  64],745,5,38530,4.400913763563678,20.0,20.0
38755,3,8755,[302 427 603 100  64],666,5,38535,4.4009821836455005,20.0,20.0
38756,3,8756,[302 427 603 100  64],13,5,38540,4.401050588100948,20.0,20.0
38757,3,8757,[302 427 603 100  64],13,5,38545,4.401118976935374,20.0,20.0
38758,3,8758,[186 328 546 405 151],95,3,38548,4.400959013586026,0.0,0.0
38759,3,8759,[ 50  22  12 194 179],10,5,38553,4.401027397260274,20.0,20.0
38760,3,8760,[568 135 176 405 515],892,5,38558,4.401095765323594,0.0,0.0
38761,3,8761,[313   8   4 508 151],378,3,38561,4.400935859392833,0.0,0.0
38762,3,8762,[302 427 603 100  64],745,5,38566,4.401004222298299,20.0,20.0
38763,3,8763,[216 273 175 174 322],234,0,38566,4.400502053856687,0.0,20.0
38764,3,8764,[302 427 603 100  64],745,5,38571,4.400570450656018,20.0,20.0
38765,3,8765,[302 427 603 100  64],537,4,38575,4.4005247547342,20.0,20.0
38766,3,8766,[302 427 603 100  64],666,5,38580,4.400593133340938,20.0,20.0
38767,3,8767,[302 427 603 100  64],474,5,38585,4.400661496350365,20.0,20.0
38768,3,8768,[302 427 603 100  64],474,5,38590,4.400729843767818,20.0,20.0
38769,3,8769,[302 427 603 100  64],370,5,38595,4.400798175598632,20.0,20.0
38770,3,8770,[588 197 385 143 168],479,2,38597,4.400524455592293,0.0,0.0
38771,3,8771,[302 427 603 100  64],666,5,38602,4.400592795257638,20.0,20.0
38772,3,8772,[302 427 603 100  64],666,5,38607,4.40066111934344,20.0,20.0
38773,3,8773,[302 427 603 100  64],666,5,38612,4.400729427855026,20.0,20.0
38774,3,8774,[508  15 194 385 216],59,4,38616,4.40068376068376,0.0,0.0
38775,3,8775,[302 427 603 100  64],458,5,38621,4.400752051048314,20.0,20.0
38776,3,8776,[475  98 234 186  96],452,1,38622,4.4003645892674035,0.0,20.0
38777,3,8777,[176 742 117 183 238],543,2,38624,4.400091136933242,0.0,0.0
38778,3,8778,[435 568 195 186  98],899,4,38628,4.400045563276,0.0,20.0
38779,3,8779,[302 427 603 100  64],271,5,38633,4.400113895216401,20.0,20.0
38780,3,8780,[302 427 603 100  64],13,5,38638,4.400182211593212,20.0,20.0
38781,3,8781,[302 427 603 100  64],537,4,38642,4.400136643133682,20.0,20.0
38782,3,8782,[302 427 603 100  64],370,5,38647,4.400204941363999,20.0,20.0
38783,3,8783,[435 117  88   7 286],102,0,38647,4.399704007285974,0.0,0.0
38784,3,8784,[135  82 568 222 191],311,5,38652,4.399772339214571,0.0,0.0
38785,3,8785,[302 427 603 100  64],474,5,38657,4.399840655588436,20.0,20.0
38786,3,8786,[302 427 603 100  64],339,5,38662,4.399908956412883,20.0,20.0
38787,3,8787,[216 405 135  28 322],474,5,38667,4.399977241693218,0.0,0.0
38788,3,8788,[302 427 603 100  64],474,5,38672,4.400045511434748,20.0,20.0
38789,3,8789,[302 427 603 100  64],13,5,38677,4.400113765642776,20.0,20.0
38790,3,8790,[204 173 153   7 655],840,4,38681,4.400068251620976,0.0,0.0
38791,3,8791,[302 427 603 100  64],13,5,38686,4.4001364877161055,20.0,20.0
38792,3,8792,[302 427 603 100  64],370,5,38691,4.400204708290686,20.0,20.0
38793,3,8793,[222 235 265 151  28],738,4,38695,4.4001591994541736,0.0,0.0
38794,3,8794,[  1  28 172  89 588],290,4,38699,4.400113700966458,0.0,0.0
38795,3,8795,[302 427 603 100  64],666,5,38704,4.4001819008640295,20.0,20.0
38796,3,8796,[302 427 603 100  64],339,5,38709,4.400250085256338,20.0,20.0
38797,3,8797,[302 427 603 100  64],271,5,38714,4.4003182541486705,20.0,20.0
38798,3,8798,[210 228 202  82  15],830,3,38717,4.400159108989658,0.0,0.0
38799,3,8799,[302 427 603 100  64],474,5,38722,4.400227272727273,20.0,20.0
38800,3,8800,[403 328 216 546 173],92,1,38723,4.399840927167367,0.0,0.0
38801,3,8801,[302 427 603 100  64],745,5,38728,4.399909111565553,20.0,20.0
38802,3,8802,[742 546 132 265 191],524,4,38732,4.399863682835397,0.0,0.0
38803,3,8803,[302 427 603 100  64],537,4,38736,4.399818264425261,20.0,20.0
38804,3,8804,[508 235 183 161 385],59,3,38739,4.399659284497445,0.0,0.0
38805,3,8805,[302 427 603 100  64],664,5,38744,4.399727458550988,20.0,20.0
38806,3,8806,[173  89 196 161 385],387,2,38746,4.399454978993982,0.0,0.0
38807,3,8807,[302 427 603 100  64],271,5,38751,4.399523160762943,20.0,20.0
38808,3,8808,[302 427 603 100  64],339,5,38756,4.399591327051879,20.0,20.0
38809,3,8809,[302 427 603 100  64],474,5,38761,4.399659477866061,20.0,20.0
38810,3,8810,[234 211 222 276 403],13,3,38764,4.399500624219725,0.0,0.0
38811,3,8811,[302 427 603 100  64],90,5,38769,4.3995687698592825,20.0,20.0
38812,3,8812,[237  70 181 405 210],85,2,38771,4.399296493815954,0.0,0.0
38813,3,8813,[ 56 197   8 216 748],474,4,38775,4.39925119128659,0.0,0.0
38814,3,8814,[302 427 603 100  64],474,5,38780,4.39931934203063,20.0,20.0
38815,3,8815,[302 427 603 100  64],13,5,38785,4.399387477313975,20.0,20.0
38816,3,8816,[117 276 174  22  25],406,3,38788,4.39922876261767,0.0,20.0
38817,3,8817,[302 427 603 100  64],537,4,38792,4.399183488319347,20.0,20.0
38818,3,8818,[ 25 276 185 427 496],194,3,38795,4.399024832747477,0.0,0.0
38819,3,8819,[302 427 603 100  64],537,4,38799,4.398979591836735,20.0,20.0
38820,3,8820,[121  79 125   1 210],271,2,38801,4.398707629520462,0.0,0.0
38821,3,8821,[302 427 603 100  64],666,5,38806,4.39877578780322,20.0,20.0
38822,3,8822,[302 427 603 100  64],666,5,38811,4.398843930635838,20.0,20.0
38823,3,8823,[302 427 603 100  64],664,5,38816,4.398912058023572,20.0,20.0
38824,3,8824,[302 427 603 100  64],474,5,38821,4.398980169971671,20.0,20.0
38825,3,8825,[302 427 603 100  64],666,5,38826,4.3990482664853845,20.0,20.0
38826,3,8826,[302 427 603 100  64],537,4,38830,4.399003058796874,20.0,20.0
38827,3,8827,[302 427 603 100  64],474,5,38835,4.39907113729044,20.0,20.0
38828,3,8828,[302 427 603 100  64],370,5,38840,4.399139200362442,20.0,20.0
38829,3,8829,[302 427 603 100  64],271,5,38845,4.39920724801812,20.0,20.0
38830,3,8830,[302 427 603 100  64],271,5,38850,4.399275280262711,20.0,20.0
38831,3,8831,[302 427 603 100  64],666,5,38855,4.399343297101449,20.0,20.0
38832,3,8832,[568   1 234 269 180],378,4,38859,4.399298086720254,0.0,0.0
38833,3,8833,[302 427 603 100  64],370,5,38864,4.399366085578447,20.0,20.0
38834,3,8834,[294 238 282 405 118],271,1,38865,4.398981324278438,0.0,0.0
38835,3,8835,[302 427 603 100  64],458,5,38870,4.3990493435943865,20.0,20.0
38836,3,8836,[302 427 603 100  64],537,4,38874,4.399004186941269,20.0,20.0
38837,3,8837,[302 427 603 100  64],13,5,38879,4.3990721882778905,20.0,20.0
38838,3,8838,[302 427 603 100  64],745,5,38884,4.3991401742278535,20.0,20.0
38839,3,8839,[302 427 603 100  64],370,5,38889,4.39920814479638,20.0,20.0
38840,3,8840,[302 427 603 100  64],339,5,38894,4.399276099988689,20.0,20.0
38841,3,8841,[302 427 603 100  64],13,5,38899,4.399344039809998,20.0,20.0
38842,3,8842,[302 427 603 100  64],271,5,38904,4.3994119642655205,20.0,20.0
38843,3,8843,[ 22 204 180  88   8],95,4,38908,4.399366802351877,0.0,0.0
38844,3,8844,[302 427 603 100  64],90,5,38913,4.399434708875071,20.0,20.0
38845,3,8845,[289 258 132  22 215],13,4,38917,4.399389554600949,0.0,0.0
38846,3,8846,[302 427 603 100  64],537,4,38921,4.399344410534645,20.0,20.0
38847,3,8847,[302 427 603 100  64],537,4,38925,4.399299276672695,20.0,20.0
38848,3,8848,[302 427 603 100  64],339,5,38930,4.399367160131089,20.0,20.0
38849,3,8849,[302 427 603 100  64],13,5,38935,4.399435028248588,20.0,20.0
38850,3,8850,[655 185 423 269  22],7,4,38939,4.3993898994463905,0.0,0.0
38851,3,8851,[302 427 603 100  64],454,5,38944,4.399457749661093,20.0,20.0
38852,3,8852,[302 427 603 100  64],666,5,38949,4.399525584547611,20.0,20.0
38853,3,8853,[302 427 603 100  64],664,5,38954,4.399593404111136,20.0,20.0
38854,3,8854,[196 318 173 423  89],234,2,38956,4.399322416713721,20.0,0.0
38855,3,8855,[302 427 603 100  64],370,5,38961,4.399390243902439,20.0,20.0
38856,3,8856,[302 427 603 100  64],13,5,38966,4.399458055775093,20.0,20.0
38857,3,8857,[302 427 603 100  64],666,5,38971,4.399525852336871,20.0,20.0
38858,3,8858,[385 546 197 603 180],804,4,38975,4.399480754035444,20.0,0.0
38859,3,8859,[ 12 403 471 405 118],378,3,38978,4.399322799097066,20.0,0.0
38860,3,8860,[302 427 603 100  64],664,5,38983,4.399390587969755,20.0,20.0
38861,3,8861,[302 427 603 100  64],339,5,38988,4.39945836154367,20.0,20.0
38862,3,8862,[302 427 603 100  64],537,4,38992,4.399413291210651,20.0,20.0
38863,3,8863,[302 427 603 100  64],339,5,38997,4.399481046931408,20.0,20.0
38864,3,8864,[302 427 603 100  64],474,5,39002,4.399548787366046,20.0,20.0
38865,3,8865,[302 427 603 100  64],537,4,39006,4.399503722084368,20.0,20.0
38866,3,8866,[  9 238 179 427 357],85,3,39009,4.399345889252284,20.0,0.0
38867,3,8867,[302 427 603 100  64],13,5,39014,4.3994136220117275,20.0,20.0
38868,3,8868,[288  98  15 423 174],59,5,39019,4.399481339497124,0.0,40.0
38869,3,8869,[302 427 603 100  64],454,5,39024,4.399549041713642,20.0,20.0
38870,3,8870,[302 427 603 100  64],664,5,39029,4.399616728666441,20.0,20.0
38871,3,8871,[302 427 603 100  64],90,5,39034,4.399684400360686,20.0,20.0
38872,3,8872,[ 82 174  11 222 475],64,4,39038,4.399639355347684,0.0,20.0
38873,3,8873,[302 427 603 100  64],339,5,39043,4.399707009240478,20.0,20.0
38874,3,8874,[302 427 603 100  64],474,5,39048,4.399774647887324,20.0,20.0
38875,3,8875,[302 427 603 100  64],271,5,39053,4.399842271293376,20.0,20.0
38876,3,8876,[302 427 603 100  64],90,5,39058,4.399909879463783,20.0,20.0
38877,3,8877,[302 427 603 100  64],90,5,39063,4.399977472403695,20.0,20.0
38878,3,8878,[294 333  69 168 742],533,5,39068,4.400045050118257,0.0,0.0
38879,3,8879,[302 427 603 100  64],370,5,39073,4.400112612612612,20.0,20.0
38880,3,8880,[195   9  12 185   1],234,0,39073,4.399617160229704,20.0,0.0
38881,3,8881,[302 427 603 100  64],454,5,39078,4.399684755685656,20.0,20.0
38882,3,8882,[302 427 603 100  64],90,5,39083,4.399752335922549,20.0,20.0
38883,3,8883,[302 427 603 100  64],13,5,39088,4.39981990094552,20.0,20.0
38884,3,8884,[302 427 603 100  64],458,5,39093,4.399887450759707,20.0,20.0
38885,3,8885,[301 144 288 174 302],458,2,39095,4.399617375647085,0.0,20.0
38886,3,8886,[302 427 603 100  64],745,5,39100,4.399684933048273,20.0,20.0
38887,3,8887,[302 427 603 100  64],664,5,39105,4.399752475247524,20.0,20.0
38888,3,8888,[302 427 603 100  64],370,5,39110,4.399820002249972,20.0,20.0
38889,3,8889,[302 427 603 100  64],666,5,39115,4.399887514060742,20.0,20.0
38890,3,8890,[302 427 603 100  64],474,5,39120,4.3999550106849625,20.0,20.0
38891,3,8891,[302 427 603 100  64],370,5,39125,4.400022492127755,20.0,20.0
38892,3,8892,[302 427 603 100  64],664,5,39130,4.4000899583942426,20.0,20.0
38893,3,8893,[302 427 603 100  64],666,5,39135,4.400157409489544,20.0,20.0
38894,3,8894,[568 183  28  82   8],387,4,39139,4.4001124227093875,0.0,0.0
38895,3,8895,[302 427 603 100  64],90,5,39144,4.400179856115108,20.0,20.0
38896,3,8896,[144  96 357 568 403],648,4,39148,4.400134876924806,20.0,0.0
38897,3,8897,[302 427 603 100  64],474,5,39153,4.400202292650034,20.0,20.0
38898,3,8898,[302 427 603 100  64],13,5,39158,4.400269693223958,20.0,20.0
38899,3,8899,[302 427 603 100  64],664,5,39163,4.4003370786516856,20.0,20.0
38900,3,8900,[302 427 603 100  64],454,5,39168,4.400404448938321,20.0,20.0
38901,3,8901,[302 427 603 100  64],271,5,39173,4.400471804088969,20.0,20.0
38902,3,8902,[357 135 403 168  89],749,5,39178,4.400539144108728,20.0,0.0
38903,3,8903,[302 427 603 100  64],666,5,39183,4.400606469002695,20.0,20.0
38904,3,8904,[302 427 603 100  64],537,4,39187,4.400561482313307,20.0,20.0
38905,3,8905,[302 427 603 100  64],339,5,39192,4.400628789580058,20.0,20.0
38906,3,8906,[302 427 603 100  64],666,5,39197,4.400696081733468,20.0,20.0
38907,3,8907,[302 427 603 100  64],13,5,39202,4.400763358778626,20.0,20.0
38908,3,8908,[302 427 603 100  64],13,5,39207,4.40083062072062,20.0,20.0
38909,3,8909,[302 427 603 100  64],745,5,39212,4.4008978675645345,20.0,20.0
38910,3,8910,[302 427 603 100  64],458,5,39217,4.400965099315453,20.0,20.0
38911,3,8911,[302 427 603 100  64],90,5,39222,4.401032315978456,20.0,20.0
38912,3,8912,[302 427 603 100  64],13,5,39227,4.401099517558622,20.0,20.0
38913,3,8913,[302 427 603 100  64],90,5,39232,4.401166704061027,20.0,20.0
38914,3,8914,[435 204  79 151 186],666,1,39233,4.400785193494111,0.0,0.0
38915,3,8915,[302 427 603 100  64],90,5,39238,4.400852400179453,20.0,20.0
38916,3,8916,[302 427 603 100  64],339,5,39243,4.400919591790961,20.0,20.0
38917,3,8917,[302 427 603 100  64],271,5,39248,4.400986768333707,20.0,20.0
38918,3,8918,[302 427 603 100  64],664,5,39253,4.401053929812759,20.0,20.0
38919,3,8919,[302 427 603 100  64],664,5,39258,4.401121076233184,20.0,20.0
38920,3,8920,[ 22 176 194 288 403],7,4,39262,4.401076112543437,0.0,0.0
38921,3,8921,[ 25 191 194 471 515],474,4,39266,4.401031158932975,0.0,0.0
38922,3,8922,[  1 168 204 603 180],843,0,39266,4.400537935671859,20.0,0.0
38923,3,8923,[302 427 603 100  64],90,5,39271,4.400605109816226,20.0,20.0
38924,3,8924,[276 202   8  88 168],881,3,39274,4.4004481792717085,0.0,0.0
38925,3,8925,[302 427 603 100  64],666,5,39279,4.400515348420345,20.0,20.0
38926,3,8926,[302 427 603 100  64],90,5,39284,4.400582502520444,20.0,20.0
38927,3,8927,[168  64  71 216  15],398,4,39288,4.400537634408602,0.0,0.0
38928,3,8928,[302 427 603 100  64],339,5,39293,4.400604770970993,20.0,20.0
38929,3,8929,[176 175 435 515 475],343,5,39298,4.400671892497201,0.0,0.0
38930,3,8930,[302 427 603 100  64],458,5,39303,4.400738998992274,20.0,20.0
38931,3,8931,[302 427 603 100  64],745,5,39308,4.400806090461263,20.0,20.0
38932,3,8932,[289 200 282 275 187],328,4,39312,4.4007612224336725,0.0,0.0
38933,3,8933,[302 427 603 100  64],271,5,39317,4.400828296395791,20.0,20.0
38934,3,8934,[302 427 603 100  64],537,4,39321,4.400783435926133,20.0,20.0
38935,3,8935,[302 427 603 100  64],339,5,39326,4.400850492390331,20.0,20.0
38936,3,8936,[302 427 603 100  64],13,5,39331,4.400917533848047,20.0,20.0
38937,3,8937,[302 427 603 100  64],474,5,39336,4.400984560304319,20.0,20.0
38938,3,8938,[302 427 603 100  64],271,5,39341,4.40105157176418,20.0,20.0
38939,3,8939,[228 322 211 302 328],102,1,39342,4.400671140939597,0.0,0.0
38940,3,8940,[228 235 423 135 200],479,3,39345,4.400514483838497,0.0,0.0
38941,3,8941,[302 427 603 100  64],90,5,39350,4.40058152538582,20.0,20.0
38942,3,8942,[302 427 603 100  64],745,5,39355,4.400648551940065,20.0,20.0
38943,3,8943,[302 427 603 100  64],370,5,39360,4.400715563506261,20.0,20.0
38944,3,8944,[385 471 151 175  11],7,4,39364,4.400670765790944,0.0,0.0
38945,3,8945,[302 427 603 100  64],454,5,39369,4.40073775989269,20.0,20.0
38946,3,8946,[302 427 603 100  64],454,5,39374,4.400804739018666,20.0,20.0
38947,3,8947,[302 427 603 100  64],664,5,39379,4.400871703173894,20.0,20.0
38948,3,8948,[302 427 603 100  64],454,5,39384,4.400938652363393,20.0,20.0
38949,3,8949,[  7 403 385 603 269],13,1,39385,4.400558659217877,20.0,0.0
38950,3,8950,[302 427 603 100  64],745,5,39390,4.400625628421405,20.0,20.0
38951,3,8951,[302 427 603 100  64],537,4,39394,4.400580875781948,20.0,20.0
38952,3,8952,[302 427 603 100  64],339,5,39399,4.40064782754384,20.0,20.0
38953,3,8953,[302 427 603 100  64],537,4,39403,4.400603082421264,20.0,20.0
38954,3,8954,[302 427 603 100  64],454,5,39408,4.400670016750419,20.0,20.0
38955,3,8955,[302 427 603 100  64],90,5,39413,4.400736936132202,20.0,20.0
38956,3,8956,[302 427 603 100  64],454,5,39418,4.40080384057162,20.0,20.0
38957,3,8957,[302 427 603 100  64],370,5,39423,4.400870730073677,20.0,20.0
38958,3,8958,[302 427 603 100  64],666,5,39428,4.400937604643375,20.0,20.0
38959,3,8959,[302 427 603 100  64],13,5,39433,4.401004464285714,20.0,20.0
38960,3,8960,[302 427 603 100  64],454,5,39438,4.401071309005691,20.0,20.0
38961,3,8961,[302 427 603 100  64],458,5,39443,4.401138138808301,20.0,20.0
38962,3,8962,[302 427 603 100  64],537,4,39447,4.401093383911637,20.0,20.0
38963,3,8963,[302 427 603 100  64],537,4,39451,4.401048639000447,20.0,20.0
38964,3,8964,[302 427 603 100  64],745,5,39456,4.40111544896821,20.0,20.0
38965,3,8965,[302 427 603 100  64],664,5,39461,4.401182244033014,20.0,20.0
38966,3,8966,[302 427 603 100  64],664,5,39466,4.401249024199844,20.0,20.0
38967,3,8967,[302 427 603 100  64],474,5,39471,4.401315789473684,20.0,20.0
38968,3,8968,[302 427 603 100  64],664,5,39476,4.401382539859516,20.0,20.0
38969,3,8969,[176 588 546 185 179],7,4,39480,4.40133779264214,0.0,0.0
38970,3,8970,[302 427 603 100  64],664,5,39485,4.401404525693903,20.0,20.0
38971,3,8971,[302 427 603 100  64],90,5,39490,4.401471243869818,20.0,20.0
38972,3,8972,[302 427 603 100  64],537,4,39494,4.401426501727404,20.0,20.0
38973,3,8973,[  9 215  96 323 127],59,5,39499,4.401493202585247,0.0,20.0
38974,3,8974,[302 427 603 100  64],666,5,39504,4.401559888579388,20.0,20.0
38975,3,8975,[234 187  96 228  56],488,3,39507,4.401403743315508,0.0,0.0
38976,3,8976,[302 427 603 100  64],454,5,39512,4.401470424417957,20.0,20.0
38977,3,8977,[302 427 603 100  64],474,5,39517,4.401537090666072,20.0,20.0
38978,3,8978,[302 427 603 100  64],745,5,39522,4.401603742064818,20.0,20.0
38979,3,8979,[302 427 603 100  64],474,5,39527,4.401670378619154,20.0,20.0
38980,3,8980,[318 172 275 185 173],883,5,39532,4.401737000334038,20.0,0.0
38981,3,8981,[302 427 603 100  64],745,5,39537,4.401803607214429,20.0,20.0
38982,3,8982,[  1 313  98 181  64],92,5,39542,4.401870199265279,0.0,20.0
38983,3,8983,[302 427 603 100  64],339,5,39547,4.4019367764915405,20.0,20.0
38984,3,8984,[302 427 603 100  64],90,5,39552,4.402003338898163,20.0,20.0
38985,3,8985,[302 427 603 100  64],474,5,39557,4.402069886490096,20.0,20.0
38986,3,8986,[  9  28 210  71 234],406,3,39560,4.401913875598086,0.0,0.0
38987,3,8987,[302 427 603 100  64],537,4,39564,4.401869158878505,20.0,20.0
38988,3,8988,[302 427 603 100  64],664,5,39569,4.401935699187896,20.0,20.0
38989,3,8989,[302 427 603 100  64],474,5,39574,4.402002224694105,20.0,20.0
38990,3,8990,[194  95  50 588 187],387,2,39576,4.401735068401735,0.0,20.0
38991,3,8991,[385  98 185 496   7],452,5,39581,4.401801601423488,0.0,20.0
38992,3,8992,[302 427 603 100  64],13,5,39586,4.401868119648616,20.0,20.0
38993,3,8993,[ 25  95   8 238  88],92,2,39588,4.401601067378252,0.0,0.0
38994,3,8994,[ 50 568 135 496 435],64,5,39593,4.401667593107282,0.0,20.0
38995,3,8995,[302 427 603 100  64],537,4,39597,4.401622943530458,20.0,20.0
38996,3,8996,[302 427 603 100  64],745,5,39602,4.401689452039569,20.0,20.0
38997,3,8997,[302 427 603 100  64],454,5,39607,4.401755945765726,20.0,20.0
38998,3,8998,[302 427 603 100  64],745,5,39612,4.401822424713857,20.0,20.0
38999,3,8999,[302 427 603 100  64],370,5,39617,4.401888888888889,20.0,20.0
39000,3,9000,[302 427 603 100  64],90,5,39622,4.401955338295745,20.0,20.0
39001,3,9001,[302 427 603 100  64],666,5,39627,4.402021772939347,20.0,20.0
39002,3,9002,[427 568 111 357  50],537,3,39630,4.401866044651783,20.0,20.0
39003,3,9003,[302 427 603 100  64],664,5,39635,4.401932474455798,20.0,20.0
39004,3,9004,[302 427 603 100  64],537,4,39639,4.40188784008884,20.0,20.0
39005,3,9005,[289 235 423   7 173],194,1,39640,4.401510104374861,0.0,0.0
39006,3,9006,[302 427 603 100  64],745,5,39645,4.401576551571,20.0,20.0
39007,3,9007,[302 427 603 100  64],339,5,39650,4.4016429840142095,20.0,20.0
39008,3,9008,[385 175 144 127 234],666,2,39652,4.401376401376401,0.0,20.0
39009,3,9009,[302 427 603 100  64],90,5,39657,4.401442841287459,20.0,20.0
39010,3,9010,[302 427 603 100  64],666,5,39662,4.4015092664521145,20.0,20.0
39011,3,9011,[302 427 603 100  64],666,5,39667,4.401575676875278,20.0,20.0
39012,3,9012,[302 427 603 100  64],664,5,39672,4.401642072561855,20.0,20.0
39013,3,9013,[302 427 603 100  64],339,5,39677,4.401708453516751,20.0,20.0
39014,3,9014,[302 427 603 100  64],339,5,39682,4.40177481974487,20.0,20.0
39015,3,9015,[302 427 603 100  64],666,5,39687,4.401841171251109,20.0,20.0
39016,3,9016,[302 427 603 100  64],666,5,39692,4.4019075080403685,20.0,20.0
39017,3,9017,[302 427 603 100  64],474,5,39697,4.401973830117543,20.0,20.0
39018,3,9018,[302 427 603 100  64],664,5,39702,4.402040137487527,20.0,20.0
39019,3,9019,[302 427 603 100  64],90,5,39707,4.402106430155211,20.0,20.0
39020,3,9020,[322 427 191 196 143],474,5,39712,4.402172708125485,0.0,0.0
39021,3,9021,[302 427 603 100  64],13,5,39717,4.402238971403237,20.0,20.0
39022,3,9022,[475 200 471 197 237],6,2,39719,4.401972736340463,0.0,0.0
39023,3,9023,[302 427 603 100  64],13,5,39724,4.402039007092198,20.0,20.0
39024,3,9024,[302 427 603 100  64],666,5,39729,4.402105263157894,20.0,20.0
39025,3,9025,[748 216 427 143 111],533,4,39733,4.4020607134943495,0.0,0.0
39026,3,9026,[302 427 603 100  64],458,5,39738,4.402126952475905,20.0,20.0
39027,3,9027,[302 427 603 100  64],339,5,39743,4.40219317678334,20.0,20.0
39028,3,9028,[302 427 603 100  64],458,5,39748,4.40225938642153,20.0,20.0
39029,3,9029,[302 427 603 100  64],745,5,39753,4.402325581395349,20.0,20.0
39030,3,9030,[ 96  25 100 117 143],90,4,39757,4.402281032000886,0.0,20.0
39031,3,9031,[302 427 603 100  64],458,5,39762,4.402347209920284,20.0,20.0
39032,3,9032,[302 427 603 100  64],454,5,39767,4.402413373187202,20.0,20.0
39033,3,9033,[215 427 161 228  95],234,1,39768,4.402036750055347,0.0,0.0
39034,3,9034,[  1 237 245 288 121],92,4,39772,4.401992252351965,0.0,0.0
39035,3,9035,[302 427 603 100  64],745,5,39777,4.402058432934927,20.0,20.0
39036,3,9036,[302 427 603 100  64],271,5,39782,4.402124598871307,20.0,20.0
39037,3,9037,[195 210 175  79 483],7,5,39787,4.402190750165966,20.0,0.0
39038,3,9038,[302 427 603 100  64],339,5,39792,4.402256886823763,20.0,20.0
39039,3,9039,[286 427  50 323  15],650,2,39794,4.401991150442478,0.0,20.0
39040,3,9040,[300 210 100 151 597],7,4,39798,4.40194668731335,0.0,20.0
39041,3,9041,[302 427 603 100  64],370,5,39803,4.402012829020128,20.0,20.0
39042,3,9042,[435 215 117 385 179],536,3,39806,4.401857790556232,0.0,0.0
39043,3,9043,[302 427 603 100  64],474,5,39811,4.401923927465723,20.0,20.0
39044,3,9044,[161 200 423 174 742],378,4,39815,4.40187949143173,0.0,20.0
39045,3,9045,[302 427 603 100  64],370,5,39820,4.4019456113199205,20.0,20.0
39046,3,9046,[ 12  70 276  89 175],334,4,39824,4.401901182712502,20.0,0.0
39047,3,9047,[302 427 603 100  64],664,5,39829,4.4019672855879755,20.0,20.0
39048,3,9048,[302 427 603 100  64],537,4,39833,4.401922864404907,20.0,20.0
39049,3,9049,[302 427 603 100  64],339,5,39838,4.401988950276243,20.0,20.0
39050,3,9050,[234 200  71 182  56],488,2,39840,4.401723566456745,0.0,0.0
39051,3,9051,[302 427 603 100  64],474,5,39845,4.401789659743703,20.0,20.0
39052,3,9052,[302 427 603 100  64],666,5,39850,4.40185573842925,20.0,20.0
39053,3,9053,[302 427 603 100  64],90,5,39855,4.401921802518224,20.0,20.0
39054,3,9054,[302 427 603 100  64],537,4,39859,4.40187741579238,20.0,20.0
39055,3,9055,[151 117 181 471   8],479,4,39863,4.401833038869258,0.0,0.0
39056,3,9056,[ 15 435 121 172 127],210,5,39868,4.40189908358176,0.0,20.0
39057,3,9057,[302 427 603 100  64],271,5,39873,4.401965113711636,20.0,20.0
39058,3,9058,[302 427 603 100  64],454,5,39878,4.402031129263715,20.0,20.0
39059,3,9059,[302 427 603 100  64],90,5,39883,4.402097130242826,20.0,20.0
39060,3,9060,[ 50   7 161 742 194],881,2,39885,4.401832027370047,0.0,20.0
39061,3,9061,[302 427 603 100  64],339,5,39890,4.401898035753697,20.0,20.0
39062,3,9062,[302 427 603 100  64],339,5,39895,4.401964029570783,20.0,20.0
39063,3,9063,[302 427 603 100  64],90,5,39900,4.4020300088261255,20.0,20.0
39064,3,9064,[302 427 603 100  64],90,5,39905,4.402095973524545,20.0,20.0
39065,3,9065,[302 427 603 100  64],537,4,39909,4.402051621442753,20.0,20.0
39066,3,9066,[302 427 603 100  64],13,5,39914,4.4021175692070145,20.0,20.0
39067,3,9067,[ 56  28 197  97 257],881,2,39916,4.401852668725187,0.0,0.0
39068,3,9068,[302 427 603 100  64],474,5,39921,4.401918623883559,20.0,20.0
39069,3,9069,[302 427 603 100  64],458,5,39926,4.401984564498346,20.0,20.0
39070,3,9070,[475  25 435 202 191],308,5,39931,4.402050490574358,0.0,0.0
39071,3,9071,[302 427 603 100  64],458,5,39936,4.402116402116402,20.0,20.0
39072,3,9072,[302 427 603 100  64],458,5,39941,4.402182299129285,20.0,20.0
39073,3,9073,[405 187   8 275 135],334,4,39945,4.402137976636544,0.0,0.0
39074,3,9074,[302 427 603 100  64],664,5,39950,4.402203856749312,20.0,20.0
39075,3,9075,[151 282 173 175  50],95,5,39955,4.402269722344645,0.0,20.0
39076,3,9076,[302 427 603 100  64],454,5,39960,4.402335573427344,20.0,20.0
39077,3,9077,[302 427 603 100  64],13,5,39965,4.402401410002203,20.0,20.0
39078,3,9078,[ 50  15 405 125 294],533,4,39969,4.402357087784998,0.0,20.0
39079,3,9079,[302 427 603 100  64],458,5,39974,4.402422907488987,20.0,20.0
39080,3,9080,[302 427 603 100  64],339,5,39979,4.402488712696839,20.0,20.0
39081,3,9081,[302 427 603 100  64],745,5,39984,4.402554503413345,20.0,20.0
39082,3,9082,[237  98 216 275 471],328,3,39987,4.402400088076627,0.0,20.0
39083,3,9083,[302 427 603 100  64],13,5,39992,4.402465874064289,20.0,20.0
39084,3,9084,[302 427 603 100  64],537,4,39996,4.402421574023115,20.0,20.0
39085,3,9085,[289   9 135  12 322],409,3,39999,4.402267224301123,20.0,0.0
39086,3,9086,[302 427 603 100  64],666,5,40004,4.402333003191372,20.0,20.0
39087,3,9087,[302 427 603 100  64],13,5,40009,4.402398767605634,20.0,20.0
39088,3,9088,[302 427 603 100  64],664,5,40014,4.402464517548685,20.0,20.0
39089,3,9089,[302 427 603 100  64],745,5,40019,4.4025302530253025,20.0,20.0
39090,3,9090,[302 427 603 100  64],745,5,40024,4.40259597404026,20.0,20.0
39091,3,9091,[175 127 196 135 144],379,5,40029,4.402661680598328,0.0,20.0
39092,3,9092,[302 427 603 100  64],745,5,40034,4.402727372704278,20.0,20.0
39093,3,9093,[302 427 603 100  64],745,5,40039,4.4027930503628765,20.0,20.0
39094,3,9094,[302 427 603 100  64],90,5,40044,4.4028587135788895,20.0,20.0
39095,3,9095,[275  22 238 211 427],615,4,40048,4.402814423922603,0.0,0.0
39096,3,9096,[204 121 197   9  50],308,3,40051,4.402660217654172,0.0,20.0
39097,3,9097,[ 82 215 180 655 273],328,3,40054,4.402506045284678,0.0,0.0
39098,3,9098,[302 427 603 100  64],370,5,40059,4.402571711177052,20.0,20.0
39099,3,9099,[515 237  15  79 546],313,3,40062,4.402417582417582,0.0,0.0
39100,3,9100,[302 427 603 100  64],664,5,40067,4.402483243599605,20.0,20.0
39101,3,9101,[302 427 603 100  64],745,5,40072,4.402548890353769,20.0,20.0
39102,3,9102,[  8 385 405 175 238],378,3,40075,4.402394814896188,0.0,0.0
39103,3,9103,[ 95 172  82 265 546],308,3,40078,4.402240773286468,0.0,0.0
39104,3,9104,[302 427 603 100  64],271,5,40083,4.4023064250411865,20.0,20.0
39105,3,9105,[302 427 603 100  64],666,5,40088,4.402372062376455,20.0,20.0
39106,3,9106,[323  89  28   1 191],488,2,40090,4.402108268364994,0.0,0.0
39107,3,9107,[302 427 603 100  64],745,5,40095,4.4021739130434785,20.0,20.0
39108,3,9108,[302 427 603 100  64],458,5,40100,4.4022395433088155,20.0,20.0
39109,3,9109,[302 427 603 100  64],271,5,40105,4.402305159165752,20.0,20.0
39110,3,9110,[302 427 603 100  64],745,5,40110,4.402370760619032,20.0,20.0
39111,3,9111,[302 427 603 100  64],664,5,40115,4.402436347673397,20.0,20.0
39112,3,9112,[302 427 603 100  64],745,5,40120,4.40250192033359,20.0,20.0
39113,3,9113,[302 427 603 100  64],474,5,40125,4.402567478604345,20.0,20.0
39114,3,9114,[302 427 603 100  64],454,5,40130,4.4026330224904004,20.0,20.0
39115,3,9115,[302 427 603 100  64],537,4,40134,4.40258885476086,20.0,20.0
39116,3,9116,[ 56 257 405 172 333],334,3,40137,4.402435011516946,0.0,0.0
39117,3,9117,[496 435 194 403 132],506,5,40142,4.40250054836587,0.0,0.0
39118,3,9118,[302 427 603 100  64],474,5,40147,4.402566070841101,20.0,20.0
39119,3,9119,[302 427 603 100  64],454,5,40152,4.402631578947369,20.0,20.0
39120,3,9120,[ 50 427 200 173  95],374,2,40154,4.402368161385813,0.0,20.0
39121,3,9121,[200 508 655 175 211],527,1,40155,4.401995176496382,0.0,0.0
39122,3,9122,[ 50 168 216  15 173],234,1,40156,4.401622273374986,0.0,20.0
39123,3,9123,[302 427 603 100  64],454,5,40161,4.401687856203419,20.0,20.0
39124,3,9124,[ 89 515  79 385 546],524,4,40165,4.401643835616438,0.0,0.0
39125,3,9125,[302 427 603 100  64],90,5,40170,4.401709401709402,20.0,20.0
39126,3,9126,[302 427 603 100  64],454,5,40175,4.401774953434864,20.0,20.0
39127,3,9127,[302 427 603 100  64],664,5,40180,4.401840490797546,20.0,20.0
39128,3,9128,[302 427 603 100  64],664,5,40185,4.401906013802169,20.0,20.0
39129,3,9129,[202 196  88 180  82],694,5,40190,4.40197152245345,0.0,0.0
39130,3,9130,[302 427 603 100  64],370,5,40195,4.402037016756106,20.0,20.0
39131,3,9131,[265   1 427 151 237],899,3,40198,4.4018834866403855,0.0,0.0
39132,3,9132,[186 196 121  22  82],804,5,40203,4.401948976240009,0.0,0.0
39133,3,9133,[153 132 211 475 197],90,4,40207,4.401904970440114,0.0,0.0
39134,3,9134,[302 427 603 100  64],745,5,40212,4.401970443349754,20.0,20.0
39135,3,9135,[302 427 603 100  64],745,5,40217,4.402035901926445,20.0,20.0
39136,3,9136,[  8 427 423  56 143],194,2,40219,4.401773010835067,0.0,0.0
39137,3,9137,[172 483 132 194 143],298,5,40224,4.401838476690742,20.0,0.0
39138,3,9138,[302 427 603 100  64],13,5,40229,4.401903928219718,20.0,20.0
39139,3,9139,[302 427 603 100  64],537,4,40233,4.401859956236324,20.0,20.0
39140,3,9140,[302 427 603 100  64],745,5,40238,4.401925391095066,20.0,20.0
39141,3,9141,[302 427 603 100  64],664,5,40243,4.4019908116385915,20.0,20.0
39142,3,9142,[302 427 603 100  64],666,5,40248,4.402056217871595,20.0,20.0
39143,3,9143,[302 427 603 100  64],370,5,40253,4.402121609798775,20.0,20.0
39144,3,9144,[302 427 603 100  64],90,5,40258,4.402186987424822,20.0,20.0
39145,3,9145,[302 427 603 100  64],271,5,40263,4.402252350754428,20.0,20.0
39146,3,9146,[302 427 603 100  64],745,5,40268,4.402317699792282,20.0,20.0
39147,3,9147,[302 427 603 100  64],474,5,40273,4.402383034543069,20.0,20.0
39148,3,9148,[302 427 603 100  64],745,5,40278,4.402448355011477,20.0,20.0
39149,3,9149,[302 427 603 100  64],271,5,40283,4.402513661202186,20.0,20.0
39150,3,9150,[302 427 603 100  64],537,4,40287,4.402469675445307,20.0,20.0
39151,3,9151,[135 180  98 144  69],144,5,40292,4.402534965034965,0.0,20.0
39152,3,9152,[302 427 603 100  64],537,4,40296,4.402490986561783,20.0,20.0
39153,3,9153,[302 427 603 100  64],458,5,40301,4.402556259558663,20.0,20.0
39154,3,9154,[286 144   4 197 117],653,2,40303,4.402293828509012,0.0,0.0
39155,3,9155,[222  11 117 181 435],749,4,40307,4.4022498907820005,0.0,0.0
39156,3,9156,[302 427 603 100  64],537,4,40311,4.402205962651523,20.0,20.0
39157,3,9157,[678 194 118  22 111],749,2,40313,4.401943655820048,0.0,0.0
39158,3,9158,[483 276 273   7  95],402,5,40318,4.402008952942461,20.0,0.0
39159,3,9159,[294 515  79 435 153],6,3,40321,4.4018558951965066,0.0,0.0
39160,3,9160,[302 427 603 100  64],13,5,40326,4.4019211876432704,20.0,20.0
39161,3,9161,[302 427 603 100  64],745,5,40331,4.401986465837154,20.0,20.0
39162,3,9162,[302 427 603 100  64],666,5,40336,4.402051729782822,20.0,20.0
39163,3,9163,[302 427 603 100  64],474,5,40341,4.4021169794849415,20.0,20.0
39164,3,9164,[302 427 603 100  64],664,5,40346,4.402182214948172,20.0,20.0
39165,3,9165,[302 427 603 100  64],537,4,40350,4.402138337333624,20.0,20.0
39166,3,9166,[302 427 603 100  64],271,5,40355,4.402203556234319,20.0,20.0
39167,3,9167,[302 427 603 100  64],90,5,40360,4.402268760907504,20.0,20.0
39168,3,9168,[111 194 235 483  11],833,3,40363,4.402115825062712,20.0,0.0
39169,3,9169,[302 427 603 100  64],745,5,40368,4.402181025081789,20.0,20.0
39170,3,9170,[302 427 603 100  64],370,5,40373,4.4022462108821285,20.0,20.0
39171,3,9171,[302 427 603 100  64],664,5,40378,4.402311382468382,20.0,20.0
39172,3,9172,[302 427 603 100  64],458,5,40383,4.402376539845198,20.0,20.0
39173,3,9173,[302 427 603 100  64],339,5,40388,4.402441683017223,20.0,20.0
39174,3,9174,[ 50 187 385 186  96],474,5,40393,4.402506811989101,0.0,20.0
39175,3,9175,[302 427 603 100  64],745,5,40398,4.402571926765475,20.0,20.0
39176,3,9176,[302 427 603 100  64],339,5,40403,4.402637027350986,20.0,20.0
39177,3,9177,[302 427 603 100  64],664,5,40408,4.402702113750272,20.0,20.0
39178,3,9178,[302 427 603 100  64],537,4,40412,4.402658241638523,20.0,20.0
39179,3,9179,[302 427 603 100  64],13,5,40417,4.402723311546841,20.0,20.0
39180,3,9180,[302 427 603 100  64],339,5,40422,4.402788367280253,20.0,20.0
39181,3,9181,[302 427 603 100  64],271,5,40427,4.402853408843389,20.0,20.0
39182,3,9182,[302 427 603 100  64],13,5,40432,4.4029184362408795,20.0,20.0
39183,3,9183,[191  96  98  89 196],738,5,40437,4.402983449477352,0.0,20.0
39184,3,9184,[302 427 603 100  64],745,5,40442,4.40304844855743,20.0,20.0
39185,3,9185,[302 427 603 100  64],537,4,40446,4.403004572175049,20.0,20.0
39186,3,9186,[302 427 603 100  64],90,5,40451,4.403069554805704,20.0,20.0
39187,3,9187,[210 111 245 125 195],749,4,40455,4.40302568567697,0.0,0.0
39188,3,9188,[195 655 176 603 496],899,5,40460,4.403090651866362,20.0,0.0
39189,3,9189,[302 427 603 100  64],13,5,40465,4.403155603917301,20.0,20.0
39190,3,9190,[127  82  50 173 228],158,5,40470,4.403220541834403,0.0,40.0
39191,3,9191,[302 427 603 100  64],537,4,40474,4.403176675369886,20.0,20.0
39192,3,9192,[302 427 603 100  64],745,5,40479,4.403241596867182,20.0,20.0
39193,3,9193,[302 427 603 100  64],454,5,40484,4.403306504241897,20.0,20.0
39194,3,9194,[302 427 603 100  64],458,5,40489,4.40337139749864,20.0,20.0
39195,3,9195,[175 211 234 174 210],379,5,40494,4.403436276642018,0.0,20.0
39196,3,9196,[302 427 603 100  64],271,5,40499,4.403501141676633,20.0,20.0
39197,3,9197,[302 427 603 100  64],370,5,40504,4.4035659926070885,20.0,20.0
39198,3,9198,[302 427 603 100  64],474,5,40509,4.403630829437982,20.0,20.0
39199,3,9199,[302 427 603 100  64],454,5,40514,4.403695652173913,20.0,20.0
39200,3,9200,[302 427 603 100  64],90,5,40519,4.403760460819476,20.0,20.0
39201,3,9201,[302 427 603 100  64],454,5,40524,4.403825255379266,20.0,20.0
39202,3,9202,[302 427 603 100  64],90,5,40529,4.403890035857873,20.0,20.0
39203,3,9203,[302 427 603 100  64],666,5,40534,4.403954802259887,20.0,20.0
39204,3,9204,[302 427 603 100  64],370,5,40539,4.404019554589897,20.0,20.0
39205,3,9205,[302 427 603 100  64],454,5,40544,4.404084292852487,20.0,20.0
39206,3,9206,[302 427 603 100  64],664,5,40549,4.404149017052243,20.0,20.0
39207,3,9207,[302 427 603 100  64],339,5,40554,4.404213727193745,20.0,20.0
39208,3,9208,[302 427 603 100  64],474,5,40559,4.404278423281572,20.0,20.0
39209,3,9209,[ 69  95 238  79 197],537,2,40561,4.404017372421281,0.0,0.0
39210,3,9210,[ 96 286   1 294 257],144,5,40566,4.40408207577896,0.0,0.0
39211,3,9211,[121 168 144 748 175],313,3,40569,4.40392965696917,0.0,0.0
39212,3,9212,[302 427 603 100  64],474,5,40574,4.403994355801585,20.0,20.0
39213,3,9213,[302 427 603 100  64],666,5,40579,4.404059040590406,20.0,20.0
39214,3,9214,[127 286   1 195 197],194,3,40582,4.403906673901248,0.0,20.0
39215,3,9215,[302 427 603 100  64],458,5,40587,4.403971354166667,20.0,20.0
39216,3,9216,[302 427 603 100  64],664,5,40592,4.4040360203970925,20.0,20.0
39217,3,9217,[302 427 603 100  64],90,5,40597,4.404100672597092,20.0,20.0
39218,3,9218,[ 11 186 588 132 187],406,3,40600,4.403948367501898,0.0,0.0
39219,3,9219,[ 28  82 191 483 173],200,5,40605,4.404013015184382,20.0,0.0
39220,3,9220,[286 603 173 475  71],648,2,40607,4.403752304522286,20.0,0.0
39221,3,9221,[302 427 603 100  64],339,5,40612,4.403816959444806,20.0,20.0
39222,3,9222,[302 427 603 100  64],537,4,40616,4.403773175756261,20.0,20.0
39223,3,9223,[302 427 603 100  64],474,5,40621,4.4038378143972245,20.0,20.0
39224,3,9224,[302 427 603 100  64],454,5,40626,4.403902439024391,20.0,20.0
39225,3,9225,[302 427 603 100  64],474,5,40631,4.403967049642315,20.0,20.0
39226,3,9226,[117  95 546 322  56],234,0,40631,4.4034897583179795,0.0,0.0
39227,3,9227,[302 427 603 100  64],664,5,40636,4.403554399653229,20.0,20.0
39228,3,9228,[302 427 603 100  64],745,5,40641,4.403619026980171,20.0,20.0
39229,3,9229,[180 100 194 204 237],188,3,40644,4.403466955579631,0.0,20.0
39230,3,9230,[302 427 603 100  64],90,5,40649,4.4035315783772075,20.0,20.0
39231,3,9231,[302 427 603 100  64],458,5,40654,4.403596187175044,20.0,20.0
39232,3,9232,[204 403 194  15 183],59,4,40658,4.403552474818586,0.0,0.0
39233,3,9233,[132 210 515 496 117],406,4,40662,4.4035087719298245,0.0,0.0
39234,3,9234,[302 427 603 100  64],458,5,40667,4.403573362208988,20.0,20.0
39235,3,9235,[302 427 603 100  64],339,5,40672,4.403637938501515,20.0,20.0
39236,3,9236,[183 238 127 161 483],184,4,40676,4.403594240554293,20.0,20.0
39237,3,9237,[302 427 603 100  64],664,5,40681,4.403658800606192,20.0,20.0
39238,3,9238,[302 427 603 100  64],454,5,40686,4.403723346682542,20.0,20.0
39239,3,9239,[302 427 603 100  64],90,5,40691,4.403787878787878,20.0,20.0
39240,3,9240,[302 427 603 100  64],454,5,40696,4.403852396926739,20.0,20.0
39241,3,9241,[302 427 603 100  64],666,5,40701,4.403916901103657,20.0,20.0
39242,3,9242,[302 427 603 100  64],745,5,40706,4.403981391323163,20.0,20.0
39243,3,9243,[302 427 603 100  64],454,5,40711,4.4040458675897876,20.0,20.0
39244,3,9244,[302 427 603 100  64],13,5,40716,4.404110329908058,20.0,20.0
39245,3,9245,[302 427 603 100  64],90,5,40721,4.404174778282501,20.0,20.0
39246,3,9246,[302 427 603 100  64],664,5,40726,4.404239212717638,20.0,20.0
39247,3,9247,[302 427 603 100  64],537,4,40730,4.404195501730104,20.0,20.0
39248,3,9248,[286 435 216 515 195],85,3,40733,4.404043680397881,0.0,0.0
39249,3,9249,[ 28  88 471 174 294],533,5,40738,4.404108108108108,0.0,20.0
39250,3,9250,[302 427 603 100  64],13,5,40743,4.404172521889525,20.0,20.0
39251,3,9251,[302 427 603 100  64],537,4,40747,4.404128837008215,20.0,20.0
39252,3,9252,[302 427 603 100  64],90,5,40752,4.404193234626607,20.0,20.0
39253,3,9253,[302 427 603 100  64],271,5,40757,4.40425761832721,20.0,20.0
39254,3,9254,[302 427 603 100  64],745,5,40762,4.404321988114533,20.0,20.0
39255,3,9255,[302 427 603 100  64],537,4,40766,4.404278305963699,20.0,20.0
39256,3,9256,[302 427 603 100  64],474,5,40771,4.404342659608945,20.0,20.0
39257,3,9257,[153 100   7  71 204],788,2,40773,4.404082955281918,0.0,20.0
39258,3,9258,[234 175 174 185 423],385,2,40775,4.403823307052598,0.0,20.0
39259,3,9259,[302 427 603 100  64],271,5,40780,4.403887688984881,20.0,20.0
39260,3,9260,[135 546 234 496 211],804,3,40783,4.403736097613649,0.0,0.0
39261,3,9261,[357 194 176 385 222],533,3,40786,4.403584538976463,20.0,0.0
39262,3,9262,[546 403 423 143 194],194,1,40787,4.403217100291482,0.0,0.0
39263,3,9263,[ 69 195 496 215 405],648,3,40790,4.403065630397236,0.0,0.0
39264,3,9264,[302 427 603 100  64],664,5,40795,4.403130059363195,20.0,20.0
39265,3,9265,[237 194 111  89 210],666,1,40796,4.4027627886898335,0.0,0.0
39266,3,9266,[302 427 603 100  64],474,5,40801,4.402827236430344,20.0,20.0
39267,3,9267,[302 427 603 100  64],271,5,40806,4.402891670263272,20.0,20.0
39268,3,9268,[568 200 196 127 181],7,4,40810,4.402848203689718,0.0,20.0
39269,3,9269,[222 294 127 179  97],406,3,40813,4.40269687162891,0.0,20.0
39270,3,9270,[302 427 603 100  64],13,5,40818,4.4027612986732825,20.0,20.0
39271,3,9271,[302 427 603 100  64],271,5,40823,4.402825711820535,20.0,20.0
39272,3,9272,[174 655 195 603  50],899,5,40828,4.402890111075164,20.0,40.0
39273,3,9273,[302 427 603 100  64],458,5,40833,4.402954496441665,20.0,20.0
39274,3,9274,[302 427 603 100  64],474,5,40838,4.403018867924528,20.0,20.0
39275,3,9275,[289 301 294 191  64],378,3,40841,4.402867615351445,0.0,0.0
39276,3,9276,[302 427 603 100  64],745,5,40846,4.4029319823218716,20.0,20.0
39277,3,9277,[302 427 603 100  64],90,5,40851,4.402996335417115,20.0,20.0
39278,3,9278,[313 121 403 100 597],378,4,40855,4.402952904407803,0.0,20.0
39279,3,9279,[302 427 603 100  64],664,5,40860,4.4030172413793105,20.0,20.0
39280,3,9280,[302 427 603 100  64],666,5,40865,4.403081564486586,20.0,20.0
39281,3,9281,[ 12 271 403 202   8],506,5,40870,4.403145873734109,20.0,0.0
39282,3,9282,[302 427 603 100  64],13,5,40875,4.40321016912636,20.0,20.0
39283,3,9283,[302 427 603 100  64],664,5,40880,4.403274450667816,20.0,20.0
39284,3,9284,[302 427 603 100  64],474,5,40885,4.403338718362951,20.0,20.0
39285,3,9285,[ 25 211 275 597  15],308,3,40888,4.4031875942278695,0.0,0.0
39286,3,9286,[161 202 234 174 185],188,3,40891,4.403036502638097,0.0,20.0
39287,3,9287,[302 427 603 100  64],666,5,40896,4.403100775193798,20.0,20.0
39288,3,9288,[302 427 603 100  64],745,5,40901,4.403165033911078,20.0,20.0
39289,3,9289,[603 427 238  88 385],537,3,40904,4.4030139935414425,20.0,0.0
39290,3,9290,[302 427 603 100  64],458,5,40909,4.403078247766656,20.0,20.0
39291,3,9291,[ 11 237 175 176 301],537,1,40910,4.402712010331468,0.0,0.0
39292,3,9292,[302 427 603 100  64],370,5,40915,4.402776283223932,20.0,20.0
39293,3,9293,[302 427 603 100  64],13,5,40920,4.402840542285346,20.0,20.0
39294,3,9294,[302 427 603 100  64],458,5,40925,4.402904787520172,20.0,20.0
39295,3,9295,[302 427 603 100  64],271,5,40930,4.4029690189328745,20.0,20.0
39296,3,9296,[196 546 153 678 135],339,4,40934,4.402925674948908,0.0,0.0
39297,3,9297,[302 427 603 100  64],271,5,40939,4.402989890298989,20.0,20.0
39298,3,9298,[302 427 603 100  64],666,5,40944,4.403054091837832,20.0,20.0
39299,3,9299,[471 194 427 196 211],90,5,40949,4.403118279569893,0.0,0.0
39300,3,9300,[302 427 603 100  64],537,4,40953,4.4030749381786904,20.0,20.0
39301,3,9301,[302 427 603 100  64],370,5,40958,4.403139109868845,20.0,20.0
39302,3,9302,[302 427 603 100  64],454,5,40963,4.403203267763087,20.0,20.0
39303,3,9303,[161 135  25 234 258],234,2,40965,4.402944969905417,0.0,0.0
39304,3,9304,[302 427 603 100  64],370,5,40970,4.403009134873724,20.0,20.0
39305,3,9305,[405 235 322 268 258],537,2,40972,4.4027509133892115,0.0,0.0
39306,3,9306,[302 427 603 100  64],13,5,40977,4.402815085419577,20.0,20.0
39307,3,9307,[302 427 603 100  64],370,5,40982,4.402879243661366,20.0,20.0
39308,3,9308,[301 294 322 117 222],13,0,40982,4.402406273498765,0.0,0.0
39309,3,9309,[302 427 603 100  64],664,5,40987,4.402470461868958,20.0,20.0
39310,3,9310,[121  15  50 385  97],850,5,40992,4.4025346364515086,0.0,20.0
39311,3,9311,[302 427 603 100  64],454,5,40997,4.402598797250859,20.0,20.0
39312,3,9312,[302 427 603 100  64],271,5,41002,4.402662944271449,20.0,20.0
39313,3,9313,[302 427 603 100  64],474,5,41007,4.402727077517715,20.0,20.0
39314,3,9314,[302 427 603 100  64],458,5,41012,4.402791196994095,20.0,20.0
39315,3,9315,[471 273 187 211 603],7,4,41016,4.4027479604980675,20.0,0.0
39316,3,9316,[117  79 546 135 228],455,3,41019,4.402597402597403,0.0,0.0
39317,3,9317,[302 427 603 100  64],370,5,41024,4.402661515346641,20.0,20.0
39318,3,9318,[302 427 603 100  64],458,5,41029,4.402725614336302,20.0,20.0
39319,3,9319,[302 427 603 100  64],90,5,41034,4.402789699570816,20.0,20.0
39320,3,9320,[302 427 603 100  64],90,5,41039,4.402853771054608,20.0,20.0
39321,3,9321,[151 143  98 153 268],90,4,41043,4.402810555674748,0.0,20.0
39322,3,9322,[288 546 127 185  69],804,2,41045,4.4025528263434515,0.0,20.0
39323,3,9323,[191  88 186 118 144],650,3,41048,4.402402402402402,0.0,0.0
39324,3,9324,[302 427 603 100  64],666,5,41053,4.402466487935657,20.0,20.0
39325,3,9325,[302 427 603 100  64],13,5,41058,4.4025305597254984,20.0,20.0
39326,3,9326,[302 427 603 100  64],370,5,41063,4.402594617776348,20.0,20.0
39327,3,9327,[ 71 294 182 302 318],378,4,41067,4.402551457975986,20.0,0.0
39328,3,9328,[302 427 603 100  64],664,5,41072,4.402615500053597,20.0,20.0
39329,3,9329,[588 194 313   1 235],650,2,41074,4.402357984994641,0.0,0.0
39330,3,9330,[302 427 603 100  64],271,5,41079,4.402422034079948,20.0,20.0
39331,3,9331,[333 318 237 211 176],343,4,41083,4.402378911273039,20.0,0.0
39332,3,9332,[168  28  70 403 357],643,3,41086,4.4022286510232504,20.0,0.0
39333,3,9333,[302 427 603 100  64],339,5,41091,4.402292693379044,20.0,20.0
39334,3,9334,[288 234 258 328 265],378,3,41094,4.402142474558115,0.0,0.0
39335,3,9335,[302 427 603 100  64],664,5,41099,4.402206512425021,20.0,20.0
39336,3,9336,[302 427 603 100  64],666,5,41104,4.402270536574917,20.0,20.0
39337,3,9337,[302 427 603 100  64],90,5,41109,4.402334547012209,20.0,20.0
39338,3,9338,[302 427 603 100  64],458,5,41114,4.4023985437413,20.0,20.0
39339,3,9339,[302 427 603 100  64],745,5,41119,4.4024625267665956,20.0,20.0
39340,3,9340,[302 427 603 100  64],370,5,41124,4.402526496092495,20.0,20.0
39341,3,9341,[302 427 603 100  64],454,5,41129,4.4025904517234,20.0,20.0
39342,3,9342,[302 427 603 100  64],664,5,41134,4.402654393663705,20.0,20.0
39343,3,9343,[435 496   8 185 385],194,3,41137,4.402504280821918,0.0,0.0
39344,3,9344,[302 427 603 100  64],745,5,41142,4.402568218298556,20.0,20.0
39345,3,9345,[302 427 603 100  64],271,5,41147,4.402632142092874,20.0,20.0
39346,3,9346,[302 427 603 100  64],474,5,41152,4.402696052209265,20.0,20.0
39347,3,9347,[302 427 603 100  64],13,5,41157,4.402759948652118,20.0,20.0
39348,3,9348,[302 427 603 100  64],13,5,41162,4.402823831425821,20.0,20.0
39349,3,9349,[302 427 603 100  64],90,5,41167,4.40288770053476,20.0,20.0
39350,3,9350,[302 427 603 100  64],90,5,41172,4.402951555983317,20.0,20.0
39351,3,9351,[180 118  79 222 117],479,3,41175,4.402801539777587,0.0,0.0
39352,3,9352,[302 427 603 100  64],339,5,41180,4.402865390783706,20.0,20.0
39353,3,9353,[748 161 318 175  25],207,3,41183,4.40271541586487,20.0,0.0
39354,3,9354,[302 427 603 100  64],474,5,41188,4.40277926242651,20.0,20.0
39355,3,9355,[222 234 423  69   9],533,4,41192,4.402736212056435,0.0,0.0
39356,3,9356,[302 427 603 100  64],537,4,41196,4.402693170888105,20.0,20.0
39357,3,9357,[302 427 603 100  64],666,5,41201,4.402756999358838,20.0,20.0
39358,3,9358,[302 427 603 100  64],271,5,41206,4.40282081418955,20.0,20.0
39359,3,9359,[302 427 603 100  64],745,5,41211,4.4028846153846155,20.0,20.0
39360,3,9360,[302 427 603 100  64],537,4,41215,4.4028415767546205,20.0,20.0
39361,3,9361,[ 88   7 143 185 182],184,2,41217,4.402584917752617,0.0,0.0
39362,3,9362,[245 174 300  11 135],666,2,41219,4.402328313574709,0.0,20.0
39363,3,9363,[302 427 603 100  64],370,5,41224,4.402392140111064,20.0,20.0
39364,3,9364,[302 427 603 100  64],339,5,41229,4.402455953016551,20.0,20.0
39365,3,9365,[302 427 603 100  64],271,5,41234,4.402519752295537,20.0,20.0
39366,3,9366,[302 427 603 100  64],454,5,41239,4.402583537952386,20.0,20.0
39367,3,9367,[ 50 357 294 234 176],95,2,41241,4.40232707087959,20.0,20.0
39368,3,9368,[302 427 603 100  64],339,5,41246,4.402390863485964,20.0,20.0
39369,3,9369,[302 427 603 100  64],666,5,41251,4.402454642475988,20.0,20.0
39370,3,9370,[302 427 603 100  64],474,5,41256,4.402518407854018,20.0,20.0
39371,3,9371,[302 427 603 100  64],745,5,41261,4.402582159624413,20.0,20.0
39372,3,9372,[302 427 603 100  64],370,5,41266,4.402645897791529,20.0,20.0
39373,3,9373,[302 427 603 100  64],474,5,41271,4.402709622359718,20.0,20.0
39374,3,9374,[302 427 603 100  64],90,5,41276,4.402773333333333,20.0,20.0
39375,3,9375,[186 471  79 144 385],313,4,41280,4.402730375426621,0.0,0.0
39376,3,9376,[322 168 597 132 427],533,4,41284,4.4026874266823075,0.0,0.0
39377,3,9377,[180 118 204  98  89],882,5,41289,4.402751119641715,0.0,20.0
39378,3,9378,[302 427 603 100  64],339,5,41294,4.402814799019085,20.0,20.0
39379,3,9379,[302 427 603 100  64],537,4,41298,4.402771855010661,20.0,20.0
39380,3,9380,[  7 237 328 496 180],95,3,41301,4.402622321714103,0.0,0.0
39381,3,9381,[302 427 603 100  64],370,5,41306,4.402685994457472,20.0,20.0
39382,3,9382,[302 427 603 100  64],339,5,41311,4.402749653628903,20.0,20.0
39383,3,9383,[302 427 603 100  64],271,5,41316,4.4028132992327365,20.0,20.0
39384,3,9384,[302 427 603 100  64],745,5,41321,4.402876931273308,20.0,20.0
39385,3,9385,[302 427 603 100  64],90,5,41326,4.4029405497549545,20.0,20.0
39386,3,9386,[302 427 603 100  64],474,5,41331,4.403004154682007,20.0,20.0
39387,3,9387,[333 357 475 228 301],13,1,41332,4.402641670217299,20.0,0.0
39388,3,9388,[302 427 603 100  64],537,4,41336,4.402598785813185,20.0,20.0
39389,3,9389,[302 427 603 100  64],339,5,41341,4.402662406815762,20.0,20.0
39390,3,9390,[302 427 603 100  64],13,5,41346,4.402726014268981,20.0,20.0
39391,3,9391,[288 286  50 200  28],59,4,41350,4.402683134582624,0.0,20.0
39392,3,9392,[302 427 603 100  64],90,5,41355,4.402746726285532,20.0,20.0
39393,3,9393,[302 427 603 100  64],666,5,41360,4.402810304449648,20.0,20.0
39394,3,9394,[  9 301 127   1  15],455,3,41363,4.402660989888238,0.0,20.0
39395,3,9395,[302 427 603 100  64],458,5,41368,4.402724563644104,20.0,20.0
39396,3,9396,[322 300  12 302 117],894,3,41371,4.402575289986165,20.0,0.0
39397,3,9397,[302 427 603 100  64],458,5,41376,4.4026388593317725,20.0,20.0
39398,3,9398,[302 427 603 100  64],474,5,41381,4.402702415150548,20.0,20.0
39399,3,9399,[191 483 655 182 135],339,5,41386,4.4027659574468085,20.0,0.0
39400,3,9400,[245 289 183 185 100],10,5,41391,4.40282948622487,0.0,20.0
39401,3,9401,[302 427 603 100  64],458,5,41396,4.402893001489045,20.0,20.0
39402,3,9402,[302 427 603 100  64],339,5,41401,4.4029565032436455,20.0,20.0
39403,3,9403,[302 427 603 100  64],370,5,41406,4.4030199914929815,20.0,20.0
39404,3,9404,[302 427 603 100  64],666,5,41411,4.403083466241361,20.0,20.0
39405,3,9405,[302 427 603 100  64],474,5,41416,4.40314692749309,20.0,20.0
39406,3,9406,[302 427 603 100  64],537,4,41420,4.4031040714361644,20.0,20.0
39407,3,9407,[302 427 603 100  64],13,5,41425,4.4031675170068025,20.0,20.0
39408,3,9408,[302 427 603 100  64],664,5,41430,4.403230949091296,20.0,20.0
39409,3,9409,[302 427 603 100  64],339,5,41435,4.403294367693943,20.0,20.0
39410,3,9410,[318 121 196 275 475],533,4,41439,4.403251514185528,20.0,0.0
39411,3,9411,[302 427 603 100  64],454,5,41444,4.403314917127072,20.0,20.0
39412,3,9412,[302 427 603 100  64],90,5,41449,4.403378306597259,20.0,20.0
39413,3,9413,[302 427 603 100  64],370,5,41454,4.403441682600382,20.0,20.0
39414,3,9414,[302 427 603 100  64],666,5,41459,4.403505045140733,20.0,20.0
39415,3,9415,[302 427 603 100  64],458,5,41464,4.4035683942226,20.0,20.0
39416,3,9416,[302 427 603 100  64],454,5,41469,4.403631729850271,20.0,20.0
39417,3,9417,[181  28   4 202 176],774,2,41471,4.403376513060097,0.0,0.0
39418,3,9418,[302 427 603 100  64],13,5,41476,4.4034398556109995,20.0,20.0
39419,3,9419,[322 748 678 197 175],881,1,41477,4.40307855626327,0.0,0.0
39420,3,9420,[302 427 603 100  64],271,5,41482,4.40314191699395,20.0,20.0
39421,3,9421,[302 427 603 100  64],458,5,41487,4.403205264275101,20.0,20.0
39422,3,9422,[302 427 603 100  64],537,4,41491,4.403162474795713,20.0,20.0
39423,3,9423,[302 427 603 100  64],664,5,41496,4.403225806451613,20.0,20.0
39424,3,9424,[302 427 603 100  64],370,5,41501,4.403289124668435,20.0,20.0
39425,3,9425,[210 121 288 228 286],59,4,41505,4.4032463399108845,0.0,0.0
39426,3,9426,[302 427 603 100  64],666,5,41510,4.403309642516177,20.0,20.0
39427,3,9427,[302 427 603 100  64],271,5,41515,4.40337293169283,20.0,20.0
39428,3,9428,[678 276 471 322 121],548,4,41519,4.403330151659773,0.0,0.0
39429,3,9429,[302 427 603 100  64],271,5,41524,4.4033934252386,20.0,20.0
39430,3,9430,[302 427 603 100  64],90,5,41529,4.403456685399215,20.0,20.0
39431,3,9431,[302 427 603 100  64],454,5,41534,4.403519932145886,20.0,20.0
39432,3,9432,[302 427 603 100  64],370,5,41539,4.403583165482879,20.0,20.0
39433,3,9433,[302 427 603 100  64],745,5,41544,4.403646385414459,20.0,20.0
39434,3,9434,[191  88 678   1 357],454,2,41546,4.403391626921039,20.0,0.0
39435,3,9435,[ 95 282 111 403 176],92,3,41549,4.4032428995337005,0.0,0.0
39436,3,9436,[302 427 603 100  64],90,5,41554,4.403306135424393,20.0,20.0
39437,3,9437,[302 427 603 100  64],537,4,41558,4.403263403263403,20.0,20.0
39438,3,9438,[302 427 603 100  64],474,5,41563,4.403326623583006,20.0,20.0
39439,3,9439,[508 228  96  97  56],653,3,41566,4.403177966101695,0.0,0.0
39440,3,9440,[302 427 603 100  64],454,5,41571,4.40324118207817,20.0,20.0
39441,3,9441,[302 427 603 100  64],666,5,41576,4.403304384664266,20.0,20.0
39442,3,9442,[302 427 603 100  64],458,5,41581,4.403367573864238,20.0,20.0
39443,3,9443,[302 427 603 100  64],370,5,41586,4.403430749682338,20.0,20.0
39444,3,9444,[302 427 603 100  64],370,5,41591,4.4034939121228165,20.0,20.0
39445,3,9445,[ 98 322 289  71 197],234,3,41594,4.403345331357189,0.0,20.0
39446,3,9446,[234 202 483 286 144],406,2,41596,4.403090928337038,20.0,0.0
39447,3,9447,[302 427 603 100  64],339,5,41601,4.403154106689247,20.0,20.0
39448,3,9448,[302 427 603 100  64],454,5,41606,4.40321727166896,20.0,20.0
39449,3,9449,[302 427 603 100  64],537,4,41610,4.4031746031746035,20.0,20.0
39450,3,9450,[275 186  56 235 427],882,4,41614,4.403131943709661,0.0,0.0
39451,3,9451,[191 121 175 496 235],184,2,41616,4.402877697841727,0.0,0.0
39452,3,9452,[302 427 603 100  64],474,5,41621,4.402940865333757,20.0,20.0
39453,3,9453,[302 427 603 100  64],474,5,41626,4.403004019462661,20.0,20.0
39454,3,9454,[302 427 603 100  64],90,5,41631,4.403067160232681,20.0,20.0
39455,3,9455,[302 427 603 100  64],745,5,41636,4.403130287648054,20.0,20.0
39456,3,9456,[302 427 603 100  64],370,5,41641,4.4031934017130165,20.0,20.0
39457,3,9457,[182  25 161 132  88],897,4,41645,4.403150771833369,0.0,0.0
39458,3,9458,[302 427 603 100  64],537,4,41649,4.403108150967332,20.0,20.0
39459,3,9459,[302 427 603 100  64],339,5,41654,4.403171247357294,20.0,20.0
39460,3,9460,[302 427 603 100  64],454,5,41659,4.403234330409048,20.0,20.0
39461,3,9461,[302 427 603 100  64],474,5,41664,4.4032974001268235,20.0,20.0
39462,3,9462,[  8 186 173 174 655],379,5,41669,4.403360456514847,0.0,20.0
39463,3,9463,[302 427 603 100  64],90,5,41674,4.403423499577346,20.0,20.0
39464,3,9464,[302 427 603 100  64],454,5,41679,4.403486529318542,20.0,20.0
39465,3,9465,[302 427 603 100  64],664,5,41684,4.403549545742658,20.0,20.0
39466,3,9466,[302 427 603 100  64],537,4,41688,4.403506918770466,20.0,20.0
39467,3,9467,[302 427 603 100  64],370,5,41693,4.403569919729615,20.0,20.0
39468,3,9468,[228  71 237 186 286],60,4,41697,4.403527299609252,0.0,0.0
39469,3,9469,[302 427 603 100  64],745,5,41702,4.403590285110877,20.0,20.0
39470,3,9470,[302 427 603 100  64],339,5,41707,4.4036532573117935,20.0,20.0
39471,3,9471,[ 15 405 216  96 172],892,5,41712,4.403716216216216,0.0,0.0
39472,3,9472,[302 427 603 100  64],90,5,41717,4.403779161828354,20.0,20.0
39473,3,9473,[302 427 603 100  64],666,5,41722,4.4038420941524175,20.0,20.0
39474,3,9474,[302 427 603 100  64],454,5,41727,4.403905013192612,20.0,20.0
39475,3,9475,[302 427 603 100  64],537,4,41731,4.403862389193753,20.0,20.0
39476,3,9476,[655  15 237 211 186],95,3,41734,4.403714255566108,0.0,0.0
39477,3,9477,[302 427 603 100  64],90,5,41739,4.403777168178941,20.0,20.0
39478,3,9478,[302 427 603 100  64],666,5,41744,4.40384006751767,20.0,20.0
39479,3,9479,[185 144 238 286 196],379,5,41749,4.403902953586498,0.0,0.0
39480,3,9480,[302 427 603 100  64],271,5,41754,4.403965826389621,20.0,20.0
39481,3,9481,[302 427 603 100  64],537,4,41758,4.403923222948745,20.0,20.0
39482,3,9482,[302 427 603 100  64],458,5,41763,4.4039860803543185,20.0,20.0
39483,3,9483,[302 427 603 100  64],664,5,41768,4.404048924504428,20.0,20.0
39484,3,9484,[ 50 168  15 187 174],271,3,41771,4.403900896151819,0.0,40.0
39485,3,9485,[302 427 603 100  64],370,5,41776,4.403963736032047,20.0,20.0
39486,3,9486,[302 427 603 100  64],271,5,41781,4.404026562664699,20.0,20.0
39487,3,9487,[302 427 603 100  64],666,5,41786,4.404089376053963,20.0,20.0
39488,3,9488,[302 427 603 100  64],474,5,41791,4.404152176204025,20.0,20.0
39489,3,9489,[302 427 603 100  64],664,5,41796,4.404214963119073,20.0,20.0
39490,3,9490,[302 427 603 100  64],339,5,41801,4.404277736803287,20.0,20.0
39491,3,9491,[ 15 245 603   4 111],533,3,41804,4.404129793510324,20.0,0.0
39492,3,9492,[273 211 228 483 216],59,4,41808,4.4040872221636995,20.0,0.0
39493,3,9493,[179 127 186  22 144],87,5,41813,4.404149989467032,0.0,20.0
39494,3,9494,[302 427 603 100  64],664,5,41818,4.404212743549237,20.0,20.0
39495,3,9495,[302 427 603 100  64],454,5,41823,4.40427548441449,20.0,20.0
39496,3,9496,[302 427 603 100  64],537,4,41827,4.404232915657576,20.0,20.0
39497,3,9497,[302 427 603 100  64],537,4,41831,4.404190355864393,20.0,20.0
39498,3,9498,[302 427 603 100  64],339,5,41836,4.404253079271502,20.0,20.0
39499,3,9499,[302 427 603 100  64],90,5,41841,4.404315789473684,20.0,20.0
39500,3,9500,[302 427 603 100  64],458,5,41846,4.404378486475108,20.0,20.0
39501,3,9501,[742 176 265 175 568],92,3,41849,4.404230688276153,0.0,0.0
39502,3,9502,[302 427 603 100  64],664,5,41854,4.404293381037567,20.0,20.0
39503,3,9503,[302 427 603 100  64],474,5,41859,4.4043560606060606,20.0,20.0
39504,3,9504,[ 69 286  89 179 200],271,4,41863,4.404313519200421,0.0,0.0
39505,3,9505,[302 427 603 100  64],13,5,41868,4.404376183463076,20.0,20.0
39506,3,9506,[302 427 603 100  64],745,5,41873,4.404438834542968,20.0,20.0
39507,3,9507,[302 427 603 100  64],666,5,41878,4.404501472444258,20.0,20.0
39508,3,9508,[302 427 603 100  64],13,5,41883,4.404564097171101,20.0,20.0
39509,3,9509,[302 427 603 100  64],339,5,41888,4.404626708727655,20.0,20.0
39510,3,9510,[302 427 603 100  64],745,5,41893,4.4046893071180735,20.0,20.0
39511,3,9511,[302 427 603 100  64],339,5,41898,4.40475189234651,20.0,20.0
39512,3,9512,[302 427 603 100  64],339,5,41903,4.404814464417114,20.0,20.0
39513,3,9513,[302 427 603 100  64],458,5,41908,4.404877023334034,20.0,20.0
39514,3,9514,[302 427 603 100  64],370,5,41913,4.404939569101419,20.0,20.0
39515,3,9515,[ 22 111 282 176 216],95,4,41917,4.404897015552753,0.0,0.0
39516,3,9516,[302 427 603 100  64],454,5,41922,4.404959546075444,20.0,20.0
39517,3,9517,[302 427 603 100  64],90,5,41927,4.40502206345871,20.0,20.0
39518,3,9518,[302 427 603 100  64],90,5,41932,4.405084567706692,20.0,20.0
39519,3,9519,[302 427 603 100  64],370,5,41937,4.4051470588235295,20.0,20.0
39520,3,9520,[302 427 603 100  64],454,5,41942,4.40520953681336,20.0,20.0
39521,3,9521,[302 427 603 100  64],339,5,41947,4.405272001680319,20.0,20.0
39522,3,9522,[143 185 204 132 655],474,5,41952,4.405334453428542,0.0,0.0
39523,3,9523,[302 427 603 100  64],90,5,41957,4.405396892062159,20.0,20.0
39524,3,9524,[508 204 173 288 328],13,1,41958,4.4050393700787405,0.0,0.0
39525,3,9525,[302 427 603 100  64],745,5,41963,4.4051018265798865,20.0,20.0
39526,3,9526,[302 427 603 100  64],458,5,41968,4.405164269969561,20.0,20.0
39527,3,9527,[181 176 196 202 210],738,5,41973,4.405226700251889,0.0,0.0
39528,3,9528,[237 172 403 258 121],378,5,41978,4.405289117431,0.0,0.0
39529,3,9529,[302 427 603 100  64],666,5,41983,4.405351521511018,20.0,20.0
39530,3,9530,[210  69 237  88 197],13,4,41987,4.405308991711258,0.0,0.0
39531,3,9531,[302 427 603 100  64],537,4,41991,4.405266470835082,20.0,20.0
39532,3,9532,[302 427 603 100  64],339,5,41996,4.405328857652365,20.0,20.0
39533,3,9533,[175 215   7 173 318],664,4,42000,4.405286343612334,20.0,0.0
39534,3,9534,[302 427 603 100  64],664,5,42005,4.40534871525957,20.0,20.0
39535,3,9535,[302 427 603 100  64],745,5,42010,4.405411073825503,20.0,20.0
39536,3,9536,[302 427 603 100  64],13,5,42015,4.40547341931425,20.0,20.0
39537,3,9537,[302 427 603 100  64],454,5,42020,4.405535751729922,20.0,20.0
39538,3,9538,[302 427 603 100  64],90,5,42025,4.405598071076633,20.0,20.0
39539,3,9539,[302 427 603 100  64],537,4,42029,4.405555555555556,20.0,20.0
39540,3,9540,[302 427 603 100  64],458,5,42034,4.405617859763128,20.0,20.0
39541,3,9541,[ 79 228  89 182 187],650,2,42036,4.405365751414798,0.0,0.0
39542,3,9542,[302 427 603 100  64],537,4,42040,4.405323273603688,20.0,20.0
39543,3,9543,[302 427 603 100  64],745,5,42045,4.405385582564962,20.0,20.0
39544,3,9544,[302 427 603 100  64],90,5,42050,4.405447878470404,20.0,20.0
39545,3,9545,[302 427 603 100  64],474,5,42055,4.4055101613241145,20.0,20.0
39546,3,9546,[302 427 603 100  64],666,5,42060,4.405572431130198,20.0,20.0
39547,3,9547,[302 427 603 100  64],90,5,42065,4.405634687892753,20.0,20.0
39548,3,9548,[302 427 603 100  64],339,5,42070,4.405696931615876,20.0,20.0
39549,3,9549,[302 427 603 100  64],339,5,42075,4.4057591623036645,20.0,20.0
39550,3,9550,[302 427 603 100  64],339,5,42080,4.405821379960214,20.0,20.0
39551,3,9551,[168 483 275 471 172],533,5,42085,4.405883584589615,20.0,0.0
39552,3,9552,[302 427 603 100  64],474,5,42090,4.405945776195959,20.0,20.0
39553,3,9553,[ 97 111  50 197 288],374,3,42093,4.405798618379737,0.0,20.0
39554,3,9554,[ 95   9 211   1  89],194,3,42096,4.405651491365777,0.0,0.0
39555,3,9555,[302 427 603 100  64],458,5,42101,4.405713687735454,20.0,20.0
39556,3,9556,[302 427 603 100  64],454,5,42106,4.405775871089254,20.0,20.0
39557,3,9557,[302 427 603 100  64],370,5,42111,4.405838041431262,20.0,20.0
39558,3,9558,[ 95 322  71 180 172],313,3,42114,4.405690971858981,0.0,0.0
39559,3,9559,[655 216 427 333  25],537,1,42115,4.4053347280334725,0.0,0.0
39560,3,9560,[302 427 603 100  64],537,4,42119,4.405292333437925,20.0,20.0
39561,3,9561,[302 427 603 100  64],90,5,42124,4.405354528341351,20.0,20.0
39562,3,9562,[294 655 143 181 125],194,2,42126,4.405103001150267,0.0,0.0
39563,3,9563,[597  64 132   8 173],92,2,42128,4.404851526557925,0.0,0.0
39564,3,9564,[302 427 603 100  64],370,5,42133,4.4049137480397285,20.0,20.0
39565,3,9565,[  1  88 288 496 271],537,1,42134,4.404557808906544,0.0,0.0
39566,3,9566,[302 427 603 100  64],474,5,42139,4.404620048081949,20.0,20.0
39567,3,9567,[302 427 603 100  64],537,4,42143,4.404577759197324,20.0,20.0
39568,3,9568,[302 427 603 100  64],370,5,42148,4.404639983279339,20.0,20.0
39569,3,9569,[302 427 603 100  64],370,5,42153,4.404702194357367,20.0,20.0
39570,3,9570,[302 427 603 100  64],271,5,42158,4.4047643924354825,20.0,20.0
39571,3,9571,[302 427 603 100  64],745,5,42163,4.40482657751776,20.0,20.0
39572,3,9572,[748 237 195 173 222],454,3,42166,4.404679828684843,0.0,0.0
39573,3,9573,[ 95 173  69 568 216],506,5,42171,4.404742009609358,0.0,0.0
39574,3,9574,[435 678   1 174 182],804,4,42175,4.404699738903394,0.0,20.0
39575,3,9575,[302 427 603 100  64],454,5,42180,4.404761904761905,20.0,20.0
39576,3,9576,[302 427 603 100  64],745,5,42185,4.404824057638091,20.0,20.0
39577,3,9577,[302 427 603 100  64],271,5,42190,4.40488619753602,20.0,20.0
39578,3,9578,[302 427 603 100  64],664,5,42195,4.404948324459756,20.0,20.0
39579,3,9579,[302 427 603 100  64],339,5,42200,4.4050104384133615,20.0,20.0
39580,3,9580,[ 15 423 180 186 143],533,3,42203,4.404863792923495,0.0,0.0
39581,3,9581,[302 427 603 100  64],666,5,42208,4.404925902734293,20.0,20.0
39582,3,9582,[302 427 603 100  64],666,5,42213,4.404987999582594,20.0,20.0
39583,3,9583,[302 427 603 100  64],664,5,42218,4.405050083472454,20.0,20.0
39584,3,9584,[302 427 603 100  64],666,5,42223,4.405112154407929,20.0,20.0
39585,3,9585,[302 427 603 100  64],745,5,42228,4.4051742123930735,20.0,20.0
39586,3,9586,[302 427 603 100  64],664,5,42233,4.405236257431939,20.0,20.0
39587,3,9587,[302 427 603 100  64],474,5,42238,4.405298289528577,20.0,20.0
39588,3,9588,[302 427 603 100  64],13,5,42243,4.405360308687038,20.0,20.0
39589,3,9589,[302 427 603 100  64],458,5,42248,4.405422314911366,20.0,20.0
39590,3,9590,[302 427 603 100  64],13,5,42253,4.405484308205609,20.0,20.0
39591,3,9591,[302 427 603 100  64],745,5,42258,4.405546288573811,20.0,20.0
39592,3,9592,[302 427 603 100  64],370,5,42263,4.405608256020015,20.0,20.0
39593,3,9593,[302 427 603 100  64],474,5,42268,4.4056702105482595,20.0,20.0
39594,3,9594,[302 427 603 100  64],370,5,42273,4.405732152162584,20.0,20.0
39595,3,9595,[302 427 603 100  64],458,5,42278,4.405794080867028,20.0,20.0
39596,3,9596,[302 427 603 100  64],745,5,42283,4.4058559966656246,20.0,20.0
39597,3,9597,[132 172 427  98 269],271,5,42288,4.405917899562409,0.0,20.0
39598,3,9598,[302 427 603 100  64],13,5,42293,4.405979789561413,20.0,20.0
39599,3,9599,[245 182 435 385 176],313,4,42297,4.4059375,0.0,0.0
39600,3,9600,[302 427 603 100  64],666,5,42302,4.405999375065098,20.0,20.0
39601,3,9601,[302 427 603 100  64],537,4,42306,4.405957092272443,20.0,20.0
39602,3,9602,[302 427 603 100  64],458,5,42311,4.406018952410705,20.0,20.0
39603,3,9603,[195 194 257 294 385],749,2,42313,4.405768429820908,0.0,0.0
39604,3,9604,[132 121 748 125 161],200,4,42317,4.405726184279021,0.0,0.0
39605,3,9605,[302 427 603 100  64],537,4,42321,4.405683947532792,20.0,20.0
39606,3,9606,[302 427 603 100  64],454,5,42326,4.405745810346622,20.0,20.0
39607,3,9607,[302 427 603 100  64],339,5,42331,4.405807660283098,20.0,20.0
39608,3,9608,[302 427 603 100  64],370,5,42336,4.405869497346238,20.0,20.0
39609,3,9609,[144  98 132 483 515],804,5,42341,4.405931321540063,20.0,20.0
39610,3,9610,[302 427 603 100  64],474,5,42346,4.405993132868588,20.0,20.0
39611,3,9611,[302 427 603 100  64],370,5,42351,4.40605493133583,20.0,20.0
39612,3,9612,[302 427 603 100  64],474,5,42356,4.406116716945802,20.0,20.0
39613,3,9613,[302 427 603 100  64],454,5,42361,4.406178489702517,20.0,20.0
39614,3,9614,[302 427 603 100  64],90,5,42366,4.406240249609985,20.0,20.0
39615,3,9615,[186 135  15   1  64],398,4,42370,4.406198003327787,0.0,0.0
39616,3,9616,[423   4  71 191  56],474,5,42375,4.406259748362275,0.0,0.0
39617,3,9617,[ 28 282 196 496  64],42,5,42380,4.406321480557288,0.0,0.0
39618,3,9618,[302 427 603 100  64],13,5,42385,4.4063831999168315,20.0,20.0
39619,3,9619,[ 69 186  95 161  88],295,5,42390,4.406444906444906,0.0,0.0
39620,3,9620,[302 427 603 100  64],458,5,42395,4.406506600145515,20.0,20.0
39621,3,9621,[302 427 603 100  64],745,5,42400,4.406568281022657,20.0,20.0
39622,3,9622,[302 427 603 100  64],458,5,42405,4.406629949080329,20.0,20.0
39623,3,9623,[302 427 603 100  64],745,5,42410,4.406691604322527,20.0,20.0
39624,3,9624,[302 427 603 100  64],664,5,42415,4.406753246753246,20.0,20.0
39625,3,9625,[302 427 603 100  64],474,5,42420,4.4068148763764805,20.0,20.0
39626,3,9626,[302 427 603 100  64],474,5,42425,4.4068764931962185,20.0,20.0
39627,3,9627,[302 427 603 100  64],745,5,42430,4.406938097216452,20.0,20.0
39628,3,9628,[302 427 603 100  64],370,5,42435,4.406999688441167,20.0,20.0
39629,3,9629,[302 427 603 100  64],90,5,42440,4.407061266874351,20.0,20.0
39630,3,9630,[ 98 118  89  28 161],543,4,42444,4.407019001142145,0.0,20.0
39631,3,9631,[302 427 603 100  64],664,5,42449,4.407080564784053,20.0,20.0
39632,3,9632,[ 98 117  79 515  89],339,4,42453,4.407038305823731,0.0,20.0
39633,3,9633,[ 22   1 121  79 182],881,4,42457,4.406996055636288,0.0,0.0
39634,3,9634,[302 427 603 100  64],370,5,42462,4.4070576024909185,20.0,20.0
39635,3,9635,[168 174 172 194 153],666,2,42464,4.4068078040680785,0.0,20.0
39636,3,9636,[302 427 603 100  64],664,5,42469,4.406869357683926,20.0,20.0
39637,3,9637,[302 427 603 100  64],474,5,42474,4.4069308985266655,20.0,20.0
39638,3,9638,[302 427 603 100  64],664,5,42479,4.40699242660027,20.0,20.0
39639,3,9639,[302 427 603 100  64],664,5,42484,4.407053941908714,20.0,20.0
39640,3,9640,[  1 318 174  79 191],6,4,42488,4.407011720775853,20.0,20.0
39641,3,9641,[302 427 603 100  64],664,5,42493,4.407073221323377,20.0,20.0
39642,3,9642,[302 427 603 100  64],454,5,42498,4.407134709115421,20.0,20.0
39643,3,9643,[302 427 603 100  64],664,5,42503,4.407196184155952,20.0,20.0
39644,3,9644,[194  12 423 403 185],524,4,42507,4.407153965785381,20.0,0.0
39645,3,9645,[302 427 603 100  64],745,5,42512,4.407215426083351,20.0,20.0
39646,3,9646,[302 427 603 100  64],666,5,42517,4.407276873639473,20.0,20.0
39647,3,9647,[302 427 603 100  64],370,5,42522,4.407338308457711,20.0,20.0
39648,3,9648,[302 427 603 100  64],339,5,42527,4.407399730542025,20.0,20.0
39649,3,9649,[211 257 216  56 174],210,5,42532,4.407461139896373,0.0,20.0
39650,3,9650,[ 11 302 265 588 323],537,1,42533,4.407108071702415,0.0,0.0
39651,3,9651,[302 427 603 100  64],454,5,42538,4.407169498549523,20.0,20.0
39652,3,9652,[302 427 603 100  64],664,5,42543,4.407230912669636,20.0,20.0
39653,3,9653,[302 427 603 100  64],454,5,42548,4.407292314066708,20.0,20.0
39654,3,9654,[742 328 125 678 118],554,2,42550,4.407042982910409,0.0,0.0
39655,3,9655,[302 427 603 100  64],454,5,42555,4.407104391052195,20.0,20.0
39656,3,9656,[302 427 603 100  64],13,5,42560,4.407165786476131,20.0,20.0
39657,3,9657,[302 427 603 100  64],537,4,42564,4.407123628080348,20.0,20.0
39658,3,9658,[328 238 181 742 435],833,0,42564,4.406667356869241,0.0,0.0
39659,3,9659,[302 427 603 100  64],745,5,42569,4.406728778467909,20.0,20.0
39660,3,9660,[302 427 603 100  64],90,5,42574,4.406790187351206,20.0,20.0
39661,3,9661,[302 427 603 100  64],458,5,42579,4.40685158352308,20.0,20.0
39662,3,9662,[302 427 603 100  64],537,4,42583,4.406809479457725,20.0,20.0
39663,3,9663,[302 427 603 100  64],458,5,42588,4.406870860927152,20.0,20.0
39664,3,9664,[302 427 603 100  64],271,5,42593,4.406932229694775,20.0,20.0
39665,3,9665,[302 427 603 100  64],13,5,42598,4.4069935857645355,20.0,20.0
39666,3,9666,[357 286 117 333 194],881,3,42601,4.406848039722768,20.0,0.0
39667,3,9667,[237  12 100 271  28],334,3,42604,4.406702523789822,20.0,20.0
39668,3,9668,[302 427 603 100  64],370,5,42609,4.4067638845795845,20.0,20.0
39669,3,9669,[302 427 603 100  64],271,5,42614,4.406825232678386,20.0,20.0
39670,3,9670,[302 427 603 100  64],458,5,42619,4.406886568090166,20.0,20.0
39671,3,9671,[268 200  88 237 403],92,3,42622,4.406741108354011,0.0,0.0
39672,3,9672,[302 427 603 100  64],537,4,42626,4.406699059237051,20.0,20.0
39673,3,9673,[302 427 603 100  64],664,5,42631,4.406760388670664,20.0,20.0
39674,3,9674,[385  64   9 268 483],7,4,42635,4.40671834625323,20.0,0.0
39675,3,9675,[302 427 603 100  64],13,5,42640,4.406779661016949,20.0,20.0
39676,3,9676,[302 427 603 100  64],664,5,42645,4.406840963108402,20.0,20.0
39677,3,9677,[302 427 603 100  64],537,4,42649,4.406798925397809,20.0,20.0
39678,3,9678,[302 427 603 100  64],13,5,42654,4.406860212831904,20.0,20.0
39679,3,9679,[302 427 603 100  64],666,5,42659,4.406921487603306,20.0,20.0
39680,3,9680,[302 427 603 100  64],537,4,42663,4.406879454601797,20.0,20.0
39681,3,9681,[546   4 118   8 271],158,4,42667,4.406837430283,0.0,0.0
39682,3,9682,[357 153 235  56 172],313,2,42669,4.406588867086647,20.0,0.0
39683,3,9683,[471  22 191 196 269],90,5,42674,4.40665014456836,0.0,0.0
39684,3,9684,[302 427 603 100  64],474,5,42679,4.406711409395973,20.0,20.0
39685,3,9685,[302 427 603 100  64],666,5,42684,4.406772661573405,20.0,20.0
39686,3,9686,[302 427 603 100  64],13,5,42689,4.406833901104573,20.0,20.0
39687,3,9687,[302 427 603 100  64],339,5,42694,4.406895127993394,20.0,20.0
39688,3,9688,[483 300 111 678 211],488,3,42697,4.406749922592631,20.0,0.0
39689,3,9689,[302 427 603 100  64],271,5,42702,4.406811145510836,20.0,20.0
39690,3,9690,[302 427 603 100  64],271,5,42707,4.406872355794036,20.0,20.0
39691,3,9691,[302 427 603 100  64],90,5,42712,4.406933553446141,20.0,20.0
39692,3,9692,[302 427 603 100  64],458,5,42717,4.406994738471061,20.0,20.0
39693,3,9693,[302 427 603 100  64],664,5,42722,4.407055910872705,20.0,20.0
39694,3,9694,[  1 187  11   7 121],102,0,42722,4.40660134089737,0.0,0.0
39695,3,9695,[302 427 603 100  64],666,5,42727,4.406662541254126,20.0,20.0
39696,3,9696,[302 427 603 100  64],271,5,42732,4.4067237289883465,20.0,20.0
39697,3,9697,[302 427 603 100  64],339,5,42737,4.406784904103939,20.0,20.0
39698,3,9698,[302 427 603 100  64],666,5,42742,4.406846066604805,20.0,20.0
39699,3,9699,[302 427 603 100  64],90,5,42747,4.4069072164948455,20.0,20.0
39700,3,9700,[194 258 302  95 322],102,2,42749,4.406659107308525,0.0,0.0
39701,3,9701,[197 508  12 286  56],527,3,42752,4.4065141207998355,20.0,0.0
39702,3,9702,[302 427 603 100  64],474,5,42757,4.406575285994022,20.0,20.0
39703,3,9703,[302 427 603 100  64],90,5,42762,4.406636438582028,20.0,20.0
39704,3,9704,[302 427 603 100  64],454,5,42767,4.406697578567749,20.0,20.0
39705,3,9705,[302 427 603 100  64],664,5,42772,4.406758705955079,20.0,20.0
39706,3,9706,[302 427 603 100  64],454,5,42777,4.406819820747914,20.0,20.0
39707,3,9707,[302 427 603 100  64],370,5,42782,4.406880922950144,20.0,20.0
39708,3,9708,[302 427 603 100  64],664,5,42787,4.40694201256566,20.0,20.0
39709,3,9709,[302 427 603 100  64],271,5,42792,4.407003089598352,20.0,20.0
39710,3,9710,[302 427 603 100  64],458,5,42797,4.407064154052106,20.0,20.0
39711,3,9711,[302 427 603 100  64],458,5,42802,4.407125205930807,20.0,20.0
39712,3,9712,[302 427 603 100  64],339,5,42807,4.40718624523834,20.0,20.0
39713,3,9713,[302 427 603 100  64],537,4,42811,4.407144327774346,20.0,20.0
39714,3,9714,[204 427 187 111  25],537,2,42813,4.406896551724138,0.0,0.0
39715,3,9715,[302 427 603 100  64],13,5,42818,4.406957595718403,20.0,20.0
39716,3,9716,[302 427 603 100  64],90,5,42823,4.407018627148297,20.0,20.0
39717,3,9717,[302 427 603 100  64],339,5,42828,4.407079646017699,20.0,20.0
39718,3,9718,[144 153 276 121  50],447,5,42833,4.407140652330487,0.0,20.0
39719,3,9719,[288 195  69 111 135],833,2,42835,4.4068930041152266,0.0,0.0
39720,3,9720,[302 427 603 100  64],666,5,42840,4.4069540170764325,20.0,20.0
39721,3,9721,[302 427 603 100  64],271,5,42845,4.407015017486114,20.0,20.0
39722,3,9722,[ 28 176 174 265  22],804,5,42850,4.407076005348143,0.0,20.0
39723,3,9723,[302 427 603 100  64],666,5,42855,4.407136980666392,20.0,20.0
39724,3,9724,[302 427 603 100  64],454,5,42860,4.40719794344473,20.0,20.0
39725,3,9725,[302 427 603 100  64],90,5,42865,4.4072588936870245,20.0,20.0
39726,3,9726,[302 427 603 100  64],370,5,42870,4.407319831397142,20.0,20.0
39727,3,9727,[  9 234 403 357 176],788,3,42873,4.407175164473684,20.0,0.0
39728,3,9728,[302 427 603 100  64],666,5,42878,4.407236098262925,20.0,20.0
39729,3,9729,[180 179 132 176 135],406,5,42883,4.407297019527236,0.0,0.0
39730,3,9730,[302 427 603 100  64],90,5,42888,4.407357928270476,20.0,20.0
39731,3,9731,[302 427 603 100  64],458,5,42893,4.4074188244965065,20.0,20.0
39732,3,9732,[597  79 144 176 172],92,4,42897,4.407376964964554,0.0,0.0
39733,3,9733,[  8 200 118 172 322],311,4,42901,4.407335114033286,0.0,0.0
39734,3,9734,[302 427 603 100  64],458,5,42906,4.407395993836672,20.0,20.0
39735,3,9735,[276 258   8 237  12],234,1,42907,4.407046014790469,20.0,0.0
39736,3,9736,[302 427 603 100  64],271,5,42912,4.407106911779809,20.0,20.0
39737,3,9737,[302 427 603 100  64],666,5,42917,4.407167796262066,20.0,20.0
39738,3,9738,[302 427 603 100  64],745,5,42922,4.407228668241093,20.0,20.0
39739,3,9739,[121 215 161 117 194],648,2,42924,4.406981519507187,0.0,0.0
39740,3,9740,[195 423 161  98 294],653,2,42926,4.406734421517298,0.0,20.0
39741,3,9741,[186 286 200 132 302],334,3,42929,4.406590022582632,0.0,0.0
39742,3,9742,[135 322 237 180 603],537,3,42932,4.406445653289541,20.0,0.0
39743,3,9743,[302 427 603 100  64],454,5,42937,4.406506568144499,20.0,20.0
39744,3,9744,[302 427 603 100  64],458,5,42942,4.406567470497691,20.0,20.0
39745,3,9745,[302 427 603 100  64],13,5,42947,4.406628360352966,20.0,20.0
39746,3,9746,[302 427 603 100  64],454,5,42952,4.406689237714168,20.0,20.0
39747,3,9747,[302 427 603 100  64],339,5,42957,4.406750102585145,20.0,20.0
39748,3,9748,[302 427 603 100  64],454,5,42962,4.406810954969741,20.0,20.0
39749,3,9749,[302 427 603 100  64],13,5,42967,4.406871794871795,20.0,20.0
39750,3,9750,[211  15  25 202  64],42,4,42971,4.406830068710901,0.0,0.0
39751,3,9751,[302 427 603 100  64],454,5,42976,4.406890894175554,20.0,20.0
39752,3,9752,[ 95 322 475 568 197],537,2,42978,4.406644109504768,0.0,0.0
39753,3,9753,[302 427 603 100  64],458,5,42983,4.4067049415624355,20.0,20.0
39754,3,9754,[313 282 301   7 117],294,4,42987,4.4066632496155815,0.0,0.0
39755,3,9755,[302 427 603 100  64],666,5,42992,4.406724067240672,20.0,20.0
39756,3,9756,[302 427 603 100  64],271,5,42997,4.406784872399303,20.0,20.0
39757,3,9757,[302 427 603 100  64],271,5,43002,4.4068456650953065,20.0,20.0
39758,3,9758,[302 427 603 100  64],745,5,43007,4.406906445332513,20.0,20.0
39759,3,9759,[302 427 603 100  64],474,5,43012,4.406967213114754,20.0,20.0
39760,3,9760,[302 427 603 100  64],537,4,43016,4.406925519926237,20.0,20.0
39761,3,9761,[302 427 603 100  64],90,5,43021,4.406986273304651,20.0,20.0
39762,3,9762,[302 427 603 100  64],370,5,43026,4.407047014237427,20.0,20.0
39763,3,9763,[302 427 603 100  64],370,5,43031,4.40710774272839,20.0,20.0
39764,3,9764,[302 427 603 100  64],271,5,43036,4.407168458781362,20.0,20.0
39765,3,9765,[302 427 603 100  64],745,5,43041,4.407229162400164,20.0,20.0
39766,3,9766,[302 427 603 100  64],90,5,43046,4.4072898535886145,20.0,20.0
39767,3,9767,[302 427 603 100  64],745,5,43051,4.407350532350533,20.0,20.0
39768,3,9768,[302 427 603 100  64],454,5,43056,4.407411198689733,20.0,20.0
39769,3,9769,[153   8   1 269 275],125,3,43059,4.407267144319345,0.0,0.0
39770,3,9770,[678 180 322 100 172],749,3,43062,4.407123119435063,0.0,20.0
39771,3,9771,[302 427 603 100  64],745,5,43067,4.4071837904216125,20.0,20.0
39772,3,9772,[302 427 603 100  64],339,5,43072,4.407244448992121,20.0,20.0
39773,3,9773,[302 427 603 100  64],474,5,43077,4.407305095150399,20.0,20.0
39774,3,9774,[302 427 603 100  64],458,5,43082,4.407365728900256,20.0,20.0
39775,3,9775,[302 427 603 100  64],90,5,43087,4.407426350245499,20.0,20.0
39776,3,9776,[302 427 603 100  64],454,5,43092,4.407486959189936,20.0,20.0
39777,3,9777,[302 427 603 100  64],370,5,43097,4.40754755573737,20.0,20.0
39778,3,9778,[302 427 603 100  64],13,5,43102,4.407608139891605,20.0,20.0
39779,3,9779,[302 427 603 100  64],90,5,43107,4.4076687116564415,20.0,20.0
39780,3,9780,[302 427 603 100  64],370,5,43112,4.407729271035682,20.0,20.0
39781,3,9781,[302 427 603 100  64],13,5,43117,4.407789818033122,20.0,20.0
39782,3,9782,[302 427 603 100  64],339,5,43122,4.40785035265256,20.0,20.0
39783,3,9783,[302 427 603 100  64],537,4,43126,4.407808667211774,20.0,20.0
39784,3,9784,[258  22 202 173 748],64,3,43129,4.4076647930505874,0.0,0.0
39785,3,9785,[302 427 603 100  64],339,5,43134,4.407725321888412,20.0,20.0
39786,3,9786,[302 427 603 100  64],474,5,43139,4.407785838357004,20.0,20.0
39787,3,9787,[302 427 603 100  64],454,5,43144,4.4078463424601555,20.0,20.0
39788,3,9788,[302 427 603 100  64],339,5,43149,4.407906834201655,20.0,20.0
39789,3,9789,[234 204 183  50   7],339,4,43153,4.407865168539326,0.0,20.0
39790,3,9790,[302 427 603 100  64],90,5,43158,4.40792564600143,20.0,20.0
39791,3,9791,[258 282 211 300 135],271,2,43160,4.407679738562091,0.0,0.0
39792,3,9792,[302 427 603 100  64],13,5,43165,4.407740222607985,20.0,20.0
39793,3,9793,[302 427 603 100  64],454,5,43170,4.407800694302634,20.0,20.0
39794,3,9794,[655  82  11 211 385],207,2,43172,4.407554874936192,0.0,0.0
39795,3,9795,[302 427 603 100  64],271,5,43177,4.40761535320539,20.0,20.0
39796,3,9796,[302 427 603 100  64],666,5,43182,4.407675819128305,20.0,20.0
39797,3,9797,[302 427 603 100  64],474,5,43187,4.407736272708716,20.0,20.0
39798,3,9798,[302 427 603 100  64],271,5,43192,4.407796713950403,20.0,20.0
39799,3,9799,[302 427 603 100  64],664,5,43197,4.407857142857143,20.0,20.0
39800,3,9800,[302 427 603 100  64],666,5,43202,4.407917559432711,20.0,20.0
39801,3,9801,[258  12 275 197 118],560,4,43206,4.407875943684962,20.0,0.0
39802,3,9802,[302 427 603 100  64],666,5,43211,4.407936346016526,20.0,20.0
39803,3,9803,[423 117 196 195 234],263,4,43215,4.407894736842105,0.0,0.0
39804,3,9804,[118 172 153  96   4],87,5,43220,4.407955124936257,0.0,0.0
39805,3,9805,[302 427 603 100  64],370,5,43225,4.408015500713849,20.0,20.0
39806,3,9806,[302 427 603 100  64],664,5,43230,4.408075864178648,20.0,20.0
39807,3,9807,[302 427 603 100  64],537,4,43234,4.408034257748777,20.0,20.0
39808,3,9808,[302 427 603 100  64],537,4,43238,4.407992659802223,20.0,20.0
39809,3,9809,[302 427 603 100  64],745,5,43243,4.408053007135576,20.0,20.0
39810,3,9810,[ 89 357 322  95 483],234,2,43245,4.407807562939557,40.0,0.0
39811,3,9811,[302 427 603 100  64],370,5,43250,4.407867916836527,20.0,20.0
39812,3,9812,[302 427 603 100  64],454,5,43255,4.407928258432691,20.0,20.0
39813,3,9813,[302 427 603 100  64],666,5,43260,4.407988587731812,20.0,20.0
39814,3,9814,[302 427 603 100  64],537,4,43264,4.407947019867549,20.0,20.0
39815,3,9815,[302 427 603 100  64],666,5,43269,4.408007334963325,20.0,20.0
39816,3,9816,[182 403 655 135  88],506,5,43274,4.408067637771214,0.0,0.0
39817,3,9817,[302 427 603 100  64],745,5,43279,4.408127928294968,20.0,20.0
39818,3,9818,[302 427 603 100  64],454,5,43284,4.408188206538344,20.0,20.0
39819,3,9819,[302 427 603 100  64],745,5,43289,4.408248472505091,20.0,20.0
39820,3,9820,[546 182 151 265 403],524,4,43293,4.408206903573974,0.0,0.0
39821,3,9821,[302 427 603 100  64],474,5,43298,4.408267155365506,20.0,20.0
39822,3,9822,[302 427 603 100  64],90,5,43303,4.408327394889545,20.0,20.0
39823,3,9823,[302 427 603 100  64],474,5,43308,4.408387622149837,20.0,20.0
39824,3,9824,[302 427 603 100  64],370,5,43313,4.408447837150128,20.0,20.0
39825,3,9825,[302 427 603 100  64],90,5,43318,4.4085080398941585,20.0,20.0
39826,3,9826,[302 427 603 100  64],537,4,43322,4.4084664699297855,20.0,20.0
39827,3,9827,[127 210 161  79 268],387,3,43325,4.408323158323158,0.0,20.0
39828,3,9828,[302 427 603 100  64],13,5,43330,4.408383355376945,20.0,20.0
39829,3,9829,[302 427 603 100  64],458,5,43335,4.408443540183113,20.0,20.0
39830,3,9830,[302 427 603 100  64],90,5,43340,4.408503712745397,20.0,20.0
39831,3,9831,[302 427 603 100  64],454,5,43345,4.408563873067535,20.0,20.0
39832,3,9832,[168  22 405 211 179],271,3,43348,4.408420624427947,0.0,0.0
39833,3,9833,[302 427 603 100  64],339,5,43353,4.408480780964003,20.0,20.0
39834,3,9834,[302 427 603 100  64],666,5,43358,4.408540925266904,20.0,20.0
39835,3,9835,[302 427 603 100  64],666,5,43363,4.408601057340382,20.0,20.0
39836,3,9836,[322 168   8  56   9],311,5,43368,4.408661177188167,0.0,0.0
39837,3,9837,[234 257 144  64 403],899,3,43371,4.408517991461679,0.0,0.0
39838,3,9838,[ 69  89   1 215 180],59,4,43375,4.408476471186096,0.0,0.0
39839,3,9839,[302 427 603 100  64],13,5,43380,4.408536585365853,20.0,20.0
39840,3,9840,[204 423 655 172 237],788,2,43382,4.408291840260136,0.0,0.0
39841,3,9841,[187 174 144 385 216],643,4,43386,4.408250355618777,0.0,20.0
39842,3,9842,[  9 194 153  50 271],940,2,43388,4.408005689322361,0.0,20.0
39843,3,9843,[302 427 603 100  64],454,5,43393,4.408065826899635,20.0,20.0
39844,3,9844,[302 427 603 100  64],90,5,43398,4.408125952260031,20.0,20.0
39845,3,9845,[302 427 603 100  64],370,5,43403,4.408186065407272,20.0,20.0
39846,3,9846,[302 427 603 100  64],664,5,43408,4.40824616634508,20.0,20.0
39847,3,9847,[302 427 603 100  64],745,5,43413,4.408306255077173,20.0,20.0
39848,3,9848,[302 427 603 100  64],745,5,43418,4.40836633160727,20.0,20.0
39849,3,9849,[302 427 603 100  64],458,5,43423,4.408426395939086,20.0,20.0
39850,3,9850,[302 427 603 100  64],370,5,43428,4.408486448076338,20.0,20.0
39851,3,9851,[302 427 603 100  64],745,5,43433,4.408546488022736,20.0,20.0
39852,3,9852,[302 427 603 100  64],666,5,43438,4.408606515781996,20.0,20.0
39853,3,9853,[302 427 603 100  64],666,5,43443,4.408666531357825,20.0,20.0
39854,3,9854,[302 427 603 100  64],13,5,43448,4.408726534753932,20.0,20.0
39855,3,9855,[655 191   9  15 423],144,5,43453,4.408786525974026,0.0,0.0
39856,3,9856,[302 427 603 100  64],745,5,43458,4.4088465050218115,20.0,20.0
39857,3,9857,[568 210 174 118 496],313,5,43463,4.408906471900994,0.0,20.0
39858,3,9858,[302 427 603 100  64],458,5,43468,4.408966426615275,20.0,20.0
39859,3,9859,[302 427 603 100  64],370,5,43473,4.409026369168357,20.0,20.0
39860,3,9860,[302 427 603 100  64],537,4,43477,4.408984889970591,20.0,20.0
39861,3,9861,[302 427 603 100  64],474,5,43482,4.409044818495234,20.0,20.0
39862,3,9862,[302 427 603 100  64],90,5,43487,4.409104734867688,20.0,20.0
39863,3,9863,[257 423  25 276 294],533,4,43491,4.409063260340632,0.0,0.0
39864,3,9864,[302 427 603 100  64],666,5,43496,4.409123162696401,20.0,20.0
39865,3,9865,[302 427 603 100  64],339,5,43501,4.40918305290898,20.0,20.0
39866,3,9866,[302 427 603 100  64],458,5,43506,4.409242930982061,20.0,20.0
39867,3,9867,[568 183 111 153 118],378,4,43510,4.4092014592622615,0.0,0.0
39868,3,9868,[127 117 597 186 403],95,3,43513,4.409058668558111,0.0,20.0
39869,3,9869,[302 427 603 100  64],664,5,43518,4.409118541033434,20.0,20.0
39870,3,9870,[302 427 603 100  64],90,5,43523,4.4091784013777735,20.0,20.0
39871,3,9871,[302 427 603 100  64],474,5,43528,4.4092382495948135,20.0,20.0
39872,3,9872,[302 427 603 100  64],458,5,43533,4.40929808568824,20.0,20.0
39873,3,9873,[117   1 222 202 174],882,5,43538,4.409357909661738,0.0,20.0
39874,3,9874,[302 427 603 100  64],339,5,43543,4.409417721518987,20.0,20.0
39875,3,9875,[168 294 748 181 222],474,2,43545,4.409173754556501,0.0,0.0
39876,3,9876,[302 427 603 100  64],339,5,43550,4.409233572947251,20.0,20.0
39877,3,9877,[302 427 603 100  64],271,5,43555,4.409293379226564,20.0,20.0
39878,3,9878,[302 427 603 100  64],745,5,43560,4.4093531733981175,20.0,20.0
39879,3,9879,[302 427 603 100  64],13,5,43565,4.409412955465587,20.0,20.0
39880,3,9880,[265  64 508  71 216],83,3,43568,4.4092703167695575,0.0,0.0
39881,3,9881,[302 427 603 100  64],458,5,43573,4.409330095122445,20.0,20.0
39882,3,9882,[302 427 603 100  64],454,5,43578,4.409389861378124,20.0,20.0
39883,3,9883,[302 427 603 100  64],90,5,43583,4.409449615540267,20.0,20.0
39884,3,9884,[302 427 603 100  64],664,5,43588,4.409509357612544,20.0,20.0
39885,3,9885,[302 427 603 100  64],664,5,43593,4.409569087598625,20.0,20.0
39886,3,9886,[302 427 603 100  64],339,5,43598,4.409628805502175,20.0,20.0
39887,3,9887,[288 257 235  98  89],650,2,43600,4.409385113268608,0.0,20.0
39888,3,9888,[302 427 603 100  64],13,5,43605,4.4094448376984525,20.0,20.0
39889,3,9889,[302 427 603 100  64],370,5,43610,4.409504550050556,20.0,20.0
39890,3,9890,[302 427 603 100  64],474,5,43615,4.4095642503285815,20.0,20.0
39891,3,9891,[302 427 603 100  64],13,5,43620,4.409623938536191,20.0,20.0
39892,3,9892,[302 427 603 100  64],454,5,43625,4.409683614677045,20.0,20.0
39893,3,9893,[302 427 603 100  64],370,5,43630,4.409743278754801,20.0,20.0
39894,3,9894,[302 427 603 100  64],454,5,43635,4.409802930773118,20.0,20.0
39895,3,9895,[302 427 603 100  64],666,5,43640,4.409862570735651,20.0,20.0
39896,3,9896,[302 427 603 100  64],454,5,43645,4.409922198646054,20.0,20.0
39897,3,9897,[302 427 603 100  64],90,5,43650,4.409981814507981,20.0,20.0
39898,3,9898,[302 427 603 100  64],13,5,43655,4.410041418325084,20.0,20.0
39899,3,9899,[403 423 515  69 210],524,4,43659,4.41,0.0,0.0
39900,3,9900,[216 173 269 132 234],64,5,43664,4.41005958994041,0.0,0.0
39901,3,9901,[302 427 603 100  64],454,5,43669,4.41011916784488,20.0,20.0
39902,3,9902,[ 82 435 204 234  12],385,0,43669,4.409673836211249,20.0,0.0
39903,3,9903,[302 427 603 100  64],537,4,43673,4.409632471728594,20.0,20.0
39904,3,9904,[300 153 385  28 235],64,3,43676,4.409490156486623,0.0,0.0
39905,3,9905,[302 427 603 100  64],339,5,43681,4.409549767817484,20.0,20.0
39906,3,9906,[302 427 603 100  64],90,5,43686,4.409609367114162,20.0,20.0
39907,3,9907,[302 427 603 100  64],271,5,43691,4.409668954380299,20.0,20.0
39908,3,9908,[ 71 546 318  98 172],234,2,43693,4.4094257745483905,20.0,20.0
39909,3,9909,[ 28 210  97 175 121],406,4,43697,4.409384460141271,0.0,0.0
39910,3,9910,[302 427 603 100  64],458,5,43702,4.409444052063364,20.0,20.0
39911,3,9911,[302 427 603 100  64],458,5,43707,4.409503631961259,20.0,20.0
39912,3,9912,[153 135  25 175 228],749,4,43711,4.409462322203168,0.0,0.0
39913,3,9913,[237  28 235 496   8],882,4,43715,4.409421020778697,0.0,0.0
39914,3,9914,[135  64  69 238 276],10,5,43720,4.409480584972264,0.0,0.0
39915,3,9915,[302 427 603 100  64],370,5,43725,4.409540137152077,20.0,20.0
39916,3,9916,[302 427 603 100  64],339,5,43730,4.40959967732177,20.0,20.0
39917,3,9917,[302 427 603 100  64],90,5,43735,4.409659205484977,20.0,20.0
39918,3,9918,[302 427 603 100  64],339,5,43740,4.409718721645327,20.0,20.0
39919,3,9919,[302 427 603 100  64],458,5,43745,4.409778225806452,20.0,20.0
39920,3,9920,[222 546 183  56  70],194,1,43746,4.409434532809192,0.0,0.0
39921,3,9921,[302 427 603 100  64],13,5,43751,4.409494053618222,20.0,20.0
39922,3,9922,[302 427 603 100  64],537,4,43755,4.409452786455709,20.0,20.0
39923,3,9923,[302 427 603 100  64],90,5,43760,4.409512293430068,20.0,20.0
39924,3,9924,[302 427 603 100  64],537,4,43764,4.409471032745592,20.0,20.0
39925,3,9925,[302 427 603 100  64],537,4,43768,4.409429780374773,20.0,20.0
39926,3,9926,[302 427 603 100  64],271,5,43773,4.409489271683288,20.0,20.0
39927,3,9927,[435 174 186 748 127],648,3,43776,4.409347300564061,0.0,40.0
39928,3,9928,[238  71 183   1 257],749,3,43779,4.409205358042099,0.0,0.0
39929,3,9929,[  4 182 132 323 211],650,2,43781,4.408962739174219,0.0,0.0
39930,3,9930,[179 153 475 237 202],13,3,43784,4.408820863961333,0.0,0.0
39931,3,9931,[187 161  25 289 385],13,2,43786,4.408578332662103,0.0,0.0
39932,3,9932,[302 427 603 100  64],474,5,43791,4.408637873754153,20.0,20.0
39933,3,9933,[302 427 603 100  64],339,5,43796,4.408697402858868,20.0,20.0
39934,3,9934,[302 427 603 100  64],664,5,43801,4.4087569199798695,20.0,20.0
39935,3,9935,[302 427 603 100  64],537,4,43805,4.4087157809983895,20.0,20.0
39936,3,9936,[302 427 603 100  64],666,5,43810,4.408775284291034,20.0,20.0
39937,3,9937,[175 202 172 289 546],378,3,43813,4.408633527872811,0.0,0.0
39938,3,9938,[302 427 603 100  64],664,5,43818,4.408693027467552,20.0,20.0
39939,3,9939,[302 427 603 100  64],474,5,43823,4.408752515090543,20.0,20.0
39940,3,9940,[302 427 603 100  64],458,5,43828,4.408811990745398,20.0,20.0
39941,3,9941,[302 427 603 100  64],339,5,43833,4.408871454435727,20.0,20.0
39942,3,9942,[302 427 603 100  64],454,5,43838,4.408930906165141,20.0,20.0
39943,3,9943,[302 427 603 100  64],745,5,43843,4.408990345937249,20.0,20.0
39944,3,9944,[302 427 603 100  64],474,5,43848,4.409049773755656,20.0,20.0
39945,3,9945,[302 427 603 100  64],90,5,43853,4.40910918962397,20.0,20.0
39946,3,9946,[515 176 546 405 385],313,4,43857,4.409068060721825,0.0,0.0
39947,3,9947,[302 427 603 100  64],537,4,43861,4.40902694008846,20.0,20.0
39948,3,9948,[302 427 603 100  64],745,5,43866,4.409086340335712,20.0,20.0
39949,3,9949,[302 427 603 100  64],13,5,43871,4.4091457286432165,20.0,20.0
39950,3,9950,[302 427 603 100  64],458,5,43876,4.409205105014571,20.0,20.0
39951,3,9951,[302 427 603 100  64],458,5,43881,4.409264469453376,20.0,20.0
39952,3,9952,[302 427 603 100  64],458,5,43886,4.409323821963227,20.0,20.0
39953,3,9953,[302 427 603 100  64],90,5,43891,4.409383162547719,20.0,20.0
39954,3,9954,[302 427 603 100  64],339,5,43896,4.409442491210447,20.0,20.0
39955,3,9955,[302 427 603 100  64],339,5,43901,4.409501807955002,20.0,20.0
39956,3,9956,[302 427 603 100  64],474,5,43906,4.409561112784975,20.0,20.0
39957,3,9957,[ 89 183 257 423 181],474,4,43910,4.409519983932516,0.0,0.0
39958,3,9958,[302 427 603 100  64],474,5,43915,4.409579275027613,20.0,20.0
39959,3,9959,[302 427 603 100  64],370,5,43920,4.409638554216867,20.0,20.0
39960,3,9960,[302 427 603 100  64],454,5,43925,4.409697821503865,20.0,20.0
39961,3,9961,[302 427 603 100  64],339,5,43930,4.40975707689219,20.0,20.0
39962,3,9962,[  8  69 176 187  96],328,4,43934,4.409715949011342,0.0,0.0
39963,3,9963,[302 427 603 100  64],537,4,43938,4.409674829385789,20.0,20.0
39964,3,9964,[302 427 603 100  64],271,5,43943,4.409734069242348,20.0,20.0
39965,3,9965,[302 427 603 100  64],458,5,43948,4.409793297210515,20.0,20.0
39966,3,9966,[302 427 603 100  64],90,5,43953,4.4098525132938695,20.0,20.0
39967,3,9967,[302 427 603 100  64],474,5,43958,4.409911717495987,20.0,20.0
39968,3,9968,[302 427 603 100  64],339,5,43963,4.409970909820443,20.0,20.0
39969,3,9969,[302 427 603 100  64],458,5,43968,4.410030090270812,20.0,20.0
39970,3,9970,[302 427 603 100  64],271,5,43973,4.410089258850667,20.0,20.0
39971,3,9971,[748 403 172 300 173],311,5,43978,4.410148415563578,0.0,0.0
39972,3,9972,[328 603 313 234 215],234,3,43981,4.410007018951168,20.0,0.0
39973,3,9973,[ 28 238 135 333 289],488,3,43984,4.409865650691799,0.0,0.0
39974,3,9974,[302 427 603 100  64],664,5,43989,4.409924812030075,20.0,20.0
39975,3,9975,[197 151 179 403 216],653,1,43990,4.409582999198076,0.0,0.0
39976,3,9976,[302 427 603 100  64],370,5,43995,4.409642177007116,20.0,20.0
39977,3,9977,[211 153 322  56  28],454,1,43996,4.409300461014231,0.0,0.0
39978,3,9978,[302 427 603 100  64],370,5,44001,4.40935965527608,20.0,20.0
39979,3,9979,[302 427 603 100  64],664,5,44006,4.409418837675351,20.0,20.0
39980,3,9980,[302 427 603 100  64],339,5,44011,4.4094780082156095,20.0,20.0
39981,3,9981,[302 427 603 100  64],474,5,44016,4.409537166900421,20.0,20.0
39982,3,9982,[302 427 603 100  64],474,5,44021,4.4095963137333465,20.0,20.0
39983,3,9983,[302 427 603 100  64],271,5,44026,4.409655448717949,20.0,20.0
39984,3,9984,[302 427 603 100  64],458,5,44031,4.409714571857787,20.0,20.0
39985,3,9985,[302 427 603 100  64],745,5,44036,4.409773683156419,20.0,20.0
39986,3,9986,[302 427 603 100  64],90,5,44041,4.409832782617403,20.0,20.0
39987,3,9987,[302 427 603 100  64],454,5,44046,4.4098918702442935,20.0,20.0
39988,3,9988,[302 427 603 100  64],454,5,44051,4.409950946040644,20.0,20.0
39989,3,9989,[286  64 176 216 182],234,1,44052,4.40960960960961,0.0,0.0
39990,3,9990,[302 427 603 100  64],474,5,44057,4.409668701831649,20.0,20.0
39991,3,9991,[302 427 603 100  64],537,4,44061,4.409627702161729,20.0,20.0
39992,3,9992,[302 427 603 100  64],370,5,44066,4.409686780746522,20.0,20.0
39993,3,9993,[302 427 603 100  64],90,5,44071,4.409745847508505,20.0,20.0
39994,3,9994,[302 427 603 100  64],666,5,44076,4.409804902451226,20.0,20.0
39995,3,9995,[318 568 237 187  97],533,3,44079,4.409663865546219,20.0,0.0
39996,3,9996,[302 427 603 100  64],13,5,44084,4.4097229168750625,20.0,20.0
39997,3,9997,[302 427 603 100  64],666,5,44089,4.409781956391278,20.0,20.0
39998,3,9998,[302 427 603 100  64],13,5,44094,4.40984098409841,20.0,20.0
39999,3,9999,[257 237 127  79 258],455,4,44098,4.4098,0.0,20.0
40000,4,0,[117 403 546 100 228],194,1,1,1.0,0.0,20.0
40001,4,1,[100 678 237  69  71],804,5,6,3.0,0.0,20.0
40002,4,2,[385  11 273 328 427],328,1,7,2.3333333333333335,0.0,0.0
40003,4,3,[678 328  69  71 100],804,5,12,3.0,0.0,20.0
40004,4,4,[678 328  69  71 100],804,5,17,3.4,0.0,20.0
40005,4,5,[678 328  69  71 100],664,2,19,3.1666666666666665,0.0,20.0
40006,4,6,[194 603 135 357 237],890,4,23,3.2857142857142856,40.0,0.0
40007,4,7,[195  98 288 423 202],452,3,26,3.25,0.0,20.0
40008,4,8,[ 71 603 195 423 100],524,2,28,3.111111111111111,20.0,20.0
40009,4,9,[100 423  98 194 135],694,5,33,3.3,0.0,40.0
40010,4,10,[100 423  98 194 135],804,3,36,3.272727272727273,0.0,40.0
40011,4,11,[172 194 174 300 228],537,0,36,3.0,0.0,20.0
40012,4,12,[ 97  98 273 228 318],59,4,40,3.076923076923077,20.0,20.0
40013,4,13,[ 97 100  98 318 357],458,2,42,3.0,40.0,40.0
40014,4,14,[100 318  71  98 328],664,4,46,3.066666666666667,20.0,40.0
40015,4,15,[100 318  71  98  69],64,4,50,3.125,20.0,40.0
40016,4,16,[100 318  98  69 678],334,3,53,3.1176470588235294,20.0,40.0
40017,4,17,[100 318  98 423 194],804,4,57,3.1666666666666665,20.0,40.0
40018,4,18,[100 318  98 194  71],328,4,61,3.210526315789474,20.0,40.0
40019,4,19,[100 318  98  71 194],380,5,66,3.3,20.0,40.0
40020,4,20,[100 318  98  71 194],406,4,70,3.3333333333333335,20.0,40.0
40021,4,21,[100 318  98 194  71],406,4,74,3.3636363636363638,20.0,40.0
40022,4,22,[100 318  98 194 135],694,5,79,3.4347826086956523,20.0,40.0
40023,4,23,[100 318  98 194 135],271,5,84,3.5,20.0,40.0
40024,4,24,[100 318  98 194 135],385,2,86,3.44,20.0,40.0
40025,4,25,[181 234 211 333 183],346,4,90,3.4615384615384617,0.0,0.0
40026,4,26,[211 100 183 333 181],666,3,93,3.4444444444444446,0.0,20.0
40027,4,27,[211 100 183  98 318],666,5,98,3.5,20.0,40.0
40028,4,28,[211 100 183  98 318],315,4,102,3.5172413793103448,20.0,40.0
40029,4,29,[211 100  98 318 183],385,2,104,3.466666666666667,20.0,40.0
40030,4,30,[313 215  82 194   7],940,4,108,3.4838709677419355,0.0,0.0
40031,4,31,[ 82   7 100 313  98],650,4,112,3.5,0.0,40.0
40032,4,32,[  7 100 313  98 318],883,3,115,3.484848484848485,20.0,40.0
40033,4,33,[  7 100  98 318 211],738,3,118,3.4705882352941178,20.0,40.0
40034,4,34,[  7 100  98 318 194],474,5,123,3.5142857142857142,20.0,40.0
40035,4,35,[  7 100  98 318 194],7,5,128,3.5555555555555554,20.0,40.0
40036,4,36,[  7 100  98 318 194],213,5,133,3.5945945945945947,20.0,40.0
40037,4,37,[  7 100  98 318 194],406,5,138,3.6315789473684212,20.0,40.0
40038,4,38,[  7 100  98 318 194],6,4,142,3.641025641025641,20.0,40.0
40039,4,39,[191  11 302  28 546],833,2,144,3.6,0.0,0.0
40040,4,40,[191 100  98 318   7],474,5,149,3.6341463414634148,20.0,40.0
40041,4,41,[191 100  98 318   7],308,4,153,3.642857142857143,20.0,40.0
40042,4,42,[191 100 318   7  98],92,4,157,3.6511627906976742,20.0,40.0
40043,4,43,[191 100   7  98 318],343,5,162,3.6818181818181817,20.0,40.0
40044,4,44,[191 100   7  98 318],666,5,167,3.7111111111111112,20.0,40.0
40045,4,45,[191 100   7  98 318],194,4,171,3.717391304347826,20.0,40.0
40046,4,46,[191 100  98 318   7],387,4,175,3.723404255319149,20.0,40.0
40047,4,47,[191 100  98   7 318],59,5,180,3.75,20.0,40.0
40048,4,48,[191 100  98   7 318],6,4,184,3.7551020408163267,20.0,40.0
40049,4,49,[191 100  98 318 194],271,5,189,3.78,20.0,40.0
40050,4,50,[191 100  98 318 194],271,5,194,3.803921568627451,20.0,40.0
40051,4,51,[191 100  98 318 194],694,5,199,3.826923076923077,20.0,40.0
40052,4,52,[191 100  98 318 194],385,2,201,3.792452830188679,20.0,40.0
40053,4,53,[100 191  98 318   7],406,5,206,3.814814814814815,20.0,40.0
40054,4,54,[100 191  98 318   7],343,5,211,3.8363636363636364,20.0,40.0
40055,4,55,[100 191  98 318   7],144,4,215,3.8392857142857144,20.0,40.0
40056,4,56,[100 191  98 318 194],232,5,220,3.8596491228070176,20.0,40.0
40057,4,57,[100 191  98 318 194],458,3,223,3.8448275862068964,20.0,40.0
40058,4,58,[483 185 286 288 471],213,3,226,3.830508474576271,20.0,0.0
40059,4,59,[483 185 100 191  98],537,4,230,3.8333333333333335,20.0,40.0
40060,4,60,[483 185 100 191  98],7,5,235,3.8524590163934427,20.0,40.0
40061,4,61,[483 185 100 191  98],184,5,240,3.870967741935484,20.0,40.0
40062,4,62,[173 191 588 603 172],234,2,242,3.8412698412698414,20.0,0.0
40063,4,63,[483 185 100 191  98],881,5,247,3.859375,20.0,40.0
40064,4,64,[483 185 100 191  98],488,2,249,3.830769230769231,20.0,40.0
40065,4,65,[185 100 191  98 318],452,5,254,3.8484848484848486,20.0,40.0
40066,4,66,[ 28 211 269 204 179],537,2,256,3.8208955223880596,0.0,0.0
40067,4,67,[185 179 100 191  98],13,2,258,3.7941176470588234,0.0,40.0
40068,4,68,[ 71 403  98 385 282],92,5,263,3.8115942028985508,0.0,20.0
40069,4,69,[282 100  98 191 318],474,5,268,3.8285714285714287,20.0,40.0
40070,4,70,[282 100  98 191 318],334,5,273,3.8450704225352115,20.0,40.0
40071,4,71,[282 100  98 191 318],533,5,278,3.861111111111111,20.0,40.0
40072,4,72,[282 100  98 191 318],194,4,282,3.863013698630137,20.0,40.0
40073,4,73,[100  98 191 318 185],234,4,286,3.864864864864865,20.0,40.0
40074,4,74,[100  98 191 318 483],499,5,291,3.88,40.0,40.0
40075,4,75,[  7 294  28 179  96],92,3,294,3.8684210526315788,0.0,0.0
40076,4,76,[238 118 655 546  95],194,2,296,3.844155844155844,0.0,0.0
40077,4,77,[655 238  96 100  98],295,4,300,3.8461538461538463,0.0,40.0
40078,4,78,[655 238 100  98 191],840,5,305,3.8607594936708862,0.0,40.0
40079,4,79,[655 238 100  98 191],804,5,310,3.875,0.0,40.0
40080,4,80,[655 238 100  98 191],234,3,313,3.8641975308641974,0.0,40.0
40081,4,81,[100  98 191 318 483],454,3,316,3.8536585365853657,40.0,40.0
40082,4,82,[100 191  98 318   7],64,5,321,3.8674698795180724,20.0,40.0
40083,4,83,[100 191  98 318   7],455,4,325,3.869047619047619,20.0,40.0
40084,4,84,[100 191  98 318   7],6,4,329,3.8705882352941177,20.0,40.0
40085,4,85,[100 191  98 318 655],144,5,334,3.883720930232558,20.0,40.0
40086,4,86,[100 191  98 318 655],13,3,337,3.8735632183908044,20.0,40.0
40087,4,87,[100  98 191 318 655],666,5,342,3.8863636363636362,20.0,40.0
40088,4,88,[100  98 191 655 318],194,5,347,3.898876404494382,20.0,40.0
40089,4,89,[100  98 191 655 318],311,4,351,3.9,20.0,40.0
40090,4,90,[100  98 191 655 318],378,5,356,3.912087912087912,20.0,40.0
40091,4,91,[100  98 191 655 318],13,3,359,3.902173913043478,20.0,40.0
40092,4,92,[100  98 655 191 318],664,3,362,3.89247311827957,20.0,40.0
40093,4,93,[100  98 191 318 655],454,3,365,3.882978723404255,20.0,40.0
40094,4,94,[100  98 191 318   7],474,5,370,3.8947368421052633,20.0,40.0
40095,4,95,[100  98 191 318   7],804,5,375,3.90625,20.0,40.0
40096,4,96,[100  98 191 318   7],144,4,379,3.9072164948453607,20.0,40.0
40097,4,97,[100  98 191 318 238],234,4,383,3.9081632653061225,20.0,40.0
40098,4,98,[100  98 191 318 282],406,4,387,3.909090909090909,20.0,40.0
40099,4,99,[100  98 191 318 194],474,5,392,3.92,20.0,40.0
40100,4,100,[100  98 191 318 194],234,5,397,3.9306930693069306,20.0,40.0
40101,4,101,[100  98 191 318 194],385,2,399,3.911764705882353,20.0,40.0
40102,4,102,[100  98 191 318   7],308,4,403,3.912621359223301,20.0,40.0
40103,4,103,[100  98 191 318   7],234,4,407,3.9134615384615383,20.0,40.0
40104,4,104,[100  98 191 318 655],194,5,412,3.9238095238095236,20.0,40.0
40105,4,105,[100  98 191 318 655],538,4,416,3.9245283018867925,20.0,40.0
40106,4,106,[100  98 191 318 185],234,4,420,3.925233644859813,20.0,40.0
40107,4,107,[100  98 191 318 194],295,5,425,3.935185185185185,20.0,40.0
40108,4,108,[100  98 191 318 194],474,5,430,3.944954128440367,20.0,40.0
40109,4,109,[100  98 191 318 194],144,5,435,3.9545454545454546,20.0,40.0
40110,4,110,[100  98 191 318 194],406,5,440,3.963963963963964,20.0,40.0
40111,4,111,[100  98 191 318 194],452,5,445,3.9732142857142856,20.0,40.0
40112,4,112,[100  98 191 318 194],499,5,450,3.982300884955752,20.0,40.0
40113,4,113,[100  98 191 318 194],533,5,455,3.991228070175439,20.0,40.0
40114,4,114,[100  98 191 318 194],308,4,459,3.991304347826087,20.0,40.0
40115,4,115,[100  98 191 318 194],343,5,464,4.0,20.0,40.0
40116,4,116,[100  98 191 318 194],308,4,468,4.0,20.0,40.0
40117,4,117,[100 191  98 318 194],308,4,472,4.0,20.0,40.0
40118,4,118,[100 191 318  98 194],465,4,476,4.0,20.0,40.0
40119,4,119,[300  97 202 216   8],87,4,480,4.0,0.0,0.0
40120,4,120,[  8 216 100 191 318],488,1,481,3.975206611570248,20.0,20.0
40121,4,121,[100 318 191  98 194],295,5,486,3.9836065573770494,20.0,40.0
40122,4,122,[403  79 200 186 194],95,3,489,3.975609756097561,0.0,0.0
40123,4,123,[186  79 100 318 191],334,4,493,3.975806451612903,20.0,20.0
40124,4,124,[ 79 100 318 191  98],454,4,497,3.976,20.0,40.0
40125,4,125,[ 79 100 318 191  98],387,4,501,3.9761904761904763,20.0,40.0
40126,4,126,[ 79 100 191 318  98],524,4,505,3.9763779527559056,20.0,40.0
40127,4,127,[ 79 100 191 318  98],537,3,508,3.96875,20.0,40.0
40128,4,128,[100 191 318  98 194],426,5,513,3.9767441860465116,20.0,40.0
40129,4,129,[100 191 318  98 194],313,5,518,3.9846153846153847,20.0,40.0
40130,4,130,[100 191 318  98 194],666,4,522,3.984732824427481,20.0,40.0
40131,4,131,[100 191 318  98 194],144,5,527,3.992424242424242,20.0,40.0
40132,4,132,[483  11   4 181 276],881,4,531,3.992481203007519,20.0,0.0
40133,4,133,[276 100 191 318  98],554,3,534,3.985074626865672,20.0,40.0
40134,4,134,[100 191 318  98 194],666,4,538,3.9851851851851854,20.0,40.0
40135,4,135,[333 318 265 385  88],653,4,542,3.985294117647059,20.0,0.0
40136,4,136,[265 100 191 318  98],13,3,545,3.978102189781022,20.0,40.0
40137,4,137,[265 100 191 318  98],892,5,550,3.9855072463768115,20.0,40.0
40138,4,138,[265 100 191 318  98],378,5,555,3.9928057553956835,20.0,40.0
40139,4,139,[265 100 191 318  98],554,4,559,3.992857142857143,20.0,40.0
40140,4,140,[265 100 191 318  98],666,4,563,3.99290780141844,20.0,40.0
40141,4,141,[100 191 318  98 265],455,4,567,3.992957746478873,20.0,40.0
40142,4,142,[100 191 318  98 265],666,4,571,3.993006993006993,20.0,40.0
40143,4,143,[100 191 318  98  79],59,5,576,4.0,20.0,40.0
40144,4,144,[100 191 318  98  79],455,4,580,4.0,20.0,40.0
40145,4,145,[100 191  98 318  79],7,5,585,4.006849315068493,20.0,40.0
40146,4,146,[100 191  79  98 318],488,3,588,4.0,20.0,40.0
40147,4,147,[100  79 191  98 318],488,3,591,3.9932432432432434,20.0,40.0
40148,4,148,[100  79 191  98 318],7,5,596,4.0,20.0,40.0
40149,4,149,[100  79 191  98 318],455,4,600,4.0,20.0,40.0
40150,4,150,[100  79 191  98 318],7,5,605,4.006622516556291,20.0,40.0
40151,4,151,[100  79 191  98 318],554,4,609,4.006578947368421,20.0,40.0
40152,4,152,[ 79 100 191  98 318],653,4,613,4.006535947712418,20.0,40.0
40153,4,153,[ 79 100 191  98 318],524,4,617,4.0064935064935066,20.0,40.0
40154,4,154,[ 50  69  56 216 118],313,4,621,4.006451612903226,0.0,20.0
40155,4,155,[ 50  79 100 191 318],454,5,626,4.012820512820513,20.0,40.0
40156,4,156,[ 50  79 100 191 318],664,4,630,4.012738853503185,20.0,40.0
40157,4,157,[ 50  79 100 191 318],406,4,634,4.012658227848101,20.0,40.0
40158,4,158,[ 50 100  79 191 318],184,4,638,4.012578616352202,20.0,40.0
40159,4,159,[ 50 100 191 318  98],311,4,642,4.0125,20.0,60.0
40160,4,160,[ 50 100 191 318  98],458,3,645,4.0062111801242235,20.0,60.0
40161,4,161,[100 191 318  98  50],311,4,649,4.006172839506172,20.0,60.0
40162,4,162,[265 132 216  56 118],295,4,653,4.006134969325154,0.0,0.0
40163,4,163,[132 100 191 318  50],653,4,657,4.0060975609756095,20.0,40.0
40164,4,164,[100 191  50 318  98],499,4,661,4.006060606060606,20.0,60.0
40165,4,165,[100 191 318  98  79],343,5,666,4.0120481927710845,20.0,40.0
40166,4,166,[100 191 318  98  79],59,5,671,4.017964071856287,20.0,40.0
40167,4,167,[100 191 318  98  79],804,5,676,4.023809523809524,20.0,40.0
40168,4,168,[100 191 318  98  79],271,5,681,4.029585798816568,20.0,40.0
40169,4,169,[100 191 318  79  98],454,4,685,4.029411764705882,20.0,40.0
40170,4,170,[100 191 318  79  98],90,5,690,4.035087719298246,20.0,40.0
40171,4,171,[100 191 318  79  98],554,4,694,4.034883720930233,20.0,40.0
40172,4,172,[100 191 318  79  98],7,5,699,4.040462427745664,20.0,40.0
40173,4,173,[100 191  79 318  98],378,5,704,4.045977011494253,20.0,40.0
40174,4,174,[ 56 238 173 289 187],194,4,708,4.045714285714285,0.0,0.0
40175,4,175,[187 100 191  79 318],666,4,712,4.045454545454546,20.0,20.0
40176,4,176,[187 100 191 318  98],385,3,715,4.03954802259887,20.0,40.0
40177,4,177,[187 100 191 318  98],488,2,717,4.02808988764045,20.0,40.0
40178,4,178,[100 318 191  98  79],311,4,721,4.027932960893855,20.0,40.0
40179,4,179,[100 318 191  98  79],194,4,725,4.027777777777778,20.0,40.0
40180,4,180,[100 318 191  98  79],194,4,729,4.027624309392265,20.0,40.0
40181,4,181,[100 318 191  98 194],59,4,733,4.027472527472527,20.0,40.0
40182,4,182,[100 318 191  98  79],234,4,737,4.027322404371585,20.0,40.0
40183,4,183,[135  50 161   4 197],738,5,742,4.032608695652174,0.0,20.0
40184,4,184,[161 197 100 318 191],694,5,747,4.037837837837838,20.0,20.0
40185,4,185,[161 197 100 318 191],452,5,752,4.043010752688172,20.0,20.0
40186,4,186,[161 197 100 318 191],85,4,756,4.042780748663102,20.0,20.0
40187,4,187,[161 197 100 318 191],194,5,761,4.047872340425532,20.0,20.0
40188,4,188,[161 197 100 318 191],13,3,764,4.042328042328043,20.0,20.0
40189,4,189,[161 197 100 318 191],194,5,769,4.0473684210526315,20.0,20.0
40190,4,190,[161 197 100 318 191],694,5,774,4.052356020942408,20.0,20.0
40191,4,191,[161 197 100 318 191],524,5,779,4.057291666666667,20.0,20.0
40192,4,192,[161 197 100 318 191],85,4,783,4.05699481865285,20.0,20.0
40193,4,193,[161 197 100 318 191],64,3,786,4.051546391752577,20.0,20.0
40194,4,194,[161 197 100 318 191],184,4,790,4.051282051282051,20.0,20.0
40195,4,195,[197 100 318 191  98],664,4,794,4.051020408163265,20.0,40.0
40196,4,196,[197 100 318 191  98],804,5,799,4.055837563451776,20.0,40.0
40197,4,197,[197 100 318 191  98],738,4,803,4.055555555555555,20.0,40.0
40198,4,198,[197 318 100 191  98],7,5,808,4.060301507537688,20.0,40.0
40199,4,199,[197 318 100 191  98],426,5,813,4.065,20.0,40.0
40200,4,200,[197 318 100 191  98],334,5,818,4.069651741293533,20.0,40.0
40201,4,201,[197 318 100 191  98],13,3,821,4.064356435643564,20.0,40.0
40202,4,202,[197 100 318 191  98],533,5,826,4.068965517241379,20.0,40.0
40203,4,203,[282 269 508 265 655],378,5,831,4.073529411764706,0.0,0.0
40204,4,204,[202 196 323  88 111],374,0,831,4.053658536585366,0.0,0.0
40205,4,205,[508 197 100 318 191],455,4,835,4.053398058252427,20.0,20.0
40206,4,206,[508 197 100 318 191],207,4,839,4.053140096618358,20.0,20.0
40207,4,207,[508 197 100 318 191],537,5,844,4.0576923076923075,20.0,20.0
40208,4,208,[508 197 100 318 191],82,4,848,4.057416267942584,20.0,20.0
40209,4,209,[197 100 318 191  98],13,3,851,4.052380952380952,20.0,40.0
40210,4,210,[197 100 318  98 191],387,3,854,4.04739336492891,20.0,40.0
40211,4,211,[197 100  98 191 318],334,5,859,4.05188679245283,20.0,40.0
40212,4,212,[197 100  98 191 318],537,4,863,4.051643192488263,20.0,40.0
40213,4,213,[197 100 191 318  98],207,4,867,4.0514018691588785,20.0,40.0
40214,4,214,[197 100 191 318  98],738,4,871,4.051162790697674,20.0,40.0
40215,4,215,[197 100 191 318  98],664,4,875,4.050925925925926,20.0,40.0
40216,4,216,[197 100 318  98 191],378,4,879,4.050691244239632,20.0,40.0
40217,4,217,[197 100 318  98 191],378,4,883,4.0504587155963305,20.0,40.0
40218,4,218,[100 318  98 191 197],804,5,888,4.054794520547945,20.0,40.0
40219,4,219,[100 318  98 191 197],387,3,891,4.05,20.0,40.0
40220,4,220,[100  98 191 318 197],481,3,894,4.04524886877828,20.0,40.0
40221,4,221,[100  98 191 318 197],653,3,897,4.04054054054054,20.0,40.0
40222,4,222,[100 191  98 318 161],64,4,901,4.040358744394619,20.0,40.0
40223,4,223,[100 191  98 318  50],378,5,906,4.044642857142857,20.0,60.0
40224,4,224,[100 191  98 318  50],653,4,910,4.044444444444444,20.0,60.0
40225,4,225,[100 191 318  98  50],64,5,915,4.048672566371682,20.0,60.0
40226,4,226,[100 191 318  98  50],378,5,920,4.052863436123348,20.0,60.0
40227,4,227,[100 191 318  98  50],533,5,925,4.057017543859649,20.0,60.0
40228,4,228,[100 191 318  98  50],234,5,930,4.06113537117904,20.0,60.0
40229,4,229,[100 191 318  50  98],666,4,934,4.060869565217391,20.0,60.0
40230,4,230,[234  25 568 357  79],313,4,938,4.0606060606060606,20.0,0.0
40231,4,231,[568 100 191 318  98],454,4,942,4.060344827586207,20.0,40.0
40232,4,232,[568 100 191 318  98],184,4,946,4.060085836909871,20.0,40.0
40233,4,233,[100 191 318  98  50],455,4,950,4.05982905982906,20.0,60.0
40234,4,234,[100 191 318  98  50],233,4,954,4.059574468085106,20.0,60.0
40235,4,235,[100 191 318  98 197],308,3,957,4.055084745762712,20.0,40.0
40236,4,236,[100 191 318  98 194],474,5,962,4.059071729957806,20.0,40.0
40237,4,237,[237 289 200  11 483],537,1,963,4.046218487394958,20.0,0.0
40238,4,238,[289 257 121 187 313],474,3,966,4.041841004184101,0.0,0.0
40239,4,239,[121 100 191 318  98],308,3,969,4.0375,20.0,40.0
40240,4,240,[100 191 318  98 194],232,5,974,4.04149377593361,20.0,40.0
40241,4,241,[100 191 318  98 194],41,4,978,4.041322314049586,20.0,40.0
40242,4,242,[100 191 318  98  79],271,5,983,4.045267489711934,20.0,40.0
40243,4,243,[100 191 318  98  79],455,4,987,4.045081967213115,20.0,40.0
40244,4,244,[100 191 318  98  79],454,4,991,4.044897959183674,20.0,40.0
40245,4,245,[100 191 318  98  79],666,4,995,4.044715447154472,20.0,40.0
40246,4,246,[100 191 318  98 187],64,5,1000,4.048582995951417,20.0,40.0
40247,4,247,[100 191 318  98 187],452,4,1004,4.048387096774194,20.0,40.0
40248,4,248,[100 191 318  98 508],455,4,1008,4.048192771084337,20.0,40.0
40249,4,249,[100 191 318  98 508],524,4,1012,4.048,20.0,40.0
40250,4,250,[100 191 318  98 508],474,4,1016,4.047808764940239,20.0,40.0
40251,4,251,[100 191 318  98 483],343,5,1021,4.051587301587301,40.0,40.0
40252,4,252,[100 191 318  98 483],666,5,1026,4.055335968379446,40.0,40.0
40253,4,253,[100 191 318  98 483],59,5,1031,4.059055118110236,40.0,40.0
40254,4,254,[100 191 318  98 483],454,3,1034,4.0549019607843135,40.0,40.0
40255,4,255,[100 191 318  98 265],474,5,1039,4.05859375,20.0,40.0
40256,4,256,[100 191 318  98 265],892,5,1044,4.062256809338521,20.0,40.0
40257,4,257,[100 191 318  98 265],194,5,1049,4.065891472868217,20.0,40.0
40258,4,258,[100 191 318  98 265],59,5,1054,4.06949806949807,20.0,40.0
40259,4,259,[100 191 318  98 265],387,4,1058,4.069230769230769,20.0,40.0
40260,4,260,[187  11 228 655 276],406,2,1060,4.061302681992337,0.0,0.0
40261,4,261,[100 191 318  98 265],474,5,1065,4.064885496183206,20.0,40.0
40262,4,262,[100 191 318 265  98],64,5,1070,4.068441064638783,20.0,40.0
40263,4,263,[100 191 265 318  98],308,3,1073,4.0643939393939394,20.0,40.0
40264,4,264,[100 191 318  98 265],13,3,1076,4.060377358490566,20.0,40.0
40265,4,265,[100 191 318  98 265],387,4,1080,4.06015037593985,20.0,40.0
40266,4,266,[100 191 318  98 265],455,4,1084,4.059925093632959,20.0,40.0
40267,4,267,[100 191 318  98 265],311,4,1088,4.059701492537314,20.0,40.0
40268,4,268,[237 172 568 132 194],892,5,1093,4.063197026022305,0.0,0.0
40269,4,269,[100 191 318  98 265],64,5,1098,4.066666666666666,20.0,40.0
40270,4,270,[185 135  69 168 211],897,3,1101,4.062730627306273,0.0,0.0
40271,4,271,[100 191 318 265  98],554,4,1105,4.0625,20.0,40.0
40272,4,272,[191 100 265 318  98],455,4,1109,4.062271062271062,20.0,40.0
40273,4,273,[191 100 265  98 318],488,3,1112,4.0583941605839415,20.0,40.0
40274,4,274,[100 191 265  98 318],387,4,1116,4.058181818181819,20.0,40.0
40275,4,275,[100 191 265  98 318],308,3,1119,4.054347826086956,20.0,40.0
40276,4,276,[100 191  98 318 265],452,4,1123,4.054151624548736,20.0,40.0
40277,4,277,[100 191  98 318 265],311,4,1127,4.053956834532374,20.0,40.0
40278,4,278,[161 471 294 568 289],533,4,1131,4.053763440860215,0.0,0.0
40279,4,279,[191 100  98 318 265],653,4,1135,4.053571428571429,20.0,40.0
40280,4,280,[191 100 318  98 265],194,5,1140,4.056939501779359,20.0,40.0
40281,4,281,[191 100 318  98 265],207,3,1143,4.053191489361702,20.0,40.0
40282,4,282,[191 100 318  98 265],378,5,1148,4.056537102473499,20.0,40.0
40283,4,283,[191 100 318  98 265],194,5,1153,4.059859154929577,20.0,40.0
40284,4,284,[191 100 318  98 265],666,4,1157,4.059649122807017,20.0,40.0
40285,4,285,[191 100 318  98 265],207,3,1160,4.055944055944056,20.0,40.0
40286,4,286,[191 100 318  98 194],308,4,1164,4.055749128919861,20.0,40.0
40287,4,287,[191 100 318  98 194],454,3,1167,4.052083333333333,20.0,40.0
40288,4,288,[191 100 318  98 568],13,2,1169,4.044982698961937,20.0,40.0
40289,4,289,[191 100 318  98  50],378,5,1174,4.048275862068966,20.0,60.0
40290,4,290,[191 100 318  98  50],387,4,1178,4.048109965635739,20.0,60.0
40291,4,291,[191 100 318  98  50],7,5,1183,4.051369863013699,20.0,60.0
40292,4,292,[191 100 318  98  50],334,5,1188,4.054607508532423,20.0,60.0
40293,4,293,[191 100 318  98  50],738,4,1192,4.054421768707483,20.0,60.0
40294,4,294,[191 100 318  98  50],234,5,1197,4.057627118644068,20.0,60.0
40295,4,295,[191 100 318  98  50],188,4,1201,4.0574324324324325,20.0,60.0
40296,4,296,[191 100 318  98  50],271,5,1206,4.0606060606060606,20.0,60.0
40297,4,297,[191 100 318  98  50],308,4,1210,4.060402684563758,20.0,60.0
40298,4,298,[211 228 546  79  71],650,2,1212,4.053511705685619,0.0,0.0
40299,4,299,[191 100 318  98  50],653,4,1216,4.053333333333334,20.0,60.0
40300,4,300,[ 96  89 216  25 200],59,5,1221,4.056478405315614,0.0,0.0
40301,4,301,[ 89 181 168   4  79],339,5,1226,4.059602649006623,0.0,0.0
40302,4,302,[ 89 191 100 318  50],474,5,1231,4.0627062706270625,20.0,40.0
40303,4,303,[405 302 483 211 182],537,4,1235,4.0625,20.0,0.0
40304,4,304,[ 89 182 191 100  50],454,3,1238,4.059016393442623,0.0,40.0
40305,4,305,[191 100  50 318  98],313,5,1243,4.062091503267974,20.0,60.0
40306,4,306,[191 100  50 318  98],313,5,1248,4.06514657980456,20.0,60.0
40307,4,307,[191 100  50 318  98],184,5,1253,4.068181818181818,20.0,60.0
40308,4,308,[191 100  50 318  98],537,4,1257,4.067961165048544,20.0,60.0
40309,4,309,[191 100  50 318  98],7,5,1262,4.070967741935484,20.0,60.0
40310,4,310,[322 210  96 235 179],92,3,1265,4.067524115755627,0.0,0.0
40311,4,311,[323 118 603 269 268],669,1,1266,4.0576923076923075,20.0,0.0
40312,4,312,[210 191 100  50 318],334,4,1270,4.057507987220447,20.0,40.0
40313,4,313,[191 100  50 318  98],378,5,1275,4.060509554140127,20.0,60.0
40314,4,314,[191 100  50 318  98],455,4,1279,4.06031746031746,20.0,60.0
40315,4,315,[191  50 100 318  98],554,4,1283,4.060126582278481,20.0,60.0
40316,4,316,[191  50 100 318  98],59,5,1288,4.063091482649842,20.0,60.0
40317,4,317,[191  50 100 318  98],59,5,1293,4.066037735849057,20.0,60.0
40318,4,318,[191  50 100 318  98],13,3,1296,4.06269592476489,20.0,60.0
40319,4,319,[ 50 191 100 318  98],454,4,1300,4.0625,20.0,60.0
40320,4,320,[ 50 191 100 318  98],458,3,1303,4.059190031152648,20.0,60.0
40321,4,321,[191 100  50 318  98],426,5,1308,4.062111801242236,20.0,60.0
40322,4,322,[191 100  50 318  98],524,4,1312,4.061919504643963,20.0,60.0
40323,4,323,[191 100  50 318  98],6,5,1317,4.064814814814815,20.0,60.0
40324,4,324,[191 100  50 318  98],804,5,1322,4.067692307692307,20.0,60.0
40325,4,325,[191  50 100 318  98],426,5,1327,4.070552147239264,20.0,60.0
40326,4,326,[191  50 100 318  98],455,4,1331,4.0703363914373085,20.0,60.0
40327,4,327,[191  50 100 318  98],313,5,1336,4.073170731707317,20.0,60.0
40328,4,328,[191  50 100 318  98],387,4,1340,4.072948328267477,20.0,60.0
40329,4,329,[191  50 100 318  98],311,4,1344,4.072727272727272,20.0,60.0
40330,4,330,[ 50 191 100 318  98],524,4,1348,4.072507552870091,20.0,60.0
40331,4,331,[546  28 508 237 302],378,4,1352,4.072289156626506,0.0,0.0
40332,4,332,[ 50 191 100 318  98],454,4,1356,4.072072072072072,20.0,60.0
40333,4,333,[ 50 191 100 318  98],664,4,1360,4.07185628742515,20.0,60.0
40334,4,334,[ 50 191 100 318  98],7,5,1365,4.074626865671642,20.0,60.0
40335,4,335,[ 50 191 100 318  98],378,5,1370,4.0773809523809526,20.0,60.0
40336,4,336,[ 50 191 100 318  98],6,5,1375,4.080118694362018,20.0,60.0
40337,4,337,[176 323 215 202 588],59,4,1379,4.079881656804734,0.0,0.0
40338,4,338,[176  50 191 100 318],311,4,1383,4.079646017699115,20.0,40.0
40339,4,339,[183 211   7 742  56],59,4,1387,4.079411764705882,0.0,0.0
40340,4,340,[176  50 191 100 318],334,4,1391,4.0791788856304985,20.0,40.0
40341,4,341,[ 50 191 100 318  98],409,5,1396,4.081871345029239,20.0,60.0
40342,4,342,[ 50 191 100 318  98],343,5,1401,4.084548104956268,20.0,60.0
40343,4,343,[ 50 191 100 318  98],524,4,1405,4.084302325581396,20.0,60.0
40344,4,344,[ 50 191 100 318  98],524,4,1409,4.084057971014492,20.0,60.0
40345,4,345,[ 50 191 100 318  98],13,3,1412,4.08092485549133,20.0,60.0
40346,4,346,[ 50 191 100 318  98],378,5,1417,4.083573487031701,20.0,60.0
40347,4,347,[ 50 191 100 318  98],378,5,1422,4.086206896551724,20.0,60.0
40348,4,348,[196 588  64 173 546],234,1,1423,4.077363896848137,0.0,0.0
40349,4,349,[ 64  50 191 100 318],232,5,1428,4.08,20.0,40.0
40350,4,350,[ 64  50 191 100 318],488,3,1431,4.076923076923077,20.0,40.0
40351,4,351,[  9 678 161  11 202],13,2,1433,4.0710227272727275,0.0,0.0
40352,4,352,[ 64  50 191 100 318],308,5,1438,4.073654390934844,20.0,40.0
40353,4,353,[ 64  50 191 100 318],233,4,1442,4.073446327683616,20.0,40.0
40354,4,354,[ 64  50 191 100 318],343,5,1447,4.076056338028169,20.0,40.0
40355,4,355,[ 64  50 191 100 318],465,4,1451,4.075842696629214,20.0,40.0
40356,4,356,[ 64  50 191 100 318],6,5,1456,4.078431372549019,20.0,40.0
40357,4,357,[ 64  50 191 100 318],537,4,1460,4.078212290502793,20.0,40.0
40358,4,358,[ 50 191 100  64 318],458,4,1464,4.077994428969359,20.0,40.0
40359,4,359,[ 50 191  64 100 318],378,5,1469,4.080555555555556,20.0,40.0
40360,4,360,[ 50  64 191 100 318],387,3,1472,4.077562326869806,20.0,40.0
40361,4,361,[ 50 191 100 318  98],481,4,1476,4.077348066298343,20.0,60.0
40362,4,362,[ 50 191 100 318  98],271,5,1481,4.079889807162535,20.0,60.0
40363,4,363,[ 50 191 100 318  98],694,5,1486,4.082417582417582,20.0,60.0
40364,4,364,[ 50 191 100 318  98],694,5,1491,4.0849315068493155,20.0,60.0
40365,4,365,[ 50 191 100 318  98],426,5,1496,4.087431693989071,20.0,60.0
40366,4,366,[ 50 191 100 318  98],378,5,1501,4.08991825613079,20.0,60.0
40367,4,367,[ 50 191 100 318  98],533,5,1506,4.092391304347826,20.0,60.0
40368,4,368,[ 50 191 100 318  98],406,5,1511,4.094850948509485,20.0,60.0
40369,4,369,[ 50 191 100 318  98],426,5,1516,4.097297297297297,20.0,60.0
40370,4,370,[ 50 191 100 318  98],664,4,1520,4.097035040431267,20.0,60.0
40371,4,371,[ 50 191 100 318  98],524,4,1524,4.096774193548387,20.0,60.0
40372,4,372,[ 50 191 100 318  98],85,4,1528,4.096514745308311,20.0,60.0
40373,4,373,[ 50 191 100 318  98],271,5,1533,4.098930481283422,20.0,60.0
40374,4,374,[ 50 191 100 318  98],533,5,1538,4.101333333333334,20.0,60.0
40375,4,375,[ 50 191 100 318  98],271,5,1543,4.1037234042553195,20.0,60.0
40376,4,376,[ 69 204 181 175 185],659,3,1546,4.10079575596817,0.0,0.0
40377,4,377,[175  50 191 100 318],234,4,1550,4.1005291005291005,20.0,40.0
40378,4,378,[ 50 191 100 318  98],308,4,1554,4.100263852242744,20.0,60.0
40379,4,379,[ 50 191 100 318  98],232,5,1559,4.102631578947369,20.0,60.0
40380,4,380,[ 50 191 100 318  98],452,5,1564,4.10498687664042,20.0,60.0
40381,4,381,[ 50 191 100 318  98],144,5,1569,4.107329842931938,20.0,60.0
40382,4,382,[ 50 191 100 318  98],271,5,1574,4.1096605744125325,20.0,60.0
40383,4,383,[ 50 191 100 318  98],653,4,1578,4.109375,20.0,60.0
40384,4,384,[ 50 191 100 318  98],409,5,1583,4.111688311688312,20.0,60.0
40385,4,385,[ 50 191 100 318  98],452,5,1588,4.1139896373057,20.0,60.0
40386,4,386,[ 50 191 100 318  98],524,4,1592,4.113695090439276,20.0,60.0
40387,4,387,[ 50 191 100 318  98],7,5,1597,4.115979381443299,20.0,60.0
40388,4,388,[202 125 173 322 265],92,2,1599,4.110539845758355,0.0,0.0
40389,4,389,[215 234  69 186  82],92,4,1603,4.11025641025641,0.0,0.0
40390,4,390,[125  50 191 100 318],804,5,1608,4.112531969309463,20.0,40.0
40391,4,391,[125  50 191 100 318],533,5,1613,4.114795918367347,20.0,40.0
40392,4,392,[125  50 191 100 318],406,4,1617,4.114503816793893,20.0,40.0
40393,4,393,[ 50 191 100 318  98],188,4,1621,4.114213197969543,20.0,60.0
40394,4,394,[ 50 191 100 318  98],144,5,1626,4.116455696202531,20.0,60.0
40395,4,395,[ 50 191 100 318  98],308,4,1630,4.116161616161616,20.0,60.0
40396,4,396,[ 50 191 100 318  98],554,4,1634,4.1158690176322414,20.0,60.0
40397,4,397,[ 50 191 100 318  98],481,4,1638,4.115577889447236,20.0,60.0
40398,4,398,[ 69 276 174 125 121],82,4,1642,4.1152882205513786,0.0,20.0
40399,4,399,[ 50 191 100 318  98],538,5,1647,4.1175,20.0,60.0
40400,4,400,[ 50 191 100 318  98],694,5,1652,4.1197007481296755,20.0,60.0
40401,4,401,[ 50 191 100 318  98],184,5,1657,4.121890547263682,20.0,60.0
40402,4,402,[ 50 191 100 318  98],406,5,1662,4.124069478908188,20.0,60.0
40403,4,403,[ 50 191 100 318  98],313,5,1667,4.126237623762377,20.0,60.0
40404,4,404,[ 50 191 100 318  98],13,3,1670,4.1234567901234565,20.0,60.0
40405,4,405,[ 50 191 100 318  98],694,5,1675,4.125615763546798,20.0,60.0
40406,4,406,[ 50 191 100 318  98],41,5,1680,4.127764127764128,20.0,60.0
40407,4,407,[ 50 191 100 318  98],738,4,1684,4.127450980392157,20.0,60.0
40408,4,408,[ 50 191 100 318  98],271,5,1689,4.12958435207824,20.0,60.0
40409,4,409,[ 50 191 100 318  98],488,3,1692,4.126829268292683,20.0,60.0
40410,4,410,[ 50 191 100 318  98],378,5,1697,4.128953771289538,20.0,60.0
40411,4,411,[ 50 191 100 318  98],234,5,1702,4.131067961165049,20.0,60.0
40412,4,412,[ 50 191 100 318  98],533,5,1707,4.13317191283293,20.0,60.0
40413,4,413,[ 50 191 100 318  98],194,4,1711,4.132850241545894,20.0,60.0
40414,4,414,[ 50 191 100 318  98],666,4,1715,4.132530120481928,20.0,60.0
40415,4,415,[ 50 191 100 318  98],313,5,1720,4.134615384615385,20.0,60.0
40416,4,416,[273 742  11 200 508],59,3,1723,4.13189448441247,0.0,0.0
40417,4,417,[ 50 191 100 318  98],378,5,1728,4.133971291866029,20.0,60.0
40418,4,418,[ 50 191 100 318  98],232,5,1733,4.136038186157518,20.0,60.0
40419,4,419,[ 50 191 100 318  98],455,4,1737,4.135714285714286,20.0,60.0
40420,4,420,[ 50 191 100 318  98],343,5,1742,4.137767220902613,20.0,60.0
40421,4,421,[ 50 191 100 318  98],85,4,1746,4.137440758293839,20.0,60.0
40422,4,422,[ 50 191 100 318  98],499,4,1750,4.137115839243499,20.0,60.0
40423,4,423,[ 50 191 100 318  98],454,4,1754,4.136792452830188,20.0,60.0
40424,4,424,[ 50 191 100 318  98],334,5,1759,4.138823529411765,20.0,60.0
40425,4,425,[ 50 191 100 318  98],664,4,1763,4.13849765258216,20.0,60.0
40426,4,426,[ 50 191 100 318  98],455,4,1767,4.138173302107728,20.0,60.0
40427,4,427,[ 50 191 100 318  98],295,5,1772,4.140186915887851,20.0,60.0
40428,4,428,[ 50 191 100 318  98],406,5,1777,4.142191142191142,20.0,60.0
40429,4,429,[ 50 191 100 318  98],7,5,1782,4.144186046511628,20.0,60.0
40430,4,430,[ 50 191 100 318  98],313,5,1787,4.146171693735499,20.0,60.0
40431,4,431,[ 50 191 100 318  98],804,5,1792,4.148148148148148,20.0,60.0
40432,4,432,[ 50 191 100 318  98],232,5,1797,4.150115473441109,20.0,60.0
40433,4,433,[ 50 191 100 318  98],694,5,1802,4.152073732718894,20.0,60.0
40434,4,434,[ 50 191 100 318  98],85,4,1806,4.151724137931034,20.0,60.0
40435,4,435,[ 50 191 100 318  98],892,5,1811,4.1536697247706424,20.0,60.0
40436,4,436,[ 50 191 100 318  98],313,5,1816,4.155606407322654,20.0,60.0
40437,4,437,[ 50 191 100 318  98],554,4,1820,4.155251141552512,20.0,60.0
40438,4,438,[ 50 191 100 318  98],271,5,1825,4.157175398633258,20.0,60.0
40439,4,439,[ 50 191 100 318  98],454,4,1829,4.156818181818182,20.0,60.0
40440,4,440,[ 50 191 100 318  98],308,4,1833,4.156462585034014,20.0,60.0
40441,4,441,[ 50 191 100 318  98],537,4,1837,4.156108597285068,20.0,60.0
40442,4,442,[ 50 191 100 318  98],161,2,1839,4.1512415349887135,20.0,60.0
40443,4,443,[ 50 191 100 318  98],308,4,1843,4.150900900900901,20.0,60.0
40444,4,444,[ 50 191 100 318  98],313,5,1848,4.152808988764045,20.0,60.0
40445,4,445,[ 50 191 100 318  98],892,5,1853,4.154708520179372,20.0,60.0
40446,4,446,[ 50 191 100 318  98],184,5,1858,4.156599552572707,20.0,60.0
40447,4,447,[ 50 191 100 318  98],426,5,1863,4.158482142857143,20.0,60.0
40448,4,448,[ 50 191 100 318  98],653,4,1867,4.158129175946548,20.0,60.0
40449,4,449,[ 50 191 100 318  98],59,5,1872,4.16,20.0,60.0
40450,4,450,[ 50 191 100 318  98],313,5,1877,4.1618625277161865,20.0,60.0
40451,4,451,[ 50 191 100 318  98],343,5,1882,4.163716814159292,20.0,60.0
40452,4,452,[ 50 191 100 318  98],188,4,1886,4.163355408388521,20.0,60.0
40453,4,453,[ 50 191 100 318  98],7,5,1891,4.165198237885463,20.0,60.0
40454,4,454,[222 273 568 300 174],102,1,1892,4.158241758241759,0.0,20.0
40455,4,455,[ 50 191 100 318  98],64,5,1897,4.160087719298246,20.0,60.0
40456,4,456,[ 50 191 100 318  98],538,5,1902,4.161925601750547,20.0,60.0
40457,4,457,[ 50 191 100 318  98],144,5,1907,4.163755458515284,20.0,60.0
40458,4,458,[ 50 191 100 318  98],194,4,1911,4.163398692810458,20.0,60.0
40459,4,459,[ 50 191 100 318  98],161,2,1913,4.158695652173913,20.0,60.0
40460,4,460,[ 50 191 100 318  98],194,4,1917,4.158351409978308,20.0,60.0
40461,4,461,[ 50 191 100 318  98],409,5,1922,4.16017316017316,20.0,60.0
40462,4,462,[ 50 191 100 318  98],6,5,1927,4.161987041036717,20.0,60.0
40463,4,463,[ 50 191 100 318  98],664,4,1931,4.161637931034483,20.0,60.0
40464,4,464,[ 50 191 100 318  98],488,3,1934,4.159139784946237,20.0,60.0
40465,4,465,[ 50 191 100 318  98],85,4,1938,4.1587982832618025,20.0,60.0
40466,4,466,[ 50 191 100 318  98],454,4,1942,4.158458244111349,20.0,60.0
40467,4,467,[ 50 191 100 318  98],664,4,1946,4.1581196581196584,20.0,60.0
40468,4,468,[ 50 191 100 318  98],892,5,1951,4.159914712153518,20.0,60.0
40469,4,469,[ 50 191 100 318  98],59,5,1956,4.1617021276595745,20.0,60.0
40470,4,470,[ 50 191 100 318  98],554,4,1960,4.16135881104034,20.0,60.0
40471,4,471,[ 50 191 100 318  98],454,4,1964,4.161016949152542,20.0,60.0
40472,4,472,[ 50 191 100 318  98],892,5,1969,4.162790697674419,20.0,60.0
40473,4,473,[ 50 191 100 318  98],232,5,1974,4.1645569620253164,20.0,60.0
40474,4,474,[ 50 191 100 318  98],426,5,1979,4.166315789473685,20.0,60.0
40475,4,475,[ 50 191 100 318  98],666,4,1983,4.165966386554622,20.0,60.0
40476,4,476,[ 50 191 100 318  98],465,4,1987,4.165618448637317,20.0,60.0
40477,4,477,[ 50 191 100 318  98],524,4,1991,4.165271966527197,20.0,60.0
40478,4,478,[ 50 191 100 318  98],295,5,1996,4.167014613778706,20.0,60.0
40479,4,479,[ 79  96   1 100 385],479,3,1999,4.164583333333334,0.0,20.0
40480,4,480,[  1  50 191 100 318],41,5,2004,4.166320166320166,20.0,40.0
40481,4,481,[  1  50 191 100 318],308,5,2009,4.168049792531121,20.0,40.0
40482,4,482,[268 135 151 211 496],234,2,2011,4.163561076604555,0.0,0.0
40483,4,483,[496   1  50 191 100],804,5,2016,4.1652892561983474,0.0,40.0
40484,4,484,[496   1  50 191 100],271,4,2020,4.164948453608248,0.0,40.0
40485,4,485,[496  50 191 100 318],311,4,2024,4.1646090534979425,20.0,40.0
40486,4,486,[496  50 191 100 318],524,4,2028,4.164271047227926,20.0,40.0
40487,4,487,[ 50 191 100 318  98],85,4,2032,4.163934426229508,20.0,60.0
40488,4,488,[ 50 191 100 318  98],161,2,2034,4.159509202453988,20.0,60.0
40489,4,489,[ 50 191 100 318  98],452,5,2039,4.161224489795918,20.0,60.0
40490,4,490,[ 50 191 100 318  98],455,4,2043,4.160896130346232,20.0,60.0
40491,4,491,[ 50 191 100 318  98],308,4,2047,4.1605691056910565,20.0,60.0
40492,4,492,[ 50 191 100 318  98],666,4,2051,4.1602434077079105,20.0,60.0
40493,4,493,[ 50 191 100 318  98],892,5,2056,4.161943319838056,20.0,60.0
40494,4,494,[ 50 191 100 318  98],892,5,2061,4.163636363636364,20.0,60.0
40495,4,495,[ 50 191 100 318  98],85,4,2065,4.163306451612903,20.0,60.0
40496,4,496,[ 50 191 100 318  98],313,5,2070,4.164989939637827,20.0,60.0
40497,4,497,[ 50 191 100 318  98],533,5,2075,4.166666666666667,20.0,60.0
40498,4,498,[ 50 191 100 318  98],144,5,2080,4.168336673346693,20.0,60.0
40499,4,499,[ 50 191 100 318  98],387,4,2084,4.168,20.0,60.0
40500,4,500,[273 678 258 323 289],13,1,2085,4.161676646706587,0.0,0.0
40501,4,501,[  9 257 302  50 269],26,4,2089,4.161354581673307,0.0,20.0
40502,4,502,[258  50 191 100 318],343,5,2094,4.163021868787276,20.0,40.0
40503,4,503,[258  50 191 100 318],6,4,2098,4.162698412698413,20.0,40.0
40504,4,504,[ 50 191 100 318  98],64,5,2103,4.1643564356435645,20.0,60.0
40505,4,505,[ 50 191 100 318  98],161,2,2105,4.160079051383399,20.0,60.0
40506,4,506,[ 50 191 100 318  98],6,5,2110,4.161735700197239,20.0,60.0
40507,4,507,[127 187 568 191 234],379,5,2115,4.163385826771654,0.0,20.0
40508,4,508,[127  50 191 100 318],804,4,2119,4.163064833005894,20.0,60.0
40509,4,509,[ 50 191 100 318  98],313,5,2124,4.1647058823529415,20.0,60.0
40510,4,510,[ 50 191 100 318  98],188,4,2128,4.164383561643835,20.0,60.0
40511,4,511,[ 50 191 100 318  98],653,4,2132,4.1640625,20.0,60.0
40512,4,512,[ 50 191 100 318  98],666,4,2136,4.16374269005848,20.0,60.0
40513,4,513,[ 50 191 100 318  98],295,5,2141,4.165369649805448,20.0,60.0
40514,4,514,[ 50 191 100 318  98],194,4,2145,4.165048543689321,20.0,60.0
40515,4,515,[ 50 191 100 318  98],694,5,2150,4.166666666666667,20.0,60.0
40516,4,516,[ 50 191 100 318  98],64,5,2155,4.1682785299806575,20.0,60.0
40517,4,517,[ 50 191 100 318  98],188,4,2159,4.167953667953668,20.0,60.0
40518,4,518,[ 50 191 100 318  98],85,4,2163,4.167630057803469,20.0,60.0
40519,4,519,[ 50 191 100 318  98],481,4,2167,4.167307692307692,20.0,60.0
40520,4,520,[ 50 191 100 318  98],13,3,2170,4.165067178502879,20.0,60.0
40521,4,521,[ 50 191 100 318  98],311,4,2174,4.164750957854406,20.0,60.0
40522,4,522,[ 50 191 100 318  98],7,5,2179,4.166347992351817,20.0,60.0
40523,4,523,[ 50 191 100 318  98],271,5,2184,4.1679389312977095,20.0,60.0
40524,4,524,[ 50 191 100 318  98],313,5,2189,4.16952380952381,20.0,60.0
40525,4,525,[ 50 191 100 318  98],454,4,2193,4.169201520912548,20.0,60.0
40526,4,526,[ 50 191 100 318  98],64,5,2198,4.170777988614801,20.0,60.0
40527,4,527,[ 50 191 100 318  98],488,3,2201,4.168560606060606,20.0,60.0
40528,4,528,[ 50 191 100 318  98],538,5,2206,4.170132325141777,20.0,60.0
40529,4,529,[ 50 191 100 318  98],554,4,2210,4.169811320754717,20.0,60.0
40530,4,530,[ 50 191 100 318  98],537,4,2214,4.169491525423729,20.0,60.0
40531,4,531,[ 50 191 100 318  98],41,5,2219,4.171052631578948,20.0,60.0
40532,4,532,[ 50 191 100 318  98],455,4,2223,4.170731707317073,20.0,60.0
40533,4,533,[ 50 191 100 318  98],499,4,2227,4.170411985018727,20.0,60.0
40534,4,534,[ 50 191 100 318  98],7,5,2232,4.17196261682243,20.0,60.0
40535,4,535,[ 50 191 100 318  98],194,4,2236,4.1716417910447765,20.0,60.0
40536,4,536,[ 50 191 100 318  98],378,5,2241,4.173184357541899,20.0,60.0
40537,4,537,[ 50 191 100 318  98],313,5,2246,4.174721189591078,20.0,60.0
40538,4,538,[ 50 191 100 318  98],7,5,2251,4.176252319109462,20.0,60.0
40539,4,539,[ 50 191 100 318  98],6,5,2256,4.177777777777778,20.0,60.0
40540,4,540,[323 180 655 222 175],804,5,2261,4.179297597042514,0.0,0.0
40541,4,541,[180  50 191 100 318],189,5,2266,4.180811808118081,20.0,40.0
40542,4,542,[135 172  15 282 111],474,5,2271,4.18232044198895,0.0,0.0
40543,4,543,[385  11 211  50  98],883,2,2273,4.178308823529412,0.0,40.0
40544,4,544,[180  15  50 191 100],653,4,2277,4.177981651376147,0.0,40.0
40545,4,545,[180  50 191 100 318],666,4,2281,4.177655677655678,20.0,40.0
40546,4,546,[180  50 191 100 318],409,5,2286,4.1791590493601465,20.0,40.0
40547,4,547,[180  50 191 100 318],537,5,2291,4.180656934306569,20.0,40.0
40548,4,548,[180  50 191 100 318],524,5,2296,4.182149362477231,20.0,40.0
40549,4,549,[180  50 191 100 318],7,5,2301,4.183636363636364,20.0,40.0
40550,4,550,[180  50 191 100 318],85,4,2305,4.183303085299456,20.0,40.0
40551,4,551,[180  50 191 100 318],7,5,2310,4.184782608695652,20.0,40.0
40552,4,552,[180  50 191 100 318],13,3,2313,4.182640144665461,20.0,40.0
40553,4,553,[180  50 191 100 318],308,5,2318,4.184115523465704,20.0,40.0
40554,4,554,[180  50 191 100 318],387,4,2322,4.183783783783784,20.0,40.0
40555,4,555,[180  50 191 100 318],378,4,2326,4.183453237410072,20.0,40.0
40556,4,556,[180  50 191 100 318],387,4,2330,4.1831238779174145,20.0,40.0
40557,4,557,[180  50 191 100 318],308,5,2335,4.184587813620071,20.0,40.0
40558,4,558,[180  50 191 100 318],666,4,2339,4.184257602862254,20.0,40.0
40559,4,559,[180  50 191 100 318],452,5,2344,4.185714285714286,20.0,40.0
40560,4,560,[180  50 191 100 318],144,5,2349,4.18716577540107,20.0,40.0
40561,4,561,[180  50 191 100 318],308,5,2354,4.1886120996441285,20.0,40.0
40562,4,562,[180  50 191 100 318],409,5,2359,4.190053285968029,20.0,40.0
40563,4,563,[180  50 191 100 318],537,5,2364,4.191489361702128,20.0,40.0
40564,4,564,[180  50 191 100 318],452,5,2369,4.192920353982301,20.0,40.0
40565,4,565,[180  50 191 100 318],738,4,2373,4.192579505300353,20.0,40.0
40566,4,566,[180  50 191 100 318],533,4,2377,4.192239858906525,20.0,40.0
40567,4,567,[180  50 191 100 318],694,5,2382,4.193661971830986,20.0,40.0
40568,4,568,[180  50 191 100 318],488,2,2384,4.189806678383128,20.0,40.0
40569,4,569,[ 50 191 100 180 318],92,4,2388,4.189473684210526,20.0,40.0
40570,4,570,[ 50 191 100 180 318],527,4,2392,4.189141856392294,20.0,40.0
40571,4,571,[ 50 191 180 100 318],144,5,2397,4.190559440559441,20.0,40.0
40572,4,572,[ 50 191 180 100 318],194,3,2400,4.18848167539267,20.0,40.0
40573,4,573,[ 50 191 100 318 180],406,5,2405,4.189895470383275,20.0,40.0
40574,4,574,[ 50 191 100 318 180],694,5,2410,4.191304347826087,20.0,40.0
40575,4,575,[ 50 191 100 318 180],653,5,2415,4.192708333333333,20.0,40.0
40576,4,576,[ 50 191 100 318 180],41,5,2420,4.194107452339688,20.0,40.0
40577,4,577,[ 50 191 100 180 318],804,5,2425,4.195501730103806,20.0,40.0
40578,4,578,[ 50 191 100 180 318],524,5,2430,4.196891191709844,20.0,40.0
40579,4,579,[ 70 323 678 300 204],454,3,2433,4.194827586206896,0.0,0.0
40580,4,580,[ 70  50 191 100 180],194,2,2435,4.19104991394148,0.0,40.0
40581,4,581,[ 50 191 100 318 180],474,5,2440,4.1924398625429555,20.0,40.0
40582,4,582,[ 50 191 100 318 180],313,5,2445,4.193825042881647,20.0,40.0
40583,4,583,[ 50 191 100 318 180],378,4,2449,4.193493150684931,20.0,40.0
40584,4,584,[ 50 191 100 318  98],343,5,2454,4.194871794871795,20.0,60.0
40585,4,585,[ 50 191 100 318  98],232,5,2459,4.196245733788396,20.0,60.0
40586,4,586,[ 50 191 100 318  98],488,3,2462,4.194207836456559,20.0,60.0
40587,4,587,[100 269 483 546 175],13,3,2465,4.192176870748299,20.0,20.0
40588,4,588,[ 50 191 100 318  98],378,5,2470,4.193548387096774,20.0,60.0
40589,4,589,[ 50 191 100 318  98],59,5,2475,4.194915254237288,20.0,60.0
40590,4,590,[181 211 427 496 588],308,4,2479,4.194585448392555,0.0,0.0
40591,4,591,[ 50 191 100 318  98],85,4,2483,4.194256756756757,20.0,60.0
40592,4,592,[ 50 191 100 318  98],59,5,2488,4.195615514333896,20.0,60.0
40593,4,593,[ 50 191 100 318  98],343,5,2493,4.196969696969697,20.0,60.0
40594,4,594,[ 50 191 100 318  98],234,5,2498,4.198319327731093,20.0,60.0
40595,4,595,[ 50 191 100 318  98],465,4,2502,4.197986577181208,20.0,60.0
40596,4,596,[ 50 191 100 318  98],455,4,2506,4.197654941373535,20.0,60.0
40597,4,597,[ 50 191 100 318  98],85,4,2510,4.197324414715719,20.0,60.0
40598,4,598,[ 50 191 100 318  98],406,5,2515,4.198664440734557,20.0,60.0
40599,4,599,[ 50 191 100 318  98],334,5,2520,4.2,20.0,60.0
40600,4,600,[ 50 191 100 318  98],666,4,2524,4.199667221297837,20.0,60.0
40601,4,601,[ 50 191 100 318  98],481,4,2528,4.1993355481727574,20.0,60.0
40602,4,602,[181 153  64  70  28],398,5,2533,4.200663349917082,0.0,0.0
40603,4,603,[153  50 191 100 318],64,4,2537,4.200331125827814,20.0,40.0
40604,4,604,[ 50 191 100 318  98],233,4,2541,4.2,20.0,60.0
40605,4,605,[ 50 191 100 318  98],426,5,2546,4.201320132013201,20.0,60.0
40606,4,606,[ 50 191 100 318  98],234,5,2551,4.2026359143327845,20.0,60.0
40607,4,607,[ 50 191 100 318  98],343,5,2556,4.203947368421052,20.0,60.0
40608,4,608,[ 56 181 265 286 144],328,5,2561,4.205254515599343,0.0,0.0
40609,4,609,[144  50 191 100 318],458,4,2565,4.204918032786885,20.0,40.0
40610,4,610,[144 191  50 100 318],538,5,2570,4.2062193126022915,20.0,40.0
40611,4,611,[144 191  50 100 318],488,2,2572,4.2026143790849675,20.0,40.0
40612,4,612,[ 50 191 100 318  98],194,4,2576,4.202283849918434,20.0,60.0
40613,4,613,[191  50 100 318  98],804,5,2581,4.203583061889251,20.0,60.0
40614,4,614,[191  50 100 318  98],455,4,2585,4.203252032520325,20.0,60.0
40615,4,615,[191  50 100 318  98],524,4,2589,4.202922077922078,20.0,60.0
40616,4,616,[191  50 100 318  98],184,5,2594,4.2042139384116695,20.0,60.0
40617,4,617,[191  50 100 318  98],387,4,2598,4.203883495145631,20.0,60.0
40618,4,618,[191  50 100 318  98],488,3,2601,4.201938610662359,20.0,60.0
40619,4,619,[191  50 100 318  98],426,5,2606,4.203225806451613,20.0,60.0
40620,4,620,[191  50 100 318  98],804,5,2611,4.20450885668277,20.0,60.0
40621,4,621,[191  50 100 318  98],481,4,2615,4.204180064308682,20.0,60.0
40622,4,622,[191  50 100 318  98],232,5,2620,4.20545746388443,20.0,60.0
40623,4,623,[ 50 191 100 318  98],59,5,2625,4.206730769230769,20.0,60.0
40624,4,624,[ 50 191 100 318  98],233,4,2629,4.2064,20.0,60.0
40625,4,625,[191  50 100 318  98],538,5,2634,4.207667731629393,20.0,60.0
40626,4,626,[191  50 100 318  98],738,4,2638,4.2073365231259965,20.0,60.0
40627,4,627,[191  50 100 318  98],537,4,2642,4.207006369426751,20.0,60.0
40628,4,628,[191  50 100 318  98],499,4,2646,4.206677265500795,20.0,60.0
40629,4,629,[179 273   1 588  56],378,4,2650,4.2063492063492065,0.0,0.0
40630,4,630,[191  50 100 318  98],378,5,2655,4.207606973058637,20.0,60.0
40631,4,631,[191  50 100 318  98],311,4,2659,4.207278481012659,20.0,60.0
40632,4,632,[191  50 100 318  98],533,5,2664,4.208530805687204,20.0,60.0
40633,4,633,[191  50 100 318  98],161,2,2666,4.205047318611987,20.0,60.0
40634,4,634,[191  50 100 318  98],537,4,2670,4.2047244094488185,20.0,60.0
40635,4,635,[191  50 100 318  98],311,4,2674,4.20440251572327,20.0,60.0
40636,4,636,[191  50 100 318  98],694,5,2679,4.205651491365777,20.0,60.0
40637,4,637,[191  50 100 318  98],7,5,2684,4.206896551724138,20.0,60.0
40638,4,638,[191  50 100 318  98],426,5,2689,4.208137715179968,20.0,60.0
40639,4,639,[237 238 143 183 100],92,4,2693,4.2078125,0.0,20.0
40640,4,640,[191  50 100 318  98],194,4,2697,4.207488299531981,20.0,60.0
40641,4,641,[191  50 100 318  98],184,5,2702,4.2087227414330215,20.0,60.0
40642,4,642,[191  50 100 318  98],554,4,2706,4.208398133748056,20.0,60.0
40643,4,643,[191  50 100 318  98],295,5,2711,4.209627329192546,20.0,60.0
40644,4,644,[191  50 100 318  98],232,5,2716,4.210852713178294,20.0,60.0
40645,4,645,[191  50 100 318  98],343,5,2721,4.212074303405573,20.0,60.0
40646,4,646,[191  50 100 318  98],6,5,2726,4.213292117465224,20.0,60.0
40647,4,647,[191  50 100 318  98],334,5,2731,4.214506172839506,20.0,60.0
40648,4,648,[191  50 100 318  98],524,4,2735,4.214175654853621,20.0,60.0
40649,4,649,[211  89 121 182 322],328,3,2738,4.212307692307692,0.0,0.0
40650,4,650,[191  50 100 318  98],452,5,2743,4.213517665130568,20.0,60.0
40651,4,651,[191  50 100 318  98],481,4,2747,4.21319018404908,20.0,60.0
40652,4,652,[191  50 100 318  98],538,5,2752,4.214395099540582,20.0,60.0
40653,4,653,[191  50 100 318  98],41,5,2757,4.215596330275229,20.0,60.0
40654,4,654,[191  50 100 318  98],409,5,2762,4.216793893129771,20.0,60.0
40655,4,655,[191  50 100 318  98],334,5,2767,4.217987804878049,20.0,60.0
40656,4,656,[191  50 100 318  98],538,5,2772,4.219178082191781,20.0,60.0
40657,4,657,[191  50 100 318  98],308,4,2776,4.218844984802431,20.0,60.0
40658,4,658,[191  50 100 318  98],194,4,2780,4.218512898330804,20.0,60.0
40659,4,659,[191  50 100 318  98],295,5,2785,4.21969696969697,20.0,60.0
40660,4,660,[173 172 234 186  89],346,2,2787,4.216338880484115,0.0,0.0
40661,4,661,[191  50 100 318  98],455,4,2791,4.216012084592145,20.0,60.0
40662,4,662,[191  50 100 318  98],538,5,2796,4.217194570135747,20.0,60.0
40663,4,663,[191  50 100 318  98],524,4,2800,4.216867469879518,20.0,60.0
40664,4,664,[191  50 100 318  98],455,4,2804,4.216541353383459,20.0,60.0
40665,4,665,[191  50 100 318  98],524,4,2808,4.216216216216216,20.0,60.0
40666,4,666,[191  50 100 318  98],458,3,2811,4.214392803598201,20.0,60.0
40667,4,667,[191  50 100 318  98],474,5,2816,4.2155688622754495,20.0,60.0
40668,4,668,[191  50 100 318  98],334,5,2821,4.216741405082212,20.0,60.0
40669,4,669,[191  50 100 318  98],7,5,2826,4.217910447761194,20.0,60.0
40670,4,670,[191  50 100 318  98],271,5,2831,4.219076005961252,20.0,60.0
40671,4,671,[191  50 100 318  98],454,4,2835,4.21875,20.0,60.0
40672,4,672,[191  50 100 318  98],313,5,2840,4.219910846953938,20.0,60.0
40673,4,673,[191  50 100 318  98],538,5,2845,4.221068249258161,20.0,60.0
40674,4,674,[191  50 100 318  98],666,4,2849,4.220740740740741,20.0,60.0
40675,4,675,[191  50 100 318  98],426,5,2854,4.22189349112426,20.0,60.0
40676,4,676,[191  50 100 318  98],653,4,2858,4.221565731166913,20.0,60.0
40677,4,677,[191  50 100 318  98],59,5,2863,4.222713864306785,20.0,60.0
40678,4,678,[191  50 100 318  98],409,5,2868,4.223858615611193,20.0,60.0
40679,4,679,[191  50 100 318  98],188,4,2872,4.223529411764706,20.0,60.0
40680,4,680,[435 655 127 333 216],313,5,2877,4.224669603524229,0.0,20.0
40681,4,681,[435 191  50 100 318],666,4,2881,4.224340175953079,20.0,40.0
40682,4,682,[435 191  50 100 318],409,4,2885,4.224011713030746,20.0,40.0
40683,4,683,[191  50 100 318  98],892,5,2890,4.2251461988304095,20.0,60.0
40684,4,684,[191  50 100 318  98],7,5,2895,4.226277372262774,20.0,60.0
40685,4,685,[191  50 100 318  98],452,5,2900,4.227405247813411,20.0,60.0
40686,4,686,[191  50 100 318  98],488,3,2903,4.225618631732169,20.0,60.0
40687,4,687,[191  50 100 318  98],64,5,2908,4.226744186046512,20.0,60.0
40688,4,688,[191  50 100 318  98],666,4,2912,4.226415094339623,20.0,60.0
40689,4,689,[191  50 100 318  98],188,4,2916,4.226086956521739,20.0,60.0
40690,4,690,[191  50 100 318  98],488,3,2919,4.224312590448625,20.0,60.0
40691,4,691,[191  50 100 318  98],664,4,2923,4.223988439306359,20.0,60.0
40692,4,692,[191  50 100 318  98],426,5,2928,4.225108225108225,20.0,60.0
40693,4,693,[191  50 100 318  98],41,5,2933,4.226224783861672,20.0,60.0
40694,4,694,[191  50 100 318  98],653,4,2937,4.22589928057554,20.0,60.0
40695,4,695,[191  50 100 318  98],64,5,2942,4.227011494252873,20.0,60.0
40696,4,696,[191  50 100 318  98],666,4,2946,4.226685796269727,20.0,60.0
40697,4,697,[191  50 100 318  98],554,4,2950,4.226361031518625,20.0,60.0
40698,4,698,[191  50 100 318  98],188,4,2954,4.2260371959942775,20.0,60.0
40699,4,699,[191  50 100 318  98],499,4,2958,4.225714285714286,20.0,60.0
40700,4,700,[191  50 100 318  98],334,5,2963,4.226818830242511,20.0,60.0
40701,4,701,[191  50 100 318  98],233,4,2967,4.226495726495727,20.0,60.0
40702,4,702,[191  50 100 318  98],738,4,2971,4.226173541963016,20.0,60.0
40703,4,703,[191  50 100 318  98],454,4,2975,4.2258522727272725,20.0,60.0
40704,4,704,[191  50 100 318  98],308,4,2979,4.225531914893617,20.0,60.0
40705,4,705,[191  50 100 318  98],194,4,2983,4.2252124645892355,20.0,60.0
40706,4,706,[180  96  98 143 427],59,4,2987,4.224893917963225,0.0,20.0
40707,4,707,[191  50 100 318  98],426,5,2992,4.2259887005649714,20.0,60.0
40708,4,708,[ 12  71 515 132  56],892,4,2996,4.225669957686883,20.0,0.0
40709,4,709,[ 12 515 191  50 100],279,1,2997,4.22112676056338,20.0,40.0
40710,4,710,[191 100  50 318  98],311,4,3001,4.220815752461322,20.0,60.0
40711,4,711,[191  50 318 100  98],7,5,3006,4.22191011235955,20.0,60.0
40712,4,712,[191  50 318 100  98],738,4,3010,4.221598877980365,20.0,60.0
40713,4,713,[191  50 318 100  98],409,5,3015,4.222689075630252,20.0,60.0
40714,4,714,[191  50 318 100  98],538,5,3020,4.223776223776224,20.0,60.0
40715,4,715,[191  50 318 100  98],378,5,3025,4.2248603351955305,20.0,60.0
40716,4,716,[191  50 318 100  98],184,5,3030,4.2259414225941425,20.0,60.0
40717,4,717,[191  50 318 100  98],6,5,3035,4.227019498607242,20.0,60.0
40718,4,718,[191  50 318 100  98],537,4,3039,4.226703755215577,20.0,60.0
40719,4,719,[191  50 318 100  98],13,3,3042,4.225,20.0,60.0
40720,4,720,[191  50 318 100  98],537,4,3046,4.224687933425797,20.0,60.0
40721,4,721,[191  50 318 100  98],481,4,3050,4.224376731301939,20.0,60.0
40722,4,722,[191  50 100 318  98],13,3,3053,4.22268326417704,20.0,60.0
40723,4,723,[191  50 100 318  98],474,5,3058,4.223756906077348,20.0,60.0
40724,4,724,[191  50 100 318  98],161,2,3060,4.220689655172414,20.0,60.0
40725,4,725,[196 179 234 508  82],653,2,3062,4.21763085399449,0.0,0.0
40726,4,726,[191  50 100 318  98],308,4,3066,4.217331499312242,20.0,60.0
40727,4,727,[258 135 202 271 210],738,4,3070,4.217032967032967,0.0,0.0
40728,4,728,[191  50 100 318  98],343,5,3075,4.2181069958847734,20.0,60.0
40729,4,729,[191  50 100 318  98],271,5,3080,4.219178082191781,20.0,60.0
40730,4,730,[191  50 100 318  98],533,5,3085,4.220246238030096,20.0,60.0
40731,4,731,[191  50 100 318  98],738,4,3089,4.219945355191257,20.0,60.0
40732,4,732,[191  50 100 318  98],7,5,3094,4.221009549795362,20.0,60.0
40733,4,733,[191  50 100 318  98],474,5,3099,4.222070844686648,20.0,60.0
40734,4,734,[191  50 100 318  98],452,5,3104,4.22312925170068,20.0,60.0
40735,4,735,[191  50 100 318  98],488,3,3107,4.221467391304348,20.0,60.0
40736,4,736,[191  50 100 318  98],387,4,3111,4.221166892808684,20.0,60.0
40737,4,737,[655 405  71 318 187],788,3,3114,4.219512195121951,20.0,0.0
40738,4,738,[191  50 100 318  98],385,2,3116,4.216508795669824,20.0,60.0
40739,4,739,[191  50 100 318  98],538,5,3121,4.217567567567568,20.0,60.0
40740,4,740,[191  50 100 318  98],458,3,3124,4.2159244264507425,20.0,60.0
40741,4,741,[191  50 100 318  98],334,5,3129,4.216981132075472,20.0,60.0
40742,4,742,[191  50 100 318  98],92,4,3133,4.216689098250336,20.0,60.0
40743,4,743,[191  50 100 318  98],426,5,3138,4.217741935483871,20.0,60.0
40744,4,744,[191  50 100 318  98],738,4,3142,4.21744966442953,20.0,60.0
40745,4,745,[191  50 100 318  98],458,3,3145,4.2158176943699734,20.0,60.0
40746,4,746,[191 100  50 318  98],892,5,3150,4.216867469879518,20.0,60.0
40747,4,747,[191 100  50 318  98],538,5,3155,4.217914438502674,20.0,60.0
40748,4,748,[191 100  50 318  98],13,3,3158,4.2162883845126835,20.0,60.0
40749,4,749,[191  50 100 318  98],7,5,3163,4.217333333333333,20.0,60.0
40750,4,750,[191  50 100 318  98],533,5,3168,4.218375499334221,20.0,60.0
40751,4,751,[191  50 100 318  98],664,4,3172,4.218085106382978,20.0,60.0
40752,4,752,[191  50 100 318  98],188,4,3176,4.2177954847277555,20.0,60.0
40753,4,753,[191  50 100 318  98],385,2,3178,4.2148541114058355,20.0,60.0
40754,4,754,[191 100  50 318  98],653,4,3182,4.214569536423841,20.0,60.0
40755,4,755,[ 22 200 135  88  50],749,5,3187,4.215608465608466,0.0,20.0
40756,4,756,[405  50  71 187  97],194,2,3189,4.212681638044915,0.0,20.0
40757,4,757,[ 22 191 100  50 318],454,5,3194,4.213720316622691,20.0,40.0
40758,4,758,[ 22 191 100  50 318],232,4,3198,4.213438735177865,20.0,40.0
40759,4,759,[191 100  50 318  98],385,2,3200,4.2105263157894735,20.0,60.0
40760,4,760,[191 100  50 318  98],233,4,3204,4.210249671484888,20.0,60.0
40761,4,761,[191 100  50 318  98],452,5,3209,4.211286089238845,20.0,60.0
40762,4,762,[191 100  50 318  98],666,4,3213,4.2110091743119265,20.0,60.0
40763,4,763,[191 100 318  50  98],334,5,3218,4.212041884816754,20.0,60.0
40764,4,764,[191 100 318  50  98],537,4,3222,4.211764705882353,20.0,60.0
40765,4,765,[191 100 318  50  98],6,5,3227,4.212793733681462,20.0,60.0
40766,4,766,[191 100 318  50  98],41,5,3232,4.213820078226858,20.0,60.0
40767,4,767,[191 100 318  50  98],426,5,3237,4.21484375,20.0,60.0
40768,4,768,[191 100 318  50  98],41,5,3242,4.215864759427828,20.0,60.0
40769,4,769,[191 100 318  50  98],892,5,3247,4.216883116883117,20.0,60.0
40770,4,770,[191 100 318  50  98],232,5,3252,4.217898832684825,20.0,60.0
40771,4,771,[191 100 318  50  98],7,5,3257,4.2189119170984455,20.0,60.0
40772,4,772,[191 100 318  50  98],232,5,3262,4.219922380336352,20.0,60.0
40773,4,773,[191 100  50 318  98],308,4,3266,4.219638242894057,20.0,60.0
40774,4,774,[191 100  50 318  98],488,3,3269,4.218064516129032,20.0,60.0
40775,4,775,[191 100  50 318  98],458,3,3272,4.216494845360825,20.0,60.0
40776,4,776,[191 100 318  50  98],666,4,3276,4.216216216216216,20.0,60.0
40777,4,777,[191 100 318  50  98],161,2,3278,4.213367609254499,20.0,60.0
40778,4,778,[191 100 318  50  98],499,4,3282,4.213093709884467,20.0,60.0
40779,4,779,[191 100 318  50  98],194,4,3286,4.212820512820513,20.0,60.0
40780,4,780,[191 100 318  50  98],188,4,3290,4.212548015364916,20.0,60.0
40781,4,781,[191 100 318  50  98],694,5,3295,4.213554987212277,20.0,60.0
40782,4,782,[191 100 318  50  98],454,4,3299,4.213282247765006,20.0,60.0
40783,4,783,[191 100 318  50  98],194,4,3303,4.213010204081633,20.0,60.0
40784,4,784,[191 100 318  50  98],234,5,3308,4.214012738853503,20.0,60.0
40785,4,785,[191 100 318  50  98],426,5,3313,4.2150127226463106,20.0,60.0
40786,4,786,[191 100 318  50  98],664,4,3317,4.214739517153748,20.0,60.0
40787,4,787,[191 100 318  50  98],6,5,3322,4.215736040609137,20.0,60.0
40788,4,788,[191 100 318  50  98],554,4,3326,4.215462610899873,20.0,60.0
40789,4,789,[191 100 318  50  98],452,5,3331,4.216455696202532,20.0,60.0
40790,4,790,[191 100 318  50  98],308,4,3335,4.216182048040455,20.0,60.0
40791,4,791,[655 173 568  25  22],339,4,3339,4.215909090909091,0.0,0.0
40792,4,792,[191 100 318  50  98],188,4,3343,4.215636822194199,20.0,60.0
40793,4,793,[191 100 318  50  98],454,4,3347,4.2153652392947105,20.0,60.0
40794,4,794,[191 100 318  50  98],385,2,3349,4.212578616352201,20.0,60.0
40795,4,795,[100 191 318  50  98],92,4,3353,4.2123115577889445,20.0,60.0
40796,4,796,[210  70 318 222 191],804,5,3358,4.213299874529485,20.0,0.0
40797,4,797,[100 191 318  50  98],738,4,3362,4.213032581453634,20.0,60.0
40798,4,798,[191 100 318  50  98],92,4,3366,4.212765957446808,20.0,60.0
40799,4,799,[191 100 318  50  98],313,5,3371,4.21375,20.0,60.0
40800,4,800,[191 100 318  50  98],295,5,3376,4.214731585518102,20.0,60.0
40801,4,801,[191 100 318  50  98],465,4,3380,4.214463840399002,20.0,60.0
40802,4,802,[191 100 318  50  98],378,5,3385,4.215442092154421,20.0,60.0
40803,4,803,[191 100 318  50  98],232,5,3390,4.2164179104477615,20.0,60.0
40804,4,804,[191 100 318  50  98],452,5,3395,4.217391304347826,20.0,60.0
40805,4,805,[191 100 318  50  98],533,5,3400,4.218362282878412,20.0,60.0
40806,4,806,[191 100 318  50  98],194,4,3404,4.218091697645601,20.0,60.0
40807,4,807,[191 100 318  50  98],452,5,3409,4.219059405940594,20.0,60.0
40808,4,808,[191 100 318  50  98],385,2,3411,4.216316440049444,20.0,60.0
40809,4,809,[191 100 318  50  98],184,5,3416,4.217283950617284,20.0,60.0
40810,4,810,[191 100 318  50  98],144,5,3421,4.218249075215783,20.0,60.0
40811,4,811,[191 100 318  50  98],666,4,3425,4.217980295566503,20.0,60.0
40812,4,812,[191 100 318  50  98],311,4,3429,4.217712177121771,20.0,60.0
40813,4,813,[191 100 318  50  98],804,5,3434,4.218673218673219,20.0,60.0
40814,4,814,[191 100 318  50  98],892,5,3439,4.219631901840491,20.0,60.0
40815,4,815,[191 100 318  50  98],664,4,3443,4.2193627450980395,20.0,60.0
40816,4,816,[ 96  15 183 289 168],488,3,3446,4.217870257037943,0.0,0.0
40817,4,817,[191 100 318  50  98],378,5,3451,4.21882640586797,20.0,60.0
40818,4,818,[186 286 403 168 385],343,4,3455,4.218559218559219,0.0,0.0
40819,4,819,[191 100 318  50  98],161,2,3457,4.215853658536585,20.0,60.0
40820,4,820,[100 191 318  50  98],406,5,3462,4.2168087697929355,20.0,60.0
40821,4,821,[100 191 318  50  98],465,4,3466,4.21654501216545,20.0,60.0
40822,4,822,[191 100 318  50  98],653,4,3470,4.2162818955042525,20.0,60.0
40823,4,823,[191 100 318  50  98],554,4,3474,4.216019417475728,20.0,60.0
40824,4,824,[191 100 318  50  98],6,5,3479,4.216969696969697,20.0,60.0
40825,4,825,[191 100 318  50  98],334,5,3484,4.217917675544794,20.0,60.0
40826,4,826,[318 271 121 191  69],290,3,3487,4.2164449818621526,20.0,0.0
40827,4,827,[191 100 318  50  98],892,5,3492,4.217391304347826,20.0,60.0
40828,4,828,[191 100 318  50  98],481,4,3496,4.217129071170085,20.0,60.0
40829,4,829,[191 100 318  50  98],234,5,3501,4.218072289156627,20.0,60.0
40830,4,830,[191 100 318  50  98],524,4,3505,4.217809867629362,20.0,60.0
40831,4,831,[191 100 318  50  98],387,4,3509,4.217548076923077,20.0,60.0
40832,4,832,[191 100 318  50  98],295,5,3514,4.218487394957983,20.0,60.0
40833,4,833,[191 100 318  50  98],59,5,3519,4.219424460431655,20.0,60.0
40834,4,834,[191 100 318  50  98],92,4,3523,4.219161676646706,20.0,60.0
40835,4,835,[191 100 318  50  98],387,4,3527,4.2188995215311005,20.0,60.0
40836,4,836,[191 100 318  50  98],385,2,3529,4.2162485065710875,20.0,60.0
40837,4,837,[100 191 318  50  98],458,3,3532,4.214797136038186,20.0,60.0
40838,4,838,[100 191 318  50  98],59,5,3537,4.215733015494637,20.0,60.0
40839,4,839,[ 95  71 405 228 328],92,2,3539,4.213095238095238,0.0,0.0
40840,4,840,[ 88 195 235 273 597],279,2,3541,4.210463733650416,0.0,0.0
40841,4,841,[597 100 191 318  50],804,4,3545,4.210213776722091,20.0,40.0
40842,4,842,[237 132 180 496  56],85,4,3549,4.209964412811388,0.0,0.0
40843,4,843,[100 191 318  50  56],378,5,3554,4.210900473933649,20.0,40.0
40844,4,844,[100 191  56 318  50],92,4,3558,4.210650887573965,20.0,40.0
40845,4,845,[ 56 100 191 318  50],455,4,3562,4.210401891252955,20.0,40.0
40846,4,846,[191  96 257 294 181],95,4,3566,4.210153482880756,0.0,0.0
40847,4,847,[ 56 100 191 318  50],82,4,3570,4.209905660377358,20.0,40.0
40848,4,848,[100 191 318  50  98],308,4,3574,4.209658421672556,20.0,60.0
40849,4,849,[100 191 318  50  98],488,3,3577,4.208235294117647,20.0,60.0
40850,4,850,[100 191 318  50  98],184,5,3582,4.209165687426557,20.0,60.0
40851,4,851,[100 191 318  50  98],465,4,3586,4.208920187793427,20.0,60.0
40852,4,852,[191 100 318  50  98],387,4,3590,4.208675263774912,20.0,60.0
40853,4,853,[191 100 318  50  98],311,4,3594,4.208430913348946,20.0,60.0
40854,4,854,[191 100 318  50  98],233,4,3598,4.208187134502924,20.0,60.0
40855,4,855,[191 100 318  50  98],694,5,3603,4.20911214953271,20.0,60.0
40856,4,856,[191 100 318  50  98],311,4,3607,4.208868144690782,20.0,60.0
40857,4,857,[191 100 318  50  98],334,5,3612,4.20979020979021,20.0,60.0
40858,4,858,[235 568 475 238 127],339,3,3615,4.208381839348079,0.0,20.0
40859,4,859,[475 191 100 318  50],308,5,3620,4.209302325581396,20.0,40.0
40860,4,860,[475 191 100 318  50],6,5,3625,4.210220673635308,20.0,40.0
40861,4,861,[475 191 100 318  50],387,3,3628,4.208816705336427,20.0,40.0
40862,4,862,[191 100 318  50  98],188,4,3632,4.208574739281576,20.0,60.0
40863,4,863,[191 100 318  50  98],343,5,3637,4.2094907407407405,20.0,60.0
40864,4,864,[191 100 318  50  98],144,5,3642,4.210404624277457,20.0,60.0
40865,4,865,[191 100 318  50  98],474,5,3647,4.211316397228638,20.0,60.0
40866,4,866,[191 100 318  50  98],233,4,3651,4.211072664359862,20.0,60.0
40867,4,867,[191 100 318  50  98],41,5,3656,4.211981566820277,20.0,60.0
40868,4,868,[191 100 318  50  98],452,5,3661,4.212888377445339,20.0,60.0
40869,4,869,[191 100 318  50  98],378,5,3666,4.213793103448276,20.0,60.0
40870,4,870,[191 100 318  50  98],664,4,3670,4.213547646383467,20.0,60.0
40871,4,871,[191 100 318  50  98],409,5,3675,4.214449541284404,20.0,60.0
40872,4,872,[191 100 318  50  98],59,5,3680,4.215349369988545,20.0,60.0
40873,4,873,[191 100 318  50  98],488,3,3683,4.21395881006865,20.0,60.0
40874,4,874,[191 100 318  50  98],295,5,3688,4.214857142857142,20.0,60.0
40875,4,875,[191 100 318  50  98],194,4,3692,4.2146118721461185,20.0,60.0
40876,4,876,[191 100 318  50  98],892,5,3697,4.215507411630559,20.0,60.0
40877,4,877,[191 100 318  50  98],538,5,3702,4.216400911161731,20.0,60.0
40878,4,878,[191 100 318  50  98],188,4,3706,4.216154721274175,20.0,60.0
40879,4,879,[100 191 318  50  98],232,5,3711,4.217045454545454,20.0,60.0
40880,4,880,[100 191 318  50  98],653,4,3715,4.216799091940977,20.0,60.0
40881,4,881,[100 191 318  50  98],232,5,3720,4.217687074829932,20.0,60.0
40882,4,882,[100 191 318  50  98],343,5,3725,4.218573046432616,20.0,60.0
40883,4,883,[100 191 318  50  98],694,5,3730,4.219457013574661,20.0,60.0
40884,4,884,[100 191 318  50  98],474,5,3735,4.220338983050848,20.0,60.0
40885,4,885,[100 191 318  50  98],271,5,3740,4.221218961625282,20.0,60.0
40886,4,886,[100 191 318  50  98],474,5,3745,4.222096956031567,20.0,60.0
40887,4,887,[100 191 318  50  98],233,4,3749,4.221846846846847,20.0,60.0
40888,4,888,[100 191 318  50  98],311,4,3753,4.221597300337458,20.0,60.0
40889,4,889,[191 100 318  50  98],538,5,3758,4.222471910112359,20.0,60.0
40890,4,890,[405 471  28 100 427],194,3,3761,4.221099887766554,0.0,20.0
40891,4,891,[191 100 318  50  98],458,3,3764,4.219730941704036,20.0,60.0
40892,4,892,[191 100 318  50  98],537,4,3768,4.219484882418813,20.0,60.0
40893,4,893,[191 100 318  50  98],406,5,3773,4.220357941834452,20.0,60.0
40894,4,894,[191 100 318  50  98],474,5,3778,4.221229050279329,20.0,60.0
40895,4,895,[191 100 318  50  98],653,4,3782,4.220982142857143,20.0,60.0
40896,4,896,[191 100 318  50  98],161,2,3784,4.21850613154961,20.0,60.0
40897,4,897,[100 191 318  50  98],426,5,3789,4.219376391982182,20.0,60.0
40898,4,898,[100 191 318  50  98],387,4,3793,4.2191323692992215,20.0,60.0
40899,4,899,[100 191 318  50  98],64,5,3798,4.22,20.0,60.0
40900,4,900,[100 191 318  50  98],233,4,3802,4.219755826859045,20.0,60.0
40901,4,901,[100 191 318  50  98],409,5,3807,4.220620842572062,20.0,60.0
40902,4,902,[100 191 318  50  98],406,5,3812,4.221483942414175,20.0,60.0
40903,4,903,[100 191 318  50  98],385,2,3814,4.219026548672566,20.0,60.0
40904,4,904,[100 191 318  50  98],313,5,3819,4.219889502762431,20.0,60.0
40905,4,905,[100 191 318  50  98],653,4,3823,4.2196467991169975,20.0,60.0
40906,4,906,[100 191 318  50  98],387,4,3827,4.219404630650496,20.0,60.0
40907,4,907,[ 71   8 174 144 357],899,4,3831,4.219162995594714,20.0,20.0
40908,4,908,[100 191 318  50  98],499,4,3835,4.218921892189219,20.0,60.0
40909,4,909,[100 191 318  50  98],653,4,3839,4.218681318681319,20.0,60.0
40910,4,910,[161 423 403  56 153],13,4,3843,4.2184412733260155,0.0,0.0
40911,4,911,[100 191 318  50  98],533,5,3848,4.219298245614035,20.0,60.0
40912,4,912,[100 191 318  50  98],7,5,3853,4.220153340635268,20.0,60.0
40913,4,913,[100 191 318  50  98],343,5,3858,4.2210065645514225,20.0,60.0
40914,4,914,[100 191 318  50  98],488,3,3861,4.219672131147541,20.0,60.0
40915,4,915,[100 191 318  50  98],13,3,3864,4.218340611353712,20.0,60.0
40916,4,916,[100 191 318  50  98],7,5,3869,4.219193020719739,20.0,60.0
40917,4,917,[100 191 318  50  98],387,4,3873,4.218954248366013,20.0,60.0
40918,4,918,[100 191 318  50  98],738,4,3877,4.218715995647443,20.0,60.0
40919,4,919,[100 191 318  50  98],232,5,3882,4.219565217391304,20.0,60.0
40920,4,920,[100 191 318  50  98],385,2,3884,4.217155266015201,20.0,60.0
40921,4,921,[100 191 318  50  98],455,4,3888,4.216919739696312,20.0,60.0
40922,4,922,[100 191 318  50  98],666,4,3892,4.216684723726977,20.0,60.0
40923,4,923,[100 191 318  50  98],474,5,3897,4.217532467532467,20.0,60.0
40924,4,924,[100 191 318  50  98],85,4,3901,4.217297297297297,20.0,60.0
40925,4,925,[100 191 318  50  98],454,4,3905,4.217062634989201,20.0,60.0
40926,4,926,[100 191 318  50  98],524,4,3909,4.216828478964401,20.0,60.0
40927,4,927,[100 191 318  50  98],295,5,3914,4.217672413793103,20.0,60.0
40928,4,928,[ 56   1 121  96 496],311,5,3919,4.2185145317545745,0.0,0.0
40929,4,929,[100 191 318  50  98],458,3,3922,4.2172043010752684,20.0,60.0
40930,4,930,[100 191 318  50  98],409,5,3927,4.2180451127819545,20.0,60.0
40931,4,931,[100 191 318  50  98],59,5,3932,4.218884120171674,20.0,60.0
40932,4,932,[100 191 318  50  98],538,5,3937,4.219721329046088,20.0,60.0
40933,4,933,[100 191 318  50  98],59,5,3942,4.220556745182013,20.0,60.0
40934,4,934,[100 191 318  50  98],499,4,3946,4.220320855614974,20.0,60.0
40935,4,935,[100 191 318  50  98],234,5,3951,4.221153846153846,20.0,60.0
40936,4,936,[100 191 318  50  98],92,4,3955,4.220917822838848,20.0,60.0
40937,4,937,[100 191 318  50  98],738,4,3959,4.220682302771855,20.0,60.0
40938,4,938,[100 191 318  50  98],452,5,3964,4.221512247071352,20.0,60.0
40939,4,939,[ 69 143 289  79 132],13,2,3966,4.219148936170213,0.0,0.0
40940,4,940,[100 191 318  50  98],308,4,3970,4.218916046758768,20.0,60.0
40941,4,941,[100 191 318  50  98],232,5,3975,4.219745222929936,20.0,60.0
40942,4,942,[100 191 318  50  98],6,5,3980,4.220572640509014,20.0,60.0
40943,4,943,[100 191 318  50  98],666,4,3984,4.220338983050848,20.0,60.0
40944,4,944,[597 289  12 515 271],833,2,3986,4.217989417989418,20.0,0.0
40945,4,945,[100 191 318  50  98],664,4,3990,4.217758985200845,20.0,60.0
40946,4,946,[100 191 318  50  98],233,4,3994,4.21752903907075,20.0,60.0
40947,4,947,[237  56 748 191 423],474,4,3998,4.217299578059071,0.0,0.0
40948,4,948,[100 191 318  50  56],499,4,4002,4.217070600632244,20.0,40.0
40949,4,949,[100 191 318  56  50],59,5,4007,4.217894736842105,20.0,40.0
40950,4,950,[100 191  56 318  50],188,4,4011,4.217665615141956,20.0,40.0
40951,4,951,[100 191  56 318  50],474,5,4016,4.218487394957983,20.0,40.0
40952,4,952,[100  56 191 318  50],295,5,4021,4.219307450157397,20.0,40.0
40953,4,953,[ 56 100 191 318  50],666,4,4025,4.219077568134172,20.0,40.0
40954,4,954,[ 56 100 191 318  50],465,4,4029,4.218848167539267,20.0,40.0
40955,4,955,[ 56 100 191 318  50],233,4,4033,4.218619246861925,20.0,40.0
40956,4,956,[ 56 100 191 318  50],455,4,4037,4.218390804597701,20.0,40.0
40957,4,957,[ 56 100 191 318  50],233,4,4041,4.218162839248434,20.0,40.0
40958,4,958,[ 56 100 191 318  98],378,5,4046,4.218978102189781,20.0,40.0
40959,4,959,[185 195 271   8  64],13,2,4048,4.216666666666667,0.0,0.0
40960,4,960,[204 357 200 202 282],643,1,4049,4.213319458896982,20.0,0.0
40961,4,961,[ 56 100 191 318  98],92,4,4053,4.213097713097713,20.0,40.0
40962,4,962,[328  15 276 269 127],537,2,4055,4.21079958463136,0.0,20.0
40963,4,963,[ 56 100 191 318  98],538,5,4060,4.211618257261411,20.0,40.0
40964,4,964,[ 56 100 191 318  98],406,5,4065,4.212435233160622,20.0,40.0
40965,4,965,[ 56 100 191 318  98],664,4,4069,4.212215320910973,20.0,40.0
40966,4,966,[ 56 100 191 318  98],234,4,4073,4.211995863495346,20.0,40.0
40967,4,967,[ 56 100 191 318  98],406,5,4078,4.212809917355372,20.0,40.0
40968,4,968,[ 56 100 191 318  98],538,5,4083,4.213622291021672,20.0,40.0
40969,4,969,[216 286  79 185 237],60,5,4088,4.214432989690722,0.0,0.0
40970,4,970,[ 56 100 191 318  98],499,5,4093,4.21524201853759,20.0,40.0
40971,4,971,[ 56 100 191 318  98],161,2,4095,4.212962962962963,20.0,40.0
40972,4,972,[100 191  56 318  98],188,4,4099,4.212744090441932,20.0,40.0
40973,4,973,[100 191  56 318  98],295,5,4104,4.213552361396304,20.0,40.0
40974,4,974,[100  56 191 318  98],232,5,4109,4.214358974358975,20.0,40.0
40975,4,975,[100  56 191 318  98],474,5,4114,4.215163934426229,20.0,40.0
40976,4,976,[ 56 100 191 318  98],387,4,4118,4.214943705220062,20.0,40.0
40977,4,977,[ 56 100 191 318  98],41,5,4123,4.215746421267894,20.0,40.0
40978,4,978,[ 56 100 191 318  98],892,5,4128,4.216547497446374,20.0,40.0
40979,4,979,[ 56 100 191 318  98],474,5,4133,4.21734693877551,20.0,40.0
40980,4,980,[ 56 100 191 318  98],465,4,4137,4.217125382262997,20.0,40.0
40981,4,981,[186 175 202 168 121],315,3,4140,4.215885947046843,0.0,0.0
40982,4,982,[ 56 100 191 318  98],90,5,4145,4.216683621566633,20.0,40.0
40983,4,983,[ 56 100 191 318  98],41,5,4150,4.217479674796748,20.0,40.0
40984,4,984,[ 56 100 191 318  98],92,4,4154,4.217258883248731,20.0,40.0
40985,4,985,[ 56 100 191 318  98],233,5,4159,4.218052738336714,20.0,40.0
40986,4,986,[ 56 100 191 318  98],311,4,4163,4.2178318135764945,20.0,40.0
40987,4,987,[ 56 100 191 318  98],59,5,4168,4.218623481781377,20.0,40.0
40988,4,988,[ 56 100 191 318  98],524,4,4172,4.21840242669363,20.0,40.0
40989,4,989,[ 56 100 191 318  98],488,3,4175,4.217171717171717,20.0,40.0
40990,4,990,[ 56 100 191 318  98],343,5,4180,4.217961654894046,20.0,40.0
40991,4,991,[568 301  97 508   4],537,1,4181,4.214717741935484,0.0,0.0
40992,4,992,[ 56 100 191 318  98],454,3,4184,4.2134944612286,20.0,40.0
40993,4,993,[508  82 655 228 568],387,3,4187,4.212273641851106,0.0,0.0
40994,4,994,[ 56 100 191 318  98],892,5,4192,4.213065326633166,20.0,40.0
40995,4,995,[ 56 100 191 318  98],194,5,4197,4.213855421686747,20.0,40.0
40996,4,996,[ 56 100 191 318  98],804,4,4201,4.213640922768305,20.0,40.0
40997,4,997,[100  56 191 318  98],7,5,4206,4.214428857715431,20.0,40.0
40998,4,998,[ 56 100 191 318  98],144,5,4211,4.215215215215215,20.0,40.0
40999,4,999,[ 56 100 191 318  98],666,5,4216,4.216,20.0,40.0
41000,4,1000,[ 56 100 191 318  98],144,5,4221,4.216783216783217,20.0,40.0
41001,4,1001,[ 56 100 191 318  98],378,5,4226,4.217564870259481,20.0,40.0
41002,4,1002,[ 56 100 191 318  98],343,5,4231,4.218344965104686,20.0,40.0
41003,4,1003,[ 56 100 191 318  98],343,5,4236,4.219123505976095,20.0,40.0
41004,4,1004,[ 56 100 191 318  98],664,4,4240,4.218905472636816,20.0,40.0
41005,4,1005,[ 56 100 191 318  98],90,5,4245,4.219681908548708,20.0,40.0
41006,4,1006,[ 56 100 191 318  98],385,3,4248,4.218470705064548,20.0,40.0
41007,4,1007,[ 56 100 191 318  98],144,5,4253,4.219246031746032,20.0,40.0
41008,4,1008,[176 748 269 144 182],13,3,4256,4.218037661050545,0.0,0.0
41009,4,1009,[ 56 100 191 318  98],385,3,4259,4.216831683168317,20.0,40.0
41010,4,1010,[ 56 100 191 318  98],41,5,4264,4.2176063303659745,20.0,40.0
41011,4,1011,[ 56 100 191 318  98],387,4,4268,4.217391304347826,20.0,40.0
41012,4,1012,[ 71 195 588 204 211],804,5,4273,4.218163869693979,0.0,0.0
41013,4,1013,[ 56 100 191 318  98],13,3,4276,4.216962524654832,20.0,40.0
41014,4,1014,[ 56 100 191 318  98],524,4,4280,4.216748768472907,20.0,40.0
41015,4,1015,[423  56  70  98  88],648,3,4283,4.215551181102362,0.0,20.0
41016,4,1016,[ 56 100 191 318  98],664,4,4287,4.215339233038348,20.0,40.0
41017,4,1017,[313 135 257  82 174],455,5,4292,4.216110019646365,0.0,20.0
41018,4,1018,[ 56 100 191 318  98],234,4,4296,4.215897939156036,20.0,40.0
41019,4,1019,[100  56 191 318  98],64,5,4301,4.216666666666667,20.0,40.0
41020,4,1020,[100  56 191 318  98],554,4,4305,4.2164544564152795,20.0,40.0
41021,4,1021,[ 56 100 191 318  98],892,5,4310,4.217221135029354,20.0,40.0
41022,4,1022,[ 56 100 191 318  98],232,5,4315,4.217986314760508,20.0,40.0
41023,4,1023,[ 56 100 191 318  98],524,4,4319,4.2177734375,20.0,40.0
41024,4,1024,[216 211 180 405 385],804,5,4324,4.218536585365854,0.0,0.0
41025,4,1025,[132 403 471 125 180],92,4,4328,4.218323586744639,0.0,0.0
41026,4,1026,[ 56 100 191 318 216],233,5,4333,4.219084712755599,20.0,20.0
41027,4,1027,[ 28  82   7 257 172],92,2,4335,4.216926070038911,0.0,0.0
41028,4,1028,[ 56 100 191 216 318],385,2,4337,4.214771622934888,20.0,20.0
41029,4,1029,[ 56 100 191 318  98],161,2,4339,4.212621359223301,20.0,40.0
41030,4,1030,[100  56 191 318  98],295,5,4344,4.213385063045587,20.0,40.0
41031,4,1031,[100  56 191 318  98],385,3,4347,4.212209302325581,20.0,40.0
41032,4,1032,[100  56 191 318  98],343,5,4352,4.21297192642788,20.0,40.0
41033,4,1033,[100  56 191 318  98],804,4,4356,4.212765957446808,20.0,40.0
41034,4,1034,[121 237 175  88 435],313,3,4359,4.211594202898551,0.0,0.0
41035,4,1035,[100 191  56 318  98],387,4,4363,4.211389961389961,20.0,40.0
41036,4,1036,[100  56 191 318  98],311,4,4367,4.211186113789778,20.0,40.0
41037,4,1037,[100  56 191 318  98],892,5,4372,4.211946050096339,20.0,40.0
41038,4,1038,[100  56 191 318  98],161,2,4374,4.209817131857555,20.0,40.0
41039,4,1039,[127 187 423  64 405],804,3,4377,4.2086538461538465,0.0,20.0
41040,4,1040,[197 195  89 483 200],833,4,4381,4.208453410182517,20.0,0.0
41041,4,1041,[100 191  56 318  98],308,4,4385,4.208253358925144,20.0,40.0
41042,4,1042,[197 483 322 143 234],533,4,4389,4.208053691275167,20.0,0.0
41043,4,1043,[333 195 132 403 294],653,2,4391,4.2059386973180075,0.0,0.0
41044,4,1044,[100 191  56 318  98],524,4,4395,4.205741626794258,20.0,40.0
41045,4,1045,[100 191  56 318  98],334,5,4400,4.2065009560229445,20.0,40.0
41046,4,1046,[234 546  97 211 588],479,2,4402,4.204393505253104,0.0,0.0
41047,4,1047,[100 191  56 318  98],458,4,4406,4.2041984732824424,20.0,40.0
41048,4,1048,[100 191  56 318  98],90,5,4411,4.204957102001907,20.0,40.0
41049,4,1049,[100 191  56 318  98],90,5,4416,4.2057142857142855,20.0,40.0
41050,4,1050,[100  56 191 318  98],7,5,4421,4.206470028544244,20.0,40.0
41051,4,1051,[100  56 191 318  98],387,4,4425,4.2062737642585555,20.0,40.0
41052,4,1052,[168 328 222 276 186],234,0,4425,4.202279202279202,0.0,0.0
41053,4,1053,[100  56 191 318  98],295,5,4430,4.20303605313093,20.0,40.0
41054,4,1054,[179 181  15  28 153],308,3,4433,4.201895734597157,0.0,0.0
41055,4,1055,[100  56 191 318  98],488,3,4436,4.200757575757576,20.0,40.0
41056,4,1056,[100  56 191 318  98],454,3,4439,4.199621570482497,20.0,40.0
41057,4,1057,[100 191  56 318  98],59,5,4444,4.200378071833648,20.0,40.0
41058,4,1058,[100 191  56 318  98],144,5,4449,4.201133144475921,20.0,40.0
41059,4,1059,[100 191  56 318  98],537,4,4453,4.200943396226415,20.0,40.0
41060,4,1060,[  4 515 175 187 294],207,3,4456,4.199811498586239,0.0,0.0
41061,4,1061,[100 191  56 318  98],295,5,4461,4.200564971751413,20.0,40.0
41062,4,1062,[100  56 191 318  98],343,5,4466,4.201317027281279,20.0,40.0
41063,4,1063,[ 79   8 318 357 385],454,3,4469,4.200187969924812,40.0,0.0
41064,4,1064,[100  56 191 318  98],234,4,4473,4.2,20.0,40.0
41065,4,1065,[100 191  56 318  98],232,5,4478,4.200750469043152,20.0,40.0
41066,4,1066,[100 191  56 318  98],7,5,4483,4.201499531396439,20.0,40.0
41067,4,1067,[100 191  56 318  98],537,4,4487,4.201310861423221,20.0,40.0
41068,4,1068,[100 191  56 318  98],454,3,4490,4.200187090739008,20.0,40.0
41069,4,1069,[100 191  56 318  98],161,2,4492,4.198130841121495,20.0,40.0
41070,4,1070,[100 191 318  56  98],41,5,4497,4.1988795518207285,20.0,40.0
41071,4,1071,[471 357  69 202 181],899,3,4500,4.197761194029851,20.0,0.0
41072,4,1072,[100 191 318  56  98],64,5,4505,4.198508853681267,20.0,40.0
41073,4,1073,[100 191 318  56  98],313,4,4509,4.198324022346369,20.0,40.0
41074,4,1074,[100 191 318  98 180],452,5,4514,4.199069767441861,20.0,40.0
41075,4,1075,[216 211 357 294 276],82,5,4519,4.199814126394052,20.0,0.0
41076,4,1076,[100 191 318 180  98],234,4,4523,4.199628597957289,20.0,40.0
41077,4,1077,[100 191 318  98  64],7,5,4528,4.200371057513915,20.0,40.0
41078,4,1078,[191 121 302 435 204],13,4,4532,4.200185356811863,0.0,0.0
41079,4,1079,[100 191 318  64  98],233,5,4537,4.200925925925926,20.0,40.0
41080,4,1080,[100 191  64 318  98],465,4,4541,4.200740055504163,20.0,40.0
41081,4,1081,[100  64 191 318  98],271,5,4546,4.2014787430683915,20.0,40.0
41082,4,1082,[100  64 191 318  98],474,5,4551,4.202216066481994,20.0,40.0
41083,4,1083,[ 64 100 191 318  98],605,5,4556,4.202952029520295,20.0,40.0
41084,4,1084,[ 64 100 191 318  98],664,4,4560,4.202764976958525,20.0,40.0
41085,4,1085,[ 64 100 191 318  98],13,3,4563,4.201657458563536,20.0,40.0
41086,4,1086,[ 64 100 191 318  98],311,4,4567,4.201471941122355,20.0,40.0
41087,4,1087,[ 64 100 191 318  98],664,4,4571,4.201286764705882,20.0,40.0
41088,4,1088,[ 64 100 191 318  98],653,4,4575,4.201101928374656,20.0,40.0
41089,4,1089,[ 64 100 191 318  98],454,4,4579,4.200917431192661,20.0,40.0
41090,4,1090,[ 64 100 191 318  98],533,5,4584,4.201649862511458,20.0,40.0
41091,4,1091,[ 64 100 191 318  98],452,5,4589,4.2023809523809526,20.0,40.0
41092,4,1092,[ 64 100 191 318  98],85,4,4593,4.202195791399817,20.0,40.0
41093,4,1093,[ 64 100 191 318  98],537,3,4596,4.201096892138939,20.0,40.0
41094,4,1094,[ 64 100 191 318  98],524,3,4599,4.2,20.0,40.0
41095,4,1095,[100 191 318  64  50],233,4,4603,4.199817518248175,20.0,40.0
41096,4,1096,[100 191  64 318  98],488,3,4606,4.198723792160438,20.0,40.0
41097,4,1097,[100 191  64 318  98],605,5,4611,4.199453551912568,20.0,40.0
41098,4,1098,[100  64 191 318  98],524,3,4614,4.198362147406733,20.0,40.0
41099,4,1099,[100 191 318  98  50],664,4,4618,4.198181818181818,20.0,60.0
41100,4,1100,[100 191 318  98  50],804,5,4623,4.198910081743869,20.0,60.0
41101,4,1101,[100 191 318  98  50],387,4,4627,4.1987295825771325,20.0,60.0
41102,4,1102,[100 191 318  98  50],6,5,4632,4.199456029011786,20.0,60.0
41103,4,1103,[100 191 318  98  50],184,5,4637,4.20018115942029,20.0,60.0
41104,4,1104,[100 191 318  98  50],666,4,4641,4.2,20.0,60.0
41105,4,1105,[100 191 318  98  50],455,4,4645,4.199819168173598,20.0,60.0
41106,4,1106,[100 191 318  98  50],184,5,4650,4.200542005420054,20.0,60.0
41107,4,1107,[100 191 318  98  50],144,5,4655,4.201263537906137,20.0,60.0
41108,4,1108,[100 191 318  98  50],666,4,4659,4.201082055906221,20.0,60.0
41109,4,1109,[100 191 318  98  50],7,5,4664,4.2018018018018015,20.0,60.0
41110,4,1110,[100 191 318  98  50],409,5,4669,4.202520252025202,20.0,60.0
41111,4,1111,[100 191 318  98  50],406,5,4674,4.203237410071942,20.0,60.0
41112,4,1112,[100 191 318  98  50],232,5,4679,4.203953279424978,20.0,60.0
41113,4,1113,[100 191 318  98  50],454,4,4683,4.203770197486535,20.0,60.0
41114,4,1114,[100 191 318  98  50],653,4,4687,4.203587443946188,20.0,60.0
41115,4,1115,[172 234 405 603 185],840,4,4691,4.203405017921147,20.0,0.0
41116,4,1116,[100 191 318  98  50],85,4,4695,4.2032229185317815,20.0,60.0
41117,4,1117,[100 191 318  98  50],452,5,4700,4.203935599284437,20.0,60.0
41118,4,1118,[100 191 318  98  50],161,2,4702,4.2019660411081325,20.0,60.0
41119,4,1119,[100 191 318  98  50],234,5,4707,4.202678571428572,20.0,60.0
41120,4,1120,[100 191 318  98  50],378,5,4712,4.203389830508475,20.0,60.0
41121,4,1121,[100 191 318  98  50],538,5,4717,4.204099821746881,20.0,60.0
41122,4,1122,[100 191 318  98  50],385,2,4719,4.2021371326803205,20.0,60.0
41123,4,1123,[100 191 318  98  56],378,5,4724,4.202846975088968,20.0,40.0
41124,4,1124,[100 191 318  98  56],233,5,4729,4.203555555555556,20.0,40.0
41125,4,1125,[100 191 318  98  56],271,4,4733,4.203374777975133,20.0,40.0
41126,4,1126,[100 191 318  98  50],161,2,4735,4.201419698314108,20.0,60.0
41127,4,1127,[100 191 318  98  50],426,5,4740,4.202127659574468,20.0,60.0
41128,4,1128,[100 191 318  98  50],343,5,4745,4.202834366696191,20.0,60.0
41129,4,1129,[100 191 318  98  50],452,5,4750,4.20353982300885,20.0,60.0
41130,4,1130,[100 191 318  98  50],295,5,4755,4.204244031830239,20.0,60.0
41131,4,1131,[100 191 318  98  50],41,5,4760,4.204946996466431,20.0,60.0
41132,4,1132,[100 191 318  98  50],385,2,4762,4.203000882612533,20.0,60.0
41133,4,1133,[100 191 318  98  50],738,4,4766,4.202821869488536,20.0,60.0
41134,4,1134,[100 191 318  98  50],343,5,4771,4.2035242290748895,20.0,60.0
41135,4,1135,[100 191 318  98  50],13,3,4774,4.202464788732394,20.0,60.0
41136,4,1136,[100 191 318  98  50],426,5,4779,4.203166226912929,20.0,60.0
41137,4,1137,[100 191 318  98  50],92,4,4783,4.20298769771529,20.0,60.0
41138,4,1138,[100 191 318  98  50],188,4,4787,4.202809482001756,20.0,60.0
41139,4,1139,[100 191 318  98  50],343,5,4792,4.203508771929824,20.0,60.0
41140,4,1140,[100 191 318  98  50],455,4,4796,4.203330411919369,20.0,60.0
41141,4,1141,[100 191 318  98  50],85,4,4800,4.203152364273205,20.0,60.0
41142,4,1142,[100 191 318  98  50],666,4,4804,4.202974628171479,20.0,60.0
41143,4,1143,[100 191 318  98  50],406,5,4809,4.203671328671328,20.0,60.0
41144,4,1144,[100 191 318  98  50],458,3,4812,4.2026200873362445,20.0,60.0
41145,4,1145,[100 191 318  98  50],385,2,4814,4.200698080279232,20.0,60.0
41146,4,1146,[100 191 318  98  64],738,4,4818,4.20052310374891,20.0,40.0
41147,4,1147,[100 191 318  98  64],13,3,4821,4.199477351916376,20.0,40.0
41148,4,1148,[100 191 318  98  64],454,4,4825,4.199303742384682,20.0,40.0
41149,4,1149,[100 191 318  64  98],474,5,4830,4.2,20.0,40.0
41150,4,1150,[118 568 275 183 191],311,4,4834,4.199826238053866,0.0,0.0
41151,4,1151,[196 125 273 210  88],892,5,4839,4.200520833333333,0.0,0.0
41152,4,1152,[275 100 191  64 318],343,5,4844,4.201214223764094,20.0,20.0
41153,4,1153,[275 100 191  64 318],455,4,4848,4.20103986135182,20.0,20.0
41154,4,1154,[275 100 191  64 318],308,5,4853,4.201731601731602,20.0,20.0
41155,4,1155,[275 100  64 191 318],454,4,4857,4.201557093425605,20.0,20.0
41156,4,1156,[  9 423 475 168 588],13,3,4860,4.200518582541054,0.0,0.0
41157,4,1157,[100  64 191 318  98],343,5,4865,4.201208981001727,20.0,40.0
41158,4,1158,[100  64 191 318  98],488,3,4868,4.2001725625539255,20.0,40.0
41159,4,1159,[100  64 191 318  98],455,4,4872,4.2,20.0,40.0
41160,4,1160,[100  64 191 318  98],194,5,4877,4.200689061154177,20.0,40.0
41161,4,1161,[100  64 191 318  98],184,5,4882,4.201376936316695,20.0,40.0
41162,4,1162,[ 64 100 191 318  98],738,4,4886,4.201203783319003,20.0,40.0
41163,4,1163,[ 64 100 191 318  98],271,5,4891,4.201890034364261,20.0,40.0
41164,4,1164,[228  96  15   1 286],488,2,4893,4.2,0.0,0.0
41165,4,1165,[385  82 176 181 202],506,5,4898,4.200686106346484,0.0,0.0
41166,4,1166,[ 64 100 191 318  98],6,5,4903,4.2013710368466155,20.0,40.0
41167,4,1167,[508  96  22 286 496],474,4,4907,4.201198630136986,0.0,0.0
41168,4,1168,[ 64 100 191 318  98],454,4,4911,4.201026518391788,20.0,40.0
41169,4,1169,[ 64 100 191 318  98],605,5,4916,4.201709401709402,20.0,40.0
41170,4,1170,[ 64 100 191 318  98],311,4,4920,4.2015371477369765,20.0,40.0
41171,4,1171,[ 64 100 191 318  98],653,4,4924,4.201365187713311,20.0,40.0
41172,4,1172,[ 64 100 191 318  98],452,5,4929,4.202046035805626,20.0,40.0
41173,4,1173,[ 64 100 191 318  98],308,4,4933,4.201873935264055,20.0,40.0
41174,4,1174,[ 64 100 191 318  98],6,5,4938,4.202553191489362,20.0,40.0
41175,4,1175,[ 64 100 191 318  98],524,3,4941,4.201530612244898,20.0,40.0
41176,4,1176,[ 64 100 191 318  98],313,5,4946,4.202209005947323,20.0,40.0
41177,4,1177,[ 64 100 191 318  98],311,4,4950,4.202037351443124,20.0,40.0
41178,4,1178,[ 64 100 191 318  98],59,5,4955,4.202714164546226,20.0,40.0
41179,4,1179,[ 64 100 191 318  98],311,4,4959,4.202542372881356,20.0,40.0
41180,4,1180,[ 64 100 191 318  98],406,5,4964,4.203217612193057,20.0,40.0
41181,4,1181,[ 64 100 191 318  98],664,4,4968,4.2030456852791875,20.0,40.0
41182,4,1182,[ 64 100 191 318  98],343,5,4973,4.203719357565512,20.0,40.0
41183,4,1183,[ 64 100 191 318  98],524,3,4976,4.202702702702703,20.0,40.0
41184,4,1184,[ 64 100 191 318  98],653,4,4980,4.2025316455696204,20.0,40.0
41185,4,1185,[275  71  11  95 135],13,3,4983,4.201517706576729,0.0,0.0
41186,4,1186,[ 64 100 191 318  98],454,4,4987,4.2013479359730415,20.0,40.0
41187,4,1187,[ 64 100 191 318  98],232,5,4992,4.202020202020202,20.0,40.0
41188,4,1188,[ 97 286  98  79 302],458,3,4995,4.201009251471825,0.0,20.0
41189,4,1189,[ 64 100 191 318  98],343,5,5000,4.201680672268908,20.0,40.0
41190,4,1190,[ 64 100 191 318  98],144,5,5005,4.202350965575147,20.0,40.0
41191,4,1191,[ 64 100 191 318  98],233,5,5010,4.203020134228188,20.0,40.0
41192,4,1192,[ 64 100 191 318  98],7,5,5015,4.203688181056161,20.0,40.0
41193,4,1193,[748 258 742  69 125],899,3,5018,4.202680067001675,0.0,0.0
41194,4,1194,[ 64 100 191 318  98],311,4,5022,4.202510460251046,20.0,40.0
41195,4,1195,[ 64 100 191 318  98],664,4,5026,4.202341137123746,20.0,40.0
41196,4,1196,[ 64 100 191 318  98],64,5,5031,4.203007518796992,20.0,40.0
41197,4,1197,[ 64 100 191 318  98],233,5,5036,4.203672787979967,20.0,40.0
41198,4,1198,[515  97 357 210 173],95,5,5041,4.204336947456214,20.0,0.0
41199,4,1199,[ 64 100 191 318  98],194,5,5046,4.205,20.0,40.0
41200,4,1200,[ 64 100 191 318  98],6,5,5051,4.205661948376353,20.0,40.0
41201,4,1201,[ 64 100 191 318  98],653,4,5055,4.205490848585691,20.0,40.0
41202,4,1202,[ 64 100 191 318  98],13,3,5058,4.204488778054863,20.0,40.0
41203,4,1203,[ 64 100 191 318  98],406,5,5063,4.20514950166113,20.0,40.0
41204,4,1204,[ 64 100 191 318  98],605,5,5068,4.2058091286307056,20.0,40.0
41205,4,1205,[182 238 135 235 318],194,2,5070,4.203980099502488,20.0,0.0
41206,4,1206,[ 64 100 191 318  98],664,4,5074,4.203811101905551,20.0,40.0
41207,4,1207,[ 64 100 191 318  98],92,4,5078,4.203642384105961,20.0,40.0
41208,4,1208,[ 64 100 191 318  98],666,5,5083,4.204301075268817,20.0,40.0
41209,4,1209,[427 168 153  12 216],940,3,5086,4.203305785123967,20.0,0.0
41210,4,1210,[202 294 322 483 161],13,3,5089,4.202312138728324,20.0,0.0
41211,4,1211,[143 265 275 185 286],452,3,5092,4.201320132013201,0.0,0.0
41212,4,1212,[ 64 100 191 318  98],387,3,5095,4.2003297609233305,20.0,40.0
41213,4,1213,[ 64 100 191 318  98],13,3,5098,4.199341021416804,20.0,40.0
41214,4,1214,[ 64 100 191 318  98],92,4,5102,4.19917695473251,20.0,40.0
41215,4,1215,[ 64 100 191 318  98],6,5,5107,4.199835526315789,20.0,40.0
41216,4,1216,[ 64 100 191 318  98],234,5,5112,4.200493015612161,20.0,40.0
41217,4,1217,[ 64 100 191 318  98],666,5,5117,4.2011494252873565,20.0,40.0
41218,4,1218,[ 64 100 191 318  98],90,5,5122,4.201804757998359,20.0,40.0
41219,4,1219,[ 64 100 191 318  98],804,5,5127,4.202459016393442,20.0,40.0
41220,4,1220,[ 64 100 191 318  98],738,4,5131,4.202293202293203,20.0,40.0
41221,4,1221,[ 64 100 191 318  98],474,5,5136,4.202945990180033,20.0,40.0
41222,4,1222,[ 64 100 191 318  98],13,3,5139,4.2019623875715455,20.0,40.0
41223,4,1223,[ 64 100 191 318  98],653,4,5143,4.201797385620915,20.0,40.0
41224,4,1224,[ 64 100 191 318  98],666,5,5148,4.2024489795918365,20.0,40.0
41225,4,1225,[ 64 100 191 318  98],406,5,5153,4.203099510603589,20.0,40.0
41226,4,1226,[ 64 100 191 318  98],7,5,5158,4.203748981255094,20.0,40.0
41227,4,1227,[ 64 100 191 318  98],454,4,5162,4.203583061889251,20.0,40.0
41228,4,1228,[ 64 100 191 318  98],537,3,5165,4.202603742880391,20.0,40.0
41229,4,1229,[ 64 100 191 318  98],92,4,5169,4.202439024390244,20.0,40.0
41230,4,1230,[ 64 100 191 318  98],458,4,5173,4.202274573517466,20.0,40.0
41231,4,1231,[ 64 100 191 318  98],378,5,5178,4.202922077922078,20.0,40.0
41232,4,1232,[ 64 100 191 318  98],92,4,5182,4.202757502027575,20.0,40.0
41233,4,1233,[ 64 100 191 318  98],92,4,5186,4.2025931928687195,20.0,40.0
41234,4,1234,[ 64 100 191 318  98],311,4,5190,4.202429149797571,20.0,40.0
41235,4,1235,[ 64 100 191 318  98],308,4,5194,4.202265372168285,20.0,40.0
41236,4,1236,[ 64 100 191 318  98],188,4,5198,4.202101859337106,20.0,40.0
41237,4,1237,[ 64 100 191 318  98],271,5,5203,4.202746365105008,20.0,40.0
41238,4,1238,[ 64 100 191 318  98],64,5,5208,4.203389830508475,20.0,40.0
41239,4,1239,[ 64 100 191 318  98],232,5,5213,4.204032258064516,20.0,40.0
41240,4,1240,[ 64 100 191 318  98],406,5,5218,4.2046736502820306,20.0,40.0
41241,4,1241,[ 64 100 191 318  98],13,3,5221,4.203703703703703,20.0,40.0
41242,4,1242,[ 64 100 191 318  98],233,5,5226,4.204344328238133,20.0,40.0
41243,4,1243,[ 64 100 191 318  98],194,5,5231,4.204983922829582,20.0,40.0
41244,4,1244,[ 64 100 191 318  98],455,4,5235,4.204819277108434,20.0,40.0
41245,4,1245,[ 64 100 191 318  98],233,5,5240,4.20545746388443,20.0,40.0
41246,4,1246,[ 64 100 191 318  98],892,5,5245,4.2060946271050526,20.0,40.0
41247,4,1247,[ 64 100 191 318  98],537,3,5248,4.205128205128205,20.0,40.0
41248,4,1248,[ 64 100 191 318  98],59,5,5253,4.205764611689352,20.0,40.0
41249,4,1249,[ 64 100 191 318  98],488,3,5256,4.2048,20.0,40.0
41250,4,1250,[ 64 100 191 318  98],194,5,5261,4.205435651478817,20.0,40.0
41251,4,1251,[182 143 237 117 161],454,3,5264,4.204472843450479,0.0,0.0
41252,4,1252,[ 64 100 191 318  98],90,5,5269,4.205107741420591,20.0,40.0
41253,4,1253,[ 64 100 191 318  98],308,4,5273,4.204944178628389,20.0,40.0
41254,4,1254,[ 64 100 191 318  98],455,4,5277,4.2047808764940235,20.0,40.0
41255,4,1255,[ 64 100 191 318  98],6,5,5282,4.205414012738854,20.0,40.0
41256,4,1256,[ 64 100 191 318  98],804,5,5287,4.2060461416070005,20.0,40.0
41257,4,1257,[ 64 100 191 318  98],488,3,5290,4.205087440381558,20.0,40.0
41258,4,1258,[ 64 100 191 318  98],188,4,5294,4.204924543288324,20.0,40.0
41259,4,1259,[ 64 100 191 318  98],474,5,5299,4.205555555555556,20.0,40.0
41260,4,1260,[ 64 100 191 318  98],488,3,5302,4.204599524187153,20.0,40.0
41261,4,1261,[ 64 100 191 318  98],144,5,5307,4.205229793977813,20.0,40.0
41262,4,1262,[ 64 100 191 318  98],271,5,5312,4.205859065716548,20.0,40.0
41263,4,1263,[ 64 100 191 318  98],455,4,5316,4.205696202531645,20.0,40.0
41264,4,1264,[ 64 100 191 318  98],605,5,5321,4.206324110671937,20.0,40.0
41265,4,1265,[ 64 100 191 318  98],64,5,5326,4.20695102685624,20.0,40.0
41266,4,1266,[ 64 100 191 318  98],804,5,5331,4.207576953433307,20.0,40.0
41267,4,1267,[ 64 100 191 318  98],234,5,5336,4.208201892744479,20.0,40.0
41268,4,1268,[ 64 100 191 318  98],207,4,5340,4.208037825059102,20.0,40.0
41269,4,1269,[301 257 185 405 179],334,3,5343,4.207086614173228,0.0,0.0
41270,4,1270,[ 64 100 191 318  98],666,5,5348,4.2077104642014165,20.0,40.0
41271,4,1271,[ 64 100 191 318  98],7,5,5353,4.208333333333333,20.0,40.0
41272,4,1272,[ 64 100 191 318  98],144,5,5358,4.208955223880597,20.0,40.0
41273,4,1273,[ 64 100 191 318  98],85,4,5362,4.208791208791209,20.0,40.0
41274,4,1274,[ 64 100 191 318  98],234,5,5367,4.209411764705882,20.0,40.0
41275,4,1275,[ 64 100 191 318  98],207,4,5371,4.209247648902822,20.0,40.0
41276,4,1276,[ 64 100 191 318  98],664,4,5375,4.209083790133125,20.0,40.0
41277,4,1277,[ 64 100 191 318  98],85,4,5379,4.208920187793427,20.0,40.0
41278,4,1278,[ 64 100 191 318  98],524,3,5382,4.207974980453479,20.0,40.0
41279,4,1279,[ 64 100 191 318  98],474,5,5387,4.20859375,20.0,40.0
41280,4,1280,[ 64 100 191 318  98],454,4,5391,4.208430913348946,20.0,40.0
41281,4,1281,[ 64 100 191 318  98],892,5,5396,4.209048361934477,20.0,40.0
41282,4,1282,[234 100 174  97 135],524,4,5400,4.208885424785659,0.0,40.0
41283,4,1283,[ 64 100 191 318  98],6,5,5405,4.209501557632398,20.0,40.0
41284,4,1284,[ 64 100 191 318  98],458,4,5409,4.209338521400778,20.0,40.0
41285,4,1285,[ 64 100 191 318  98],85,4,5413,4.209175738724728,20.0,40.0
41286,4,1286,[ 64 100 191 318  98],92,4,5417,4.209013209013209,20.0,40.0
41287,4,1287,[ 64 100 191 318  98],184,5,5422,4.209627329192546,20.0,40.0
41288,4,1288,[ 64 100 191 318  98],184,5,5427,4.210240496508922,20.0,40.0
41289,4,1289,[ 64 100 191 318  98],308,4,5431,4.210077519379845,20.0,40.0
41290,4,1290,[ 64 100 191 318  98],13,3,5434,4.209140201394268,20.0,40.0
41291,4,1291,[ 64 100 191 318  98],232,5,5439,4.209752321981425,20.0,40.0
41292,4,1292,[ 64 100 191 318  98],738,4,5443,4.2095901005413765,20.0,40.0
41293,4,1293,[ 64 100 191 318  98],488,3,5446,4.2086553323029365,20.0,40.0
41294,4,1294,[ 64 100 191 318  98],537,3,5449,4.207722007722007,20.0,40.0
41295,4,1295,[ 64 100 191 318  98],188,4,5453,4.207561728395062,20.0,40.0
41296,4,1296,[111 276 186 237 588],59,3,5456,4.20663068619892,0.0,0.0
41297,4,1297,[ 64 100 191 318  98],533,5,5461,4.207241910631741,20.0,40.0
41298,4,1298,[ 64 100 191 318  98],653,4,5465,4.207082371054657,20.0,40.0
41299,4,1299,[237 132  64 183 385],7,5,5470,4.207692307692308,0.0,0.0
41300,4,1300,[ 64 100 191 318  98],455,4,5474,4.207532667179093,20.0,40.0
41301,4,1301,[ 64 100 191 318  98],378,5,5479,4.208141321044547,20.0,40.0
41302,4,1302,[ 64 100 191 318  98],605,5,5484,4.2087490406753645,20.0,40.0
41303,4,1303,[ 64 100 191 318  98],455,4,5488,4.208588957055214,20.0,40.0
41304,4,1304,[ 64 100 191 318  98],738,4,5492,4.208429118773946,20.0,40.0
41305,4,1305,[ 64 100 191 318  98],892,5,5497,4.2090352220520675,20.0,40.0
41306,4,1306,[ 64 100 191 318  98],653,4,5501,4.208875286916603,20.0,40.0
41307,4,1307,[ 64 100 191 318  98],653,4,5505,4.208715596330276,20.0,40.0
41308,4,1308,[ 64 100 191 318  98],233,5,5510,4.209320091673033,20.0,40.0
41309,4,1309,[ 64 100 191 318  98],454,4,5514,4.209160305343511,20.0,40.0
41310,4,1310,[ 64 100 191 318  98],343,5,5519,4.20976353928299,20.0,40.0
41311,4,1311,[ 64 100 191 318  98],804,5,5524,4.210365853658536,20.0,40.0
41312,4,1312,[ 64 100 191 318  98],184,5,5529,4.210967250571211,20.0,40.0
41313,4,1313,[ 64 100 191 318  98],474,5,5534,4.211567732115677,20.0,40.0
41314,4,1314,[ 64 100 191 318  98],90,5,5539,4.212167300380228,20.0,40.0
41315,4,1315,[ 64 100 191 318  98],406,5,5544,4.212765957446808,20.0,40.0
41316,4,1316,[ 64 100 191 318  98],664,4,5548,4.212604403948368,20.0,40.0
41317,4,1317,[588 100 197  70 238],537,4,5552,4.212443095599393,0.0,20.0
41318,4,1318,[ 64 100 191 318  98],233,5,5557,4.2130401819560275,20.0,40.0
41319,4,1319,[ 64 100 191 318  98],311,4,5561,4.212878787878788,20.0,40.0
41320,4,1320,[ 64 100 191 318  98],664,4,5565,4.212717638152914,20.0,40.0
41321,4,1321,[ 64 100 191 318  98],144,5,5570,4.213313161875946,20.0,40.0
41322,4,1322,[ 64 100 191 318  98],474,5,5575,4.213907785336357,20.0,40.0
41323,4,1323,[ 64 100 191 318  98],144,5,5580,4.214501510574018,20.0,40.0
41324,4,1324,[ 64 100 191 318  98],92,4,5584,4.21433962264151,20.0,40.0
41325,4,1325,[328 427 475 273 271],13,1,5585,4.211915535444947,0.0,0.0
41326,4,1326,[ 64 100 191 318  98],605,5,5590,4.212509419743783,20.0,40.0
41327,4,1327,[ 64 100 191 318  98],537,3,5593,4.211596385542169,20.0,40.0
41328,4,1328,[ 64 100 191 318  98],311,4,5597,4.211437170805117,20.0,40.0
41329,4,1329,[ 64 100 191 318  98],738,4,5601,4.211278195488722,20.0,40.0
41330,4,1330,[ 64 100 191 318  98],474,5,5606,4.211870773854245,20.0,40.0
41331,4,1331,[ 64 100 191 318  98],271,5,5611,4.2124624624624625,20.0,40.0
41332,4,1332,[216 180  89 118 234],378,4,5615,4.212303075768943,0.0,0.0
41333,4,1333,[ 64 100 191  89 318],184,5,5620,4.212893553223388,20.0,20.0
41334,4,1334,[ 64 100  89 191 318],454,4,5624,4.212734082397004,20.0,20.0
41335,4,1335,[ 64 100 191 318  98],474,5,5629,4.213323353293413,20.0,40.0
41336,4,1336,[ 64 100 191 318  98],488,3,5632,4.212415856394914,20.0,40.0
41337,4,1337,[ 64 100 191 318  98],92,4,5636,4.212257100149476,20.0,40.0
41338,4,1338,[ 64 100 191 318  98],537,3,5639,4.2113517550410755,20.0,40.0
41339,4,1339,[ 64 100 191 318  98],144,5,5644,4.2119402985074625,20.0,40.0
41340,4,1340,[ 64 100 191 318  98],308,4,5648,4.211782252050709,20.0,40.0
41341,4,1341,[ 64 100 191 318  98],738,4,5652,4.211624441132638,20.0,40.0
41342,4,1342,[ 64 100 191 318  98],184,5,5657,4.212211466865227,20.0,40.0
41343,4,1343,[ 64 100 191 318  98],232,5,5662,4.212797619047619,20.0,40.0
41344,4,1344,[ 64 100 191 318  98],271,5,5667,4.213382899628253,20.0,40.0
41345,4,1345,[ 64 100 191 318  98],605,5,5672,4.213967310549777,20.0,40.0
41346,4,1346,[ 64 100 191 318  98],892,5,5677,4.214550853749072,20.0,40.0
41347,4,1347,[ 64 100 191 318  98],378,5,5682,4.21513353115727,20.0,40.0
41348,4,1348,[ 64 100 191 318  98],455,4,5686,4.214974054855449,20.0,40.0
41349,4,1349,[ 64 100 191 318  98],233,5,5691,4.2155555555555555,20.0,40.0
41350,4,1350,[ 64 100 191 318  98],308,4,5695,4.2153960029607696,20.0,40.0
41351,4,1351,[ 64 100 191 318  98],537,3,5698,4.214497041420119,20.0,40.0
41352,4,1352,[ 64 100 191 318  98],7,5,5703,4.2150776053215075,20.0,40.0
41353,4,1353,[ 64 100 191 318  98],664,4,5707,4.214918759231906,20.0,40.0
41354,4,1354,[ 64 100 191 318  98],738,4,5711,4.214760147601476,20.0,40.0
41355,4,1355,[ 64 100 191 318  98],207,4,5715,4.214601769911504,20.0,40.0
41356,4,1356,[ 64 100 191 318  98],605,5,5720,4.21518054532056,20.0,40.0
41357,4,1357,[ 64 100 191 318  98],207,4,5724,4.215022091310751,20.0,40.0
41358,4,1358,[405  79 289  70 515],85,2,5726,4.213392200147167,0.0,0.0
41359,4,1359,[ 64 100 191 318  98],653,4,5730,4.213235294117647,20.0,40.0
41360,4,1360,[ 64 100 191 318  98],343,5,5735,4.213813372520206,20.0,40.0
41361,4,1361,[ 64 100 191 318  98],144,5,5740,4.214390602055801,20.0,40.0
41362,4,1362,[ 64 100 191 318  98],406,5,5745,4.21496698459281,20.0,40.0
41363,4,1363,[ 64 100 191 318  98],474,5,5750,4.215542521994135,20.0,40.0
41364,4,1364,[ 64 100 191 318  98],605,5,5755,4.216117216117216,20.0,40.0
41365,4,1365,[ 64 100 191 318  98],144,5,5760,4.216691068814056,20.0,40.0
41366,4,1366,[ 64 100 191 318  98],474,5,5765,4.217264081931236,20.0,40.0
41367,4,1367,[ 64 100 191 318  98],234,5,5770,4.2178362573099415,20.0,40.0
41368,4,1368,[ 64 100 191 318  98],59,5,5775,4.218407596785975,20.0,40.0
41369,4,1369,[ 64 100 191 318  98],533,5,5780,4.218978102189781,20.0,40.0
41370,4,1370,[ 64 100 191 318  98],184,5,5785,4.219547775346462,20.0,40.0
41371,4,1371,[ 64 100 191 318  98],85,4,5789,4.219387755102041,20.0,40.0
41372,4,1372,[ 64 100 191 318  98],7,5,5794,4.219956300072833,20.0,40.0
41373,4,1373,[ 64 100 191 318  98],188,4,5798,4.219796215429403,20.0,40.0
41374,4,1374,[197 176 245 268 508],334,2,5800,4.218181818181818,0.0,0.0
41375,4,1375,[ 64 100 191 318  98],452,5,5805,4.21875,20.0,40.0
41376,4,1376,[ 64 100 191 318  98],378,5,5810,4.219317356572258,20.0,40.0
41377,4,1377,[ 64 100 191 318  98],6,5,5815,4.21988388969521,20.0,40.0
41378,4,1378,[ 64 100 191 318  98],537,3,5818,4.218999274836838,20.0,40.0
41379,4,1379,[ 64 100 191 318  98],537,3,5821,4.2181159420289855,20.0,40.0
41380,4,1380,[ 64 100 191 318  98],455,4,5825,4.217958001448226,20.0,40.0
41381,4,1381,[204   4 301 121 403],378,3,5828,4.217076700434154,0.0,0.0
41382,4,1382,[265   9 180  15 403],311,5,5833,4.2176428054953,0.0,0.0
41383,4,1383,[ 64 100 191 318  98],64,5,5838,4.218208092485549,20.0,40.0
41384,4,1384,[ 64 100 191 318  98],7,5,5843,4.218772563176895,20.0,40.0
41385,4,1385,[ 64 100 191 318  98],232,5,5848,4.21933621933622,20.0,40.0
41386,4,1386,[ 64 100 191 318  98],90,5,5853,4.219899062725307,20.0,40.0
41387,4,1387,[ 64 100 191 318  98],64,5,5858,4.220461095100864,20.0,40.0
41388,4,1388,[  4 195 204 181 180],346,5,5863,4.221022318214543,0.0,0.0
41389,4,1389,[ 64 100 191 318  98],465,4,5867,4.220863309352518,20.0,40.0
41390,4,1390,[ 64 100 191 318  98],92,4,5871,4.220704529115744,20.0,40.0
41391,4,1391,[ 64 100 191 318  98],308,4,5875,4.220545977011494,20.0,40.0
41392,4,1392,[ 64 100 191 318  98],194,5,5880,4.221105527638191,20.0,40.0
41393,4,1393,[ 64 100 191 318  98],664,4,5884,4.220946915351506,20.0,40.0
41394,4,1394,[ 64 100 191 318  98],474,5,5889,4.221505376344086,20.0,40.0
41395,4,1395,[ 64 100 191 318  98],537,3,5892,4.2206303724928365,20.0,40.0
41396,4,1396,[ 64 100 191 318  98],533,5,5897,4.221188260558339,20.0,40.0
41397,4,1397,[ 64 100 191 318  98],378,5,5902,4.221745350500715,20.0,40.0
41398,4,1398,[258 210   7  56  98],666,4,5906,4.221586847748392,0.0,20.0
41399,4,1399,[ 64 100 191 318  98],664,4,5910,4.2214285714285715,20.0,40.0
41400,4,1400,[ 64 100 191 318  98],488,3,5913,4.220556745182013,20.0,40.0
41401,4,1401,[ 64 100 191 318  98],90,5,5918,4.221112696148359,20.0,40.0
41402,4,1402,[ 64 100 191 318  98],738,4,5922,4.22095509622238,20.0,40.0
41403,4,1403,[ 64 100 191 318  98],488,3,5925,4.22008547008547,20.0,40.0
41404,4,1404,[ 64 100 191 318  98],458,4,5929,4.219928825622776,20.0,40.0
41405,4,1405,[ 64 100 191 318  98],85,4,5933,4.2197724039829305,20.0,40.0
41406,4,1406,[ 64 100 191 318  98],59,5,5938,4.220326936744847,20.0,40.0
41407,4,1407,[ 64 100 191 318  98],7,5,5943,4.220880681818182,20.0,40.0
41408,4,1408,[ 64 100 191 318  98],524,3,5946,4.220014194464159,20.0,40.0
41409,4,1409,[ 64 100 191 318  98],465,4,5950,4.219858156028369,20.0,40.0
41410,4,1410,[ 64 100 191 318  98],892,5,5955,4.22041105598866,20.0,40.0
41411,4,1411,[ 64 100 191 318  98],474,5,5960,4.220963172804533,20.0,40.0
41412,4,1412,[ 64 100 191 318  98],308,4,5964,4.220806794055202,20.0,40.0
41413,4,1413,[ 64 100 191 318  98],458,4,5968,4.220650636492221,20.0,40.0
41414,4,1414,[ 64 100 191 318  98],537,3,5971,4.219787985865724,20.0,40.0
41415,4,1415,[ 64 100 191 318  98],664,4,5975,4.219632768361582,20.0,40.0
41416,4,1416,[ 64 100 191 318  98],7,5,5980,4.220183486238532,20.0,40.0
41417,4,1417,[ 64 100 191 318  98],271,5,5985,4.220733427362482,20.0,40.0
41418,4,1418,[ 64 100 191 318  98],271,5,5990,4.221282593375617,20.0,40.0
41419,4,1419,[ 64 100 191 318  98],184,5,5995,4.221830985915493,20.0,40.0
41420,4,1420,[ 64 100 191 318  98],13,3,5998,4.2209711470795215,20.0,40.0
41421,4,1421,[ 64 100 191 318  98],194,5,6003,4.2215189873417724,20.0,40.0
41422,4,1422,[276 168 200 286 318],234,2,6005,4.219957835558679,20.0,0.0
41423,4,1423,[ 64 100 191 318  98],804,5,6010,4.220505617977528,20.0,40.0
41424,4,1424,[ 64 100 191 318  98],92,4,6014,4.220350877192982,20.0,40.0
41425,4,1425,[ 64 100 191 318  98],232,5,6019,4.2208976157082745,20.0,40.0
41426,4,1426,[ 64 100 191 318  98],144,5,6024,4.221443587946742,20.0,40.0
41427,4,1427,[ 64 100 191 318  98],666,5,6029,4.221988795518207,20.0,40.0
41428,4,1428,[ 64 100 191 318  98],92,4,6033,4.22183344996501,20.0,40.0
41429,4,1429,[ 64 100 191 318  98],234,5,6038,4.222377622377622,20.0,40.0
41430,4,1430,[ 64 100 191 318  98],85,4,6042,4.222222222222222,20.0,40.0
41431,4,1431,[ 64 100 191 318  98],59,5,6047,4.222765363128492,20.0,40.0
41432,4,1432,[ 64 100 191 318  98],406,5,6052,4.223307745987439,20.0,40.0
41433,4,1433,[ 64 100 191 318  98],311,4,6056,4.223152022315202,20.0,40.0
41434,4,1434,[ 64 100 191 318  98],207,4,6060,4.2229965156794425,20.0,40.0
41435,4,1435,[ 64 100 191 318  98],474,5,6065,4.2235376044568245,20.0,40.0
41436,4,1436,[ 64 100 191 318  98],308,4,6069,4.223382045929019,20.0,40.0
41437,4,1437,[ 64 100 191 318  98],465,4,6073,4.223226703755215,20.0,40.0
41438,4,1438,[ 64 100 191 318  98],188,4,6077,4.223071577484364,20.0,40.0
41439,4,1439,[ 64 100 191 318  98],387,3,6080,4.222222222222222,20.0,40.0
41440,4,1440,[ 64 100 191 318  98],207,4,6084,4.22206800832755,20.0,40.0
41441,4,1441,[ 64 100 191 318  98],188,4,6088,4.221914008321775,20.0,40.0
41442,4,1442,[ 64 100 191 318  98],188,4,6092,4.2217602217602215,20.0,40.0
41443,4,1443,[ 64 100 191 318  98],605,5,6097,4.222299168975069,20.0,40.0
41444,4,1444,[ 64 100 191 318  98],90,5,6102,4.222837370242215,20.0,40.0
41445,4,1445,[ 64 100 191 318  98],387,3,6105,4.221991701244813,20.0,40.0
41446,4,1446,[ 64 100 191 318  98],537,3,6108,4.221147201105736,20.0,40.0
41447,4,1447,[ 64 100 191 318  98],207,4,6112,4.220994475138122,20.0,40.0
41448,4,1448,[ 64 100 191 318  98],144,5,6117,4.221532091097308,20.0,40.0
41449,4,1449,[ 64 100 191 318  98],664,4,6121,4.221379310344828,20.0,40.0
41450,4,1450,[ 64 100 191 318  98],537,3,6124,4.22053756030324,20.0,40.0
41451,4,1451,[ 64 100 191 318  98],452,5,6129,4.221074380165289,20.0,40.0
41452,4,1452,[ 64 100 191 318  98],474,5,6134,4.221610461114935,20.0,40.0
41453,4,1453,[ 64 100 191 318  98],144,5,6139,4.222145804676754,20.0,40.0
41454,4,1454,[ 64 100 191 318  98],85,4,6143,4.221993127147766,20.0,40.0
41455,4,1455,[ 64 100 191 318  98],6,5,6148,4.222527472527473,20.0,40.0
41456,4,1456,[ 64 100 191 318  98],406,5,6153,4.223061084420041,20.0,40.0
41457,4,1457,[ 64 100 191 318  98],6,5,6158,4.223593964334705,20.0,40.0
41458,4,1458,[ 64 100 191 318  98],85,4,6162,4.2234407128169975,20.0,40.0
41459,4,1459,[ 64 100 191 318  98],537,3,6165,4.222602739726027,20.0,40.0
41460,4,1460,[191  97 288 117 194],387,1,6166,4.220396988364135,0.0,0.0
41461,4,1461,[ 64 100 191 318  98],458,4,6170,4.220246238030096,20.0,40.0
41462,4,1462,[ 64 100 191 318  98],59,5,6175,4.220779220779221,20.0,40.0
41463,4,1463,[ 64 100 191 318  98],144,5,6180,4.221311475409836,20.0,40.0
41464,4,1464,[ 64 100 191 318  98],524,3,6183,4.220477815699659,20.0,40.0
41465,4,1465,[ 64 100 191 318  98],406,5,6188,4.221009549795362,20.0,40.0
41466,4,1466,[ 64 100 191 318  98],406,5,6193,4.221540558963872,20.0,40.0
41467,4,1467,[ 64 100 191 318  98],271,5,6198,4.222070844686648,20.0,40.0
41468,4,1468,[ 64 100 191 318  98],144,5,6203,4.222600408441116,20.0,40.0
41469,4,1469,[ 64 100 191 318  98],6,5,6208,4.22312925170068,20.0,40.0
41470,4,1470,[228 313 191   1 181],650,4,6212,4.2229775662814415,0.0,0.0
41471,4,1471,[ 64 100 191 318  98],311,4,6216,4.2228260869565215,20.0,40.0
41472,4,1472,[ 64 100 191 318  98],465,4,6220,4.2226748133061776,20.0,40.0
41473,4,1473,[ 64 100 191 318  98],488,3,6223,4.221845318860244,20.0,40.0
41474,4,1474,[ 64 100 191 318  98],233,5,6228,4.222372881355932,20.0,40.0
41475,4,1475,[ 64 100 191 318  98],664,4,6232,4.222222222222222,20.0,40.0
41476,4,1476,[ 15 202 471 204 117],207,1,6233,4.220040622884225,0.0,0.0
41477,4,1477,[ 64 100 191 318  98],387,3,6236,4.2192151556156965,20.0,40.0
41478,4,1478,[ 64 100 191 318  98],804,5,6241,4.21974306964165,20.0,40.0
41479,4,1479,[ 64 100 191 318  98],90,5,6246,4.22027027027027,20.0,40.0
41480,4,1480,[238 197 200 161 257],95,3,6249,4.2194463200540175,0.0,0.0
41481,4,1481,[237 275  95   8 179],334,4,6253,4.219298245614035,0.0,0.0
41482,4,1482,[ 64 100 191 318  98],533,5,6258,4.219824679703304,20.0,40.0
41483,4,1483,[238 202 181 168 597],899,2,6260,4.218328840970351,0.0,0.0
41484,4,1484,[ 64 100 191 318  98],7,5,6265,4.218855218855219,20.0,40.0
41485,4,1485,[ 64 100 191 318  98],271,5,6270,4.219380888290713,20.0,40.0
41486,4,1486,[ 64 100 191 318  98],6,5,6275,4.21990585070612,20.0,40.0
41487,4,1487,[ 64 100 191 318  98],454,4,6279,4.219758064516129,20.0,40.0
41488,4,1488,[ 64 100 191 318  98],387,3,6282,4.218938885157824,20.0,40.0
41489,4,1489,[ 64 100 191 318  98],90,5,6287,4.2194630872483225,20.0,40.0
41490,4,1490,[ 64 100 191 318  98],452,5,6292,4.2199865861837695,20.0,40.0
41491,4,1491,[ 64 100 191 318  98],524,3,6295,4.21916890080429,20.0,40.0
41492,4,1492,[ 64 100 191 318  98],233,5,6300,4.219691895512391,20.0,40.0
41493,4,1493,[ 64 100 191 318  98],524,3,6303,4.218875502008032,20.0,40.0
41494,4,1494,[ 64 100 191 318  98],533,5,6308,4.219397993311037,20.0,40.0
41495,4,1495,[234 195 202 357 483],194,2,6310,4.217914438502674,40.0,0.0
41496,4,1496,[ 64 100 191 318  98],311,4,6314,4.217768871075484,20.0,40.0
41497,4,1497,[ 64 100 191 318  98],452,5,6319,4.218291054739653,20.0,40.0
41498,4,1498,[ 64 100 191 318  98],184,5,6324,4.218812541694463,20.0,40.0
41499,4,1499,[ 64 100 191 318  98],455,4,6328,4.218666666666667,20.0,40.0
41500,4,1500,[ 64 100 191 318  98],13,3,6331,4.217854763491006,20.0,40.0
41501,4,1501,[ 64 100 191 318  98],64,5,6336,4.218375499334221,20.0,40.0
41502,4,1502,[ 64 100 191 318  98],234,5,6341,4.218895542248836,20.0,40.0
41503,4,1503,[ 64 100 191 318  98],343,5,6346,4.219414893617022,20.0,40.0
41504,4,1504,[ 64 100 191 318  98],90,5,6351,4.219933554817276,20.0,40.0
41505,4,1505,[ 64 100 191 318  98],233,5,6356,4.220451527224435,20.0,40.0
41506,4,1506,[ 64 100 191 318  98],90,5,6361,4.220968812209688,20.0,40.0
41507,4,1507,[ 64 100 191 318  98],653,4,6365,4.220822281167108,20.0,40.0
41508,4,1508,[151 496 194 168  12],524,1,6366,4.21868787276342,20.0,0.0
41509,4,1509,[300 328 265  82  97],533,3,6369,4.217880794701987,0.0,0.0
41510,4,1510,[ 64 100 191 318  98],207,4,6373,4.217736598279285,20.0,40.0
41511,4,1511,[ 64 100 191 318  98],313,5,6378,4.218253968253968,20.0,40.0
41512,4,1512,[ 64 100 191 318  98],455,4,6382,4.218109715796431,20.0,40.0
41513,4,1513,[ 64 100 191 318  98],454,4,6386,4.217965653896962,20.0,40.0
41514,4,1514,[ 64 100 191 318  98],804,5,6391,4.218481848184818,20.0,40.0
41515,4,1515,[ 64 100 191 318  98],7,5,6396,4.218997361477572,20.0,40.0
41516,4,1516,[ 64 100 191 318  98],454,4,6400,4.218852999340804,20.0,40.0
41517,4,1517,[ 64 100 191 318  98],234,5,6405,4.219367588932807,20.0,40.0
41518,4,1518,[ 64 100 191 318  98],605,5,6410,4.2198815009874915,20.0,40.0
41519,4,1519,[ 64 100 191 318  98],452,5,6415,4.220394736842105,20.0,40.0
41520,4,1520,[ 64 100 191 318  98],271,5,6420,4.220907297830375,20.0,40.0
41521,4,1521,[546 748 300 405  22],788,3,6423,4.220105124835743,0.0,0.0
41522,4,1522,[ 64 100 191 318  98],85,4,6427,4.219960604070913,20.0,40.0
41523,4,1523,[ 64 100 191 318  98],233,5,6432,4.2204724409448815,20.0,40.0
41524,4,1524,[ 64 100 191 318  98],524,3,6435,4.219672131147541,20.0,40.0
41525,4,1525,[ 64 100 191 318  98],207,4,6439,4.219528178243775,20.0,40.0
41526,4,1526,[ 64 100 191 318  98],738,4,6443,4.219384413883431,20.0,40.0
41527,4,1527,[ 64 100 191 318  98],804,5,6448,4.219895287958115,20.0,40.0
41528,4,1528,[ 64 100 191 318  98],85,4,6452,4.219751471550032,20.0,40.0
41529,4,1529,[ 64 100 191 318  98],524,3,6455,4.218954248366013,20.0,40.0
41530,4,1530,[ 64 100 191 318  98],6,5,6460,4.219464402351404,20.0,40.0
41531,4,1531,[ 64 100 191 318  98],207,4,6464,4.219321148825065,20.0,40.0
41532,4,1532,[ 64 191 100 318  98],533,5,6469,4.21983039791259,20.0,40.0
41533,4,1533,[ 64 191 100 318  98],92,4,6473,4.219687092568448,20.0,40.0
41534,4,1534,[ 64 191 100 318  98],188,4,6477,4.219543973941368,20.0,40.0
41535,4,1535,[ 64 100 191 318  98],474,5,6482,4.220052083333333,20.0,40.0
41536,4,1536,[ 64 100 191 318  98],90,5,6487,4.2205595315549775,20.0,40.0
41537,4,1537,[ 64 100 191 318  98],455,4,6491,4.220416124837452,20.0,40.0
41538,4,1538,[183 496 127   9  11],334,4,6495,4.220272904483431,0.0,20.0
41539,4,1539,[ 64 100 191 318  98],804,5,6500,4.220779220779221,20.0,40.0
41540,4,1540,[ 64 100 191 318  98],465,4,6504,4.220635950681376,20.0,40.0
41541,4,1541,[ 64 191 100 318  98],90,5,6509,4.221141374837873,20.0,40.0
41542,4,1542,[ 64 191 100 318  98],184,5,6514,4.221646143875567,20.0,40.0
41543,4,1543,[ 64 191 100 318  98],455,4,6518,4.221502590673575,20.0,40.0
41544,4,1544,[ 64 191 100 318  98],387,3,6521,4.220711974110032,20.0,40.0
41545,4,1545,[  9  97 174 301 269],455,4,6525,4.220569210866753,0.0,20.0
41546,4,1546,[ 79  64 135 151 153],833,2,6527,4.219133807369102,0.0,0.0
41547,4,1547,[ 64 191 100 318  98],458,4,6531,4.2189922480620154,20.0,40.0
41548,4,1548,[ 64 191 100 318  98],465,4,6535,4.2188508715300195,20.0,40.0
41549,4,1549,[ 64 191 100 318  98],311,4,6539,4.218709677419355,20.0,40.0
41550,4,1550,[121 186 288 151 181],378,2,6541,4.2172791747259835,0.0,0.0
41551,4,1551,[ 64 191 100 318  98],13,3,6544,4.216494845360825,20.0,40.0
41552,4,1552,[ 64 191 100 318  98],804,5,6549,4.2169993560849965,20.0,40.0
41553,4,1553,[ 79 323 237 318 176],804,5,6554,4.217503217503218,20.0,0.0
41554,4,1554,[183 515 191 289 258],13,2,6556,4.216077170418006,0.0,0.0
41555,4,1555,[ 64 191 100 318  98],234,5,6561,4.216580976863753,20.0,40.0
41556,4,1556,[ 64 191 100 318  98],232,5,6566,4.217084136159281,20.0,40.0
41557,4,1557,[ 64 191 100 318  98],6,5,6571,4.217586649550706,20.0,40.0
41558,4,1558,[ 64 191 100 318  98],524,3,6574,4.216805644644003,20.0,40.0
41559,4,1559,[ 64 191 100 318  98],452,5,6579,4.217307692307692,20.0,40.0
41560,4,1560,[ 64 191 100 318  98],232,5,6584,4.217809096732863,20.0,40.0
41561,4,1561,[ 64 191 100 318  98],537,3,6587,4.217029449423816,20.0,40.0
41562,4,1562,[ 64 191 100 318  98],343,5,6592,4.217530390275112,20.0,40.0
41563,4,1563,[ 64 191 100 318  98],455,4,6596,4.217391304347826,20.0,40.0
41564,4,1564,[ 64 191 100 318  98],233,5,6601,4.217891373801917,20.0,40.0
41565,4,1565,[ 88 678  79 211  95],454,2,6603,4.216475095785441,0.0,0.0
41566,4,1566,[ 64 191 100 318  98],184,5,6608,4.216975111678367,20.0,40.0
41567,4,1567,[195 655 173 211 172],234,0,6608,4.214285714285714,0.0,0.0
41568,4,1568,[ 64 191 100 318  98],308,4,6612,4.21414913957935,20.0,40.0
41569,4,1569,[  7 182 153 132 175],92,4,6616,4.214012738853503,0.0,0.0
41570,4,1570,[197 655 423 258 121],64,2,6618,4.212603437301082,0.0,0.0
41571,4,1571,[ 64 191 100 318  98],605,5,6623,4.213104325699746,20.0,40.0
41572,4,1572,[ 64 191 100 318  98],188,4,6627,4.212968849332485,20.0,40.0
41573,4,1573,[ 64 100 191 318  98],653,4,6631,4.212833545108005,20.0,40.0
41574,4,1574,[ 64 100 191 318  98],6,5,6636,4.213333333333333,20.0,40.0
41575,4,1575,[ 64 100 191 318  98],271,5,6641,4.213832487309645,20.0,40.0
41576,4,1576,[ 64 100 191 318  98],455,4,6645,4.213696892834496,20.0,40.0
41577,4,1577,[ 64 100 191 318  98],184,5,6650,4.2141951837769325,20.0,40.0
41578,4,1578,[ 64 100 191 318  98],207,4,6654,4.214059531348955,20.0,40.0
41579,4,1579,[ 64 191 100 318  98],452,5,6659,4.214556962025316,20.0,40.0
41580,4,1580,[ 64 191 100 318  98],533,5,6664,4.21505376344086,20.0,40.0
41581,4,1581,[ 64 191 100 318  98],653,4,6668,4.214917825537294,20.0,40.0
41582,4,1582,[ 64 191 100 318  98],664,4,6672,4.214782059380922,20.0,40.0
41583,4,1583,[ 64 100 191 318  98],188,4,6676,4.2146464646464645,20.0,40.0
41584,4,1584,[100 204 269  89  11],7,3,6679,4.213880126182965,0.0,20.0
41585,4,1585,[ 64 100 191 318  98],313,5,6684,4.21437578814628,20.0,40.0
41586,4,1586,[ 64 100 191 318  98],738,4,6688,4.214240705734089,20.0,40.0
41587,4,1587,[ 64 100 191 318  98],234,5,6693,4.214735516372796,20.0,40.0
41588,4,1588,[ 64 100 191 318  98],194,5,6698,4.215229704216489,20.0,40.0
41589,4,1589,[ 64 100 191 318  98],64,5,6703,4.215723270440251,20.0,40.0
41590,4,1590,[ 64 100 191 318  98],664,4,6707,4.21558768070396,20.0,40.0
41591,4,1591,[265 288  88  28  82],479,4,6711,4.215452261306533,0.0,0.0
41592,4,1592,[ 64 100 191 318  98],458,4,6715,4.215317011927182,20.0,40.0
41593,4,1593,[ 64 100 191 318  98],455,4,6719,4.2151819322459225,20.0,40.0
41594,4,1594,[ 64 100 191 318  98],233,5,6724,4.215673981191222,20.0,40.0
41595,4,1595,[ 64 100 191 318  98],666,5,6729,4.216165413533835,20.0,40.0
41596,4,1596,[ 64 100 191 318  98],387,3,6732,4.215403882279274,20.0,40.0
41597,4,1597,[ 64 100 191 318  98],387,3,6735,4.2146433041301625,20.0,40.0
41598,4,1598,[ 64 100 191 318  98],90,5,6740,4.215134459036898,20.0,40.0
41599,4,1599,[ 64 100 191 318  98],738,4,6744,4.215,20.0,40.0
41600,4,1600,[ 64 100 191 318  98],524,3,6747,4.21424109931293,20.0,40.0
41601,4,1601,[185 403 191 515 180],650,2,6749,4.212858926342072,0.0,0.0
41602,4,1602,[ 64 100 191 318  98],233,5,6754,4.213349968808484,20.0,40.0
41603,4,1603,[ 64 100 191 318  98],892,5,6759,4.2138403990024935,20.0,40.0
41604,4,1604,[ 64 100 191 318  98],488,3,6762,4.213084112149533,20.0,40.0
41605,4,1605,[ 64 100 191 318  98],452,5,6767,4.213574097135741,20.0,40.0
41606,4,1606,[ 64 100 191 318  98],666,5,6772,4.214063472308649,20.0,40.0
41607,4,1607,[ 64 100 191 318  98],92,4,6776,4.213930348258707,20.0,40.0
41608,4,1608,[ 64 100 191 318  98],653,4,6780,4.213797389683033,20.0,40.0
41609,4,1609,[ 64 100 191 318  98],474,5,6785,4.214285714285714,20.0,40.0
41610,4,1610,[ 64 100 191 318  98],59,5,6790,4.214773432650528,20.0,40.0
41611,4,1611,[ 64 100 191 318  98],454,4,6794,4.214640198511166,20.0,40.0
41612,4,1612,[ 64 100 191 318  98],378,5,6799,4.215127092374457,20.0,40.0
41613,4,1613,[ 64 100 191 318  98],6,5,6804,4.215613382899628,20.0,40.0
41614,4,1614,[ 64 100 191 318  98],144,5,6809,4.21609907120743,20.0,40.0
41615,4,1615,[ 64 100 191 318  98],64,5,6814,4.216584158415841,20.0,40.0
41616,4,1616,[ 64 100 191 318  98],738,4,6818,4.216450216450217,20.0,40.0
41617,4,1617,[ 64 191 100 318  98],64,5,6823,4.216934487021014,20.0,40.0
41618,4,1618,[ 64 191 100 318  98],664,4,6827,4.216800494132181,20.0,40.0
41619,4,1619,[ 64 100 191 318  98],666,5,6832,4.217283950617284,20.0,40.0
41620,4,1620,[175 588  64  82 333],10,4,6836,4.2171499074645284,0.0,0.0
41621,4,1621,[ 64 100 191 318  98],188,4,6840,4.217016029593095,20.0,40.0
41622,4,1622,[ 64 100 191 318  98],90,5,6845,4.217498459642637,20.0,40.0
41623,4,1623,[ 64 100 191 318  98],605,5,6850,4.217980295566503,20.0,40.0
41624,4,1624,[ 64 100 191 318  98],13,3,6853,4.21723076923077,20.0,40.0
41625,4,1625,[ 64 100 191 318  98],474,5,6858,4.217712177121771,20.0,40.0
41626,4,1626,[ 64 100 191 318  98],184,5,6863,4.21819299323909,20.0,40.0
41627,4,1627,[ 64 100 191 318  98],234,5,6868,4.218673218673219,20.0,40.0
41628,4,1628,[ 64 100 191 318  98],85,4,6872,4.21853898096992,20.0,40.0
41629,4,1629,[ 64 100 191 318  98],378,5,6877,4.219018404907976,20.0,40.0
41630,4,1630,[ 64 100 191 318  98],144,5,6882,4.219497240956469,20.0,40.0
41631,4,1631,[ 64 100 191 318  98],454,4,6886,4.2193627450980395,20.0,40.0
41632,4,1632,[ 64 100 191 318  98],233,5,6891,4.219840783833435,20.0,40.0
41633,4,1633,[ 64 100 191 318  98],488,3,6894,4.219094247246022,20.0,40.0
41634,4,1634,[ 64 100 191 318  98],188,4,6898,4.218960244648318,20.0,40.0
41635,4,1635,[ 64 100 191 318  98],234,5,6903,4.219437652811736,20.0,40.0
41636,4,1636,[ 64 100 191 318  98],664,4,6907,4.21930360415394,20.0,40.0
41637,4,1637,[ 64 100 191 318  98],537,3,6910,4.218559218559219,20.0,40.0
41638,4,1638,[ 64 100 191 318  98],524,3,6913,4.2178157413056745,20.0,40.0
41639,4,1639,[ 64 100 191 318  98],664,4,6917,4.217682926829268,20.0,40.0
41640,4,1640,[ 64 100 191 318  98],308,4,6921,4.217550274223035,20.0,40.0
41641,4,1641,[197  79  70 179 313],659,4,6925,4.21741778319123,0.0,0.0
41642,4,1642,[ 64 100 191 318  98],311,4,6929,4.217285453438832,20.0,40.0
41643,4,1643,[ 56 121 175 179 182],92,5,6934,4.2177615571776155,0.0,0.0
41644,4,1644,[ 64 100 191 318  56],533,4,6938,4.217629179331307,20.0,20.0
41645,4,1645,[276 125 286 118 195],533,4,6942,4.217496962332929,0.0,0.0
41646,4,1646,[ 64 100 191 318  98],311,4,6946,4.217364905889496,20.0,40.0
41647,4,1647,[ 64 100 191 318  98],892,5,6951,4.217839805825243,20.0,40.0
41648,4,1648,[  1 568 127 132   4],194,3,6954,4.2171012734990905,0.0,20.0
41649,4,1649,[ 64 100 191 318  98],738,4,6958,4.216969696969697,20.0,40.0
41650,4,1650,[ 64 100 191 318  98],13,3,6961,4.216232586311326,20.0,40.0
41651,4,1651,[ 64 100 191 318  98],234,5,6966,4.216707021791768,20.0,40.0
41652,4,1652,[ 64 100 191 318  98],64,5,6971,4.217180883242589,20.0,40.0
41653,4,1653,[ 64 100 191 318  98],64,5,6976,4.217654171704957,20.0,40.0
41654,4,1654,[ 64 100 191 318  98],92,4,6980,4.217522658610272,20.0,40.0
41655,4,1655,[ 64 100 191 318  98],144,5,6985,4.217995169082125,20.0,40.0
41656,4,1656,[ 64 100 191 318  98],666,5,6990,4.218467109233555,20.0,40.0
41657,4,1657,[ 64 100 191 318  98],605,5,6995,4.218938480096502,20.0,40.0
41658,4,1658,[183 322 257 222 121],92,3,6998,4.218203737191079,0.0,0.0
41659,4,1659,[143 286 197  64 405],406,2,7000,4.216867469879518,0.0,0.0
41660,4,1660,[ 64 100 191 318  98],378,5,7005,4.21733895243829,20.0,40.0
41661,4,1661,[ 64 100 191 318  98],378,5,7010,4.217809867629362,20.0,40.0
41662,4,1662,[ 64 100 191 318  98],194,5,7015,4.218280216476248,20.0,40.0
41663,4,1663,[ 64 100 191 318  98],458,4,7019,4.218149038461538,20.0,40.0
41664,4,1664,[ 64 100 191 318  98],184,5,7024,4.218618618618619,20.0,40.0
41665,4,1665,[ 64 100 191 318  98],313,5,7029,4.219087635054022,20.0,40.0
41666,4,1666,[ 64 100 191 318  98],406,5,7034,4.219556088782244,20.0,40.0
41667,4,1667,[ 64 100 191 318  98],308,4,7038,4.219424460431655,20.0,40.0
41668,4,1668,[ 28  71  82 322  22],788,3,7041,4.218693828639904,0.0,0.0
41669,4,1669,[ 64 100 191 318  98],194,5,7046,4.219161676646706,20.0,40.0
41670,4,1670,[ 64 100 191 318  98],308,4,7050,4.21903052064632,20.0,40.0
41671,4,1671,[181 210 300 228 568],87,4,7054,4.2188995215311005,0.0,0.0
41672,4,1672,[ 64 100 191 318  98],184,5,7059,4.219366407650926,20.0,40.0
41673,4,1673,[ 64 100 191 318  98],234,5,7064,4.219832735961768,20.0,40.0
41674,4,1674,[483 742 143 181 268],189,3,7067,4.21910447761194,20.0,0.0
41675,4,1675,[ 64 100 191 318  98],232,5,7072,4.219570405727923,20.0,40.0
41676,4,1676,[ 64 100 191 318  98],664,4,7076,4.219439475253429,20.0,40.0
41677,4,1677,[ 64 100 191 318  98],605,5,7081,4.2199046483909415,20.0,40.0
41678,4,1678,[ 64 100 191 318  98],64,5,7086,4.220369267421084,20.0,40.0
41679,4,1679,[174 204 483 121  82],815,4,7090,4.220238095238095,20.0,20.0
41680,4,1680,[ 64 100 191 318 174],194,5,7095,4.220701963117192,20.0,40.0
41681,4,1681,[ 64 174 100 191 318],6,5,7100,4.2211652794292505,20.0,40.0
41682,4,1682,[ 64 174 100 191 318],234,4,7104,4.221033868092691,20.0,40.0
41683,4,1683,[ 64 100 191 318 483],524,4,7108,4.220902612826603,40.0,20.0
41684,4,1684,[ 64 100 191 318 483],488,2,7110,4.2195845697329375,40.0,20.0
41685,4,1685,[ 11  82   4 286 742],554,3,7113,4.2188612099644125,0.0,0.0
41686,4,1686,[ 64 100 191 318  98],524,3,7116,4.218138707765264,20.0,40.0
41687,4,1687,[ 64 100 191 318  98],343,5,7121,4.218601895734597,20.0,40.0
41688,4,1688,[ 64 100 191 318  98],452,5,7126,4.219064535227946,20.0,40.0
41689,4,1689,[ 64 100 191 318  98],232,5,7131,4.219526627218935,20.0,40.0
41690,4,1690,[ 64 100 191 318  98],64,5,7136,4.219988172678888,20.0,40.0
41691,4,1691,[ 70 405  25 197  22],533,4,7140,4.219858156028369,0.0,0.0
41692,4,1692,[ 64 100 191 318  22],653,5,7145,4.22031896042528,20.0,20.0
41693,4,1693,[ 64  22 100 191 318],465,3,7148,4.219598583234947,20.0,20.0
41694,4,1694,[ 64 100 191 318  98],85,4,7152,4.219469026548673,20.0,40.0
41695,4,1695,[ 64 100 191 318  98],892,5,7157,4.219929245283019,20.0,40.0
41696,4,1696,[ 64 100 191 318  98],90,5,7162,4.2203889216264,20.0,40.0
41697,4,1697,[ 64 100 191 318  98],533,5,7167,4.220848056537102,20.0,40.0
41698,4,1698,[ 64 100 191 318  98],308,4,7171,4.220718069452619,20.0,40.0
41699,4,1699,[ 64 100 191 318  98],64,5,7176,4.221176470588235,20.0,40.0
41700,4,1700,[ 64 100 191 318  98],653,4,7180,4.221046443268666,20.0,40.0
41701,4,1701,[ 64 100 191 318  50],311,4,7184,4.2209165687426555,20.0,40.0
41702,4,1702,[ 64 100 191 318  50],533,5,7189,4.221374045801527,20.0,40.0
41703,4,1703,[ 64 100 191 318  50],232,5,7194,4.221830985915493,20.0,40.0
41704,4,1704,[ 64 100 191 318  50],524,4,7198,4.221700879765396,20.0,40.0
41705,4,1705,[  7 180 161 234 288],650,2,7200,4.220398593200469,0.0,0.0
41706,4,1706,[ 64 100 191 318  50],64,5,7205,4.220855301698887,20.0,40.0
41707,4,1707,[ 64 100 191 318  50],184,5,7210,4.221311475409836,20.0,40.0
41708,4,1708,[ 64 100 191 318  50],666,4,7214,4.2211819777647746,20.0,40.0
41709,4,1709,[ 64 100 191 318  50],144,5,7219,4.2216374269005845,20.0,40.0
41710,4,1710,[ 64 100 191 318  50],664,4,7223,4.221507890122735,20.0,40.0
41711,4,1711,[ 64 100 191 318  50],527,3,7226,4.220794392523365,20.0,40.0
41712,4,1712,[ 64 100 191 318  50],537,4,7230,4.220665499124343,20.0,40.0
41713,4,1713,[ 64 100 191 318  50],85,4,7234,4.220536756126021,20.0,40.0
41714,4,1714,[ 64 100 191 318  50],524,4,7238,4.220408163265306,20.0,40.0
41715,4,1715,[ 64 100 191 318  50],188,4,7242,4.22027972027972,20.0,40.0
41716,4,1716,[ 64 100 191 318  50],527,3,7245,4.219569015725102,20.0,40.0
41717,4,1717,[ 64 100 191 318  50],664,4,7249,4.219441210710128,20.0,40.0
41718,4,1718,[ 64 100 191 318  50],804,5,7254,4.219895287958115,20.0,40.0
41719,4,1719,[ 64 100 191 318  50],524,4,7258,4.219767441860465,20.0,40.0
41720,4,1720,[ 64 100 191 318  50],144,5,7263,4.220220801859384,20.0,40.0
41721,4,1721,[ 64 100 191 318  50],311,4,7267,4.220092915214867,20.0,40.0
41722,4,1722,[ 64 100 191 318  50],537,4,7271,4.219965177016831,20.0,40.0
41723,4,1723,[ 64 100 191 318  50],6,5,7276,4.220417633410673,20.0,40.0
41724,4,1724,[ 64 100 191 318  50],406,5,7281,4.2208695652173915,20.0,40.0
41725,4,1725,[ 64 100 191 318  50],7,5,7286,4.221320973348783,20.0,40.0
41726,4,1726,[ 64 100 191 318  50],664,4,7290,4.221192819918935,20.0,40.0
41727,4,1727,[ 64 100 191 318  50],59,5,7295,4.221643518518518,20.0,40.0
41728,4,1728,[ 64 100 191 318  50],194,4,7299,4.221515326778484,20.0,40.0
41729,4,1729,[ 64 100 191 318  50],13,3,7302,4.220809248554914,20.0,40.0
41730,4,1730,[ 64 100 191 318  50],533,5,7307,4.221259387637204,20.0,40.0
41731,4,1731,[ 64 100 191 318  50],537,4,7311,4.221131639722864,20.0,40.0
41732,4,1732,[ 64 100 191 318  50],144,5,7316,4.221581073283324,20.0,40.0
41733,4,1733,[ 64 100 191 318  50],387,3,7319,4.220876585928489,20.0,40.0
41734,4,1734,[ 64 100 191 318  50],311,4,7323,4.2207492795389046,20.0,40.0
41735,4,1735,[ 64 100 191 318  50],892,5,7328,4.221198156682028,20.0,40.0
41736,4,1736,[ 64 100 191 318  50],343,5,7333,4.221646516983305,20.0,40.0
41737,4,1737,[ 64 100 191 318  50],13,3,7336,4.220943613348677,20.0,40.0
41738,4,1738,[ 64 100 191 318  50],13,3,7339,4.220241518113858,20.0,40.0
41739,4,1739,[ 64 100 191 318  50],738,4,7343,4.220114942528736,20.0,40.0
41740,4,1740,[ 64 100 191 318  50],318,4,7347,4.219988512349224,20.0,40.0
41741,4,1741,[ 64 100 191 318  50],82,5,7352,4.220436280137773,20.0,40.0
41742,4,1742,[ 64 100 191 318  50],184,5,7357,4.220883534136546,20.0,40.0
41743,4,1743,[ 64 100 191 318  50],537,4,7361,4.220756880733945,20.0,40.0
41744,4,1744,[ 64 100 191 318  50],488,3,7364,4.220057306590258,20.0,40.0
41745,4,1745,[ 64 100 191 318  50],188,4,7368,4.219931271477663,20.0,40.0
41746,4,1746,[ 64 100 191 318  50],474,5,7373,4.220377790497997,20.0,40.0
41747,4,1747,[ 64 100 191 318  50],738,4,7377,4.22025171624714,20.0,40.0
41748,4,1748,[ 64 100 191 318  50],232,5,7382,4.2206975414522585,20.0,40.0
41749,4,1749,[ 64 100 191 318  50],92,4,7386,4.220571428571429,20.0,40.0
41750,4,1750,[ 64 100 191 318  50],85,4,7390,4.220445459737293,20.0,40.0
41751,4,1751,[ 64 100 191 318  50],271,5,7395,4.220890410958904,20.0,40.0
41752,4,1752,[ 64 100 191 318  50],188,4,7399,4.220764403879064,20.0,40.0
41753,4,1753,[ 64 100 191 318  50],738,4,7403,4.220638540478905,20.0,40.0
41754,4,1754,[ 64 100 191 318  50],59,5,7408,4.221082621082621,20.0,40.0
41755,4,1755,[ 64 100 191 318  50],13,3,7411,4.220387243735763,20.0,40.0
41756,4,1756,[ 64 100 191 318  50],664,4,7415,4.220261809903244,20.0,40.0
41757,4,1757,[ 64 100 191 318  50],343,5,7420,4.22070534698521,20.0,40.0
41758,4,1758,[ 64 100 191 318  50],664,4,7424,4.220579874928937,20.0,40.0
41759,4,1759,[ 64 100 318 191  50],7,5,7429,4.221022727272727,20.0,40.0
41760,4,1760,[ 64 100 318 191  50],454,5,7434,4.221465076660988,20.0,40.0
41761,4,1761,[ 64 100 318 191  50],82,5,7439,4.221906923950057,20.0,40.0
41762,4,1762,[ 64 100 318 191  50],653,5,7444,4.2223482699943276,20.0,40.0
41763,4,1763,[ 64 100 318 191  50],378,5,7449,4.2227891156462585,20.0,40.0
41764,4,1764,[ 64 100 318 191  50],271,5,7454,4.223229461756374,20.0,40.0
41765,4,1765,[ 64 100 318 191  50],144,5,7459,4.223669309173273,20.0,40.0
41766,4,1766,[ 64 100 318 191  50],465,4,7463,4.22354272778721,20.0,40.0
41767,4,1767,[ 64 100 318 191  50],194,4,7467,4.22341628959276,20.0,40.0
41768,4,1768,[ 64 100 318 191  50],664,4,7471,4.2232899943470885,20.0,40.0
41769,4,1769,[ 64 100 318 191  50],188,4,7475,4.22316384180791,20.0,40.0
41770,4,1770,[ 64 100 318 191  50],232,5,7480,4.22360248447205,20.0,40.0
41771,4,1771,[ 64 100 318 191  50],488,3,7483,4.222911963882619,20.0,40.0
41772,4,1772,[ 64 100 318 191  50],527,3,7486,4.222222222222222,20.0,40.0
41773,4,1773,[ 71 257  64 245 423],804,4,7490,4.222096956031567,0.0,0.0
41774,4,1774,[ 64 100 318 191  50],378,5,7495,4.222535211267606,20.0,40.0
41775,4,1775,[ 64 100 318 191  50],343,5,7500,4.222972972972973,20.0,40.0
41776,4,1776,[ 64 100 318 191  50],343,5,7505,4.223410241980867,20.0,40.0
41777,4,1777,[ 64 100 318 191  50],311,4,7509,4.223284589426322,20.0,40.0
41778,4,1778,[ 64 100 318 191  50],271,5,7514,4.22372119168072,20.0,40.0
41779,4,1779,[ 64 100 318 191  50],465,4,7518,4.223595505617977,20.0,40.0
41780,4,1780,[ 64 100 318 191  50],343,5,7523,4.224031443009546,20.0,40.0
41781,4,1781,[ 64 100 318 191  50],92,4,7527,4.223905723905724,20.0,40.0
41782,4,1782,[ 64 100 318 191  50],537,4,7531,4.223780145821649,20.0,40.0
41783,4,1783,[ 64 100 318 191  50],533,5,7536,4.2242152466367715,20.0,40.0
41784,4,1784,[ 64 100 318 191  50],234,5,7541,4.224649859943978,20.0,40.0
41785,4,1785,[ 64 100 318 191  50],738,4,7545,4.224524076147817,20.0,40.0
41786,4,1786,[ 64 100 318 191  50],804,5,7550,4.224958030218243,20.0,40.0
41787,4,1787,[ 64 100 318 191  50],527,3,7553,4.22427293064877,20.0,40.0
41788,4,1788,[ 64 100 318 191  50],311,4,7557,4.224147568474008,20.0,40.0
41789,4,1789,[ 64 100 318 191  50],64,5,7562,4.224581005586592,20.0,40.0
41790,4,1790,[ 64 100 318 191  50],59,5,7567,4.2250139586823,20.0,40.0
41791,4,1791,[ 64 100 318 191  50],308,5,7572,4.225446428571429,20.0,40.0
41792,4,1792,[ 64 100 318 191  50],804,5,7577,4.225878416062465,20.0,40.0
41793,4,1793,[ 64 100 318 191  50],458,4,7581,4.225752508361204,20.0,40.0
41794,4,1794,[ 64 100 318 191  50],653,5,7586,4.226183844011142,20.0,40.0
41795,4,1795,[ 64 100 318 191  50],527,3,7589,4.2255011135857465,20.0,40.0
41796,4,1796,[ 64 100 191 318  50],311,4,7593,4.225375626043406,20.0,40.0
41797,4,1797,[ 64 100 191 318  50],311,4,7597,4.225250278086763,20.0,40.0
41798,4,1798,[ 64 100 191 318  50],85,4,7601,4.225125069483046,20.0,40.0
41799,4,1799,[144  15 100 655 222],378,4,7605,4.225,0.0,20.0
41800,4,1800,[ 64 191 318 100  50],666,4,7609,4.224875069405885,20.0,40.0
41801,4,1801,[ 64 191 318 100  50],458,4,7613,4.224750277469479,20.0,40.0
41802,4,1802,[ 64 191 318 100  50],804,5,7618,4.225180255130338,20.0,40.0
41803,4,1803,[ 64 191 318 100  50],59,5,7623,4.225609756097561,20.0,40.0
41804,4,1804,[ 64 191 318 100  50],144,5,7628,4.226038781163435,20.0,40.0
41805,4,1805,[ 64 191 318 100  50],533,5,7633,4.226467331118494,20.0,40.0
41806,4,1806,[ 64 191 318 100  50],308,5,7638,4.226895406751522,20.0,40.0
41807,4,1807,[ 64 191 318 100  50],378,5,7643,4.227323008849558,20.0,40.0
41808,4,1808,[ 64 191 318 100  50],804,5,7648,4.2277501381979,20.0,40.0
41809,4,1809,[ 64 191 318 100  50],308,5,7653,4.228176795580111,20.0,40.0
41810,4,1810,[ 64 191 318 100  50],184,5,7658,4.228602981778023,20.0,40.0
41811,4,1811,[ 64 191 318 100  50],194,4,7662,4.228476821192053,20.0,40.0
41812,4,1812,[ 64 191 318 100  50],406,5,7667,4.2289023717595144,20.0,40.0
41813,4,1813,[748 135 289 282 238],881,2,7669,4.227673649393605,0.0,0.0
41814,4,1814,[ 64 191 318 100  50],13,3,7672,4.226997245179064,20.0,40.0
41815,4,1815,[ 95   4 174 515 111],537,1,7673,4.225220264317181,0.0,20.0
41816,4,1816,[ 64 100 191 318  50],85,4,7677,4.225096312603192,20.0,40.0
41817,4,1817,[ 64 191 318 100  50],184,5,7682,4.225522552255225,20.0,40.0
41818,4,1818,[ 64 191 318 100  50],488,3,7685,4.2248488180318855,20.0,40.0
41819,4,1819,[ 64 318 191 100  50],378,5,7690,4.225274725274725,20.0,40.0
41820,4,1820,[ 64 318 191 100  50],527,3,7693,4.224601867105986,20.0,40.0
41821,4,1821,[ 64 191 318 100  50],537,4,7697,4.224478594950604,20.0,40.0
41822,4,1822,[ 64 191 318 100  50],474,5,7702,4.224904004388371,20.0,40.0
41823,4,1823,[ 64 191 318 100  50],488,3,7705,4.224232456140351,20.0,40.0
41824,4,1824,[ 64 318 191 100  50],232,5,7710,4.2246575342465755,20.0,40.0
41825,4,1825,[ 64 318 191 100  50],664,4,7714,4.224534501642935,20.0,40.0
41826,4,1826,[ 64 318 100 191  50],455,4,7718,4.224411603721949,20.0,40.0
41827,4,1827,[ 64 318 100 191  50],234,5,7723,4.224835886214442,20.0,40.0
41828,4,1828,[ 64 318 100 191  50],664,4,7727,4.2247129579004925,20.0,40.0
41829,4,1829,[405 153 301   8 275],85,2,7729,4.223497267759563,0.0,0.0
41830,4,1830,[ 64 318 100 191  50],144,5,7734,4.22392135445112,20.0,40.0
41831,4,1831,[ 64 318 100 191  50],313,5,7739,4.224344978165939,20.0,40.0
41832,4,1832,[ 64 318 100 191  50],92,4,7743,4.224222585924713,20.0,40.0
41833,4,1833,[ 64 100 318 191  50],458,4,7747,4.224100327153762,20.0,40.0
41834,4,1834,[ 64 100 318 191  50],233,4,7751,4.2239782016348775,20.0,40.0
41835,4,1835,[ 64 100 318 191  50],527,3,7754,4.223311546840959,20.0,40.0
41836,4,1836,[ 64 100 191 318  50],455,4,7758,4.223189983669026,20.0,40.0
41837,4,1837,[ 64 100 191 318  50],406,5,7763,4.223612622415669,20.0,40.0
41838,4,1838,[ 64 100 191 318  50],533,5,7768,4.224034801522567,20.0,40.0
41839,4,1839,[ 64 100 191 318  50],387,3,7771,4.223369565217391,20.0,40.0
41840,4,1840,[ 64 100 191 318  50],465,4,7775,4.223248234655078,20.0,40.0
41841,4,1841,[ 64 100 191 318  50],271,5,7780,4.223669923995657,20.0,40.0
41842,4,1842,[ 11 423 245  71 195],200,4,7784,4.223548562126967,0.0,0.0
41843,4,1843,[ 64 100 191 318  50],452,5,7789,4.223969631236442,20.0,40.0
41844,4,1844,[ 64 100 191 318  50],233,4,7793,4.223848238482385,20.0,40.0
41845,4,1845,[100 175 204 385 125],234,1,7794,4.222101841820152,0.0,20.0
41846,4,1846,[ 64 100 191 318  50],455,4,7798,4.221981591770438,20.0,40.0
41847,4,1847,[ 64 100 191 318  50],343,5,7803,4.222402597402597,20.0,40.0
41848,4,1848,[ 64 100 191 318  50],454,5,7808,4.222823147647377,20.0,40.0
41849,4,1849,[ 64 100 191 318  50],527,3,7811,4.222162162162162,20.0,40.0
41850,4,1850,[405 183 181  28 655],42,4,7815,4.222042139384117,0.0,0.0
41851,4,1851,[ 64 100 191 318  50],455,4,7819,4.221922246220302,20.0,40.0
41852,4,1852,[175  22 302 181 191],474,5,7824,4.222342147868321,0.0,0.0
41853,4,1853,[ 64 100 191 318  50],653,5,7829,4.222761596548004,20.0,40.0
41854,4,1854,[ 64 100 191 318  50],533,5,7834,4.2231805929919135,20.0,40.0
41855,4,1855,[ 64 100 191 318  50],232,5,7839,4.223599137931035,20.0,40.0
41856,4,1856,[ 64 100 191 318  50],666,4,7843,4.22347872913301,20.0,40.0
41857,4,1857,[144 210  96 200 181],374,4,7847,4.223358449946178,0.0,0.0
41858,4,1858,[ 64 100 191 318  50],454,5,7852,4.223776223776224,20.0,40.0
41859,4,1859,[ 64 100 191 318  50],308,5,7857,4.224193548387097,20.0,40.0
41860,4,1860,[ 64 100 191 318  50],465,4,7861,4.2240730789897905,20.0,40.0
41861,4,1861,[ 64 191 100 318  50],527,3,7864,4.223415682062298,20.0,40.0
41862,4,1862,[ 64 191 100 318  50],378,5,7869,4.223832528180354,20.0,40.0
41863,4,1863,[ 64 191 100 318  50],343,5,7874,4.2242489270386265,20.0,40.0
41864,4,1864,[ 64 191 100 318  50],527,3,7877,4.223592493297587,20.0,40.0
41865,4,1865,[ 64 191 100 318  50],234,5,7882,4.22400857449089,20.0,40.0
41866,4,1866,[ 64 191 100 318  50],7,5,7887,4.224424209962507,20.0,40.0
41867,4,1867,[ 64 191 100 318  50],318,4,7891,4.224304068522484,20.0,40.0
41868,4,1868,[ 64 191 100 318  50],738,4,7895,4.22418405564473,20.0,40.0
41869,4,1869,[ 64 191 100 318  50],313,5,7900,4.224598930481283,20.0,40.0
41870,4,1870,[ 64 191 100 318  50],311,4,7904,4.224478888295029,20.0,40.0
41871,4,1871,[ 64 191 100 318  50],524,4,7908,4.2243589743589745,20.0,40.0
41872,4,1872,[515 546  97 179 202],271,4,7912,4.224239188467699,0.0,0.0
41873,4,1873,[ 64 191 100 318  50],184,5,7917,4.2246531483457845,20.0,40.0
41874,4,1874,[ 64 191 100 318  50],465,4,7921,4.2245333333333335,20.0,40.0
41875,4,1875,[ 64 191 100 318  50],537,4,7925,4.224413646055437,20.0,40.0
41876,4,1876,[ 64 191 100 318  50],234,5,7930,4.224826851358551,20.0,40.0
41877,4,1877,[ 64 191 100 318  50],92,4,7934,4.2247071352502665,20.0,40.0
41878,4,1878,[ 64 191 100 318  50],13,3,7937,4.224055348589675,20.0,40.0
41879,4,1879,[ 64 191 100 318  50],533,5,7942,4.224468085106383,20.0,40.0
41880,4,1880,[ 64 191 100 318  50],465,4,7946,4.22434875066454,20.0,40.0
41881,4,1881,[234 237  28 135 271],883,2,7948,4.2231668437832095,0.0,0.0
41882,4,1882,[ 64 191 100 318  50],454,5,7953,4.223579394583112,20.0,40.0
41883,4,1883,[238 211   7 288 271],833,1,7954,4.221868365180467,0.0,0.0
41884,4,1884,[ 64 191 100 318  50],378,5,7959,4.222281167108753,20.0,40.0
41885,4,1885,[ 64 191 100 318  50],234,5,7964,4.222693531283139,20.0,40.0
41886,4,1886,[ 64 191 100 318  50],234,5,7969,4.223105458399576,20.0,40.0
41887,4,1887,[ 64 191 100 318  50],664,4,7973,4.222987288135593,20.0,40.0
41888,4,1888,[ 64 191 100 318  50],454,5,7978,4.223398623610376,20.0,40.0
41889,4,1889,[ 64 191 100 318  50],188,4,7982,4.223280423280423,20.0,40.0
41890,4,1890,[ 64 191 100 318  50],232,5,7987,4.223691168693813,20.0,40.0
41891,4,1891,[ 64 191 100 318  50],458,4,7991,4.223572938689218,20.0,40.0
41892,4,1892,[ 64 191 100 318  50],234,5,7996,4.223983095615425,20.0,40.0
41893,4,1893,[ 64 191 100 318  50],406,5,8001,4.224392819429778,20.0,40.0
41894,4,1894,[ 64 191 100 318  50],194,4,8005,4.224274406332454,20.0,40.0
41895,4,1895,[ 64 191 100 318  50],194,4,8009,4.22415611814346,20.0,40.0
41896,4,1896,[ 98 748  50 100 282],804,5,8014,4.224565102793885,0.0,60.0
41897,4,1897,[ 64 191 100 318  50],488,3,8017,4.223919915700738,20.0,40.0
41898,4,1898,[ 64 191 100 318  50],474,5,8022,4.22432859399684,20.0,40.0
41899,4,1899,[ 64 191 100 318  50],738,4,8026,4.224210526315789,20.0,40.0
41900,4,1900,[ 64 191 100 318  50],387,3,8029,4.2235665439242505,20.0,40.0
41901,4,1901,[151   4 153 385 357],387,2,8031,4.222397476340694,20.0,0.0
41902,4,1902,[ 64 191 100 318  50],7,5,8036,4.222806095638465,20.0,40.0
41903,4,1903,[ 64 191 100 318  50],458,4,8040,4.222689075630252,20.0,40.0
41904,4,1904,[ 64 191 100 318  50],378,5,8045,4.223097112860892,20.0,40.0
41905,4,1905,[ 64 191 100 318  50],664,4,8049,4.222980062959077,20.0,40.0
41906,4,1906,[ 64 191 100 318  50],533,5,8054,4.223387519664394,20.0,40.0
41907,4,1907,[ 64 191 100 318  50],188,4,8058,4.223270440251572,20.0,40.0
41908,4,1908,[ 64 191 100 318  50],533,5,8063,4.223677317967522,20.0,40.0
41909,4,1909,[ 64 191 100 318  50],232,5,8068,4.224083769633508,20.0,40.0
41910,4,1910,[ 64 191 100 318  50],666,4,8072,4.223966509680795,20.0,40.0
41911,4,1911,[238 234 121 196  89],406,3,8075,4.223326359832636,0.0,0.0
41912,4,1912,[ 64 191 100 318  50],311,4,8079,4.223209618400418,20.0,40.0
41913,4,1913,[ 64 191 100 318  50],233,4,8083,4.223092998955068,20.0,40.0
41914,4,1914,[ 64 191 100 318  50],343,5,8088,4.223498694516971,20.0,40.0
41915,4,1915,[ 64 191 100 318  50],458,4,8092,4.223382045929019,20.0,40.0
41916,4,1916,[ 64 191 100 318  50],82,5,8097,4.22378716744914,20.0,40.0
41917,4,1917,[ 64 191 100 318  50],64,5,8102,4.224191866527633,20.0,40.0
41918,4,1918,[ 64 191 100 318  50],318,4,8106,4.224075039082856,20.0,40.0
41919,4,1919,[ 64 191 100 318  50],308,5,8111,4.224479166666667,20.0,40.0
41920,4,1920,[ 64 191 100 318  50],387,3,8114,4.223841749089016,20.0,40.0
41921,4,1921,[ 64 191 100 318  50],92,4,8118,4.22372528616025,20.0,40.0
41922,4,1922,[ 64 191 100 318  50],59,5,8123,4.224128965158607,20.0,40.0
41923,4,1923,[568 269 151  79 174],25,5,8128,4.224532224532225,0.0,20.0
41924,4,1924,[ 64 191 100 318  50],474,5,8133,4.224935064935065,20.0,40.0
41925,4,1925,[ 64 191 100 318  50],64,5,8138,4.22533748701973,20.0,40.0
41926,4,1926,[ 64 191 100 318  50],653,5,8143,4.2257394914374675,20.0,40.0
41927,4,1927,[ 64 191 100 318  50],308,5,8148,4.226141078838174,20.0,40.0
41928,4,1928,[ 64 191 100 318  50],343,5,8153,4.226542249870399,20.0,40.0
41929,4,1929,[ 64 191 100 318  50],455,4,8157,4.226424870466321,20.0,40.0
41930,4,1930,[ 64 191 100 318  50],458,4,8161,4.22630761263594,20.0,40.0
41931,4,1931,[ 64 191 100 318  50],64,5,8166,4.226708074534161,20.0,40.0
41932,4,1932,[ 64 191 100 318  50],232,5,8171,4.227108122090016,20.0,40.0
41933,4,1933,[ 64 191 100 318  50],188,4,8175,4.226990692864529,20.0,40.0
41934,4,1934,[ 64 191 100 318  50],465,4,8179,4.22687338501292,20.0,40.0
41935,4,1935,[ 64 191 100 318  50],458,4,8183,4.226756198347108,20.0,40.0
41936,4,1936,[ 64 191 100 318  50],804,5,8188,4.22715539494063,20.0,40.0
41937,4,1937,[ 64 191 100 318  50],738,4,8192,4.22703818369453,20.0,40.0
41938,4,1938,[ 64 191 100 318  50],537,4,8196,4.226921093347086,20.0,40.0
41939,4,1939,[238 181  50 195 435],694,4,8200,4.22680412371134,0.0,20.0
41940,4,1940,[ 64 191 100 318  50],233,4,8204,4.226687274600721,20.0,40.0
41941,4,1941,[ 64 191 100 318  50],308,5,8209,4.227085478887744,20.0,40.0
41942,4,1942,[ 64 191 100 318  50],666,4,8213,4.226968605249614,20.0,40.0
41943,4,1943,[179 173   1 151 196],378,3,8216,4.226337448559671,0.0,0.0
41944,4,1944,[ 64 191 100 318  50],233,4,8220,4.226221079691516,20.0,40.0
41945,4,1945,[ 64 191 100 318  50],308,5,8225,4.226618705035971,20.0,40.0
41946,4,1946,[ 64 191 100 318  50],271,5,8230,4.2270159219311765,20.0,40.0
41947,4,1947,[ 64 191 100 318  50],533,5,8235,4.22741273100616,20.0,40.0
41948,4,1948,[ 64 191 100 318  50],537,4,8239,4.2272960492560285,20.0,40.0
41949,4,1949,[ 64 191 100 318  50],343,5,8244,4.227692307692307,20.0,40.0
41950,4,1950,[ 64 191 100 318  50],378,5,8249,4.2280881599179905,20.0,40.0
41951,4,1951,[ 64 191 100 318  50],233,4,8253,4.22797131147541,20.0,40.0
41952,4,1952,[ 64 191 100 318  50],311,4,8257,4.2278545826932925,20.0,40.0
41953,4,1953,[ 64 191 100 318  50],85,4,8261,4.227737973387923,20.0,40.0
41954,4,1954,[ 64 191 100 318  50],387,3,8264,4.227109974424552,20.0,40.0
41955,4,1955,[ 64 191 100 318  50],653,5,8269,4.227505112474438,20.0,40.0
41956,4,1956,[ 64 191 100 318  50],458,4,8273,4.227388860500766,20.0,40.0
41957,4,1957,[ 64 191 100 318  50],387,3,8276,4.226762002042901,20.0,40.0
41958,4,1958,[ 64 191 100 318  50],194,4,8280,4.226646248085758,20.0,40.0
41959,4,1959,[ 64 191 100 318  50],455,4,8284,4.226530612244898,20.0,40.0
41960,4,1960,[ 64 191 100 318  50],144,5,8289,4.226925038245793,20.0,40.0
41961,4,1961,[ 64 191 100 318  50],454,5,8294,4.227319062181447,20.0,40.0
41962,4,1962,[ 64 191 100 318  50],233,4,8298,4.227203260315843,20.0,40.0
41963,4,1963,[ 64 191 100 318  50],524,4,8302,4.227087576374745,20.0,40.0
41964,4,1964,[ 64 191 100 318  50],318,4,8306,4.226972010178117,20.0,40.0
41965,4,1965,[ 64 191 100 318  50],233,4,8310,4.2268565615462865,20.0,40.0
41966,4,1966,[ 64 191 100 318  50],533,5,8315,4.227249618708694,20.0,40.0
41967,4,1967,[ 64 191 100 318  50],232,5,8320,4.227642276422764,20.0,40.0
41968,4,1968,[ 64 191 100 318  50],6,5,8325,4.228034535297105,20.0,40.0
41969,4,1969,[ 64 191 100 318  50],194,4,8329,4.227918781725888,20.0,40.0
41970,4,1970,[ 64 191 100 318  50],387,3,8332,4.2272957889396245,20.0,40.0
41971,4,1971,[ 64 191 100 318  50],452,5,8337,4.2276876267748476,20.0,40.0
41972,4,1972,[ 64 191 100 318  50],452,5,8342,4.228079067410036,20.0,40.0
41973,4,1973,[ 64 191 100 318  50],454,5,8347,4.228470111448835,20.0,40.0
41974,4,1974,[ 64 191 100 318  50],406,5,8352,4.228860759493671,20.0,40.0
41975,4,1975,[ 64 191 100 318  50],664,4,8356,4.228744939271255,20.0,40.0
41976,4,1976,[ 64 191 100 318  50],92,4,8360,4.22862923621649,20.0,40.0
41977,4,1977,[ 64 191 100 318  50],465,4,8364,4.228513650151668,20.0,40.0
41978,4,1978,[ 64 191 100 318  50],7,5,8369,4.228903486609399,20.0,40.0
41979,4,1979,[ 64 191 100 318  50],537,4,8373,4.2287878787878785,20.0,40.0
41980,4,1980,[ 64 191 100 318  50],7,5,8378,4.229177183240788,20.0,40.0
41981,4,1981,[ 64 191 100 318  50],85,4,8382,4.229061553985873,20.0,40.0
41982,4,1982,[ 64 191 100 318  50],13,3,8385,4.228441754916792,20.0,40.0
41983,4,1983,[ 64 191 100 318  50],458,4,8389,4.228326612903226,20.0,40.0
41984,4,1984,[ 64 191 100 318  50],387,3,8392,4.227707808564232,20.0,40.0
41985,4,1985,[ 64 191 100 318  50],343,5,8397,4.22809667673716,20.0,40.0
41986,4,1986,[ 64 191 100 318  50],7,5,8402,4.2284851534977355,20.0,40.0
41987,4,1987,[151 216  98 748  50],883,4,8406,4.2283702213279675,0.0,40.0
41988,4,1988,[ 64 191 100 318  50],194,4,8410,4.228255404725993,20.0,40.0
41989,4,1989,[ 64 191 100 318  50],144,5,8415,4.228643216080402,20.0,40.0
41990,4,1990,[ 64 191 100 318  50],6,5,8420,4.229030637870417,20.0,40.0
41991,4,1991,[176 197 202 195  11],881,4,8424,4.228915662650603,0.0,0.0
41992,4,1992,[ 64 191 100 318  50],92,4,8428,4.228800802809834,20.0,40.0
41993,4,1993,[ 64 191 100 318  50],311,4,8432,4.228686058174524,20.0,40.0
41994,4,1994,[ 64 191 100 318  50],406,5,8437,4.2290726817042605,20.0,40.0
41995,4,1995,[ 64 191 100 318  50],308,5,8442,4.229458917835672,20.0,40.0
41996,4,1996,[ 64 191 100 318  50],488,3,8445,4.228843264897346,20.0,40.0
41997,4,1997,[ 64 191 100 318  50],378,5,8450,4.2292292292292295,20.0,40.0
41998,4,1998,[ 64 191 100 318  50],92,4,8454,4.229114557278639,20.0,40.0
41999,4,1999,[ 64 191 100 318  50],343,5,8459,4.2295,20.0,40.0
42000,4,2000,[ 64 191 100 318  50],455,4,8463,4.229385307346327,20.0,40.0
42001,4,2001,[ 64 191 100 318  50],92,4,8467,4.22927072927073,20.0,40.0
42002,4,2002,[ 64 191 100 318  50],59,5,8472,4.229655516724913,20.0,40.0
42003,4,2003,[ 64 191 100 318  50],653,5,8477,4.2300399201596806,20.0,40.0
42004,4,2004,[ 64 191 100 318  50],527,3,8480,4.229426433915212,20.0,40.0
42005,4,2005,[655 385 403 153 215],749,4,8484,4.229312063808575,0.0,0.0
42006,4,2006,[ 64 191 100 318  50],232,5,8489,4.229696063776781,20.0,40.0
42007,4,2007,[ 64 191 100 318  50],454,5,8494,4.2300796812749,20.0,40.0
42008,4,2008,[ 64 191 100 318  50],892,5,8499,4.230462916874067,20.0,40.0
42009,4,2009,[ 64 191 100 318  50],7,5,8504,4.230845771144279,20.0,40.0
42010,4,2010,[ 64 191 100 318  50],85,4,8508,4.230730979612133,20.0,40.0
42011,4,2011,[ 64 191 100 318  50],533,5,8513,4.231113320079523,20.0,40.0
42012,4,2012,[ 64 191 100 318  50],378,5,8518,4.231495280675609,20.0,40.0
42013,4,2013,[ 64 191 100 318  50],454,5,8523,4.231876861966236,20.0,40.0
42014,4,2014,[ 64 191 100 318  50],465,4,8527,4.231761786600496,20.0,40.0
42015,4,2015,[237 183 748 546 194],882,3,8530,4.2311507936507935,0.0,0.0
42016,4,2016,[ 64 191 100 318 183],82,4,8534,4.231036192364899,20.0,20.0
42017,4,2017,[ 64 191 100 318  50],666,4,8538,4.230921704658077,20.0,40.0
42018,4,2018,[ 64 191 100 318  50],488,3,8541,4.2303120356612185,20.0,40.0
42019,4,2019,[ 64 191 100 318  50],804,5,8546,4.2306930693069305,20.0,40.0
42020,4,2020,[ 64 191 100 318  50],85,4,8550,4.230578921326076,20.0,40.0
42021,4,2021,[ 64 191 100 318  50],234,5,8555,4.230959446092977,20.0,40.0
42022,4,2022,[ 64 191 100 318  50],311,4,8559,4.230845279288186,20.0,40.0
42023,4,2023,[ 64 191 100 318  50],313,5,8564,4.2312252964426875,20.0,40.0
42024,4,2024,[ 64 191 100 318  50],537,4,8568,4.231111111111111,20.0,40.0
42025,4,2025,[ 64 191 100 318  50],458,4,8572,4.230997038499506,20.0,40.0
42026,4,2026,[ 64 191 100 318  50],465,4,8576,4.230883078441046,20.0,40.0
42027,4,2027,[ 64 191 100 318  50],738,4,8580,4.230769230769231,20.0,40.0
42028,4,2028,[ 64 191 100 318  50],234,5,8585,4.231148348940365,20.0,40.0
42029,4,2029,[ 64 191 100 318  50],234,5,8590,4.231527093596059,20.0,40.0
42030,4,2030,[ 64 191 100 318  50],488,3,8593,4.230920728705072,20.0,40.0
42031,4,2031,[265 135 185 179 182],479,4,8597,4.230807086614173,0.0,0.0
42032,4,2032,[ 64 191 100 318  50],406,5,8602,4.231185440236104,20.0,40.0
42033,4,2033,[ 64 191 100 318  50],527,3,8605,4.230580137659784,20.0,40.0
42034,4,2034,[ 64 191 100 318  50],537,4,8609,4.23046683046683,20.0,40.0
42035,4,2035,[ 64 191 100 318  50],664,4,8613,4.230353634577603,20.0,40.0
42036,4,2036,[ 64  96  28 144 265],13,5,8618,4.23073146784487,0.0,0.0
42037,4,2037,[ 64 191 100 318  50],653,5,8623,4.231108930323847,20.0,40.0
42038,4,2038,[ 64 191 100 318  50],92,4,8627,4.230995586071604,20.0,40.0
42039,4,2039,[ 64 191 100 318  50],465,4,8631,4.230882352941176,20.0,40.0
42040,4,2040,[ 64 191 100 318  50],308,5,8636,4.231259186673199,20.0,40.0
42041,4,2041,[ 64 191 100 318  50],804,5,8641,4.231635651322233,20.0,40.0
42042,4,2042,[ 64 191 100 318  50],664,4,8645,4.231522271169848,20.0,40.0
42043,4,2043,[ 64 191 100 318  50],452,5,8650,4.231898238747553,20.0,40.0
42044,4,2044,[ 64 191 100 318  50],537,4,8654,4.231784841075795,20.0,40.0
42045,4,2045,[ 64 191 100 318  50],64,5,8659,4.232160312805474,20.0,40.0
42046,4,2046,[ 64 191 100 318  50],232,5,8664,4.232535417684416,20.0,40.0
42047,4,2047,[ 64 191 100 318  50],524,4,8668,4.232421875,20.0,40.0
42048,4,2048,[ 64 191 100 318  50],387,3,8671,4.231820400195217,20.0,40.0
42049,4,2049,[ 64 191 100 318  50],653,5,8676,4.23219512195122,20.0,40.0
42050,4,2050,[174 405 546   9 179],200,3,8679,4.231594344222331,0.0,20.0
42051,4,2051,[ 64 191 100 318  50],85,4,8683,4.231481481481482,20.0,40.0
42052,4,2052,[ 64 191 100 318  50],92,4,8687,4.231368728689723,20.0,40.0
42053,4,2053,[ 64 191 100 318  50],387,3,8690,4.230769230769231,20.0,40.0
42054,4,2054,[ 64 191 100 318  50],892,5,8695,4.231143552311435,20.0,40.0
42055,4,2055,[ 64 191 100 318  50],465,4,8699,4.231031128404669,20.0,40.0
42056,4,2056,[ 64 191 100 318  50],537,4,8703,4.230918813806515,20.0,40.0
42057,4,2057,[ 64 191 100 318  50],524,4,8707,4.230806608357629,20.0,40.0
42058,4,2058,[ 64 191 100 318  50],488,3,8710,4.2302088392423505,20.0,40.0
42059,4,2059,[ 64 191 100 318  50],13,3,8713,4.229611650485437,20.0,40.0
42060,4,2060,[ 64 191 100 318  50],233,4,8717,4.229500242600679,20.0,40.0
42061,4,2061,[ 64 191 100 318  50],194,4,8721,4.229388942774006,20.0,40.0
42062,4,2062,[ 64 191 100 318  50],311,4,8725,4.229277750848279,20.0,40.0
42063,4,2063,[ 64 191 100 318  50],7,5,8730,4.229651162790698,20.0,40.0
42064,4,2064,[ 64 191 100 318  50],85,4,8734,4.22953995157385,20.0,40.0
42065,4,2065,[ 64 191 100 318  50],474,5,8739,4.229912875121006,20.0,40.0
42066,4,2066,[ 64 191 100 318  50],313,5,8744,4.230285437832608,20.0,40.0
42067,4,2067,[ 64 191 100 318  50],455,4,8748,4.230174081237911,20.0,40.0
42068,4,2068,[ 64 191 100 318  50],184,5,8753,4.23054615756404,20.0,40.0
42069,4,2069,[ 64 191 100 318  50],188,4,8757,4.230434782608696,20.0,40.0
42070,4,2070,[ 64 191 100 318  50],378,5,8762,4.230806373732497,20.0,40.0
42071,4,2071,[ 64 191 100 318  50],234,5,8767,4.2311776061776065,20.0,40.0
42072,4,2072,[ 64 191 100 318  50],465,4,8771,4.231066087795465,20.0,40.0
42073,4,2073,[ 64 191 100 318  50],271,5,8776,4.231436837029894,20.0,40.0
42074,4,2074,[ 64 191 100 318  50],144,5,8781,4.231807228915662,20.0,40.0
42075,4,2075,[546 357 385   1 273],308,3,8784,4.23121387283237,20.0,0.0
42076,4,2076,[ 64 191 100 318  50],537,4,8788,4.231102551757342,20.0,40.0
42077,4,2077,[ 64 191 100 318  50],664,4,8792,4.230991337824832,20.0,40.0
42078,4,2078,[  1 195 257 678  88],749,3,8795,4.230399230399231,0.0,0.0
42079,4,2079,[ 64 191 100 318  50],318,4,8799,4.2302884615384615,20.0,40.0
42080,4,2080,[ 64 191 100 318  50],892,5,8804,4.230658337337818,20.0,40.0
42081,4,2081,[ 64 191 100 318  50],64,5,8809,4.231027857829011,20.0,40.0
42082,4,2082,[ 64 191 100 318  50],343,5,8814,4.231397023523764,20.0,40.0
42083,4,2083,[ 64 191 100 318  50],455,4,8818,4.231285988483685,20.0,40.0
42084,4,2084,[ 64 191 100 318  50],271,5,8823,4.231654676258993,20.0,40.0
42085,4,2085,[ 64 191 100 318  50],188,4,8827,4.231543624161074,20.0,40.0
42086,4,2086,[ 64 191 100 318  50],533,5,8832,4.2319118351701,20.0,40.0
42087,4,2087,[ 64 191 100 318  50],452,5,8837,4.23227969348659,20.0,40.0
42088,4,2088,[ 64 191 100 318  50],452,5,8842,4.232647199617042,20.0,40.0
42089,4,2089,[ 64 191 100 318  50],82,5,8847,4.233014354066985,20.0,40.0
42090,4,2090,[ 64 191 100 318  50],318,4,8851,4.232902917264466,20.0,40.0
42091,4,2091,[ 64 191 100 318  50],343,5,8856,4.233269598470363,20.0,40.0
42092,4,2092,[ 28   4 185  98   9],7,5,8861,4.233635929288103,0.0,20.0
42093,4,2093,[ 64 191 100 318  50],454,5,8866,4.234001910219675,20.0,40.0
42094,4,2094,[ 64 191 100 318  50],188,4,8870,4.233890214797136,20.0,40.0
42095,4,2095,[ 64 191 100 318  50],804,5,8875,4.23425572519084,20.0,40.0
42096,4,2096,[ 64 191 100 318  50],387,3,8878,4.233667143538388,20.0,40.0
42097,4,2097,[ 64 191 100 318  50],892,5,8883,4.234032411820782,20.0,40.0
42098,4,2098,[ 64 191 100 318  50],188,4,8887,4.2339209147212955,20.0,40.0
42099,4,2099,[ 64 191 100 318  50],13,3,8890,4.233333333333333,20.0,40.0
42100,4,2100,[ 64 191 100 318  50],82,5,8895,4.233698238933841,20.0,40.0
42101,4,2101,[508 265  56 496 222],343,4,8899,4.233587059942912,0.0,0.0
42102,4,2102,[ 64 191 100 318  50],738,4,8903,4.233475986685687,20.0,40.0
42103,4,2103,[ 64 191 100 318  50],318,4,8907,4.233365019011407,20.0,40.0
42104,4,2104,[ 64 191 100 318  50],452,5,8912,4.233729216152019,20.0,40.0
42105,4,2105,[ 64 191 100 318  50],738,4,8916,4.233618233618234,20.0,40.0
42106,4,2106,[179 111 132 121  96],378,3,8919,4.233032747982914,0.0,0.0
42107,4,2107,[ 64 191 100 318  50],465,4,8923,4.23292220113852,20.0,40.0
42108,4,2108,[ 64 191 100 318  50],378,5,8928,4.233285917496444,20.0,40.0
42109,4,2109,[181 405   9 289 427],328,4,8932,4.233175355450237,0.0,0.0
42110,4,2110,[ 64 191 100 318  50],232,5,8937,4.233538607295121,20.0,40.0
42111,4,2111,[ 64 191 100 318  50],653,5,8942,4.233901515151516,20.0,40.0
42112,4,2112,[ 64 191 100 318  50],452,5,8947,4.234264079507809,20.0,40.0
42113,4,2113,[ 64 191 100 318  50],64,5,8952,4.234626300851467,20.0,40.0
42114,4,2114,[ 64 191 100 318  50],892,5,8957,4.23498817966903,20.0,40.0
42115,4,2115,[ 64 191 100 318  50],232,5,8962,4.235349716446125,20.0,40.0
42116,4,2116,[ 64 191 100 318  50],7,5,8967,4.235710911667454,20.0,40.0
42117,4,2117,[ 64 191 100 318  50],653,5,8972,4.236071765816808,20.0,40.0
42118,4,2118,[180 269 318  56 286],7,4,8976,4.235960358659745,20.0,0.0
42119,4,2119,[ 64 191 100 318  50],474,5,8981,4.236320754716981,20.0,40.0
42120,4,2120,[ 64 191 100 318  50],64,5,8986,4.236680810938236,20.0,40.0
42121,4,2121,[ 64 191 100 318  50],233,4,8990,4.236569274269557,20.0,40.0
42122,4,2122,[300 496 111 172 125],749,4,8994,4.236457842675459,0.0,0.0
42123,4,2123,[ 64 191 100 318  50],308,5,8999,4.236817325800376,20.0,40.0
42124,4,2124,[ 64 191 100 318  50],524,4,9003,4.2367058823529415,20.0,40.0
42125,4,2125,[ 64 191 100 318  50],82,5,9008,4.237064910630291,20.0,40.0
42126,4,2126,[ 64 191 100 318  50],664,4,9012,4.236953455571227,20.0,40.0
42127,4,2127,[ 64 191 100 318  50],533,5,9017,4.237312030075188,20.0,40.0
42128,4,2128,[202 515  50 132 127],343,5,9022,4.237670267731329,0.0,40.0
42129,4,2129,[ 64 191 100 318  50],406,5,9027,4.238028169014084,20.0,40.0
42130,4,2130,[ 64 191 100 318  50],82,5,9032,4.238385734396997,20.0,40.0
42131,4,2131,[ 64 191 100 318  50],653,5,9037,4.238742964352721,20.0,40.0
42132,4,2132,[ 64 191 100 318  50],458,4,9041,4.238631036099391,20.0,40.0
42133,4,2133,[ 64 191 100 318  50],537,4,9045,4.2385192127460165,20.0,40.0
42134,4,2134,[423 174 111 222 195],64,5,9050,4.23887587822014,0.0,20.0
42135,4,2135,[ 64 191 100 318  50],892,5,9055,4.239232209737827,20.0,40.0
42136,4,2136,[ 64 191 100 318  50],234,5,9060,4.239588207767899,20.0,40.0
42137,4,2137,[ 64 191 100 318  50],666,4,9064,4.239476145930777,20.0,40.0
42138,4,2138,[ 64 191 100 318  50],184,5,9069,4.239831697054698,20.0,40.0
42139,4,2139,[ 64 191 100 318  50],59,5,9074,4.2401869158878505,20.0,40.0
42140,4,2140,[ 64 191 100 318  50],664,4,9078,4.24007473143391,20.0,40.0
42141,4,2141,[ 64 191 100 318  50],232,5,9083,4.2404295051353875,20.0,40.0
42142,4,2142,[ 64 191 100 318  50],313,5,9088,4.240783947736817,20.0,40.0
42143,4,2143,[ 64 191 100 318  50],524,4,9092,4.240671641791045,20.0,40.0
42144,4,2144,[ 64 191 100 318  50],804,5,9097,4.241025641025641,20.0,40.0
42145,4,2145,[ 64 191 100 318  50],524,4,9101,4.240913327120223,20.0,40.0
42146,4,2146,[ 64 191 100 318  50],234,5,9106,4.24126688402422,20.0,40.0
42147,4,2147,[ 64 191 100 318  50],64,5,9111,4.2416201117318435,20.0,40.0
42148,4,2148,[127 483  95 175 176],308,4,9115,4.2415076779897625,20.0,20.0
42149,4,2149,[191 194  82   7  98],308,4,9119,4.24139534883721,0.0,20.0
42150,4,2150,[ 64 191 100 318  50],452,5,9124,4.241748024174802,20.0,40.0
42151,4,2151,[ 64 191 100 318  50],537,4,9128,4.241635687732342,20.0,40.0
42152,4,2152,[ 64 191 100 318  50],232,5,9133,4.241987923827218,20.0,40.0
42153,4,2153,[ 64 191 100 318  50],92,4,9137,4.241875580315692,20.0,40.0
42154,4,2154,[ 64 191 100 318  50],232,5,9142,4.242227378190255,20.0,40.0
42155,4,2155,[ 64 191 100 318  50],527,3,9145,4.24165120593692,20.0,40.0
42156,4,2156,[180 289 237 151 435],788,3,9148,4.241075567918405,0.0,0.0
42157,4,2157,[ 64 191 100 318  50],524,4,9152,4.240963855421687,20.0,40.0
42158,4,2158,[215 496 258 191 435],749,5,9157,4.241315423807318,0.0,0.0
42159,4,2159,[ 64 191 100 318  50],465,4,9161,4.241203703703704,20.0,40.0
42160,4,2160,[ 64 191 100 318  50],271,5,9166,4.241554835724202,20.0,40.0
42161,4,2161,[ 64 191 100 318  50],7,5,9171,4.24190564292322,20.0,40.0
42162,4,2162,[ 64 191 100 318  50],92,4,9175,4.241793804900601,20.0,40.0
42163,4,2163,[496  97 173 385 132],897,3,9178,4.241219963031424,0.0,0.0
42164,4,2164,[ 64 191 100 318  50],13,3,9181,4.2406466512702075,20.0,40.0
42165,4,2165,[ 64 191 100 318  50],59,5,9186,4.240997229916897,20.0,40.0
42166,4,2166,[ 64 191 100 318  50],188,4,9190,4.240886017535764,20.0,40.0
42167,4,2167,[ 64 191 100 318  50],892,5,9195,4.2412361623616235,20.0,40.0
42168,4,2168,[ 64 191 100 318  50],465,4,9199,4.241124942369756,20.0,40.0
42169,4,2169,[ 64 191 100 318  50],144,5,9204,4.24147465437788,20.0,40.0
42170,4,2170,[ 64 191 100 318  50],271,5,9209,4.241824044219253,20.0,40.0
42171,4,2171,[ 64 191 100 318  50],378,5,9214,4.242173112338858,20.0,40.0
42172,4,2172,[ 64 191 100 318  50],454,5,9219,4.242521859180856,20.0,40.0
42173,4,2173,[385   1 175 180 168],279,3,9222,4.241950321987121,0.0,0.0
42174,4,2174,[ 64 191 100 318  50],313,5,9227,4.242298850574713,20.0,40.0
42175,4,2175,[ 64 191 100 318  50],454,5,9232,4.242647058823529,20.0,40.0
42176,4,2176,[ 64 191 100 318  50],6,5,9237,4.242994947175012,20.0,40.0
42177,4,2177,[ 64 191 100 318  50],343,5,9242,4.243342516069789,20.0,40.0
42178,4,2178,[ 64 191 100 318  50],7,5,9247,4.243689765947682,20.0,40.0
42179,4,2179,[ 64 191 100 318  50],271,5,9252,4.244036697247706,20.0,40.0
42180,4,2180,[ 64 191 100 318  50],184,5,9257,4.24438331040807,20.0,40.0
42181,4,2181,[ 64 191 100 318  50],664,4,9261,4.244271310724106,20.0,40.0
42182,4,2182,[ 64 191 100 318  50],85,4,9265,4.244159413650939,20.0,40.0
42183,4,2183,[ 64 191 100 318  50],13,3,9268,4.243589743589744,20.0,40.0
42184,4,2184,[403 588  71 655 742],881,3,9271,4.243020594965675,0.0,0.0
42185,4,2185,[ 64 191 100 318  50],452,5,9276,4.243366880146386,20.0,40.0
42186,4,2186,[ 64 191 100 318  50],458,4,9280,4.243255601280293,20.0,40.0
42187,4,2187,[ 64 191 100 318  50],406,5,9285,4.243601462522852,20.0,40.0
42188,4,2188,[ 64 191 100 318  50],527,3,9288,4.243033348560987,20.0,40.0
42189,4,2189,[ 64 191 100 318  50],474,5,9293,4.24337899543379,20.0,40.0
42190,4,2190,[ 64 191 100 318  50],892,5,9298,4.243724326791419,20.0,40.0
42191,4,2191,[ 64 191 100 318  50],738,4,9302,4.243613138686132,20.0,40.0
42192,4,2192,[ 64 191 100 318  50],194,4,9306,4.243502051983584,20.0,40.0
42193,4,2193,[ 64 191 100 318  50],233,4,9310,4.243391066545123,20.0,40.0
42194,4,2194,[ 64 191 100 318  50],524,4,9314,4.243280182232346,20.0,40.0
42195,4,2195,[ 64 191 100 318  50],82,5,9319,4.2436247723132965,20.0,40.0
42196,4,2196,[ 64 191 100 318  50],387,3,9322,4.243058716431498,20.0,40.0
42197,4,2197,[  4 435 200  82  64],59,5,9327,4.243403093721565,0.0,0.0
42198,4,2198,[ 64 191 100 318  50],387,3,9330,4.242837653478854,20.0,40.0
42199,4,2199,[ 64 191 100 318  50],406,5,9335,4.243181818181818,20.0,40.0
42200,4,2200,[ 64 191 100 318  50],458,4,9339,4.243071331213085,20.0,40.0
42201,4,2201,[ 64 191 100 318  50],454,5,9344,4.243415077202543,20.0,40.0
42202,4,2202,[ 64 191 100 318  50],738,4,9348,4.243304584657285,20.0,40.0
42203,4,2203,[ 64 191 100 318  50],378,5,9353,4.243647912885662,20.0,40.0
42204,4,2204,[ 64 191 100 318  50],6,5,9358,4.243990929705215,20.0,40.0
42205,4,2205,[ 64 191 100 318  50],452,5,9363,4.244333635539438,20.0,40.0
42206,4,2206,[ 64 191 100 318  50],454,5,9368,4.244676030811056,20.0,40.0
42207,4,2207,[ 64 191 100 318  50],387,3,9371,4.24411231884058,20.0,40.0
42208,4,2208,[ 64 191 100 318  50],232,5,9376,4.244454504300588,20.0,40.0
42209,4,2209,[ 64 191 100 318  50],13,3,9379,4.243891402714932,20.0,40.0
42210,4,2210,[ 64 191 100 318  50],82,5,9384,4.244233378561737,20.0,40.0
42211,4,2211,[ 64 191 100 318  50],188,4,9388,4.244122965641953,20.0,40.0
42212,4,2212,[ 64 191 100 318  50],524,4,9392,4.244012652507908,20.0,40.0
42213,4,2213,[ 64 191 100 318  50],313,5,9397,4.244354110207769,20.0,40.0
42214,4,2214,[ 64 191 100 318  50],92,4,9401,4.244243792325056,20.0,40.0
42215,4,2215,[ 64 191 100 318  50],664,4,9405,4.24413357400722,20.0,40.0
42216,4,2216,[ 64 191 100 318  50],85,4,9409,4.244023455119531,20.0,40.0
42217,4,2217,[ 64 191 100 318  50],6,5,9414,4.244364292155095,20.0,40.0
42218,4,2218,[ 64 191 100 318  50],85,4,9418,4.24425416854439,20.0,40.0
42219,4,2219,[ 64 191 100 318  50],524,4,9422,4.244144144144144,20.0,40.0
42220,4,2220,[ 64 191 100 318  50],666,4,9426,4.244034218820351,20.0,40.0
42221,4,2221,[ 64 191 100 318  50],184,5,9431,4.244374437443744,20.0,40.0
42222,4,2222,[ 64 191 100 318  50],308,5,9436,4.2447143499775075,20.0,40.0
42223,4,2223,[ 64 191 100 318  50],666,4,9440,4.244604316546763,20.0,40.0
42224,4,2224,[ 64 191 100 318  50],653,5,9445,4.244943820224719,20.0,40.0
42225,4,2225,[ 64 191 100 318  50],144,5,9450,4.245283018867925,20.0,40.0
42226,4,2226,[ 64 191 100 318  50],455,4,9454,4.24517287831163,20.0,40.0
42227,4,2227,[ 64 191 100 318  50],184,5,9459,4.245511669658887,20.0,40.0
42228,4,2228,[ 64 191 100 318  50],474,5,9464,4.245850157021086,20.0,40.0
42229,4,2229,[ 64 191 100 318  50],311,4,9468,4.245739910313901,20.0,40.0
42230,4,2230,[204 100 151 302 117],339,3,9471,4.245181532944867,0.0,20.0
42231,4,2231,[238 161 318 222  89],380,2,9473,4.244175627240144,20.0,0.0
42232,4,2232,[ 64 191 100 318 302],454,5,9478,4.244514106583072,20.0,20.0
42233,4,2233,[ 64 302 191 100 318],6,5,9483,4.244852282900626,20.0,20.0
42234,4,2234,[302  64 191 100 318],454,5,9488,4.245190156599553,20.0,20.0
42235,4,2235,[302  64 191 100 318],343,5,9493,4.245527728085867,20.0,20.0
42236,4,2236,[302  64 191 100 318],474,5,9498,4.245864997764864,20.0,20.0
42237,4,2237,[ 50  25 273  70 168],537,3,9501,4.245308310991957,0.0,20.0
42238,4,2238,[302  64 191 100 318],537,4,9505,4.245198749441715,20.0,20.0
42239,4,2239,[302  64 191 100 318],454,5,9510,4.245535714285714,20.0,20.0
42240,4,2240,[302  64 191 100 318],458,5,9515,4.245872378402499,20.0,20.0
42241,4,2241,[302  64 191 100 318],605,5,9520,4.24620874219447,20.0,20.0
42242,4,2242,[302  64 191 100 318],271,5,9525,4.246544806063308,20.0,20.0
42243,4,2243,[302  64 191 100 318],144,4,9529,4.246434937611408,20.0,20.0
42244,4,2244,[ 64 302 191 100 318],90,5,9534,4.246770601336303,20.0,20.0
42245,4,2245,[302  64 191 100 318],458,5,9539,4.247105966162066,20.0,20.0
42246,4,2246,[302  64 191 100 318],90,5,9544,4.247441032487761,20.0,20.0
42247,4,2247,[302  64 191 100 318],271,5,9549,4.247775800711744,20.0,20.0
42248,4,2248,[313 132 245 215 179],200,4,9553,4.2476656291685195,0.0,0.0
42249,4,2249,[302  64 191 100 318],13,3,9556,4.247111111111111,20.0,20.0
42250,4,2250,[302  64 191 100 318],458,5,9561,4.247445579742337,20.0,20.0
42251,4,2251,[302  64 191 100 318],13,3,9564,4.246891651865009,20.0,20.0
42252,4,2252,[302  64 191 100 318],666,5,9569,4.24722592099423,20.0,20.0
42253,4,2253,[302  64 191 100 318],207,4,9573,4.247116237799467,20.0,20.0
42254,4,2254,[302  64 191 100 318],474,5,9578,4.247450110864745,20.0,20.0
42255,4,2255,[288  22   1  25 289],13,1,9579,4.246010638297872,0.0,0.0
42256,4,2256,[302  64 191 100 318],343,5,9584,4.246344705361099,20.0,20.0
42257,4,2257,[302  64 191 100 318],537,4,9588,4.246235606731621,20.0,20.0
42258,4,2258,[302  64 191 100 318],271,5,9593,4.246569278441789,20.0,20.0
42259,4,2259,[302  64 191 100 318],6,5,9598,4.246902654867257,20.0,20.0
42260,4,2260,[302  64 191 100 318],378,5,9603,4.247235736399823,20.0,20.0
42261,4,2261,[ 79 235 496 183 132],882,4,9607,4.247126436781609,0.0,0.0
42262,4,2262,[234 176 265  11 245],328,4,9611,4.247017233760495,0.0,0.0
42263,4,2263,[302  64 191 100 318],474,5,9616,4.247349823321555,20.0,20.0
42264,4,2264,[302  64 191 100 318],524,4,9620,4.247240618101546,20.0,20.0
42265,4,2265,[173 176  22 234 258],234,2,9622,4.2462488967343335,0.0,0.0
42266,4,2266,[302  64 191 100 318],524,4,9626,4.246140273489193,20.0,20.0
42267,4,2267,[302  64 191 100 318],605,5,9631,4.24647266313933,20.0,20.0
42268,4,2268,[302  64 191 100 318],605,5,9636,4.246804759806082,20.0,20.0
42269,4,2269,[302  64 191 100 318],6,5,9641,4.247136563876652,20.0,20.0
42270,4,2270,[302  64 191 100 318],6,5,9646,4.247468075737561,20.0,20.0
42271,4,2271,[  8   9 403  56 546],87,3,9649,4.246919014084507,0.0,0.0
42272,4,2272,[302  64 191 100 318],207,4,9653,4.246810382754069,20.0,20.0
42273,4,2273,[302  64 191 100 318],232,5,9658,4.247141600703606,20.0,20.0
42274,4,2274,[302  64 191 100 318],458,5,9663,4.247472527472527,20.0,20.0
42275,4,2275,[  8 211 125 405 427],271,3,9666,4.246924428822496,0.0,0.0
42276,4,2276,[318 288 196 286 187],537,2,9668,4.245937637241985,20.0,0.0
42277,4,2277,[302  64   8 191 100],232,4,9672,4.245829675153644,0.0,20.0
42278,4,2278,[238 121  50 180 403],479,4,9676,4.245721807810443,0.0,20.0
42279,4,2279,[302  64 191 100 318],378,5,9681,4.246052631578947,20.0,20.0
42280,4,2280,[302  64 191 100 318],474,5,9686,4.246383165278386,20.0,20.0
42281,4,2281,[302  64 191 100 318],537,4,9690,4.246275197195443,20.0,20.0
42282,4,2282,[302  64 191 100 318],207,4,9694,4.24616732369689,20.0,20.0
42283,4,2283,[302  64 191 100 318],474,5,9699,4.246497373029772,20.0,20.0
42284,4,2284,[302  64 191 100 318],537,4,9703,4.2463894967177245,20.0,20.0
42285,4,2285,[302  64 191 100 318],378,5,9708,4.246719160104987,20.0,20.0
42286,4,2286,[ 89 185   1 235 403],64,4,9712,4.246611281154351,0.0,0.0
42287,4,2287,[302  64 191 100 318],666,5,9717,4.246940559440559,20.0,20.0
42288,4,2288,[302  64 191 100 318],458,5,9722,4.247269550021843,20.0,20.0
42289,4,2289,[302  64 191 100 318],454,5,9727,4.247598253275109,20.0,20.0
42290,4,2290,[300 427 174 475  56],13,3,9730,4.247053688345701,0.0,20.0
42291,4,2291,[302  64 191 100 318],454,5,9735,4.24738219895288,20.0,20.0
42292,4,2292,[302  64 191 100 318],343,5,9740,4.247710423026603,20.0,20.0
42293,4,2293,[210 100   4 403 742],795,3,9743,4.24716652136007,0.0,20.0
42294,4,2294,[302  64 191 100 318],474,5,9748,4.247494553376907,20.0,20.0
42295,4,2295,[302  64 191 100 318],458,5,9753,4.247822299651568,20.0,20.0
42296,4,2296,[302  64 191 100 318],537,4,9757,4.247714410100131,20.0,20.0
42297,4,2297,[302  64 191 100 318],664,4,9761,4.247606614447346,20.0,20.0
42298,4,2298,[ 88 228 204 161 197],313,3,9764,4.247063940843845,0.0,0.0
42299,4,2299,[302  64 191 100 318],343,5,9769,4.247391304347826,20.0,20.0
42300,4,2300,[302  64 191 100 318],378,5,9774,4.247718383311604,20.0,20.0
42301,4,2301,[302  64 191 100 318],207,4,9778,4.247610773240661,20.0,20.0
42302,4,2302,[302  64 191 100 318],271,5,9783,4.247937472861485,20.0,20.0
42303,4,2303,[302  64 191 100 318],90,5,9788,4.248263888888889,20.0,20.0
42304,4,2304,[  8 471 603 127  25],271,3,9791,4.247722342733189,20.0,20.0
42305,4,2305,[302  64 191 100 318],144,4,9795,4.247614917606245,20.0,20.0
42306,4,2306,[ 89 179 385 127  82],843,2,9797,4.246640658864326,0.0,20.0
42307,4,2307,[302  64 191 100 318],232,5,9802,4.246967071057193,20.0,20.0
42308,4,2308,[302  64 191 100 318],524,4,9806,4.2468601126028585,20.0,20.0
42309,4,2309,[302  64 191 100 318],207,4,9810,4.246753246753247,20.0,20.0
42310,4,2310,[302  64 191 100 318],537,4,9814,4.246646473388144,20.0,20.0
42311,4,2311,[302  64 191 100 318],207,4,9818,4.246539792387543,20.0,20.0
42312,4,2312,[204   4 211 216 546],650,3,9821,4.2460008646779075,0.0,0.0
42313,4,2313,[302  64 191 100 318],232,5,9826,4.246326707000864,20.0,20.0
42314,4,2314,[515 168 237 196 173],882,5,9831,4.2466522678185745,0.0,0.0
42315,4,2315,[302  64 191 100 318],343,5,9836,4.246977547495682,20.0,20.0
42316,4,2316,[302  64 191 100 318],524,4,9840,4.246870953819594,20.0,20.0
42317,4,2317,[302  64 191 100 318],232,5,9845,4.2471958584987055,20.0,20.0
42318,4,2318,[  4  97   7  25 118],795,3,9848,4.246658042259595,0.0,0.0
42319,4,2319,[302  64 191 100 318],6,5,9853,4.24698275862069,20.0,20.0
42320,4,2320,[302  64 191 100 318],605,5,9858,4.247307195174494,20.0,20.0
42321,4,2321,[175  98 211 275 135],6,5,9863,4.247631352282515,0.0,20.0
42322,4,2322,[385 143 174  97  28],95,5,9868,4.24795523030564,0.0,20.0
42323,4,2323,[302  64 191 100 318],144,4,9872,4.247848537005163,20.0,20.0
42324,4,2324,[302  64 191 100 318],13,3,9875,4.247311827956989,20.0,20.0
42325,4,2325,[302  64 191 100 318],474,5,9880,4.247635425623388,20.0,20.0
42326,4,2326,[302  64 191 100 318],537,4,9884,4.247529007305544,20.0,20.0
42327,4,2327,[302  64 191 100 318],454,5,9889,4.2478522336769755,20.0,20.0
42328,4,2328,[302  64 191 100 318],271,5,9894,4.248175182481752,20.0,20.0
42329,4,2329,[302  64 191 100 318],458,5,9899,4.248497854077253,20.0,20.0
42330,4,2330,[117 234 385 210 238],13,1,9900,4.2471042471042475,0.0,0.0
42331,4,2331,[302  64 191 100 318],232,5,9905,4.247427101200686,20.0,20.0
42332,4,2332,[302  64 191 100 318],664,4,9909,4.2473210458636945,20.0,20.0
42333,4,2333,[302  64 191 100 318],271,5,9914,4.24764353041988,20.0,20.0
42334,4,2334,[100 185 179 742 197],833,3,9917,4.247109207708779,0.0,20.0
42335,4,2335,[302  64 191 100 318],343,5,9922,4.247431506849315,20.0,20.0
42336,4,2336,[302  64 191 100 318],458,5,9927,4.2477535301668805,20.0,20.0
42337,4,2337,[742 183 385 174 197],207,3,9930,4.247219846022241,0.0,20.0
42338,4,2338,[302  64 191 100 318],454,5,9935,4.247541684480547,20.0,20.0
42339,4,2339,[302  64 191 100 318],474,5,9940,4.247863247863248,20.0,20.0
42340,4,2340,[357 174   7 168 132],6,4,9944,4.247757368645878,20.0,20.0
42341,4,2341,[302  64 191 100 318],458,5,9949,4.248078565328779,20.0,20.0
42342,4,2342,[302  64 191 100 318],232,5,9954,4.2483994878361075,20.0,20.0
42343,4,2343,[302  64 191 100 318],666,5,9959,4.248720136518771,20.0,20.0
42344,4,2344,[302  64 191 100 318],474,5,9964,4.249040511727079,20.0,20.0
42345,4,2345,[302  64 191 100 318],232,5,9969,4.249360613810742,20.0,20.0
42346,4,2346,[655 195 202 174 515],311,5,9974,4.2496804431188755,0.0,20.0
42347,4,2347,[333 186 117 161 173],13,2,9976,4.248722316865417,0.0,0.0
42348,4,2348,[302  64 191 100 318],664,4,9980,4.248616432524479,20.0,20.0
42349,4,2349,[257 216  88 655 269],659,3,9983,4.2480851063829785,0.0,0.0
42350,4,2350,[302  64 191 100 318],454,5,9988,4.248404934070608,20.0,20.0
42351,4,2351,[302  64 191 100 318],666,5,9993,4.248724489795919,20.0,20.0
42352,4,2352,[302  64 191 100 318],343,5,9998,4.249043773905653,20.0,20.0
42353,4,2353,[216 202 273 268 435],13,3,10001,4.248513169073917,0.0,0.0
42354,4,2354,[302  64 191 100 318],271,5,10006,4.2488322717622085,20.0,20.0
42355,4,2355,[302  64 191 100 318],343,5,10011,4.249151103565365,20.0,20.0
42356,4,2356,[168 153 234 603  88],738,3,10014,4.248621128553245,20.0,0.0
42357,4,2357,[302  64 191 100 318],271,5,10019,4.248939779474131,20.0,20.0
42358,4,2358,[302  64 191 100 318],6,5,10024,4.249258160237389,20.0,20.0
42359,4,2359,[302  64 191 100 318],232,5,10029,4.249576271186441,20.0,20.0
42360,4,2360,[302  64 191 100 318],6,5,10034,4.249894112664125,20.0,20.0
42361,4,2361,[302  64 191 100 318],144,4,10038,4.249788314987299,20.0,20.0
42362,4,2362,[302  64 191 100 318],207,4,10042,4.249682606855692,20.0,20.0
42363,4,2363,[302  64 191 100 318],458,5,10047,4.25,20.0,20.0
42364,4,2364,[174 323 186 204  97],650,3,10050,4.249471458773784,0.0,20.0
42365,4,2365,[ 96 294  28  95 427],882,5,10055,4.249788672865596,0.0,0.0
42366,4,2366,[302  64 191 100 318],524,4,10059,4.249683143219265,20.0,20.0
42367,4,2367,[515   7 186  12 168],380,3,10062,4.249155405405405,20.0,0.0
42368,4,2368,[ 69 211  50  97 258],380,3,10065,4.248628113127902,0.0,20.0
42369,4,2369,[302  64 191 100 318],666,5,10070,4.248945147679325,20.0,20.0
42370,4,2370,[302  64 191 100 318],474,5,10075,4.24926191480388,20.0,20.0
42371,4,2371,[302  64 191 100 318],474,5,10080,4.249578414839798,20.0,20.0
42372,4,2372,[302  64 191 100 318],537,4,10084,4.249473240623683,20.0,20.0
42373,4,2373,[135 403  96 176 655],378,4,10088,4.249368155012637,0.0,0.0
42374,4,2374,[ 88   7 179 228 483],200,5,10093,4.249684210526316,20.0,0.0
42375,4,2375,[568 678 588 515  95],804,4,10097,4.249579124579125,0.0,0.0
42376,4,2376,[302  64 191 100 318],6,5,10102,4.2498948254101805,20.0,20.0
42377,4,2377,[302  64 191 100 318],13,3,10105,4.249369217830109,20.0,20.0
42378,4,2378,[302  64 191 100 318],605,5,10110,4.249684741488021,20.0,20.0
42379,4,2379,[302  64 191 100 318],90,5,10115,4.25,20.0,20.0
42380,4,2380,[508  96  69 127 483],533,5,10120,4.250314993700126,20.0,20.0
42381,4,2381,[ 88 288 161 185 475],339,3,10123,4.249790092359362,0.0,0.0
42382,4,2382,[234 515 202  89 216],543,5,10128,4.250104909777591,0.0,0.0
42383,4,2383,[302  64 191 100 318],207,4,10132,4.25,20.0,20.0
42384,4,2384,[302  64 191 100 318],666,5,10137,4.250314465408805,20.0,20.0
42385,4,2385,[302  64 191 100 318],90,5,10142,4.250628667225482,20.0,20.0
42386,4,2386,[302  64 191 100 318],474,5,10147,4.250942605781315,20.0,20.0
42387,4,2387,[302  64 191 100 318],271,5,10152,4.251256281407035,20.0,20.0
42388,4,2388,[302  64 191 100 318],537,4,10156,4.251151109250732,20.0,20.0
42389,4,2389,[302  64 191 100 318],378,5,10161,4.251464435146444,20.0,20.0
42390,4,2390,[302  64 191 100 318],13,3,10164,4.250941028858218,20.0,20.0
42391,4,2391,[302  64 191 100 318],90,5,10169,4.2512541806020065,20.0,20.0
42392,4,2392,[302  64 191 100 318],474,5,10174,4.25156707062265,20.0,20.0
42393,4,2393,[302  64 191 100 318],664,4,10178,4.251461988304094,20.0,20.0
42394,4,2394,[302  64 191 100 318],537,4,10182,4.251356993736952,20.0,20.0
42395,4,2395,[302  64 191 100 318],537,4,10186,4.251252086811352,20.0,20.0
42396,4,2396,[302  64 191 100 318],666,5,10191,4.251564455569461,20.0,20.0
42397,4,2397,[302  64 191 100 318],13,3,10194,4.251042535446206,20.0,20.0
42398,4,2398,[234 181 186 121 144],638,5,10199,4.251354731137974,0.0,0.0
42399,4,2399,[ 64 234  12 168 100],271,4,10203,4.25125,20.0,20.0
42400,4,2400,[ 22 276 216 403  89],13,3,10206,4.2507288629737605,0.0,0.0
42401,4,2401,[302  64 191 100 318],664,4,10210,4.250624479600333,20.0,20.0
42402,4,2402,[302  64 191 100 318],454,5,10215,4.250936329588015,20.0,20.0
42403,4,2403,[302  64 191 100 318],207,4,10219,4.250831946755408,20.0,20.0
42404,4,2404,[286 117  25 127 483],537,2,10221,4.24989604989605,20.0,20.0
42405,4,2405,[302  64 191 100 318],271,5,10226,4.250207813798836,20.0,20.0
42406,4,2406,[302  64 191 100 318],605,5,10231,4.250519318653926,20.0,20.0
42407,4,2407,[302  64 191 100 318],13,3,10234,4.25,20.0,20.0
42408,4,2408,[302  64 191 100 318],90,5,10239,4.250311332503113,20.0,20.0
42409,4,2409,[ 88  56 168 194 182],326,1,10240,4.24896265560166,0.0,0.0
42410,4,2410,[302  64 191 100 318],524,4,10244,4.24885939444214,20.0,20.0
42411,4,2411,[302  64 191 100 318],13,3,10247,4.2483416252072965,20.0,20.0
42412,4,2412,[302  64 191 100 318],605,5,10252,4.248653128885205,20.0,20.0
42413,4,2413,[302  64 191 100 318],13,3,10255,4.248135874067937,20.0,20.0
42414,4,2414,[302  64 191 100 318],454,5,10260,4.248447204968944,20.0,20.0
42415,4,2415,[111 282 323 257 118],552,0,10260,4.246688741721854,0.0,0.0
42416,4,2416,[302  64 191 100 318],90,5,10265,4.247000413736036,20.0,20.0
42417,4,2417,[100 508  70 323 496],474,3,10268,4.246484698097602,0.0,20.0
42418,4,2418,[216 187 183 318 273],144,5,10273,4.246796196775527,20.0,0.0
42419,4,2419,[302  64 191 100 318],6,5,10278,4.247107438016529,20.0,20.0
42420,4,2420,[302  64 191 100 318],6,5,10283,4.247418422139612,20.0,20.0
42421,4,2421,[748 121  69 173  25],648,2,10285,4.246490503715937,0.0,0.0
42422,4,2422,[ 22 197  25  82 385],59,5,10290,4.246801485761453,0.0,0.0
42423,4,2423,[302  64 191 100 318],207,4,10294,4.246699669966997,20.0,20.0
42424,4,2424,[302  64 191 100 318],144,4,10298,4.24659793814433,20.0,20.0
42425,4,2425,[302  64 191 100 318],605,5,10303,4.246908491343776,20.0,20.0
42426,4,2426,[302  64 191 100 318],474,5,10308,4.247218788627936,20.0,20.0
42427,4,2427,[302  64 191 100 318],474,5,10313,4.247528830313015,20.0,20.0
42428,4,2428,[302  64 191 100 318],343,5,10318,4.247838616714698,20.0,20.0
42429,4,2429,[302  64 191 100 318],605,5,10323,4.2481481481481485,20.0,20.0
42430,4,2430,[302  64 191 100 318],524,4,10327,4.248046071575484,20.0,20.0
42431,4,2431,[ 69 322 182 385 258],533,4,10331,4.247944078947368,0.0,0.0
42432,4,2432,[302  64 191 100 318],378,5,10336,4.248253185367859,20.0,20.0
42433,4,2433,[117   1  79 289 302],537,1,10337,4.246918652423993,0.0,0.0
42434,4,2434,[200 187 588  69 597],897,5,10342,4.247227926078029,0.0,0.0
42435,4,2435,[302  64 191 100 318],271,5,10347,4.247536945812808,20.0,20.0
42436,4,2436,[483 180 228   4 197],7,5,10352,4.2478457119409105,20.0,0.0
42437,4,2437,[302  64 191 100 318],90,5,10357,4.248154224774405,20.0,20.0
42438,4,2438,[302  64 191 100 318],90,5,10362,4.248462484624846,20.0,20.0
42439,4,2439,[302  64 191 100 318],144,4,10366,4.248360655737705,20.0,20.0
42440,4,2440,[302  64 191 100 318],90,5,10371,4.248668578451454,20.0,20.0
42441,4,2441,[302  64 191 100 318],271,5,10376,4.248976248976249,20.0,20.0
42442,4,2442,[302  64 191 100 318],454,5,10381,4.249283667621777,20.0,20.0
42443,4,2443,[258 144 288 333 117],343,2,10383,4.248363338788871,0.0,0.0
42444,4,2444,[302  64 191 100 318],13,3,10386,4.247852760736197,20.0,20.0
42445,4,2445,[302  64 191 100 318],271,5,10391,4.248160261651676,20.0,20.0
42446,4,2446,[302  64 191 100 318],666,5,10396,4.248467511238251,20.0,20.0
42447,4,2447,[302  64 191 100 318],13,3,10399,4.247957516339869,20.0,20.0
42448,4,2448,[302  64 191 100 318],207,4,10403,4.247856267864434,20.0,20.0
42449,4,2449,[302  64 191 100 318],90,5,10408,4.248163265306123,20.0,20.0
42450,4,2450,[302  64 191 100 318],666,5,10413,4.248470012239902,20.0,20.0
42451,4,2451,[322 185 174 286  95],881,4,10417,4.24836867862969,0.0,20.0
42452,4,2452,[302  64 191 100 318],454,5,10422,4.248675091724419,20.0,20.0
42453,4,2453,[ 98 179 180 276 132],10,5,10427,4.2489812550937245,0.0,20.0
42454,4,2454,[302  64 191 100 318],207,4,10431,4.24887983706721,20.0,20.0
42455,4,2455,[302  64 191 100 318],144,4,10435,4.2487785016286646,20.0,20.0
42456,4,2456,[302  64 191 100 318],524,4,10439,4.248677248677248,20.0,20.0
42457,4,2457,[302  64 191 100 318],537,4,10443,4.248576078112286,20.0,20.0
42458,4,2458,[603 235 132 288 597],650,2,10445,4.2476616510776735,20.0,0.0
42459,4,2459,[302  64 191 100 318],207,4,10449,4.2475609756097565,20.0,20.0
42460,4,2460,[302  64 191 100 318],6,5,10454,4.247866720845185,20.0,20.0
42461,4,2461,[302  64 191 100 318],537,4,10458,4.247766043866775,20.0,20.0
42462,4,2462,[302  64 191 100 318],378,5,10463,4.248071457572067,20.0,20.0
42463,4,2463,[302  64 191 100 318],207,4,10467,4.247970779220779,20.0,20.0
42464,4,2464,[302  64 191 100 318],6,5,10472,4.248275862068965,20.0,20.0
42465,4,2465,[302  64 191 100 318],232,5,10477,4.248580697485807,20.0,20.0
42466,4,2466,[302  64 191 100 318],6,5,10482,4.248885285772193,20.0,20.0
42467,4,2467,[302  64 191 100 318],454,5,10487,4.2491896272285254,20.0,20.0
42468,4,2468,[302  64 191 100 318],207,4,10491,4.249088699878493,20.0,20.0
42469,4,2469,[302  64 191 100 318],378,5,10496,4.249392712550607,20.0,20.0
42470,4,2470,[234 187 185  64  88],537,2,10498,4.248482395791178,0.0,0.0
42471,4,2471,[302  64 191 100 318],232,5,10503,4.24878640776699,20.0,20.0
42472,4,2472,[302  64 191 100 318],454,5,10508,4.249090173877881,20.0,20.0
42473,4,2473,[302  64 191 100 318],271,5,10513,4.249393694421989,20.0,20.0
42474,4,2474,[302  64 191 100 318],378,5,10518,4.24969696969697,20.0,20.0
42475,4,2475,[211 237  69  12 210],13,4,10522,4.249596122778676,20.0,0.0
42476,4,2476,[121 238 515 289 179],271,4,10526,4.24949535728704,0.0,0.0
42477,4,2477,[271 180  69  28 222],537,1,10527,4.24818401937046,0.0,0.0
42478,4,2478,[302  64 191 100 318],232,5,10532,4.248487293263413,20.0,20.0
42479,4,2479,[302  64 191 100 318],537,4,10536,4.248387096774193,20.0,20.0
42480,4,2480,[ 70 228 496 289  79],194,1,10537,4.24707779121322,0.0,0.0
42481,4,2481,[302  64 191 100 318],6,5,10542,4.247381144238517,20.0,20.0
42482,4,2482,[300  64  28   7 546],774,0,10542,4.245670559806685,0.0,0.0
42483,4,2483,[302  64 191 100 318],144,4,10546,4.245571658615137,20.0,20.0
42484,4,2484,[302  64 191 100 318],664,4,10550,4.245472837022133,20.0,20.0
42485,4,2485,[302  64 191 100 318],144,4,10554,4.245374094931617,20.0,20.0
42486,4,2486,[302  64 191 100 318],207,4,10558,4.245275432247688,20.0,20.0
42487,4,2487,[275 435 197 100 211],85,3,10561,4.244774919614148,0.0,20.0
42488,4,2488,[302  64 191 100 318],343,5,10566,4.245078344716754,20.0,20.0
42489,4,2489,[302  64 191 100 318],207,4,10570,4.244979919678715,20.0,20.0
42490,4,2490,[302  64 191 318 100],13,3,10573,4.244480128462465,20.0,20.0
42491,4,2491,[302  64 191 100 318],664,4,10577,4.24438202247191,20.0,20.0
42492,4,2492,[302  64 191 100 318],458,5,10582,4.2446851183313274,20.0,20.0
42493,4,2493,[302  64 191 100 318],524,4,10586,4.244587008821171,20.0,20.0
42494,4,2494,[302  64 191 100 318],664,4,10590,4.244488977955911,20.0,20.0
42495,4,2495,[238  98 185 237 183],313,4,10594,4.2443910256410255,0.0,20.0
42496,4,2496,[302  64 191 100 318],232,5,10599,4.244693632358831,20.0,20.0
42497,4,2497,[385 187 197 127 111],537,3,10602,4.244195356285028,0.0,20.0
42498,4,2498,[302  64 191 100 318],454,5,10607,4.244497799119648,20.0,20.0
42499,4,2499,[302  64 191 100 318],605,5,10612,4.2448,20.0,20.0
42500,4,2500,[302  64 191 100 318],207,4,10616,4.244702119152339,20.0,20.0
42501,4,2501,[302  64 191 318 100],144,4,10620,4.244604316546763,20.0,20.0
42502,4,2502,[302  64 191 318 100],232,5,10625,4.244906112664802,20.0,20.0
42503,4,2503,[302  64 191 318 100],271,5,10630,4.24520766773163,20.0,20.0
42504,4,2504,[302  64 191 318 100],537,4,10634,4.245109780439122,20.0,20.0
42505,4,2505,[302  64 191 318 100],271,5,10639,4.2454110135674386,20.0,20.0
42506,4,2506,[302  64 191 318 100],524,4,10643,4.245313123254887,20.0,20.0
42507,4,2507,[302  64 191 318 100],474,5,10648,4.245614035087719,20.0,20.0
42508,4,2508,[302  64 191 318 100],524,4,10652,4.2455161418891985,20.0,20.0
42509,4,2509,[302  64 191 318 100],664,4,10656,4.245418326693227,20.0,20.0
42510,4,2510,[302  64 191 318 100],474,5,10661,4.245718837116686,20.0,20.0
42511,4,2511,[100 215 173 678 161],940,2,10663,4.244824840764331,0.0,20.0
42512,4,2512,[302  64 191 318 100],454,5,10668,4.245125348189415,20.0,20.0
42513,4,2513,[302  64 191 318 100],474,5,10673,4.245425616547335,20.0,20.0
42514,4,2514,[176 200  11 228 125],788,2,10675,4.244532803180914,0.0,0.0
42515,4,2515,[153  89 318 405  15],378,4,10679,4.244435612082671,20.0,0.0
42516,4,2516,[302  64 191 318 100],90,5,10684,4.244735796583234,20.0,20.0
42517,4,2517,[302  64 191 318 100],454,5,10689,4.245035742652899,20.0,20.0
42518,4,2518,[ 25  69 204 318 655],13,3,10692,4.244541484716157,20.0,0.0
42519,4,2519,[302  64 191 318 100],605,5,10697,4.244841269841269,20.0,20.0
42520,4,2520,[302  64 191 318 100],524,4,10701,4.244744149147164,20.0,20.0
42521,4,2521,[302  64 191 318 100],144,4,10705,4.244647105471848,20.0,20.0
42522,4,2522,[302  64 191 318 100],458,5,10710,4.244946492271106,20.0,20.0
42523,4,2523,[385  95 322 748   4],749,2,10712,4.24405705229794,0.0,0.0
42524,4,2524,[302  64 191 318 100],664,4,10716,4.243960396039604,20.0,20.0
42525,4,2525,[302  64 191 318 100],605,5,10721,4.244259699129058,20.0,20.0
42526,4,2526,[  1 215 161 294 186],13,3,10724,4.243767313019391,0.0,0.0
42527,4,2527,[302  64 191 318 100],144,4,10728,4.243670886075949,20.0,20.0
42528,4,2528,[302  64 191 318 100],605,5,10733,4.243969948596283,20.0,20.0
42529,4,2529,[302  64 191 318 100],664,4,10737,4.243873517786561,20.0,20.0
42530,4,2530,[302  64 191 318 100],90,5,10742,4.244172263927301,20.0,20.0
42531,4,2531,[357 180 234 515 237],60,5,10747,4.244470774091627,20.0,0.0
42532,4,2532,[302  64 191 318 100],144,4,10751,4.244374259771022,20.0,20.0
42533,4,2533,[302  64 191 318 100],144,4,10755,4.244277821625888,20.0,20.0
42534,4,2534,[302  64 191 318 100],524,4,10759,4.244181459566075,20.0,20.0
42535,4,2535,[302  64 191 318 100],6,5,10764,4.244479495268139,20.0,20.0
42536,4,2536,[302  64 191 318 100],144,4,10768,4.244383129680725,20.0,20.0
42537,4,2537,[302  64 191 318 100],207,4,10772,4.244286840031521,20.0,20.0
42538,4,2538,[302  64 191 318 100],13,3,10775,4.2437967703820405,20.0,20.0
42539,4,2539,[302  64 191 318 100],524,4,10779,4.243700787401575,20.0,20.0
42540,4,2540,[302  64 191 318 100],144,4,10783,4.243604879968516,20.0,20.0
42541,4,2541,[302  64 191 318 100],90,5,10788,4.2439024390243905,20.0,20.0
42542,4,2542,[302  64 191 318 100],232,5,10793,4.244199764058199,20.0,20.0
42543,4,2543,[302  64 191 318 100],378,5,10798,4.244496855345912,20.0,20.0
42544,4,2544,[302  64 191 318 100],207,4,10802,4.244400785854617,20.0,20.0
42545,4,2545,[302  64 191 318 100],378,5,10807,4.244697564807542,20.0,20.0
42546,4,2546,[302  64 191 318 100],90,5,10812,4.244994110718492,20.0,20.0
42547,4,2547,[302  64 191 318 100],271,5,10817,4.245290423861852,20.0,20.0
42548,4,2548,[302  64 191 318 100],343,5,10822,4.245586504511573,20.0,20.0
42549,4,2549,[302  64 191 318 100],458,5,10827,4.245882352941177,20.0,20.0
42550,4,2550,[302  64 191 318 100],378,5,10832,4.246177969423756,20.0,20.0
42551,4,2551,[302  64 191 318 100],343,5,10837,4.246473354231975,20.0,20.0
42552,4,2552,[302  64 191 318 100],271,5,10842,4.246768507638073,20.0,20.0
42553,4,2553,[405 181   9  28 186],488,4,10846,4.246671887235709,0.0,0.0
42554,4,2554,[302  64 191 318 100],537,4,10850,4.2465753424657535,20.0,20.0
42555,4,2555,[496 191 182  56 197],385,3,10853,4.246087636932708,0.0,0.0
42556,4,2556,[ 95 294  96 357  71],234,1,10854,4.244818146265154,20.0,0.0
42557,4,2557,[302  64 191 318 100],271,5,10859,4.245113369820172,20.0,20.0
42558,4,2558,[135 182   9 161 234],85,5,10864,4.2454083626416566,0.0,0.0
42559,4,2559,[302  64 191 318 100],378,5,10869,4.245703125,20.0,20.0
42560,4,2560,[302  64 191 318 100],13,3,10872,4.245216712221788,20.0,20.0
42561,4,2561,[302  64 191 318 100],207,4,10876,4.24512099921936,20.0,20.0
42562,4,2562,[302  64 191 318 100],271,5,10881,4.245415528677332,20.0,20.0
42563,4,2563,[423 185 508  82  56],385,2,10883,4.244539781591263,0.0,0.0
42564,4,2564,[302  64 191 318 100],6,5,10888,4.244834307992202,20.0,20.0
42565,4,2565,[302  64 191 318 100],207,4,10892,4.244738893219018,20.0,20.0
42566,4,2566,[302  64 191 318 100],474,5,10897,4.245033112582782,20.0,20.0
42567,4,2567,[302  64 191 318 100],6,5,10902,4.2453271028037385,20.0,20.0
42568,4,2568,[302  64 191 318 100],13,3,10905,4.244842351109381,20.0,20.0
42569,4,2569,[302  64 191 318 100],144,4,10909,4.244747081712062,20.0,20.0
42570,4,2570,[302  64 191 318 100],232,5,10914,4.245040840140024,20.0,20.0
42571,4,2571,[257 174 276 200 258],455,5,10919,4.245334370139969,0.0,20.0
42572,4,2572,[302  64 191 318 100],378,5,10924,4.2456276719782355,20.0,20.0
42573,4,2573,[302  64 191 318 100],90,5,10929,4.2459207459207455,20.0,20.0
42574,4,2574,[302  64 191 318 100],605,5,10934,4.246213592233009,20.0,20.0
42575,4,2575,[302  64 191 318 100],6,5,10939,4.246506211180124,20.0,20.0
42576,4,2576,[496 181  97 216 197],313,5,10944,4.246798603026775,0.0,0.0
42577,4,2577,[222 118 176 204 234],774,1,10945,4.245539177657099,0.0,0.0
42578,4,2578,[302  64 191 318 100],666,5,10950,4.245831717720047,20.0,20.0
42579,4,2579,[302  64 191 318 100],666,5,10955,4.246124031007752,20.0,20.0
42580,4,2580,[302  64 191 318 100],474,5,10960,4.246416117783805,20.0,20.0
42581,4,2581,[125 132 168 655 181],313,3,10963,4.245933384972889,0.0,0.0
42582,4,2582,[302  64 191 318 100],666,5,10968,4.246225319396051,20.0,20.0
42583,4,2583,[313  28 228  96 200],738,4,10972,4.246130030959752,0.0,0.0
42584,4,2584,[302  64 313 191 318],232,4,10976,4.246034816247582,20.0,0.0
42585,4,2585,[237 168 300 322 127],749,4,10980,4.2459396751740135,0.0,20.0
42586,4,2586,[302  64 191 318 100],6,5,10985,4.2462311557788945,20.0,20.0
42587,4,2587,[302  64 191 318 100],90,5,10990,4.246522411128284,20.0,20.0
42588,4,2588,[302  64 191 318 100],605,5,10995,4.246813441483198,20.0,20.0
42589,4,2589,[174 385 210  71  89],524,2,10997,4.245945945945946,0.0,20.0
42590,4,2590,[302  64 191 318 100],664,4,11001,4.245851022771131,20.0,20.0
42591,4,2591,[302  64 191 318 100],13,3,11004,4.24537037037037,20.0,20.0
42592,4,2592,[302  64 191 318 100],271,5,11009,4.245661396066333,20.0,20.0
42593,4,2593,[302  64 191 318 100],378,5,11014,4.245952197378566,20.0,20.0
42594,4,2594,[302  64 191 318 100],343,5,11019,4.246242774566474,20.0,20.0
42595,4,2595,[302  64 191 318 100],232,5,11024,4.24653312788906,20.0,20.0
42596,4,2596,[302  64 191 318 100],664,4,11028,4.246438197920678,20.0,20.0
42597,4,2597,[302  64 191 318 100],664,4,11032,4.2463433410315625,20.0,20.0
42598,4,2598,[302  64 191 318 100],537,4,11036,4.246248557137361,20.0,20.0
42599,4,2599,[302  64 191 318 100],207,4,11040,4.246153846153846,20.0,20.0
42600,4,2600,[302  64 191 318 100],271,5,11045,4.246443675509419,20.0,20.0
42601,4,2601,[302  64 191 318 100],664,4,11049,4.246348962336664,20.0,20.0
42602,4,2602,[302  64 191 318 100],524,4,11053,4.246254321936227,20.0,20.0
42603,4,2603,[174 204 423 238 118],840,4,11057,4.24615975422427,0.0,20.0
42604,4,2604,[302  64 191 318 100],343,5,11062,4.246449136276391,20.0,20.0
42605,4,2605,[302  64 191 318 100],524,4,11066,4.246354566385265,20.0,20.0
42606,4,2606,[302  64 191 318 100],524,4,11070,4.2462600690448795,20.0,20.0
42607,4,2607,[302  64 191 318 100],378,5,11075,4.246549079754601,20.0,20.0
42608,4,2608,[302  64 191 318 100],666,5,11080,4.246837868915293,20.0,20.0
42609,4,2609,[302  64 191 318 100],474,5,11085,4.247126436781609,20.0,20.0
42610,4,2610,[302  64 191 318 100],666,5,11090,4.247414783607813,20.0,20.0
42611,4,2611,[121 294 200 234 265],474,3,11093,4.246937212863706,0.0,0.0
42612,4,2612,[161  50 127  95  56],881,2,11095,4.246077305778798,0.0,40.0
42613,4,2613,[183  15  50  95 385],881,3,11098,4.245600612088753,0.0,20.0
42614,4,2614,[302  64 191 318 100],454,5,11103,4.245889101338432,20.0,20.0
42615,4,2615,[302  64 191 318 100],537,4,11107,4.245795107033639,20.0,20.0
42616,4,2616,[302  64 191 318 100],666,5,11112,4.246083301490256,20.0,20.0
42617,4,2617,[168 282 328  25 385],85,1,11113,4.244843391902215,0.0,0.0
42618,4,2618,[228 748 132 742 176],92,2,11115,4.243986254295533,0.0,0.0
42619,4,2619,[302  64 191 318 100],271,5,11120,4.244274809160306,20.0,20.0
42620,4,2620,[302  64 191 318 100],537,4,11124,4.244181610072491,20.0,20.0
42621,4,2621,[302  64 191 318 100],207,4,11128,4.244088482074752,20.0,20.0
42622,4,2622,[302  64 191 318 100],13,3,11131,4.243614182234083,20.0,20.0
42623,4,2623,[302  64 191 318 100],474,5,11136,4.2439024390243905,20.0,20.0
42624,4,2624,[176  96  89 210 288],308,5,11141,4.244190476190476,0.0,0.0
42625,4,2625,[302  64 191 318 100],13,3,11144,4.243716679360244,20.0,20.0
42626,4,2626,[302  64 191 318 100],13,3,11147,4.243243243243243,20.0,20.0
42627,4,2627,[302  64 191 100 318],271,5,11152,4.243531202435312,20.0,20.0
42628,4,2628,[302  64 191 100 318],6,5,11157,4.2438189425637125,20.0,20.0
42629,4,2629,[176 161   8  71 175],64,3,11160,4.243346007604563,0.0,0.0
42630,4,2630,[302  64 191 100 318],343,5,11165,4.243633599391866,20.0,20.0
42631,4,2631,[302  64 191 100 318],90,5,11170,4.243920972644377,20.0,20.0
42632,4,2632,[423  28 546 568  88],92,0,11170,4.242309153057349,0.0,0.0
42633,4,2633,[302  64 191 100 318],90,5,11175,4.242596810933941,20.0,20.0
42634,4,2634,[302  64 191 100 318],378,5,11180,4.242884250474384,20.0,20.0
42635,4,2635,[302  64 191 100 318],458,5,11185,4.2431714719271625,20.0,20.0
42636,4,2636,[183 195 276 228  88],311,5,11190,4.243458475540387,0.0,0.0
42637,4,2637,[302  64 191 100 318],537,4,11194,4.243366186504928,20.0,20.0
42638,4,2638,[  4  15  25 127 125],207,5,11199,4.243652898825313,0.0,20.0
42639,4,2639,[302  64 191 100 318],343,5,11204,4.243939393939394,20.0,20.0
42640,4,2640,[302  64 191 100 318],664,4,11208,4.243847027641045,20.0,20.0
42641,4,2641,[302  64 191 100 318],474,5,11213,4.244133232399697,20.0,20.0
42642,4,2642,[302  64 191 100 318],454,5,11218,4.244419220582671,20.0,20.0
42643,4,2643,[423 228 191 323 187],48,3,11221,4.243948562783661,0.0,0.0
42644,4,2644,[302  64 191 100 318],524,4,11225,4.2438563327032135,20.0,20.0
42645,4,2645,[302  64 191 100 318],232,5,11230,4.244142101284958,20.0,20.0
42646,4,2646,[271 174 127 197 323],883,4,11234,4.244049867774839,0.0,40.0
42647,4,2647,[302  64 191 100 318],454,5,11239,4.244335347432024,20.0,20.0
42648,4,2648,[302  64 191 100 318],343,5,11244,4.244620611551529,20.0,20.0
42649,4,2649,[302  64 191 100 318],207,4,11248,4.244528301886793,20.0,20.0
42650,4,2650,[302  64 191 318 100],271,5,11253,4.244813278008299,20.0,20.0
42651,4,2651,[302  64 191 318 100],666,5,11258,4.245098039215686,20.0,20.0
42652,4,2652,[302  64 191 318 100],90,5,11263,4.245382585751979,20.0,20.0
42653,4,2653,[302  64 191 318 100],90,5,11268,4.245666917859834,20.0,20.0
42654,4,2654,[302  64 191 318 100],271,5,11273,4.245951035781545,20.0,20.0
42655,4,2655,[302  64 191 318 100],6,5,11278,4.246234939759036,20.0,20.0
42656,4,2656,[302  64 191 318 100],6,5,11283,4.246518630033873,20.0,20.0
42657,4,2657,[302  64 191 318 100],343,5,11288,4.2468021068472535,20.0,20.0
42658,4,2658,[302  64 191 318 100],6,5,11293,4.247085370440015,20.0,20.0
42659,4,2659,[  9  69 588 196 117],311,5,11298,4.247368421052632,0.0,0.0
42660,4,2660,[405  88 323 187 228],881,2,11300,4.24652386320932,0.0,0.0
42661,4,2661,[302  64 191 318 100],207,4,11304,4.246431254695717,20.0,20.0
42662,4,2662,[302  64 191 318 100],524,4,11308,4.246338715734135,20.0,20.0
42663,4,2663,[302  64 191 318 100],537,4,11312,4.246246246246246,20.0,20.0
42664,4,2664,[121  12 427 161  88],13,5,11317,4.246529080675423,20.0,0.0
42665,4,2665,[302  64 191 318 100],6,5,11322,4.246811702925731,20.0,20.0
42666,4,2666,[302  64 191 318 100],605,5,11327,4.247094113235845,20.0,20.0
42667,4,2667,[302  64 191 318 100],454,5,11332,4.247376311844078,20.0,20.0
42668,4,2668,[302  64 191 318 100],537,4,11336,4.247283626826527,20.0,20.0
42669,4,2669,[302  64 191 318 100],474,5,11341,4.247565543071161,20.0,20.0
42670,4,2670,[302  64 191 318 100],524,4,11345,4.247472856608012,20.0,20.0
42671,4,2671,[302  64 191 318 100],207,4,11349,4.247380239520958,20.0,20.0
42672,4,2672,[302  64 191 318 100],271,5,11354,4.247661803217359,20.0,20.0
42673,4,2673,[302  64 191 318 100],537,4,11358,4.24756918474196,20.0,20.0
42674,4,2674,[302  64 191 318 100],271,5,11363,4.2478504672897195,20.0,20.0
42675,4,2675,[302  64 191 318 100],13,3,11366,4.247384155455904,20.0,20.0
42676,4,2676,[357 168  69  82 655],738,3,11369,4.246918192005976,20.0,0.0
42677,4,2677,[302  64 191 318 100],454,5,11374,4.247199402539208,20.0,20.0
42678,4,2678,[302  64 191 318 100],664,4,11378,4.247107129525943,20.0,20.0
42679,4,2679,[ 97 153   4   1 174],653,2,11380,4.246268656716418,0.0,20.0
42680,4,2680,[302  64 174 318 191],271,5,11385,4.246549794852667,20.0,20.0
42681,4,2681,[302 174  64 318 191],378,5,11390,4.24683072334079,20.0,20.0
42682,4,2682,[302 174  64 318 191],6,5,11395,4.247111442415207,20.0,20.0
42683,4,2683,[302 174  64 318 191],207,5,11400,4.247391952309985,20.0,20.0
42684,4,2684,[302 174  64 318 191],666,4,11404,4.247299813780261,20.0,20.0
42685,4,2685,[302  64 318 191 100],605,5,11409,4.2475800446760985,20.0,20.0
42686,4,2686,[302  64 318 191 100],378,5,11414,4.247860066989207,20.0,20.0
42687,4,2687,[302  64 318 191 100],6,5,11419,4.248139880952381,20.0,20.0
42688,4,2688,[302  64 318 191 100],144,4,11423,4.248047601338787,20.0,20.0
42689,4,2689,[302  64 318 191 100],6,5,11428,4.248327137546468,20.0,20.0
42690,4,2690,[302  64 318 191 100],13,3,11431,4.247863247863248,20.0,20.0
42691,4,2691,[216  98 483 322  96],311,5,11436,4.2481426448737,20.0,20.0
42692,4,2692,[302  64 318 191 100],13,3,11439,4.247679168213888,20.0,20.0
42693,4,2693,[302  64 318 191 100],232,5,11444,4.247958426132145,20.0,20.0
42694,4,2694,[302  64 318 191 100],378,5,11449,4.248237476808906,20.0,20.0
42695,4,2695,[302  64 318 191 100],458,5,11454,4.248516320474778,20.0,20.0
42696,4,2696,[302  64 318 191 100],458,5,11459,4.24879495736003,20.0,20.0
42697,4,2697,[302  64 318 191 100],666,5,11464,4.2490733876945885,20.0,20.0
42698,4,2698,[302  64 318 191 100],454,5,11469,4.24935161170804,20.0,20.0
42699,4,2699,[302  64 318 191 100],207,4,11473,4.249259259259259,20.0,20.0
42700,4,2700,[302  64 318 191 100],232,5,11478,4.249537208441318,20.0,20.0
42701,4,2701,[174 603  22  95  88],897,4,11482,4.249444855662472,20.0,20.0
42702,4,2702,[302  64 603 318 191],271,5,11487,4.249722530521643,40.0,0.0
42703,4,2703,[302 603  64 318 191],271,5,11492,4.25,40.0,0.0
42704,4,2704,[302 603  64 318 191],474,5,11497,4.250277264325323,40.0,0.0
42705,4,2705,[302 603  64 318 191],664,4,11501,4.250184774575018,40.0,0.0
42706,4,2706,[302 603  64 318 191],454,5,11506,4.25046176579239,40.0,0.0
42707,4,2707,[302 603  64 318 191],474,5,11511,4.250738552437223,40.0,0.0
42708,4,2708,[302 603  64 318 191],524,3,11514,4.250276854928018,40.0,0.0
42709,4,2709,[302  64 318 191 100],664,4,11518,4.250184501845019,20.0,20.0
42710,4,2710,[302  64 318 100 191],666,5,11523,4.250461084470675,20.0,20.0
42711,4,2711,[302  64 318 100 191],90,5,11528,4.2507374631268435,20.0,20.0
42712,4,2712,[302  64 318 100 191],524,4,11532,4.250645042388499,20.0,20.0
42713,4,2713,[302  64 318 100 191],605,5,11537,4.250921149594694,20.0,20.0
42714,4,2714,[302  64 318 100 191],605,5,11542,4.251197053406998,20.0,20.0
42715,4,2715,[678 174 475  98  11],308,3,11545,4.250736377025037,0.0,40.0
42716,4,2716,[302  64 318 100 191],458,5,11550,4.251012145748988,20.0,20.0
42717,4,2717,[204 234  25  50 153],194,1,11551,4.24981604120677,0.0,20.0
42718,4,2718,[ 88 181 508 215  96],378,5,11556,4.250091945568224,0.0,0.0
42719,4,2719,[302  64 318 100 191],144,4,11560,4.25,20.0,20.0
42720,4,2720,[302  64 318 100 191],605,5,11565,4.250275633958104,20.0,20.0
42721,4,2721,[302  64 318 100 191],605,5,11570,4.250551065393093,20.0,20.0
42722,4,2722,[302  64 318 100 191],13,3,11573,4.250091810503122,20.0,20.0
42723,4,2723,[302  64 318 100 191],90,5,11578,4.250367107195301,20.0,20.0
42724,4,2724,[302  64 318 100 191],232,5,11583,4.250642201834863,20.0,20.0
42725,4,2725,[302  64 318 100 191],271,5,11588,4.2509170946441674,20.0,20.0
42726,4,2726,[302  64 318 100 191],664,4,11592,4.250825082508251,20.0,20.0
42727,4,2727,[427  79 176 273 153],385,2,11594,4.25,0.0,0.0
42728,4,2728,[302  64 318 100 191],232,5,11599,4.250274825943569,20.0,20.0
42729,4,2729,[302  64 318 100 191],524,4,11603,4.25018315018315,20.0,20.0
42730,4,2730,[302  64 318 100 191],666,5,11608,4.250457707799341,20.0,20.0
42731,4,2731,[302  64 318 100 191],664,4,11612,4.2503660322108345,20.0,20.0
42732,4,2732,[302  64 318 100 191],666,5,11617,4.2506403219904865,20.0,20.0
42733,4,2733,[302  64 318 100 191],271,5,11622,4.250914411119239,20.0,20.0
42734,4,2734,[302  64 318 100 191],666,5,11627,4.251188299817184,20.0,20.0
42735,4,2735,[302  64 318 100 191],666,5,11632,4.251461988304094,20.0,20.0
42736,4,2736,[427 210 568  96  69],313,5,11637,4.251735476799415,0.0,0.0
42737,4,2737,[302  64 318 100 191],90,5,11642,4.252008765522279,20.0,20.0
42738,4,2738,[302  64 318 100 191],13,3,11645,4.2515516611902155,20.0,20.0
42739,4,2739,[302  64 318 100 191],458,5,11650,4.251824817518248,20.0,20.0
42740,4,2740,[302  64 318 100 191],666,5,11655,4.252097774534842,20.0,20.0
42741,4,2741,[302  64 318 100 191],474,5,11660,4.25237053245806,20.0,20.0
42742,4,2742,[302  64 318 100 191],90,5,11665,4.252643091505651,20.0,20.0
42743,4,2743,[302  64 318 100 191],271,5,11670,4.252915451895044,20.0,20.0
42744,4,2744,[302  64 318 100 191],666,5,11675,4.253187613843352,20.0,20.0
42745,4,2745,[302  64 318 100 191],144,4,11679,4.253095411507648,20.0,20.0
42746,4,2746,[302  64 318 100 191],271,5,11684,4.253367309792501,20.0,20.0
42747,4,2747,[302  64 318 100 191],343,5,11689,4.253639010189229,20.0,20.0
42748,4,2748,[302  64 318 100 191],232,5,11694,4.253910512913786,20.0,20.0
42749,4,2749,[121 197 100 194  88],406,4,11698,4.253818181818182,0.0,20.0
42750,4,2750,[302  64 318 100 191],664,4,11702,4.2537259178480555,20.0,20.0
42751,4,2751,[302  64 318 100 191],524,4,11706,4.253633720930233,20.0,20.0
42752,4,2752,[302  64 318 100 191],537,4,11710,4.253541590991645,20.0,20.0
42753,4,2753,[302  64 318 100 191],232,5,11715,4.253812636165577,20.0,20.0
42754,4,2754,[  8   4  82 222  50],87,5,11720,4.254083484573503,0.0,20.0
42755,4,2755,[302  64 318 100 191],474,5,11725,4.254354136429608,20.0,20.0
42756,4,2756,[302  64 318 100 191],605,5,11730,4.25462459194777,20.0,20.0
42757,4,2757,[302  64 318 100 191],524,4,11734,4.254532269760696,20.0,20.0
42758,4,2758,[302  64 318 100 191],271,5,11739,4.254802464661109,20.0,20.0
42759,4,2759,[302  64 318 100 191],13,3,11742,4.254347826086956,20.0,20.0
42760,4,2760,[302  64 100 318 191],666,5,11747,4.254617892068091,20.0,20.0
42761,4,2761,[302  64 100 318 191],232,5,11752,4.254887762490949,20.0,20.0
42762,4,2762,[302  64 100 318 191],537,4,11756,4.2547955121245025,20.0,20.0
42763,4,2763,[302  64 100 318 191],524,4,11760,4.2547033285094065,20.0,20.0
42764,4,2764,[302  64 100 318 191],458,5,11765,4.25497287522604,20.0,20.0
42765,4,2765,[302  64 100 318 191],207,4,11769,4.254880694143167,20.0,20.0
42766,4,2766,[302  64 318 100 191],90,5,11774,4.255149981929888,20.0,20.0
42767,4,2767,[302  64 318 100 191],271,5,11779,4.255419075144508,20.0,20.0
42768,4,2768,[302  64 318 100 191],378,5,11784,4.2556879739978335,20.0,20.0
42769,4,2769,[302  64 318 100 191],605,5,11789,4.255956678700361,20.0,20.0
42770,4,2770,[211 215  25 118 282],42,4,11793,4.25586430891375,0.0,0.0
42771,4,2771,[302  64 318 100 191],524,4,11797,4.255772005772005,20.0,20.0
42772,4,2772,[302  64 318 100 191],664,4,11801,4.255679769203029,20.0,20.0
42773,4,2773,[302  64 318 100 191],664,4,11805,4.255587599134824,20.0,20.0
42774,4,2774,[302  64 318 100 191],271,5,11810,4.255855855855856,20.0,20.0
42775,4,2775,[302  64 318 100 191],13,3,11813,4.255403458213256,20.0,20.0
42776,4,2776,[302  64 100 318 191],454,5,11818,4.2556715880446525,20.0,20.0
42777,4,2777,[302  64 100 318 191],537,4,11822,4.255579553635709,20.0,20.0
42778,4,2778,[302  64 100 318 191],474,5,11827,4.255847427132062,20.0,20.0
42779,4,2779,[302  64 100 318 191],207,4,11831,4.255755395683453,20.0,20.0
42780,4,2780,[216 328 313 121 271],537,1,11832,4.254584681769148,0.0,0.0
42781,4,2781,[125 546 191 117  88],378,2,11834,4.253774263120057,0.0,0.0
42782,4,2782,[302  64 318 100 191],144,4,11838,4.253683075817463,20.0,20.0
42783,4,2783,[508 603 385 300  98],533,5,11843,4.253951149425287,20.0,20.0
42784,4,2784,[180 183   8 300 403],479,3,11846,4.253500897666068,0.0,0.0
42785,4,2785,[302  64 318 100 191],13,3,11849,4.253050969131371,20.0,20.0
42786,4,2786,[302  64 100 318 191],605,5,11854,4.253318980983136,20.0,20.0
42787,4,2787,[302  64 100 318 191],6,5,11859,4.253586800573888,20.0,20.0
42788,4,2788,[302  64 100 318 191],524,4,11863,4.253495876658301,20.0,20.0
42789,4,2789,[302  64 100 318 191],605,5,11868,4.253763440860215,20.0,20.0
42790,4,2790,[100 328 202 117 483],499,4,11872,4.253672518810462,20.0,20.0
42791,4,2791,[302  64 100 318 191],605,5,11877,4.253939828080229,20.0,20.0
42792,4,2792,[ 79 121 238 183 235],334,3,11880,4.253490870032223,0.0,0.0
42793,4,2793,[302  64 100 318 191],458,5,11885,4.253758052970651,20.0,20.0
42794,4,2794,[302  64 100 318 191],271,5,11890,4.254025044722719,20.0,20.0
42795,4,2795,[302  64 100 318 191],474,5,11895,4.2542918454935625,20.0,20.0
42796,4,2796,[302  64 100 318 191],605,5,11900,4.254558455488023,20.0,20.0
42797,4,2797,[405 288 210 678  98],474,3,11903,4.254110078627591,0.0,20.0
42798,4,2798,[302  64 100 318 191],343,5,11908,4.254376563058235,20.0,20.0
42799,4,2799,[302  64 100 318 191],474,5,11913,4.254642857142857,20.0,20.0
42800,4,2800,[302  64 100 318 191],454,5,11918,4.254908961085326,20.0,20.0
42801,4,2801,[302  64 100 318 191],524,4,11922,4.254817987152034,20.0,20.0
42802,4,2802,[302  64 100 318 191],454,5,11927,4.255083838744203,20.0,20.0
42803,4,2803,[302  64 100 318 191],458,5,11932,4.255349500713267,20.0,20.0
42804,4,2804,[302  64 100 318 191],666,5,11937,4.255614973262032,20.0,20.0
42805,4,2805,[153 257 234 100 168],385,2,11939,4.254811119030649,0.0,20.0
42806,4,2806,[302  64 100 318 191],144,4,11943,4.254720342002138,20.0,20.0
42807,4,2807,[302  64 100 318 191],232,5,11948,4.254985754985755,20.0,20.0
42808,4,2808,[302  64 100 318 191],664,4,11952,4.254894980420079,20.0,20.0
42809,4,2809,[ 28 204 294 268 301],234,1,11953,4.25373665480427,0.0,0.0
42810,4,2810,[302  64 100 318 191],90,5,11958,4.254002134471718,20.0,20.0
42811,4,2811,[302  64 100 318 191],90,5,11963,4.254267425320057,20.0,20.0
42812,4,2812,[194 276 125 183  97],42,3,11966,4.253821542836829,0.0,0.0
42813,4,2813,[302  64 100 318 191],664,4,11970,4.253731343283582,20.0,20.0
42814,4,2814,[302  64 100 318 191],666,5,11975,4.253996447602131,20.0,20.0
42815,4,2815,[294 174 597 195 288],102,2,11977,4.2531960227272725,0.0,20.0
42816,4,2816,[302  64 100 318 191],13,3,11980,4.25275115370962,20.0,20.0
42817,4,2817,[302  64 100 318 191],666,5,11985,4.253016323633783,20.0,20.0
42818,4,2818,[194 175 111 273  22],524,2,11987,4.252217098261795,0.0,0.0
42819,4,2819,[302  64 100 318 191],271,5,11992,4.252482269503546,20.0,20.0
42820,4,2820,[302  64 100 318 191],343,5,11997,4.252747252747253,20.0,20.0
42821,4,2821,[302  64 100 318 191],458,5,12002,4.253012048192771,20.0,20.0
42822,4,2822,[302  64 100 318 191],271,5,12007,4.253276656039674,20.0,20.0
42823,4,2823,[302  64 100 318 191],524,4,12011,4.253186968838527,20.0,20.0
42824,4,2824,[302  64 100 318 191],458,5,12016,4.253451327433629,20.0,20.0
42825,4,2825,[302  64 100 318 191],207,4,12020,4.2533616418966735,20.0,20.0
42826,4,2826,[302  64 100 318 191],458,5,12025,4.253625751680226,20.0,20.0
42827,4,2827,[302  64 100 318 191],537,4,12029,4.253536067892504,20.0,20.0
42828,4,2828,[302  64 100 318 191],13,3,12032,4.253092965712266,20.0,20.0
42829,4,2829,[302  64 100 318 191],144,4,12036,4.253003533568904,20.0,20.0
42830,4,2830,[302  64 100 318 191],271,5,12041,4.253267396679618,20.0,20.0
42831,4,2831,[302  64 100 318 191],664,4,12045,4.253177966101695,20.0,20.0
42832,4,2832,[302  64 100 318 191],378,5,12050,4.253441581362513,20.0,20.0
42833,4,2833,[302  64 100 318 191],378,5,12055,4.253705010585745,20.0,20.0
42834,4,2834,[302  64 100 318 191],378,5,12060,4.253968253968254,20.0,20.0
42835,4,2835,[302  64 100 318 191],90,5,12065,4.254231311706629,20.0,20.0
42836,4,2836,[234  79 318 197 210],313,5,12070,4.25449418399718,20.0,0.0
42837,4,2837,[302  64 100 318 191],605,5,12075,4.254756871035941,20.0,20.0
42838,4,2838,[302  64 100 318 191],232,5,12080,4.255019373018668,20.0,20.0
42839,4,2839,[302  64 100 318 191],378,5,12085,4.255281690140845,20.0,20.0
42840,4,2840,[302  64 100 318 191],537,4,12089,4.255191833861317,20.0,20.0
42841,4,2841,[268 357 117 405 127],643,3,12092,4.2547501759324415,20.0,20.0
42842,4,2842,[302  64 100 318 191],207,4,12096,4.254660569820612,20.0,20.0
42843,4,2843,[151  25 508  96 588],406,3,12099,4.2542194092827,0.0,0.0
42844,4,2844,[100 300 385 172 257],533,5,12104,4.254481546572935,0.0,20.0
42845,4,2845,[302  64 100 318 191],144,4,12108,4.254392129304287,20.0,20.0
42846,4,2846,[302  64 100 318 191],271,5,12113,4.254654021777309,20.0,20.0
42847,4,2847,[742 172  22 204 483],313,3,12116,4.254213483146067,20.0,0.0
42848,4,2848,[302  64 100 318 191],454,5,12121,4.254475254475254,20.0,20.0
42849,4,2849,[435 151 228 300 323],788,1,12122,4.253333333333333,0.0,0.0
42850,4,2850,[302  64 100 318 191],343,5,12127,4.25359522974395,20.0,20.0
42851,4,2851,[302  64 100 318 191],524,4,12131,4.253506311360449,20.0,20.0
42852,4,2852,[302  64 100 318 191],524,4,12135,4.2534174553102,20.0,20.0
42853,4,2853,[405  50 135 186   4],374,3,12138,4.252978276103714,0.0,20.0
42854,4,2854,[302  64 100 318 191],666,5,12143,4.253239929947461,20.0,20.0
42855,4,2855,[175 235 210 187 117],308,3,12146,4.252801120448179,0.0,0.0
42856,4,2856,[302  64 100 318 191],454,5,12151,4.253062653132656,20.0,20.0
42857,4,2857,[318   1  50 222 176],263,5,12156,4.25332400279916,20.0,20.0
42858,4,2858,[302  64 100 318 191],454,5,12161,4.253585169639734,20.0,20.0
42859,4,2859,[ 69 175   1  15 742],648,2,12163,4.252797202797203,0.0,0.0
42860,4,2860,[302  64 100 318 191],378,5,12168,4.253058371198882,20.0,20.0
42861,4,2861,[302  64 100 318 191],271,5,12173,4.253319357092942,20.0,20.0
42862,4,2862,[302  64 100 318 191],524,4,12177,4.25323087670276,20.0,20.0
42863,4,2863,[302 100  64 318 191],343,5,12182,4.253491620111732,20.0,20.0
42864,4,2864,[302 100  64 318 191],458,5,12187,4.2537521815008725,20.0,20.0
42865,4,2865,[302 100  64 318 191],537,4,12191,4.253663642707607,20.0,20.0
42866,4,2866,[238  69   9 125 235],64,4,12195,4.253575165678409,0.0,0.0
42867,4,2867,[302 100 318  64 191],378,5,12200,4.253835425383542,20.0,20.0
42868,4,2868,[302 100 318  64 191],271,5,12205,4.254095503659812,20.0,20.0
42869,4,2869,[302 100 318  64 191],232,5,12210,4.2543554006968645,20.0,20.0
42870,4,2870,[302 100 318  64 191],664,4,12214,4.254266805990944,20.0,20.0
42871,4,2871,[328 222  28 175 117],788,3,12217,4.253830083565459,0.0,0.0
42872,4,2872,[302 100 318  64 191],524,4,12221,4.2537417333797425,20.0,20.0
42873,4,2873,[302 100 318  64 191],343,5,12226,4.2540013917884485,20.0,20.0
42874,4,2874,[302 100 318  64 191],6,5,12231,4.2542608695652175,20.0,20.0
42875,4,2875,[302 100 318  64 191],232,5,12236,4.2545201668984705,20.0,20.0
42876,4,2876,[302 100 318  64 191],13,3,12239,4.254084115397984,20.0,20.0
42877,4,2877,[302 100 318  64 191],378,5,12244,4.254343293954135,20.0,20.0
42878,4,2878,[302 100 318  64 191],474,5,12249,4.2546022924626605,20.0,20.0
42879,4,2879,[655 286 288 318  71],234,1,12250,4.253472222222222,20.0,0.0
42880,4,2880,[302 100 318  64 191],207,4,12254,4.253384241582784,20.0,20.0
42881,4,2881,[194 405 185  69  88],406,3,12257,4.252949340735601,0.0,0.0
42882,4,2882,[183 181 286 423   8],387,3,12260,4.252514741588623,0.0,0.0
42883,4,2883,[302 100 318  64 191],605,5,12265,4.252773925104022,20.0,20.0
42884,4,2884,[302 100 318  64 191],605,5,12270,4.253032928942807,20.0,20.0
42885,4,2885,[302 100 318  64 191],343,5,12275,4.253291753291753,20.0,20.0
42886,4,2886,[302 100 318  64 191],6,5,12280,4.253550398337374,20.0,20.0
42887,4,2887,[191 196  64 117 181],234,2,12282,4.252770083102493,0.0,0.0
42888,4,2888,[302 100 318  64 191],6,5,12287,4.253028729664243,20.0,20.0
42889,4,2889,[151 127 588 603  79],234,2,12289,4.252249134948097,20.0,20.0
42890,4,2890,[276 121   1 144 202],643,4,12293,4.252161881701833,0.0,0.0
42891,4,2891,[294 121 125 333 313],533,5,12298,4.252420470262794,0.0,0.0
42892,4,2892,[302 100 318  64 603],454,5,12303,4.2526788800553055,40.0,20.0
42893,4,2893,[302 603 100 318  64],537,4,12307,4.252591568762957,40.0,20.0
42894,4,2894,[ 88 282 191 257 183],653,1,12308,4.25146804835924,0.0,0.0
42895,4,2895,[179 515 175  98 144],543,4,12312,4.251381215469613,0.0,20.0
42896,4,2896,[179 286 200 318   7],234,2,12314,4.250604073179151,20.0,0.0
42897,4,2897,[302 603 100 318  64],90,5,12319,4.250862663906142,40.0,20.0
42898,4,2898,[302 603 100 318  64],664,5,12324,4.251121076233184,40.0,20.0
42899,4,2899,[515 294  70 215 323],537,2,12326,4.250344827586207,0.0,0.0
42900,4,2900,[302 603 100 318  64],883,5,12331,4.250603240261978,40.0,20.0
42901,4,2901,[302 603 100 318  64],474,5,12336,4.2508614748449345,40.0,20.0
42902,4,2902,[302 603 100 318  64],13,4,12340,4.250775060282466,40.0,20.0
42903,4,2903,[302 603 100 318  64],271,5,12345,4.25103305785124,40.0,20.0
42904,4,2904,[100 197 182 423 215],378,4,12349,4.250946643717728,0.0,20.0
42905,4,2905,[302 603 100 318  64],537,4,12353,4.250860289057123,40.0,20.0
42906,4,2906,[302 603 100 318  64],664,5,12358,4.251117991056072,40.0,20.0
42907,4,2907,[302 603 100 318  64],524,3,12361,4.250687757909216,40.0,20.0
42908,4,2908,[302 603 100 318  64],232,5,12366,4.2509453420419385,40.0,20.0
42909,4,2909,[302 603 100 318  64],458,5,12371,4.2512027491408935,40.0,20.0
42910,4,2910,[302 603 100 318  64],13,4,12375,4.25111645482652,40.0,20.0
42911,4,2911,[302 603 100 318  64],883,5,12380,4.251373626373627,40.0,20.0
42912,4,2912,[200 385 151 181 174],374,3,12383,4.2509440439409545,0.0,20.0
42913,4,2913,[302 603 100 318  64],271,5,12388,4.251201098146877,40.0,20.0
42914,4,2914,[  8 196   9 313   1],234,2,12390,4.2504288164665525,0.0,0.0
42915,4,2915,[ 15 357 118 222 179],749,3,12393,4.25,20.0,0.0
42916,4,2916,[302 603 100 318  64],537,4,12397,4.249914295509084,40.0,20.0
42917,4,2917,[302 603 100 318  64],664,5,12402,4.25017135023989,40.0,20.0
42918,4,2918,[302 603 100 318  64],474,5,12407,4.250428228845495,40.0,20.0
42919,4,2919,[302 603 100 318  64],458,5,12412,4.250684931506849,40.0,20.0
42920,4,2920,[151 111 496 176 237],653,0,12412,4.249229715850736,0.0,0.0
42921,4,2921,[475 202 197 211  98],343,5,12417,4.249486652977413,0.0,20.0
42922,4,2922,[302 603 100 318  64],474,5,12422,4.249743414300377,40.0,20.0
42923,4,2923,[302 603 100 318  64],90,5,12427,4.25,40.0,20.0
42924,4,2924,[302 603 100 318  64],232,5,12432,4.25025641025641,40.0,20.0
42925,4,2925,[204  12 328 276 121],334,3,12435,4.249829118250171,20.0,0.0
42926,4,2926,[302 603 100 318  64],271,5,12440,4.250085411684318,40.0,20.0
42927,4,2927,[302 603 100 318  64],666,5,12445,4.250341530054645,40.0,20.0
42928,4,2928,[302 603 100 318  64],524,3,12448,4.249914646637078,40.0,20.0
42929,4,2929,[302 603 100 318  64],13,4,12452,4.249829351535836,40.0,20.0
42930,4,2930,[302 603 100 318  64],474,5,12457,4.250085295121119,40.0,20.0
42931,4,2931,[302 603 100 318  64],232,5,12462,4.250341064120055,40.0,20.0
42932,4,2932,[302 603 100 318  64],458,5,12467,4.250596658711217,40.0,20.0
42933,4,2933,[302 603 100 318  64],664,5,12472,4.250852079072938,40.0,20.0
42934,4,2934,[302 603 100 318  64],458,5,12477,4.251107325383305,40.0,20.0
42935,4,2935,[302 603 100 318  64],232,5,12482,4.251362397820164,40.0,20.0
42936,4,2936,[302 603 100 318  64],537,4,12486,4.251276813074566,40.0,20.0
42937,4,2937,[302 603 100 318  64],537,4,12490,4.251191286589517,40.0,20.0
42938,4,2938,[302 603 100 318  64],90,5,12495,4.251446070091868,40.0,20.0
42939,4,2939,[302 603 100 318  64],232,5,12500,4.2517006802721085,40.0,20.0
42940,4,2940,[202 655 187 132 186],804,5,12505,4.2519551173070385,0.0,0.0
42941,4,2941,[302 603 100 318  64],458,5,12510,4.252209381373215,40.0,20.0
42942,4,2942,[302 603 100 318  64],474,5,12515,4.252463472646959,40.0,20.0
42943,4,2943,[302 603 100 318  64],232,5,12520,4.252717391304348,40.0,20.0
42944,4,2944,[302 603 100 318  64],458,5,12525,4.2529711375212225,40.0,20.0
42945,4,2945,[302 603 100 318  64],454,5,12530,4.253224711473184,40.0,20.0
42946,4,2946,[302 603 100 318  64],537,4,12534,4.2531387852052935,40.0,20.0
42947,4,2947,[302 603 100 318  64],537,4,12538,4.253052917232021,40.0,20.0
42948,4,2948,[323  56 678 195 173],506,3,12541,4.252628009494744,0.0,0.0
42949,4,2949,[302 603 100 318 357],474,5,12546,4.252881355932203,60.0,20.0
42950,4,2950,[302 603 357 100 318],666,5,12551,4.2531345306675705,60.0,20.0
42951,4,2951,[302 603 357 100 318],458,4,12555,4.253048780487805,60.0,20.0
42952,4,2952,[302 603 100 318 174],90,5,12560,4.25330172705723,40.0,40.0
42953,4,2953,[302 603 100 318 174],474,5,12565,4.253554502369668,40.0,40.0
42954,4,2954,[ 82  11  89 655 132],64,3,12568,4.253130287648054,0.0,0.0
42955,4,2955,[302 603 174 100 318],334,5,12573,4.253382949932341,40.0,40.0
42956,4,2956,[357 210  22 235 234],406,4,12577,4.2532972607372335,20.0,0.0
42957,4,2957,[302 603 174 100 318],13,4,12581,4.253211629479378,40.0,40.0
42958,4,2958,[302 603 174 100 318],334,5,12586,4.253464008110848,40.0,40.0
42959,4,2959,[302 603 174 100 318],334,5,12591,4.253716216216216,40.0,40.0
42960,4,2960,[357 216  71 211 323],648,3,12594,4.253292806484295,20.0,0.0
42961,4,2961,[ 82 471 222  95 568],882,5,12599,4.25354490209318,0.0,0.0
42962,4,2962,[ 95 597 168   7 173],804,3,12602,4.25312183597705,0.0,0.0
42963,4,2963,[302 603 174 100 318],537,4,12606,4.253036437246964,40.0,40.0
42964,4,2964,[302 603 100 318  64],454,5,12611,4.2532883642495785,40.0,20.0
42965,4,2965,[265 117 294  79 405],13,1,12612,4.252191503708699,0.0,0.0
42966,4,2966,[234  88  82 135 282],881,3,12615,4.251769464105156,0.0,0.0
42967,4,2967,[302 603 100 318  64],90,5,12620,4.252021563342318,40.0,20.0
42968,4,2968,[302 603 100 318  64],271,5,12625,4.252273492758505,40.0,20.0
42969,4,2969,[302 603 100 318  64],666,5,12630,4.252525252525253,40.0,20.0
42970,4,2970,[ 50 183 435 216 191],804,4,12634,4.252440255806126,0.0,20.0
42971,4,2971,[302 603 100 318  64],524,3,12637,4.2520188425302825,40.0,20.0
42972,4,2972,[238 322  12 475 153],308,4,12641,4.2519340733266064,20.0,0.0
42973,4,2973,[302 603 100 318  64],474,5,12646,4.2521856086079355,40.0,20.0
42974,4,2974,[323 194 508 385  95],13,2,12648,4.251428571428572,0.0,0.0
42975,4,2975,[302 603 100 318  64],458,5,12653,4.251680107526882,40.0,20.0
42976,4,2976,[302 603 100 318  64],90,5,12658,4.251931474638898,40.0,20.0
42977,4,2977,[302 603 100 318  64],90,5,12663,4.252182672934856,40.0,20.0
42978,4,2978,[302 603 100 318  64],232,5,12668,4.25243370258476,40.0,20.0
42979,4,2979,[ 50 186 265 276 302],537,4,12672,4.2523489932885905,0.0,20.0
42980,4,2980,[302 603 100 318  64],664,5,12677,4.25259979872526,40.0,20.0
42981,4,2981,[302 603 100 318  64],524,3,12680,4.252179745137491,40.0,20.0
42982,4,2982,[302 603 100 318  64],664,5,12685,4.252430439155213,40.0,20.0
42983,4,2983,[302 603 100 318  64],232,5,12690,4.252680965147453,40.0,20.0
42984,4,2984,[302 603 100 318  64],474,5,12695,4.252931323283082,40.0,20.0
42985,4,2985,[302 603 100 318  64],524,3,12698,4.252511721366377,40.0,20.0
42986,4,2986,[118   8 168 117 111],13,4,12702,4.252427184466019,0.0,0.0
42987,4,2987,[302 603 100 318  64],664,5,12707,4.252677376171352,40.0,20.0
42988,4,2988,[302 603 100 318  64],458,5,12712,4.252927400468384,40.0,20.0
42989,4,2989,[655  50 357 275 143],343,5,12717,4.253177257525084,20.0,20.0
42990,4,2990,[172   4  69 132  22],650,2,12719,4.252423938482113,0.0,0.0
42991,4,2991,[302 603 100 318  64],664,5,12724,4.252673796791444,40.0,20.0
42992,4,2992,[302 603 100 318  64],232,5,12729,4.252923488138991,40.0,20.0
42993,4,2993,[302 603 100 318  64],883,5,12734,4.25317301269205,40.0,20.0
42994,4,2994,[176 568 191 405  97],379,3,12737,4.252754590984975,0.0,0.0
42995,4,2995,[302 603 100 318  64],458,5,12742,4.253004005340454,40.0,20.0
42996,4,2996,[302 603 100 318  64],666,5,12747,4.253253253253253,40.0,20.0
42997,4,2997,[302 603 100 318  64],666,5,12752,4.253502334889927,40.0,20.0
42998,4,2998,[423 211  98  96 194],387,3,12755,4.253084361453818,0.0,20.0
42999,4,2999,[302 603 100 318  64],90,5,12760,4.253333333333333,40.0,20.0
43000,4,3000,[302 603 100 318  64],454,5,12765,4.253582139286904,40.0,20.0
43001,4,3001,[202  88 222  96 121],533,5,12770,4.253830779480347,0.0,0.0
43002,4,3002,[302 603 100 318  64],271,5,12775,4.2540792540792545,40.0,20.0
43003,4,3003,[302 603 100 318  64],454,5,12780,4.254327563249001,40.0,20.0
43004,4,3004,[ 96 216 211 322   4],883,5,12785,4.254575707154742,0.0,0.0
43005,4,3005,[234 195 151 300  64],379,3,12788,4.254158349966733,0.0,0.0
43006,4,3006,[302 603 100 318  64],271,5,12793,4.25440638510143,40.0,20.0
43007,4,3007,[245 275  69 385 435],455,3,12796,4.253989361702128,0.0,0.0
43008,4,3008,[302 603 100 318  64],13,4,12800,4.253904951811233,40.0,20.0
43009,4,3009,[302 603 100 318  64],883,5,12805,4.254152823920266,40.0,20.0
43010,4,3010,[302 603 100 318  64],664,5,12810,4.254400531384922,40.0,20.0
43011,4,3011,[302 603 100 318  64],664,5,12815,4.25464807436919,40.0,20.0
43012,4,3012,[302 603 100 318  64],454,5,12820,4.25489545303684,40.0,20.0
43013,4,3013,[302 603 100 318  64],90,5,12825,4.255142667551427,40.0,20.0
43014,4,3014,[302 603 100 318  64],524,3,12828,4.254726368159204,40.0,20.0
43015,4,3015,[127  11 603 182  56],59,5,12833,4.254973474801061,20.0,20.0
43016,4,3016,[195 328 180   4  56],13,3,12836,4.254557507457739,0.0,0.0
43017,4,3017,[302 603 100 318  64],474,5,12841,4.25480450629556,40.0,20.0
43018,4,3018,[302 603 100 318  64],458,5,12846,4.255051341503809,40.0,20.0
43019,4,3019,[  4 194 435 276  89],343,4,12850,4.254966887417218,0.0,0.0
43020,4,3020,[216 191 172 200 173],506,5,12855,4.255213505461768,0.0,0.0
43021,4,3021,[125 275 273 385 168],158,2,12857,4.254467240238252,0.0,0.0
43022,4,3022,[302 603 100 318  64],537,4,12861,4.254383063182269,40.0,20.0
43023,4,3023,[302 603 100 318  64],666,5,12866,4.25462962962963,40.0,20.0
43024,4,3024,[302 603 100 318  64],537,4,12870,4.254545454545455,40.0,20.0
43025,4,3025,[  7 294 144 132 328],804,5,12875,4.254791804362195,0.0,0.0
43026,4,3026,[302 603 100 318  64],474,5,12880,4.255037991410638,40.0,20.0
43027,4,3027,[302 603 100 318  64],537,4,12884,4.254953764861295,40.0,20.0
43028,4,3028,[179  89 173 210 172],200,5,12889,4.255199735886431,0.0,0.0
43029,4,3029,[100 143 153 234 195],263,4,12893,4.255115511551155,0.0,20.0
43030,4,3030,[357 483 183  97 172],328,4,12897,4.255031342791158,40.0,0.0
43031,4,3031,[302 603 100 318  64],271,5,12902,4.255277044854881,40.0,20.0
43032,4,3032,[168  64 100 153 204],346,3,12905,4.254863171777118,0.0,20.0
43033,4,3033,[175 222 385  69 194],42,4,12909,4.2547791694133155,0.0,0.0
43034,4,3034,[302 603 100 318  64],13,4,12913,4.254695222405272,40.0,20.0
43035,4,3035,[302 603 100 318  64],883,5,12918,4.25494071146245,40.0,20.0
43036,4,3036,[302 603 100 318  64],524,3,12921,4.254527494237735,40.0,20.0
43037,4,3037,[357 100  97 515 168],804,5,12926,4.254772876892693,20.0,20.0
43038,4,3038,[302 603 100 318 191],271,5,12931,4.255018098058572,40.0,20.0
43039,4,3039,[302 603 100 318 191],334,5,12936,4.255263157894737,40.0,20.0
43040,4,3040,[173   8 182 179 144],13,3,12939,4.254850378165077,0.0,0.0
43041,4,3041,[302 603 100 318   8],232,4,12943,4.254766600920447,40.0,20.0
43042,4,3042,[302 603 100 318 191],666,5,12948,4.255011501807427,40.0,20.0
43043,4,3043,[302 603 100 318 191],524,4,12952,4.254927726675427,40.0,20.0
43044,4,3044,[300 100  70  64 211],537,3,12955,4.254515599343185,0.0,20.0
43045,4,3045,[302 603 100 318 191],666,5,12960,4.2547603414313855,40.0,20.0
43046,4,3046,[302 603 100 318 191],664,4,12964,4.254676731211028,40.0,20.0
43047,4,3047,[161 204 174 135  98],653,4,12968,4.254593175853018,0.0,40.0
43048,4,3048,[302 603 100 318 191],13,3,12971,4.2541816989176775,40.0,20.0
43049,4,3049,[302 603 100 318 191],474,5,12976,4.254426229508197,40.0,20.0
43050,4,3050,[302 603 100 318 191],537,5,12981,4.254670599803343,40.0,20.0
43051,4,3051,[181 197 234 546 187],339,5,12986,4.254914809960682,0.0,0.0
43052,4,3052,[  4 385 323 265 289],474,3,12989,4.254503766786767,0.0,0.0
43053,4,3053,[302 603 100 318 191],524,4,12993,4.254420432220039,40.0,20.0
43054,4,3054,[ 88 191  12 111   4],533,4,12997,4.254337152209493,20.0,0.0
43055,4,3055,[302 603 100 318 191],524,4,13001,4.254253926701571,40.0,20.0
43056,4,3056,[ 22 655  95 127 168],234,2,13003,4.253516519463527,0.0,20.0
43057,4,3057,[302 603 100 318 191],454,5,13008,4.253760627861348,40.0,20.0
43058,4,3058,[222 238 183  69   7],64,5,13013,4.254004576659039,0.0,0.0
43059,4,3059,[302 603 100 318 191],474,5,13018,4.254248366013072,40.0,20.0
43060,4,3060,[111 496   7 181 135],64,5,13023,4.254491996079713,0.0,0.0
43061,4,3061,[  1 508 288 125   8],144,4,13027,4.254408883082952,0.0,0.0
43062,4,3062,[302 603 100 318 191],13,3,13030,4.25399934704538,40.0,20.0
43063,4,3063,[302 603 100 318 191],13,3,13033,4.2535900783289815,40.0,20.0
43064,4,3064,[302 603 100 318  64],458,5,13038,4.253833605220229,40.0,20.0
43065,4,3065,[302 603 100 318  64],454,5,13043,4.254076973255056,40.0,20.0
43066,4,3066,[302 603 100 318  64],883,5,13048,4.254320182588849,40.0,20.0
43067,4,3067,[302 603 100 318  64],524,3,13051,4.253911342894393,40.0,20.0
43068,4,3068,[302 603 100 318 174],271,5,13056,4.254154447702835,40.0,40.0
43069,4,3069,[175  11 238 385 127],308,5,13061,4.254397394136808,0.0,20.0
43070,4,3070,[508  22 202 180 191],6,2,13063,4.253663301856073,0.0,0.0
43071,4,3071,[ 64 200 161 135   1],455,5,13068,4.25390625,0.0,0.0
43072,4,3072,[ 79 483 211  82 234],524,5,13073,4.254149040026033,20.0,0.0
43073,4,3073,[302 603 100 318 174],474,5,13078,4.2543916720884845,40.0,40.0
43074,4,3074,[302 603 100 318 174],474,5,13083,4.254634146341464,40.0,40.0
43075,4,3075,[302 603 100 174 318],90,5,13088,4.254876462938881,40.0,40.0
43076,4,3076,[302 603 100 174 318],90,5,13093,4.255118622034449,40.0,40.0
43077,4,3077,[302 603 174 100 318],524,4,13097,4.255035737491878,40.0,40.0
43078,4,3078,[302 603 174 100 318],271,5,13102,4.255277687560897,40.0,40.0
43079,4,3079,[302 603 174 100 318],474,5,13107,4.255519480519481,40.0,40.0
43080,4,3080,[302 603 174 100 318],664,5,13112,4.255761116520611,40.0,40.0
43081,4,3081,[302 603 174 100 318],664,5,13117,4.256002595717066,40.0,40.0
43082,4,3082,[127  79 496 151 405],64,3,13120,4.255595199481025,0.0,20.0
43083,4,3083,[ 97 742 405  25   1],378,4,13124,4.255512321660182,0.0,0.0
43084,4,3084,[302 174 603 100 318],90,5,13129,4.255753646677472,40.0,40.0
43085,4,3085,[302 174 603 100 318],524,4,13133,4.255670771224887,40.0,40.0
43086,4,3086,[302 174 603 100 318],666,4,13137,4.2555879494655,40.0,40.0
43087,4,3087,[  4 276 405 546 238],554,1,13138,4.254533678756476,0.0,0.0
43088,4,3088,[302 603 100 174 318],664,5,13143,4.254775008093234,40.0,40.0
43089,4,3089,[302 603 100 174 318],524,4,13147,4.254692556634304,40.0,40.0
43090,4,3090,[302 174 100 603 318],664,5,13152,4.254933678421223,40.0,40.0
43091,4,3091,[ 82  64 222 228   7],374,4,13156,4.254851228978008,0.0,0.0
43092,4,3092,[302 174 603 100 318],454,5,13161,4.255092143549952,40.0,40.0
43093,4,3093,[302 174 603 100 318],458,4,13165,4.255009696186167,40.0,40.0
43094,4,3094,[302 603 100 318 174],524,4,13169,4.254927302100161,40.0,40.0
43095,4,3095,[302 100 318 603 174],90,5,13174,4.2551679586563305,40.0,40.0
43096,4,3096,[194 385 273 135 318],666,2,13176,4.254439780432676,20.0,0.0
43097,4,3097,[302 100 318 603 174],334,5,13181,4.2546804389928985,40.0,40.0
43098,4,3098,[302 100 603 318 174],90,5,13186,4.2549209422394325,40.0,40.0
43099,4,3099,[300 282 405  28 125],653,2,13188,4.2541935483870965,0.0,0.0
43100,4,3100,[302 100 603 318 174],524,4,13192,4.254111576910674,40.0,40.0
43101,4,3101,[ 96 286 275 313  82],533,5,13197,4.254352030947776,0.0,0.0
43102,4,3102,[302 100 174 318 603],13,4,13201,4.254270061231066,40.0,40.0
43103,4,3103,[302 100 174 318 603],458,4,13205,4.254188144329897,40.0,40.0
43104,4,3104,[302 100 318 603 191],13,3,13208,4.25378421900161,40.0,20.0
43105,4,3105,[302 100 318 603  64],90,5,13213,4.2540244687701225,40.0,20.0
43106,4,3106,[302 100 318 603  64],454,5,13218,4.254264563887995,40.0,20.0
43107,4,3107,[302 100 318 603  64],271,5,13223,4.254504504504505,40.0,20.0
43108,4,3108,[302 100 318 603  64],13,4,13227,4.254422643936957,40.0,20.0
43109,4,3109,[302 100 603 318  64],232,5,13232,4.254662379421222,40.0,20.0
43110,4,3110,[302 100 603 318  64],90,5,13237,4.254901960784314,40.0,20.0
43111,4,3111,[302 100 603 318  64],666,5,13242,4.255141388174807,40.0,20.0
43112,4,3112,[302 100 603 318  64],458,5,13247,4.255380661741086,40.0,20.0
43113,4,3113,[302 100 603 318  64],90,5,13252,4.255619781631342,40.0,20.0
43114,4,3114,[302 100 603 318  64],524,3,13255,4.255216693418941,40.0,20.0
43115,4,3115,[302 100 318 603  64],271,5,13260,4.2554557124518615,40.0,20.0
43116,4,3116,[ 79 678 127 161 588],308,3,13263,4.255052935514918,0.0,20.0
43117,4,3117,[302 100 318 603  64],664,5,13268,4.255291853752405,40.0,20.0
43118,4,3118,[302 100 318 603  64],524,3,13271,4.254889387624239,40.0,20.0
43119,4,3119,[100 282 185 385 265],666,2,13273,4.254166666666666,0.0,20.0
43120,4,3120,[302 100 318 603  64],13,4,13277,4.254085229093239,40.0,20.0
43121,4,3121,[302 100 318 603  64],454,5,13282,4.254324151185138,40.0,20.0
43122,4,3122,[302 100 318 603  64],13,4,13286,4.254242715337816,40.0,20.0
43123,4,3123,[302 100 318 603  64],271,5,13291,4.254481434058899,40.0,20.0
43124,4,3124,[302 100 318 603  64],537,4,13295,4.2544,40.0,20.0
43125,4,3125,[302 100 318 603 191],13,3,13298,4.253998720409469,40.0,20.0
43126,4,3126,[302 100 318 603  64],232,5,13303,4.254237288135593,40.0,20.0
43127,4,3127,[302 100 318 603  64],232,5,13308,4.254475703324808,40.0,20.0
43128,4,3128,[204 172 423 179 173],311,4,13312,4.254394375199745,0.0,0.0
43129,4,3129,[302 100 603 318  64],524,3,13315,4.253993610223642,40.0,20.0
43130,4,3130,[302 100 318 603 191],13,3,13318,4.253593101245609,40.0,20.0
43131,4,3131,[ 64 175 508 125 173],378,4,13322,4.253512132822478,0.0,0.0
43132,4,3132,[302 100 318 603  64],883,5,13327,4.253750398978615,40.0,20.0
43133,4,3133,[302 100 318 603  64],524,3,13330,4.253350350989151,40.0,20.0
43134,4,3134,[302 100 318 191  64],664,4,13334,4.2532695374800635,20.0,20.0
43135,4,3135,[302 100 318  64 191],343,5,13339,4.253507653061225,20.0,20.0
43136,4,3136,[302 100 318  64 191],524,4,13343,4.253426840930826,20.0,20.0
43137,4,3137,[ 11  79 313 222 515],334,5,13348,4.253664754620778,0.0,0.0
43138,4,3138,[302 100 318 191 603],666,5,13353,4.253902516725072,40.0,20.0
43139,4,3139,[302 100 318 603 191],232,5,13358,4.254140127388535,40.0,20.0
43140,4,3140,[276 173 168 328 318],334,4,13362,4.254059216809933,20.0,0.0
43141,4,3141,[302 100 318 603 191],474,5,13367,4.254296626352642,40.0,20.0
43142,4,3142,[603 127 173  22 118],804,4,13371,4.254215717467388,20.0,20.0
43143,4,3143,[742 357 234 211 174],788,2,13373,4.253498727735369,20.0,20.0
43144,4,3144,[302 100 318 603 191],666,5,13378,4.253736089030206,40.0,20.0
43145,4,3145,[302 100 318 603 191],524,4,13382,4.253655435473617,40.0,20.0
43146,4,3146,[302 100 318 191  64],474,5,13387,4.253892596123292,20.0,20.0
43147,4,3147,[144 301 132 153 121],788,3,13390,4.253494282083863,0.0,0.0
43148,4,3148,[302 100 318 191  64],207,4,13394,4.253413782153064,20.0,20.0
43149,4,3149,[161 435 183 153 180],932,4,13398,4.253333333333333,0.0,0.0
43150,4,3150,[302 100 318 191  64],474,5,13403,4.2535702951443985,20.0,20.0
43151,4,3151,[302 100 318 191  64],207,4,13407,4.253489847715736,20.0,20.0
43152,4,3152,[302 100 318 191  64],605,5,13412,4.253726609578179,20.0,20.0
43153,4,3153,[  4 117 186 301 265],328,3,13415,4.253329105897273,0.0,0.0
43154,4,3154,[ 97 385 179 161  28],64,3,13418,4.252931854199683,0.0,0.0
43155,4,3155,[302 100 318 191  64],343,5,13423,4.253168567807351,20.0,20.0
43156,4,3156,[100  95 117 655 318],537,2,13425,4.25245486221096,20.0,20.0
43157,4,3157,[302 100 318 191  64],343,5,13430,4.252691576947435,20.0,20.0
43158,4,3158,[302 100 318 191  64],271,5,13435,4.252928141817031,20.0,20.0
43159,4,3159,[302 100 318 191  64],537,4,13439,4.252848101265823,20.0,20.0
43160,4,3160,[195 202   1 357 204],42,5,13444,4.253084466940842,20.0,0.0
43161,4,3161,[302 100 318 191  64],664,4,13448,4.2530044275774825,20.0,20.0
43162,4,3162,[302 100 318 191  64],454,5,13453,4.253240594372431,20.0,20.0
43163,4,3163,[302 100 318 191  64],6,5,13458,4.253476611883691,20.0,20.0
43164,4,3164,[302 100 318 191  64],474,5,13463,4.253712480252765,20.0,20.0
43165,4,3165,[302 100 318 191  64],13,3,13466,4.253316487681617,20.0,20.0
43166,4,3166,[302 100 318 191  64],537,4,13470,4.253236501420903,20.0,20.0
43167,4,3167,[302 100 318 191  64],605,5,13475,4.253472222222222,20.0,20.0
43168,4,3168,[302 100 318 191  64],524,4,13479,4.253392237298833,20.0,20.0
43169,4,3169,[302 100 318 191  64],537,4,13483,4.253312302839117,20.0,20.0
43170,4,3170,[302 100 318 191  64],458,5,13488,4.253547776726585,20.0,20.0
43171,4,3171,[302 100 318 191  64],664,4,13492,4.253467843631778,20.0,20.0
43172,4,3172,[322 187  11  98 182],334,3,13495,4.253072801764891,0.0,20.0
43173,4,3173,[302 100 318 191  64],666,5,13500,4.253308128544424,20.0,20.0
43174,4,3174,[302 100 318 191  64],13,3,13503,4.252913385826772,20.0,20.0
43175,4,3175,[546 748 211 289 328],13,2,13505,4.2522040302267,0.0,0.0
43176,4,3176,[302 100 318 191  64],474,5,13510,4.252439408246774,20.0,20.0
43177,4,3177,[302 100 318 191  64],537,4,13514,4.252359974826935,20.0,20.0
43178,4,3178,[302 100 318 191 603],334,5,13519,4.252595155709343,40.0,20.0
43179,4,3179,[302 100 318 191 603],232,5,13524,4.252830188679245,40.0,20.0
43180,4,3180,[655 180   1 276 175],343,5,13529,4.253065073876139,0.0,0.0
43181,4,3181,[302 100 318 191 603],271,5,13534,4.253299811439346,40.0,20.0
43182,4,3182,[ 12 187   9   4 269],343,5,13539,4.253534401508011,20.0,0.0
43183,4,3183,[302 100 318 603 191],664,4,13543,4.253454773869347,40.0,20.0
43184,4,3184,[181 117 191 144 195],738,4,13547,4.253375196232339,0.0,0.0
43185,4,3185,[302 100 318 603 191],90,5,13552,4.253609541745135,40.0,20.0
43186,4,3186,[302 100 318 603 191],454,5,13557,4.25384374019454,40.0,20.0
43187,4,3187,[302 100 202 175  70],537,4,13561,4.253764115432873,0.0,20.0
43188,4,3188,[282 186 302 144  89],328,4,13565,4.253684540608341,0.0,0.0
43189,4,3189,[302 100 318 144 603],666,4,13569,4.2536050156739815,40.0,20.0
43190,4,3190,[302 100 318 603 191],271,5,13574,4.253838921968035,40.0,20.0
43191,4,3191,[568 195 300  71 172],506,4,13578,4.253759398496241,0.0,0.0
43192,4,3192,[302 100 318 603 191],232,5,13583,4.2539931099279675,40.0,20.0
43193,4,3193,[302 100 318 603 191],271,5,13588,4.254226675015654,40.0,20.0
43194,4,3194,[ 56  64 483   8  98],213,4,13592,4.25414710485133,20.0,20.0
43195,4,3195,[179 185 265 182  11],686,5,13597,4.254380475594493,0.0,0.0
43196,4,3196,[302 100 318 603 191],524,4,13601,4.254300907100407,40.0,20.0
43197,4,3197,[  4 655 546 238 508],774,1,13602,4.25328330206379,0.0,0.0
43198,4,3198,[222 357 168  56  64],311,5,13607,4.253516723976243,20.0,0.0
43199,4,3199,[546 276 186  96 182],881,2,13609,4.2528125,0.0,0.0
43200,4,3200,[302 100 318 191 603],524,4,13613,4.252733520774758,40.0,20.0
43201,4,3201,[302 100 318 191  64],605,5,13618,4.252966895690194,20.0,20.0
43202,4,3202,[302 100 318 191  64],474,5,13623,4.253200124882922,20.0,20.0
43203,4,3203,[302 100 318 191  64],6,5,13628,4.253433208489389,20.0,20.0
43204,4,3204,[302 100 318 191  64],6,5,13633,4.253666146645866,20.0,20.0
43205,4,3205,[302 100 318 191  64],343,5,13638,4.253898939488459,20.0,20.0
43206,4,3206,[302 100 318 191  64],664,4,13642,4.253819769254755,20.0,20.0
43207,4,3207,[ 28 210 172 151 135],379,5,13647,4.254052369077307,0.0,0.0
43208,4,3208,[302 100 318 191  64],13,3,13650,4.253661576815207,20.0,20.0
43209,4,3209,[302 100 318 191  64],13,3,13653,4.253271028037383,20.0,20.0
43210,4,3210,[302 100 318 191  64],207,4,13657,4.2531921519775775,20.0,20.0
43211,4,3211,[210 173  79 273 588],387,4,13661,4.2531133250311335,0.0,0.0
43212,4,3212,[286 215 176 151 125],234,0,13661,4.2517896047307815,0.0,0.0
43213,4,3213,[302 100 318 191  64],664,4,13665,4.251711263223398,20.0,20.0
43214,4,3214,[302 100 318  64 191],378,5,13670,4.25194401244168,20.0,20.0
43215,4,3215,[302 100 318  64 191],537,4,13674,4.251865671641791,20.0,20.0
43216,4,3216,[302 100 318 191  64],13,3,13677,4.251476530929438,20.0,20.0
43217,4,3217,[302 100 318  64 191],207,4,13681,4.251398384089496,20.0,20.0
43218,4,3218,[200 294 168 125 202],271,2,13683,4.250698974836906,0.0,0.0
43219,4,3219,[302 100 318  64 191],537,4,13687,4.250621118012423,20.0,20.0
43220,4,3220,[176 185 204  88 153],398,5,13692,4.250853772120459,0.0,0.0
43221,4,3221,[302 100 318 191  64],13,3,13695,4.250465549348231,20.0,20.0
43222,4,3222,[302 100 318 191  64],6,5,13700,4.250698107353397,20.0,20.0
43223,4,3223,[302 100 318  64 191],207,4,13704,4.250620347394541,20.0,20.0
43224,4,3224,[302 100 318  64 191],474,5,13709,4.250852713178294,20.0,20.0
43225,4,3225,[302 100 318  64 191],458,5,13714,4.251084934903906,20.0,20.0
43226,4,3226,[302 100 318  64 191],524,4,13718,4.251007127362875,20.0,20.0
43227,4,3227,[186 235 385 302 357],13,2,13720,4.250309789343246,20.0,0.0
43228,4,3228,[302 100 318 191  64],664,4,13724,4.250232270052648,20.0,20.0
43229,4,3229,[191 333 143 435 515],458,4,13728,4.25015479876161,0.0,0.0
43230,4,3230,[194 215 357 294 127],615,4,13732,4.2500773754255645,20.0,20.0
43231,4,3231,[302 100 318 191  64],524,4,13736,4.25,20.0,20.0
43232,4,3232,[302 100 318 191  64],232,5,13741,4.250231982678627,20.0,20.0
43233,4,3233,[302 100 318 191  64],474,5,13746,4.250463821892393,20.0,20.0
43234,4,3234,[427 172 143 181  70],85,4,13750,4.250386398763524,0.0,0.0
43235,4,3235,[302 100 318 191  64],524,4,13754,4.2503090234857845,20.0,20.0
43236,4,3236,[302 100 318 191  64],6,5,13759,4.2505406240346,20.0,20.0
43237,4,3237,[302 100 318 191  64],666,5,13764,4.25077208153181,20.0,20.0
43238,4,3238,[302 100 318 191  64],605,5,13769,4.25100339610991,20.0,20.0
43239,4,3239,[302 100 318 191  64],207,4,13773,4.250925925925926,20.0,20.0
43240,4,3240,[302 100 318 191  64],13,3,13776,4.250539956803456,20.0,20.0
43241,4,3241,[302 100 318 191  64],524,4,13780,4.250462677359654,20.0,20.0
43242,4,3242,[302 100 318 191  64],271,5,13785,4.250693802035153,20.0,20.0
43243,4,3243,[302 100 318 191  64],664,4,13789,4.250616522811344,20.0,20.0
43244,4,3244,[302 100 318 191  64],664,4,13793,4.250539291217257,20.0,20.0
43245,4,3245,[302 100 318 191  64],13,3,13796,4.250154035736291,20.0,20.0
43246,4,3246,[302 100 318 191  64],6,5,13801,4.250384970742224,20.0,20.0
43247,4,3247,[302 100 318  64 191],271,5,13806,4.250615763546798,20.0,20.0
43248,4,3248,[143 127   4 276 357],343,5,13811,4.250846414281317,20.0,20.0
43249,4,3249,[302 100 318  64 191],474,5,13816,4.251076923076923,20.0,20.0
43250,4,3250,[302 100 318  64 191],271,5,13821,4.251307290064595,20.0,20.0
43251,4,3251,[168 357 161 125  50],899,4,13825,4.251230012300123,20.0,20.0
43252,4,3252,[302 100 318  64 191],378,5,13830,4.251460190593298,20.0,20.0
43253,4,3253,[302 100 318  64 191],343,5,13835,4.251690227412415,20.0,20.0
43254,4,3254,[302 100 318  64 191],458,5,13840,4.2519201228878645,20.0,20.0
43255,4,3255,[302 100 318  64 191],207,4,13844,4.2518427518427515,20.0,20.0
43256,4,3256,[302 100 318  64 191],664,4,13848,4.251765428308259,20.0,20.0
43257,4,3257,[302 100 318  64 191],524,4,13852,4.2516881522406385,20.0,20.0
43258,4,3258,[302 100 318  64 191],207,4,13856,4.251610923596195,20.0,20.0
43259,4,3259,[302 100 318  64 191],343,5,13861,4.251840490797546,20.0,20.0
43260,4,3260,[302 100 318  64 191],343,5,13866,4.252069917203312,20.0,20.0
43261,4,3261,[302 100 318  64 191],207,4,13870,4.251992642550582,20.0,20.0
43262,4,3262,[302 100 318  64 191],6,5,13875,4.252221881703953,20.0,20.0
43263,4,3263,[318 197 118 168 276],311,4,13879,4.252144607843137,20.0,0.0
43264,4,3264,[302 100 318  64 191],144,4,13883,4.252067381316999,20.0,20.0
43265,4,3265,[302 100 318  64 191],524,4,13887,4.251990202082058,20.0,20.0
43266,4,3266,[302 100 318 191  64],271,5,13892,4.25221916131007,20.0,20.0
43267,4,3267,[302 100 318 191  64],454,5,13897,4.252447980416156,20.0,20.0
43268,4,3268,[  9 175 176 508 172],334,2,13899,4.251758947690425,0.0,0.0
43269,4,3269,[302 100 318 191  64],605,5,13904,4.251987767584098,20.0,20.0
43270,4,3270,[302 100 318 191  64],458,5,13909,4.252216447569551,20.0,20.0
43271,4,3271,[302 100 318 191  64],232,5,13914,4.252444987775061,20.0,20.0
43272,4,3272,[302 100 318 191  64],378,5,13919,4.25267338832875,20.0,20.0
43273,4,3273,[245 117 100 508 655],207,2,13921,4.25198533903482,0.0,20.0
43274,4,3274,[302 100 318 191  64],207,4,13925,4.251908396946565,20.0,20.0
43275,4,3275,[302 100 318 191  64],524,4,13929,4.251831501831502,20.0,20.0
43276,4,3276,[302 100 318 191  64],90,5,13934,4.252059810802563,20.0,20.0
43277,4,3277,[302 100 318 191  64],666,5,13939,4.2522879804758995,20.0,20.0
43278,4,3278,[ 56  69 235 427 153],374,3,13942,4.251906068923453,0.0,0.0
43279,4,3279,[  1 135 588 118 153],795,2,13944,4.251219512195122,0.0,0.0
43280,4,3280,[ 50  56 435 174 237],901,3,13947,4.250838159097836,0.0,40.0
43281,4,3281,[302 100 318 191  64],378,5,13952,4.251066422912858,20.0,20.0
43282,4,3282,[302 100 318 191  64],605,5,13957,4.251294547669814,20.0,20.0
43283,4,3283,[302 100 318 191  64],207,4,13961,4.2512180267965896,20.0,20.0
43284,4,3284,[ 98 144 111  25 328],13,3,13964,4.250837138508372,0.0,20.0
43285,4,3285,[302 100 318 191  64],378,5,13969,4.251065124771759,20.0,20.0
43286,4,3286,[302 100 318 191  64],271,5,13974,4.251292972315181,20.0,20.0
43287,4,3287,[302 100 318 191  64],664,4,13978,4.2512165450121655,20.0,20.0
43288,4,3288,[302 100 318 191  64],605,5,13983,4.251444207965947,20.0,20.0
43289,4,3289,[187 597 357  15   8],144,5,13988,4.251671732522796,20.0,0.0
43290,4,3290,[302 100 318 187 191],474,5,13993,4.251899118808873,20.0,20.0
43291,4,3291,[127 186 403 228 546],339,4,13997,4.251822600243013,0.0,20.0
43292,4,3292,[302 100 318 187 191],664,4,14001,4.251746128150622,20.0,20.0
43293,4,3293,[423  79 180 323 238],311,4,14005,4.251669702489375,0.0,0.0
43294,4,3294,[302 100 318 187  64],207,4,14009,4.251593323216995,20.0,20.0
43295,4,3295,[302 100 187 318  64],788,5,14014,4.251820388349515,20.0,20.0
43296,4,3296,[302 187 100 318  64],144,4,14018,4.251744009705793,20.0,20.0
43297,4,3297,[302 187 100 318  64],666,5,14023,4.251970891449363,20.0,20.0
43298,4,3298,[302 187 100 318  64],458,5,14028,4.252197635647166,20.0,20.0
43299,4,3299,[302 187 100 318  64],271,5,14033,4.252424242424242,20.0,20.0
43300,4,3300,[302 187 100 318  64],605,5,14038,4.252650711905483,20.0,20.0
43301,4,3301,[302 187 100 318  64],605,5,14043,4.2528770442156265,20.0,20.0
43302,4,3302,[302 187 100 318  64],524,4,14047,4.252800484408114,20.0,20.0
43303,4,3303,[302 187 100 318  64],788,5,14052,4.253026634382566,20.0,20.0
43304,4,3304,[302 187 100 318  64],788,5,14057,4.253252647503782,20.0,20.0
43305,4,3305,[302 187 100 318  64],605,5,14062,4.2534785238959465,20.0,20.0
43306,4,3306,[302 187 100 318  64],271,5,14067,4.253704263683097,20.0,20.0
43307,4,3307,[302 187 100 318  64],458,5,14072,4.253929866989117,20.0,20.0
43308,4,3308,[302 187 100 318  64],328,5,14077,4.254155333937746,20.0,20.0
43309,4,3309,[302 187 100 318  64],271,5,14082,4.254380664652568,20.0,20.0
43310,4,3310,[302 187 100 318  64],13,4,14086,4.254303835699185,20.0,20.0
43311,4,3311,[302 187 100 318  64],13,4,14090,4.254227053140097,20.0,20.0
43312,4,3312,[211 175 228 273  22],387,5,14095,4.254452158164805,0.0,0.0
43313,4,3313,[302 187 100 318  64],666,5,14100,4.254677127338564,20.0,20.0
43314,4,3314,[ 15 179  70  88 405],95,3,14103,4.254298642533937,0.0,0.0
43315,4,3315,[302 187 100 318  64],605,5,14108,4.254523522316044,20.0,20.0
43316,4,3316,[302 187 100 318  64],90,5,14113,4.254748266505879,20.0,20.0
43317,4,3317,[302 187 100 318  64],6,5,14118,4.25497287522604,20.0,20.0
43318,4,3318,[302 187 100 318  64],6,5,14123,4.255197348598975,20.0,20.0
43319,4,3319,[302 187 100 318  64],537,4,14127,4.255120481927711,20.0,20.0
43320,4,3320,[302 187 100 318  64],144,4,14131,4.2550436615477265,20.0,20.0
43321,4,3321,[302 187 100 318  64],666,5,14136,4.25526791089705,20.0,20.0
43322,4,3322,[302 187 100 318  64],666,5,14141,4.255492025278363,20.0,20.0
43323,4,3323,[302 187 100 318  64],13,4,14145,4.255415162454874,20.0,20.0
43324,4,3324,[302 187 100 318  64],524,4,14149,4.255338345864661,20.0,20.0
43325,4,3325,[186 286 135   8 423],234,3,14152,4.254960914010824,0.0,0.0
43326,4,3326,[302 187 100 318  64],474,5,14157,4.2551848512173125,20.0,20.0
43327,4,3327,[182   8 216 183 195],308,4,14161,4.255108173076923,0.0,0.0
43328,4,3328,[302 187 100 318  64],343,5,14166,4.255331931510964,20.0,20.0
43329,4,3329,[302 187 100 318  64],537,4,14170,4.255255255255255,20.0,20.0
43330,4,3330,[302 187 100 318 191],524,5,14175,4.255478835184629,20.0,20.0
43331,4,3331,[302 187 100 318 191],144,4,14179,4.255402160864346,20.0,20.0
43332,4,3332,[748 568 515  96  98],881,3,14182,4.2550255025502555,0.0,20.0
43333,4,3333,[191 294   1 405 597],95,2,14184,4.254349130173965,0.0,0.0
43334,4,3334,[302 187 100 318 191],605,5,14189,4.254572713643179,20.0,20.0
43335,4,3335,[302 187 100 318 191],13,3,14192,4.2541966426858515,20.0,20.0
43336,4,3336,[302 187 100 318  64],664,5,14197,4.254420137848367,20.0,20.0
43337,4,3337,[117 202 258 228   7],653,2,14199,4.2537447573397245,0.0,0.0
43338,4,3338,[302 187 100 318  64],664,5,14204,4.253968253968254,20.0,20.0
43339,4,3339,[302 187 100 318  64],666,5,14209,4.254191616766467,20.0,20.0
43340,4,3340,[302 187 100 318  64],664,5,14214,4.2544148458545346,20.0,20.0
43341,4,3341,[302 187 100 318  64],666,5,14219,4.254637941352484,20.0,20.0
43342,4,3342,[302 187 100 318  64],664,5,14224,4.254860903380197,20.0,20.0
43343,4,3343,[302 187 100 318  64],328,5,14229,4.255083732057416,20.0,20.0
43344,4,3344,[302 187 100 318  64],343,5,14234,4.255306427503737,20.0,20.0
43345,4,3345,[302 187 100 318  64],343,5,14239,4.255528989838613,20.0,20.0
43346,4,3346,[302 187 100 318  64],343,5,14244,4.255751419181356,20.0,20.0
43347,4,3347,[302 187 100 318  64],605,5,14249,4.255973715651135,20.0,20.0
43348,4,3348,[302 187 100 318  64],788,5,14254,4.256195879366976,20.0,20.0
43349,4,3349,[302 187 100 318  64],328,5,14259,4.2564179104477615,20.0,20.0
43350,4,3350,[302 187 100 318  64],458,5,14264,4.256639809012235,20.0,20.0
43351,4,3351,[302 187 100 318  64],537,4,14268,4.256563245823389,20.0,20.0
43352,4,3352,[302 187 100 318  64],6,5,14273,4.25678496868476,20.0,20.0
43353,4,3353,[302 187 100 318  64],788,5,14278,4.257006559332141,20.0,20.0
43354,4,3354,[302 187 100 318  64],666,5,14283,4.257228017883755,20.0,20.0
43355,4,3355,[302 187 100 318  64],537,4,14287,4.25715137067938,20.0,20.0
43356,4,3356,[302 187 100 318  64],207,4,14291,4.257074769139113,20.0,20.0
43357,4,3357,[302 187 100 318  64],346,2,14293,4.2564026206075045,20.0,20.0
43358,4,3358,[302 187 100 318  64],343,5,14298,4.256623995236677,20.0,20.0
43359,4,3359,[265 385   1 179 143],13,1,14299,4.255654761904762,0.0,0.0
43360,4,3360,[117 289 132  64 172],406,4,14303,4.255578696816424,0.0,0.0
43361,4,3361,[302 187 100 318  64],90,5,14308,4.2558001189768,20.0,20.0
43362,4,3362,[265  64 238 144 742],95,4,14312,4.255724055902468,0.0,0.0
43363,4,3363,[423 121 132   9   1],533,5,14317,4.2559453032104635,0.0,0.0
43364,4,3364,[302 187 100 318  64],458,5,14322,4.2561664190193165,20.0,20.0
43365,4,3365,[121 182  97 403   7],339,3,14325,4.255793226381462,0.0,0.0
43366,4,3366,[302 187 100 318  64],346,2,14327,4.255123255123255,20.0,20.0
43367,4,3367,[302 187 100 318  64],207,4,14331,4.255047505938243,20.0,20.0
43368,4,3368,[302 187 100 318  64],524,4,14335,4.254971801721579,20.0,20.0
43369,4,3369,[302 187 100 318  64],271,5,14340,4.255192878338279,20.0,20.0
43370,4,3370,[302 187 100 318  64],6,5,14345,4.25541382379116,20.0,20.0
43371,4,3371,[546 276 475 211 202],699,1,14346,4.254448398576512,0.0,0.0
43372,4,3372,[302 187 100 318  64],788,5,14351,4.254669433738512,20.0,20.0
43373,4,3373,[121 100  88 265   8],474,5,14356,4.25489033787789,0.0,20.0
43374,4,3374,[302 187 100 318  64],474,5,14361,4.255111111111111,20.0,20.0
43375,4,3375,[302 187 100 318  64],537,4,14365,4.255035545023697,20.0,20.0
43376,4,3376,[302 187 100 318  64],6,5,14370,4.2552561445069585,20.0,20.0
43377,4,3377,[302 187 100 318  64],605,5,14375,4.255476613380699,20.0,20.0
43378,4,3378,[302 187 100 318  64],207,4,14379,4.255401006214856,20.0,20.0
43379,4,3379,[302 187 100 318  64],90,5,14384,4.255621301775148,20.0,20.0
43380,4,3380,[302 187 100 318  64],328,5,14389,4.255841467021591,20.0,20.0
43381,4,3381,[302 187 100 318  64],664,5,14394,4.256061502069781,20.0,20.0
43382,4,3382,[302 187 100 318  64],788,5,14399,4.256281407035176,20.0,20.0
43383,4,3383,[302 187 100 318  64],328,5,14404,4.256501182033097,20.0,20.0
43384,4,3384,[302 187 100 318  64],13,4,14408,4.2564254062038405,20.0,20.0
43385,4,3385,[302 187 100 318  64],343,5,14413,4.256645008860012,20.0,20.0
43386,4,3386,[302 187 100 318  64],13,4,14417,4.256569235311485,20.0,20.0
43387,4,3387,[302 187 100 318  64],664,5,14422,4.256788665879575,20.0,20.0
43388,4,3388,[302 187 100 318  64],537,4,14426,4.2567128946591914,20.0,20.0
43389,4,3389,[302 187 100 318  64],458,5,14431,4.256932153392331,20.0,20.0
43390,4,3390,[302 187 100 318  64],605,5,14436,4.257151282807431,20.0,20.0
43391,4,3391,[302 187 100 318  64],207,4,14440,4.257075471698113,20.0,20.0
43392,4,3392,[286 301 161 273 181],378,4,14444,4.256999705275567,0.0,0.0
43393,4,3393,[302 187 100 318  64],458,5,14449,4.257218621096052,20.0,20.0
43394,4,3394,[302 187 100 318  64],474,5,14454,4.257437407952872,20.0,20.0
43395,4,3395,[302 187 100 318  64],605,5,14459,4.257656065959953,20.0,20.0
43396,4,3396,[ 28 151 655 183 179],59,5,14464,4.257874595231086,0.0,0.0
43397,4,3397,[302 187 100 318  64],343,5,14469,4.258092995879929,20.0,20.0
43398,4,3398,[302 187 100 318  64],343,5,14474,4.258311268020006,20.0,20.0
43399,4,3399,[302 187 100 318  64],13,4,14478,4.258235294117647,20.0,20.0
43400,4,3400,[111 173  71 258 200],749,4,14482,4.258159364892679,0.0,0.0
43401,4,3401,[302 187 100 318  64],605,5,14487,4.258377425044092,20.0,20.0
43402,4,3402,[302 187 100 318  64],605,5,14492,4.258595357037907,20.0,20.0
43403,4,3403,[302 187 100 318  64],666,5,14497,4.258813160987074,20.0,20.0
43404,4,3404,[273 597 515 132 181],92,3,14500,4.258443465491924,0.0,0.0
43405,4,3405,[302 187 100 318  64],346,2,14502,4.25778038755138,20.0,20.0
43406,4,3406,[302 187 100 318  64],328,5,14507,4.257998238919871,20.0,20.0
43407,4,3407,[202 568 597 258  12],59,3,14510,4.257629107981221,20.0,0.0
43408,4,3408,[302 187 100 318  64],524,4,14514,4.257553534760927,20.0,20.0
43409,4,3409,[302 187 100 318  64],13,4,14518,4.257478005865103,20.0,20.0
43410,4,3410,[302 187 100 318  64],788,5,14523,4.257695690413368,20.0,20.0
43411,4,3411,[302 187 100 318  64],144,4,14527,4.257620164126612,20.0,20.0
43412,4,3412,[302 187 100 318  64],343,5,14532,4.257837679460885,20.0,20.0
43413,4,3413,[427  98 496 111 176],666,4,14536,4.25776215582894,0.0,20.0
43414,4,3414,[302 187 100 318  64],537,4,14540,4.257686676427525,20.0,20.0
43415,4,3415,[302 187 100 318  64],271,5,14545,4.257903981264637,20.0,20.0
43416,4,3416,[302 187 100 318  64],6,5,14550,4.258121158911326,20.0,20.0
43417,4,3417,[302 187 100 318  64],343,5,14555,4.258338209479228,20.0,20.0
43418,4,3418,[ 50 276 182 195 238],881,2,14557,4.257677683533196,0.0,20.0
43419,4,3419,[302 187 100 318  64],13,4,14561,4.257602339181287,20.0,20.0
43420,4,3420,[302 187 100 318  64],328,5,14566,4.2578193510669395,20.0,20.0
43421,4,3421,[302 187 100 318  64],666,5,14571,4.258036236119229,20.0,20.0
43422,4,3422,[210 175  89 127 182],804,4,14575,4.257960853052878,0.0,20.0
43423,4,3423,[302 187 100 318  64],328,5,14580,4.258177570093458,20.0,20.0
43424,4,3424,[302 187 100 318  64],664,5,14585,4.258394160583942,20.0,20.0
43425,4,3425,[302 187 100 318  64],207,4,14589,4.258318739054291,20.0,20.0
43426,4,3426,[302 187 100 318  64],328,5,14594,4.258535161949227,20.0,20.0
43427,4,3427,[302 187 100 318  64],343,5,14599,4.2587514585764294,20.0,20.0
43428,4,3428,[211 174 183 186  98],882,5,14604,4.258967629046369,0.0,40.0
43429,4,3429,[302 187 100 318  64],474,5,14609,4.259183673469388,20.0,20.0
43430,4,3430,[302 187 100 318  64],328,5,14614,4.259399591955698,20.0,20.0
43431,4,3431,[302 187 100 318  64],537,4,14618,4.2593240093240095,20.0,20.0
43432,4,3432,[302 187 100 318  64],13,4,14622,4.259248470725313,20.0,20.0
43433,4,3433,[197 179 196 161  50],694,5,14627,4.259464181712289,0.0,20.0
43434,4,3434,[302 187 100 318  64],343,5,14632,4.259679767103348,20.0,20.0
43435,4,3435,[302 187 100 318  64],328,5,14637,4.259895227008149,20.0,20.0
43436,4,3436,[302 187 100 318  64],346,2,14639,4.25923770730288,20.0,20.0
43437,4,3437,[302 187 100 318  64],537,4,14643,4.2591623036649215,20.0,20.0
43438,4,3438,[302 187 100 318  64],666,5,14648,4.259377726083164,20.0,20.0
43439,4,3439,[300 191 508 204 176],13,1,14649,4.25843023255814,0.0,0.0
43440,4,3440,[302 187 100 318  64],605,5,14654,4.25864574251671,20.0,20.0
43441,4,3441,[302 187 100 318  64],605,5,14659,4.258861127251598,20.0,20.0
43442,4,3442,[302 187 100 318  64],537,4,14663,4.258785942492013,20.0,20.0
43443,4,3443,[302 187 100 318  64],666,5,14668,4.259001161440186,20.0,20.0
43444,4,3444,[483 385 427 180 151],666,3,14671,4.258635703918722,20.0,0.0
43445,4,3445,[288 200 742  79  97],387,2,14673,4.257980266976205,0.0,0.0
43446,4,3446,[302 187 100 318  64],788,5,14678,4.258195532346968,20.0,20.0
43447,4,3447,[302 187 100 318  64],90,5,14683,4.258410672853828,20.0,20.0
43448,4,3448,[302 187 100 318  64],788,5,14688,4.258625688605393,20.0,20.0
43449,4,3449,[302 187 100 318  64],207,4,14692,4.258550724637681,20.0,20.0
43450,4,3450,[302 187 100 318  64],6,5,14697,4.2587655751955955,20.0,20.0
43451,4,3451,[302 187 100 318  64],346,2,14699,4.25811123986095,20.0,20.0
43452,4,3452,[302 187 100 318  64],524,4,14703,4.2580364900086884,20.0,20.0
43453,4,3453,[302 187 100 318  64],13,4,14707,4.25796178343949,20.0,20.0
43454,4,3454,[302 187 100 318  64],605,5,14712,4.258176555716353,20.0,20.0
43455,4,3455,[302 187 100 318  64],664,5,14717,4.258391203703703,20.0,20.0
43456,4,3456,[302 187 100 318  64],524,4,14721,4.258316459357824,20.0,20.0
43457,4,3457,[302 187 100 318  64],6,5,14726,4.258530942741469,20.0,20.0
43458,4,3458,[302 187 100 318  64],664,5,14731,4.2587453021104364,20.0,20.0
43459,4,3459,[195 322 742   1  50],749,5,14736,4.258959537572254,0.0,20.0
43460,4,3460,[302 187 100 318  64],346,2,14738,4.25830684773187,20.0,20.0
43461,4,3461,[275  79  71 265   9],82,3,14741,4.257943385326401,0.0,0.0
43462,4,3462,[302 187 100 318  64],6,5,14746,4.258157666762922,20.0,20.0
43463,4,3463,[302 187 100 318  64],90,5,14751,4.25837182448037,20.0,20.0
43464,4,3464,[302 187 100 318  64],458,5,14756,4.2585858585858585,20.0,20.0
43465,4,3465,[302 187 100 318  64],664,5,14761,4.258799769186382,20.0,20.0
43466,4,3466,[302 187 100 318  64],664,5,14766,4.259013556388809,20.0,20.0
43467,4,3467,[302 187 100 318  64],524,4,14770,4.2589388696655135,20.0,20.0
43468,4,3468,[302 187 100 318  64],207,4,14774,4.258864226001729,20.0,20.0
43469,4,3469,[302 187 100 318  64],346,2,14776,4.25821325648415,20.0,20.0
43470,4,3470,[302 187 100 318  64],144,4,14780,4.258138864880438,20.0,20.0
43471,4,3471,[302 187 100 318  64],537,4,14784,4.258064516129032,20.0,20.0
43472,4,3472,[302 187 100 318  64],605,5,14789,4.258278145695364,20.0,20.0
43473,4,3473,[183 132  64  71 245],328,5,14794,4.258491652274036,0.0,0.0
43474,4,3474,[496 181 403  12 118],533,4,14798,4.258417266187051,20.0,0.0
43475,4,3475,[302 187 100 318  64],458,5,14803,4.258630609896433,20.0,20.0
43476,4,3476,[403   4 271 135 546],788,0,14803,4.257405809605983,0.0,0.0
43477,4,3477,[302 187 100 318  64],6,5,14808,4.257619321449108,20.0,20.0
43478,4,3478,[302 187 100 318  64],458,5,14813,4.257832710549009,20.0,20.0
43479,4,3479,[228  22 181 195 182],881,3,14816,4.257471264367816,0.0,0.0
43480,4,3480,[302 187 100 318  64],458,5,14821,4.257684573398449,20.0,20.0
43481,4,3481,[275 197 234  97   8],536,3,14824,4.257323377369328,0.0,0.0
43482,4,3482,[302 187 100 318  64],666,5,14829,4.257536606373816,20.0,20.0
43483,4,3483,[302 187 100 318  64],474,5,14834,4.2577497129735935,20.0,20.0
43484,4,3484,[302 187 100 318  64],537,4,14838,4.257675753228121,20.0,20.0
43485,4,3485,[302 187 100 318  64],343,5,14843,4.257888697647734,20.0,20.0
43486,4,3486,[302 187 100 318  64],328,5,14848,4.258101519931173,20.0,20.0
43487,4,3487,[302 187 100 318  64],664,5,14853,4.258314220183486,20.0,20.0
43488,4,3488,[302 187 100 318  64],664,5,14858,4.258526798509601,20.0,20.0
43489,4,3489,[302 187 100 318  64],90,5,14863,4.258739255014326,20.0,20.0
43490,4,3490,[302 187 100 318  64],458,5,14868,4.258951589802349,20.0,20.0
43491,4,3491,[ 64 235 294  69 179],378,2,14870,4.258304696449026,0.0,0.0
43492,4,3492,[302 187 100 318  64],788,5,14875,4.258517034068136,20.0,20.0
43493,4,3493,[302 187 100 318  64],664,5,14880,4.258729250143102,20.0,20.0
43494,4,3494,[286 276  97 183  50],234,2,14882,4.258082975679542,0.0,20.0
43495,4,3495,[302 187 100 318  64],207,4,14886,4.258009153318078,20.0,20.0
43496,4,3496,[302 187 100 318  64],328,5,14891,4.258221332570775,20.0,20.0
43497,4,3497,[471 300 235 153 195],13,1,14892,4.257289879931389,0.0,0.0
43498,4,3498,[187 294 313 234  22],474,4,14896,4.257216347527865,0.0,0.0
43499,4,3499,[215 195 496 181 211],533,5,14901,4.257428571428571,0.0,0.0
43500,4,3500,[302 187 100 318  64],343,5,14906,4.257640674093116,20.0,20.0
43501,4,3501,[302 187 100 318  64],6,5,14911,4.257852655625357,20.0,20.0
43502,4,3502,[302 187 100 318  64],346,2,14913,4.257208107336568,20.0,20.0
43503,4,3503,[302 187 100 318  64],207,4,14917,4.257134703196347,20.0,20.0
43504,4,3504,[ 25 118 276 204  97],455,4,14921,4.257061340941513,0.0,0.0
43505,4,3505,[405 185 182 286 235],59,2,14923,4.256417569880205,0.0,0.0
43506,4,3506,[302 187 100 318  64],524,4,14927,4.256344453949245,20.0,20.0
43507,4,3507,[302 187 100 318  64],664,5,14932,4.256556442417332,20.0,20.0
43508,4,3508,[100  96 286  98 235],406,4,14936,4.256483328583642,0.0,40.0
43509,4,3509,[302 187 100 318  64],458,5,14941,4.256695156695157,20.0,20.0
43510,4,3510,[294 423 118 405 385],825,5,14946,4.25690686414127,0.0,0.0
43511,4,3511,[302 187 100 318  64],537,4,14950,4.256833712984054,20.0,20.0
43512,4,3512,[302 187 100 318  64],524,4,14954,4.256760603472816,20.0,20.0
43513,4,3513,[496 289 435  98   1],387,2,14956,4.256118383608423,0.0,20.0
43514,4,3514,[302 187 100 318 191],343,5,14961,4.256330014224751,20.0,20.0
43515,4,3515,[302 187 100 318 191],13,3,14964,4.255972696245734,20.0,20.0
43516,4,3516,[302 187 100 318  64],474,5,14969,4.256184247938584,20.0,20.0
43517,4,3517,[302 187 100 318  64],666,5,14974,4.2563956793632745,20.0,20.0
43518,4,3518,[268 153 237 173 204],7,4,14978,4.256322818982666,0.0,0.0
43519,4,3519,[302 187 100 318  64],346,2,14980,4.255681818181818,20.0,20.0
43520,4,3520,[143  64 323 197 423],474,4,14984,4.25560920193127,0.0,0.0
43521,4,3521,[302 187 100 318  64],458,5,14989,4.2558205565019875,20.0,20.0
43522,4,3522,[302 187 100 318  64],207,4,14993,4.255747942094805,20.0,20.0
43523,4,3523,[302 187 100 318  64],271,5,14998,4.255959137343927,20.0,20.0
43524,4,3524,[302 187 100 318  64],328,5,15003,4.256170212765958,20.0,20.0
43525,4,3525,[ 28 678 271 180 238],615,2,15005,4.255530346001135,0.0,0.0
43526,4,3526,[302 187 100 318  64],664,5,15010,4.255741423305926,20.0,20.0
43527,4,3527,[302 187 100 318  64],13,4,15014,4.255668934240362,20.0,20.0
43528,4,3528,[302 187 100 318  64],90,5,15019,4.255879852649476,20.0,20.0
43529,4,3529,[302 187 100 318  64],666,5,15024,4.256090651558074,20.0,20.0
43530,4,3530,[302 187 100 318  64],90,5,15029,4.256301331067686,20.0,20.0
43531,4,3531,[302 187 100 318  64],328,5,15034,4.256511891279728,20.0,20.0
43532,4,3532,[302 187 100 318  64],524,4,15038,4.256439286725163,20.0,20.0
43533,4,3533,[302 187 100 318  64],346,2,15040,4.255800792303339,20.0,20.0
43534,4,3534,[302 187 100 318  64],144,4,15044,4.255728429985855,20.0,20.0
43535,4,3535,[302 187 100 318  64],666,5,15049,4.2559389140271495,20.0,20.0
43536,4,3536,[302 187 100 318  64],458,5,15054,4.256149279050042,20.0,20.0
43537,4,3537,[228 294 475 234 135],537,2,15056,4.255511588468061,0.0,0.0
43538,4,3538,[302 187 100 318  64],13,4,15060,4.255439389658095,20.0,20.0
43539,4,3539,[302 187 100 318  64],537,4,15064,4.255367231638418,20.0,20.0
43540,4,3540,[302 187 100 318  64],537,4,15068,4.25529511437447,20.0,20.0
43541,4,3541,[302 187 100 318 191],334,5,15073,4.255505364201016,20.0,20.0
43542,4,3542,[100  15 271 185 313],537,3,15076,4.255151001975727,0.0,20.0
43543,4,3543,[302 187 100 318 313],271,5,15081,4.255361173814898,20.0,20.0
43544,4,3544,[121 568 237 194 168],119,5,15086,4.255571227080395,0.0,0.0
43545,4,3545,[302 187 100 318 313],537,5,15091,4.255781161872532,20.0,20.0
43546,4,3546,[302 187 100 318 313],474,5,15096,4.255990978291514,20.0,20.0
43547,4,3547,[151  12 275 403  15],901,2,15098,4.255355129650507,20.0,0.0
43548,4,3548,[302 187 313 100 318],271,5,15103,4.2555649478726405,20.0,20.0
43549,4,3549,[302 187 313 100 318],334,5,15108,4.255774647887324,20.0,20.0
43550,4,3550,[475 269 302 100 111],634,5,15113,4.255984229794424,0.0,20.0
43551,4,3551,[ 98 176 210 742  79],648,5,15118,4.256193693693693,0.0,20.0
43552,4,3552,[302 187 313 100 318],271,5,15123,4.256403039684773,20.0,20.0
43553,4,3553,[302 187 313 100 318],474,5,15128,4.256612267867192,20.0,20.0
43554,4,3554,[302 187 313 100 318],537,5,15133,4.256821378340366,20.0,20.0
43555,4,3555,[302 187 313 100 318],474,5,15138,4.2570303712036,20.0,20.0
43556,4,3556,[175 179 282 111 143],207,3,15141,4.256676974978915,0.0,0.0
43557,4,3557,[655  88 333 322 748],313,2,15143,4.2560427206295675,0.0,0.0
43558,4,3558,[302 187 313 100 318],207,4,15147,4.255970778308513,20.0,20.0
43559,4,3559,[222   8 435  89  56],313,2,15149,4.255337078651685,0.0,0.0
43560,4,3560,[ 12  56 121 515 182],7,4,15153,4.255265374894693,20.0,0.0
43561,4,3561,[302 187 313 100 318],474,5,15158,4.255474452554744,20.0,20.0
43562,4,3562,[302 187 313 100 318],207,4,15162,4.255402750491159,20.0,20.0
43563,4,3563,[302 187 313 100 318],334,5,15167,4.255611672278339,20.0,20.0
43564,4,3564,[302 187 313 100 318],537,5,15172,4.255820476858345,20.0,20.0
43565,4,3565,[ 69 234 475 172 125],92,5,15177,4.256029164329782,0.0,0.0
43566,4,3566,[211 423  70  89 294],271,3,15180,4.255677039529016,0.0,0.0
43567,4,3567,[302 187 313 100 318],90,5,15185,4.255885650224215,20.0,20.0
43568,4,3568,[302 187 313 100 318],13,4,15189,4.255813953488372,20.0,20.0
43569,4,3569,[302 187 313 100 318],271,5,15194,4.256022408963585,20.0,20.0
43570,4,3570,[  8 144 385 143 222],234,1,15195,4.255110613273593,0.0,0.0
43571,4,3571,[302 187 313 100 318],537,5,15200,4.25531914893617,20.0,20.0
43572,4,3572,[302 187 313 100 318],328,5,15205,4.255527567870137,20.0,20.0
43573,4,3573,[302 187 313 100 318],334,5,15210,4.255735870173475,20.0,20.0
43574,4,3574,[302 187 313 100 318],144,4,15214,4.255664335664336,20.0,20.0
43575,4,3575,[302 187 313 100 318],90,5,15219,4.255872483221476,20.0,20.0
43576,4,3576,[151 111 269 471  69],524,4,15223,4.255800950517193,0.0,0.0
43577,4,3577,[302 313 187 100 318],537,5,15228,4.256008943543879,20.0,20.0
43578,4,3578,[302 313 187 100 318],334,5,15233,4.256216820340877,20.0,20.0
43579,4,3579,[302 313 187 100 318],207,4,15237,4.2561452513966485,20.0,20.0
43580,4,3580,[302 313 187 100 318],474,5,15242,4.256352974029601,20.0,20.0
43581,4,3581,[ 71  25 172 135 191],13,3,15245,4.256002233389168,0.0,0.0
43582,4,3582,[ 22  64 180  69 423],7,5,15250,4.256209879988837,0.0,0.0
43583,4,3583,[302 313 187 100 318],334,5,15255,4.256417410714286,20.0,20.0
43584,4,3584,[302 313 187 100 318],90,5,15260,4.256624825662483,20.0,20.0
43585,4,3585,[302 313 187 100 318],207,4,15264,4.256553262688232,20.0,20.0
43586,4,3586,[302 313 187 100 318],537,5,15269,4.256760524114859,20.0,20.0
43587,4,3587,[302 313 187 100 318],328,5,15274,4.256967670011148,20.0,20.0
43588,4,3588,[302 313 187 100 318],13,4,15278,4.256896071329061,20.0,20.0
43589,4,3589,[313 302 187 100 318],537,5,15283,4.257103064066852,20.0,20.0
43590,4,3590,[313 302 187 100 318],474,5,15288,4.257309941520468,20.0,20.0
43591,4,3591,[313 302 187 100 318],13,4,15292,4.257238307349666,20.0,20.0
43592,4,3592,[313 302 187 100 318],271,5,15297,4.25744503200668,20.0,20.0
43593,4,3593,[237  28  11 289  56],82,1,15298,4.256538675570395,0.0,0.0
43594,4,3594,[313 302 187 100 318],474,5,15303,4.256745479833102,20.0,20.0
43595,4,3595,[127 385 286  56  50],387,3,15306,4.256395995550612,0.0,40.0
43596,4,3596,[313 302 187 100 318],474,5,15311,4.256602724492633,20.0,20.0
43597,4,3597,[313 302 187 100 318],474,5,15316,4.256809338521401,20.0,20.0
43598,4,3598,[313 302 187 100 318],334,5,15321,4.257015837732704,20.0,20.0
43599,4,3599,[313 302 187 100 318],13,4,15325,4.256944444444445,20.0,20.0
43600,4,3600,[100 222  50 288 257],279,2,15327,4.256317689530686,0.0,40.0
43601,4,3601,[313 302 187 100 318],13,4,15331,4.256246529705719,20.0,20.0
43602,4,3602,[313 302 187 100 318],207,4,15335,4.256175409381071,20.0,20.0
43603,4,3603,[496 403 603 655 135],506,5,15340,4.25638179800222,20.0,0.0
43604,4,3604,[313 302 187 100 318],328,5,15345,4.256588072122053,20.0,20.0
43605,4,3605,[313 302 187 100 318],271,5,15350,4.256794231835829,20.0,20.0
43606,4,3606,[135 197 191 423  97],533,3,15353,4.2564457998336565,0.0,0.0
43607,4,3607,[313 302 187 100 318],328,5,15358,4.256651884700665,20.0,20.0
43608,4,3608,[313 302 187 100 318],144,4,15362,4.256580770296481,20.0,20.0
43609,4,3609,[ 82  56 100 173 180],537,4,15366,4.256509695290859,0.0,20.0
43610,4,3610,[204  64  97 195 294],125,4,15370,4.256438659651066,0.0,0.0
43611,4,3611,[313 302 187 100 318],207,4,15374,4.256367663344408,20.0,20.0
43612,4,3612,[  9 333  28  71   8],85,4,15378,4.256296706338223,0.0,0.0
43613,4,3613,[313 302 187 100 318],90,5,15383,4.25650249031544,20.0,20.0
43614,4,3614,[168 180 195 265 196],452,4,15387,4.2564315352697095,0.0,0.0
43615,4,3615,[222 182 121   4  25],666,2,15389,4.255807522123894,0.0,0.0
43616,4,3616,[313 302 187 100 318],537,5,15394,4.256013270666298,20.0,20.0
43617,4,3617,[100  79   1 216  56],881,4,15398,4.255942509673853,0.0,20.0
43618,4,3618,[313 302 187 100 318],90,5,15403,4.256148107211937,20.0,20.0
43619,4,3619,[176  95 187 423 210],234,2,15405,4.255524861878453,0.0,0.0
43620,4,3620,[313 302 187 100 318],13,4,15409,4.255454294393814,20.0,20.0
43621,4,3621,[273  96   8  95  28],308,3,15412,4.255107675317504,0.0,0.0
43622,4,3622,[313 302 187 100 318],271,5,15417,4.255313276290367,20.0,20.0
43623,4,3623,[210 235 127 328 172],804,4,15421,4.2552428256070645,0.0,20.0
43624,4,3624,[313 302 187 100 318],271,5,15426,4.255448275862069,20.0,20.0
43625,4,3625,[313 302 187 100 318],207,4,15430,4.255377826806399,20.0,20.0
43626,4,3626,[313 302 187 100 318],537,5,15435,4.255583126550868,20.0,20.0
43627,4,3627,[313 302 187 100 318],13,4,15439,4.255512679162073,20.0,20.0
43628,4,3628,[515 174 238 568 435],892,5,15444,4.255717828602921,0.0,20.0
43629,4,3629,[313 302 187 100 318],207,4,15448,4.2556473829201105,20.0,20.0
43630,4,3630,[ 98 385 176 143   7],379,4,15452,4.2555769760396585,0.0,20.0
43631,4,3631,[603 176 200 238  28],648,3,15455,4.255231277533039,20.0,0.0
43632,4,3632,[313 302 187 100 318],13,4,15459,4.255161023947151,20.0,20.0
43633,4,3633,[313 302 187 100 318],328,5,15464,4.25536598789213,20.0,20.0
43634,4,3634,[313 302 187 100 318],144,4,15468,4.255295735900963,20.0,20.0
43635,4,3635,[313 302 187 100 318],334,5,15473,4.255500550055006,20.0,20.0
43636,4,3636,[  8 180 235 174 269],13,3,15476,4.255155347814132,0.0,20.0
43637,4,3637,[313 302 187 100 318],13,4,15480,4.255085211654755,20.0,20.0
43638,4,3638,[183 328 118 235  95],313,3,15483,4.254740313272877,0.0,0.0
43639,4,3639,[515  82 135 168 357],892,4,15487,4.25467032967033,20.0,0.0
43640,4,3640,[ 56 185  96 176 678],648,3,15490,4.254325734688273,0.0,0.0
43641,4,3641,[288 182  69 202 179],897,3,15493,4.253981328940143,0.0,0.0
43642,4,3642,[313 302 187 100 318],207,4,15497,4.25391161130936,20.0,20.0
43643,4,3643,[313 302 187 100 318],328,5,15502,4.254116355653128,20.0,20.0
43644,4,3644,[313 302 187 100 318],328,5,15507,4.254320987654321,20.0,20.0
43645,4,3645,[313 302 187 100 318],13,4,15511,4.254251234229292,20.0,20.0
43646,4,3646,[313 302 187 100 318],90,5,15516,4.254455717027694,20.0,20.0
43647,4,3647,[313 302 187 100 318],334,5,15521,4.254660087719298,20.0,20.0
43648,4,3648,[313 302 187 100 318],334,5,15526,4.254864346396273,20.0,20.0
43649,4,3649,[313 302 187 100 318],207,4,15530,4.254794520547946,20.0,20.0
43650,4,3650,[313 302 187 100 318],90,5,15535,4.254998630512189,20.0,20.0
43651,4,3651,[313 302 187 100 318],144,4,15539,4.254928806133625,20.0,20.0
43652,4,3652,[313 302 187 100 318],90,5,15544,4.255132767588283,20.0,20.0
43653,4,3653,[ 28  97 121  11 423],455,4,15548,4.255062944718117,0.0,0.0
43654,4,3654,[313 302 187 100 318],207,4,15552,4.2549931600547195,20.0,20.0
43655,4,3655,[313 302 187 100 318],328,5,15557,4.25519693654267,20.0,20.0
43656,4,3656,[313 302 187 100 318],271,5,15562,4.2554006015859995,20.0,20.0
43657,4,3657,[144 322 185 168 294],308,2,15564,4.254784034991799,0.0,0.0
43658,4,3658,[313 302 187 100 318],271,5,15569,4.254987701557803,20.0,20.0
43659,4,3659,[313 302 187 100 318],537,5,15574,4.255191256830601,20.0,20.0
43660,4,3660,[313 302 187 100 318],13,4,15578,4.2551215514886644,20.0,20.0
43661,4,3661,[313 302 187 100 318],328,5,15583,4.255324959038776,20.0,20.0
43662,4,3662,[313 187 302 100 318],90,5,15588,4.255528255528255,20.0,20.0
43663,4,3663,[313 187 302 100 318],474,5,15593,4.255731441048035,20.0,20.0
43664,4,3664,[100 175  56 302  50],10,4,15597,4.255661664392906,0.0,40.0
43665,4,3665,[ 69 258 288 508 289],92,3,15600,4.25531914893617,0.0,0.0
43666,4,3666,[313 187 302 100 318],474,5,15605,4.25552222525225,20.0,20.0
43667,4,3667,[313 187 302 100 318],271,5,15610,4.255725190839694,20.0,20.0
43668,4,3668,[313 187 302 100 318],90,5,15615,4.255928045789044,20.0,20.0
43669,4,3669,[483 125 211 515 179],234,2,15617,4.255313351498637,20.0,0.0
43670,4,3670,[ 70 180 515  50 183],804,5,15622,4.255516208117679,0.0,20.0
43671,4,3671,[357   9 210 185 135],311,4,15626,4.255446623093682,20.0,0.0
43672,4,3672,[313 187 302 100 318],537,5,15631,4.255649332970324,20.0,20.0
43673,4,3673,[202 135  89 194   8],90,4,15635,4.255579749591726,0.0,0.0
43674,4,3674,[200 143 194 182 318],378,4,15639,4.255510204081633,20.0,0.0
43675,4,3675,[313 187 302 100 318],90,5,15644,4.255712731229598,20.0,20.0
43676,4,3676,[194  64 195 234 210],13,3,15647,4.255371226543378,0.0,0.0
43677,4,3677,[237 588 195  70 403],804,4,15651,4.255301794453508,0.0,0.0
43678,4,3678,[313 187 302 100 318],90,5,15656,4.2555042131013865,20.0,20.0
43679,4,3679,[313 187 302 100 318],334,5,15661,4.25570652173913,20.0,20.0
43680,4,3680,[265 496 515  28 121],194,4,15665,4.255637055148058,0.0,0.0
43681,4,3681,[204  64 182 385 216],881,4,15669,4.25556762629006,0.0,0.0
43682,4,3682,[313 187 302 100 318],271,5,15674,4.255769752918816,20.0,20.0
43683,4,3683,[313 187 302 100 318],13,4,15678,4.255700325732899,20.0,20.0
43684,4,3684,[ 56 678 515 288 195],537,2,15680,4.255088195386703,0.0,0.0
43685,4,3685,[313 187 302 100 318],328,5,15685,4.255290287574606,20.0,20.0
43686,4,3686,[313 187 302 100 318],328,5,15690,4.2554922701383235,20.0,20.0
43687,4,3687,[313 187 302 100 318],13,4,15694,4.255422993492408,20.0,20.0
43688,4,3688,[313 187 302 100 318],144,4,15698,4.255353754404988,20.0,20.0
43689,4,3689,[144 174  82   1  69],263,5,15703,4.2555555555555555,0.0,20.0
43690,4,3690,[127 151 135 294 191],666,3,15706,4.255215388783528,0.0,20.0
43691,4,3691,[313 187 302 100 318],271,5,15711,4.255417118093175,20.0,20.0
43692,4,3692,[322 222 174 237 185],524,3,15714,4.255077173030057,0.0,20.0
43693,4,3693,[313 187 302 100 318],90,5,15719,4.255278830536004,20.0,20.0
43694,4,3694,[313 187 302 100 318],474,5,15724,4.255480378890392,20.0,20.0
43695,4,3695,[313 187 302 100 318],474,5,15729,4.255681818181818,20.0,20.0
43696,4,3696,[313 187 302 100 318],328,5,15734,4.255883148498783,20.0,20.0
43697,4,3697,[121 313 471 132 435],328,4,15738,4.255813953488372,0.0,0.0
43698,4,3698,[313 187 302 100 318],271,5,15743,4.256015139226818,20.0,20.0
43699,4,3699,[ 12  56 237 185 318],234,1,15744,4.255135135135135,40.0,0.0
43700,4,3700,[174 144 194 195  96],543,4,15748,4.255066198324777,0.0,20.0
43701,4,3701,[313 187 302 100 318],474,5,15753,4.255267423014587,20.0,20.0
43702,4,3702,[204 187 183 496 180],474,5,15758,4.255468539022414,0.0,0.0
43703,4,3703,[313 187 302 100 318],334,5,15763,4.255669546436285,20.0,20.0
43704,4,3704,[313 187 302 100 318],144,4,15767,4.255600539811066,20.0,20.0
43705,4,3705,[ 71 200 238 568 268],92,3,15770,4.255261737722612,0.0,0.0
43706,4,3706,[313 187 302 100 318],13,4,15774,4.255192878338279,20.0,20.0
43707,4,3707,[228 144 197 181 127],194,3,15777,4.254854368932039,0.0,20.0
43708,4,3708,[313 187 302 100 318],474,5,15782,4.255055270962524,20.0,20.0
43709,4,3709,[ 98 153 210 172 655],326,4,15786,4.254986522911051,0.0,20.0
43710,4,3710,[313 187 302 100 318],334,5,15791,4.255187281056319,20.0,20.0
43711,4,3711,[313 187 302 100 318],474,5,15796,4.255387931034483,20.0,20.0
43712,4,3712,[313 187 302 100 318],474,5,15801,4.2555884729329385,20.0,20.0
43713,4,3713,[301  70 276 286 603],234,1,15802,4.254711900915455,20.0,0.0
43714,4,3714,[313 187 302 100 318],328,5,15807,4.254912516823688,20.0,20.0
43715,4,3715,[313 187 302 100 318],271,5,15812,4.255113024757804,20.0,20.0
43716,4,3716,[313 187 302 100 318],144,4,15816,4.255044390637611,20.0,20.0
43717,4,3717,[313 187 302 100 318],474,5,15821,4.255244755244755,20.0,20.0
43718,4,3718,[ 28  70 211  88 228],13,4,15825,4.255176122613606,0.0,0.0
43719,4,3719,[313 187 302 100 318],207,4,15829,4.25510752688172,20.0,20.0
43720,4,3720,[  1 191 228  50 603],815,4,15833,4.25503896801935,20.0,20.0
43721,4,3721,[313 187 302 100 318],474,5,15838,4.255239118753359,20.0,20.0
43722,4,3722,[313 187 302 100 318],474,5,15843,4.255439161966156,20.0,20.0
43723,4,3723,[235  69  28 151 135],804,3,15846,4.255102040816326,0.0,0.0
43724,4,3724,[135 172  82 257 125],334,3,15849,4.254765100671141,0.0,0.0
43725,4,3725,[313 187 302 100 318],537,5,15854,4.254965110037574,20.0,20.0
43726,4,3726,[ 15 143 318 588 385],234,1,15855,4.254091762811913,20.0,0.0
43727,4,3727,[313 187 302 100 318],474,5,15860,4.2542918454935625,20.0,20.0
43728,4,3728,[313 187 302 100 318],13,4,15864,4.254223652453741,20.0,20.0
43729,4,3729,[313 187 302 100 318],144,4,15868,4.254155495978552,20.0,20.0
43730,4,3730,[313 187 302 100 318],13,4,15872,4.254087376038596,20.0,20.0
43731,4,3731,[185 215 111 313  50],537,3,15875,4.253751339764202,0.0,20.0
43732,4,3732,[100 655  79  11 302],833,2,15877,4.253147602464506,0.0,20.0
43733,4,3733,[ 89 173 117 265  50],815,4,15881,4.25307980717729,0.0,20.0
43734,4,3734,[313 187 302 100 318],13,4,15885,4.253012048192771,20.0,20.0
43735,4,3735,[313 187 302 100 318],537,5,15890,4.253211991434689,20.0,20.0
43736,4,3736,[ 89 235 210 405 173],334,2,15892,4.252609044688253,0.0,0.0
43737,4,3737,[313 187 302 100 318],334,5,15897,4.252808988764045,20.0,20.0
43738,4,3738,[313 187 302 100 318],474,5,15902,4.2530088258892755,20.0,20.0
43739,4,3739,[313 187 302 100 318],537,5,15907,4.253208556149732,20.0,20.0
43740,4,3740,[216 211 151 182 238],385,2,15909,4.2526062550120285,0.0,0.0
43741,4,3741,[185 183 385  98 288],643,3,15912,4.252271512560128,0.0,20.0
43742,4,3742,[ 71 588 515 151 568],308,4,15916,4.252204114346781,0.0,0.0
43743,4,3743,[313 187 302 100 318],207,4,15920,4.252136752136752,20.0,20.0
43744,4,3744,[313 187 302 100 318],271,5,15925,4.252336448598131,20.0,20.0
43745,4,3745,[313 187 302 100 318],144,4,15929,4.2522690870261615,20.0,20.0
43746,4,3746,[496 187 185  96 405],840,3,15932,4.251934881238324,0.0,0.0
43747,4,3747,[313 187 302 100 318],328,5,15937,4.25213447171825,20.0,20.0
43748,4,3748,[191 655 179 127 496],659,4,15941,4.25206721792478,0.0,20.0
43749,4,3749,[183 435 181  25   8],455,4,15945,4.252,0.0,0.0
43750,4,3750,[313 187 302 100 318],328,5,15950,4.252199413489736,20.0,20.0
43751,4,3751,[313 187 302 100 318],13,4,15954,4.252132196162047,20.0,20.0
43752,4,3752,[313 187 302 100 318],271,5,15959,4.252331468158807,20.0,20.0
43753,4,3753,[313 187 302 100 318],271,5,15964,4.2525306339904105,20.0,20.0
43754,4,3754,[313 187 302 100 318],474,5,15969,4.252729693741678,20.0,20.0
43755,4,3755,[313 187 302 100 318],537,5,15974,4.252928647497337,20.0,20.0
43756,4,3756,[313 187 302 100 318],271,5,15979,4.253127495342028,20.0,20.0
43757,4,3757,[276  11 125 318 257],378,3,15982,4.252794039382651,20.0,0.0
43758,4,3758,[435 185 215 318 186],194,4,15986,4.252726789039638,20.0,0.0
43759,4,3759,[313 187 302 100 318],537,5,15991,4.252925531914894,20.0,20.0
43760,4,3760,[313 187 302 100 318],328,5,15996,4.253124169103962,20.0,20.0
43761,4,3761,[427 257 187 435   7],339,5,16001,4.253322700691122,0.0,0.0
43762,4,3762,[161 483 515 323 173],311,4,16005,4.253255381344672,20.0,0.0
43763,4,3763,[313 187 302 100 318],144,4,16009,4.253188097768332,20.0,20.0
43764,4,3764,[313 187 302 100 318],13,4,16013,4.253120849933599,20.0,20.0
43765,4,3765,[313 187 302 100 318],90,5,16018,4.253319171534785,20.0,20.0
43766,4,3766,[302 483 151  69 111],666,2,16020,4.252720998141758,20.0,0.0
43767,4,3767,[313 187 302 100 318],474,5,16025,4.25291932059448,20.0,20.0
43768,4,3768,[265 186 121  50 222],295,5,16030,4.253117537808437,0.0,20.0
43769,4,3769,[313 187 302 100 318],271,5,16035,4.253315649867374,20.0,20.0
43770,4,3770,[385 742 483 216 515],95,4,16039,4.253248475205516,20.0,0.0
43771,4,3771,[435 515 125 286 187],881,3,16042,4.252916224814422,0.0,0.0
43772,4,3772,[313 187 302 100 318],334,5,16047,4.25311423270607,20.0,20.0
43773,4,3773,[313 187 302 100 318],474,5,16052,4.253312135665077,20.0,20.0
43774,4,3774,[313 187 302 100 318],334,5,16057,4.2535099337748346,20.0,20.0
43775,4,3775,[313 187 302 100 318],207,4,16061,4.2534427966101696,20.0,20.0
43776,4,3776,[313 187 302 100 318],537,5,16066,4.253640455387874,20.0,20.0
43777,4,3777,[ 22 357   1  88  12],537,1,16067,4.252779248279513,40.0,0.0
43778,4,3778,[313 187 302 100 318],334,5,16072,4.252976978036518,20.0,20.0
43779,4,3779,[313 187 302 100 318],328,5,16077,4.253174603174603,20.0,20.0
43780,4,3780,[187 258   8 211  70],6,3,16080,4.252843163184343,0.0,0.0
43781,4,3781,[313 187 302 100 318],537,5,16085,4.253040719196193,20.0,20.0
43782,4,3782,[313 187 302 100 318],334,5,16090,4.253238170763944,20.0,20.0
43783,4,3783,[ 69   1 357  79  70],488,3,16093,4.252906976744186,20.0,0.0
43784,4,3784,[313 187 302 100 318],328,5,16098,4.2531043593130775,20.0,20.0
43785,4,3785,[313 187 302 100 318],144,4,16102,4.253037506603275,20.0,20.0
43786,4,3786,[143 179 174 385   9],311,3,16105,4.252706627937681,0.0,20.0
43787,4,3787,[ 69 294 143 211 125],207,4,16109,4.252639915522703,0.0,0.0
43788,4,3788,[153 234 265 143 423],60,3,16112,4.252309316442333,0.0,0.0
43789,4,3789,[313 187 302 100 318],144,4,16116,4.252242744063325,20.0,20.0
43790,4,3790,[313 187 302 100 318],328,5,16121,4.252439989448694,20.0,20.0
43791,4,3791,[313 187 302 100 318],271,5,16126,4.252637130801688,20.0,20.0
43792,4,3792,[313 187 302 100 318],271,5,16131,4.252834168204587,20.0,20.0
43793,4,3793,[313 187 302 100 318],328,5,16136,4.253031101739589,20.0,20.0
43794,4,3794,[313 187 302 100 318],474,5,16141,4.253227931488801,20.0,20.0
43795,4,3795,[313 187 302 100 318],144,4,16145,4.253161222339305,20.0,20.0
43796,4,3796,[313 187 302 100 318],328,5,16150,4.253357914142744,20.0,20.0
43797,4,3797,[313 187 302 100 318],90,5,16155,4.253554502369668,20.0,20.0
43798,4,3798,[313 187 302 100 318],328,5,16160,4.253750987101869,20.0,20.0
43799,4,3799,[313 187 302 100 318],207,4,16164,4.253684210526316,20.0,20.0
43800,4,3800,[313 187 302 100 318],90,5,16169,4.253880557747961,20.0,20.0
43801,4,3801,[111 588  50 143 173],479,3,16172,4.253550762756444,0.0,20.0
43802,4,3802,[313 187 302 100 318],474,5,16177,4.253747041809098,20.0,20.0
43803,4,3803,[313 187 302 100 318],334,5,16182,4.253943217665615,20.0,20.0
43804,4,3804,[313 187 302 100 318],13,4,16186,4.253876478318003,20.0,20.0
43805,4,3805,[313 187 302 100 318],537,5,16191,4.254072517078297,20.0,20.0
43806,4,3806,[200 357 471  96 185],543,4,16195,4.254005778828474,20.0,0.0
43807,4,3807,[313 187 302 100 318],207,4,16199,4.253939075630252,20.0,20.0
43808,4,3808,[313 187 302 100 318],328,5,16204,4.254134943554739,20.0,20.0
43809,4,3809,[313 187 302 100 318],334,5,16209,4.254330708661417,20.0,20.0
43810,4,3810,[313 187 302 100 318],90,5,16214,4.2545263710312256,20.0,20.0
43811,4,3811,[546  25  50   7  69],13,2,16216,4.253934942287513,0.0,20.0
43812,4,3812,[313 187 302 100 318],90,5,16221,4.254130605822187,20.0,20.0
43813,4,3813,[313 187 302 100 318],207,4,16225,4.254063974829576,20.0,20.0
43814,4,3814,[313 187 302 100 318],537,5,16230,4.254259501965924,20.0,20.0
43815,4,3815,[194 180 182 603 175],59,4,16234,4.2541928721174,20.0,0.0
43816,4,3816,[313 187 302 100 318],271,5,16239,4.254388263033796,20.0,20.0
43817,4,3817,[313 187 302 100 318],334,5,16244,4.254583551597695,20.0,20.0
43818,4,3818,[313 187 302 100 318],13,4,16248,4.254516889238021,20.0,20.0
43819,4,3819,[313 187 302 100 318],144,4,16252,4.2544502617801045,20.0,20.0
43820,4,3820,[211 194   8  97 210],7,5,16257,4.254645380790369,0.0,0.0
43821,4,3821,[313 187 302 100 318],207,4,16261,4.254578754578755,20.0,20.0
43822,4,3822,[265  28  89 172 405],200,4,16265,4.2545121632226,0.0,0.0
43823,4,3823,[313 187 302 100 318],474,5,16270,4.254707112970712,20.0,20.0
43824,4,3824,[313 187 302 100 318],334,5,16275,4.254901960784314,20.0,20.0
43825,4,3825,[313 187 302 100 318],90,5,16280,4.255096706743335,20.0,20.0
43826,4,3826,[313 187 302 100 318],207,4,16284,4.255030049647243,20.0,20.0
43827,4,3827,[313 187 302 100 318],334,5,16289,4.255224660397074,20.0,20.0
43828,4,3828,[313 187 302 100 318],144,4,16293,4.2551580047009665,20.0,20.0
43829,4,3829,[151 173   4 748 183],648,2,16295,4.254569190600522,0.0,0.0
43830,4,3830,[313 187 302 100 318],474,5,16300,4.254763769250848,20.0,20.0
43831,4,3831,[153 172 118 187 210],194,1,16301,4.2539144050104385,0.0,0.0
43832,4,3832,[313 187 302 100 318],537,5,16306,4.254109052961127,20.0,20.0
43833,4,3833,[180 143 211 265 496],60,4,16310,4.254042775169536,0.0,0.0
43834,4,3834,[ 64 286 273 515 168],387,3,16313,4.253715775749674,0.0,0.0
43835,4,3835,[313 187 302 100 318],334,5,16318,4.253910323253389,20.0,20.0
43836,4,3836,[313 187 302 100 318],328,5,16323,4.254104769351056,20.0,20.0
43837,4,3837,[215  12 191 385 234],474,5,16328,4.254299114121938,20.0,0.0
43838,4,3838,[313 187 302 100 318],90,5,16333,4.25449335764522,20.0,20.0
43839,4,3839,[313 187 302 100 318],537,5,16338,4.2546875,20.0,20.0
43840,4,3840,[313 187 302 100 318],13,4,16342,4.2546211923978134,20.0,20.0
43841,4,3841,[313 187 302 100 318],271,5,16347,4.2548152004164494,20.0,20.0
43842,4,3842,[313 187 302 100 318],537,5,16352,4.2550091074681236,20.0,20.0
43843,4,3843,[313 187 302 100 318],334,5,16357,4.255202913631634,20.0,20.0
43844,4,3844,[313 187 302 100 318],207,4,16361,4.2551365409622885,20.0,20.0
43845,4,3845,[200   4 125  50 294],653,2,16363,4.25455018200728,0.0,20.0
43846,4,3846,[313 187 302 100 318],334,5,16368,4.254743956329608,20.0,20.0
43847,4,3847,[ 98  25 483  56 183],650,3,16371,4.254417879417879,20.0,20.0
43848,4,3848,[117 546 282  64 496],194,2,16373,4.253832164198493,0.0,0.0
43849,4,3849,[313 187 302 100 318],474,5,16378,4.254025974025974,20.0,20.0
43850,4,3850,[313 187 302 100 318],144,4,16382,4.253960010386913,20.0,20.0
43851,4,3851,[196  82 191  11   8],488,1,16383,4.253115264797508,0.0,0.0
43852,4,3852,[121 742 403 678 265],308,2,16385,4.252530495717623,0.0,0.0
43853,4,3853,[313 187 302 100 318],474,5,16390,4.252724442138039,20.0,20.0
43854,4,3854,[313 187 302 100 318],271,5,16395,4.252918287937743,20.0,20.0
43855,4,3855,[313 187 302 100 318],328,5,16400,4.253112033195021,20.0,20.0
43856,4,3856,[313 187 302 100 318],537,5,16405,4.253305677988074,20.0,20.0
43857,4,3857,[237  71   8   4 546],92,4,16409,4.253240020736133,0.0,0.0
43858,4,3858,[ 98 435 748 282 200],447,3,16412,4.252915263021508,0.0,20.0
43859,4,3859,[143 161 423 111  69],92,1,16413,4.252072538860103,0.0,0.0
43860,4,3860,[185 655 132  71 515],59,4,16417,4.252007252007252,0.0,0.0
43861,4,3861,[313 187 302 100 318],13,4,16421,4.251941998964267,20.0,20.0
43862,4,3862,[313 187 302 100 318],334,5,16426,4.252135645871085,20.0,20.0
43863,4,3863,[313 187 302 100 318],271,5,16431,4.252329192546584,20.0,20.0
43864,4,3864,[313 187 302 100 318],334,5,16436,4.252522639068564,20.0,20.0
43865,4,3865,[313 187 302 100 318],90,5,16441,4.252715985514744,20.0,20.0
43866,4,3866,[313 187 302 100 318],271,5,16446,4.252909231962762,20.0,20.0
43867,4,3867,[111  50 275 216 197],64,4,16450,4.252843846949328,0.0,20.0
43868,4,3868,[313 187 302 100 318],144,4,16454,4.252778495735332,20.0,20.0
43869,4,3869,[313 187 302 100 318],144,4,16458,4.252713178294574,20.0,20.0
43870,4,3870,[333 202 180  98  82],666,3,16461,4.252389563420305,0.0,20.0
43871,4,3871,[313 187 302 100 318],13,4,16465,4.252324380165289,20.0,20.0
43872,4,3872,[313 187 302 100 318],474,5,16470,4.252517428350116,20.0,20.0
43873,4,3873,[313 187 302 100 318],474,5,16475,4.252710376871451,20.0,20.0
43874,4,3874,[313 187 302 100 318],474,5,16480,4.252903225806452,20.0,20.0
43875,4,3875,[313 187 302 100 318],207,4,16484,4.252837977296181,20.0,20.0
43876,4,3876,[328 235 194  95  79],804,4,16488,4.25277276244519,0.0,0.0
43877,4,3877,[313 187 302 100 318],144,4,16492,4.252707581227437,20.0,20.0
43878,4,3878,[313 187 302 100 318],90,5,16497,4.252900232018561,20.0,20.0
43879,4,3879,[173  69   7 603 235],13,2,16499,4.252319587628866,20.0,0.0
43880,4,3880,[313 187 302 100 318],13,4,16503,4.252254573563515,20.0,20.0
43881,4,3881,[ 25 135 245 118 286],402,4,16507,4.252189592993302,0.0,0.0
43882,4,3882,[313 187 302 100 318],328,5,16512,4.252382178727788,20.0,20.0
43883,4,3883,[313 187 302 100 318],207,4,16516,4.25231719876416,20.0,20.0
43884,4,3884,[313 187 302 100 318],334,5,16521,4.252509652509652,20.0,20.0
43885,4,3885,[313 187 302 100 318],144,4,16525,4.252444673185795,20.0,20.0
43886,4,3886,[313 187 302 100 318],90,5,16530,4.252636995111912,20.0,20.0
43887,4,3887,[313 187 302 100 318],474,5,16535,4.252829218106996,20.0,20.0
43888,4,3888,[ 25 405 143  28 282],474,5,16540,4.253021342247364,0.0,0.0
43889,4,3889,[313 187 302 100 318],474,5,16545,4.253213367609255,20.0,20.0
43890,4,3890,[742 151   7  25  70],648,1,16546,4.252377280904652,0.0,0.0
43891,4,3891,[313 187 302 100 318],474,5,16551,4.25256937307297,20.0,20.0
43892,4,3892,[313 187 302 100 318],90,5,16556,4.252761366555355,20.0,20.0
43893,4,3893,[117 151 132 185 435],749,5,16561,4.252953261427837,0.0,0.0
43894,4,3894,[313 187 302 100 318],537,5,16566,4.253145057766367,20.0,20.0
43895,4,3895,[  4 151 173 211 322],234,1,16567,4.2523100616016425,0.0,0.0
43896,4,3896,[313 187 302 100 318],271,5,16572,4.252501924557352,20.0,20.0
43897,4,3897,[313 187 302 100 318],328,5,16577,4.252693689071319,20.0,20.0
43898,4,3898,[118 197  69  97 568],194,2,16579,4.25211592716081,0.0,0.0
43899,4,3899,[475 435 211 423 300],506,3,16582,4.251794871794872,0.0,0.0
43900,4,3900,[313 187 302 100 318],474,5,16587,4.251986670084594,20.0,20.0
43901,4,3901,[313 187 302 100 318],90,5,16592,4.252178370066632,20.0,20.0
43902,4,3902,[176 117 423 546 182],308,3,16595,4.251857545477837,0.0,0.0
43903,4,3903,[273 238 258 179 742],59,2,16597,4.251280737704918,0.0,0.0
43904,4,3904,[313 187 302 100 318],537,5,16602,4.251472471190781,20.0,20.0
43905,4,3905,[313 187 302 100 318],474,5,16607,4.251664106502816,20.0,20.0
43906,4,3906,[313 187 302 100 318],474,5,16612,4.251855643716406,20.0,20.0
43907,4,3907,[276 216  89 423 215],92,3,16615,4.251535312180144,0.0,0.0
43908,4,3908,[313 187 302 100 318],328,5,16620,4.251726784343822,20.0,20.0
43909,4,3909,[313 187 302 100 318],271,5,16625,4.251918158567775,20.0,20.0
43910,4,3910,[265 100 187 216 173],334,3,16628,4.251598056762976,0.0,20.0
43911,4,3911,[435  22 603 202 161],387,2,16630,4.2510224948875255,20.0,0.0
43912,4,3912,[385  71 191 196 180],881,4,16634,4.250958343981599,0.0,0.0
43913,4,3913,[313 187 302 100 318],90,5,16639,4.251149718957588,20.0,20.0
43914,4,3914,[313 187 302 100 318],13,4,16643,4.251085568326948,20.0,20.0
43915,4,3915,[313 187 302 100 318],328,5,16648,4.251276813074566,20.0,20.0
43916,4,3916,[313 187 302 100 318],334,5,16653,4.251467960173602,20.0,20.0
43917,4,3917,[483 151  71 258 403],313,2,16655,4.250893312914752,20.0,0.0
43918,4,3918,[427 183 508 405 195],474,4,16659,4.250829293187038,0.0,0.0
43919,4,3919,[313 187 302 100 318],207,4,16663,4.250765306122449,20.0,20.0
43920,4,3920,[313 187 302 100 318],13,4,16667,4.250701351695996,20.0,20.0
43921,4,3921,[275 117 678  95 179],13,1,16668,4.2498725140234574,0.0,0.0
43922,4,3922,[313 187 302 100 318],328,5,16673,4.25006372673974,20.0,20.0
43923,4,3923,[ 12 183 211 483 471],447,5,16678,4.250254841997961,40.0,0.0
43924,4,3924,[313 187 302 100 318],537,5,16683,4.250445859872611,20.0,20.0
43925,4,3925,[313 187 302 100 318],13,4,16687,4.250382068262863,20.0,20.0
43926,4,3926,[ 56 234  69 121 200],339,4,16691,4.250318309141838,0.0,0.0
43927,4,3927,[313 187 302 100 318],271,5,16696,4.25050916496945,20.0,20.0
43928,4,3928,[ 96 210 475 144 286],387,2,16698,4.249936370577755,0.0,0.0
43929,4,3929,[313 187 302 100 318],328,5,16703,4.250127226463104,20.0,20.0
43930,4,3930,[197 603 515   7   9],7,4,16707,4.250063597049097,20.0,0.0
43931,4,3931,[313 187 302 100 318],271,5,16712,4.250254323499491,20.0,20.0
43932,4,3932,[313 187 302 100 318],474,5,16717,4.250444952962115,20.0,20.0
43933,4,3933,[313 187 302 100 318],271,5,16722,4.25063548551093,20.0,20.0
43934,4,3934,[313 187 302 100 318],474,5,16727,4.250825921219822,20.0,20.0
43935,4,3935,[313 187 302 100 318],90,5,16732,4.251016260162602,20.0,20.0
43936,4,3936,[313 187 302 100 318],207,4,16736,4.250952501905004,20.0,20.0
43937,4,3937,[117 151 597 211 182],533,2,16738,4.2503809040121885,0.0,0.0
43938,4,3938,[313 187 302 100 318],474,5,16743,4.250571210967251,20.0,20.0
43939,4,3939,[313 187 302 100 318],271,5,16748,4.250761421319797,20.0,20.0
43940,4,3940,[313 187 302 100 318],474,5,16753,4.250951535143365,20.0,20.0
43941,4,3941,[313 187 302 100 318],271,5,16758,4.251141552511416,20.0,20.0
43942,4,3942,[313 187 302 100 318],144,4,16762,4.251077859497844,20.0,20.0
43943,4,3943,[222 282 121  71 328],334,2,16764,4.250507099391481,0.0,0.0
43944,4,3944,[313 187 302 100 318],90,5,16769,4.2506970849176176,20.0,20.0
43945,4,3945,[100 427  88 603  15],308,4,16773,4.250633552965028,20.0,20.0
43946,4,3946,[196   4 194 197 385],318,3,16776,4.250316696224981,0.0,0.0
43947,4,3947,[313 187 302 100 318],334,5,16781,4.2505065856129685,20.0,20.0
43948,4,3948,[313 187 302 100 318],474,5,16786,4.250696378830083,20.0,20.0
43949,4,3949,[597 237 117 271 100],788,3,16789,4.250379746835443,0.0,20.0
43950,4,3950,[ 88 289 197 127 121],537,2,16791,4.2498101746393315,0.0,20.0
43951,4,3951,[313 187 302 100 318],334,5,16796,4.25,20.0,20.0
43952,4,3952,[423  88 257 237  69],343,4,16800,4.249936756893499,0.0,0.0
43953,4,3953,[313 187 302 100 318],144,4,16804,4.2498735457764285,20.0,20.0
43954,4,3954,[313 187 302 100 318],144,4,16808,4.2498103666245255,20.0,20.0
43955,4,3955,[313 187 302 100 318],334,5,16813,4.25,20.0,20.0
43956,4,3956,[313 187 302 100 318],13,4,16817,4.249936820823857,20.0,20.0
43957,4,3957,[333  56 228 403 143],653,3,16820,4.249621020717534,0.0,0.0
43958,4,3958,[313 187 302 100 318],328,5,16825,4.249810558221773,20.0,20.0
43959,4,3959,[117 288  64 496 265],339,2,16827,4.249242424242424,0.0,0.0
43960,4,3960,[313 187 302 100 318],144,4,16831,4.249179500126231,20.0,20.0
43961,4,3961,[  1 187  11 161 282],271,2,16833,4.248611812216052,0.0,0.0
43962,4,3962,[313 187 302 100 318],537,5,16838,4.248801413070906,20.0,20.0
43963,4,3963,[313 187 302 100 318],13,4,16842,4.248738647830474,20.0,20.0
43964,4,3964,[313 187 302 100 318],271,5,16847,4.248928121059269,20.0,20.0
43965,4,3965,[313 187 302 100 318],90,5,16852,4.249117498739284,20.0,20.0
43966,4,3966,[313 187 302 100 318],207,4,16856,4.249054701285607,20.0,20.0
43967,4,3967,[313 187 302 100 318],271,5,16861,4.249243951612903,20.0,20.0
43968,4,3968,[313 187 302 100 318],207,4,16865,4.249181153943058,20.0,20.0
43969,4,3969,[313 187 302 100 318],474,5,16870,4.249370277078086,20.0,20.0
43970,4,3970,[313 187 302 100 318],334,5,16875,4.249559304960967,20.0,20.0
43971,4,3971,[313 187 302 100 318],537,5,16880,4.2497482376636455,20.0,20.0
43972,4,3972,[313 187 302 100 318],90,5,16885,4.249937075257991,20.0,20.0
43973,4,3973,[313 187 302 100 318],271,5,16890,4.250125817815802,20.0,20.0
43974,4,3974,[546 175 143  50 127],95,4,16894,4.250062893081761,0.0,40.0
43975,4,3975,[313 187 302 100 318],334,5,16899,4.250251509054326,20.0,20.0
43976,4,3976,[313 187 302 100 318],144,4,16903,4.25018858436007,20.0,20.0
43977,4,3977,[313 187 302 100 318],328,5,16908,4.250377073906486,20.0,20.0
43978,4,3978,[313 187 302 100 318],207,4,16912,4.2503141492837395,20.0,20.0
43979,4,3979,[423 183 173 211 117],749,5,16917,4.250502512562814,0.0,0.0
43980,4,3980,[313 187 302 100 318],474,5,16922,4.250690781210751,20.0,20.0
43981,4,3981,[210   9 183 161 748],200,4,16926,4.250627825213461,0.0,0.0
43982,4,3982,[313 187 302 100 318],13,4,16930,4.250564900828521,20.0,20.0
43983,4,3983,[  8 144 588 182 118],13,5,16935,4.250753012048193,0.0,0.0
43984,4,3984,[313 187 302 100 318],474,5,16940,4.250941028858218,20.0,20.0
43985,4,3985,[483 196  11 204 427],59,5,16945,4.251128951329654,20.0,0.0
43986,4,3986,[313 187 302 100 318],90,5,16950,4.251316779533484,20.0,20.0
43987,4,3987,[313 187 302 100 318],537,5,16955,4.251504513540622,20.0,20.0
43988,4,3988,[313 187 302 100 318],13,4,16959,4.251441464026072,20.0,20.0
43989,4,3989,[313 187 302 100 318],144,4,16963,4.251378446115289,20.0,20.0
43990,4,3990,[313 187 302 100 318],144,4,16967,4.251315459784515,20.0,20.0
43991,4,3991,[313 187 302 100 318],271,5,16972,4.251503006012024,20.0,20.0
43992,4,3992,[313 187 302 100 318],334,5,16977,4.251690458302028,20.0,20.0
43993,4,3993,[313 187 302 100 318],537,5,16982,4.251877816725088,20.0,20.0
43994,4,3994,[313 187 302 100 318],207,4,16986,4.251814768460576,20.0,20.0
43995,4,3995,[313 187 302 100 318],328,5,16991,4.252002002002002,20.0,20.0
43996,4,3996,[313 187 302 100 318],328,5,16996,4.252189141856392,20.0,20.0
43997,4,3997,[313 187 302 100 318],334,5,17001,4.252376188094047,20.0,20.0
43998,4,3998,[313 187 302 100 318],90,5,17006,4.252563140785196,20.0,20.0
43999,4,3999,[313 187 302 100 318],144,4,17010,4.2525,20.0,20.0
44000,4,4000,[313 187 302 100 318],271,5,17015,4.252686828292926,20.0,20.0
44001,4,4001,[313 187 302 100 318],207,4,17019,4.252623688155922,20.0,20.0
44002,4,4002,[313 187 302 100 318],90,5,17024,4.252810392205846,20.0,20.0
44003,4,4003,[313 187 302 100 318],207,4,17028,4.252747252747253,20.0,20.0
44004,4,4004,[313 187 302 100 318],271,5,17033,4.252933832709114,20.0,20.0
44005,4,4005,[228  95 202  97 173],374,3,17036,4.252621068397404,0.0,0.0
44006,4,4006,[313 187 302 100 318],328,5,17041,4.252807586723234,20.0,20.0
44007,4,4007,[313 187 302 100 318],537,5,17046,4.252994011976048,20.0,20.0
44008,4,4008,[313 187 302 100 318],334,5,17051,4.253180344225493,20.0,20.0
44009,4,4009,[121 197   1 597 496],308,1,17052,4.252369077306733,0.0,0.0
44010,4,4010,[313 187 302 100 318],474,5,17057,4.25255547245076,20.0,20.0
44011,4,4011,[313 187 302 100 318],334,5,17062,4.252741774675972,20.0,20.0
44012,4,4012,[313 187 302 100 318],144,4,17066,4.252678793919761,20.0,20.0
44013,4,4013,[127 183  50 181 179],774,4,17070,4.252615844544096,0.0,40.0
44014,4,4014,[172 403 127 271 385],749,4,17074,4.252552926525529,0.0,20.0
44015,4,4015,[313 187 302 100 318],144,4,17078,4.252490039840637,20.0,20.0
44016,4,4016,[313 187 302 100 318],474,5,17083,4.252676126462534,20.0,20.0
44017,4,4017,[742 568 210 216  88],92,1,17084,4.251866600298656,0.0,0.0
44018,4,4018,[313 187 302 100 318],90,5,17089,4.25205274944016,20.0,20.0
44019,4,4019,[313 187 302 100 318],328,5,17094,4.2522388059701495,20.0,20.0
44020,4,4020,[313 187 302 100 318],334,5,17099,4.252424769957722,20.0,20.0
44021,4,4021,[313 187 302 100 318],334,5,17104,4.252610641471905,20.0,20.0
44022,4,4022,[313 187 302 100 318],207,4,17108,4.252547849863286,20.0,20.0
44023,4,4023,[235 172 286 175 180],325,4,17112,4.252485089463221,0.0,0.0
44024,4,4024,[ 89 588 289 168 121],95,2,17114,4.251925465838509,0.0,0.0
44025,4,4025,[313 187 302 100 318],207,4,17118,4.251862891207153,20.0,20.0
44026,4,4026,[313 187 302 100 318],328,5,17123,4.252048671467594,20.0,20.0
44027,4,4027,[313 187 302 100 318],207,4,17127,4.251986097318769,20.0,20.0
44028,4,4028,[180 435   1 655 258],144,5,17132,4.25217175477786,0.0,0.0
44029,4,4029,[313 187 302 100 318],328,5,17137,4.2523573200992555,20.0,20.0
44030,4,4030,[222 191  25 125  82],378,3,17140,4.252046638551228,0.0,0.0
44031,4,4031,[313 187 302 100 318],334,5,17145,4.252232142857143,20.0,20.0
44032,4,4032,[313 187 302 100 318],90,5,17150,4.252417555169849,20.0,20.0
44033,4,4033,[288 186 216 174 322],474,4,17154,4.252354982647496,0.0,20.0
44034,4,4034,[313 187 302 100 318],474,5,17159,4.252540272614622,20.0,20.0
44035,4,4035,[216 357 471 483 151],234,2,17161,4.251982160555005,40.0,0.0
44036,4,4036,[313 187 302 100 318],271,5,17166,4.252167451077533,20.0,20.0
44037,4,4037,[302 161 182 271 191],334,2,17168,4.251609707776127,0.0,0.0
44038,4,4038,[313 187 302 100 318],207,4,17172,4.251547412725922,20.0,20.0
44039,4,4039,[210   4  56 181  70],59,4,17176,4.251485148514852,0.0,0.0
44040,4,4040,[313 187 302 100 318],144,4,17180,4.25142291512002,20.0,20.0
44041,4,4041,[ 71 357 185 125 176],848,4,17184,4.251360712518555,20.0,0.0
44042,4,4042,[313 187 302 100 318],144,4,17188,4.251298540687608,20.0,20.0
44043,4,4043,[265  11  82 143  69],778,2,17190,4.250741839762611,0.0,0.0
44044,4,4044,[313 187 302 100 318],537,5,17195,4.2509270704573545,20.0,20.0
44045,4,4045,[313 187 302 100 318],537,5,17200,4.251112209589718,20.0,20.0
44046,4,4046,[313 187 302 100 318],13,4,17204,4.2510501606128,20.0,20.0
44047,4,4047,[603 234 294 275 191],189,5,17209,4.251235177865612,20.0,0.0
44048,4,4048,[313 187 302 100 318],13,4,17213,4.251173129167696,20.0,20.0
44049,4,4049,[153 282  88 276  98],92,4,17217,4.251111111111111,0.0,20.0
44050,4,4050,[143 508 483  12 211],343,5,17222,4.251295976302147,40.0,0.0
44051,4,4051,[313 187 302 100 318],207,4,17226,4.251233958538993,20.0,20.0
44052,4,4052,[313 187 302 100 318],474,5,17231,4.251418702195904,20.0,20.0
44053,4,4053,[313 187 302 100 318],537,5,17236,4.2516033547113965,20.0,20.0
44054,4,4054,[313 187 302 100 318],334,5,17241,4.251787916152898,20.0,20.0
44055,4,4055,[313 187 302 100 318],328,5,17246,4.251972386587771,20.0,20.0
44056,4,4056,[197 403 222  98 174],899,4,17250,4.251910278530934,0.0,40.0
44057,4,4057,[313 187 302 100 318],271,5,17255,4.252094627895515,20.0,20.0
44058,4,4058,[ 22  95 508 132 125],92,2,17257,4.251539788125154,0.0,0.0
44059,4,4059,[204 496 135   1 175],234,2,17259,4.250985221674877,0.0,0.0
44060,4,4060,[313 187 302 100 318],537,5,17264,4.251169662644669,20.0,20.0
44061,4,4061,[313 187 302 100 318],537,5,17269,4.251354012801576,20.0,20.0
44062,4,4062,[132 161 238   7 237],653,1,17270,4.250553777996554,0.0,0.0
44063,4,4063,[313 187 302 100 318],271,5,17275,4.250738188976378,20.0,20.0
44064,4,4064,[313 187 302 100 318],328,5,17280,4.250922509225092,20.0,20.0
44065,4,4065,[ 82 187 182 210 328],313,4,17284,4.250860796851943,0.0,0.0
44066,4,4066,[313 187 302 100 318],334,5,17289,4.251044996311777,20.0,20.0
44067,4,4067,[313 187 302 100 318],13,4,17293,4.250983284169125,20.0,20.0
44068,4,4068,[313 187 302 100 318],13,4,17297,4.250921602359302,20.0,20.0
44069,4,4069,[313 187 302 100 318],328,5,17302,4.251105651105651,20.0,20.0
44070,4,4070,[313 187 302 100 318],144,4,17306,4.251043969540653,20.0,20.0
44071,4,4071,[357  71 187 405 191],533,3,17309,4.25073673870334,20.0,0.0
44072,4,4072,[313 187 302 100 318],537,5,17314,4.250920697274736,20.0,20.0
44073,4,4073,[313 187 302 100 318],207,4,17318,4.25085910652921,20.0,20.0
44074,4,4074,[568 135 301 427  69],328,1,17319,4.250061349693252,0.0,0.0
44075,4,4075,[357 180  64 655  12],7,5,17324,4.250245338567223,40.0,0.0
44076,4,4076,[313 187 302 100 318],207,4,17328,4.25018395879323,20.0,20.0
44077,4,4077,[313 187 302 100 318],90,5,17333,4.250367827366356,20.0,20.0
44078,4,4078,[313 187 302 100 318],537,5,17338,4.2505516057857315,20.0,20.0
44079,4,4079,[313 187 302 100 318],334,5,17343,4.250735294117647,20.0,20.0
44080,4,4080,[222 216   1 322 271],537,0,17343,4.249693702523891,0.0,0.0
44081,4,4081,[313 187 302 100 318],271,5,17348,4.249877511024008,20.0,20.0
44082,4,4082,[313 187 302 100 318],207,4,17352,4.2498163115356355,20.0,20.0
44083,4,4083,[546 135 151  69 588],234,2,17354,4.249265426052889,0.0,0.0
44084,4,4084,[313 187 302 100 318],271,5,17359,4.249449204406365,20.0,20.0
44085,4,4085,[186 318 483 496 265],452,3,17362,4.249143416544298,40.0,0.0
44086,4,4086,[191 245  50 265 127],455,4,17366,4.249082456569611,0.0,40.0
44087,4,4087,[135 143  25  70 180],406,2,17368,4.24853228962818,0.0,0.0
44088,4,4088,[313 187 302 100 318],537,5,17373,4.248716067498166,20.0,20.0
44089,4,4089,[568 515 179 202 194],881,4,17377,4.248655256723716,0.0,0.0
44090,4,4090,[427 423 286 222 183],380,3,17380,4.248350036665852,0.0,0.0
44091,4,4091,[515  56 173 313 300],13,2,17382,4.247800586510264,0.0,0.0
44092,4,4092,[313 187 302 100 183],144,4,17386,4.247740043977522,0.0,20.0
44093,4,4093,[313 187 302 183 100],474,5,17391,4.247923790913532,0.0,20.0
44094,4,4094,[313 187 302 183 100],334,5,17396,4.248107448107448,0.0,20.0
44095,4,4095,[313 187 302 183 100],13,5,17401,4.248291015625,0.0,20.0
44096,4,4096,[435 200  88 423 405],749,4,17405,4.248230412496949,0.0,0.0
44097,4,4097,[313 187 302 183 100],207,3,17408,4.247925817471938,0.0,20.0
44098,4,4098,[186 135 322 655  95],881,4,17412,4.2478653330080505,0.0,0.0
44099,4,4099,[313 187 302 100 318],144,4,17416,4.247804878048781,20.0,20.0
44100,4,4100,[ 79  15  70 405  71],474,5,17421,4.247988295537674,0.0,0.0
44101,4,4101,[211 144 181 238 234],638,5,17426,4.248171623598245,0.0,0.0
44102,4,4102,[313 187 302 100 318],144,4,17430,4.248111138191567,20.0,20.0
44103,4,4103,[313 187 302 100 318],271,5,17435,4.2482943469785575,20.0,20.0
44104,4,4104,[313 187 302 100 318],13,4,17439,4.2482338611449455,20.0,20.0
44105,4,4105,[313 187 302 100 318],271,5,17444,4.248416950803702,20.0,20.0
44106,4,4106,[313 187 302 100 318],474,5,17449,4.248599951302654,20.0,20.0
44107,4,4107,[313 187 302 100 318],271,5,17454,4.248782862706913,20.0,20.0
44108,4,4108,[313 187 302 100 318],474,5,17459,4.2489656850815285,20.0,20.0
44109,4,4109,[313 187 302 100 318],207,4,17463,4.248905109489051,20.0,20.0
44110,4,4110,[313 187 302 100 318],271,5,17468,4.24908781318414,20.0,20.0
44111,4,4111,[435 215  12 200 300],380,2,17470,4.248540856031128,20.0,0.0
44112,4,4112,[313 187 302 100 318],144,4,17474,4.2484804279115,20.0,20.0
44113,4,4113,[313 187 302 100 318],90,5,17479,4.248663101604278,20.0,20.0
44114,4,4114,[313 187 302 100 318],271,5,17484,4.248845686512758,20.0,20.0
44115,4,4115,[313 187 302 100 318],144,4,17488,4.2487852283770655,20.0,20.0
44116,4,4116,[313 187 302 100 318],328,5,17493,4.248967694923488,20.0,20.0
44117,4,4117,[313 187 302 100 318],207,4,17497,4.248907236522584,20.0,20.0
44118,4,4118,[313 187 302 100 318],207,4,17501,4.248846807477543,20.0,20.0
44119,4,4119,[ 96 748  25 222 210],360,2,17503,4.248300970873786,0.0,0.0
44120,4,4120,[313 187 302 100 318],271,5,17508,4.248483377820917,20.0,20.0
44121,4,4121,[313 187 302 100 318],537,5,17513,4.2486656962639495,20.0,20.0
44122,4,4122,[313 187 302 100 318],474,5,17518,4.248847926267281,20.0,20.0
44123,4,4123,[313 187 302 100 318],328,5,17523,4.249030067895247,20.0,20.0
44124,4,4124,[313 187 302 100 318],328,5,17528,4.249212121212121,20.0,20.0
44125,4,4125,[313 187 302 100 318],13,4,17532,4.249151720794959,20.0,20.0
44126,4,4126,[748 742 238 655 328],207,2,17534,4.248606736127938,0.0,0.0
44127,4,4127,[313 187 302 100 318],144,4,17538,4.248546511627907,20.0,20.0
44128,4,4128,[313 187 302 100 318],474,5,17543,4.24872850569145,20.0,20.0
44129,4,4129,[313 187 302 100 318],334,5,17548,4.248910411622276,20.0,20.0
44130,4,4130,[313 187 302 100 318],13,4,17552,4.248850157346889,20.0,20.0
44131,4,4131,[313 187 302 100 318],334,5,17557,4.249031945788964,20.0,20.0
44132,4,4132,[202  95 265 238  98],234,1,17558,4.248245826276313,0.0,20.0
44133,4,4133,[385 318 546 194 748],207,2,17560,4.24770198355104,20.0,0.0
44134,4,4134,[313 187 302 100 318],90,5,17565,4.2478839177750904,20.0,20.0
44135,4,4135,[313 187 302 100 318],271,5,17570,4.2480657640232105,20.0,20.0
44136,4,4136,[515 127  70 546 153],95,4,17574,4.248005801305293,0.0,20.0
44137,4,4137,[313 187 302 100 318],144,4,17578,4.247945867568874,20.0,20.0
44138,4,4138,[313 187 302 100 318],334,5,17583,4.24812756704518,20.0,20.0
44139,4,4139,[313 187 302 100 318],207,4,17587,4.248067632850241,20.0,20.0
44140,4,4140,[313 187 302 100 318],537,5,17592,4.248249215165419,20.0,20.0
44141,4,4141,[127 237 508 271 197],334,3,17595,4.247947851279575,0.0,20.0
44142,4,4142,[313 187 302 100 318],144,4,17599,4.247888003861936,20.0,20.0
44143,4,4143,[273  89  69  56 215],524,3,17602,4.247586872586872,0.0,0.0
44144,4,4144,[ 96   8 655 318 168],406,3,17605,4.247285886610374,20.0,0.0
44145,4,4145,[568 127 748  22 172],311,5,17610,4.247467438494935,0.0,20.0
44146,4,4146,[ 22  95 405 173 235],479,4,17614,4.247407764649144,0.0,0.0
44147,4,4147,[313 187 302 100 318],207,4,17618,4.247348119575699,20.0,20.0
44148,4,4148,[313 187 302 100 318],474,5,17623,4.247529525186792,20.0,20.0
44149,4,4149,[313 187 302 100 318],334,5,17628,4.247710843373494,20.0,20.0
44150,4,4150,[313 187 302 100 318],537,5,17633,4.2478920741989885,20.0,20.0
44151,4,4151,[ 50 180 483 204 269],7,4,17637,4.247832369942197,20.0,20.0
44152,4,4152,[302  12 405 153 508],378,4,17641,4.247772694437756,20.0,0.0
44153,4,4153,[423 179 195 323 234],648,5,17646,4.247953779489649,0.0,0.0
44154,4,4154,[313 187 302 100 318],13,4,17650,4.247894103489771,20.0,20.0
44155,4,4155,[357 603 185 210 117],308,4,17654,4.247834456207892,40.0,0.0
44156,4,4156,[313 187 302 100 318],271,5,17659,4.248015395718066,20.0,20.0
44157,4,4157,[132 483 100 181 151],380,4,17663,4.247955747955748,20.0,20.0
44158,4,4158,[313 187 302 100 318],537,5,17668,4.248136571291176,20.0,20.0
44159,4,4159,[313 187 302 100 318],328,5,17673,4.248317307692307,20.0,20.0
44160,4,4160,[313 187 302 100 318],207,4,17677,4.248257630377313,20.0,20.0
44161,4,4161,[313 187 302 100 318],328,5,17682,4.248438250840942,20.0,20.0
44162,4,4162,[313 187 302 100 318],207,4,17686,4.248378573144367,20.0,20.0
44163,4,4163,[313 187 302 100 318],271,5,17691,4.248559077809798,20.0,20.0
44164,4,4164,[313 187 302 100 318],537,5,17696,4.248739495798319,20.0,20.0
44165,4,4165,[313 187 302 100 318],334,5,17701,4.248919827172347,20.0,20.0
44166,4,4166,[269 678 185 127 125],334,2,17703,4.248380129589632,0.0,20.0
44167,4,4167,[313 187 302 100 318],144,4,17707,4.248320537428023,20.0,20.0
44168,4,4168,[313 187 302 100 318],334,5,17712,4.248500839529863,20.0,20.0
44169,4,4169,[313 187 302 100 318],207,4,17716,4.248441247002398,20.0,20.0
44170,4,4170,[ 28 257 508 655 423],474,3,17719,4.248141932390314,0.0,0.0
44171,4,4171,[313 187 302 318 100],90,5,17724,4.248322147651007,20.0,20.0
44172,4,4172,[313 187 302 318 100],537,5,17729,4.24850227653966,20.0,20.0
44173,4,4173,[313 187 302 318 100],328,5,17734,4.248682319118352,20.0,20.0
44174,4,4174,[588 176 235 202 288],200,4,17738,4.248622754491018,0.0,0.0
44175,4,4175,[313 187 302 318 100],328,5,17743,4.248802681992337,20.0,20.0
44176,4,4176,[210 211 265 186 202],102,2,17745,4.2482643045247785,0.0,0.0
44177,4,4177,[132 318  88 385  82],653,3,17748,4.2479655337482045,20.0,0.0
44178,4,4178,[ 50 496 186 603 118],298,5,17753,4.248145489351519,20.0,20.0
44179,4,4179,[ 89 132 276 195 176],406,5,17758,4.248325358851675,0.0,0.0
44180,4,4180,[175  70 181 322 117],881,3,17761,4.248026787849796,0.0,0.0
44181,4,4181,[313 187 302 318 100],90,5,17766,4.248206599713056,20.0,20.0
44182,4,4182,[313 187 302 318 100],144,4,17770,4.248147262730098,20.0,20.0
44183,4,4183,[313 187 302 318 100],271,5,17775,4.248326959847036,20.0,20.0
44184,4,4184,[313 187 302 318 100],328,5,17780,4.2485065710872165,20.0,20.0
44185,4,4185,[313 187 302 318 100],90,5,17785,4.248686096512183,20.0,20.0
44186,4,4186,[ 96 132 286 357 588],200,5,17790,4.248865536183425,20.0,0.0
44187,4,4187,[313 187 302 318 100],537,5,17795,4.249044890162368,20.0,20.0
44188,4,4188,[313 187 302 318 100],144,4,17799,4.248985438052041,20.0,20.0
44189,4,4189,[194 496 143 183 215],840,4,17803,4.248926014319809,0.0,0.0
44190,4,4190,[ 97 222 211  28  79],454,3,17806,4.24862801240754,0.0,0.0
44191,4,4191,[313 187 302 318 100],90,5,17811,4.248807251908397,20.0,20.0
44192,4,4192,[313 187 302 318 100],474,5,17816,4.24898640591462,20.0,20.0
44193,4,4193,[313 187 302 318 100],90,5,17821,4.249165474487363,20.0,20.0
44194,4,4194,[313 187 302 318 100],328,5,17826,4.249344457687723,20.0,20.0
44195,4,4195,[508 202 211  56 234],447,3,17829,4.249046711153479,0.0,0.0
44196,4,4196,[313 187 302 318 100],144,4,17833,4.248987371932333,20.0,20.0
44197,4,4197,[313 187 302 318 100],537,5,17838,4.249166269652215,20.0,20.0
44198,4,4198,[313 187 302 318 100],537,5,17843,4.24934508216242,20.0,20.0
44199,4,4199,[435 273 179 118 204],643,2,17845,4.248809523809523,0.0,0.0
44200,4,4200,[313 187 302 318 100],144,4,17849,4.248750297548203,20.0,20.0
44201,4,4201,[313 187 302 318 100],207,4,17853,4.2486910994764395,20.0,20.0
44202,4,4202,[313 187 302 318 100],271,5,17858,4.248869854865572,20.0,20.0
44203,4,4203,[313 187 302 318 100],328,5,17863,4.249048525214082,20.0,20.0
44204,4,4204,[313 187 302 318 100],474,5,17868,4.249227110582639,20.0,20.0
44205,4,4205,[313 187 302 318 100],144,4,17872,4.249167855444603,20.0,20.0
44206,4,4206,[313 187 302 318 100],207,4,17876,4.249108628476349,20.0,20.0
44207,4,4207,[313 187 302 318 100],90,5,17881,4.249287072243346,20.0,20.0
44208,4,4208,[313 187 302 318 100],144,4,17885,4.249227845093847,20.0,20.0
44209,4,4209,[313 187 302 318 100],271,5,17890,4.249406175771972,20.0,20.0
44210,4,4210,[313 187 302 318 100],144,4,17894,4.249346948468298,20.0,20.0
44211,4,4211,[313 187 302 318 100],90,5,17899,4.249525166191833,20.0,20.0
44212,4,4212,[313 187 302 318 100],144,4,17903,4.249465938760978,20.0,20.0
44213,4,4213,[313 187 302 318 100],474,5,17908,4.249644043663977,20.0,20.0
44214,4,4214,[12 25 70  9 11],90,5,17913,4.249822064056939,20.0,0.0
44215,4,4215,[313 187 302 318 100],144,4,17917,4.249762808349146,20.0,20.0
44216,4,4216,[313 187 302 318 100],144,4,17921,4.2497035807446055,20.0,20.0
44217,4,4217,[313 187 302 318 100],13,4,17925,4.249644381223328,20.0,20.0
44218,4,4218,[ 25 210  50 121 132],271,3,17928,4.249348186774117,0.0,20.0
44219,4,4219,[313 187 302 318 100],537,5,17933,4.249526066350711,20.0,20.0
44220,4,4220,[313 187 302 318 100],328,5,17938,4.24970386164416,20.0,20.0
44221,4,4221,[313 187 302 318 100],537,5,17943,4.2498815727143535,20.0,20.0
44222,4,4222,[313 187 302 318 100],537,5,17948,4.2500591996211226,20.0,20.0
44223,4,4223,[313 187 302 318 100],537,5,17953,4.250236742424242,20.0,20.0
44224,4,4224,[151  89  96 237 318],295,4,17957,4.2501775147929,20.0,0.0
44225,4,4225,[313 187 302 318 100],144,4,17961,4.250118315191671,20.0,20.0
44226,4,4226,[313 187 302 318 100],334,5,17966,4.250295718003312,20.0,20.0
44227,4,4227,[ 98 127  28  50 318],194,4,17970,4.250236518448439,20.0,60.0
44228,4,4228,[313 187 302 318 100],328,5,17975,4.250413809411208,20.0,20.0
44229,4,4229,[313 187 302 318 100],207,4,17979,4.250354609929078,20.0,20.0
44230,4,4230,[313 187 302 318 100],271,5,17984,4.2505317891751355,20.0,20.0
44231,4,4231,[313 187 302 318 100],144,4,17988,4.250472589792061,20.0,20.0
44232,4,4232,[194 100 237 357  22],892,5,17993,4.2506496574533426,20.0,20.0
44233,4,4233,[313 187 302 318 100],271,5,17998,4.250826641473783,20.0,20.0
44234,4,4234,[313 187 302 318 100],474,5,18003,4.251003541912633,20.0,20.0
44235,4,4235,[313 187 302 318 100],474,5,18008,4.251180358829084,20.0,20.0
44236,4,4236,[313 187 302 318 100],144,4,18012,4.251121076233184,20.0,20.0
44237,4,4237,[313 187 302 318 100],144,4,18016,4.251061821613969,20.0,20.0
44238,4,4238,[313 187 302 318 100],207,4,18020,4.25100259495164,20.0,20.0
44239,4,4239,[313 187 302 318 100],90,5,18025,4.251179245283019,20.0,20.0
44240,4,4240,[313 187 302 318 100],537,5,18030,4.251355812308418,20.0,20.0
44241,4,4241,[313 187 302 318 100],90,5,18035,4.251532296086752,20.0,20.0
44242,4,4242,[313 187 302 318 100],328,5,18040,4.25170869667688,20.0,20.0
44243,4,4243,[313 187 302 318 100],537,5,18045,4.251885014137606,20.0,20.0
44244,4,4244,[313 187 302 318 100],328,5,18050,4.25206124852768,20.0,20.0
44245,4,4245,[313 187 302 318 100],334,5,18055,4.252237399905794,20.0,20.0
44246,4,4246,[313 187 302 318 100],144,4,18059,4.252178008005651,20.0,20.0
44247,4,4247,[313 187 302 318 100],328,5,18064,4.252354048964219,20.0,20.0
44248,4,4248,[313 187 302 318 100],334,5,18069,4.252530007060485,20.0,20.0
44249,4,4249,[117 185  95   7 228],95,3,18072,4.252235294117647,0.0,0.0
44250,4,4250,[313 187 302 318 100],334,5,18077,4.252411197365326,20.0,20.0
44251,4,4251,[313 187 302 318 100],13,4,18081,4.252351834430856,20.0,20.0
44252,4,4252,[313 187 302 318 100],474,5,18086,4.2525276275570185,20.0,20.0
44253,4,4253,[313 187 302 318 100],474,5,18091,4.252703338034791,20.0,20.0
44254,4,4254,[275 111 172 196 216],474,4,18095,4.2526439482961225,0.0,0.0
44255,4,4255,[313 187 302 318 100],90,5,18100,4.25281954887218,20.0,20.0
44256,4,4256,[144 174 655  56 471],207,3,18103,4.252525252525253,0.0,20.0
44257,4,4257,[313 187 302 318 100],207,4,18107,4.252465946453734,20.0,20.0
44258,4,4258,[313 187 302 318 100],537,5,18112,4.25264146513266,20.0,20.0
44259,4,4259,[143 121 385 328 238],95,5,18117,4.252816901408451,0.0,0.0
44260,4,4260,[313 187 302 318 100],207,4,18121,4.252757568645857,20.0,20.0
44261,4,4261,[313 187 302 318 100],144,4,18125,4.25269826372595,20.0,20.0
44262,4,4262,[313 187 302 318 100],334,5,18130,4.252873563218391,20.0,20.0
44263,4,4263,[313 187 302 318 100],90,5,18135,4.253048780487805,20.0,20.0
44264,4,4264,[313 187 302 318 100],328,5,18140,4.253223915592028,20.0,20.0
44265,4,4265,[313 187 302 318 100],271,5,18145,4.253398968588842,20.0,20.0
44266,4,4266,[313 187 302 318 100],474,5,18150,4.253573939535974,20.0,20.0
44267,4,4267,[313 187 302 318 100],13,4,18154,4.253514526710403,20.0,20.0
44268,4,4268,[313 187 302 318 100],90,5,18159,4.253689388615601,20.0,20.0
44269,4,4269,[313 187 302 318 100],90,5,18164,4.253864168618267,20.0,20.0
44270,4,4270,[313 187 302 318 100],537,5,18169,4.254038866775931,20.0,20.0
44271,4,4271,[313 187 302 318 100],144,4,18173,4.2539794007490634,20.0,20.0
44272,4,4272,[313 187 302 318 100],90,5,18178,4.25415399017084,20.0,20.0
44273,4,4273,[313 187 302 318 100],271,5,18183,4.254328497894244,20.0,20.0
44274,4,4274,[313 187 302 318 100],207,4,18187,4.254269005847953,20.0,20.0
44275,4,4275,[313 187 302 318 100],207,4,18191,4.25420954162769,20.0,20.0
44276,4,4276,[313 187 302 318 100],90,5,18196,4.254383913958382,20.0,20.0
44277,4,4277,[276 318  22 508 161],59,4,18200,4.254324450677887,20.0,0.0
44278,4,4278,[313 187 302 318 100],144,4,18204,4.254265015190465,20.0,20.0
44279,4,4279,[313 187 302 318 100],207,4,18208,4.254205607476636,20.0,20.0
44280,4,4280,[313 187 302 318 100],328,5,18213,4.254379817799579,20.0,20.0
44281,4,4281,[313 187 302 318 100],328,5,18218,4.254553946753854,20.0,20.0
44282,4,4282,[268  98 423 357  79],7,4,18222,4.2544945131916885,20.0,20.0
44283,4,4283,[313 187 302 318 100],537,5,18227,4.254668534080299,20.0,20.0
44284,4,4284,[210 238 568 483 180],897,4,18231,4.25460910151692,20.0,0.0
44285,4,4285,[313 187 302 318 100],144,4,18235,4.254549696686888,20.0,20.0
44286,4,4286,[313 187 302 318 100],328,5,18240,4.254723582925123,20.0,20.0
44287,4,4287,[135 194 228 153 175],788,1,18241,4.253964552238806,0.0,0.0
44288,4,4288,[194 111  15 216  12],42,4,18245,4.253905339239916,20.0,0.0
44289,4,4289,[313 187 302 318 100],271,5,18250,4.2540792540792545,20.0,20.0
44290,4,4290,[313 187 302 318 100],334,5,18255,4.2542530878583085,20.0,20.0
44291,4,4291,[313 187 302 318 100],13,4,18259,4.254193849021435,20.0,20.0
44292,4,4292,[313 187 302 318 100],334,5,18264,4.254367575122292,20.0,20.0
44293,4,4293,[222  89 313  12 168],119,4,18268,4.254308337214718,20.0,0.0
44294,4,4294,[313 187 302 318 100],144,4,18272,4.254249126891734,20.0,20.0
44295,4,4295,[313 187 302 318 100],537,5,18277,4.254422718808193,20.0,20.0
44296,4,4296,[435 187  22 195 211],326,3,18280,4.254130788922504,0.0,0.0
44297,4,4297,[313 187 302 318 100],537,5,18285,4.25430432759423,20.0,20.0
44298,4,4298,[197 496 427 191 403],59,5,18290,4.254477785531519,0.0,0.0
44299,4,4299,[313 187 302 318 100],90,5,18295,4.254651162790697,20.0,20.0
44300,4,4300,[313 187 302 318 100],537,5,18300,4.25482445942804,20.0,20.0
44301,4,4301,[ 22  50 121  89 385],537,2,18302,4.254300325430033,0.0,20.0
44302,4,4302,[313 187 302 318 100],207,4,18306,4.254241227050895,20.0,20.0
44303,4,4303,[655  22 100 265 268],13,5,18311,4.254414498141264,0.0,20.0
44304,4,4304,[313 187 302 318 100],537,5,18316,4.254587688734031,20.0,20.0
44305,4,4305,[237 125 143 202 216],7,3,18319,4.254296330701347,0.0,0.0
44306,4,4306,[313 187 302 318 100],13,4,18323,4.254237288135593,20.0,20.0
44307,4,4307,[313 187 302 318 100],90,5,18328,4.254410399257196,20.0,20.0
44308,4,4308,[313 187 302 318 100],13,4,18332,4.2543513576235785,20.0,20.0
44309,4,4309,[313 187 302 318 100],328,5,18337,4.254524361948956,20.0,20.0
44310,4,4310,[125  96 475 228 118],92,4,18341,4.254465321271167,0.0,0.0
44311,4,4311,[197 176 405   7 111],666,3,18344,4.25417439703154,0.0,0.0
44312,4,4312,[313 187 302 318 100],328,5,18349,4.254347322049617,20.0,20.0
44313,4,4313,[313 187 302 318 100],328,5,18354,4.2545201668984705,20.0,20.0
44314,4,4314,[313 187 302 318 100],13,4,18358,4.2544611819235225,20.0,20.0
44315,4,4315,[313 187 302 318 100],207,4,18362,4.254402224281742,20.0,20.0
44316,4,4316,[313 187 302 318 100],334,5,18367,4.254574936298355,20.0,20.0
44317,4,4317,[313 187 302 318 100],537,5,18372,4.254747568318666,20.0,20.0
44318,4,4318,[313 187 302 318 100],207,4,18376,4.254688585320676,20.0,20.0
44319,4,4319,[313 187 302 318 100],207,4,18380,4.25462962962963,20.0,20.0
44320,4,4320,[ 64 234 195 194 174],239,3,18383,4.254339273316362,0.0,20.0
44321,4,4321,[313 187 302 318 100],207,4,18387,4.25428042572883,20.0,20.0
44322,4,4322,[313 187 302 318 100],474,5,18392,4.254452926208652,20.0,20.0
44323,4,4323,[313 187 302 318 100],271,5,18397,4.254625346901018,20.0,20.0
44324,4,4324,[313 187 302 318 100],334,5,18402,4.254797687861272,20.0,20.0
44325,4,4325,[313 187 302 318 100],13,4,18406,4.254738788719371,20.0,20.0
44326,4,4326,[313 187 302 318 100],271,5,18411,4.254911023804021,20.0,20.0
44327,4,4327,[313 187 302 318 100],13,4,18415,4.25485212569316,20.0,20.0
44328,4,4328,[313 187 302 318 100],328,5,18420,4.255024255024255,20.0,20.0
44329,4,4329,[313 187 302 318 100],328,5,18425,4.255196304849885,20.0,20.0
44330,4,4330,[121 161 282 289 127],95,3,18428,4.254906488108982,0.0,20.0
44331,4,4331,[313 187 302 318 100],328,5,18433,4.255078485687904,20.0,20.0
44332,4,4332,[423 202 173 132 127],59,5,18438,4.255250403877222,0.0,20.0
44333,4,4333,[313 187 302 318 100],207,4,18442,4.255191508998616,20.0,20.0
44334,4,4334,[508 211 153 318 238],343,5,18447,4.255363321799308,20.0,0.0
44335,4,4335,[313 187 302 318 100],474,5,18452,4.2555350553505535,20.0,20.0
44336,4,4336,[313 187 302 318 100],13,4,18456,4.255476135577588,20.0,20.0
44337,4,4337,[313 187 302 318 100],13,4,18460,4.25541724296911,20.0,20.0
44338,4,4338,[313 187 302 318 100],537,5,18465,4.255588845356073,20.0,20.0
44339,4,4339,[ 97 588 186  71  64],406,3,18468,4.255299539170507,0.0,0.0
44340,4,4340,[313 187 302 318 100],13,4,18472,4.25524072794287,20.0,20.0
44341,4,4341,[313 187 302 318 100],271,5,18477,4.255412252418241,20.0,20.0
44342,4,4342,[313 187 302 318 100],13,4,18481,4.255353442320977,20.0,20.0
44343,4,4343,[313 187 302 318 100],144,4,18485,4.255294659300184,20.0,20.0
44344,4,4344,[313 187 302 318 100],207,4,18489,4.255235903337169,20.0,20.0
44345,4,4345,[313 187 302 318 100],271,5,18494,4.255407271053842,20.0,20.0
44346,4,4346,[183 144 748 237 515],883,4,18498,4.255348516218081,0.0,0.0
44347,4,4347,[313 187 302 318 100],144,4,18502,4.255289788408463,20.0,20.0
44348,4,4348,[271 215 235 100 655],144,3,18505,4.255001149689583,0.0,20.0
44349,4,4349,[313 187 302 318 100],13,4,18509,4.254942528735632,20.0,20.0
44350,4,4350,[313 187 302 318 100],13,4,18513,4.254883934727649,20.0,20.0
44351,4,4351,[313 187 302 318 100],90,5,18518,4.255055147058823,20.0,20.0
44352,4,4352,[176  11 385 168 265],59,5,18523,4.255226280725936,0.0,0.0
44353,4,4353,[313 187 302 318 100],90,5,18528,4.255397335783188,20.0,20.0
44354,4,4354,[313 187 302 318 100],144,4,18532,4.2553386911595865,20.0,20.0
44355,4,4355,[313 187 302 318 100],13,4,18536,4.255280073461892,20.0,20.0
44356,4,4356,[313 187 302 318 100],144,4,18540,4.255221482671563,20.0,20.0
44357,4,4357,[ 56 197 118  28 515],271,3,18543,4.25493345571363,0.0,0.0
44358,4,4358,[ 89 202  97 515 211],194,2,18545,4.254416150493232,0.0,0.0
44359,4,4359,[313 187 302 318 100],537,5,18550,4.254587155963303,20.0,20.0
44360,4,4360,[196 568 153   4  70],194,1,18551,4.253840862187571,0.0,0.0
44361,4,4361,[313 187 302 318 100],537,5,18556,4.254011921137093,20.0,20.0
44362,4,4362,[313 187 302 318 100],90,5,18561,4.25418290167316,20.0,20.0
44363,4,4363,[121 471 211  50 202],699,0,18561,4.2532080659945,0.0,20.0
44364,4,4364,[313 187 302 318 100],144,4,18565,4.253150057273769,20.0,20.0
44365,4,4365,[313 187 302 318 100],90,5,18570,4.253321117727897,20.0,20.0
44366,4,4366,[313 187 302 318 100],537,5,18575,4.253492099839707,20.0,20.0
44367,4,4367,[  9 403 275   7 168],13,1,18576,4.252747252747253,0.0,0.0
44368,4,4368,[313 187 302 318 100],334,5,18581,4.252918287937743,20.0,20.0
44369,4,4369,[313 187 302 318 100],537,5,18586,4.2530892448512585,20.0,20.0
44370,4,4370,[ 71   8 179 132  89],200,5,18591,4.253260123541524,0.0,0.0
44371,4,4371,[313 187 302 318 100],144,4,18595,4.2532021957914,20.0,20.0
44372,4,4372,[  7  69 191 187   1],881,4,18599,4.2531442945346445,0.0,0.0
44373,4,4373,[313 187 302 318 100],13,4,18603,4.253086419753086,20.0,20.0
44374,4,4374,[313 187 302 318 100],271,5,18608,4.253257142857143,20.0,20.0
44375,4,4375,[135  89 405  15 234],537,2,18610,4.252742230347349,0.0,0.0
44376,4,4376,[313 187 302 318 100],537,5,18615,4.252912954078136,20.0,20.0
44377,4,4377,[313 187 302 318 100],537,5,18620,4.253083599817268,20.0,20.0
44378,4,4378,[ 70 186  50 322   1],533,4,18624,4.253025804978305,0.0,20.0
44379,4,4379,[313 187 302 318 100],271,5,18629,4.253196347031963,20.0,20.0
44380,4,4380,[313 187 302 318 100],328,5,18634,4.253366811230313,20.0,20.0
44381,4,4381,[435 180 161 202 427],59,4,18638,4.2533089913281605,0.0,0.0
44382,4,4382,[313 187 302 318 100],144,4,18642,4.253251197809719,20.0,20.0
44383,4,4383,[313 187 302 318 100],328,5,18647,4.2534215328467155,20.0,20.0
44384,4,4384,[313 187 302 318 100],13,4,18651,4.253363740022805,20.0,20.0
44385,4,4385,[313 187 302 100 318],271,5,18656,4.253533971728226,20.0,20.0
44386,4,4386,[313 187 302 100 318],13,4,18660,4.253476179621609,20.0,20.0
44387,4,4387,[313 187 302 100 318],207,4,18664,4.253418413855971,20.0,20.0
44388,4,4388,[313 187 302 100 318],334,5,18669,4.253588516746412,20.0,20.0
44389,4,4389,[313 187 302 100 318],271,5,18674,4.25375854214123,20.0,20.0
44390,4,4390,[515  50 135  25 180],537,4,18678,4.253700751537235,0.0,20.0
44391,4,4391,[313 187 302 100 318],271,5,18683,4.253870673952641,20.0,20.0
44392,4,4392,[313 187 302 100 318],13,4,18687,4.25381288413385,20.0,20.0
44393,4,4393,[313 187 302 100 318],13,4,18691,4.253755120619026,20.0,20.0
44394,4,4394,[313 187 302 100 318],271,5,18696,4.253924914675768,20.0,20.0
44395,4,4395,[313 187 302 100 318],90,5,18701,4.2540946314831665,20.0,20.0
44396,4,4396,[313 187 302 100 318],207,4,18705,4.254036843302251,20.0,20.0
44397,4,4397,[597 237 245  88  98],378,3,18708,4.2537517053206,0.0,20.0
44398,4,4398,[313 187 302 100 318],328,5,18713,4.2539213457604,20.0,20.0
44399,4,4399,[222  50 215 328 181],749,4,18717,4.253863636363636,0.0,20.0
44400,4,4400,[313 187 302 100 318],328,5,18722,4.254033174278573,20.0,20.0
44401,4,4401,[176 173 655 211 275],7,4,18726,4.25397546569741,0.0,0.0
44402,4,4402,[313 187 302 100 318],13,4,18730,4.253917783329548,20.0,20.0
44403,4,4403,[127 111 294 435  88],533,5,18735,4.2540871934604905,0.0,20.0
44404,4,4404,[176   1 301  15 323],378,3,18738,4.253802497162315,0.0,0.0
44405,4,4405,[313 187 302 100 318],474,5,18743,4.253971856559238,20.0,20.0
44406,4,4406,[ 69 186 174 597  96],897,5,18748,4.254141139096891,0.0,20.0
44407,4,4407,[313 187 302 100 318],13,4,18752,4.254083484573503,20.0,20.0
44408,4,4408,[313 187 302 100 318],90,5,18757,4.254252665003402,20.0,20.0
44409,4,4409,[313 187 302 100 318],144,4,18761,4.254195011337869,20.0,20.0
44410,4,4410,[313 187 302 100 318],13,4,18765,4.254137383813195,20.0,20.0
44411,4,4411,[313 187 302 100 318],537,5,18770,4.254306436990027,20.0,20.0
44412,4,4412,[173 273 271 286 185],479,3,18773,4.254022207115341,0.0,0.0
44413,4,4413,[313 187 302 100 318],144,4,18777,4.253964657906661,20.0,20.0
44414,4,4414,[313 187 302 100 318],207,4,18781,4.253907134767837,20.0,20.0
44415,4,4415,[313 187 302 100 318],474,5,18786,4.2540760869565215,20.0,20.0
44416,4,4416,[313 187 302 100 318],334,5,18791,4.254244962644329,20.0,20.0
44417,4,4417,[ 98  69  70 186 117],308,2,18793,4.2537347215934815,0.0,20.0
44418,4,4418,[313 187 302 100 318],90,5,18798,4.253903598099117,20.0,20.0
44419,4,4419,[ 64 328 191   7   4],653,3,18801,4.253619909502262,0.0,0.0
44420,4,4420,[210 153 181   9   1],374,3,18804,4.253336349242253,0.0,0.0
44421,4,4421,[313 187 302 100 318],90,5,18809,4.253505201266395,20.0,20.0
44422,4,4422,[  4 127 483 748 403],328,2,18811,4.2529957042731175,20.0,20.0
44423,4,4423,[313 187 302 100 318],90,5,18816,4.253164556962025,20.0,20.0
44424,4,4424,[ 98 173 275 471 194],7,5,18821,4.253333333333333,0.0,20.0
44425,4,4425,[313 187 302 100 318],328,5,18826,4.253502033438771,20.0,20.0
44426,4,4426,[313 187 302 100 318],90,5,18831,4.25367065733002,20.0,20.0
44427,4,4427,[237 228 313  56 748],13,5,18836,4.253839205058717,0.0,0.0
44428,4,4428,[313 187 302 100 318],328,5,18841,4.2540076766764505,20.0,20.0
44429,4,4429,[655 186 143 423  64],313,3,18844,4.25372460496614,0.0,0.0
44430,4,4430,[313 187 302 100 318],474,5,18849,4.253893026404874,20.0,20.0
44431,4,4431,[  7 173 568  96 238],883,4,18853,4.253835740072202,0.0,0.0
44432,4,4432,[313 187 302 100 318],271,5,18858,4.2540040604556735,20.0,20.0
44433,4,4433,[313 187 302 100 318],207,4,18862,4.253946774921064,20.0,20.0
44434,4,4434,[313 187 302 100 318],90,5,18867,4.254114994363022,20.0,20.0
44435,4,4435,[313 187 302 100 318],207,4,18871,4.254057709648332,20.0,20.0
44436,4,4436,[313 187 302 100 318],328,5,18876,4.2542258282623395,20.0,20.0
44437,4,4437,[405 183 179 172 427],536,2,18878,4.253717890941866,0.0,0.0
44438,4,4438,[  9 202 143  82  11],343,5,18883,4.253886010362694,0.0,0.0
44439,4,4439,[313 187 302 100 318],144,4,18887,4.253828828828829,20.0,20.0
44440,4,4440,[313 187 302 100 318],537,5,18892,4.253996847556857,20.0,20.0
44441,4,4441,[313 187 302 100 318],144,4,18896,4.253939666816749,20.0,20.0
44442,4,4442,[294 282 210 276 222],42,4,18900,4.25388251181634,0.0,0.0
44443,4,4443,[313 187 302 100 318],13,4,18904,4.2538253825382535,20.0,20.0
44444,4,4444,[228 121 181 180  64],279,2,18906,4.253318335208099,0.0,0.0
44445,4,4445,[313 187 302 100 318],90,5,18911,4.253486279802069,20.0,20.0
44446,4,4446,[313 187 302 100 318],334,5,18916,4.253654148864403,20.0,20.0
44447,4,4447,[313 187 302 100 318],13,4,18920,4.253597122302159,20.0,20.0
44448,4,4448,[313 187 302 100 318],474,5,18925,4.253764890986739,20.0,20.0
44449,4,4449,[313 187 302 100 318],144,4,18929,4.253707865168539,20.0,20.0
44450,4,4450,[313 187 302 100 318],328,5,18934,4.253875533587958,20.0,20.0
44451,4,4451,[678  22 286  70 423],554,4,18938,4.25381850853549,0.0,0.0
44452,4,4452,[313 187 302 100 318],144,4,18942,4.253761509094992,20.0,20.0
44453,4,4453,[265 183 186  15 168],374,3,18945,4.253480017961383,0.0,0.0
44454,4,4454,[ 12 211  64 215  97],13,5,18950,4.253647586980921,20.0,0.0
44455,4,4455,[  8 200 173 216 161],474,4,18954,4.253590664272891,0.0,0.0
44456,4,4456,[313 187 302 100 318],90,5,18959,4.253758133273502,20.0,20.0
44457,4,4457,[313 187 302 100 318],328,5,18964,4.253925527142216,20.0,20.0
44458,4,4458,[ 56 496 183 427 204],60,5,18969,4.254092845929581,0.0,0.0
44459,4,4459,[204 546  25 125 323],200,3,18972,4.2538116591928254,0.0,0.0
44460,4,4460,[313 187 302 100 318],144,4,18976,4.25375476350594,20.0,20.0
44461,4,4461,[313 187 302 100 318],334,5,18981,4.253922008068131,20.0,20.0
44462,4,4462,[313 187 302 100 318],90,5,18986,4.254089177683173,20.0,20.0
44463,4,4463,[  9 153 196 183  64],64,4,18990,4.254032258064516,0.0,0.0
44464,4,4464,[313 187 302 100 318],334,5,18995,4.254199328107503,20.0,20.0
44465,4,4465,[313 187 302 100 318],474,5,19000,4.2543663233318405,20.0,20.0
44466,4,4466,[313 187 302 100 318],144,4,19004,4.254309379897022,20.0,20.0
44467,4,4467,[ 71 286   7 174 588],59,2,19006,4.253804834377798,0.0,20.0
44468,4,4468,[187 173  79 475  12],13,2,19008,4.253300514656523,20.0,0.0
44469,4,4469,[435  70 257 515 174],308,4,19012,4.25324384787472,0.0,20.0
44470,4,4470,[313 187 302 100 318],328,5,19017,4.253410870051443,20.0,20.0
44471,4,4471,[313 187 302 100 318],207,4,19021,4.253354203935599,20.0,20.0
44472,4,4472,[144 181 403 191 195],385,0,19021,4.252403308741337,0.0,0.0
44473,4,4473,[313 187 302 100 318],90,5,19026,4.252570406794814,20.0,20.0
44474,4,4474,[403 215 191  79 568],892,4,19030,4.252513966480447,0.0,0.0
44475,4,4475,[313 187 302 100 318],334,5,19035,4.252680965147453,20.0,20.0
44476,4,4476,[313 187 302 100 318],13,4,19039,4.2526245253517985,20.0,20.0
44477,4,4477,[313 187 302 100 318],271,5,19044,4.252791424743189,20.0,20.0
44478,4,4478,[313 187 302 100 318],207,4,19048,4.252734985487832,20.0,20.0
44479,4,4479,[313 182  98 276 186],271,3,19051,4.252455357142857,0.0,20.0
44480,4,4480,[313 187 302 100 318],207,4,19055,4.252399018076322,20.0,20.0
44481,4,4481,[313 187 302 100 318],537,5,19060,4.252565818830879,20.0,20.0
44482,4,4482,[313 187 302 100 318],207,4,19064,4.252509480258755,20.0,20.0
44483,4,4483,[313 187 302 100 318],207,4,19068,4.252453166815344,20.0,20.0
44484,4,4484,[313 187 302 318 100],334,5,19073,4.252619843924192,20.0,20.0
44485,4,4485,[313 187 302 318 100],271,5,19078,4.252786446723139,20.0,20.0
44486,4,4486,[313 187 302 318 100],328,5,19083,4.252952975261867,20.0,20.0
44487,4,4487,[313 187 302 318 100],328,5,19088,4.253119429590018,20.0,20.0
44488,4,4488,[211  96 194  98 100],804,5,19093,4.253285809757184,0.0,40.0
44489,4,4489,[313 187 302 100 318],90,5,19098,4.253452115812918,20.0,20.0
44490,4,4490,[313 187 302 100 318],537,5,19103,4.253618347806724,20.0,20.0
44491,4,4491,[ 28 143 328 127 168],653,3,19106,4.253339269813001,0.0,20.0
44492,4,4492,[313 187 302 100 318],207,4,19110,4.25328288448698,20.0,20.0
44493,4,4493,[313 187 302 318 100],90,5,19115,4.253449043168669,20.0,20.0
44494,4,4494,[313 187 302 318 100],144,4,19119,4.253392658509455,20.0,20.0
44495,4,4495,[655  89  95 185 172],815,2,19121,4.252891459074733,0.0,0.0
44496,4,4496,[195 191  89 423  28],311,5,19126,4.253057593951524,0.0,0.0
44497,4,4497,[313 187 302 318 100],90,5,19131,4.253223654957759,20.0,20.0
44498,4,4498,[168   7 135 237 173],334,5,19136,4.253389642142698,0.0,0.0
44499,4,4499,[234 204 174 508 180],833,2,19138,4.252888888888889,0.0,20.0
44500,4,4500,[313 187 302 318 100],90,5,19143,4.253054876694068,20.0,20.0
44501,4,4501,[313 187 302 318 100],90,5,19148,4.253220790759662,20.0,20.0
44502,4,4502,[313 187 302 318 100],328,5,19153,4.253386631134799,20.0,20.0
44503,4,4503,[127  97 100 202 180],188,4,19157,4.253330373001776,0.0,40.0
44504,4,4504,[333 222 322 748   7],26,0,19157,4.252386237513874,0.0,0.0
44505,4,4505,[313 187 302 318 100],474,5,19162,4.2525521526853085,20.0,20.0
44506,4,4506,[313 187 302 318 100],271,5,19167,4.252717994231196,20.0,20.0
44507,4,4507,[313 187 302 318 100],334,5,19172,4.252883762200533,20.0,20.0
44508,4,4508,[258 211 276 187 313],13,5,19177,4.253049456642271,0.0,0.0
44509,4,4509,[313 187 302 318 100],207,4,19181,4.252993348115299,20.0,20.0
44510,4,4510,[403 197 265 597 215],13,3,19184,4.252715584127688,0.0,0.0
44511,4,4511,[202 222 200 153 328],653,2,19186,4.252216312056738,0.0,0.0
44512,4,4512,[313 187 302 318 100],13,4,19190,4.252160425437625,20.0,20.0
44513,4,4513,[655  71 678 435  69],7,4,19194,4.252104563579973,0.0,0.0
44514,4,4514,[313 187 302 318 100],474,5,19199,4.252270210409745,20.0,20.0
44515,4,4515,[ 97  96 173 222 215],42,4,19203,4.2522143489814,0.0,0.0
44516,4,4516,[313 187 302 318 100],271,5,19208,4.252379898162498,20.0,20.0
44517,4,4517,[313 187 302 318 100],207,4,19212,4.252324037184595,20.0,20.0
44518,4,4518,[313 187 302 318 100],537,5,19217,4.252489488824962,20.0,20.0
44519,4,4519,[161  97 323  89 603],59,4,19221,4.252433628318584,20.0,0.0
44520,4,4520,[313 187 302 318 100],537,5,19226,4.25259898252599,20.0,20.0
44521,4,4521,[313 187 302 318 100],144,4,19230,4.252543122512162,20.0,20.0
44522,4,4522,[313 187 302 318 100],90,5,19235,4.252708379394208,20.0,20.0
44523,4,4523,[313 176 269 197 258],334,3,19238,4.252431476569408,0.0,0.0
44524,4,4524,[313 187 302 318 100],207,4,19242,4.252375690607735,20.0,20.0
44525,4,4525,[313 187 302 318 100],13,4,19246,4.252319929297393,20.0,20.0
44526,4,4526,[ 12 182 185 121 228],64,4,19250,4.252264192622046,20.0,0.0
44527,4,4527,[216 118 183 265 276],378,5,19255,4.252429328621908,0.0,0.0
44528,4,4528,[ 79 195 289 132 588],194,1,19256,4.2517111945241775,0.0,0.0
44529,4,4529,[180 300 175 357 546],234,1,19257,4.250993377483444,20.0,0.0
44530,4,4530,[313 187 302 318 100],334,5,19262,4.251158684617082,20.0,20.0
44531,4,4531,[313 187 302 318 100],207,4,19266,4.251103265666372,20.0,20.0
44532,4,4532,[313 187 302 318 100],537,5,19271,4.251268475623208,20.0,20.0
44533,4,4533,[313 187 302 318 100],474,5,19276,4.251433612704014,20.0,20.0
44534,4,4534,[313 187 302 318 100],13,4,19280,4.251378169790518,20.0,20.0
44535,4,4535,[313 187 302 318 100],474,5,19285,4.2515432098765435,20.0,20.0
44536,4,4536,[200   7  50 117 655],387,3,19288,4.251267357284549,0.0,20.0
44537,4,4537,[313 187 302 318 100],13,4,19292,4.251211987659762,20.0,20.0
44538,4,4538,[313 187 302 318 100],207,4,19296,4.251156642432254,20.0,20.0
44539,4,4539,[ 89 496 357  64 300],271,3,19299,4.250881057268723,20.0,0.0
44540,4,4540,[313 187 302 318 100],474,5,19304,4.2510460251046025,20.0,20.0
44541,4,4541,[313 187 302 318 100],207,4,19308,4.250990752972259,20.0,20.0
44542,4,4542,[313 187 302 318 100],144,4,19312,4.2509355051727935,20.0,20.0
44543,4,4543,[313 187 302 318 100],13,4,19316,4.250880281690141,20.0,20.0
44544,4,4544,[508  12 318  71 222],533,5,19321,4.251045104510451,40.0,0.0
44545,4,4545,[235 222 100 286 275],119,5,19326,4.2512098548174215,0.0,20.0
44546,4,4546,[313 187 302 318 100],207,4,19330,4.251154607433473,20.0,20.0
44547,4,4547,[313 187 302 318 100],13,4,19334,4.251099384344767,20.0,20.0
44548,4,4548,[313 187 302 318 100],90,5,19339,4.251264014069026,20.0,20.0
44549,4,4549,[313 187 302 318 100],474,5,19344,4.251428571428572,20.0,20.0
44550,4,4550,[313 187 302 318 100],334,5,19349,4.251593056471105,20.0,20.0
44551,4,4551,[313 187 302 318 100],271,5,19354,4.251757469244288,20.0,20.0
44552,4,4552,[313 187 302 318 100],13,4,19358,4.251702174390512,20.0,20.0
44553,4,4553,[313 187 302 318 100],474,5,19363,4.2518664909969255,20.0,20.0
44554,4,4554,[313 187 302 318 100],13,4,19367,4.251811196487377,20.0,20.0
44555,4,4555,[313 187 302 100 318],13,4,19371,4.251755926251097,20.0,20.0
44556,4,4556,[313 187 302 100 318],13,4,19375,4.2517006802721085,20.0,20.0
44557,4,4557,[175 276 173   4 187],194,3,19378,4.251426064063185,0.0,0.0
44558,4,4558,[678 423 197 427 187],537,3,19381,4.251151568326387,0.0,0.0
44559,4,4559,[313 187 302 100 318],537,5,19386,4.251315789473685,20.0,20.0
44560,4,4560,[202 117 403  50  79],158,4,19390,4.251260688445516,0.0,20.0
44561,4,4561,[313 187 302 100 318],334,5,19395,4.251424813678211,20.0,20.0
44562,4,4562,[313 187 302 100 318],271,5,19400,4.251588866973482,20.0,20.0
44563,4,4563,[313 187 302 100 318],13,4,19404,4.251533742331288,20.0,20.0
44564,4,4564,[313 187 302 100 318],90,5,19409,4.251697699890471,20.0,20.0
44565,4,4565,[313 187 302 100 318],144,4,19413,4.251642575558476,20.0,20.0
44566,4,4566,[313 187 302 100 318],13,4,19417,4.251587475366762,20.0,20.0
44567,4,4567,[313 187 302 100 318],207,4,19421,4.2515323992994745,20.0,20.0
44568,4,4568,[313 187 302 100 318],474,5,19426,4.251696213613482,20.0,20.0
44569,4,4569,[ 89 568  15 132 597],200,5,19431,4.2518599562363235,0.0,0.0
44570,4,4570,[313 187 302 100 318],144,4,19435,4.251804856705316,20.0,20.0
44571,4,4571,[313 187 302 100 318],537,5,19440,4.251968503937008,20.0,20.0
44572,4,4572,[313 187 302 100 318],537,5,19445,4.252132079597638,20.0,20.0
44573,4,4573,[197   8 385 294  88],308,3,19448,4.25185832968955,0.0,0.0
44574,4,4574,[313 187 302 100 318],271,5,19453,4.252021857923498,20.0,20.0
44575,4,4575,[313 187 302 100 318],207,4,19457,4.251966783216783,20.0,20.0
44576,4,4576,[313 187 302 100 318],207,4,19461,4.251911732575923,20.0,20.0
44577,4,4577,[313 187 302 100 318],271,5,19466,4.252075141983399,20.0,20.0
44578,4,4578,[289 172 603 228 678],537,1,19467,4.251364926839921,20.0,0.0
44579,4,4579,[313 187 302 100 318],207,4,19471,4.251310043668123,20.0,20.0
44580,4,4580,[313 187 302 100 318],334,5,19476,4.251473477406679,20.0,20.0
44581,4,4581,[313 187 302 100 318],271,5,19481,4.2516368398079445,20.0,20.0
44582,4,4582,[313   7   4 603 282],334,4,19485,4.251581933231508,20.0,0.0
44583,4,4583,[313 187 302 100 318],334,5,19490,4.25174520069808,20.0,20.0
44584,4,4584,[313 187 302 100 318],271,5,19495,4.251908396946565,20.0,20.0
44585,4,4585,[313 187 302 100 318],144,4,19499,4.251853467073703,20.0,20.0
44586,4,4586,[175 678 117 181  25],749,3,19502,4.251580553738827,0.0,0.0
44587,4,4587,[313 187 302 100 318],328,5,19507,4.251743679163034,20.0,20.0
44588,4,4588,[313 187 302 100 318],334,5,19512,4.2519067334931355,20.0,20.0
44589,4,4589,[313 187 302 100 318],144,4,19516,4.2518518518518515,20.0,20.0
44590,4,4590,[313 187 302 100 318],537,5,19521,4.252014811587889,20.0,20.0
44591,4,4591,[313 187 302 100 318],13,4,19525,4.251959930313589,20.0,20.0
44592,4,4592,[313 187 302 100 318],537,5,19530,4.252122795558458,20.0,20.0
44593,4,4593,[313 187 302 100 318],537,5,19535,4.252285589899869,20.0,20.0
44594,4,4594,[313 187 302 100 318],328,5,19540,4.2524483133841136,20.0,20.0
44595,4,4595,[313 187 302 100 318],144,4,19544,4.252393385552654,20.0,20.0
44596,4,4596,[313 187 302 100 318],537,5,19549,4.252556014792256,20.0,20.0
44597,4,4597,[313 187 302 100 318],334,5,19554,4.252718573292736,20.0,20.0
44598,4,4598,[313 187 302 100 318],537,5,19559,4.252881061100239,20.0,20.0
44599,4,4599,[313 187 302 100 318],474,5,19564,4.25304347826087,20.0,20.0
44600,4,4600,[313 187 302 100 318],328,5,19569,4.253205824820691,20.0,20.0
44601,4,4601,[313 187 302 100 318],144,4,19573,4.2531508039982615,20.0,20.0
44602,4,4602,[238  69 176 153 191],10,5,19578,4.253313056702151,0.0,0.0
44603,4,4603,[313 187 302 100 318],90,5,19583,4.253475238922676,20.0,20.0
44604,4,4604,[313 187 302 100 318],90,5,19588,4.2536373507057545,20.0,20.0
44605,4,4605,[196  70 588 235 174],308,3,19591,4.253365175857577,0.0,20.0
44606,4,4606,[313 187 302 100 318],90,5,19596,4.253527241154765,20.0,20.0
44607,4,4607,[313 187 302 100 318],328,5,19601,4.253689236111111,20.0,20.0
44608,4,4608,[313 187 302 100 318],207,4,19605,4.253634193968323,20.0,20.0
44609,4,4609,[313 187 302 100 318],271,5,19610,4.253796095444685,20.0,20.0
44610,4,4610,[238  11 215 153 176],499,3,19613,4.253524181305574,0.0,0.0
44611,4,4611,[313 187 302 100 318],13,4,19617,4.253469210754553,20.0,20.0
44612,4,4612,[313 187 302 100 318],328,5,19622,4.253631042705398,20.0,20.0
44613,4,4613,[121 179 313 275 202],378,3,19625,4.253359341135674,0.0,0.0
44614,4,4614,[313 187 302 100 318],207,4,19629,4.253304442036836,20.0,20.0
44615,4,4615,[313 187 302 100 318],144,4,19633,4.2532495667244365,20.0,20.0
44616,4,4616,[313 187 302 100 318],474,5,19638,4.253411306042885,20.0,20.0
44617,4,4617,[655 405  98   7 515],92,4,19642,4.253356431355565,0.0,20.0
44618,4,4618,[313 187 302 100 318],13,4,19646,4.253301580428664,20.0,20.0
44619,4,4619,[235 269 181 288 144],13,2,19648,4.252813852813853,0.0,0.0
44620,4,4620,[313 187 302 100 318],334,5,19653,4.252975546418524,20.0,20.0
44621,4,4621,[313 187 302 100 318],13,4,19657,4.252920813500649,20.0,20.0
44622,4,4622,[313 187 302 100 318],13,4,19661,4.252866104261302,20.0,20.0
44623,4,4623,[237 265  22   8  71],378,5,19666,4.2530276816609,0.0,0.0
44624,4,4624,[313 187 302 100 318],13,4,19670,4.252972972972973,20.0,20.0
44625,4,4625,[313 187 302 100 318],334,5,19675,4.253134457414613,20.0,20.0
44626,4,4626,[313 187 302 100 318],474,5,19680,4.253295872055327,20.0,20.0
44627,4,4627,[313 187 302 100 318],328,5,19685,4.253457216940363,20.0,20.0
44628,4,4628,[183  82 238 175 265],95,3,19688,4.253186433354936,0.0,0.0
44629,4,4629,[313 187 302 100 318],207,4,19692,4.253131749460043,20.0,20.0
44630,4,4630,[313 187 302 100 318],90,5,19697,4.253293025264521,20.0,20.0
44631,4,4631,[313 187 302 100 318],90,5,19702,4.253454231433506,20.0,20.0
44632,4,4632,[496 175 151 276  79],334,4,19706,4.253399525145694,0.0,0.0
44633,4,4633,[313 187 302 100 318],144,4,19710,4.253344842468709,20.0,20.0
44634,4,4634,[183 191  56 161 300],379,3,19713,4.253074433656958,0.0,0.0
44635,4,4635,[ 98 132 294 237 168],666,3,19716,4.2528041415012945,0.0,20.0
44636,4,4636,[216 268 678 313 204],537,2,19718,4.252318309251671,0.0,0.0
44637,4,4637,[313 187 302 100 318],474,5,19723,4.252479517033204,20.0,20.0
44638,4,4638,[313 187 302 100 318],271,5,19728,4.2526406553136455,20.0,20.0
44639,4,4639,[313 187 302 100 318],207,4,19732,4.252586206896551,20.0,20.0
44640,4,4640,[313 187 302 100 318],474,5,19737,4.252747252747253,20.0,20.0
44641,4,4641,[313 187 302 100 318],90,5,19742,4.252908229211546,20.0,20.0
44642,4,4642,[313 187 302 100 318],474,5,19747,4.2530691363342665,20.0,20.0
44643,4,4643,[313 187 302 100 318],537,5,19752,4.253229974160207,20.0,20.0
44644,4,4644,[ 89 210 475 173  11],92,4,19756,4.253175457481163,0.0,0.0
44645,4,4645,[313 187 302 100 318],90,5,19761,4.253336203185536,20.0,20.0
44646,4,4646,[313 187 302 100 318],537,5,19766,4.253496879707338,20.0,20.0
44647,4,4647,[313 187 302 100 318],207,4,19770,4.2534423407917386,20.0,20.0
44648,4,4648,[385  50  82 300 144],653,4,19774,4.253387825338782,0.0,20.0
44649,4,4649,[313 187 302 100 318],90,5,19779,4.2535483870967745,20.0,20.0
44650,4,4650,[196 385  88 568  69],774,1,19780,4.25284884970974,0.0,0.0
44651,4,4651,[313 187 302 100 318],13,4,19784,4.252794496990542,20.0,20.0
44652,4,4652,[294 144 168 186 546],194,4,19788,4.252740167633784,0.0,0.0
44653,4,4653,[234 275 185 328 153],328,4,19792,4.252685861624409,0.0,0.0
44654,4,4654,[313 187 302 100 318],207,4,19796,4.252631578947368,20.0,20.0
44655,4,4655,[313 187 302 100 318],537,5,19801,4.252792096219931,20.0,20.0
44656,4,4656,[313 187 302 100 318],13,4,19805,4.252737814043376,20.0,20.0
44657,4,4657,[313 187 302 100 318],334,5,19810,4.252898239587806,20.0,20.0
44658,4,4658,[313 187 302 100 318],207,4,19814,4.252843957930886,20.0,20.0
44659,4,4659,[313 187 302 100 318],271,5,19819,4.253004291845493,20.0,20.0
44660,4,4660,[313 187 302 100 318],334,5,19824,4.253164556962025,20.0,20.0
44661,4,4661,[313 187 302 100 318],271,5,19829,4.253324753324753,20.0,20.0
44662,4,4662,[ 69 135 210 427 655],379,5,19834,4.253484880977911,0.0,0.0
44663,4,4663,[151 237 289 302 322],90,3,19837,4.253216123499143,0.0,0.0
44664,4,4664,[313 187 302 100 318],271,5,19842,4.253376205787782,20.0,20.0
44665,4,4665,[313 187 302 100 318],271,5,19847,4.253536219459923,20.0,20.0
44666,4,4666,[313 187 302 100 318],334,5,19852,4.253696164559674,20.0,20.0
44667,4,4667,[313 187 302 100 318],144,4,19856,4.253641816623822,20.0,20.0
44668,4,4668,[313 187 302 100 318],537,5,19861,4.253801670593274,20.0,20.0
44669,4,4669,[173 121 195 435 172],650,4,19865,4.2537473233404715,0.0,0.0
44670,4,4670,[313 187 302 100 318],13,4,19869,4.253692999357739,20.0,20.0
44671,4,4671,[313 187 302 100 318],13,4,19873,4.253638698630137,20.0,20.0
44672,4,4672,[ 56 181 127 275  22],271,4,19877,4.253584421142735,0.0,20.0
44673,4,4673,[385 200  95   4 322],804,3,19880,4.2533162173727,0.0,0.0
44674,4,4674,[111  56 118   9 197],59,5,19885,4.253475935828877,0.0,0.0
44675,4,4675,[313 187 302 100 318],207,4,19889,4.2534217279726265,20.0,20.0
44676,4,4676,[ 95 322 181 245 435],102,1,19890,4.252726106478512,0.0,0.0
44677,4,4677,[313 187 302 100 318],144,4,19894,4.252672082086361,20.0,20.0
44678,4,4678,[313 187 302 100 318],90,5,19899,4.252831801667023,20.0,20.0
44679,4,4679,[117 200 546  79 194],899,4,19903,4.252777777777778,0.0,0.0
44680,4,4680,[313 187 302 100 318],537,5,19908,4.252937406537065,20.0,20.0
44681,4,4681,[313 187 302 100 318],207,4,19912,4.252883383169586,20.0,20.0
44682,4,4682,[496 175 135  71 265],42,3,19915,4.252615844544096,0.0,0.0
44683,4,4683,[176  11 181 235  56],339,4,19919,4.252561912894961,0.0,0.0
44684,4,4684,[328 204 172   4 235],334,1,19920,4.251867662753469,0.0,0.0
44685,4,4685,[313 187 302 100 318],13,4,19924,4.251813913785745,20.0,20.0
44686,4,4686,[313 187 302 100 318],13,4,19928,4.25176018775336,20.0,20.0
44687,4,4687,[313 187 302 100 318],537,5,19933,4.251919795221843,20.0,20.0
44688,4,4688,[313 187 302 100 318],207,4,19937,4.251866069524419,20.0,20.0
44689,4,4689,[313 187 302 100 318],13,4,19941,4.25181236673774,20.0,20.0
44690,4,4690,[100   7  98  12 265],308,3,19944,4.251545512683863,20.0,40.0
44691,4,4691,[ 22 168 161  98 235],833,2,19946,4.251065643648764,0.0,20.0
44692,4,4692,[313 187 302 100 318],328,5,19951,4.2512252290645645,20.0,20.0
44693,4,4693,[313 187 302 100 318],537,5,19956,4.251384746484875,20.0,20.0
44694,4,4694,[ 79 204 313  69 161],85,4,19960,4.25133120340788,0.0,0.0
44695,4,4695,[313 187 302 100 318],271,5,19965,4.25149063032368,20.0,20.0
44696,4,4696,[313 187 302 100 318],474,5,19970,4.251649989354908,20.0,20.0
44697,4,4697,[313 187 302 100 318],207,4,19974,4.251596424010217,20.0,20.0
44698,4,4698,[483   7 182 197 181],666,4,19978,4.251542881464141,20.0,0.0
44699,4,4699,[ 56 301 357 194 195],6,4,19982,4.251489361702128,20.0,0.0
44700,4,4700,[313 187 302 100 318],328,5,19987,4.25164858540736,20.0,20.0
44701,4,4701,[313 187 302 100 318],537,5,19992,4.251807741386644,20.0,20.0
44702,4,4702,[313 187 302 100 318],537,5,19997,4.251966829683181,20.0,20.0
44703,4,4703,[313 187 302 100 318],271,5,20002,4.2521258503401365,20.0,20.0
44704,4,4704,[216 273  22 238 117],479,3,20005,4.251859723698193,0.0,0.0
44705,4,4705,[  7 182 318 435 405],788,3,20008,4.251593710157246,20.0,0.0
44706,4,4706,[313 187 302 100 318],207,4,20012,4.251540259188443,20.0,20.0
44707,4,4707,[127 603 300 179 191],537,4,20016,4.251486830926083,20.0,20.0
44708,4,4708,[  1  12 174 125 197],234,1,20017,4.2507963474198345,20.0,20.0
44709,4,4709,[405 235  70 144 276],643,3,20020,4.250530785562633,0.0,0.0
44710,4,4710,[313 187 302 100 318],334,5,20025,4.250689874761197,20.0,20.0
44711,4,4711,[237 588 132 197   1],804,5,20030,4.250848896434635,0.0,0.0
44712,4,4712,[313 187 302 100 318],328,5,20035,4.251007850625928,20.0,20.0
44713,4,4713,[313 187 302 100 318],207,4,20039,4.2509546033092915,20.0,20.0
44714,4,4714,[288  79 423 265 168],92,3,20042,4.250689289501591,0.0,0.0
44715,4,4715,[313 187 302 100 318],207,4,20046,4.250636132315521,20.0,20.0
44716,4,4716,[313 187 302 318 100],328,5,20051,4.250794996820013,20.0,20.0
44717,4,4717,[313 187 302 318 100],537,5,20056,4.2509537939805,20.0,20.0
44718,4,4718,[313 187 302 318 100],90,5,20061,4.251112523839796,20.0,20.0
44719,4,4719,[125 403  50 174 238],311,5,20066,4.251271186440678,0.0,40.0
44720,4,4720,[313 187 302 318 100],90,5,20071,4.251429781825884,20.0,20.0
44721,4,4721,[313 187 302 318 100],328,5,20076,4.2515883100381195,20.0,20.0
44722,4,4722,[313 187 302 318 100],271,5,20081,4.251746771120051,20.0,20.0
44723,4,4723,[655 435 603 181 238],339,5,20086,4.25190516511431,20.0,0.0
44724,4,4724,[471 294 276  12   4],207,1,20087,4.2512169312169314,20.0,0.0
44725,4,4725,[313 187 302 318 100],144,4,20091,4.251163774862463,20.0,20.0
44726,4,4726,[100 288 318 121 176],13,2,20093,4.2506875396657495,20.0,20.0
44727,4,4727,[357 173 269 228 197],13,2,20095,4.250211505922166,20.0,0.0
44728,4,4728,[313 187 302 100 318],334,5,20100,4.250370057094523,20.0,20.0
44729,4,4729,[313 187 302 100 318],328,5,20105,4.250528541226216,20.0,20.0
44730,4,4730,[313 187 302 100 318],537,5,20110,4.250686958359755,20.0,20.0
44731,4,4731,[313 187 302 100 318],207,4,20114,4.250633981403213,20.0,20.0
44732,4,4732,[313 187 302 318 100],537,5,20119,4.250792309317558,20.0,20.0
44733,4,4733,[313 187 302 318 100],328,5,20124,4.250950570342205,20.0,20.0
44734,4,4734,[275 286  96 302 121],13,3,20127,4.250686378035903,0.0,0.0
44735,4,4735,[ 82 153 496  64  22],194,3,20130,4.250422297297297,0.0,0.0
44736,4,4736,[313 187 302 318 100],144,4,20134,4.25036943213004,20.0,20.0
44737,4,4737,[313 187 302 318 100],144,4,20138,4.250316589278176,20.0,20.0
44738,4,4738,[313 187 302 318 100],271,5,20143,4.2504747837096435,20.0,20.0
44739,4,4739,[313 187 302 318 100],207,4,20147,4.25042194092827,20.0,20.0
44740,4,4740,[515 172 234 175 143],85,5,20152,4.250580046403712,0.0,0.0
44741,4,4741,[313 187 302 318 100],334,5,20157,4.25073808519612,20.0,20.0
44742,4,4742,[313 187 302 318 100],334,5,20162,4.250896057347671,20.0,20.0
44743,4,4743,[313 187 302 318 100],537,5,20167,4.251053962900506,20.0,20.0
44744,4,4744,[313 187 302 318 100],474,5,20172,4.2512118018967335,20.0,20.0
44745,4,4745,[313 187 302 318 100],537,5,20177,4.251369574378424,20.0,20.0
44746,4,4746,[313 187 302 318 100],328,5,20182,4.251527280387613,20.0,20.0
44747,4,4747,[ 25 161 269 111  79],452,3,20185,4.251263689974726,0.0,0.0
44748,4,4748,[313 187 302 318 100],207,4,20189,4.2512107812170985,20.0,20.0
44749,4,4749,[313 187 302 318 100],271,5,20194,4.251368421052631,20.0,20.0
44750,4,4750,[313 187 302 318 100],144,4,20198,4.2513155125236795,20.0,20.0
44751,4,4751,[ 28 195 183  97  56],64,4,20202,4.251262626262626,0.0,0.0
44752,4,4752,[313 187 302 318 100],537,5,20207,4.251420155691142,20.0,20.0
44753,4,4753,[204 121 294 210 216],378,4,20211,4.251367269667648,0.0,0.0
44754,4,4754,[313 187 302 318 100],537,5,20216,4.251524710830704,20.0,20.0
44755,4,4755,[313 187 302 318 100],537,5,20221,4.251682085786375,20.0,20.0
44756,4,4756,[313 187 302 318 100],271,5,20226,4.251839394576414,20.0,20.0
44757,4,4757,[ 25 403 405 175  88],749,3,20229,4.251576292559899,0.0,0.0
44758,4,4758,[ 22 173 202 182 195],92,2,20231,4.2511031729354904,0.0,0.0
44759,4,4759,[313 187 302 318 100],328,5,20236,4.251260504201681,20.0,20.0
44760,4,4760,[313 187 302 318 100],13,4,20240,4.251207729468599,20.0,20.0
44761,4,4761,[258 194 237 300 195],7,5,20245,4.251364972700546,0.0,0.0
44762,4,4762,[313 187 302 318 100],537,5,20250,4.251522149905521,20.0,20.0
44763,4,4763,[313 187 302 318 100],334,5,20255,4.251679261125105,20.0,20.0
44764,4,4764,[313 187 302 318 100],537,5,20260,4.25183630640084,20.0,20.0
44765,4,4765,[127   4  15 197 191],398,4,20264,4.2517834662190515,0.0,20.0
44766,4,4766,[313 187 302 318 100],144,4,20268,4.251730648206419,20.0,20.0
44767,4,4767,[313 187 302 318 100],271,5,20273,4.251887583892618,20.0,20.0
44768,4,4768,[313 187 302 318 100],13,4,20277,4.251834766198365,20.0,20.0
44769,4,4769,[748   7  28 143 286],653,3,20280,4.251572327044025,0.0,0.0
44770,4,4770,[237 151  11 427 423],882,5,20285,4.251729197233284,0.0,0.0
44771,4,4771,[  1 100 238 215 257],308,4,20289,4.251676445934619,0.0,20.0
44772,4,4772,[237 161  96 234 121],7,4,20293,4.251623716739996,0.0,0.0
44773,4,4773,[313 187 302 318 100],537,5,20298,4.251780477586929,20.0,20.0
44774,4,4774,[313 187 302 318 100],271,5,20303,4.251937172774869,20.0,20.0
44775,4,4775,[313 187 302 318 100],328,5,20308,4.252093802345058,20.0,20.0
44776,4,4776,[313 187 302 318 100],334,5,20313,4.252250366338706,20.0,20.0
44777,4,4777,[313 187 302 318 100],90,5,20318,4.252406864796987,20.0,20.0
44778,4,4778,[313 187 302 318 100],90,5,20323,4.2525632977610375,20.0,20.0
44779,4,4779,[175 204 300 195  12],378,4,20327,4.252510460251046,20.0,0.0
44780,4,4780,[313 187 302 318 100],474,5,20332,4.252666806107509,20.0,20.0
44781,4,4781,[313 187 302 318 100],144,4,20336,4.252613969050606,20.0,20.0
44782,4,4782,[313 187 302 318 100],537,5,20341,4.252770227890445,20.0,20.0
44783,4,4783,[313 187 302 318 100],474,5,20346,4.252926421404682,20.0,20.0
44784,4,4784,[313 187 302 318 100],334,5,20351,4.253082549634274,20.0,20.0
44785,4,4785,[313 187 302 318 100],334,5,20356,4.253238612620142,20.0,20.0
44786,4,4786,[313 187 302 318 100],90,5,20361,4.253394610403175,20.0,20.0
44787,4,4787,[313 187 302 318 100],537,5,20366,4.253550543024227,20.0,20.0
44788,4,4788,[313 187 302 318 100],144,4,20370,4.253497598663604,20.0,20.0
44789,4,4789,[742 135 568 301 238],524,3,20373,4.253235908141963,0.0,0.0
44790,4,4790,[ 89 435   4 195 235],102,2,20375,4.2527656021707365,0.0,0.0
44791,4,4791,[313 187 302 318 100],537,5,20380,4.252921535893155,20.0,20.0
44792,4,4792,[313 187 302 318 100],537,5,20385,4.2530774045483,20.0,20.0
44793,4,4793,[322  70 313 194 282],119,4,20389,4.253024614100959,0.0,0.0
44794,4,4794,[313 187 302 318 100],13,4,20393,4.252971845672576,20.0,20.0
44795,4,4795,[313 187 302 100 318],537,5,20398,4.253127606338616,20.0,20.0
44796,4,4796,[313 187 302 100 318],90,5,20403,4.25328330206379,20.0,20.0
44797,4,4797,[313 187 302 100 318],474,5,20408,4.253438932888703,20.0,20.0
44798,4,4798,[300  71 182  95 172],85,4,20412,4.253386122108773,0.0,0.0
44799,4,4799,[313 187 302 100 318],271,5,20417,4.253541666666667,20.0,20.0
44800,4,4800,[313 187 302 100 318],537,5,20422,4.253697146427828,20.0,20.0
44801,4,4801,[313 187 302 100 318],537,5,20427,4.253852561432736,20.0,20.0
44802,4,4802,[313 187 302 100 318],334,5,20432,4.254007911721841,20.0,20.0
44803,4,4803,[118 175 194 183 588],840,3,20435,4.253746877601999,0.0,0.0
44804,4,4804,[313 187 302 100 318],90,5,20440,4.253902185223725,20.0,20.0
44805,4,4805,[181 187  89 117   1],479,4,20444,4.25384935497295,0.0,0.0
44806,4,4806,[313 187 302 100 318],334,5,20449,4.254004576659039,20.0,20.0
44807,4,4807,[313 187 302 100 318],144,4,20453,4.253951747088187,20.0,20.0
44808,4,4808,[313 187 302 100 318],90,5,20458,4.254106882927844,20.0,20.0
44809,4,4809,[313 187 302 100 318],328,5,20463,4.254261954261954,20.0,20.0
44810,4,4810,[258 276 195 151 168],669,2,20465,4.253793390147578,0.0,0.0
44811,4,4811,[313 187 302 100 318],328,5,20470,4.253948462177888,20.0,20.0
44812,4,4812,[313 187 302 100 318],207,4,20474,4.25389569914814,20.0,20.0
44813,4,4813,[313 187 302 318 100],474,5,20479,4.254050685500623,20.0,20.0
44814,4,4814,[313 187 302 318 100],328,5,20484,4.254205607476636,20.0,20.0
44815,4,4815,[313 187 302 318 100],334,5,20489,4.254360465116279,20.0,20.0
44816,4,4816,[313 187 302 318 100],474,5,20494,4.254515258459622,20.0,20.0
44817,4,4817,[313 187 302 318 100],271,5,20499,4.2546699875467,20.0,20.0
44818,4,4818,[313 187 302 318 100],144,4,20503,4.2546171404855775,20.0,20.0
44819,4,4819,[ 15  95 588  50 286],194,2,20505,4.254149377593361,0.0,20.0
44820,4,4820,[313 187 302 318 100],334,5,20510,4.254304086289151,20.0,20.0
44821,4,4821,[ 69  98 144 385 435],899,1,20511,4.2536291995022815,0.0,20.0
44822,4,4822,[313 187 302 318 100],537,5,20516,4.25378395189716,20.0,20.0
44823,4,4823,[161 655 143 357 216],843,0,20516,4.252902155887231,20.0,0.0
44824,4,4824,[313 187 302 318 100],13,4,20520,4.252849740932643,20.0,20.0
44825,4,4825,[313 187 302 100 318],144,4,20524,4.252797347699959,20.0,20.0
44826,4,4826,[313 187 302 100 318],328,5,20529,4.252952144188937,20.0,20.0
44827,4,4827,[313 187 302 100 318],13,4,20533,4.252899751449876,20.0,20.0
44828,4,4828,[313 187 302 100 318],334,5,20538,4.253054462621661,20.0,20.0
44829,4,4829,[234 204 313 117 200],328,4,20542,4.253002070393375,0.0,0.0
44830,4,4830,[313 187 302 100 318],207,4,20546,4.252949699855103,20.0,20.0
44831,4,4831,[ 25 234 132 273 269],90,4,20550,4.252897350993377,0.0,0.0
44832,4,4832,[313 187 302 100 318],271,5,20555,4.25305193461618,20.0,20.0
44833,4,4833,[313 187 302 100 318],474,5,20560,4.253206454282168,20.0,20.0
44834,4,4834,[313 187 302 100 318],144,4,20564,4.253154084798346,20.0,20.0
44835,4,4835,[275 385  82 288 202],343,3,20567,4.252894954507858,0.0,0.0
44836,4,4836,[313 187 302 100 318],334,5,20572,4.253049410791813,20.0,20.0
44837,4,4837,[194 176 195 435 496],899,4,20576,4.2529971062422485,0.0,0.0
44838,4,4838,[515 127 216 655  12],334,4,20580,4.252944823310601,20.0,20.0
44839,4,4839,[313 187 302 100 318],207,4,20584,4.252892561983471,20.0,20.0
44840,4,4840,[313 187 302 318 100],13,4,20588,4.2528403222474696,20.0,20.0
44841,4,4841,[313 187 302 100 318],207,4,20592,4.25278810408922,20.0,20.0
44842,4,4842,[313 187 302 318 100],144,4,20596,4.252735907495354,20.0,20.0
44843,4,4843,[313 187 302 318 100],328,5,20601,4.252890173410405,20.0,20.0
44844,4,4844,[313 187 302 318 100],474,5,20606,4.253044375644995,20.0,20.0
44845,4,4845,[234 294 182  12 286],474,4,20610,4.252992158481222,20.0,0.0
44846,4,4846,[313 187 302 318 100],271,5,20615,4.2531462760470395,20.0,20.0
44847,4,4847,[180  79  98 117  96],648,3,20618,4.252887788778878,0.0,20.0
44848,4,4848,[313 187 302 318 100],144,4,20622,4.252835636213653,20.0,20.0
44849,4,4849,[313 187 302 318 100],328,5,20627,4.252989690721649,20.0,20.0
44850,4,4850,[313 187 302 318 100],334,5,20632,4.253143681715111,20.0,20.0
44851,4,4851,[176  69  89 195 132],843,3,20635,4.252885408079143,0.0,0.0
44852,4,4852,[313 187 302 318 100],207,4,20639,4.252833298990315,20.0,20.0
44853,4,4853,[313 187 302 318 100],271,5,20644,4.252987227029254,20.0,20.0
44854,4,4854,[313 187 302 318 100],474,5,20649,4.253141091658084,20.0,20.0
44855,4,4855,[215 328 228  96  11],749,5,20654,4.253294892915981,0.0,0.0
44856,4,4856,[313 187 302 318 100],13,4,20658,4.253242742433601,20.0,20.0
44857,4,4857,[288 258 174 210 181],197,4,20662,4.253190613421161,0.0,20.0
44858,4,4858,[313 187 302 318 100],144,4,20666,4.2531385058654045,20.0,20.0
44859,4,4859,[313 187 302 318 100],13,4,20670,4.253086419753086,20.0,20.0
44860,4,4860,[180 168 125 195  15],881,3,20673,4.252828636083111,0.0,0.0
44861,4,4861,[333 318 568 151 183],313,4,20677,4.252776635129576,20.0,0.0
44862,4,4862,[195 238 182 144 180],95,3,20680,4.252519021180341,0.0,0.0
44863,4,4863,[313 187 302 100 318],537,5,20685,4.252672697368421,20.0,20.0
44864,4,4864,[313 187 302 100 318],328,5,20690,4.252826310380267,20.0,20.0
44865,4,4865,[ 12 300 197  98  64],13,4,20694,4.252774352651048,20.0,20.0
44866,4,4866,[313 187 302 100 318],144,4,20698,4.252722416272858,20.0,20.0
44867,4,4867,[313 187 302 100 318],537,5,20703,4.252875924404273,20.0,20.0
44868,4,4868,[313 187 302 100 318],271,5,20708,4.2530293694803865,20.0,20.0
44869,4,4869,[313 187 302 100 318],537,5,20713,4.253182751540041,20.0,20.0
44870,4,4870,[385 483 235 187  69],524,3,20716,4.25292547731472,20.0,0.0
44871,4,4871,[313 187 302 100 318],334,5,20721,4.25307881773399,20.0,20.0
44872,4,4872,[271 144 276 655 313],144,3,20724,4.252821670428894,0.0,0.0
44873,4,4873,[313 187 302 100 318],144,4,20728,4.252769798933114,20.0,20.0
44874,4,4874,[313 187 302 100 318],474,5,20733,4.252923076923077,20.0,20.0
44875,4,4875,[313 187 302 100 318],90,5,20738,4.253076292042658,20.0,20.0
44876,4,4876,[ 70 215   8 222 258],234,1,20739,4.252409267992618,0.0,0.0
44877,4,4877,[313 187 302 100 318],474,5,20744,4.252562525625256,20.0,20.0
44878,4,4878,[403   7 118 187 121],158,5,20749,4.252715720434515,0.0,0.0
44879,4,4879,[313 187 302 100 318],537,5,20754,4.252868852459017,20.0,20.0
44880,4,4880,[313 187 302 100 318],207,4,20758,4.252817045687359,20.0,20.0
44881,4,4881,[313 187 302 318 100],474,5,20763,4.252970094223679,20.0,20.0
44882,4,4882,[313 187 302 318 100],328,5,20768,4.253123080073725,20.0,20.0
44883,4,4883,[313 187 302 318 100],334,5,20773,4.253276003276003,20.0,20.0
44884,4,4884,[313 187 302 318 100],144,4,20777,4.253224155578301,20.0,20.0
44885,4,4885,[313 187 302 318 100],474,5,20782,4.253376995497339,20.0,20.0
44886,4,4886,[313 187 302 318 100],328,5,20787,4.25352977286679,20.0,20.0
44887,4,4887,[313 187 302 318 100],271,5,20792,4.253682487725041,20.0,20.0
44888,4,4888,[313 187 302 318 100],144,4,20796,4.253630599304561,20.0,20.0
44889,4,4889,[271   1 322   9 288],894,2,20798,4.253169734151329,0.0,0.0
44890,4,4890,[313 187 302 318 100],144,4,20802,4.253117971784911,20.0,20.0
44891,4,4891,[313 187 302 318 100],474,5,20807,4.2532706459525755,20.0,20.0
44892,4,4892,[313 187 302 318 100],144,4,20811,4.253218884120171,20.0,20.0
44893,4,4893,[313 187 302 318 100],328,5,20816,4.253371475275848,20.0,20.0
44894,4,4894,[322 222  56  64 143],881,4,20820,4.253319713993871,0.0,0.0
44895,4,4895,[313 187 302 318 100],334,5,20825,4.253472222222222,20.0,20.0
44896,4,4896,[  8 300 483 333 121],533,4,20829,4.253420461507045,20.0,0.0
44897,4,4897,[257 258   4 195  28],92,3,20832,4.253164556962025,0.0,0.0
44898,4,4898,[313 187 302 318 100],474,5,20837,4.253317003470096,20.0,20.0
44899,4,4899,[313 187 302 318 100],474,5,20842,4.253469387755102,20.0,20.0
44900,4,4900,[ 98 265 202 100 269],883,2,20844,4.253009589879617,0.0,40.0
44901,4,4901,[313 187 302 318 100],144,4,20848,4.252957976336189,20.0,20.0
44902,4,4902,[313 187 302 318 100],334,5,20853,4.253110340607791,20.0,20.0
44903,4,4903,[313 187 302 318 100],474,5,20858,4.25326264274062,20.0,20.0
44904,4,4904,[135 197  96 195 385],64,4,20862,4.253211009174312,0.0,0.0
44905,4,4905,[313 187 302 318 100],328,5,20867,4.253363228699552,20.0,20.0
44906,4,4906,[313 187 302 318 100],144,4,20871,4.253311595679642,20.0,20.0
44907,4,4907,[313 187 302 318 100],474,5,20876,4.253463732681337,20.0,20.0
44908,4,4908,[313 187 302 318 100],271,5,20881,4.253615807700142,20.0,20.0
44909,4,4909,[313 187 302 318 100],334,5,20886,4.2537678207739305,20.0,20.0
44910,4,4910,[313 187 302 318 100],144,4,20890,4.25371614742415,20.0,20.0
44911,4,4911,[313 187 302 318 100],328,5,20895,4.253868078175896,20.0,20.0
44912,4,4912,[328  28 173 174 151],537,1,20896,4.253205780582129,0.0,20.0
44913,4,4913,[546 235  12 143 180],339,4,20900,4.253154253154253,20.0,0.0
44914,4,4914,[313 187 302 318 100],334,5,20905,4.253306205493388,20.0,20.0
44915,4,4915,[313 187 302 318 100],144,4,20909,4.253254678600488,20.0,20.0
44916,4,4916,[ 79  15 132 174 168],881,2,20911,4.252796420581656,0.0,20.0
44917,4,4917,[313 187 302 318 100],474,5,20916,4.25294835298902,20.0,20.0
44918,4,4918,[385 143 194 174 515],313,4,20920,4.2528969302703805,0.0,20.0
44919,4,4919,[313 187 302 318 100],271,5,20925,4.253048780487805,20.0,20.0
44920,4,4920,[132  79 357 655 144],13,3,20928,4.25279414753099,20.0,0.0
44921,4,4921,[313 187 302 318 100],474,5,20933,4.252945956928078,20.0,20.0
44922,4,4922,[ 82   8 121 174  22],334,4,20937,4.2528945764777575,0.0,20.0
44923,4,4923,[313 187 302 318 100],144,4,20941,4.2528432168968315,20.0,20.0
44924,4,4924,[176 215 183 210 228],77,2,20943,4.25238578680203,0.0,0.0
44925,4,4925,[405 237 215 127 508],605,2,20945,4.251928542427933,0.0,20.0
44926,4,4926,[ 64  96 273  11  95],234,1,20946,4.251268520397808,0.0,0.0
44927,4,4927,[313 187 302 318 100],271,5,20951,4.251420454545454,20.0,20.0
44928,4,4928,[313 187 302 318 100],328,5,20956,4.251572327044025,20.0,20.0
44929,4,4929,[313 187 302 318 100],334,5,20961,4.251724137931035,20.0,20.0
44930,4,4930,[313 187 302 318 100],537,5,20966,4.251875887243966,20.0,20.0
44931,4,4931,[313 187 302 318 100],144,4,20970,4.251824817518248,20.0,20.0
44932,4,4932,[313 187 302 318 100],13,4,20974,4.251773768497872,20.0,20.0
44933,4,4933,[313 187 302 100 318],537,5,20979,4.251925415484394,20.0,20.0
44934,4,4934,[185 300 313  11 238],234,1,20980,4.251266464032422,0.0,0.0
44935,4,4935,[ 70 175 294 238 187],653,1,20981,4.250607779578607,0.0,0.0
44936,4,4936,[588 196 179   9 215],308,3,20984,4.250354466275065,0.0,0.0
44937,4,4937,[313 118 655 318 191],13,3,20987,4.2501012555690565,20.0,0.0
44938,4,4938,[313 187 302 100 318],13,4,20991,4.250050617533914,20.0,20.0
44939,4,4939,[742 191 194 234  50],804,5,20996,4.250202429149797,0.0,20.0
44940,4,4940,[313 187 302 100 318],334,5,21001,4.250354179315928,20.0,20.0
44941,4,4941,[313 187 302 100 318],334,5,21006,4.250505868069608,20.0,20.0
44942,4,4942,[313 187 302 100 318],537,5,21011,4.250657495448109,20.0,20.0
44943,4,4943,[313 187 302 100 318],144,4,21015,4.250606796116505,20.0,20.0
44944,4,4944,[313 187 302 100 318],144,4,21019,4.250556117290192,20.0,20.0
44945,4,4945,[ 11 111 238 200 318],378,1,21020,4.249898908208653,20.0,0.0
44946,4,4946,[313 187 302 100 318],334,5,21025,4.250050535678189,20.0,20.0
44947,4,4947,[  9  71 588  88  89],815,5,21030,4.250202101859337,0.0,0.0
44948,4,4948,[313 187 302 100 318],474,5,21035,4.2503536067892504,20.0,20.0
44949,4,4949,[313 187 302 100 318],13,4,21039,4.25030303030303,20.0,20.0
44950,4,4950,[313 187 302 100 318],144,4,21043,4.250252474247627,20.0,20.0
44951,4,4951,[313 187 302 100 318],328,5,21048,4.250403877221324,20.0,20.0
44952,4,4952,[313 187 302 100 318],207,4,21052,4.250353321219463,20.0,20.0
44953,4,4953,[313 187 302 100 318],90,5,21057,4.25050464271296,20.0,20.0
44954,4,4954,[313 187 302 100 318],334,5,21062,4.250655903128154,20.0,20.0
44955,4,4955,[ 71 222 180 385  11],387,2,21064,4.250201775625505,0.0,0.0
44956,4,4956,[ 11  22 176 742 265],447,4,21068,4.250151301190236,0.0,0.0
44957,4,4957,[313 187 302 100 318],13,4,21072,4.250100847115773,20.0,20.0
44958,4,4958,[313 187 302 100 318],13,4,21076,4.250050413389796,20.0,20.0
44959,4,4959,[300 181 357 276 235],669,3,21079,4.249798387096774,20.0,0.0
44960,4,4960,[132 176 183 471 405],328,4,21083,4.2497480346704295,0.0,0.0
44961,4,4961,[235 121  97 202 135],13,4,21087,4.249697702539299,0.0,0.0
44962,4,4962,[313 187 302 183 100],13,5,21092,4.2498488817247635,0.0,20.0
44963,4,4963,[313 187 302 183 100],537,4,21096,4.249798549556809,0.0,20.0
44964,4,4964,[183 100 173  98 294],749,3,21099,4.249546827794562,0.0,40.0
44965,4,4965,[313 187 302 100 318],90,5,21104,4.249697946033025,20.0,20.0
44966,4,4966,[313 187 302 100 318],90,5,21109,4.249849003422589,20.0,20.0
44967,4,4967,[143 186 313  69 161],308,2,21111,4.249396135265701,0.0,0.0
44968,4,4968,[271  56 742 111 135],833,3,21114,4.249144697122158,0.0,0.0
44969,4,4969,[483 153 603 200 234],313,3,21117,4.248893360160966,40.0,0.0
44970,4,4970,[127 186  56   7 257],374,3,21120,4.248642124321062,0.0,20.0
44971,4,4971,[173  56 427 515 179],59,5,21125,4.248793242156074,0.0,0.0
44972,4,4972,[313 187 302 100 127],144,4,21129,4.2487432133521015,0.0,40.0
44973,4,4973,[313 187 302 127 100],328,5,21134,4.2488942501005225,0.0,40.0
44974,4,4974,[313 187 302 127 100],144,4,21138,4.248844221105528,0.0,40.0
44975,4,4975,[185  98 202 435  89],650,3,21141,4.248593247588424,0.0,20.0
44976,4,4976,[313 187 302 127 100],328,5,21146,4.248744223427768,0.0,40.0
44977,4,4977,[357 318  82 179 191],311,4,21150,4.248694254720771,40.0,0.0
44978,4,4978,[318 313 197 174 182],378,4,21154,4.248644306085559,20.0,20.0
44979,4,4979,[313 187 302 127 100],207,4,21158,4.24859437751004,0.0,40.0
44980,4,4980,[313 187 302 127 100],334,5,21163,4.2487452318811485,0.0,40.0
44981,4,4981,[  9  97 322 191  69],13,2,21165,4.248293857888398,0.0,0.0
44982,4,4982,[313 187 302 127 100],474,5,21170,4.248444712020871,0.0,40.0
44983,4,4983,[313 187 302 127 100],271,5,21175,4.248595505617978,0.0,40.0
44984,4,4984,[  4 237 196 282  70],207,4,21179,4.248545636910732,0.0,0.0
44985,4,4985,[ 56 185 181  98 187],749,3,21182,4.248295226634577,0.0,20.0
44986,4,4986,[ 95 318  64  97 144],290,3,21185,4.248044916783638,20.0,0.0
44987,4,4987,[216 515 180 237 323],804,5,21190,4.248195669607057,0.0,0.0
44988,4,4988,[ 69 357 127 179  70],406,4,21194,4.248145921026258,20.0,20.0
44989,4,4989,[313 187 302 127 100],90,5,21199,4.248296593186373,0.0,40.0
44990,4,4990,[313 187 302 127 100],474,5,21204,4.248447204968944,0.0,40.0
44991,4,4991,[313 187 302 127 100],144,4,21208,4.248397435897436,0.0,40.0
44992,4,4992,[313 187 302 127 100],271,5,21213,4.248547967154016,0.0,40.0
44993,4,4993,[313 187 302 127 100],90,5,21218,4.248698438125751,0.0,40.0
44994,4,4994,[195 117  22 508 318],144,5,21223,4.248848848848849,20.0,0.0
44995,4,4995,[313 187 302 127 100],144,4,21227,4.248799039231385,0.0,40.0
44996,4,4996,[215 483 185   8 286],881,3,21230,4.248549129477687,20.0,0.0
44997,4,4997,[313 187 302 127 100],144,4,21234,4.248499399759904,0.0,40.0
44998,4,4998,[385 435 483 168 235],643,4,21238,4.2484496899379876,20.0,0.0
44999,4,4999,[313 187 127 302 100],144,4,21242,4.2484,0.0,40.0
45000,4,5000,[313 187 127 302 100],474,5,21247,4.248550289942012,0.0,40.0
45001,4,5001,[313 187 127 302 100],474,5,21252,4.2487005197920835,0.0,40.0
45002,4,5002,[313 187 127 302 100],474,5,21257,4.248850689586249,0.0,40.0
45003,4,5003,[313 187 127 302 100],474,5,21262,4.249000799360512,0.0,40.0
45004,4,5004,[313 187 127 302 100],207,4,21266,4.248951048951049,0.0,40.0
45005,4,5005,[ 82 125 294 132 196],881,2,21268,4.2485017978425885,0.0,0.0
45006,4,5006,[313 187 127 302 100],13,5,21273,4.248651887357699,0.0,40.0
45007,4,5007,[313 187 127 302 100],334,5,21278,4.248801916932908,0.0,40.0
45008,4,5008,[276 202  71 121 357],59,4,21282,4.248752245957277,20.0,0.0
45009,4,5009,[313 187 127 302 100],334,5,21287,4.248902195608783,0.0,40.0
45010,4,5010,[300 568   8 265 196],64,4,21291,4.248852524446218,0.0,0.0
45011,4,5011,[313 187 127 302 100],474,5,21296,4.249002394253791,0.0,40.0
45012,4,5012,[313 187 127 302 100],537,5,21301,4.249152204268901,0.0,40.0
45013,4,5013,[313 187 127 302 100],537,5,21306,4.249301954527324,0.0,40.0
45014,4,5014,[153 678 405 258  69],13,3,21309,4.2490528414755735,0.0,0.0
45015,4,5015,[313 187 127 302 100],13,5,21314,4.249202551834131,0.0,40.0
45016,4,5016,[ 69 282 588 258 405],144,5,21319,4.249352202511461,0.0,0.0
45017,4,5017,[313 187 127 302 100],207,4,21323,4.2493025109605425,0.0,40.0
45018,4,5018,[313 187 127 302 100],90,5,21328,4.249452082088065,0.0,40.0
45019,4,5019,[210 182   9 405 135],13,2,21330,4.249003984063745,0.0,0.0
45020,4,5020,[313 187 127 302 100],271,5,21335,4.249153555068712,0.0,40.0
45021,4,5021,[313 187 127 302 100],144,4,21339,4.249103942652329,0.0,40.0
45022,4,5022,[313 187 127 302 100],334,5,21344,4.249253434202668,0.0,40.0
45023,4,5023,[313 187 127 302 100],90,5,21349,4.249402866242038,0.0,40.0
45024,4,5024,[215  69   8 276 546],13,4,21353,4.2493532338308455,0.0,0.0
45025,4,5025,[313 187 127 302 100],334,5,21358,4.249502586549941,0.0,40.0
45026,4,5026,[ 97 118 181 483 216],188,3,21361,4.249254028247464,20.0,0.0
45027,4,5027,[313 187 127 302 100],271,5,21366,4.249403341288783,0.0,40.0
45028,4,5028,[313 187 127 302 100],207,4,21370,4.249353748260091,0.0,40.0
45029,4,5029,[313 187 127 302 100],328,5,21375,4.249502982107356,0.0,40.0
45030,4,5030,[313 187 127 302 100],13,5,21380,4.249652156628901,0.0,40.0
45031,4,5031,[313 187 127 302 100],90,5,21385,4.249801271860095,0.0,40.0
45032,4,5032,[313 187 127 302 100],474,5,21390,4.249950327836281,0.0,40.0
45033,4,5033,[313 187 127 302 100],271,5,21395,4.250099324592769,0.0,40.0
45034,4,5034,[216 181 228 385 288],533,4,21399,4.25004965243297,0.0,0.0
45035,4,5035,[175 222 176 174  28],234,1,21400,4.249404289118348,0.0,20.0
45036,4,5036,[143  56 496   7  98],882,5,21405,4.249553305539012,0.0,20.0
45037,4,5037,[313 187 127 302 100],474,5,21410,4.2497022628027,0.0,40.0
45038,4,5038,[313 187 127 302 100],271,5,21415,4.2498511609446314,0.0,40.0
45039,4,5039,[313 187 127 302 100],334,5,21420,4.25,0.0,40.0
45040,4,5040,[313 187 127 302 100],271,5,21425,4.2501487800039675,0.0,40.0
45041,4,5041,[216 385 328  97 182],804,5,21430,4.25029750099167,0.0,0.0
45042,4,5042,[313 187 127 302 100],474,5,21435,4.250446162998215,0.0,40.0
45043,4,5043,[ 64 742 161 597 191],804,4,21439,4.250396510705789,0.0,0.0
45044,4,5044,[313 187 127 302 100],328,5,21444,4.250545094152626,0.0,40.0
45045,4,5045,[313 187 127 302 100],537,5,21449,4.250693618707888,0.0,40.0
45046,4,5046,[313 187 127 302 100],271,5,21454,4.250842084406578,0.0,40.0
45047,4,5047,[313 187 127 302 100],474,5,21459,4.250990491283677,0.0,40.0
45048,4,5048,[ 28 100 258 322 210],207,2,21461,4.250544662309368,0.0,20.0
45049,4,5049,[313 187 127 302 100],271,5,21466,4.250693069306931,0.0,40.0
45050,4,5050,[748  88 546 216 172],479,2,21468,4.2502474757473765,0.0,0.0
45051,4,5051,[186 196   1  79  28],653,4,21472,4.2501979414093425,0.0,0.0
45052,4,5052,[313 187 127 302 100],271,5,21477,4.250346328913516,0.0,40.0
45053,4,5053,[313 187 127 302 100],90,5,21482,4.250494657696874,0.0,40.0
45054,4,5054,[176  11 174 276  15],59,5,21487,4.250642927794263,0.0,20.0
45055,4,5055,[ 89 194 427  71 161],313,5,21492,4.250791139240507,0.0,0.0
45056,4,5056,[ 95  82 423 182   7],804,3,21495,4.250543800672335,0.0,0.0
45057,4,5057,[  1 423 471 282  50],653,2,21497,4.2500988533017,0.0,20.0
45058,4,5058,[210  56 228 204 168],738,4,21501,4.250049416880806,0.0,0.0
45059,4,5059,[313 187 127 302 100],328,5,21506,4.250197628458498,0.0,40.0
45060,4,5060,[313 187 127 302 100],271,5,21511,4.250345781466113,0.0,40.0
45061,4,5061,[204 186   4  96 182],398,4,21515,4.250296325563019,0.0,0.0
45062,4,5062,[289 322 135 143 194],537,1,21516,4.249654355125419,0.0,0.0
45063,4,5063,[313 187 127 302 100],334,5,21521,4.249802527646129,0.0,40.0
45064,4,5064,[ 88 183 222 742 180],290,3,21524,4.2495557749259625,0.0,0.0
45065,4,5065,[ 82 234 111 282 175],92,3,21527,4.249309119621003,0.0,0.0
45066,4,5066,[568  22 435 423 180],339,3,21530,4.249062561673574,0.0,0.0
45067,4,5067,[313 187 127 302 100],334,5,21535,4.249210734017364,0.0,40.0
45068,4,5068,[313 187 127 302 100],90,5,21540,4.249358847898994,0.0,40.0
45069,4,5069,[313 187 127 302 100],13,5,21545,4.2495069033530575,0.0,40.0
45070,4,5070,[313 187 127 302 100],271,5,21550,4.24965490041412,0.0,40.0
45071,4,5071,[179 135 210 168 496],7,5,21555,4.249802839116719,0.0,0.0
45072,4,5072,[313 187 127 302 100],90,5,21560,4.249950719495367,0.0,40.0
45073,4,5073,[313 187 127 302 100],207,4,21564,4.249901458415452,0.0,40.0
45074,4,5074,[132  98 100  97  79],406,4,21568,4.249852216748769,0.0,40.0
45075,4,5075,[313 187 127 302 100],271,5,21573,4.25,0.0,40.0
45076,4,5076,[313 187 127 302 100],474,5,21578,4.250147725034469,0.0,40.0
45077,4,5077,[405 118 183 200 180],881,4,21582,4.25009846396219,0.0,0.0
45078,4,5078,[ 25 175 234 748 200],313,2,21584,4.249655443985036,0.0,0.0
45079,4,5079,[405 313 234 176 132],189,3,21587,4.249409448818898,0.0,0.0
45080,4,5080,[313 187 127 302 100],328,5,21592,4.249557173784688,0.0,40.0
45081,4,5081,[313 187 127 302 100],144,4,21596,4.249508067689886,0.0,40.0
45082,4,5082,[313 187 127 302 100],13,5,21601,4.249655715128861,0.0,40.0
45083,4,5083,[313 187 127 302 100],537,5,21606,4.249803304484658,0.0,40.0
45084,4,5084,[127 238 508  15  70],184,4,21610,4.249754178957719,0.0,20.0
45085,4,5085,[313 187 127 302 100],271,5,21615,4.249901690916241,0.0,40.0
45086,4,5086,[273  11 568 234 172],308,3,21618,4.249655985846275,0.0,0.0
45087,4,5087,[313 187 127 302 100],537,5,21623,4.249803459119497,0.0,40.0
45088,4,5088,[313 187 127 302 100],144,4,21627,4.24975437217528,0.0,40.0
45089,4,5089,[ 96 238 271  82  25],13,1,21628,4.249115913555992,0.0,0.0
45090,4,5090,[181 435 405 153 269],85,2,21630,4.248674130819093,0.0,0.0
45091,4,5091,[ 98 194  97 174  64],233,5,21635,4.248821681068343,0.0,40.0
45092,4,5092,[313 187 127 302 100],13,5,21640,4.248969173375221,0.0,40.0
45093,4,5093,[172  97 568 173 357],659,4,21644,4.248920298390263,20.0,0.0
45094,4,5094,[385  11  70 405 132],13,1,21645,4.248282630029441,0.0,0.0
45095,4,5095,[471 678 237 135 435],454,1,21646,4.2476452119309265,0.0,0.0
45096,4,5096,[313 187 127 302 100],90,5,21651,4.247792819305474,0.0,40.0
45097,4,5097,[313 187 127 302 100],144,4,21655,4.247744213417026,0.0,40.0
45098,4,5098,[238  50   1  89 182],6,5,21660,4.247891743479114,0.0,20.0
45099,4,5099,[313 187 127 302 100],144,4,21664,4.247843137254902,0.0,40.0
45100,4,5100,[186 234  70 180  97],312,4,21668,4.247794550088218,0.0,0.0
45101,4,5101,[313 187 127 302 100],537,5,21673,4.247941983535869,0.0,40.0
45102,4,5102,[313 187 127 302 100],144,4,21677,4.247893396041544,0.0,40.0
45103,4,5103,[117 228 265 678  89],648,3,21680,4.247648902821316,0.0,0.0
45104,4,5104,[313 187 127 302 100],13,5,21685,4.247796278158668,0.0,40.0
45105,4,5105,[313 187 127 302 100],474,5,21690,4.247943595769683,0.0,40.0
45106,4,5106,[204 235   1 135 357],804,4,21694,4.247895046015273,20.0,0.0
45107,4,5107,[ 98 515 333 385 202],313,5,21699,4.24804228660924,0.0,20.0
45108,4,5108,[286 471   8 405 588],13,2,21701,4.247602270503034,0.0,0.0
45109,4,5109,[313 187 127 302 100],13,5,21706,4.247749510763209,0.0,40.0
45110,4,5110,[313 187 127 302 100],328,5,21711,4.247896693406378,0.0,40.0
45111,4,5111,[168 357 215 195  22],892,5,21716,4.248043818466353,20.0,0.0
45112,4,5112,[313 187 127 302 100],271,5,21721,4.248190885976921,0.0,40.0
45113,4,5113,[ 69 313 173 202 228],738,5,21726,4.248337895971842,0.0,0.0
45114,4,5114,[313 187 127 302 100],328,5,21731,4.248484848484848,0.0,40.0
45115,4,5115,[313 187 127 302 100],334,5,21736,4.248631743549648,0.0,40.0
45116,4,5116,[258 323 196 328 172],13,3,21739,4.248387727183897,0.0,0.0
45117,4,5117,[313 187 127 302 100],537,5,21744,4.248534583821805,0.0,40.0
45118,4,5118,[313 187 127 302 100],328,5,21749,4.2486813830826335,0.0,40.0
45119,4,5119,[318  98 176   9  82],7,3,21752,4.2484375,20.0,20.0
45120,4,5120,[ 11 196 568 237 496],804,5,21757,4.248584260886545,0.0,0.0
45121,4,5121,[313 187 127 302 100],13,5,21762,4.248730964467005,0.0,40.0
45122,4,5122,[313 187 127 302 100],474,5,21767,4.248877610774937,0.0,40.0
45123,4,5123,[161  70 175 423 186],13,4,21771,4.248829039812646,0.0,0.0
45124,4,5124,[313 187 127 302 100],474,5,21776,4.248975609756098,0.0,40.0
45125,4,5125,[313 187 127 302 100],90,5,21781,4.249122122512681,0.0,40.0
45126,4,5126,[313 187 127 302 100],144,4,21785,4.249073532280086,0.0,40.0
45127,4,5127,[ 79  70 435 216 357],194,2,21787,4.248634945397816,20.0,0.0
45128,4,5128,[175  15 269 423 435],650,3,21790,4.248391499317606,0.0,0.0
45129,4,5129,[135 286   7 182 195],7,5,21795,4.248538011695906,0.0,0.0
45130,4,5130,[313 187 127 302 100],207,4,21799,4.248489573182615,0.0,40.0
45131,4,5131,[313 187 127 302 100],271,5,21804,4.248636009353079,0.0,40.0
45132,4,5132,[313 187 127 302 100],207,4,21808,4.248587570621469,0.0,40.0
45133,4,5133,[313 187 127 302 100],537,5,21813,4.248733930658356,0.0,40.0
45134,4,5134,[318 403 168 176 508],13,1,21814,4.248101265822785,20.0,0.0
45135,4,5135,[313 187 127 302 100],90,5,21819,4.2482476635514015,0.0,40.0
45136,4,5136,[275 313 174  71 328],85,3,21822,4.248004671987541,0.0,20.0
45137,4,5137,[313 187 127 302 100],334,5,21827,4.248151031529778,0.0,40.0
45138,4,5138,[313 187 127 302 100],334,5,21832,4.248297334111695,0.0,40.0
45139,4,5139,[313 187 127 302 100],271,5,21837,4.248443579766537,0.0,40.0
45140,4,5140,[294 144 172  71 265],374,3,21840,4.2482007391558065,0.0,0.0
45141,4,5141,[313 187 127 302 100],328,5,21845,4.248346946713341,0.0,40.0
45142,4,5142,[313 187 127 302 100],207,4,21849,4.248298658370601,0.0,40.0
45143,4,5143,[313 187 127 302 100],328,5,21854,4.248444790046657,0.0,40.0
45144,4,5144,[313 187 127 302 100],271,5,21859,4.248590864917396,0.0,40.0
45145,4,5145,[313 187 127 302 100],271,5,21864,4.248736883015935,0.0,40.0
45146,4,5146,[313 187 127 302 100],207,4,21868,4.248688556440645,0.0,40.0
45147,4,5147,[313 187 127 302 100],271,5,21873,4.248834498834499,0.0,40.0
45148,4,5148,[313 187 127 302 100],90,5,21878,4.248980384540688,0.0,40.0
45149,4,5149,[121 168 195 185  70],210,5,21883,4.249126213592233,0.0,0.0
45150,4,5150,[183 168 257 228 204],749,4,21887,4.249077848961367,0.0,0.0
45151,4,5151,[313 187 127 302 100],474,5,21892,4.249223602484472,0.0,40.0
45152,4,5152,[313 187 127 302 100],271,5,21897,4.249369299437221,0.0,40.0
45153,4,5153,[313 187 127 302 100],90,5,21902,4.249514939852542,0.0,40.0
45154,4,5154,[313 187 127 302 100],207,4,21906,4.249466537342386,0.0,40.0
45155,4,5155,[313 187 127 302 100],271,5,21911,4.249612102404965,0.0,40.0
45156,4,5156,[496 191 323  56   4],648,3,21914,4.2493697886368045,0.0,0.0
45157,4,5157,[313 187 127 302 100],271,5,21919,4.249515316013959,0.0,40.0
45158,4,5158,[313 187 127 302 100],144,4,21923,4.249466950959488,0.0,40.0
45159,4,5159,[313 187 127 302 100],13,5,21928,4.249612403100775,0.0,40.0
45160,4,5160,[132 144 215 323  50],650,2,21930,4.249176516179035,0.0,20.0
45161,4,5161,[211 197   8 237 313],271,5,21935,4.249321968229369,0.0,0.0
45162,4,5162,[313 187 127 302 100],207,4,21939,4.249273678094132,0.0,40.0
45163,4,5163,[313 187 127 302 100],537,5,21944,4.249419054996127,0.0,40.0
45164,4,5164,[313 187 127 302 100],328,5,21949,4.249564375605034,0.0,40.0
45165,4,5165,[313 187 127 302 100],13,5,21954,4.249709639953543,0.0,40.0
45166,4,5166,[313 187 127 302 100],328,5,21959,4.2498548480743175,0.0,40.0
45167,4,5167,[313 187 127 302 100],207,4,21963,4.249806501547988,0.0,40.0
45168,4,5168,[313 187 127 302 100],144,4,21967,4.249758173727994,0.0,40.0
45169,4,5169,[313 187 127 302 100],207,4,21971,4.249709864603481,0.0,40.0
45170,4,5170,[313 187 127 302 100],271,5,21976,4.24985496035583,0.0,40.0
45171,4,5171,[210 197 288 200  50],843,1,21977,4.249226604795051,0.0,20.0
45172,4,5172,[228 211 175  15 323],59,5,21982,4.2493717378697085,0.0,0.0
45173,4,5173,[313 187 127 302 100],328,5,21987,4.249516814843448,0.0,40.0
45174,4,5174,[313 187 127 302 100],13,5,21992,4.2496618357487925,0.0,40.0
45175,4,5175,[313 187 127 302 100],13,5,21997,4.249806800618238,0.0,40.0
45176,4,5176,[313 187 127 302 100],207,4,22001,4.249758547421287,0.0,40.0
45177,4,5177,[313 187 127 302 100],474,5,22006,4.249903437620703,0.0,40.0
45178,4,5178,[313 187 127 302 100],144,4,22010,4.249855184398532,0.0,40.0
45179,4,5179,[313 187 127 302 100],90,5,22015,4.25,0.0,40.0
45180,4,5180,[313 187 127 302 100],207,4,22019,4.249951746767033,0.0,40.0
45181,4,5181,[313 187 127 302 100],144,4,22023,4.249903512157468,0.0,40.0
45182,4,5182,[186 180  64  79 265],271,5,22028,4.250048234613159,0.0,0.0
45183,4,5183,[ 69 286 185  22  89],339,5,22033,4.250192901234568,0.0,0.0
45184,4,5184,[313 187 127 302 100],328,5,22038,4.250337512054002,0.0,40.0
45185,4,5185,[313 187 127 302 100],328,5,22043,4.250482067103741,0.0,40.0
45186,4,5186,[173 603 403 196  70],59,4,22047,4.250433776749566,20.0,0.0
45187,4,5187,[313 187 127 302 100],474,5,22052,4.250578257517348,0.0,40.0
45188,4,5188,[245 323 200 276  25],455,2,22054,4.250144536519561,0.0,0.0
45189,4,5189,[313 187 127 302 100],334,5,22059,4.25028901734104,0.0,40.0
45190,4,5190,[313 187 127 302 100],328,5,22064,4.250433442496629,0.0,40.0
45191,4,5191,[ 82 111 568 423 385],42,4,22068,4.250385208012327,0.0,0.0
45192,4,5192,[313 187 127 302 100],328,5,22073,4.25052955902176,0.0,40.0
45193,4,5193,[313 187 127 302 100],207,4,22077,4.250481324605314,0.0,40.0
45194,4,5194,[313 187 127 302 100],328,5,22082,4.250625601539943,0.0,40.0
45195,4,5195,[313 187 127 302 100],334,5,22087,4.250769822940724,0.0,40.0
45196,4,5196,[678 322 333 435 210],263,1,22088,4.250144314027324,0.0,0.0
45197,4,5197,[  7  98 222 100  64],328,4,22092,4.250096190842632,0.0,40.0
45198,4,5198,[323 181  56 588 427],537,2,22094,4.249663396807079,0.0,0.0
45199,4,5199,[313 187 127 302 100],474,5,22099,4.249807692307693,0.0,40.0
45200,4,5200,[ 64 204 328 275 313],533,5,22104,4.249951932320707,0.0,0.0
45201,4,5201,[313 187 127 302 100],474,5,22109,4.250096116878124,0.0,40.0
45202,4,5202,[153  96 179   7 300],653,3,22112,4.249855852392851,0.0,0.0
45203,4,5203,[186 423 273   9 195],59,4,22116,4.249807840122982,0.0,0.0
45204,4,5204,[515 196 195 179 238],92,5,22121,4.2499519692603265,0.0,0.0
45205,4,5205,[313 187 127 302 100],474,5,22126,4.250096043027276,0.0,40.0
45206,4,5206,[ 89 135 121  69 174],899,4,22130,4.250048012291146,0.0,20.0
45207,4,5207,[181  82 568 288  88],374,3,22133,4.249807987711214,0.0,0.0
45208,4,5208,[313 187 127 302 100],474,5,22138,4.2499520061432134,0.0,40.0
45209,4,5209,[313 187 127 302 100],90,5,22143,4.250095969289827,0.0,40.0
45210,4,5210,[313 187 127 302 100],13,5,22148,4.250239877182882,0.0,40.0
45211,4,5211,[313 187 127 302 100],13,5,22153,4.250383729854183,0.0,40.0
45212,4,5212,[313 187 127 302 100],537,5,22158,4.250527527335508,0.0,40.0
45213,4,5213,[179 222 186 185  25],13,1,22159,4.249904104334484,0.0,0.0
45214,4,5214,[313 187 127 302 100],328,5,22164,4.250047938638542,0.0,40.0
45215,4,5215,[313 187 127 302 100],207,4,22168,4.25,0.0,40.0
45216,4,5216,[ 95  82 200 282 435],378,4,22172,4.249952079739314,0.0,0.0
45217,4,5217,[313 187 127 302 100],144,4,22176,4.249904177845918,0.0,40.0
45218,4,5218,[194  69 222 301 273],666,1,22177,4.249281471546273,0.0,0.0
45219,4,5219,[235 202 496  82 435],295,5,22182,4.249425287356321,0.0,0.0
45220,4,5220,[313 187 127 302 100],474,5,22187,4.249569048075082,0.0,40.0
45221,4,5221,[313 187 127 302 100],13,5,22192,4.249712753734202,0.0,40.0
45222,4,5222,[ 98 234 328   4  22],749,5,22197,4.249856404365307,0.0,20.0
45223,4,5223,[202 423 323 195 294],374,0,22197,4.249042879019908,0.0,0.0
45224,4,5224,[313 187 127 302 100],207,4,22201,4.248995215311004,0.0,40.0
45225,4,5225,[313 187 127 302 100],334,5,22206,4.2491389207807115,0.0,40.0
45226,4,5226,[313 187 127 302 100],537,5,22211,4.249282571264588,0.0,40.0
45227,4,5227,[228   1 276  82 191],13,2,22213,4.2488523335883706,0.0,0.0
45228,4,5228,[313 187 127 302 100],328,5,22218,4.248995983935743,0.0,40.0
45229,4,5229,[313 187 127 302 100],13,5,22223,4.2491395793499045,0.0,40.0
45230,4,5230,[313 187 127 302 100],334,5,22228,4.249283119862359,0.0,40.0
45231,4,5231,[313 187 127 302 100],474,5,22233,4.2494266055045875,0.0,40.0
45232,4,5232,[313 187 127 302 100],271,5,22238,4.249570036308045,0.0,40.0
45233,4,5233,[313 187 127 302 100],13,5,22243,4.249713412304165,0.0,40.0
45234,4,5234,[172  88   8  98  15],60,4,22247,4.249665711556829,0.0,20.0
45235,4,5235,[313 187 127 302 100],144,4,22251,4.249618029029794,0.0,40.0
45236,4,5236,[313 187 127 302 100],13,5,22256,4.249761313729234,0.0,40.0
45237,4,5237,[313 187 127 302 100],207,4,22260,4.24971363115693,0.0,40.0
45238,4,5238,[313 187 127 302 100],144,4,22264,4.249665966787555,0.0,40.0
45239,4,5239,[313 187 127 302 100],13,5,22269,4.249809160305343,0.0,40.0
45240,4,5240,[313 187 127 302 100],90,5,22274,4.2499522991795455,0.0,40.0
45241,4,5241,[313 187 127 302 100],144,4,22278,4.249904616558565,0.0,40.0
45242,4,5242,[313 187 127 302 100],13,5,22283,4.2500476826244515,0.0,40.0
45243,4,5243,[313 187 127 302 100],334,5,22288,4.250190694126621,0.0,40.0
45244,4,5244,[546 117 151 118 204],788,1,22289,4.249571020019066,0.0,0.0
45245,4,5245,[313 187 127 302 100],90,5,22294,4.249714067861228,0.0,40.0
45246,4,5246,[294 161 144 385 118],479,1,22295,4.249094720792834,0.0,0.0
45247,4,5247,[313 187 127 302 100],328,5,22300,4.249237804878049,0.0,40.0
45248,4,5248,[313 187 127 302 100],13,5,22305,4.249380834444656,0.0,40.0
45249,4,5249,[313 187 127 302 100],537,5,22310,4.24952380952381,0.0,40.0
45250,4,5250,[313 187 127 302 100],474,5,22315,4.249666730146639,0.0,40.0
45251,4,5251,[313 187 127 302 100],13,5,22320,4.2498095963442495,0.0,40.0
45252,4,5252,[313 187 127 302 100],334,5,22325,4.249952408147725,0.0,40.0
45253,4,5253,[328  69   4 288 183],378,1,22326,4.2493338408831365,0.0,0.0
45254,4,5254,[313 187 127 302 100],271,5,22331,4.249476688867745,0.0,40.0
45255,4,5255,[313 187 127 302 100],207,4,22335,4.2494292237442925,0.0,40.0
45256,4,5256,[313 222  64 176  88],738,4,22339,4.249381776678714,0.0,0.0
45257,4,5257,[  1 187 197 258 204],650,2,22341,4.2489539748953975,0.0,0.0
45258,4,5258,[222 427  15 121 288],882,4,22345,4.248906636242632,0.0,0.0
45259,4,5259,[313 187 127 302 100],271,5,22350,4.249049429657795,0.0,40.0
45260,4,5260,[234 183  89 215 568],804,5,22355,4.249192168789204,0.0,0.0
45261,4,5261,[ 28 174 216 427  79],271,5,22360,4.249334853667807,0.0,20.0
45262,4,5262,[322 117   7 132  96],308,2,22362,4.248907467224017,0.0,0.0
45263,4,5263,[ 89 588 197 269 183],650,4,22366,4.24886018237082,0.0,0.0
45264,4,5264,[313 187 127 302 100],13,5,22371,4.249002849002849,0.0,40.0
45265,4,5265,[313 187 127 302 100],271,5,22376,4.249145461450817,0.0,40.0
45266,4,5266,[216 588 268 174 496],234,1,22377,4.248528574140877,0.0,20.0
45267,4,5267,[313 187 127 302 100],328,5,22382,4.2486712224753225,0.0,40.0
45268,4,5268,[313 187 127 302 100],474,5,22387,4.248813816663503,0.0,40.0
45269,4,5269,[313 187 127 302 100],537,5,22392,4.248956356736243,0.0,40.0
45270,4,5270,[313 187 127 302 100],207,4,22396,4.2489091254031495,0.0,40.0
45271,4,5271,[313 187 127 302 100],537,5,22401,4.249051593323217,0.0,40.0
45272,4,5272,[313 187 127 302 100],537,5,22406,4.2491940072065235,0.0,40.0
45273,4,5273,[313 187 127 302 100],207,4,22410,4.249146757679181,0.0,40.0
45274,4,5274,[204 172 357 588 202],537,1,22411,4.248530805687204,20.0,0.0
45275,4,5275,[313 187 127 302 183],669,4,22415,4.248483699772555,0.0,20.0
45276,4,5276,[245 182 678 385 222],804,5,22420,4.248626113321963,0.0,0.0
45277,4,5277,[ 50   1 118 215 216],194,1,22421,4.248010610079576,0.0,20.0
45278,4,5278,[508  96 197 655 187],387,3,22424,4.247774199659026,0.0,0.0
45279,4,5279,[161 127 100 286 265],474,5,22429,4.247916666666667,0.0,40.0
45280,4,5280,[313 187 127 302 100],328,5,22434,4.24805907971975,0.0,40.0
45281,4,5281,[286 385 183 204 222],479,3,22437,4.247822794396062,0.0,0.0
45282,4,5282,[313 187 127 302 100],144,4,22441,4.2477758849138745,0.0,40.0
45283,4,5283,[313 187 127 302 100],328,5,22446,4.247918243754731,0.0,40.0
45284,4,5284,[313 187 127 302 100],328,5,22451,4.2480605487228,0.0,40.0
45285,4,5285,[313 187 127 302 100],90,5,22456,4.248202799848657,0.0,40.0
45286,4,5286,[313 187 127 302 100],271,5,22461,4.248344997162852,0.0,40.0
45287,4,5287,[ 88 204 288 405 215],92,2,22463,4.247919818456883,0.0,0.0
45288,4,5288,[313 187 127 302 100],207,4,22467,4.247872943845717,0.0,40.0
45289,4,5289,[313 187 127 302 100],328,5,22472,4.248015122873346,0.0,40.0
45290,4,5290,[313 187 127 302 100],144,4,22476,4.247968247968248,0.0,40.0
45291,4,5291,[313 187 127 302 100],271,5,22481,4.248110355253212,0.0,40.0
45292,4,5292,[655 117 483 191 471],308,2,22483,4.24768562252031,20.0,0.0
45293,4,5293,[313 187 127 302 100],537,5,22488,4.2478277295051,0.0,40.0
45294,4,5294,[313 187 127 302 100],334,5,22493,4.247969782813976,0.0,40.0
45295,4,5295,[313 187 127 302 100],90,5,22498,4.248111782477341,0.0,40.0
45296,4,5296,[313 187 127 302 100],207,4,22502,4.248064942420238,0.0,40.0
45297,4,5297,[313 187 127 302 100],13,5,22507,4.248206870517176,0.0,40.0
45298,4,5298,[313 187 127 302 100],474,5,22512,4.248348745046235,0.0,40.0
45299,4,5299,[313 187 127 302 100],13,5,22517,4.248490566037736,0.0,40.0
45300,4,5300,[313 187 127 302 100],474,5,22522,4.248632333521977,0.0,40.0
45301,4,5301,[117 181 204 135  95],387,2,22524,4.248208223311957,0.0,0.0
45302,4,5302,[313 187 127 302 100],207,4,22528,4.248161418065246,0.0,40.0
45303,4,5303,[313 187 127 302 100],90,5,22533,4.248303167420814,0.0,40.0
45304,4,5304,[313 187 127 302 100],13,5,22538,4.248444863336475,0.0,40.0
45305,4,5305,[313 187 127 302 100],334,5,22543,4.248586505842442,0.0,40.0
45306,4,5306,[313 187 127 302 100],144,4,22547,4.248539664593933,0.0,40.0
45307,4,5307,[313 187 127 302 100],144,4,22551,4.248492840994725,0.0,40.0
45308,4,5308,[313 187 127 302 100],271,5,22556,4.248634394424562,0.0,40.0
45309,4,5309,[748  11 313 237 185],13,3,22559,4.248399246704332,0.0,0.0
45310,4,5310,[313 187 127 302 100],13,5,22564,4.248540764451139,0.0,40.0
45311,4,5311,[313 187 127 302 100],13,5,22569,4.248682228915663,0.0,40.0
45312,4,5312,[313 187 127 302 100],207,4,22573,4.248635422548466,0.0,40.0
45313,4,5313,[313 187 127 302 100],474,5,22578,4.248776815957847,0.0,40.0
45314,4,5314,[313 187 127 302 100],90,5,22583,4.248918156161806,0.0,40.0
45315,4,5315,[313 187 127 302 100],474,5,22588,4.249059443190369,0.0,40.0
45316,4,5316,[313 187 127 302 100],537,5,22593,4.249200677073538,0.0,40.0
45317,4,5317,[313 187 127 302 100],13,5,22598,4.249341857841293,0.0,40.0
45318,4,5318,[313 187 127 302 100],271,5,22603,4.249482985523595,0.0,40.0
45319,4,5319,[313 187 127 302 100],334,5,22608,4.249624060150376,0.0,40.0
45320,4,5320,[313 187 127 302 100],474,5,22613,4.24976508175155,0.0,40.0
45321,4,5321,[313 187 127 302 100],271,5,22618,4.2499060503570085,0.0,40.0
45322,4,5322,[313 187 127 302 100],13,5,22623,4.250046965996618,0.0,40.0
45323,4,5323,[ 69  12 200 302  88],343,4,22627,4.25,20.0,0.0
45324,4,5324,[313 187 127 302 100],334,5,22632,4.250140845070423,0.0,40.0
45325,4,5325,[196 257 385 357 238],666,2,22634,4.24971836274878,20.0,0.0
45326,4,5326,[ 22 125 405 228 257],533,4,22638,4.249671484888305,0.0,0.0
45327,4,5327,[125 357  82 423  97],263,5,22643,4.249812312312312,20.0,0.0
45328,4,5328,[313 187 127 302 100],474,5,22648,4.249953086883092,0.0,40.0
45329,4,5329,[234 268 222  82 423],234,2,22650,4.24953095684803,0.0,0.0
45330,4,5330,[313 187 127 302 100],144,4,22654,4.249484149315325,0.0,40.0
45331,4,5331,[121 196 197 173 143],749,4,22658,4.249437359339835,0.0,0.0
45332,4,5332,[168 200 118 603 151],738,2,22660,4.249015563472717,20.0,0.0
45333,4,5333,[313 187 127 302 100],271,5,22665,4.249156355455568,0.0,40.0
45334,4,5334,[215 191  96  25 568],92,3,22668,4.24892221180881,0.0,0.0
45335,4,5335,[313 187 127 302 100],13,5,22673,4.249062968515742,0.0,40.0
45336,4,5336,[313 187 127 302 100],13,5,22678,4.249203672475173,0.0,40.0
45337,4,5337,[313 187 127 302 100],90,5,22683,4.249344323716747,0.0,40.0
45338,4,5338,[313 187 127 302 100],144,4,22687,4.2492976212773925,0.0,40.0
45339,4,5339,[265 200   4 186 151],650,3,22690,4.249063670411985,0.0,0.0
45340,4,5340,[313 187 127 302 100],207,4,22694,4.249017038007864,0.0,40.0
45341,4,5341,[237 235 187 215 275],537,2,22696,4.248596031448896,0.0,0.0
45342,4,5342,[215 405 294 175 143],479,2,22698,4.248175182481752,0.0,0.0
45343,4,5343,[313 187 127 302 100],334,5,22703,4.248315868263473,0.0,40.0
45344,4,5344,[235 435 180  15  82],901,3,22706,4.248082319925164,0.0,0.0
45345,4,5345,[313 187 127 302 100],13,5,22711,4.248222970445193,0.0,40.0
45346,4,5346,[238 276 186  28 322],334,2,22713,4.247802506078175,0.0,0.0
45347,4,5347,[313 187 127 302 100],271,5,22718,4.24794315632012,0.0,40.0
45348,4,5348,[313 187 127 302 100],474,5,22723,4.248083753972705,0.0,40.0
45349,4,5349,[234 144 153 168 132],95,3,22726,4.2478504672897195,0.0,0.0
45350,4,5350,[313 187 127 302 100],334,5,22731,4.247991029714072,0.0,40.0
45351,4,5351,[313 187 127 302 100],328,5,22736,4.24813153961136,0.0,40.0
45352,4,5352,[216   4 273 403 435],87,3,22739,4.2478983747431345,0.0,0.0
45353,4,5353,[435 588 182 245  22],454,1,22740,4.247291744490101,0.0,0.0
45354,4,5354,[313 187 127 302 100],334,5,22745,4.247432306255836,0.0,40.0
45355,4,5355,[313 187 127 302 100],328,5,22750,4.247572815533981,0.0,40.0
45356,4,5356,[313 187 127 302 100],474,5,22755,4.24771327235393,0.0,40.0
45357,4,5357,[313 187 127 302 100],13,5,22760,4.247853676745054,0.0,40.0
45358,4,5358,[ 70 117 655 301 496],234,1,22761,4.247247620824781,0.0,0.0
45359,4,5359,[313 187 127 302 100],334,5,22766,4.247388059701493,0.0,40.0
45360,4,5360,[176 294 234 186 322],311,4,22770,4.247341913822048,0.0,0.0
45361,4,5361,[313 187 127 302 100],144,4,22774,4.247295785154793,0.0,40.0
45362,4,5362,[313 187 127 302 100],328,5,22779,4.24743613649077,0.0,40.0
45363,4,5363,[313 187 127 302 100],207,4,22783,4.247390007457121,0.0,40.0
45364,4,5364,[313 187 127 302 100],144,4,22787,4.247343895619758,0.0,40.0
45365,4,5365,[471 200 655 191  12],311,5,22792,4.247484159522922,20.0,0.0
45366,4,5366,[313 187 127 302 100],144,4,22796,4.247438047326253,0.0,40.0
45367,4,5367,[471 265 125 357 318],194,3,22799,4.24720566318927,40.0,0.0
45368,4,5368,[313 187 127 302 100],537,5,22804,4.247345874464519,0.0,40.0
45369,4,5369,[313 187 127 302 100],271,5,22809,4.247486033519553,0.0,40.0
45370,4,5370,[385 318 151 132  12],788,3,22812,4.247253770247626,40.0,0.0
45371,4,5371,[313 187 127 302 100],271,5,22817,4.247393894266567,0.0,40.0
45372,4,5372,[313 187 127 302 100],144,4,22821,4.247347850362925,0.0,40.0
45373,4,5373,[313 187 127 302 100],328,5,22826,4.24748790472646,0.0,40.0
45374,4,5374,[313 187 127 302 100],474,5,22831,4.247627906976744,0.0,40.0
45375,4,5375,[313 187 127 302 100],271,5,22836,4.247767857142857,0.0,40.0
45376,4,5376,[313 187 127 302 100],207,4,22840,4.247721777943091,0.0,40.0
45377,4,5377,[  4 143 427  88 179],379,5,22845,4.247861658609148,0.0,0.0
45378,4,5378,[313 187 127 302 100],537,5,22850,4.248001487265291,0.0,40.0
45379,4,5379,[313 187 127 302 100],13,5,22855,4.2481412639405205,0.0,40.0
45380,4,5380,[313 187 127 302 100],474,5,22860,4.248280988663817,0.0,40.0
45381,4,5381,[313 187 127 302 100],13,5,22865,4.24842066146414,0.0,40.0
45382,4,5382,[313 187 127 302 100],328,5,22870,4.248560282370425,0.0,40.0
45383,4,5383,[313 187 127 302 100],474,5,22875,4.2486998514115895,0.0,40.0
45384,4,5384,[313 187 127 302 100],144,4,22879,4.248653667595172,0.0,40.0
45385,4,5385,[313 187 127 302 100],334,5,22884,4.248793167471222,0.0,40.0
45386,4,5386,[185 143 237 194 151],308,4,22888,4.248746983478745,0.0,0.0
45387,4,5387,[313 187 127 302 100],537,5,22893,4.248886414253898,0.0,40.0
45388,4,5388,[313 187 127 302 100],144,4,22897,4.248840230098349,0.0,40.0
45389,4,5389,[288 237  69 234  95],378,3,22900,4.24860853432282,0.0,0.0
45390,4,5390,[313 187 127 302 100],90,5,22905,4.248747913188648,0.0,40.0
45391,4,5391,[405 322 235  88 333],313,1,22906,4.248145400593472,0.0,0.0
45392,4,5392,[ 96 179 175  89   7],379,5,22911,4.248284813647321,0.0,0.0
45393,4,5393,[313 187 127 302 100],207,4,22915,4.248238783833889,0.0,40.0
45394,4,5394,[313 187 127 302 100],90,5,22920,4.2483781278962,0.0,40.0
45395,4,5395,[313 187 127 302 100],207,4,22924,4.24833209785026,0.0,40.0
45396,4,5396,[313 187 127 302 100],334,5,22929,4.248471372984992,0.0,40.0
45397,4,5397,[313 187 127 302 100],537,5,22934,4.248610596517229,0.0,40.0
45398,4,5398,[313 187 127 302 100],334,5,22939,4.248749768475643,0.0,40.0
45399,4,5399,[313 187 127 302 100],328,5,22944,4.248888888888889,0.0,40.0
45400,4,5400,[313 181 127 288 655],334,4,22948,4.248842806887613,0.0,20.0
45401,4,5401,[313 187 127 302 100],13,5,22953,4.248981858570899,0.0,40.0
45402,4,5402,[313 187 127 302 100],474,5,22958,4.249120858782158,0.0,40.0
45403,4,5403,[313 187 127 302 100],144,4,22962,4.249074759437454,0.0,40.0
45404,4,5404,[132 313 202 168 258],234,2,22964,4.248658649398705,0.0,0.0
45405,4,5405,[313 187 127 302 100],13,5,22969,4.248797632260452,0.0,40.0
45406,4,5406,[313 187 127 302 100],13,5,22974,4.248936563713705,0.0,40.0
45407,4,5407,[313 187 127 302 100],271,5,22979,4.249075443786983,0.0,40.0
45408,4,5408,[ 79  96 215 181 180],7,4,22983,4.249029395452024,0.0,0.0
45409,4,5409,[  1  79 210 748 405],488,3,22986,4.248798521256932,0.0,0.0
45410,4,5410,[313 187 127 302 100],328,5,22991,4.248937349842913,0.0,40.0
45411,4,5411,[313 187 127 302 100],207,4,22995,4.248891352549889,0.0,40.0
45412,4,5412,[313 187 127 302 100],328,5,23000,4.249030112691668,0.0,40.0
45413,4,5413,[  7 196 288 132 176],64,5,23005,4.249168821573698,0.0,0.0
45414,4,5414,[313 187 127 302 100],207,4,23009,4.249122807017544,0.0,40.0
45415,4,5415,[313 187 127 302 100],537,5,23014,4.249261447562777,0.0,40.0
45416,4,5416,[282 161  96  79 118],881,3,23017,4.249030828872069,0.0,0.0
45417,4,5417,[300  56 121  15  98],537,1,23018,4.2484311554079,0.0,20.0
45418,4,5418,[289 515 475 294   4],474,3,23021,4.248200775050748,0.0,0.0
45419,4,5419,[ 89  97 496 197   4],387,1,23022,4.2476014760147605,0.0,0.0
45420,4,5420,[125 196 118 176 258],533,4,23026,4.247555801512636,0.0,0.0
45421,4,5421,[313 187 127 302 100],207,4,23030,4.247510143858355,0.0,40.0
45422,4,5422,[ 56 210 202 175 183],749,3,23033,4.2472801032638765,0.0,0.0
45423,4,5423,[222  22 144  28  97],653,2,23035,4.246865781710914,0.0,0.0
45424,4,5424,[117 238  70 172 655],308,4,23039,4.2468202764976954,0.0,0.0
45425,4,5425,[313 187 127 302 318],207,5,23044,4.246959085882787,20.0,20.0
45426,4,5426,[313 187 127 302 318],90,5,23049,4.247097844112769,20.0,20.0
45427,4,5427,[313 187 127 302 318],334,5,23054,4.247236551215917,20.0,20.0
45428,4,5428,[313 187 127 302 318],13,4,23058,4.247191011235955,20.0,20.0
45429,4,5429,[194 196 423 180 174],840,4,23062,4.247145488029466,0.0,20.0
45430,4,5430,[313 187 127 302 100],13,5,23067,4.247284109740379,0.0,40.0
45431,4,5431,[313 187 127 302 100],207,4,23071,4.2472385861561115,0.0,40.0
45432,4,5432,[313 187 127 302 318],328,5,23076,4.247377139701822,20.0,20.0
45433,4,5433,[313 187 127 302 318],144,4,23080,4.247331615752668,20.0,20.0
45434,4,5434,[313 187 127 302 318],328,5,23085,4.247470101195952,20.0,20.0
45435,4,5435,[313 187 127 302 318],328,5,23090,4.247608535688006,20.0,20.0
45436,4,5436,[258   1 202 603 211],749,5,23095,4.247746919256943,20.0,0.0
45437,4,5437,[313 187 127 302 318],144,4,23099,4.24770136079441,20.0,20.0
45438,4,5438,[313 187 127 302 318],207,5,23104,4.247839676411105,20.0,20.0
45439,4,5439,[300 179 385 144 153],378,4,23108,4.247794117647059,0.0,0.0
45440,4,5440,[313 187 127 302 318],90,5,23113,4.247932365374012,20.0,20.0
45441,4,5441,[435 405 191 132 211],85,4,23117,4.247886806321206,0.0,0.0
45442,4,5442,[  1  56  96  64 127],144,5,23122,4.248024986220834,0.0,20.0
45443,4,5443,[191 435 655 211 195],313,5,23127,4.2481631153563555,0.0,0.0
45444,4,5444,[313 187 127 302 318],144,4,23131,4.24811753902663,20.0,20.0
45445,4,5445,[ 82 276 471 302 185],207,2,23133,4.247704737421961,0.0,0.0
45446,4,5446,[313 187 127 302 318],90,5,23138,4.24784284927483,20.0,20.0
45447,4,5447,[313 187 127 302 318],144,4,23142,4.247797356828194,20.0,20.0
45448,4,5448,[ 71 168 222 161 318],524,2,23144,4.247384841255276,20.0,0.0
45449,4,5449,[313 187 127 302 318],474,5,23149,4.247522935779816,20.0,20.0
45450,4,5450,[313 187 127 302 318],144,4,23153,4.247477527059255,20.0,20.0
45451,4,5451,[313 187 127 302 318],90,5,23158,4.247615553925165,20.0,20.0
45452,4,5452,[313 187 127 302 318],144,4,23162,4.2475701448743814,20.0,20.0
45453,4,5453,[313 187 127 302 318],474,5,23167,4.247708104143748,20.0,20.0
45454,4,5454,[313 187 127 302 318],271,5,23172,4.247846012832264,20.0,20.0
45455,4,5455,[313 187 127 302 318],13,4,23176,4.247800586510264,20.0,20.0
45456,4,5456,[172   9 121 118 237],184,3,23179,4.247571925966648,0.0,0.0
45457,4,5457,[313 187 127 302 318],328,5,23184,4.247709783803591,20.0,20.0
45458,4,5458,[127 168 294 144 471],194,4,23188,4.247664407400623,0.0,20.0
45459,4,5459,[238 655 127 143 200],213,5,23193,4.247802197802198,0.0,20.0
45460,4,5460,[313 187 127 302 318],334,5,23198,4.24793993774034,20.0,20.0
45461,4,5461,[313 187 127 302 318],537,5,23203,4.248077627242768,20.0,20.0
45462,4,5462,[313 187 127 302 318],334,5,23208,4.248215266337177,20.0,20.0
45463,4,5463,[313 187 127 302 318],334,5,23213,4.248352855051245,20.0,20.0
45464,4,5464,[313 187 127 302 318],334,5,23218,4.2484903934126255,20.0,20.0
45465,4,5465,[313 187 127 302 318],144,4,23222,4.248444932308818,20.0,20.0
45466,4,5466,[313 187 127 302 318],334,5,23227,4.248582403511981,20.0,20.0
45467,4,5467,[313 187 127 302 318],13,4,23231,4.248536942209217,20.0,20.0
45468,4,5468,[313 187 127 302 318],334,5,23236,4.248674346315597,20.0,20.0
45469,4,5469,[515  12  97 678 183],455,3,23239,4.248446069469836,20.0,0.0
45470,4,5470,[222 211 238  98 118],897,5,23244,4.248583439956132,0.0,20.0
45471,4,5471,[588 194 125 748   8],64,3,23247,4.248355263157895,0.0,0.0
45472,4,5472,[313 187 127 302 318],474,5,23252,4.248492600036543,20.0,20.0
45473,4,5473,[  9 318 385 603 183],308,5,23257,4.248629886737303,40.0,0.0
45474,4,5474,[313 187 127 302 318],334,5,23262,4.248767123287672,20.0,20.0
45475,4,5475,[313 187 127 302 318],271,5,23267,4.248904309715121,20.0,20.0
45476,4,5476,[313 187 127 302 318],13,4,23271,4.248858864341793,20.0,20.0
45477,4,5477,[313 187 127 302 318],207,5,23276,4.248995983935743,20.0,20.0
45478,4,5478,[313 187 127 302 318],328,5,23281,4.249133053476912,20.0,20.0
45479,4,5479,[313 187 127 302 318],90,5,23286,4.249270072992701,20.0,20.0
45480,4,5480,[168 302 423  64 204],6,3,23289,4.24904214559387,0.0,0.0
45481,4,5481,[313 187 127 302 318],537,5,23294,4.249179131703758,20.0,20.0
45482,4,5482,[ 89 100 180 294  56],804,4,23298,4.249133685938355,0.0,20.0
45483,4,5483,[313 187 127 302 318],537,5,23303,4.24927060539752,20.0,20.0
45484,4,5484,[313 187 127 302 318],328,5,23308,4.2494074749316315,20.0,20.0
45485,4,5485,[313 187 127 302 318],90,5,23313,4.2495442945679915,20.0,20.0
45486,4,5486,[100 176  15 483 405],374,3,23316,4.249316566429743,20.0,20.0
45487,4,5487,[313 187 127 302 318],537,5,23321,4.249453352769679,20.0,20.0
45488,4,5488,[313 187 127 302 318],334,5,23326,4.249590089269448,20.0,20.0
45489,4,5489,[ 97 153 173  22 127],650,2,23328,4.249180327868852,0.0,20.0
45490,4,5490,[313 187 127 302 318],144,4,23332,4.249134948096886,20.0,20.0
45491,4,5491,[313 187 127 302 318],13,4,23336,4.249089584850692,20.0,20.0
45492,4,5492,[313 187 127 302 318],474,5,23341,4.249226288002912,20.0,20.0
45493,4,5493,[313 187 127 302 318],334,5,23346,4.249362941390608,20.0,20.0
45494,4,5494,[127 143 204 257  97],653,2,23348,4.248953594176524,0.0,20.0
45495,4,5495,[313 187 127 302 318],537,5,23353,4.249090247452693,20.0,20.0
45496,4,5496,[313 187 127 302 318],334,5,23358,4.249226851009642,20.0,20.0
45497,4,5497,[313 187 127 302 318],13,4,23362,4.249181520552928,20.0,20.0
45498,4,5498,[173 132  89 175 143],650,5,23367,4.249318057828696,0.0,0.0
45499,4,5499,[313 187 127 302 318],334,5,23372,4.249454545454546,20.0,20.0
45500,4,5500,[ 50   1   7 181  89],653,4,23376,4.249409198327577,0.0,20.0
45501,4,5501,[222 194  97 423 300],378,4,23380,4.249363867684479,0.0,0.0
45502,4,5502,[313 187 127 302 318],13,4,23384,4.249318553516264,20.0,20.0
45503,4,5503,[313 187 127 302 100],474,5,23389,4.249454941860465,0.0,40.0
45504,4,5504,[313 187 127 302 100],13,5,23394,4.249591280653951,0.0,40.0
45505,4,5505,[127   1  96 222  98],650,3,23397,4.249364329822012,0.0,40.0
45506,4,5506,[186 185 121 405 273],13,2,23399,4.248955874341747,0.0,0.0
45507,4,5507,[313 187 127 302 100],537,5,23404,4.249092229484386,0.0,40.0
45508,4,5508,[313 187 127 302 100],144,4,23408,4.249047013977128,0.0,40.0
45509,4,5509,[597 385  64   4 257],804,4,23412,4.249001814882033,0.0,0.0
45510,4,5510,[313 187 127 302 100],144,4,23416,4.248956632190165,0.0,40.0
45511,4,5511,[313 187 127 302 100],90,5,23421,4.2490928882438315,0.0,40.0
45512,4,5512,[313 187 127 302 100],474,5,23426,4.249229094866679,0.0,40.0
45513,4,5513,[111 302 235 174 427],669,3,23429,4.2490025389916575,0.0,20.0
45514,4,5514,[313 187 127 302 100],90,5,23434,4.249138712601995,0.0,40.0
45515,4,5515,[ 28 172 173 127 403],334,3,23437,4.248912255257433,0.0,20.0
45516,4,5516,[313 187 127 302 100],334,5,23442,4.2490483958673195,0.0,40.0
45517,4,5517,[173 237  79 275 196],13,2,23444,4.248640811888365,0.0,0.0
45518,4,5518,[265 179 286 294 117],554,3,23447,4.2484145678564955,0.0,0.0
45519,4,5519,[313 187 127 302 100],334,5,23452,4.248550724637681,0.0,40.0
45520,4,5520,[313 187 127 302 100],90,5,23457,4.248686832095635,0.0,40.0
45521,4,5521,[282 121   4 265  56],115,3,23460,4.248460702643969,0.0,0.0
45522,4,5522,[210 187 144  97 435],234,1,23461,4.247872533043636,0.0,0.0
45523,4,5523,[222  22 546 153 318],653,2,23463,4.247465604634323,20.0,0.0
45524,4,5524,[222  28 403  25 238],339,4,23467,4.247420814479638,0.0,0.0
45525,4,5525,[215 228  79  69 187],749,4,23471,4.2473760405356495,0.0,0.0
45526,4,5526,[197   8 143 385 210],379,4,23475,4.247331282793559,0.0,0.0
45527,4,5527,[313 187 127 302 100],537,5,23480,4.247467438494935,0.0,40.0
45528,4,5528,[313 187 127 302 100],334,5,23485,4.247603544944837,0.0,40.0
45529,4,5529,[ 95 403   7 435 117],892,4,23489,4.247558770343581,0.0,0.0
45530,4,5530,[313 187 127 302 100],474,5,23494,4.247694811064907,0.0,40.0
45531,4,5531,[  7  89  82  25 204],59,5,23499,4.247830802603037,0.0,0.0
45532,4,5532,[313 187 127 302 100],207,4,23503,4.247786011205494,0.0,40.0
45533,4,5533,[313 187 127 302 100],328,5,23508,4.24792193711601,0.0,40.0
45534,4,5534,[313 187 127 302 100],334,5,23513,4.248057813911473,0.0,40.0
45535,4,5535,[313 187 127 302 100],271,5,23518,4.2481936416184976,0.0,40.0
45536,4,5536,[588 275  25 597 234],458,3,23521,4.2479682138342065,0.0,0.0
45537,4,5537,[313 187 127 302 100],207,4,23525,4.247923438064283,0.0,40.0
45538,4,5538,[210 121 318 151 197],533,4,23529,4.2478786784618165,20.0,0.0
45539,4,5539,[313 187 127 302 100],474,5,23534,4.248014440433213,0.0,40.0
45540,4,5540,[313 187 127 302 100],537,5,23539,4.248150153401913,0.0,40.0
45541,4,5541,[313 187 127 302 100],537,5,23544,4.248285817394442,0.0,40.0
45542,4,5542,[ 50 174 168 385 515],650,5,23549,4.248421432437309,0.0,40.0
45543,4,5543,[313 187 127 302 100],328,5,23554,4.248556998556999,0.0,40.0
45544,4,5544,[174 508  22 179  96],543,4,23558,4.248512173128945,0.0,20.0
45545,4,5545,[313 187 127 302 100],144,4,23562,4.248467363865849,0.0,40.0
45546,4,5546,[313 187 127 302 100],13,5,23567,4.248602848386515,0.0,40.0
45547,4,5547,[313 187 127 302 100],144,4,23571,4.2485580389329485,0.0,40.0
45548,4,5548,[181 182  95 121 568],194,0,23571,4.2477923950261305,0.0,0.0
45549,4,5549,[313 187 127 302 100],328,5,23576,4.247927927927928,0.0,40.0
45550,4,5550,[118  22 257 153 194],308,4,23580,4.247883264276707,0.0,0.0
45551,4,5551,[313 187 127 302 100],328,5,23585,4.248018731988473,0.0,40.0
45552,4,5552,[313 187 127 302 100],474,5,23590,4.248154150909419,0.0,40.0
45553,4,5553,[313 187 127 302 100],537,5,23595,4.248289521065899,0.0,40.0
45554,4,5554,[313 187 127 302 100],474,5,23600,4.248424842484249,0.0,40.0
45555,4,5555,[313 187 127 302 100],13,5,23605,4.248560115190784,0.0,40.0
45556,4,5556,[313 187 127 302 100],474,5,23610,4.248695339211805,0.0,40.0
45557,4,5557,[313 187 127 302 100],474,5,23615,4.248830514573587,0.0,40.0
45558,4,5558,[313 187 127 302 100],537,5,23620,4.248965641302393,0.0,40.0
45559,4,5559,[313 187 127 302 100],144,4,23624,4.248920863309353,0.0,40.0
45560,4,5560,[313 187 127 302 100],334,5,23629,4.249055925193311,0.0,40.0
45561,4,5561,[313 187 127 302 100],328,5,23634,4.249190938511327,0.0,40.0
45562,4,5562,[313 187 127 302 100],144,4,23638,4.249146144166817,0.0,40.0
45563,4,5563,[196 435 181   4 195],339,4,23642,4.249101365923796,0.0,0.0
45564,4,5564,[313 187 127 302 100],328,5,23647,4.249236298292902,0.0,40.0
45565,4,5565,[313 187 127 302 100],474,5,23652,4.249371182177506,0.0,40.0
45566,4,5566,[313 187 127 302 100],13,5,23657,4.2495060176037365,0.0,40.0
45567,4,5567,[313 187 127 302 100],271,5,23662,4.249640804597701,0.0,40.0
45568,4,5568,[313 187 127 302 100],334,5,23667,4.249775543185491,0.0,40.0
45569,4,5569,[216  15 603 172 135],452,3,23670,4.2495511669658885,20.0,0.0
45570,4,5570,[ 79 186 121  89  12],664,4,23674,4.2495063722850475,20.0,0.0
45571,4,5571,[313 187 127 302 100],90,5,23679,4.249641062455133,0.0,40.0
45572,4,5572,[313 187 127 302 100],334,5,23684,4.249775704288534,0.0,40.0
45573,4,5573,[ 82  50 132 185   7],643,4,23688,4.249730893433799,0.0,20.0
45574,4,5574,[  8  69 121 143 286],7,4,23692,4.249686098654709,0.0,0.0
45575,4,5575,[313 187 127 302 100],328,5,23697,4.249820659971306,0.0,40.0
45576,4,5576,[313 187 127 302 100],90,5,23702,4.249955173032096,0.0,40.0
45577,4,5577,[313 187 127 302 100],144,4,23706,4.2499103621369665,0.0,40.0
45578,4,5578,[313 187 127 302 100],271,5,23711,4.25004481089801,0.0,40.0
45579,4,5579,[313  79 568 125   1],200,5,23716,4.2501792114695345,0.0,0.0
45580,4,5580,[313 187 127 302 100],13,5,23721,4.250313563877441,0.0,40.0
45581,4,5581,[143  97 210 328 508],378,4,23725,4.25026872088857,0.0,0.0
45582,4,5582,[313 187 127 302 100],13,5,23730,4.250403009134874,0.0,40.0
45583,4,5583,[313 187 127 302 100],13,5,23735,4.250537249283668,0.0,40.0
45584,4,5584,[172 195 294 202  15],311,5,23740,4.250671441360788,0.0,0.0
45585,4,5585,[153 405 597 322 588],804,4,23744,4.25062656641604,0.0,0.0
45586,4,5586,[313 187 127 302 100],90,5,23749,4.250760694469304,0.0,40.0
45587,4,5587,[313 187 127 302 100],334,5,23754,4.250894774516822,0.0,40.0
45588,4,5588,[313 187 127 302 100],271,5,23759,4.251028806584362,0.0,40.0
45589,4,5589,[313 187 127 302 100],207,4,23763,4.250983899821109,0.0,40.0
45590,4,5590,[282  70  71 215   9],474,5,23768,4.251117868002146,0.0,0.0
45591,4,5591,[151 195 603 186 265],897,4,23772,4.25107296137339,20.0,0.0
45592,4,5592,[302  95 168   4 483],664,5,23777,4.251206865725013,20.0,0.0
45593,4,5593,[313 187 127 302 100],474,5,23782,4.25134072220236,0.0,40.0
45594,4,5594,[313 187 127 302 100],334,5,23787,4.251474530831099,0.0,40.0
45595,4,5595,[313 187 127 302 100],144,4,23791,4.251429592566119,0.0,40.0
45596,4,5596,[313 187 127 302 100],13,5,23796,4.251563337502233,0.0,40.0
45597,4,5597,[313 187 127 302 100],144,4,23800,4.251518399428368,0.0,40.0
45598,4,5598,[313 187 127 302 100],13,5,23805,4.251652080728702,0.0,40.0
45599,4,5599,[313 187 127 302 100],13,5,23810,4.251785714285714,0.0,40.0
45600,4,5600,[313 187 127 302 100],334,5,23815,4.251919300124977,0.0,40.0
45601,4,5601,[172  70 471  97  98],13,3,23818,4.251695822920386,0.0,20.0
45602,4,5602,[313 187 127 302 100],334,5,23823,4.2518293771194005,0.0,40.0
45603,4,5603,[313 187 127 302 100],328,5,23828,4.2519628836545325,0.0,40.0
45604,4,5604,[313 187 127 302 100],334,5,23833,4.252096342551294,0.0,40.0
45605,4,5605,[313 187 127 302 100],474,5,23838,4.252229753835176,0.0,40.0
45606,4,5606,[313 187 127 302 100],13,5,23843,4.252363117531657,0.0,40.0
45607,4,5607,[313 187 127 302 100],144,4,23847,4.252318116975749,0.0,40.0
45608,4,5608,[313 187 127 302 100],144,4,23851,4.25227313246568,0.0,40.0
45609,4,5609,[313 187 127 302 100],271,5,23856,4.252406417112299,0.0,40.0
45610,4,5610,[313 187 127 302 100],90,5,23861,4.25253965425058,0.0,40.0
45611,4,5611,[313 187 127 302 100],144,4,23865,4.252494654312188,0.0,40.0
45612,4,5612,[603 195 143 546  79],458,4,23869,4.252449670407981,20.0,0.0
45613,4,5613,[313 187 127 302 100],537,5,23874,4.252582828642679,0.0,40.0
45614,4,5614,[313 187 127 302 100],334,5,23879,4.252715939447907,0.0,40.0
45615,4,5615,[204 742  12 515 475],387,2,23881,4.252314814814815,20.0,0.0
45616,4,5616,[313 187 127 302 100],328,5,23886,4.252447925939113,0.0,40.0
45617,4,5617,[313 187 127 302 100],271,5,23891,4.252580989676042,0.0,40.0
45618,4,5618,[275 216 174 172 515],279,1,23892,4.252002135611319,0.0,20.0
45619,4,5619,[568 100 180 127 196],13,4,23896,4.251957295373665,0.0,40.0
45620,4,5620,[508  97 328 238 176],653,1,23897,4.251378758228073,0.0,0.0
45621,4,5621,[313 187 127 302 100],537,5,23902,4.251511917467093,0.0,40.0
45622,4,5622,[313 187 127 302 100],328,5,23907,4.251645029343766,0.0,40.0
45623,4,5623,[313 187 127 302 100],537,5,23912,4.251778093883357,0.0,40.0
45624,4,5624,[258 143 357   4 194],650,3,23915,4.251555555555556,20.0,0.0
45625,4,5625,[313 187 127 302 100],334,5,23920,4.251688588695343,0.0,40.0
45626,4,5626,[313 187 127 302 100],207,4,23924,4.251643859960903,0.0,40.0
45627,4,5627,[313 187 127 302 100],90,5,23929,4.251776830135039,0.0,40.0
45628,4,5628,[289 211 508 176 385],387,2,23931,4.2513767987209095,0.0,0.0
45629,4,5629,[313 187 127 302 100],474,5,23936,4.251509769094138,0.0,40.0
45630,4,5630,[ 69 265  12  71 748],533,3,23939,4.251287515538981,20.0,0.0
45631,4,5631,[313 187 127 302 100],90,5,23944,4.251420454545454,0.0,40.0
45632,4,5632,[483 183 197  69  97],194,3,23947,4.2511982957571455,20.0,0.0
45633,4,5633,[313 187 127 302 100],207,4,23951,4.251153709620163,0.0,40.0
45634,4,5634,[313 187 127 302 100],328,5,23956,4.251286601597161,0.0,40.0
45635,4,5635,[313 187 127 302 100],537,5,23961,4.251419446415897,0.0,40.0
45636,4,5636,[313 187 127 302 100],334,5,23966,4.251552244101473,0.0,40.0
45637,4,5637,[245 288 172   7 144],378,3,23969,4.251330258957077,0.0,0.0
45638,4,5638,[265 127 118 678 282],455,3,23972,4.251108352544778,0.0,20.0
45639,4,5639,[313 187 127 302 100],328,5,23977,4.251241134751773,0.0,40.0
45640,4,5640,[313 187 127 302 100],90,5,23982,4.251373869881227,0.0,40.0
45641,4,5641,[313 187 127 302 100],334,5,23987,4.251506557958171,0.0,40.0
45642,4,5642,[125 216 245 237  82],653,2,23989,4.251107566897041,0.0,0.0
45643,4,5643,[313 187 127 302 100],90,5,23994,4.2512402551382,0.0,40.0
45644,4,5644,[313 187 127 302 100],144,4,23998,4.251195748449955,0.0,40.0
45645,4,5645,[196 202 144 678 125],92,3,24001,4.250974140984768,0.0,0.0
45646,4,5646,[471 183 173 678 546],455,3,24004,4.250752612006375,0.0,0.0
45647,4,5647,[197 300 286 100 179],666,4,24008,4.2507082152974505,0.0,20.0
45648,4,5648,[313 187 127 302 100],144,4,24012,4.250663834306957,0.0,40.0
45649,4,5649,[313 187 127 302 100],90,5,24017,4.250796460176991,0.0,40.0
45650,4,5650,[313 187 127 302 100],144,4,24021,4.250752079278004,0.0,40.0
45651,4,5651,[515 289 111  11 186],334,2,24023,4.250353857041755,0.0,0.0
45652,4,5652,[313 187 127 302 100],537,5,24028,4.250486467362462,0.0,40.0
45653,4,5653,[313 187 127 302 100],207,4,24032,4.250442164839052,0.0,40.0
45654,4,5654,[132 197 237  15 423],215,4,24036,4.250397877984085,0.0,0.0
45655,4,5655,[313 187 127 302 100],90,5,24041,4.250530410183876,0.0,40.0
45656,4,5656,[313 187 127 302 100],207,4,24045,4.250486123386954,0.0,40.0
45657,4,5657,[313 187 127 302 100],474,5,24050,4.250618593142454,0.0,40.0
45658,4,5658,[435 179 185 176 194],666,4,24054,4.250574306414561,0.0,0.0
45659,4,5659,[313 187 127 302 100],13,5,24059,4.250706713780919,0.0,40.0
45660,4,5660,[185 181 111 176  97],64,4,24063,4.250662427133015,0.0,0.0
45661,4,5661,[313 187 127 302 100],207,4,24067,4.250618156128576,0.0,40.0
45662,4,5662,[603 313  22 597 403],308,3,24070,4.250397315910295,20.0,0.0
45663,4,5663,[313 187 127 302 100],271,5,24075,4.250529661016949,0.0,40.0
45664,4,5664,[313 187 127 302 100],474,5,24080,4.250661959399824,0.0,40.0
45665,4,5665,[313 187 127 302 100],13,5,24085,4.250794211083657,0.0,40.0
45666,4,5666,[  4 117  12  97  11],13,3,24088,4.250573495676725,20.0,0.0
45667,4,5667,[313 187 127 302 100],207,4,24092,4.250529287226535,0.0,40.0
45668,4,5668,[313 187 127 302 100],271,5,24097,4.250661492326689,0.0,40.0
45669,4,5669,[313 187 127 302 100],207,4,24101,4.250617283950617,0.0,40.0
45670,4,5670,[313 187 127 302 100],537,5,24106,4.250749426908834,0.0,40.0
45671,4,5671,[313 187 127 302 100],207,4,24110,4.250705218617772,0.0,40.0
45672,4,5672,[496 182 194 215 483],533,4,24114,4.2506610259122155,20.0,0.0
45673,4,5673,[313 187 127 302 100],328,5,24119,4.25079309129362,0.0,40.0
45674,4,5674,[313 187 127 302 100],144,4,24123,4.250748898678414,0.0,40.0
45675,4,5675,[313 187 127 302 100],537,5,24128,4.250880902043693,0.0,40.0
45676,4,5676,[286 151  95 168 471],524,2,24130,4.2504844107803414,0.0,0.0
45677,4,5677,[313 187 127 302 100],207,4,24134,4.250440295878831,0.0,40.0
45678,4,5678,[117 187 515 127 151],650,2,24136,4.25004402183483,0.0,20.0
45679,4,5679,[  4 228  28 211  88],653,2,24138,4.249647887323944,0.0,0.0
45680,4,5680,[  9  70 603 313 202],14,2,24140,4.249251892272487,20.0,0.0
45681,4,5681,[313 187 127 302 100],328,5,24145,4.2493840197113695,0.0,40.0
45682,4,5682,[313 187 127 302 100],334,5,24150,4.249516100651064,0.0,40.0
45683,4,5683,[423 173 294 655 135],804,3,24153,4.2492962702322306,0.0,0.0
45684,4,5684,[ 71  28  11 234 172],788,1,24154,4.248724714160071,0.0,0.0
45685,4,5685,[313 187 127 302 100],271,5,24159,4.248856841364756,0.0,40.0
45686,4,5686,[313 187 127 302 100],144,4,24163,4.248813082468788,0.0,40.0
45687,4,5687,[313 187 127 302 100],537,5,24168,4.248945147679325,0.0,40.0
45688,4,5688,[313 187 127 302 100],271,5,24173,4.249077166461593,0.0,40.0
45689,4,5689,[313 187 127 302 100],334,5,24178,4.249209138840071,0.0,40.0
45690,4,5690,[197 568   9 153 143],13,2,24180,4.248813916710596,0.0,0.0
45691,4,5691,[ 22 144 181  25 423],95,4,24184,4.2487702037948,0.0,0.0
45692,4,5692,[ 89 172  28   8  98],379,5,24189,4.248902160548042,0.0,20.0
45693,4,5693,[313 187 127 302 100],537,5,24194,4.249034070951879,0.0,40.0
45694,4,5694,[313 187 127 302 100],474,5,24199,4.249165935030729,0.0,40.0
45695,4,5695,[197  22 179  50 228],406,3,24202,4.248946629213483,0.0,20.0
45696,4,5696,[ 28 182 174 195 180],474,5,24207,4.249078462348605,0.0,20.0
45697,4,5697,[180 175 215 197  70],60,5,24212,4.2492102492102495,0.0,0.0
45698,4,5698,[313 187 127 302 100],328,5,24217,4.249341989822776,0.0,40.0
45699,4,5699,[313 187 127 302 100],537,5,24222,4.2494736842105265,0.0,40.0
45700,4,5700,[508 191 197 496   9],406,5,24227,4.249605332397825,0.0,0.0
45701,4,5701,[313 187 127 302 100],90,5,24232,4.249736934408979,0.0,40.0
45702,4,5702,[313 187 127 302 100],271,5,24237,4.2498684902682795,0.0,40.0
45703,4,5703,[194  98 195 435 271],883,2,24239,4.249474053295932,0.0,20.0
45704,4,5704,[ 25  50 678 742 153],308,4,24243,4.24943032427695,0.0,20.0
45705,4,5705,[180 258 405 118 125],788,3,24246,4.249211356466877,0.0,0.0
45706,4,5706,[313 187 127 302 100],271,5,24251,4.249342912213072,0.0,40.0
45707,4,5707,[313 187 127 302 100],271,5,24256,4.2494744218640506,0.0,40.0
45708,4,5708,[313 187 127 302 100],144,4,24260,4.249430723419163,0.0,40.0
45709,4,5709,[144 385 273 196  88],92,4,24264,4.24938704028021,0.0,0.0
45710,4,5710,[328 258 111  98 172],92,3,24267,4.24916827175626,0.0,20.0
45711,4,5711,[176 121 216  64 603],13,3,24270,4.248949579831932,20.0,0.0
45712,4,5712,[313 187 127 302 100],144,4,24274,4.248906003850866,0.0,40.0
45713,4,5713,[313 187 127 302 100],271,5,24279,4.249037451872594,0.0,40.0
45714,4,5714,[313 187 127 302 100],537,5,24284,4.249168853893264,0.0,40.0
45715,4,5715,[313 187 127 302 100],334,5,24289,4.249300209937019,0.0,40.0
45716,4,5716,[111 222 196 202 508],92,3,24292,4.249081686199055,0.0,0.0
45717,4,5717,[  7 182 258 222 257],339,4,24296,4.249038125218608,0.0,0.0
45718,4,5718,[403 144 100 204 515],339,2,24298,4.248644867983913,0.0,20.0
45719,4,5719,[182  89 268 222 678],334,3,24301,4.248426573426573,0.0,0.0
45720,4,5720,[313 187 127 302 100],144,4,24305,4.248383149798986,0.0,40.0
45721,4,5721,[313 187 127 302 100],144,4,24309,4.248339741349179,0.0,40.0
45722,4,5722,[ 25 135 508 234   9],343,3,24312,4.24812161453783,0.0,0.0
45723,4,5723,[228 100  22  56 135],447,5,24317,4.248252969951083,0.0,20.0
45724,4,5724,[313 187 127 302 100],144,4,24321,4.2482096069869,0.0,40.0
45725,4,5725,[313 187 127 302 100],271,5,24326,4.248340901152637,0.0,40.0
45726,4,5726,[313 187 127 302 100],13,5,24331,4.248472149467435,0.0,40.0
45727,4,5727,[313 187 127 302 100],90,5,24336,4.248603351955308,0.0,40.0
45728,4,5728,[234 318 211 181   9],527,4,24340,4.248559958107872,20.0,0.0
45729,4,5729,[202 210 211 185 271],13,2,24342,4.2481675392670155,0.0,0.0
45730,4,5730,[313 187 127 302 100],13,5,24347,4.24829872622579,0.0,40.0
45731,4,5731,[313 187 127 302 100],144,4,24351,4.248255408234473,0.0,40.0
45732,4,5732,[313 187 127 302 100],271,5,24356,4.24838653410082,0.0,40.0
45733,4,5733,[174 216  79 269 357],207,5,24361,4.248517614230903,20.0,20.0
45734,4,5734,[313 187 127 302 100],13,5,24366,4.248648648648649,0.0,40.0
45735,4,5735,[181 182 655  25 234],666,2,24368,4.248256624825663,0.0,0.0
45736,4,5736,[185 135 172 483 235],398,3,24371,4.248039044796932,20.0,0.0
45737,4,5737,[ 50 405 483  15  79],406,3,24374,4.247821540606483,20.0,20.0
45738,4,5738,[125 546 742 172   1],897,4,24378,4.247778358599059,0.0,0.0
45739,4,5739,[183 265 515   1 742],200,5,24383,4.247909407665505,0.0,0.0
45740,4,5740,[313 187 127 302 100],334,5,24388,4.248040411078209,0.0,40.0
45741,4,5741,[313 187 127 302 100],334,5,24393,4.248171368861024,0.0,40.0
45742,4,5742,[313 187 127 302 100],13,5,24398,4.248302281037785,0.0,40.0
45743,4,5743,[313 187 127 302 100],271,5,24403,4.248433147632312,0.0,40.0
45744,4,5744,[403  50 172 357 328],533,3,24406,4.248215839860748,20.0,20.0
45745,4,5745,[117 211 186 423 271],537,2,24408,4.247824573616429,0.0,0.0
45746,4,5746,[313 187 127 302 100],13,5,24413,4.24795545502001,0.0,40.0
45747,4,5747,[194 211 603 546 748],524,3,24416,4.247738343771747,20.0,0.0
45748,4,5748,[313 187 127 302 100],144,4,24420,4.247695251348061,0.0,40.0
45749,4,5749,[313 187 127 302 100],537,5,24425,4.247826086956522,0.0,40.0
45750,4,5750,[313 187 127 302 100],13,5,24430,4.247956877064858,0.0,40.0
45751,4,5751,[313 187 127 302 100],13,5,24435,4.2480876216968015,0.0,40.0
45752,4,5752,[313 187 127 302 100],271,5,24440,4.248218320876065,0.0,40.0
45753,4,5753,[ 70 187   9 179 435],13,2,24442,4.247827598192561,0.0,0.0
45754,4,5754,[313 187 127 302 100],13,5,24447,4.247958297132928,0.0,40.0
45755,4,5755,[313 187 127 302 100],90,5,24452,4.248088950660181,0.0,40.0
45756,4,5756,[258   8   9  50 603],271,4,24456,4.248045857217301,20.0,20.0
45757,4,5757,[313 187 127 302 100],90,5,24461,4.248176450156304,0.0,40.0
45758,4,5758,[313 187 127 302 100],334,5,24466,4.248306997742664,0.0,40.0
45759,4,5759,[313 187 127 302 100],144,4,24470,4.248263888888889,0.0,40.0
45760,4,5760,[313 187 127 302 100],537,5,24475,4.248394375976393,0.0,40.0
45761,4,5761,[153 318  82 258 121],378,5,24480,4.2485248177716075,20.0,0.0
45762,4,5762,[313 187 127 302 100],334,5,24485,4.248655214298108,0.0,40.0
45763,4,5763,[313 187 127 302 100],13,5,24490,4.248785565579459,0.0,40.0
45764,4,5764,[313 187 127 302 100],537,5,24495,4.248915871639202,0.0,40.0
45765,4,5765,[196  28  56  82 174],897,3,24498,4.248699271592091,0.0,20.0
45766,4,5766,[313 187 127 302 100],328,5,24503,4.248829547425005,0.0,40.0
45767,4,5767,[294 161  82 515  96],207,2,24505,4.248439667128988,0.0,0.0
45768,4,5768,[313 187 127 302 100],334,5,24510,4.248569942797712,0.0,40.0
45769,4,5769,[216 168 176 174 181],881,4,24514,4.248526863084922,0.0,20.0
45770,4,5770,[195 182 180  96   9],328,3,24517,4.248310518107781,0.0,0.0
45771,4,5771,[313 187 127 302 100],90,5,24522,4.248440748440748,0.0,40.0
45772,4,5772,[313 187 127 302 100],328,5,24527,4.248570933656677,0.0,40.0
45773,4,5773,[313 187 127 302 100],334,5,24532,4.248701073779009,0.0,40.0
45774,4,5774,[313 187 127 302 100],334,5,24537,4.248831168831169,0.0,40.0
45775,4,5775,[ 15 200 210  98   8],311,5,24542,4.248961218836565,0.0,20.0
45776,4,5776,[194 275   9 471 196],13,2,24544,4.2485719231435,0.0,0.0
45777,4,5777,[173 183 508 423 127],387,4,24548,4.248528902734511,0.0,20.0
45778,4,5778,[313 187 127 302 100],328,5,24553,4.248658937532445,0.0,40.0
45779,4,5779,[313 187 127 302 100],271,5,24558,4.2487889273356405,0.0,40.0
45780,4,5780,[173 175 258 294 111],13,3,24561,4.248572911261028,0.0,0.0
45781,4,5781,[313 187 127 302 100],328,5,24566,4.2487028709789,0.0,40.0
45782,4,5782,[313 187 127 302 100],537,5,24571,4.24883278575134,0.0,40.0
45783,4,5783,[204 183  89 125 161],374,4,24575,4.248789764868603,0.0,0.0
45784,4,5784,[ 25 202 234 483 176],200,5,24580,4.248919619706137,20.0,0.0
45785,4,5785,[182 313  88  79 515],474,5,24585,4.249049429657795,0.0,0.0
45786,4,5786,[568 151 179 496  89],378,2,24587,4.2486607914290655,0.0,0.0
45787,4,5787,[313 187 127 302 100],474,5,24592,4.248790601243953,0.0,40.0
45788,4,5788,[313 187 127 302 100],144,4,24596,4.248747624805666,0.0,40.0
45789,4,5789,[313 187 127 302 100],271,5,24601,4.248877374784111,0.0,40.0
45790,4,5790,[313 187 127 302 100],537,5,24606,4.2490070799516495,0.0,40.0
45791,4,5791,[313 187 127 302 100],271,5,24611,4.249136740331492,0.0,40.0
45792,4,5792,[ 50 174 275 508 186],780,4,24615,4.249093733816675,0.0,40.0
45793,4,5793,[313 187 127 302 100],271,5,24620,4.249223334483949,0.0,40.0
45794,4,5794,[313 187 127 302 100],537,5,24625,4.249352890422778,0.0,40.0
45795,4,5795,[748   1 300 423 405],13,2,24627,4.24896480331263,0.0,0.0
45796,4,5796,[144  25 151 385 268],387,0,24627,4.248231844057271,0.0,0.0
45797,4,5797,[742 568 174 135 144],488,3,24630,4.248016557433598,0.0,20.0
45798,4,5798,[313 187 127 302 100],271,5,24635,4.248146232108985,0.0,40.0
45799,4,5799,[200 655  28 301 100],666,4,24639,4.248103448275862,0.0,20.0
45800,4,5800,[ 28 168 187 483 197],537,4,24643,4.248060679193243,20.0,0.0
45801,4,5801,[313 187 127 302 100],90,5,24648,4.2481902792140644,0.0,40.0
45802,4,5802,[313 187 127 302 100],207,4,24652,4.248147509908668,0.0,40.0
45803,4,5803,[313 187 127 302 100],474,5,24657,4.248277050310131,0.0,40.0
45804,4,5804,[313 187 127 302 100],144,4,24661,4.2482342807924205,0.0,40.0
45805,4,5805,[ 70  95 258 471 196],882,3,24664,4.248019290389252,0.0,0.0
45806,4,5806,[313 187 127 302 100],144,4,24668,4.247976579989667,0.0,40.0
45807,4,5807,[313 187 127 302 100],271,5,24673,4.2481060606060606,0.0,40.0
45808,4,5808,[313 187 127 302 100],144,4,24677,4.248063349974178,0.0,40.0
45809,4,5809,[313 187 127 302 100],334,5,24682,4.248192771084337,0.0,40.0
45810,4,5810,[182 300 125 276  89],271,0,24682,4.247461710548959,0.0,0.0
45811,4,5811,[313 187 127 302 100],328,5,24687,4.247591190640055,0.0,40.0
45812,4,5812,[ 82 200 187 427 125],7,4,24691,4.247548597970067,0.0,0.0
45813,4,5813,[313 187 127 302 100],13,5,24696,4.247678018575852,0.0,40.0
45814,4,5814,[117  79 301  15 235],184,0,24696,4.2469475494411,0.0,0.0
45815,4,5815,[313 187 127 302 100],13,5,24701,4.247077028885832,0.0,40.0
45816,4,5816,[313 187 127 302 100],537,5,24706,4.247206463812962,0.0,40.0
45817,4,5817,[313 187 127 302 100],207,4,24710,4.2471639738741835,0.0,40.0
45818,4,5818,[313 187 127 302 100],474,5,24715,4.247293349372744,0.0,40.0
45819,4,5819,[313 187 127 302 100],144,4,24719,4.247250859106529,0.0,40.0
45820,4,5820,[313 187 127 302 100],537,5,24724,4.247380175227624,0.0,40.0
45821,4,5821,[313 187 127 302 100],144,4,24728,4.247337684644452,0.0,40.0
45822,4,5822,[313 187 127 302 100],271,5,24733,4.247466941439121,0.0,40.0
45823,4,5823,[172  11 180 322 228],234,0,24733,4.246737637362638,0.0,0.0
45824,4,5824,[313 187 127 302 100],90,5,24738,4.246866952789699,0.0,40.0
45825,4,5825,[276 237 153 215 322],308,2,24740,4.246481290765534,0.0,0.0
45826,4,5826,[ 70  28 234  96 496],648,4,24744,4.2464389909044105,0.0,0.0
45827,4,5827,[127 144 483 273 238],13,3,24747,4.2462251201098145,20.0,20.0
45828,4,5828,[313 187 127 302 100],474,5,24752,4.246354434722937,0.0,40.0
45829,4,5829,[286 210 211 423 195],385,0,24752,4.2456260720411665,0.0,0.0
45830,4,5830,[100 174 286 173  22],145,4,24756,4.24558394786486,0.0,40.0
45831,4,5831,[313 187 127 302 100],474,5,24761,4.245713305898491,0.0,40.0
45832,4,5832,[313 187 127 302 100],334,5,24766,4.245842619578261,0.0,40.0
45833,4,5833,[222 483  88  50 121],648,5,24771,4.24597188892698,20.0,20.0
45834,4,5834,[144 234 288 182  97],339,3,24774,4.245758354755784,0.0,0.0
45835,4,5835,[313 187 127 302 100],13,5,24779,4.245887594242632,0.0,40.0
45836,4,5836,[  8 195 475 496 181],533,3,24782,4.245674147678602,0.0,0.0
45837,4,5837,[195 302  56 183 135],145,5,24787,4.2458033573141485,0.0,0.0
45838,4,5838,[313 187 127 302 100],334,5,24792,4.245932522692242,0.0,40.0
45839,4,5839,[313 187 127 302 100],90,5,24797,4.246061643835616,0.0,40.0
45840,4,5840,[258  28 186 197  79],653,3,24800,4.245848313644924,0.0,0.0
45841,4,5841,[313 187 127 302 100],271,5,24805,4.245977404998288,0.0,40.0
45842,4,5842,[313 187 127 302 100],207,4,24809,4.245935307205203,0.0,40.0
45843,4,5843,[313 187 127 302 100],144,4,24813,4.2458932238193015,0.0,40.0
45844,4,5844,[210 135 385 121 118],890,3,24816,4.2456800684345595,0.0,0.0
45845,4,5845,[313 187 127 302 100],334,5,24821,4.24580910023948,0.0,40.0
45846,4,5846,[111 161 196 100  88],207,2,24823,4.245425004275697,0.0,20.0
45847,4,5847,[168 435 546 153  28],234,1,24824,4.244870041039672,0.0,0.0
45848,4,5848,[313 187 127 302 100],144,4,24828,4.244828175756539,0.0,40.0
45849,4,5849,[313 187 127 302 100],334,5,24833,4.244957264957265,0.0,40.0
45850,4,5850,[313 187 127 302 100],474,5,24838,4.245086310032473,0.0,40.0
45851,4,5851,[313 187 127 302 100],207,4,24842,4.245044429254955,0.0,40.0
45852,4,5852,[127 471 238 515 191],308,3,24845,4.244831710234068,0.0,20.0
45853,4,5853,[313 187 127 302 100],13,5,24850,4.244960710625214,0.0,40.0
45854,4,5854,[313 187 127 302 100],537,5,24855,4.245089666951324,0.0,40.0
45855,4,5855,[313 187 127 302 100],207,4,24859,4.24504781420765,0.0,40.0
45856,4,5856,[275 135 161 294 222],13,2,24861,4.244664504012293,0.0,0.0
45857,4,5857,[ 70 151 222 197 181],536,2,24863,4.244281324684192,0.0,0.0
45858,4,5858,[313 187 127 302 100],207,4,24867,4.244239631336406,0.0,40.0
45859,4,5859,[313 187 127 302 100],328,5,24872,4.244368600682594,0.0,40.0
45860,4,5860,[313 187 127 302 100],13,5,24877,4.24449752601945,0.0,40.0
45861,4,5861,[313 187 127 302 100],474,5,24882,4.244626407369498,0.0,40.0
45862,4,5862,[ 64 423 204 435 275],458,4,24886,4.244584683609074,0.0,0.0
45863,4,5863,[313 187 127 302 100],334,5,24891,4.2447135061391545,0.0,40.0
45864,4,5864,[313 187 127 302 100],13,5,24896,4.244842284739983,0.0,40.0
45865,4,5865,[515  28  79 235 204],833,1,24897,4.244289123764064,0.0,0.0
45866,4,5866,[313 187 127 302 100],474,5,24902,4.244417930799386,0.0,40.0
45867,4,5867,[ 69 288  56 427 748],474,3,24905,4.244205862304022,0.0,0.0
45868,4,5868,[313 187 127 302 100],474,5,24910,4.244334639631965,0.0,40.0
45869,4,5869,[313 187 127 302 100],13,5,24915,4.244463373083475,0.0,40.0
45870,4,5870,[ 71 118  96  97 125],881,3,24918,4.24425140521206,0.0,0.0
45871,4,5871,[313 187 127 302 100],90,5,24923,4.244380108991826,0.0,40.0
45872,4,5872,[313 187 127 302 100],271,5,24928,4.244508768942619,0.0,40.0
45873,4,5873,[313 187 127 302 100],474,5,24933,4.244637385086823,0.0,40.0
45874,4,5874,[  8  64  69 318 183],387,2,24935,4.2442553191489365,20.0,0.0
45875,4,5875,[403 237 215  11 258],92,5,24940,4.244383934649421,0.0,0.0
45876,4,5876,[313 187 127 302 100],13,5,24945,4.244512506380807,0.0,40.0
45877,4,5877,[423   1  12 118 210],59,4,24949,4.24447090847227,20.0,0.0
45878,4,5878,[211 144 286 216 302],13,3,24952,4.244259227759823,0.0,0.0
45879,4,5879,[313 187 127 302 100],537,5,24957,4.244387755102041,0.0,40.0
45880,4,5880,[313 187 127 302 100],271,5,24962,4.244516238734909,0.0,40.0
45881,4,5881,[204 265 176 228 180],13,4,24966,4.244474668480109,0.0,0.0
45882,4,5882,[313 187 127 302 100],271,5,24971,4.2446030936596975,0.0,40.0
45883,4,5883,[313 187 127 302 100],474,5,24976,4.244731475186947,0.0,40.0
45884,4,5884,[313 187 127 302 100],90,5,24981,4.244859813084112,0.0,40.0
45885,4,5885,[ 64 403 323 471 127],374,3,24984,4.244648318042813,0.0,20.0
45886,4,5886,[228 132 435 197 194],694,5,24989,4.244776626465093,0.0,0.0
45887,4,5887,[313 187 127 302 100],207,4,24993,4.244735054347826,0.0,40.0
45888,4,5888,[ 25 546 185 182 678],881,2,24995,4.24435388011547,0.0,0.0
45889,4,5889,[313 187 127 302 100],334,5,25000,4.244482173174872,0.0,40.0
45890,4,5890,[313 187 127 302 100],474,5,25005,4.2446104226786625,0.0,40.0
45891,4,5891,[313 187 127 302 100],474,5,25010,4.244738628649015,0.0,40.0
45892,4,5892,[313 187 127 302 100],13,5,25015,4.244866791108095,0.0,40.0
45893,4,5893,[313 187 127 302 100],271,5,25020,4.244994910078045,0.0,40.0
45894,4,5894,[313 187 127 302 100],537,5,25025,4.245122985581001,0.0,40.0
45895,4,5895,[742 678 245  11   1],804,5,25030,4.245251017639077,0.0,0.0
45896,4,5896,[269 132 135 174  56],271,4,25034,4.245209428522978,0.0,20.0
45897,4,5897,[313 187 127 302 100],334,5,25039,4.245337402509326,0.0,40.0
45898,4,5898,[313 187 127 302 100],13,5,25044,4.2454653331073064,0.0,40.0
45899,4,5899,[185 546 143 228  71],7,4,25048,4.2454237288135594,0.0,0.0
45900,4,5900,[238 168 271   9 258],334,4,25052,4.245382138620573,0.0,0.0
45901,4,5901,[313 187 127 302 100],334,5,25057,4.245509996611318,0.0,40.0
45902,4,5902,[313 187 127 302 100],144,4,25061,4.245468405895307,0.0,40.0
45903,4,5903,[313 187 127 302 100],13,5,25066,4.24559620596206,0.0,40.0
45904,4,5904,[313 187 127 302 100],90,5,25071,4.245723962743438,0.0,40.0
45905,4,5905,[483 216 183  97 265],339,3,25074,4.245513037588893,20.0,0.0
45906,4,5906,[313 187 127 302 100],334,5,25079,4.245640765193838,0.0,40.0
45907,4,5907,[313 187 127 302 100],90,5,25084,4.245768449559919,0.0,40.0
45908,4,5908,[313 187 127 302 100],474,5,25089,4.2458960907090875,0.0,40.0
45909,4,5909,[313 187 127 302 100],271,5,25094,4.246023688663283,0.0,40.0
45910,4,5910,[313 187 127 302 100],537,5,25099,4.246151243444426,0.0,40.0
45911,4,5911,[313 187 127 302 100],474,5,25104,4.2462787550744245,0.0,40.0
45912,4,5912,[234  98 185 403 111],833,1,25105,4.245729748012853,0.0,20.0
45913,4,5913,[185 176 180 174  71],325,2,25107,4.245350016909029,0.0,20.0
45914,4,5914,[ 22 215 216 289 318],406,1,25108,4.24480135249366,20.0,0.0
45915,4,5915,[333 176 273  11 186],387,1,25109,4.244252873563219,0.0,0.0
45916,4,5916,[435 245 144 180 202],207,1,25110,4.24370458002366,0.0,0.0
45917,4,5917,[313 187 127 302 100],334,5,25115,4.243832375802636,0.0,40.0
45918,4,5918,[313 187 127 302 100],474,5,25120,4.243960128400068,0.0,40.0
45919,4,5919,[313 187 127 302 100],90,5,25125,4.244087837837838,0.0,40.0
45920,4,5920,[496 135 191 210  28],334,2,25127,4.243708832967404,0.0,0.0
45921,4,5921,[313 187 127 302 100],474,5,25132,4.243836541708882,0.0,40.0
45922,4,5922,[313 187 127 302 100],334,5,25137,4.243964207327368,0.0,40.0
45923,4,5923,[313 187 127 302 100],207,4,25141,4.243923024983119,0.0,40.0
45924,4,5924,[313 187 127 302 100],13,5,25146,4.244050632911392,0.0,40.0
45925,4,5925,[313 187 127 302 100],90,5,25151,4.244178197772528,0.0,40.0
45926,4,5926,[742 202 175  82 121],378,4,25155,4.2441370001687195,0.0,0.0
45927,4,5927,[313 187 127 302 100],271,5,25160,4.244264507422402,0.0,40.0
45928,4,5928,[186 204  79 655  25],194,3,25163,4.2440546466520495,0.0,0.0
45929,4,5929,[174 182 135 121  22],145,4,25167,4.244013490725126,0.0,20.0
45930,4,5930,[313 187 127 302 100],474,5,25172,4.244140954307874,0.0,40.0
45931,4,5931,[313 187 127 302 100],328,5,25177,4.244268374915712,0.0,40.0
45932,4,5932,[288 265 215 597 194],7,4,25181,4.244227203775493,0.0,0.0
45933,4,5933,[313 187 127 302 100],90,5,25186,4.2443545669025955,0.0,40.0
45934,4,5934,[313 187 127 302 100],207,4,25190,4.244313395113732,0.0,40.0
45935,4,5935,[179 288 143  56  25],308,5,25195,4.244440700808625,0.0,0.0
45936,4,5936,[313 187 127 302 100],144,4,25199,4.244399528381337,0.0,40.0
45937,4,5937,[313 187 127 302 100],334,5,25204,4.2445267766924895,0.0,40.0
45938,4,5938,[143 403 245 289 282],92,3,25207,4.244317225122074,0.0,0.0
45939,4,5939,[ 70  12 202 427  28],42,4,25211,4.244276094276095,20.0,0.0
45940,4,5940,[ 88 496 202  56  79],406,2,25213,4.24389833361387,0.0,0.0
45941,4,5941,[144 222  82 483 215],313,3,25216,4.243688993604847,20.0,0.0
45942,4,5942,[313 187 127 302 100],13,5,25221,4.243816254416961,0.0,40.0
45943,4,5943,[ 15 245 258 204  69],749,5,25226,4.2439434724091525,0.0,0.0
45944,4,5944,[313 187 127 302 100],13,5,25231,4.244070647603028,0.0,40.0
45945,4,5945,[313 187 127 302 100],13,5,25236,4.2441977800201816,0.0,40.0
45946,4,5946,[313 187 127 302 100],13,5,25241,4.244324869682193,0.0,40.0
45947,4,5947,[313 187 127 302 100],537,5,25246,4.244451916610625,0.0,40.0
45948,4,5948,[185 403  69 357 294],788,3,25249,4.2442427298705665,20.0,0.0
45949,4,5949,[313 187 127 302 100],328,5,25254,4.244369747899159,0.0,40.0
45950,4,5950,[546 313 210 222 333],13,1,25255,4.2438245672996135,0.0,0.0
45951,4,5951,[313 187 127 302 100],334,5,25260,4.243951612903226,0.0,40.0
45952,4,5952,[176 135 294 313 271],328,2,25262,4.243574668234504,0.0,0.0
45953,4,5953,[237  98 435  70 289],271,5,25267,4.243701713134027,0.0,20.0
45954,4,5954,[588  15 191 176  96],311,5,25272,4.24382871536524,0.0,0.0
45955,4,5955,[313 187 127 302 100],144,4,25276,4.243787777031565,0.0,40.0
45956,4,5956,[ 50 210 496 173 483],524,3,25279,4.243578982709417,20.0,20.0
45957,4,5957,[144 191 118 403 175],795,3,25282,4.2433702584759985,0.0,0.0
45958,4,5958,[258 597 748  97  50],533,2,25284,4.242993790904515,0.0,20.0
45959,4,5959,[313 187 127 302 100],328,5,25289,4.243120805369127,0.0,40.0
45960,4,5960,[313 187 127 302 100],328,5,25294,4.2432477772185875,0.0,40.0
45961,4,5961,[313 187 127 302 100],328,5,25299,4.243374706474338,0.0,40.0
45962,4,5962,[313 187 127 302 100],90,5,25304,4.243501593157807,0.0,40.0
45963,4,5963,[313 187 127 302 100],474,5,25309,4.243628437290409,0.0,40.0
45964,4,5964,[313 187 127 302 100],537,5,25314,4.243755238893546,0.0,40.0
45965,4,5965,[313 187 127 302 100],144,4,25318,4.243714381495139,0.0,40.0
45966,4,5966,[313 187 127 302 100],207,4,25322,4.243673537791185,0.0,40.0
45967,4,5967,[197  69  56  28 215],881,1,25323,4.243130026809651,0.0,0.0
45968,4,5968,[313 187 127 302 100],474,5,25328,4.243256826939186,0.0,40.0
45969,4,5969,[191 322 245 423 238],313,3,25331,4.243048576214405,0.0,0.0
45970,4,5970,[313 187 127 302 100],328,5,25336,4.243175347512979,0.0,40.0
45971,4,5971,[483 100 496 515 655],7,4,25340,4.243134628265238,20.0,20.0
45972,4,5972,[216 235  11 294 403],308,2,25342,4.242759082538088,0.0,0.0
45973,4,5973,[313 187 127 302 100],90,5,25347,4.242885838634081,0.0,40.0
45974,4,5974,[196 235 282 286   1],378,5,25352,4.243012552301256,0.0,0.0
45975,4,5975,[357 333 313 204 288],537,2,25354,4.242637215528782,20.0,0.0
45976,4,5976,[313 187 127 302 100],144,4,25358,4.242596620378116,0.0,40.0
45977,4,5977,[174   7 588 294   1],881,3,25361,4.242388758782202,0.0,20.0
45978,4,5978,[313 187 127 302 100],271,5,25366,4.242515470814517,0.0,40.0
45979,4,5979,[568 195 172 176  96],897,5,25371,4.242642140468227,0.0,0.0
45980,4,5980,[313 187 127 302 100],144,4,25375,4.2426015716435375,0.0,40.0
45981,4,5981,[313 187 127 302 100],207,4,25379,4.2425610163824805,0.0,40.0
45982,4,5982,[313 187 127 302 100],271,5,25384,4.242687614908909,0.0,40.0
45983,4,5983,[313 187 127 302 100],271,5,25389,4.242814171122995,0.0,40.0
45984,4,5984,[313 187 127 302 100],328,5,25394,4.242940685045948,0.0,40.0
45985,4,5985,[318 471 180 423 216],90,5,25399,4.243067156698964,20.0,0.0
45986,4,5986,[313 187 127 302 100],144,4,25403,4.24302655754134,0.0,40.0
45987,4,5987,[313 187 127 302 100],13,5,25408,4.243152972611891,0.0,40.0
45988,4,5988,[313 187 127 302 100],537,5,25413,4.243279345466689,0.0,40.0
45989,4,5989,[313 187 127 302 100],334,5,25418,4.243405676126878,0.0,40.0
45990,4,5990,[313 187 127 302 100],328,5,25423,4.243531964613587,0.0,40.0
45991,4,5991,[313 187 127 302 100],334,5,25428,4.24365821094793,0.0,40.0
45992,4,5992,[313 187 127 302 100],207,4,25432,4.243617553812782,0.0,40.0
45993,4,5993,[313 187 127 302 100],537,5,25437,4.243743743743743,0.0,40.0
45994,4,5994,[496 153 568 176 210],488,3,25440,4.243536280233528,0.0,0.0
45995,4,5995,[313 187 127 302 100],474,5,25445,4.243662441627752,0.0,40.0
45996,4,5996,[313 187 127 302 100],13,5,25450,4.243788560947141,0.0,40.0
45997,4,5997,[235   1  50 508 515],537,3,25453,4.243581193731243,0.0,20.0
45998,4,5998,[288 323 300 194 127],537,1,25454,4.243040506751125,0.0,20.0
45999,4,5999,[313 187 127 302 100],334,5,25459,4.243166666666666,0.0,40.0
46000,4,6000,[313 187 127 302 100],90,5,25464,4.24329278453591,0.0,40.0
46001,4,6001,[313 187 127 302 100],537,5,25469,4.243418860379873,0.0,40.0
46002,4,6002,[313 187 127 302 100],537,5,25474,4.243544894219557,0.0,40.0
46003,4,6003,[313 187 127 302 100],144,4,25478,4.243504330446369,0.0,40.0
46004,4,6004,[313 187 127 302 100],474,5,25483,4.243630308076603,0.0,40.0
46005,4,6005,[313 187 127 302 100],334,5,25488,4.243756243756244,0.0,40.0
46006,4,6006,[313 187 127 302 100],334,5,25493,4.243882137506243,0.0,40.0
46007,4,6007,[313 187 127 302 100],537,5,25498,4.244007989347536,0.0,40.0
46008,4,6008,[125  15  97  64 204],271,3,25501,4.243800965218838,0.0,0.0
46009,4,6009,[313 187 127 302 100],207,4,25505,4.243760399334443,0.0,40.0
46010,4,6010,[313 187 127 302 100],90,5,25510,4.243886208617535,0.0,40.0
46011,4,6011,[313 187 127 302 100],207,4,25514,4.2438456420492345,0.0,40.0
46012,4,6012,[216 237  96 588 235],398,3,25517,4.2436387826376185,0.0,0.0
46013,4,6013,[313 187 127 302 100],207,4,25521,4.243598270701696,0.0,40.0
46014,4,6014,[182  95 258 276  96],59,3,25524,4.243391521197007,0.0,0.0
46015,4,6015,[313 187 127 302 100],144,4,25528,4.243351063829787,0.0,40.0
46016,4,6016,[313 187 127 302 100],271,5,25533,4.243476815688881,0.0,40.0
46017,4,6017,[313 187 127 302 100],13,5,25538,4.2436025257560654,0.0,40.0
46018,4,6018,[313 187 127 302 100],90,5,25543,4.243728194052168,0.0,40.0
46019,4,6019,[ 28 234 328 423 288],13,3,25546,4.243521594684386,0.0,0.0
46020,4,6020,[313 187 127 302 100],474,5,25551,4.243647234678625,0.0,40.0
46021,4,6021,[313 187 127 302 100],13,5,25556,4.243772832945865,0.0,40.0
46022,4,6022,[144 180 196 211 238],308,3,25559,4.243566329071891,0.0,0.0
46023,4,6023,[313 187 127 302 100],474,5,25564,4.243691899070385,0.0,40.0
46024,4,6024,[313 187 127 302 100],474,5,25569,4.243817427385892,0.0,40.0
46025,4,6025,[313 187 127 302 100],334,5,25574,4.243942914039164,0.0,40.0
46026,4,6026,[313 187 127 302 100],144,4,25578,4.2439024390243905,0.0,40.0
46027,4,6027,[313 187 127 302 100],474,5,25583,4.244027869940279,0.0,40.0
46028,4,6028,[313 187 127 302 100],271,5,25588,4.244153259246973,0.0,40.0
46029,4,6029,[197 180 200 202 435],6,3,25591,4.243946932006634,0.0,0.0
46030,4,6030,[ 28 195 191 289 286],41,4,25595,4.243906483170287,0.0,0.0
46031,4,6031,[313 187 127 302 100],144,4,25599,4.2438660477453585,0.0,40.0
46032,4,6032,[200 195 245  56 237],749,3,25602,4.243659870711089,0.0,0.0
46033,4,6033,[313 187 127 302 100],144,4,25606,4.243619489559165,0.0,40.0
46034,4,6034,[265 111 238 483 294],234,1,25607,4.243082021541011,20.0,0.0
46035,4,6035,[357 597 151  15   7],308,3,25610,4.2428760768721006,20.0,0.0
46036,4,6036,[313 187 127 302 100],207,4,25614,4.242835845618685,0.0,40.0
46037,4,6037,[328 515 172 357 222],804,5,25619,4.242961245445512,20.0,0.0
46038,4,6038,[313 187 127 302 100],13,5,25624,4.243086603742341,0.0,40.0
46039,4,6039,[313 187 127 302 100],474,5,25629,4.243211920529801,0.0,40.0
46040,4,6040,[313 187 127 302 100],13,5,25634,4.243337195828505,0.0,40.0
46041,4,6041,[313 187 127 302 100],13,5,25639,4.243462429659053,0.0,40.0
46042,4,6042,[265 186 172  11 300],7,4,25643,4.243422141320536,0.0,0.0
46043,4,6043,[313 187 127 302 100],537,5,25648,4.243547319655857,0.0,40.0
46044,4,6044,[ 89 238 135 222 174],488,4,25652,4.243507030603805,0.0,20.0
46045,4,6045,[288 202 423 257   9],533,4,25656,4.243466754879259,0.0,0.0
46046,4,6046,[313 187 127 302 100],334,5,25661,4.243591863734083,0.0,40.0
46047,4,6047,[313 187 127 302 100],537,5,25666,4.243716931216931,0.0,40.0
46048,4,6048,[313 187 127 302 100],13,5,25671,4.243841957348322,0.0,40.0
46049,4,6049,[313 187 127 302 100],207,4,25675,4.243801652892562,0.0,40.0
46050,4,6050,[180   1 181 300  69],271,3,25678,4.243596099818212,0.0,0.0
46051,4,6051,[195 302  70 313 186],328,4,25682,4.243555849306015,0.0,0.0
46052,4,6052,[191 302 195 318  88],474,5,25687,4.243680819428382,20.0,0.0
46053,4,6053,[313 187 127 302 100],13,5,25692,4.2438057482656095,0.0,40.0
46054,4,6054,[ 82  98 496   1 318],125,5,25697,4.24393063583815,20.0,20.0
46055,4,6055,[313 187 127 302 100],13,5,25702,4.244055482166447,0.0,40.0
46056,4,6056,[127 238 483 180 185],694,4,25706,4.244015189037477,20.0,20.0
46057,4,6057,[234 211 333  98 515],85,4,25710,4.24397490921096,0.0,20.0
46058,4,6058,[313 187 127 302 100],144,4,25714,4.24393464268031,0.0,40.0
46059,4,6059,[313 187 127 302 100],207,4,25718,4.243894389438944,0.0,40.0
46060,4,6060,[597 174 385 195 117],92,4,25722,4.243854149480284,0.0,20.0
46061,4,6061,[197 187 588 174 228],664,4,25726,4.243813922797757,0.0,20.0
46062,4,6062,[423 275 151 301 238],334,4,25730,4.243773709384793,0.0,0.0
46063,4,6063,[313 187 127 302 100],13,5,25735,4.243898416886544,0.0,40.0
46064,4,6064,[313 187 127 302 100],144,4,25739,4.243858202802968,0.0,40.0
46065,4,6065,[313 187 127 302 100],207,4,25743,4.243818001978239,0.0,40.0
46066,4,6066,[313 187 127 302 100],328,5,25748,4.243942640514257,0.0,40.0
46067,4,6067,[313 187 127 302 100],144,4,25752,4.2439024390243905,0.0,40.0
46068,4,6068,[313 187 127 302 100],13,5,25757,4.244027022573736,0.0,40.0
46069,4,6069,[313 187 127 302 100],13,5,25762,4.2441515650741355,0.0,40.0
46070,4,6070,[ 82 258 228 181 183],843,3,25765,4.243946631526931,0.0,0.0
46071,4,6071,[313 187 127 302 100],13,5,25770,4.2440711462450595,0.0,40.0
46072,4,6072,[313 187 127 302 100],13,5,25775,4.244195619957187,0.0,40.0
46073,4,6073,[313 187 127 302 100],328,5,25780,4.24432005268357,0.0,40.0
46074,4,6074,[313 187 127 302 100],271,5,25785,4.2444444444444445,0.0,40.0
46075,4,6075,[313 187 127 302 100],334,5,25790,4.244568795260039,0.0,40.0
46076,4,6076,[161 238 546 181 508],774,1,25791,4.244034885634359,0.0,0.0
46077,4,6077,[322 588 228  89  22],454,1,25792,4.243501151694637,0.0,0.0
46078,4,6078,[313 187 127 302 100],537,5,25797,4.243625596315184,0.0,40.0
46079,4,6079,[ 12 423 288 405  98],374,4,25801,4.24358552631579,20.0,20.0
46080,4,6080,[313 187 127 302 100],207,4,25805,4.243545469495149,0.0,40.0
46081,4,6081,[313 187 127 302 100],474,5,25810,4.243669845445577,0.0,40.0
46082,4,6082,[313 187 127 302 100],144,4,25814,4.243629787933585,0.0,40.0
46083,4,6083,[313 187 127 302 100],328,5,25819,4.243754109138725,0.0,40.0
46084,4,6084,[313 187 127 302 100],90,5,25824,4.243878389482334,0.0,40.0
46085,4,6085,[197 318   1 153 174],308,4,25828,4.243838317449885,20.0,20.0
46086,4,6086,[313 187 127 302 100],13,5,25833,4.243962543124692,0.0,40.0
46087,4,6087,[313 187 127 302 100],271,5,25838,4.244086727989488,0.0,40.0
46088,4,6088,[313 187 127 302 100],144,4,25842,4.244046641484644,0.0,40.0
46089,4,6089,[313 187 127 302 100],334,5,25847,4.244170771756979,0.0,40.0
46090,4,6090,[228 678 286 194 258],13,3,25850,4.2439665079625675,0.0,0.0
46091,4,6091,[313 187 127 302 100],207,4,25854,4.243926460932371,0.0,40.0
46092,4,6092,[168 161 357  50 125],899,4,25858,4.243886427047432,20.0,20.0
46093,4,6093,[313 187 127 302 100],334,5,25863,4.2440105021332455,0.0,40.0
46094,4,6094,[313 187 127 302 100],328,5,25868,4.2441345365053325,0.0,40.0
46095,4,6095,[313 187 127 302 100],144,4,25872,4.244094488188976,0.0,40.0
46096,4,6096,[313 187 127 302 100],13,5,25877,4.244218468099065,0.0,40.0
46097,4,6097,[313 187 127 302 100],90,5,25882,4.244342407346671,0.0,40.0
46098,4,6098,[313 187 127 302 100],474,5,25887,4.2444663059517955,0.0,40.0
46099,4,6099,[313 187 127 302 100],13,5,25892,4.244590163934427,0.0,40.0
46100,4,6100,[313 187 127 302 100],90,5,25897,4.244713981314539,0.0,40.0
46101,4,6101,[313 187 127 302 100],13,5,25902,4.244837758112094,0.0,40.0
46102,4,6102,[ 71 185 289  98 215],454,1,25903,4.244306078977552,0.0,20.0
46103,4,6103,[313 187 127 302 100],13,5,25908,4.244429882044561,0.0,40.0
46104,4,6104,[313 187 127 302 100],90,5,25913,4.244553644553645,0.0,40.0
46105,4,6105,[313 187 127 302 100],207,4,25917,4.244513593187029,0.0,40.0
46106,4,6106,[313 187 127 302 100],271,5,25922,4.244637301457344,0.0,40.0
46107,4,6107,[191 197 161  56 275],474,4,25926,4.244597249508841,0.0,0.0
46108,4,6108,[313 187 127 302 100],474,5,25931,4.2447209035848745,0.0,40.0
46109,4,6109,[313 187 127 302 100],328,5,25936,4.2448445171849425,0.0,40.0
46110,4,6110,[210 245 289 427  97],533,2,25938,4.244477172312224,0.0,0.0
46111,4,6111,[222 200 742 265 405],145,4,25942,4.2444371727748695,0.0,0.0
46112,4,6112,[471  64 210 301 357],537,1,25943,4.24390642892197,20.0,0.0
46113,4,6113,[313 187 127 302 100],537,5,25948,4.244030094864246,0.0,40.0
46114,4,6114,[ 12 194 496 185 258],7,5,25953,4.244153720359771,20.0,0.0
46115,4,6115,[ 70 275 288   9 202],533,4,25957,4.244113799869195,0.0,0.0
46116,4,6116,[313 187 127 302 100],474,5,25962,4.2442373712604216,0.0,40.0
46117,4,6117,[313 187 127 302 100],207,4,25966,4.244197450147107,0.0,40.0
46118,4,6118,[313 187 127 302 100],13,5,25971,4.244320967478346,0.0,40.0
46119,4,6119,[313 187 127 302 100],90,5,25976,4.2444444444444445,0.0,40.0
46120,4,6120,[313 187 127 302 100],328,5,25981,4.244567881065185,0.0,40.0
46121,4,6121,[313 187 127 302 100],537,5,25986,4.24469127736034,0.0,40.0
46122,4,6122,[ 82  15 423 176  22],653,2,25988,4.244324677445697,0.0,0.0
46123,4,6123,[313 187 127 302 100],474,5,25993,4.244448073154801,0.0,40.0
46124,4,6124,[196   4 135 215 200],378,2,25995,4.244081632653061,0.0,0.0
46125,4,6125,[313 187 127 302 100],334,5,26000,4.244205027750572,0.0,40.0
46126,4,6126,[ 12 282 127 200 202],374,4,26004,4.244165170556553,20.0,20.0
46127,4,6127,[313 187 127 302 100],334,5,26009,4.244288511749347,0.0,40.0
46128,4,6128,[313 187 127 302 100],271,5,26014,4.244411812693751,0.0,40.0
46129,4,6129,[186 182 300   1 181],380,1,26015,4.2438825448613375,0.0,0.0
46130,4,6130,[313 187 127 302 100],271,5,26020,4.244005871799054,0.0,40.0
46131,4,6131,[ 97 125 151   7 191],378,3,26023,4.243803000652315,0.0,0.0
46132,4,6132,[313 187 127 302 100],207,4,26027,4.243763248002609,0.0,40.0
46133,4,6133,[313 187 127 302 100],537,5,26032,4.2438865340723835,0.0,40.0
46134,4,6134,[313 187 127 302 100],271,5,26037,4.2440097799511,0.0,40.0
46135,4,6135,[313 187 127 302 100],207,4,26041,4.24397001303781,0.0,40.0
46136,4,6136,[215 185  69 237 483],328,4,26045,4.243930259084243,20.0,0.0
46137,4,6137,[313 187 127 302 100],474,5,26050,4.244053437601825,0.0,40.0
46138,4,6138,[313 187 127 302 100],207,4,26054,4.244013683010262,0.0,40.0
46139,4,6139,[215  97 161 234  98],378,5,26059,4.24413680781759,0.0,20.0
46140,4,6140,[313 187 127 302 100],474,5,26064,4.244259892525648,0.0,40.0
46141,4,6141,[313 187 127 302 100],13,5,26069,4.244382937154022,0.0,40.0
46142,4,6142,[313 187 127 302 100],271,5,26074,4.244505941722285,0.0,40.0
46143,4,6143,[ 56  96  88 228 237],892,4,26078,4.244466145833333,0.0,0.0
46144,4,6144,[ 97 100 144 172 546],804,4,26082,4.244426362896664,0.0,20.0
46145,4,6145,[313 187 127 302 100],474,5,26087,4.244549300357956,0.0,40.0
46146,4,6146,[ 98  97 195 127 175],843,2,26089,4.244184154872295,0.0,40.0
46147,4,6147,[313 187 127 302 100],144,4,26093,4.244144437215355,0.0,40.0
46148,4,6148,[187  95 273 313 161],102,1,26094,4.243616848268011,0.0,0.0
46149,4,6149,[313 187 127 302 100],537,5,26099,4.243739837398374,0.0,40.0
46150,4,6150,[313 187 127 302 100],207,4,26103,4.243700211347749,0.0,40.0
46151,4,6151,[313 187 127 302 100],328,5,26108,4.2438231469440835,0.0,40.0
46152,4,6152,[313 187 127 302 100],271,5,26113,4.243946042580855,0.0,40.0
46153,4,6153,[175 678 174 111 183],537,1,26114,4.243418914527137,0.0,20.0
46154,4,6154,[302 234 215 603 117],90,3,26117,4.243216896831844,20.0,0.0
46155,4,6155,[289 301 216 238 423],524,5,26122,4.24333983105913,0.0,0.0
46156,4,6156,[471 168 179  82 588],95,2,26124,4.242975475069027,0.0,0.0
46157,4,6157,[313 186 234  71 435],59,4,26128,4.242936018187724,0.0,0.0
46158,4,6158,[313 187 127 302 100],207,4,26132,4.242896574119175,0.0,40.0
46159,4,6159,[313 187 127 302 100],328,5,26137,4.2430194805194805,0.0,40.0
46160,4,6160,[313 187 127 302 100],144,4,26141,4.242980035708489,0.0,40.0
46161,4,6161,[313 187 127 302 100],474,5,26146,4.243102888672509,0.0,40.0
46162,4,6162,[ 79 172 265 289 202],194,1,26147,4.242576667207529,0.0,0.0
46163,4,6163,[313 187 127 302 100],13,5,26152,4.242699545749513,0.0,40.0
46164,4,6164,[313 187 127 302 100],207,4,26156,4.242660178426601,0.0,40.0
46165,4,6165,[313 187 127 302 100],207,4,26160,4.242620823872851,0.0,40.0
46166,4,6166,[313 187 127 302 100],474,5,26165,4.2427436354791634,0.0,40.0
46167,4,6167,[313 187 127 302 100],144,4,26169,4.242704280155642,0.0,40.0
46168,4,6168,[313 187 127 302 100],13,5,26174,4.242827038417896,0.0,40.0
46169,4,6169,[313 187 127 302 100],90,5,26179,4.2429497568881684,0.0,40.0
46170,4,6170,[313 187 127 302 100],537,5,26184,4.2430724355858045,0.0,40.0
46171,4,6171,[313 187 127 302 100],334,5,26189,4.243195074530136,0.0,40.0
46172,4,6172,[313 187 127 302 100],144,4,26193,4.243155677952373,0.0,40.0
46173,4,6173,[313 187 127 302 100],13,5,26198,4.243278263686427,0.0,40.0
46174,4,6174,[313  96 196 333 172],144,4,26202,4.243238866396761,0.0,0.0
46175,4,6175,[187 173 183 179 168],537,4,26206,4.243199481865285,0.0,0.0
46176,4,6176,[175 180 194  28 405],474,5,26211,4.243322000971346,0.0,0.0
46177,4,6177,[313 187 127 302 100],537,5,26216,4.243444480414373,0.0,40.0
46178,4,6178,[313 187 127 302 100],328,5,26221,4.243566920213627,0.0,40.0
46179,4,6179,[  4 135 222 215 333],653,2,26223,4.243203883495146,0.0,0.0
46180,4,6180,[313 187 127 302 100],207,4,26227,4.2431645364827695,0.0,40.0
46181,4,6181,[313 187 127 302 100],90,5,26232,4.243286962148172,0.0,40.0
46182,4,6182,[313 187 127 302 100],328,5,26237,4.243409348212841,0.0,40.0
46183,4,6183,[313 187 127 302 100],207,4,26241,4.24336998706339,0.0,40.0
46184,4,6184,[288 515 173  11 301],13,0,26241,4.242683912691997,0.0,0.0
46185,4,6185,[197 168 603 222 125],533,5,26246,4.242806336889751,20.0,0.0
46186,4,6186,[313 187 127 302 100],13,5,26251,4.2429287215128495,0.0,40.0
46187,4,6187,[211 180  96 182 186],804,5,26256,4.243051066580478,0.0,0.0
46188,4,6188,[313 187 127 302 100],328,5,26261,4.243173372111811,0.0,40.0
46189,4,6189,[313 187 127 302 100],90,5,26266,4.24329563812601,0.0,40.0
46190,4,6190,[313 187 127 302 100],144,4,26270,4.243256339848167,0.0,40.0
46191,4,6191,[423 742   9 385 245],749,3,26273,4.243055555555555,0.0,0.0
46192,4,6192,[357 216 385 423 172],60,5,26278,4.243177781366058,20.0,0.0
46193,4,6193,[121  50 153  22 175],749,3,26281,4.242977074588311,0.0,20.0
46194,4,6194,[313 187 127 302 100],334,5,26286,4.243099273607748,0.0,40.0
46195,4,6195,[313 187 127 302 100],13,5,26291,4.243221433182699,0.0,40.0
46196,4,6196,[313 187 127 302 100],537,5,26296,4.243343553332258,0.0,40.0
46197,4,6197,[313 187 127 302 100],207,4,26300,4.243304291707002,0.0,40.0
46198,4,6198,[ 11 475 187 357  79],13,1,26301,4.242781093724794,20.0,0.0
46199,4,6199,[313 187 127 302 100],328,5,26306,4.242903225806452,0.0,40.0
46200,4,6200,[313 187 127 302 100],328,5,26311,4.243025318497017,0.0,40.0
46201,4,6201,[  8 588 357  97 216],840,4,26315,4.242986133505321,20.0,0.0
46202,4,6202,[289  89  96 153 427],454,2,26317,4.242624536514589,0.0,0.0
46203,4,6203,[313 187 127 302 100],90,5,26322,4.24274661508704,0.0,40.0
46204,4,6204,[313 187 127 302 100],271,5,26327,4.24286865431104,0.0,40.0
46205,4,6205,[313 187 127 302 100],271,5,26332,4.242990654205608,0.0,40.0
46206,4,6206,[182 318 237 200 175],326,1,26333,4.24246818108587,20.0,0.0
46207,4,6207,[ 11  15 179 546 323],200,3,26336,4.242268041237113,0.0,0.0
46208,4,6208,[313 187 127 302 100],474,5,26341,4.2423900789177,0.0,40.0
46209,4,6209,[215  70  79 100 271],64,4,26345,4.2423510466988725,0.0,20.0
46210,4,6210,[313 187 127 302 100],144,4,26349,4.242312027048785,0.0,40.0
46211,4,6211,[313 187 127 302 100],328,5,26354,4.24243399871217,0.0,40.0
46212,4,6212,[313 187 127 302 100],537,5,26359,4.242555931112184,0.0,40.0
46213,4,6213,[313 187 127 302 100],207,4,26363,4.2425168973286125,0.0,40.0
46214,4,6214,[313 187 127 302 100],474,5,26368,4.2426387771520515,0.0,40.0
46215,4,6215,[313 187 127 302 100],474,5,26373,4.242760617760617,0.0,40.0
46216,4,6216,[172  12 181 357 475],14,3,26376,4.242560720604794,40.0,0.0
46217,4,6217,[313 187 127 302 100],537,5,26381,4.2426825345770345,0.0,40.0
46218,4,6218,[194 132  96 183 182],398,5,26386,4.242804309374497,0.0,0.0
46219,4,6219,[313 187 127 302 100],13,5,26391,4.242926045016077,0.0,40.0
46220,4,6220,[313 187 127 302 100],90,5,26396,4.243047741520656,0.0,40.0
46221,4,6221,[216 135  79 161 269],659,3,26399,4.242847958855673,0.0,0.0
46222,4,6222,[ 95   1  79 180 427],882,5,26404,4.2429696287964,0.0,0.0
46223,4,6223,[313 187 127 302 100],474,5,26409,4.243091259640103,0.0,40.0
46224,4,6224,[313 187 127 302 100],271,5,26414,4.243212851405622,0.0,40.0
46225,4,6225,[313 187 127 302 100],474,5,26419,4.243334404111789,0.0,40.0
46226,4,6226,[313 427 237 235 678],13,3,26422,4.243134735827846,0.0,0.0
46227,4,6227,[313 187 127 302 100],90,5,26427,4.243256262042389,0.0,40.0
46228,4,6228,[313 187 127 302 100],334,5,26432,4.243377749237438,0.0,40.0
46229,4,6229,[313 187 127 302 100],474,5,26437,4.243499197431782,0.0,40.0
46230,4,6230,[313 187 127 302 100],207,4,26441,4.243460118761034,0.0,40.0
46231,4,6231,[ 96 174 135 655 204],833,2,26443,4.243100128369705,0.0,20.0
46232,4,6232,[568 318  11  15 182],59,5,26448,4.243221562650409,20.0,0.0
46233,4,6233,[323  70 294 357 176],648,2,26450,4.2428617260186074,20.0,0.0
46234,4,6234,[313 187 127 302 100],13,5,26455,4.242983159582999,0.0,40.0
46235,4,6235,[597  50 273 271 191],13,1,26456,4.242463117382938,0.0,20.0
46236,4,6236,[313 187 127 302 100],334,5,26461,4.242584575917909,0.0,40.0
46237,4,6237,[313 187 127 302 100],207,4,26465,4.2425456877204235,0.0,40.0
46238,4,6238,[265 111  11 483 238],59,5,26470,4.242667094085591,20.0,0.0
46239,4,6239,[313 187 127 302 100],271,5,26475,4.242788461538462,0.0,40.0
46240,4,6240,[313 187 127 302 100],474,5,26480,4.242909790097741,0.0,40.0
46241,4,6241,[313 187 127 302 100],474,5,26485,4.243031079782121,0.0,40.0
46242,4,6242,[ 64  95 186 286 100],13,4,26489,4.2429921512093545,0.0,20.0
46243,4,6243,[313 187 127 302 100],537,5,26494,4.243113388853299,0.0,40.0
46244,4,6244,[313 187 127 302 100],328,5,26499,4.243234587670136,0.0,40.0
46245,4,6245,[313 187 127 302 100],537,5,26504,4.243355747678514,0.0,40.0
46246,4,6246,[204  97 118 496 196],254,5,26509,4.243476868897071,0.0,0.0
46247,4,6247,[313 187 127 302 100],13,5,26514,4.24359795134443,0.0,40.0
46248,4,6248,[313 187 127 302 100],207,4,26518,4.243558969435109,0.0,40.0
46249,4,6249,[313 187 127 302 100],474,5,26523,4.24368,0.0,40.0
46250,4,6250,[313 187 127 302 100],271,5,26528,4.243800991841305,0.0,40.0
46251,4,6251,[313 187 127 302 100],90,5,26533,4.2439219449776076,0.0,40.0
46252,4,6252,[313 187 127 302 100],537,5,26538,4.244042859427474,0.0,40.0
46253,4,6253,[313 187 127 302 100],537,5,26543,4.244163735209466,0.0,40.0
46254,4,6254,[313 187 127 302 100],90,5,26548,4.244284572342126,0.0,40.0
46255,4,6255,[197 179 228 427 125],194,3,26551,4.244085677749361,0.0,0.0
46256,4,6256,[313 187 127 302 100],334,5,26556,4.24420648873262,0.0,40.0
46257,4,6257,[313 187 127 302 100],474,5,26561,4.244327261105784,0.0,40.0
46258,4,6258,[508  97  98 127 174],455,5,26566,4.244447994887362,0.0,60.0
46259,4,6259,[313 187 127 302 100],144,4,26570,4.244408945686901,0.0,40.0
46260,4,6260,[313 187 127 302 100],474,5,26575,4.244529627854975,0.0,40.0
46261,4,6261,[313 187 127 302 100],474,5,26580,4.24465027147876,0.0,40.0
46262,4,6262,[313 187 127 302 100],207,4,26584,4.244611208685933,0.0,40.0
46263,4,6263,[313 187 127 302 100],13,5,26589,4.244731800766283,0.0,40.0
46264,4,6264,[313 187 127 302 100],13,5,26594,4.244852354349561,0.0,40.0
46265,4,6265,[216 235 173 181  11],804,5,26599,4.244972869454197,0.0,0.0
46266,4,6266,[127 483 176 288 301],650,2,26601,4.244614648157013,20.0,20.0
46267,4,6267,[289 275 135  89 168],524,2,26603,4.244256541161455,0.0,0.0
46268,4,6268,[313 187 127 302 100],13,5,26608,4.244377093635348,0.0,40.0
46269,4,6269,[313 187 127 302 100],334,5,26613,4.244497607655503,0.0,40.0
46270,4,6270,[313 187 127 302 100],271,5,26618,4.244618083240312,0.0,40.0
46271,4,6271,[313 187 127 302 100],207,4,26622,4.244579081632653,0.0,40.0
46272,4,6272,[313 187 127 302 100],474,5,26627,4.244699505818588,0.0,40.0
46273,4,6273,[313 187 127 302 100],537,5,26632,4.244819891616194,0.0,40.0
46274,4,6274,[313 187 127 302 100],328,5,26637,4.2449402390438244,0.0,40.0
46275,4,6275,[313 187 127 302 100],328,5,26642,4.245060548119821,0.0,40.0
46276,4,6276,[313 187 127 302 100],13,5,26647,4.245180818862514,0.0,40.0
46277,4,6277,[313 187 127 302 100],13,5,26652,4.24530105129022,0.0,40.0
46278,4,6278,[313 187 127 302 100],207,4,26656,4.245261984392419,0.0,40.0
46279,4,6279,[161   1 282 245 180],533,3,26659,4.2450636942675155,0.0,0.0
46280,4,6280,[313 187 127 302 100],328,5,26664,4.245183887915937,0.0,40.0
46281,4,6281,[313 187 127 302 100],334,5,26669,4.2453040432983125,0.0,40.0
46282,4,6282,[313 187 127 302 100],13,5,26674,4.245424160432914,0.0,40.0
46283,4,6283,[313 187 127 302 100],334,5,26679,4.245544239338002,0.0,40.0
46284,4,6284,[195   9 318 282  96],788,3,26682,4.245346062052506,20.0,0.0
46285,4,6285,[313 187 127 302 100],207,4,26686,4.245307031498569,0.0,40.0
46286,4,6286,[282 423 496 257 172],899,5,26691,4.245427071735327,0.0,0.0
46287,4,6287,[ 56 234 186 185  95],524,3,26694,4.245229007633588,0.0,0.0
46288,4,6288,[427 127  98   4 176],339,5,26699,4.245349022102083,0.0,40.0
46289,4,6289,[313 187 127 302 100],334,5,26704,4.245468998410175,0.0,40.0
46290,4,6290,[180  98 125 275 655],899,3,26707,4.245271022095056,0.0,20.0
46291,4,6291,[143 423 403  22 216],308,4,26711,4.245232040686586,0.0,0.0
46292,4,6292,[313 187 127 302 100],334,5,26716,4.245351978388686,0.0,40.0
46293,4,6293,[313 187 127 302 100],474,5,26721,4.2454718779790275,0.0,40.0
46294,4,6294,[117  28 175  56 222],447,3,26724,4.24527402700556,0.0,0.0
46295,4,6295,[313 187 127 302 100],13,5,26729,4.245393900889454,0.0,40.0
46296,4,6296,[111  82 245 127 323],83,3,26732,4.245196125138955,0.0,20.0
46297,4,6297,[313 187 127 302 100],271,5,26737,4.245315973324865,0.0,40.0
46298,4,6298,[ 97  89 144 385 597],788,2,26739,4.244959517383712,0.0,0.0
46299,4,6299,[313 187 127 302 100],334,5,26744,4.2450793650793655,0.0,40.0
46300,4,6300,[313 187 127 302 100],90,5,26749,4.245199174734169,0.0,40.0
46301,4,6301,[655 222 185  82   4],64,3,26752,4.245001586797842,0.0,0.0
46302,4,6302,[385  79 194  28 313],85,3,26755,4.244804061557988,0.0,0.0
46303,4,6303,[179 234  79 204 237],271,5,26760,4.24492385786802,0.0,0.0
46304,4,6304,[313 187 127 302 100],474,5,26765,4.245043616177637,0.0,40.0
46305,4,6305,[313 187 127 302 100],271,5,26770,4.245163336504916,0.0,40.0
46306,4,6306,[313 187 127 302 100],271,5,26775,4.245283018867925,0.0,40.0
46307,4,6307,[313 187 127 302 100],90,5,26780,4.245402663284718,0.0,40.0
46308,4,6308,[313 187 127 302 100],144,4,26784,4.245363766048502,0.0,40.0
46309,4,6309,[ 56  79 238 187  22],234,2,26786,4.245007923930269,0.0,0.0
46310,4,6310,[313 187 127 302 100],90,5,26791,4.245127555062589,0.0,40.0
46311,4,6311,[258  25 121 151 496],533,4,26795,4.245088719898606,0.0,0.0
46312,4,6312,[313 187 127 302 100],328,5,26800,4.245208300332647,0.0,40.0
46313,4,6313,[385 176  64 100 196],378,5,26805,4.245327842888819,0.0,20.0
46314,4,6314,[ 89 143 174  11 215],537,1,26806,4.244813935075218,0.0,20.0
46315,4,6315,[313 187 127 302 100],90,5,26811,4.244933502216592,0.0,40.0
46316,4,6316,[313 187 127 302 100],13,5,26816,4.245053031502295,0.0,40.0
46317,4,6317,[313 187 127 302 100],537,5,26821,4.245172522950301,0.0,40.0
46318,4,6318,[ 50 179 144  82 546],7,4,26825,4.245133723690457,0.0,20.0
46319,4,6319,[168 222 385 288   8],488,3,26828,4.2449367088607595,0.0,0.0
46320,4,6320,[313 187 127 302 100],144,4,26832,4.244897959183674,0.0,40.0
46321,4,6321,[216 151 483 405 265],95,2,26834,4.244542866181588,20.0,0.0
46322,4,6322,[ 69 655  22 235 276],184,1,26835,4.244029732721809,0.0,0.0
46323,4,6323,[313 187 127 302 100],334,5,26840,4.244149272612271,0.0,40.0
46324,4,6324,[313 187 127 302 100],90,5,26845,4.244268774703557,0.0,40.0
46325,4,6325,[313 187 127 302 100],271,5,26850,4.2443882390135945,0.0,40.0
46326,4,6326,[313 187 127 302 100],271,5,26855,4.244507665560297,0.0,40.0
46327,4,6327,[313 187 127 302 100],474,5,26860,4.244627054361568,0.0,40.0
46328,4,6328,[ 70  95 185 186 423],271,4,26864,4.244588402591247,0.0,0.0
46329,4,6329,[313 187 127 302 100],334,5,26869,4.2447077409162715,0.0,40.0
46330,4,6330,[ 15 180 603   7 132],308,3,26872,4.244511135681567,20.0,0.0
46331,4,6331,[313 187 127 302 100],328,5,26877,4.244630448515477,0.0,40.0
46332,4,6332,[ 56 568 118 286 144],102,0,26877,4.243960208432023,0.0,0.0
46333,4,6333,[313 187 127 302 100],13,5,26882,4.244079570571519,0.0,40.0
46334,4,6334,[313 187 127 302 100],334,5,26887,4.244198895027624,0.0,40.0
46335,4,6335,[313 187 127 302 100],144,4,26891,4.244160353535354,0.0,40.0
46336,4,6336,[313 187 127 302 100],271,5,26896,4.244279627584031,0.0,40.0
46337,4,6337,[313 187 127 302 100],328,5,26901,4.2443988639949515,0.0,40.0
46338,4,6338,[176 318  64 187 655],13,3,26904,4.24420255560814,20.0,0.0
46339,4,6339,[313 187 127 302 100],334,5,26909,4.244321766561514,0.0,40.0
46340,4,6340,[313 187 127 302 100],207,4,26913,4.244283236082637,0.0,40.0
46341,4,6341,[313 187 127 302 100],537,5,26918,4.244402396720277,0.0,40.0
46342,4,6342,[313 187 127 302 100],537,5,26923,4.24452151978559,0.0,40.0
46343,4,6343,[313 187 127 302 100],90,5,26928,4.244640605296343,0.0,40.0
46344,4,6344,[132 678 127 187 181],339,4,26932,4.244602048857368,0.0,20.0
46345,4,6345,[313 187 127 302 100],271,5,26937,4.2447210841474945,0.0,40.0
46346,4,6346,[313 187 127 302 100],144,4,26941,4.2446825271781945,0.0,40.0
46347,4,6347,[197 121 216 183 181],694,5,26946,4.244801512287334,0.0,0.0
46348,4,6348,[202 215 183 143  82],694,4,26950,4.244762954796031,0.0,0.0
46349,4,6349,[313 187 127 302 100],144,4,26954,4.244724409448819,0.0,40.0
46350,4,6350,[313 187 127 302 100],537,5,26959,4.244843331758778,0.0,40.0
46351,4,6351,[313 187 127 302 100],13,5,26964,4.244962216624685,0.0,40.0
46352,4,6352,[313 187 127 302 100],207,4,26968,4.244923658114277,0.0,40.0
46353,4,6353,[ 70  79 423 186 234],659,4,26972,4.244885111740635,0.0,0.0
46354,4,6354,[313 187 127 302 100],90,5,26977,4.245003933910307,0.0,40.0
46355,4,6355,[313 187 127 302 100],207,4,26981,4.2449653870358715,0.0,40.0
46356,4,6356,[196  98 597 294 475],308,1,26982,4.244454931571496,0.0,20.0
46357,4,6357,[313 187 127 302 100],90,5,26987,4.244573765335011,0.0,40.0
46358,4,6358,[313 187 127 302 100],13,5,26992,4.244692561723541,0.0,40.0
46359,4,6359,[313 187 127 302 100],474,5,26997,4.244811320754717,0.0,40.0
46360,4,6360,[313 187 127 302 100],13,5,27002,4.244930042446156,0.0,40.0
46361,4,6361,[ 88 216 117  79 405],145,4,27006,4.244891543539767,0.0,0.0
46362,4,6362,[183 313  82 194  15],234,3,27009,4.244695898161245,0.0,0.0
46363,4,6363,[313 187 127 302 100],474,5,27014,4.244814582023884,0.0,40.0
46364,4,6364,[313 187 127 302 100],271,5,27019,4.244933228593872,0.0,40.0
46365,4,6365,[313 187 127 302 100],474,5,27024,4.245051837888784,0.0,40.0
46366,4,6366,[313 187 127 302 100],328,5,27029,4.245170409926182,0.0,40.0
46367,4,6367,[313 187 127 302 100],334,5,27034,4.245288944723618,0.0,40.0
46368,4,6368,[313 187 127 302 100],90,5,27039,4.245407442298634,0.0,40.0
46369,4,6369,[313 187 127 302 100],537,5,27044,4.24552590266876,0.0,40.0
46370,4,6370,[313 187 127 302 100],537,5,27049,4.245644325851515,0.0,40.0
46371,4,6371,[313 187 127 302 100],13,5,27054,4.245762711864407,0.0,40.0
46372,4,6372,[313 187 127 302 100],13,5,27059,4.245881060724933,0.0,40.0
46373,4,6373,[313 187 127 302 100],271,5,27064,4.245999372450581,0.0,40.0
46374,4,6374,[313 187 127 302 100],13,5,27069,4.246117647058823,0.0,40.0
46375,4,6375,[313 187 127 302 100],271,5,27074,4.246235884567127,0.0,40.0
46376,4,6376,[322 191 197 294 288],533,4,27078,4.246197271444252,0.0,0.0
46377,4,6377,[313 187 127 302 100],144,4,27082,4.246158670429602,0.0,40.0
46378,4,6378,[ 69 286 655 197 471],378,2,27084,4.2458065527512145,0.0,0.0
46379,4,6379,[313 187 127 302 100],207,4,27088,4.24576802507837,0.0,40.0
46380,4,6380,[313 187 127 302 100],474,5,27093,4.2458862247296665,0.0,40.0
46381,4,6381,[313 187 127 302 100],271,5,27098,4.246004387339392,0.0,40.0
46382,4,6382,[313 187 127 302 100],144,4,27102,4.245965846780511,0.0,40.0
46383,4,6383,[313 187 127 302 100],207,4,27106,4.245927318295739,0.0,40.0
46384,4,6384,[313 187 127 302 100],328,5,27111,4.246045418950666,0.0,40.0
46385,4,6385,[313 187 127 302 100],271,5,27116,4.246163482618227,0.0,40.0
46386,4,6386,[313 187 127 302 100],13,5,27121,4.246281509315797,0.0,40.0
46387,4,6387,[313 187 127 302 100],207,4,27125,4.246242955541641,0.0,40.0
46388,4,6388,[742 174  15 186   9],648,3,27128,4.24604789481922,0.0,20.0
46389,4,6389,[313 187 127 302 100],537,5,27133,4.2461658841940535,0.0,40.0
46390,4,6390,[161 132 174  22  82],897,5,27138,4.246283836645283,0.0,20.0
46391,4,6391,[313 187 127 302 100],474,5,27143,4.246401752190238,0.0,40.0
46392,4,6392,[313 187 127 302 100],328,5,27148,4.2465196308462385,0.0,40.0
46393,4,6393,[313 187 127 302 100],537,5,27153,4.246637472630591,0.0,40.0
46394,4,6394,[174  15 202 117 357],479,3,27156,4.246442533229085,20.0,20.0
46395,4,6395,[313 187 127 302 100],474,5,27161,4.2465603502188864,0.0,40.0
46396,4,6396,[313 187 127 302 100],271,5,27166,4.2466781303736125,0.0,40.0
46397,4,6397,[313 187 127 302 100],537,5,27171,4.246795873710535,0.0,40.0
46398,4,6398,[313 187 127 302 100],144,4,27175,4.2467573058290355,0.0,40.0
46399,4,6399,[313 187 127 302 100],474,5,27180,4.246875,0.0,40.0
46400,4,6400,[313 187 127 302 100],90,5,27185,4.246992657397282,0.0,40.0
46401,4,6401,[313 187 127 302 100],474,5,27190,4.247110278038113,0.0,40.0
46402,4,6402,[597 475 427 186  50],13,3,27193,4.246915508355459,0.0,20.0
46403,4,6403,[313 187 127 302 100],334,5,27198,4.247033104309806,0.0,40.0
46404,4,6404,[742 238 172 323 100],804,5,27203,4.247150663544106,0.0,20.0
46405,4,6405,[313 187 127 302 100],474,5,27208,4.247268186075554,0.0,40.0
46406,4,6406,[313 187 127 302 100],474,5,27213,4.247385671921336,0.0,40.0
46407,4,6407,[313 187 127 302 100],474,5,27218,4.247503121098627,0.0,40.0
46408,4,6408,[357 655 194 216 403],308,4,27222,4.247464503042596,20.0,0.0
46409,4,6409,[235 265 125 313 301],378,3,27225,4.247269890795632,0.0,0.0
46410,4,6410,[313 187 127 302 100],271,5,27230,4.247387303072844,0.0,40.0
46411,4,6411,[195 357 333 127 289],537,2,27232,4.247036805988771,20.0,20.0
46412,4,6412,[313 187 127 302 100],207,4,27236,4.246998284734134,0.0,40.0
46413,4,6413,[313 187 127 302 100],144,4,27240,4.2469597754911135,0.0,40.0
46414,4,6414,[313 187 127 302 100],144,4,27244,4.246921278254092,0.0,40.0
46415,4,6415,[125 300 282 271 597],26,3,27247,4.246726932668329,0.0,0.0
46416,4,6416,[180 678 318 268 273],387,2,27249,4.246376811594203,20.0,0.0
46417,4,6417,[313 187 127 302 100],334,5,27254,4.246494234964163,0.0,40.0
46418,4,6418,[313 187 127 302 100],328,5,27259,4.2466116217479355,0.0,40.0
46419,4,6419,[ 82 181  95 153 300],892,4,27263,4.246573208722741,0.0,0.0
46420,4,6420,[313 187 127 302 100],90,5,27268,4.246690546643825,0.0,40.0
46421,4,6421,[313 187 127 302 100],144,4,27272,4.24665213329181,0.0,40.0
46422,4,6422,[313 187 127 302 100],334,5,27277,4.246769422388292,0.0,40.0
46423,4,6423,[313 187 127 302 100],13,5,27282,4.2468866749688665,0.0,40.0
46424,4,6424,[313 187 127 302 100],328,5,27287,4.247003891050584,0.0,40.0
46425,4,6425,[313 187 127 302 100],537,5,27292,4.247121070650483,0.0,40.0
46426,4,6426,[483 210  82 216 288],650,2,27294,4.24677143301696,20.0,0.0
46427,4,6427,[313 187 127 302 100],207,4,27298,4.24673304293715,0.0,40.0
46428,4,6428,[313 187 127 302 100],537,5,27303,4.246850209986001,0.0,40.0
46429,4,6429,[313 187 127 302 100],537,5,27308,4.24696734059098,0.0,40.0
46430,4,6430,[  8 179 186  88 328],95,4,27312,4.246928937956772,0.0,0.0
46431,4,6431,[313 187 127 302 100],537,5,27317,4.247046019900497,0.0,40.0
46432,4,6432,[313 187 127 302 100],207,4,27321,4.247007616974972,0.0,40.0
46433,4,6433,[286  50  79   1 546],102,1,27322,4.246502953061859,0.0,20.0
46434,4,6434,[  7 179  97 215 180],664,3,27325,4.246309246309246,0.0,0.0
46435,4,6435,[313 187 127 302 100],537,5,27330,4.246426351771286,0.0,40.0
46436,4,6436,[ 70  88 176 179 111],271,4,27334,4.2463880689762314,0.0,0.0
46437,4,6437,[313 187 127 302 100],271,5,27339,4.246505125815471,0.0,40.0
46438,4,6438,[483 168  79 200  50],385,1,27340,4.246000931821712,20.0,20.0
46439,4,6439,[313 187 127 302 100],90,5,27345,4.24611801242236,0.0,40.0
46440,4,6440,[313 187 127 302 100],13,5,27350,4.246235056668219,0.0,40.0
46441,4,6441,[313 187 127 302 100],144,4,27354,4.24619683328159,0.0,40.0
46442,4,6442,[313 187 127 302 100],90,5,27359,4.2463138289616635,0.0,40.0
46443,4,6443,[313 187 127 302 100],328,5,27364,4.24643078833023,0.0,40.0
46444,4,6444,[313 187 127 302 100],90,5,27369,4.246547711404189,0.0,40.0
46445,4,6445,[568 215 427 300 135],454,4,27373,4.2465094632330125,0.0,0.0
46446,4,6446,[313 187 127 302 100],207,4,27377,4.246471226927253,0.0,40.0
46447,4,6447,[ 69 125 234 471 186],653,2,27379,4.246122828784119,0.0,0.0
46448,4,6448,[313 187 127 302 100],207,4,27383,4.246084664289037,0.0,40.0
46449,4,6449,[313 187 127 302 427],271,5,27388,4.246201550387597,0.0,20.0
46450,4,6450,[313 187 127 302 427],669,5,27393,4.246318400248024,0.0,20.0
46451,4,6451,[143 496 313  98  97],308,1,27394,4.2458152510849345,0.0,20.0
46452,4,6452,[132 245   9 168 210],488,3,27397,4.245622191228886,0.0,0.0
46453,4,6453,[  9 257 222   7 288],455,3,27400,4.245429191199256,0.0,0.0
46454,4,6454,[603 144 357 288  64],387,2,27402,4.2450813323005425,40.0,0.0
46455,4,6455,[313 187 127 302 427],90,5,27407,4.245198265179678,0.0,20.0
46456,4,6456,[313 187 127 302 427],669,5,27412,4.245315161839864,0.0,20.0
46457,4,6457,[313 187 127 302 427],328,4,27416,4.24527717559616,0.0,20.0
46458,4,6458,[300 216 187 301 168],666,3,27419,4.245084378386747,0.0,0.0
46459,4,6459,[313 185  12   7 195],537,3,27422,4.244891640866873,20.0,0.0
46460,4,6460,[313 187 127 302 100],474,5,27427,4.245008512614146,0.0,40.0
46461,4,6461,[195 300 191 125 100],653,4,27431,4.244970597338285,0.0,20.0
46462,4,6462,[313 187 127 302 100],537,5,27436,4.24508742070246,0.0,40.0
46463,4,6463,[ 89 483 385 180 235],385,4,27440,4.2450495049504955,20.0,0.0
46464,4,6464,[313 187 127 302 100],271,5,27445,4.245166279969064,0.0,40.0
46465,4,6465,[313 187 127 302 100],271,5,27450,4.245283018867925,0.0,40.0
46466,4,6466,[313 187 127 302 100],90,5,27455,4.245399721663832,0.0,40.0
46467,4,6467,[313 187 127 302 100],334,5,27460,4.245516388373531,0.0,40.0
46468,4,6468,[313 187 127 302 100],537,5,27465,4.245633019013758,0.0,40.0
46469,4,6469,[313 187 127 302 100],328,5,27470,4.2457496136012365,0.0,40.0
46470,4,6470,[ 25  71  82 174  56],13,3,27473,4.2455571009117605,0.0,20.0
46471,4,6471,[423 180  97 235 196],87,3,27476,4.2453646477132265,0.0,0.0
46472,4,6472,[435 313 286 183 234],934,2,27478,4.24501776610536,0.0,0.0
46473,4,6473,[313 187 127 302 100],144,4,27482,4.244979919678715,0.0,40.0
46474,4,6474,[313 187 127 302 100],474,5,27487,4.245096525096525,0.0,40.0
46475,4,6475,[313 187 127 302 100],328,5,27492,4.2452130945027795,0.0,40.0
46476,4,6476,[172  97 181 275 597],455,4,27496,4.24517523544851,0.0,0.0
46477,4,6477,[181 234 483 276   9],189,2,27498,4.244828650818154,20.0,0.0
46478,4,6478,[234  71 215 216  82],95,3,27501,4.24463651798117,0.0,0.0
46479,4,6479,[313 187 127 302 100],144,4,27505,4.244598765432099,0.0,40.0
46480,4,6480,[127 187 153 176 265],638,1,27506,4.244098133004166,0.0,20.0
46481,4,6481,[403 200  98 322 172],102,1,27507,4.24359765504474,0.0,20.0
46482,4,6482,[313 187 127 302 100],271,5,27512,4.243714329785593,0.0,40.0
46483,4,6483,[313 187 127 302 100],537,5,27517,4.24383096853794,0.0,40.0
46484,4,6484,[313 187 127 302 100],207,4,27521,4.243793369313801,0.0,40.0
46485,4,6485,[313 187 127 302 100],90,5,27526,4.24390995991366,0.0,40.0
46486,4,6486,[313 187 127 302 100],334,5,27531,4.244026514567596,0.0,40.0
46487,4,6487,[313 187 127 302 100],328,5,27536,4.244143033292231,0.0,40.0
46488,4,6488,[313 187 127 302 100],13,5,27541,4.244259516104177,0.0,40.0
46489,4,6489,[  7 202 143 181  56],650,3,27544,4.244067796610169,0.0,0.0
46490,4,6490,[313 187 127 302 100],334,5,27549,4.2441842551224775,0.0,40.0
46491,4,6491,[313 187 127 302 100],328,5,27554,4.24430067775724,0.0,40.0
46492,4,6492,[313 187 127 302 100],90,5,27559,4.244417064531033,0.0,40.0
46493,4,6493,[186  97 194 655  89],234,1,27560,4.243917462272868,0.0,0.0
46494,4,6494,[313 187 127 302 100],13,5,27565,4.244033872209392,0.0,40.0
46495,4,6495,[313 187 127 302 100],537,5,27570,4.244150246305419,0.0,40.0
46496,4,6496,[313 187 127 302 100],144,4,27574,4.244112667384947,0.0,40.0
46497,4,6497,[313 187 127 302 100],328,5,27579,4.244228993536473,0.0,40.0
46498,4,6498,[313 187 127 302 100],537,5,27584,4.244345283889829,0.0,40.0
46499,4,6499,[238 245 515 328 174],334,3,27587,4.244153846153846,0.0,20.0
46500,4,6500,[313 187 127 302 100],271,5,27592,4.244270112290417,0.0,40.0
46501,4,6501,[ 79  15 172 515 210],313,4,27596,4.244232543832667,0.0,0.0
46502,4,6502,[313 187 127 302 100],90,5,27601,4.244348762109795,0.0,40.0
46503,4,6503,[118 100 215 180 273],749,3,27604,4.244157441574416,0.0,20.0
46504,4,6504,[496 405 200  71 181],488,2,27606,4.24381245196003,0.0,0.0
46505,4,6505,[174 475  12 405 176],144,4,27610,4.243774976944359,20.0,20.0
46506,4,6506,[313 187 127 302 100],271,5,27615,4.243891194098663,0.0,40.0
46507,4,6507,[313 187 127 302 100],334,5,27620,4.2440073755378,0.0,40.0
46508,4,6508,[475 174 143 508 273],13,1,27621,4.243508987555692,0.0,20.0
46509,4,6509,[276 125  64 403  56],59,4,27625,4.243471582181259,0.0,0.0
46510,4,6510,[313 187 127 302 100],334,5,27630,4.243587774535402,0.0,40.0
46511,4,6511,[313 187 127 302 100],90,5,27635,4.243703931203931,0.0,40.0
46512,4,6512,[313 187 127 302 100],334,5,27640,4.243820052203286,0.0,40.0
46513,4,6513,[173 174  95 257 286],334,4,27644,4.243782622044827,0.0,20.0
46514,4,6514,[313 187 127 302 100],207,4,27648,4.243745203376823,0.0,40.0
46515,4,6515,[313 187 127 302 100],90,5,27653,4.243861264579497,0.0,40.0
46516,4,6516,[313 187 127 302 100],144,4,27657,4.243823845327605,0.0,40.0
46517,4,6517,[313 187 127 302 100],537,5,27662,4.243939858852409,0.0,40.0
46518,4,6518,[313 187 127 302 100],334,5,27667,4.244055836784783,0.0,40.0
46519,4,6519,[313 187 127 302 100],144,4,27671,4.244018404907975,0.0,40.0
46520,4,6520,[313 187 127 302 100],474,5,27676,4.2441343352246585,0.0,40.0
46521,4,6521,[100 301 117 180 151],90,3,27679,4.243943575590309,0.0,20.0
46522,4,6522,[313 187 127 302 100],207,4,27683,4.243906178138893,0.0,40.0
46523,4,6523,[588 597   1 174  97],13,3,27686,4.243715511955855,0.0,20.0
46524,4,6524,[313 187 127 302 100],90,5,27691,4.243831417624521,0.0,40.0
46525,4,6525,[313 187 127 302 100],474,5,27696,4.243947287771989,0.0,40.0
46526,4,6526,[210 234   1 265 196],263,4,27700,4.243909912670446,0.0,0.0
46527,4,6527,[313 187 127 302 100],144,4,27704,4.243872549019608,0.0,40.0
46528,4,6528,[313 187 127 302 100],271,5,27709,4.243988359626282,0.0,40.0
46529,4,6529,[196 385 153  22  82],749,4,27713,4.243950995405819,0.0,0.0
46530,4,6530,[313 187 127 302 100],271,5,27718,4.244066758536212,0.0,40.0
46531,4,6531,[313 187 127 302 100],334,5,27723,4.2441824862216775,0.0,40.0
46532,4,6532,[568 323 222   1 357],650,2,27725,4.243838971376091,20.0,0.0
46533,4,6533,[313 187 127 302 100],90,5,27730,4.243954698500153,0.0,40.0
46534,4,6534,[313 187 127 302 100],13,5,27735,4.24407039020658,0.0,40.0
46535,4,6535,[313 187 127 302 100],334,5,27740,4.244186046511628,0.0,40.0
46536,4,6536,[313 187 127 302 100],537,5,27745,4.244301667431544,0.0,40.0
46537,4,6537,[318 118  22 385  82],648,4,27749,4.244264301009483,20.0,0.0
46538,4,6538,[202 135 182   7  69],892,5,27754,4.244379874598563,0.0,0.0
46539,4,6539,[313 187 127 302 100],328,5,27759,4.244495412844037,0.0,40.0
46540,4,6540,[496 508  22 276 111],378,3,27762,4.2443051521174135,0.0,0.0
46541,4,6541,[313 187 127 302 100],474,5,27767,4.244420666462855,0.0,40.0
46542,4,6542,[118  97 202  22 515],774,1,27768,4.243924805135259,0.0,0.0
46543,4,6543,[210 135 175 238 121],479,5,27773,4.244040342298288,0.0,0.0
46544,4,6544,[313 187 127 302 100],144,4,27777,4.244003055767761,0.0,40.0
46545,4,6545,[313 187 127 302 100],207,4,27781,4.243965780629392,0.0,40.0
46546,4,6546,[323 196 117 597 204],897,3,27784,4.243775775164197,0.0,0.0
46547,4,6547,[313 187 127 302 100],13,5,27789,4.243891264508247,0.0,40.0
46548,4,6548,[200 288 176 568  70],537,1,27790,4.243395938311193,0.0,0.0
46549,4,6549,[313 187 127 302 100],474,5,27795,4.243511450381679,0.0,40.0
46550,4,6550,[313 187 127 302 100],474,5,27800,4.243626927186689,0.0,40.0
46551,4,6551,[655  82  25 117 427],398,5,27805,4.243742368742368,0.0,0.0
46552,4,6552,[313 187 127 302 100],144,4,27809,4.2437051732031135,0.0,40.0
46553,4,6553,[403 135 191 185 181],815,3,27812,4.243515410436375,0.0,0.0
46554,4,6554,[313 187 127 302 100],271,5,27817,4.243630816170862,0.0,40.0
46555,4,6555,[194  64 322 294  12],84,3,27820,4.243441122635754,20.0,0.0
46556,4,6556,[313 187 127 302 100],334,5,27825,4.243556504499009,0.0,40.0
46557,4,6557,[ 96 546 597 186 228],788,0,27825,4.2429094236047575,0.0,0.0
46558,4,6558,[313 187 127 302 100],144,4,27829,4.2428723890837015,0.0,40.0
46559,4,6559,[313 187 127 302 100],90,5,27834,4.242987804878049,0.0,40.0
46560,4,6560,[313 187 127 302 100],90,5,27839,4.243103185490017,0.0,40.0
46561,4,6561,[313 187 127 302 100],144,4,27843,4.2430661383724475,0.0,40.0
46562,4,6562,[546 179 161   9 222],194,3,27846,4.24287673320128,0.0,0.0
46563,4,6563,[313 187 127 302 100],537,5,27851,4.242992078001219,0.0,40.0
46564,4,6564,[313 187 127 302 100],207,4,27855,4.242955064737243,0.0,40.0
46565,4,6565,[ 25 322   4 194 318],804,5,27860,4.243070362473348,20.0,0.0
46566,4,6566,[313 187 127 302 100],13,5,27865,4.2431856250951725,0.0,40.0
46567,4,6567,[313 187 127 302 100],334,5,27870,4.2433008526187574,0.0,40.0
46568,4,6568,[313 187 127 302 100],13,5,27875,4.243416045060131,0.0,40.0
46569,4,6569,[313 187 127 302 100],271,5,27880,4.243531202435312,0.0,40.0
46570,4,6570,[313 187 127 302 100],144,4,27884,4.243494140922234,0.0,40.0
46571,4,6571,[313 187 127 302 100],207,4,27888,4.243457090687766,0.0,40.0
46572,4,6572,[313 187 127 302 100],334,5,27893,4.2435721892590905,0.0,40.0
46573,4,6573,[313 187 127 302 100],537,5,27898,4.243687252814116,0.0,40.0
46574,4,6574,[313 187 127 302 100],334,5,27903,4.243802281368821,0.0,40.0
46575,4,6575,[286  89  79 276 183],234,1,27904,4.24330900243309,0.0,0.0
46576,4,6576,[313 187 127 302 100],537,5,27909,4.243424053519842,0.0,40.0
46577,4,6577,[216 234 185   4 132],537,1,27910,4.2429309820614165,0.0,0.0
46578,4,6578,[313 187 127 302 100],13,5,27915,4.243046055631555,0.0,40.0
46579,4,6579,[313 187 127 302 100],537,5,27920,4.243161094224924,0.0,40.0
46580,4,6580,[313 187 127 302 100],207,4,27924,4.243124145266677,0.0,40.0
46581,4,6581,[313 187 127 302 100],13,5,27929,4.243239137040414,0.0,40.0
46582,4,6582,[202  70 187 228 288],537,2,27931,4.242898374601245,0.0,0.0
46583,4,6583,[313 187 127 302 100],537,5,27936,4.2430133657351154,0.0,40.0
46584,4,6584,[313 187 127 302 100],334,5,27941,4.243128321943812,0.0,40.0
46585,4,6585,[313 187 127 302 100],537,5,27946,4.243243243243243,0.0,40.0
46586,4,6586,[313 187 127 302 100],144,4,27950,4.243206315469865,0.0,40.0
46587,4,6587,[313 187 127 302 100],144,4,27954,4.243169398907104,0.0,40.0
46588,4,6588,[313 187 127 302 100],13,5,27959,4.243284261648202,0.0,40.0
46589,4,6589,[313 187 127 302 100],271,5,27964,4.24339908952959,0.0,40.0
46590,4,6590,[515 597  25 742 125],634,5,27969,4.243513882567137,0.0,0.0
46591,4,6591,[313 187 127 302 100],328,5,27974,4.243628640776699,0.0,40.0
46592,4,6592,[313 187 127 302 100],144,4,27978,4.243591688154103,0.0,40.0
46593,4,6593,[313 187 127 302 100],537,5,27983,4.243706399757355,0.0,40.0
46594,4,6594,[313 187 127 302 100],474,5,27988,4.243821076573162,0.0,40.0
46595,4,6595,[  4 125 475 135 273],374,2,27990,4.243480897513645,0.0,0.0
46596,4,6596,[151 257  71 238 655],95,5,27995,4.243595573745642,0.0,0.0
46597,4,6597,[427 216 172  15 180],194,2,27997,4.243255531979388,0.0,0.0
46598,4,6598,[313 187 127 302 100],144,4,28001,4.243218669495378,0.0,40.0
46599,4,6599,[313 187 127 302 100],144,4,28005,4.243181818181818,0.0,40.0
46600,4,6600,[313 187 127 302 100],328,5,28010,4.243296470231783,0.0,40.0
46601,4,6601,[313 187 127 302 100],474,5,28015,4.2434110875492275,0.0,40.0
46602,4,6602,[313 187 127 302 100],328,5,28020,4.243525670149932,0.0,40.0
46603,4,6603,[313 187 127 302 100],207,4,28024,4.243488794669897,0.0,40.0
46604,4,6604,[313 187 127 302 100],537,5,28029,4.243603330809992,0.0,40.0
46605,4,6605,[313 187 127 302 100],90,5,28034,4.24371783227369,0.0,40.0
46606,4,6606,[313 187 127 302 100],537,5,28039,4.243832299076737,0.0,40.0
46607,4,6607,[313 187 127 302 100],144,4,28043,4.243795399515738,0.0,40.0
46608,4,6608,[313 187 127 302 100],328,5,28048,4.243909819942503,0.0,40.0
46609,4,6609,[313 187 127 302 100],90,5,28053,4.2440242057488655,0.0,40.0
46610,4,6610,[313 187 127 302 100],144,4,28057,4.243987293904099,0.0,40.0
46611,4,6611,[313 187 127 302 100],207,4,28061,4.2439503932244405,0.0,40.0
46612,4,6612,[117  12 603 183  98],234,3,28064,4.243762286405564,40.0,20.0
46613,4,6613,[313 187 127 302 100],328,5,28069,4.243876625340188,0.0,40.0
46614,4,6614,[172 313 121 132 300],334,1,28070,4.243386243386244,0.0,0.0
46615,4,6615,[265  71 127 132 237],313,4,28074,4.24334945586457,0.0,20.0
46616,4,6616,[313 187 127 302 100],328,5,28079,4.243463805349856,0.0,40.0
46617,4,6617,[313 187 127 302 100],474,5,28084,4.24357812027803,0.0,40.0
46618,4,6618,[423  79 180 181 235],479,3,28087,4.243390240217556,0.0,0.0
46619,4,6619,[313 187 127 302 100],144,4,28091,4.243353474320242,0.0,40.0
46620,4,6620,[313 187 127 302 100],328,5,28096,4.243467754115692,0.0,40.0
46621,4,6621,[597 173 222   7 174],554,3,28099,4.2432799758381154,0.0,20.0
46622,4,6622,[313 187 127 302 100],144,4,28103,4.243243243243243,0.0,40.0
46623,4,6623,[313 187 127 302 100],13,5,28108,4.243357487922705,0.0,40.0
46624,4,6624,[202  95 118   4 588],308,4,28112,4.243320754716981,0.0,0.0
46625,4,6625,[313 187 127 302 100],328,5,28117,4.243434953214609,0.0,40.0
46626,4,6626,[313 187 127 302 100],207,4,28121,4.243398219405463,0.0,40.0
46627,4,6627,[ 56 313  88  28 276],883,3,28124,4.243210621605311,0.0,0.0
46628,4,6628,[405  89  98  79 118],892,5,28129,4.24332478503545,0.0,20.0
46629,4,6629,[313 187 127 302 100],13,5,28134,4.243438914027149,0.0,40.0
46630,4,6630,[313 187 127 302 100],144,4,28138,4.243402201779521,0.0,40.0
46631,4,6631,[153 210 168 234 117],13,3,28141,4.243214716525935,0.0,0.0
46632,4,6632,[313 187 127 302 100],537,5,28146,4.243328810492989,0.0,40.0
46633,4,6633,[313 187 127 302 100],537,5,28151,4.24344287006331,0.0,40.0
46634,4,6634,[313 187 127 302 100],90,5,28156,4.243556895252449,0.0,40.0
46635,4,6635,[313 187 127 302 100],328,5,28161,4.243670886075949,0.0,40.0
46636,4,6636,[ 69 405  70  50 153],144,5,28166,4.243784842549345,0.0,20.0
46637,4,6637,[313 187 127 302 100],271,5,28171,4.243898764688159,0.0,40.0
46638,4,6638,[313 187 127 302 100],474,5,28176,4.244012652507908,0.0,40.0
46639,4,6639,[313 187 127 302 100],474,5,28181,4.244126506024096,0.0,40.0
46640,4,6640,[313 187 127 302 100],90,5,28186,4.244240325252221,0.0,40.0
46641,4,6641,[228 222 294 322 144],102,1,28187,4.243751881963264,0.0,0.0
46642,4,6642,[313 187 127 302 100],13,5,28192,4.243865723317778,0.0,40.0
46643,4,6643,[313 187 127 302 100],474,5,28197,4.243979530403371,0.0,40.0
46644,4,6644,[313 187 127 302 100],13,5,28202,4.244093303235515,0.0,40.0
46645,4,6645,[257 174 117  96  82],650,3,28205,4.243906108937707,0.0,20.0
46646,4,6646,[216 176 678 748  64],804,5,28210,4.24401985858282,0.0,0.0
46647,4,6647,[ 71 322 186 385 435],804,4,28214,4.243983152827918,0.0,0.0
46648,4,6648,[313 187 127 302 100],13,5,28219,4.2440968566701756,0.0,40.0
46649,4,6649,[313 187 127 302 100],537,5,28224,4.24421052631579,0.0,40.0
46650,4,6650,[313 187 127 302 100],90,5,28229,4.244324161780184,0.0,40.0
46651,4,6651,[ 56   1 144 135 196],892,5,28234,4.244437763078773,0.0,0.0
46652,4,6652,[313 187 127 302 100],537,5,28239,4.244551330226965,0.0,40.0
46653,4,6653,[313 187 127 302 100],271,5,28244,4.244664863240156,0.0,40.0
46654,4,6654,[313 187 127 302 100],271,5,28249,4.244778362133734,0.0,40.0
46655,4,6655,[313 187 127 302 100],144,4,28253,4.244741586538462,0.0,40.0
46656,4,6656,[313 187 127 302 100],474,5,28258,4.244855039807721,0.0,40.0
46657,4,6657,[603 182 423 195 194],524,3,28261,4.244668068489036,20.0,0.0
46658,4,6658,[313 187 127 302 100],271,5,28266,4.244781498723532,0.0,40.0
46659,4,6659,[313 187 127 302 100],271,5,28271,4.244894894894895,0.0,40.0
46660,4,6660,[143 322  89 186 742],92,2,28273,4.244557874193064,0.0,0.0
46661,4,6661,[313 187 127 302 100],144,4,28277,4.244521164815371,0.0,40.0
46662,4,6662,[313 187 127 302 100],207,4,28281,4.2444844664565515,0.0,40.0
46663,4,6663,[313 187 127 302 100],474,5,28286,4.244597839135654,0.0,40.0
46664,4,6664,[183 294 222 197 100],311,4,28290,4.244561140285072,0.0,20.0
46665,4,6665,[ 64 294  12 300 234],378,4,28294,4.244524452445244,20.0,0.0
46666,4,6666,[ 82 194  15 275 172],882,4,28298,4.244487775611219,0.0,0.0
46667,4,6667,[313 187 127 302 100],271,5,28303,4.244601079784043,0.0,40.0
46668,4,6668,[313 187 127 302 100],334,5,28308,4.2447143499775075,0.0,40.0
46669,4,6669,[313 187 127 302 100],144,4,28312,4.2446776611694155,0.0,40.0
46670,4,6670,[216 118 286 475 111],479,1,28313,4.244191275670814,0.0,0.0
46671,4,6671,[313 187 127 302 100],207,4,28317,4.244154676258993,0.0,40.0
46672,4,6672,[313 187 127 302 100],537,5,28322,4.244267945451821,0.0,40.0
46673,4,6673,[313 187 127 302 100],334,5,28327,4.244381180701229,0.0,40.0
46674,4,6674,[313 187 127 302 100],328,5,28332,4.244494382022472,0.0,40.0
46675,4,6675,[313 187 127 302 100],90,5,28337,4.244607549430797,0.0,40.0
46676,4,6676,[313 187 127 302 100],271,5,28342,4.24472068294144,0.0,40.0
46677,4,6677,[313 187 127 302 100],334,5,28347,4.244833782569632,0.0,40.0
46678,4,6678,[313 187 127 302 100],328,5,28352,4.2449468483305886,0.0,40.0
46679,4,6679,[313 187 127 302 100],334,5,28357,4.245059880239521,0.0,40.0
46680,4,6680,[222 200 182 174 143],881,3,28360,4.244873521927855,0.0,20.0
46681,4,6681,[135 427 496 202  89],882,5,28365,4.244986530978749,0.0,0.0
46682,4,6682,[ 82 515 186 222 423],804,4,28369,4.2449498728116115,0.0,0.0
46683,4,6683,[313 187 127 302 100],13,5,28374,4.245062836624776,0.0,40.0
46684,4,6684,[313 187 127 302 100],271,5,28379,4.245175766641736,0.0,40.0
46685,4,6685,[269 222 181  25 235],279,2,28381,4.244839964104098,0.0,0.0
46686,4,6686,[153 175 176 222  12],60,4,28385,4.244803349783162,20.0,0.0
46687,4,6687,[313 187 127 302 100],474,5,28390,4.244916267942584,0.0,40.0
46688,4,6688,[313 187 127 302 100],144,4,28394,4.244879653161908,0.0,40.0
46689,4,6689,[313 187 127 302 100],144,4,28398,4.244843049327354,0.0,40.0
46690,4,6690,[313 187 127 302 100],334,5,28403,4.244955910925123,0.0,40.0
46691,4,6691,[135   9 204 195  64],326,2,28405,4.244620442319187,0.0,0.0
46692,4,6692,[127 182 172 187 176],406,4,28409,4.2445838936202005,0.0,20.0
46693,4,6693,[313 187 127 302 100],90,5,28414,4.2446967433522556,0.0,40.0
46694,4,6694,[313 187 127 302 100],537,5,28419,4.2448095593726665,0.0,40.0
46695,4,6695,[118  96 318  98  50],328,4,28423,4.2447729988052565,20.0,40.0
46696,4,6696,[313 187 127 302 100],334,5,28428,4.244885769747648,0.0,40.0
46697,4,6697,[ 64  12 357  11 195],666,4,28432,4.24484920871902,40.0,0.0
46698,4,6698,[313 187 127 302 100],207,4,28436,4.244812658605762,0.0,40.0
46699,4,6699,[313 187 127 302 100],328,5,28441,4.244925373134328,0.0,40.0
46700,4,6700,[313 187 127 302 100],537,5,28446,4.245038054021788,0.0,40.0
46701,4,6701,[403 471 289 322 597],788,2,28448,4.24470307370934,0.0,0.0
46702,4,6702,[313 187 127 302 100],207,4,28452,4.2446665672087125,0.0,40.0
46703,4,6703,[313 187 127 302 100],207,4,28456,4.244630071599046,0.0,40.0
46704,4,6704,[313 187 127 302 100],13,5,28461,4.244742729306488,0.0,40.0
46705,4,6705,[313 187 127 302 100],144,4,28465,4.244706233223979,0.0,40.0
46706,4,6706,[313 187 127 302 100],13,5,28470,4.24481884598181,0.0,40.0
46707,4,6707,[313 187 127 302 100],144,4,28474,4.244782349433512,0.0,40.0
46708,4,6708,[313 187 127 302 100],328,5,28479,4.244894917275301,0.0,40.0
46709,4,6709,[313 187 127 302 100],13,5,28484,4.245007451564828,0.0,40.0
46710,4,6710,[313 187 127 302 100],207,4,28488,4.244970943227537,0.0,40.0
46711,4,6711,[313 187 127 302 100],474,5,28493,4.2450834326579265,0.0,40.0
46712,4,6712,[313 187 127 302 100],328,5,28498,4.245195888574408,0.0,40.0
46713,4,6713,[111  56  69 508 483],524,5,28503,4.245308310991957,20.0,0.0
46714,4,6714,[405 568 197 186 597],7,3,28506,4.245122859270291,0.0,0.0
46715,4,6715,[215 235 202 282  56],804,4,28510,4.2450863609291245,0.0,0.0
46716,4,6716,[313 187 127 302 100],90,5,28515,4.245198749441715,0.0,40.0
46717,4,6717,[313 187 127 302 100],90,5,28520,4.245311104495386,0.0,40.0
46718,4,6718,[313 187 127 302 100],328,5,28525,4.245423426105075,0.0,40.0
46719,4,6719,[313 187 127 302 100],271,5,28530,4.245535714285714,0.0,40.0
46720,4,6720,[313 187 127 302 100],474,5,28535,4.245647969052224,0.0,40.0
46721,4,6721,[313 187 127 302 100],328,5,28540,4.245760190419518,0.0,40.0
46722,4,6722,[313 187 127 302 100],90,5,28545,4.245872378402499,0.0,40.0
46723,4,6723,[313 187 127 302 100],90,5,28550,4.2459845330160615,0.0,40.0
46724,4,6724,[313 187 127 302 100],271,5,28555,4.246096654275093,0.0,40.0
46725,4,6725,[313 187 127 302 100],144,4,28559,4.246060065417781,0.0,40.0
46726,4,6726,[313 187 127 302 100],537,5,28564,4.24617214211387,0.0,40.0
46727,4,6727,[496 313  22 318 748],533,4,28568,4.2461355529131986,20.0,0.0
46728,4,6728,[269  28 235 121 328],378,4,28572,4.246098974587606,0.0,0.0
46729,4,6729,[313 187 127 302 100],474,5,28577,4.246210995542348,0.0,40.0
46730,4,6730,[117 423 143  70 176],474,5,28582,4.246322983212004,0.0,0.0
46731,4,6731,[ 50 135 191 180  64],653,5,28587,4.246434937611408,0.0,20.0
46732,4,6732,[313 187 127 302 100],537,5,28592,4.246546858755384,0.0,40.0
46733,4,6733,[313 187 127 302 100],328,5,28597,4.246658746658746,0.0,40.0
46734,4,6734,[235  56  89 182 180],524,4,28601,4.246622123236823,0.0,0.0
46735,4,6735,[313 187 127 302 100],474,5,28606,4.246733966745843,0.0,40.0
46736,4,6736,[313 187 127 302 100],207,4,28610,4.246697343031022,0.0,40.0
46737,4,6737,[  9  79 475 121 153],334,4,28614,4.246660730186999,0.0,0.0
46738,4,6738,[313 187 127 302 100],13,5,28619,4.246772518177771,0.0,40.0
46739,4,6739,[ 82 216  98 183 127],64,4,28623,4.246735905044511,0.0,40.0
46740,4,6740,[313 187 127 302 100],328,5,28628,4.246847648716807,0.0,40.0
46741,4,6741,[313 187 127 302 100],271,5,28633,4.246959359240582,0.0,40.0
46742,4,6742,[194 175  98  11  96],788,2,28635,4.246626130802314,0.0,20.0
46743,4,6743,[313 187 127 302 100],537,5,28640,4.246737841043891,0.0,40.0
46744,4,6744,[313 187 127 302 100],13,5,28645,4.246849518161601,0.0,40.0
46745,4,6745,[313 187 127 302 100],474,5,28650,4.246961162170175,0.0,40.0
46746,4,6746,[313 187 127 302 100],328,5,28655,4.247072773084334,0.0,40.0
46747,4,6747,[202 125 742  50   7],881,4,28659,4.247036158861885,0.0,20.0
46748,4,6748,[313 187 127 302 100],334,5,28664,4.2471477255889765,0.0,40.0
46749,4,6749,[ 15 471 211 328  71],479,3,28667,4.246962962962963,0.0,0.0
46750,4,6750,[313 187 127 302 100],13,5,28672,4.247074507480373,0.0,40.0
46751,4,6751,[313 187 127 302 100],90,5,28677,4.247186018957346,0.0,40.0
46752,4,6752,[313 187 127 302 100],207,4,28681,4.247149415074782,0.0,40.0
46753,4,6753,[ 97 200   4  64 238],379,4,28685,4.247112822031389,0.0,0.0
46754,4,6754,[313 187 127 302 100],474,5,28690,4.247224278312361,0.0,40.0
46755,4,6755,[313 187 127 302 100],90,5,28695,4.247335701598579,0.0,40.0
46756,4,6756,[282 197 237 210 174],474,5,28700,4.247447091904691,0.0,20.0
46757,4,6757,[ 88   4 234   7 100],774,0,28700,4.24681858538029,0.0,20.0
46758,4,6758,[ 25 195 235 100 275],308,4,28704,4.246782068353307,0.0,20.0
46759,4,6759,[313 187 127 302 100],90,5,28709,4.24689349112426,0.0,40.0
46760,4,6760,[313 187 127 302 100],271,5,28714,4.247004880934773,0.0,40.0
46761,4,6761,[313 187 127 302 100],144,4,28718,4.246968352558414,0.0,40.0
46762,4,6762,[313 187 127 302 100],207,4,28722,4.2469318349844745,0.0,40.0
46763,4,6763,[435  28 496 237 111],666,2,28724,4.246599645180367,0.0,0.0
46764,4,6764,[235 168  56 194 172],385,2,28726,4.246267553584627,0.0,0.0
46765,4,6765,[313 187 127 302 100],144,4,28730,4.2462311557788945,0.0,40.0
46766,4,6766,[546  56 181 197 191],524,4,28734,4.2461947687306045,0.0,0.0
46767,4,6767,[313 187 127 302 100],207,4,28738,4.246158392434988,0.0,40.0
46768,4,6768,[313 187 127 302 100],334,5,28743,4.246269759196336,0.0,40.0
46769,4,6769,[313 187 127 302 100],474,5,28748,4.246381093057607,0.0,40.0
46770,4,6770,[313 187 127 302 100],13,5,28753,4.246492394033377,0.0,40.0
46771,4,6771,[313 187 127 302 100],13,5,28758,4.246603662138217,0.0,40.0
46772,4,6772,[313 187 127 302 100],334,5,28763,4.246714897386682,0.0,40.0
46773,4,6773,[313 187 127 302 100],537,5,28768,4.246826099793328,0.0,40.0
46774,4,6774,[172  15 328 235 117],537,0,28768,4.24619926199262,0.0,0.0
46775,4,6775,[181 216  98  22 161],13,4,28772,4.24616292798111,0.0,20.0
46776,4,6776,[313 187 127 302 100],328,5,28777,4.246274162608824,0.0,40.0
46777,4,6777,[313 187 127 302 100],90,5,28782,4.246385364414282,0.0,40.0
46778,4,6778,[313 187 127 302 100],334,5,28787,4.2464965334120075,0.0,40.0
46779,4,6779,[588 194 275 202 180],406,3,28790,4.2463126843657815,0.0,0.0
46780,4,6780,[313 187 127 302 100],271,5,28795,4.24642383129332,0.0,40.0
46781,4,6781,[191 435 655 300  56],666,4,28799,4.246387496313772,0.0,0.0
46782,4,6782,[ 82 182  95 318 475],387,2,28801,4.246056317263748,20.0,0.0
46783,4,6783,[235  22 174 210   8],897,3,28804,4.245872641509434,0.0,20.0
46784,4,6784,[313 187 127 302 100],537,5,28809,4.245983787767133,0.0,40.0
46785,4,6785,[313 187 127 302 100],13,5,28814,4.246094901267315,0.0,40.0
46786,4,6786,[313 187 127 302 100],144,4,28818,4.246058641520554,0.0,40.0
46787,4,6787,[ 95 117  12 202   4],406,3,28821,4.245875073659399,20.0,0.0
46788,4,6788,[313 187 127 302 100],13,5,28826,4.245986154072765,0.0,40.0
46789,4,6789,[313 187 127 302 100],474,5,28831,4.246097201767305,0.0,40.0
46790,4,6790,[313 187 127 302 100],328,5,28836,4.2462082167574735,0.0,40.0
46791,4,6791,[313 187 127 302 100],90,5,28841,4.246319199057715,0.0,40.0
46792,4,6792,[276 238 269   7 275],378,4,28845,4.246282938318858,0.0,0.0
46793,4,6793,[313 187 127 302 100],144,4,28849,4.246246688254342,0.0,40.0
46794,4,6794,[748 313 276 483  69],207,3,28852,4.246063281824871,20.0,0.0
46795,4,6795,[294 286 118 357   8],298,4,28856,4.246027074749853,20.0,0.0
46796,4,6796,[ 88  15 204 202 237],406,2,28858,4.245696630866559,0.0,0.0
46797,4,6797,[ 97 483 168 125 546],82,3,28861,4.245513386290085,20.0,0.0
46798,4,6798,[313 187 127 302 100],144,4,28865,4.245477276070011,0.0,40.0
46799,4,6799,[313 187 127 302 100],90,5,28870,4.245588235294117,0.0,40.0
46800,4,6800,[313 187 127 302 100],474,5,28875,4.245699161887957,0.0,40.0
46801,4,6801,[423  70 172 194 181],144,5,28880,4.245810055865922,0.0,0.0
46802,4,6802,[181 603 200 118  88],848,3,28883,4.245626929295899,20.0,0.0
46803,4,6803,[100  89  82 182 196],334,4,28887,4.245590828924162,0.0,20.0
46804,4,6804,[313 187 127 302 100],474,5,28892,4.245701689933872,0.0,40.0
46805,4,6805,[313 187 127 302 100],474,5,28897,4.245812518366147,0.0,40.0
46806,4,6806,[228 435 300 117 237],13,3,28900,4.2456294990451005,0.0,0.0
46807,4,6807,[ 28 568  82 234 210],378,5,28905,4.245740305522914,0.0,0.0
46808,4,6808,[313 187 127 302 100],334,5,28910,4.245851079453664,0.0,40.0
46809,4,6809,[202 318 235 276  69],82,4,28914,4.245814977973568,20.0,0.0
46810,4,6810,[313 187 127 302 100],144,4,28918,4.245778887094406,0.0,40.0
46811,4,6811,[273 211 143 748 180],207,3,28921,4.245596007046388,0.0,0.0
46812,4,6812,[235 496 194 403 179],524,3,28924,4.245413180683986,0.0,0.0
46813,4,6813,[313 187 127 302 100],334,5,28929,4.245523921338421,0.0,40.0
46814,4,6814,[289  98 286 173  71],406,1,28930,4.245047688921496,0.0,20.0
46815,4,6815,[313 187 127 302 100],207,4,28934,4.245011737089202,0.0,40.0
46816,4,6816,[313 187 127 302 100],474,5,28939,4.245122487897902,0.0,40.0
46817,4,6817,[237 194 172 100 153],13,5,28944,4.245233206218833,0.0,20.0
46818,4,6818,[313 187 127 302 100],207,4,28948,4.245197242997507,0.0,40.0
46819,4,6819,[313 187 127 302 100],90,5,28953,4.245307917888563,0.0,40.0
46820,4,6820,[  8 182 176  22 234],897,4,28957,4.245271954258906,0.0,0.0
46821,4,6821,[313 187 127 302 100],474,5,28962,4.245382585751979,0.0,40.0
46822,4,6822,[678 210 118 423  22],254,4,28966,4.245346621720651,0.0,0.0
46823,4,6823,[161 237 118 127 210],59,3,28969,4.245164126611958,0.0,20.0
46824,4,6824,[313 187 127 302 100],207,4,28973,4.245128205128205,0.0,40.0
46825,4,6825,[ 98 175 161 118   7],774,1,28974,4.244652798124817,0.0,20.0
46826,4,6826,[258 132 182 245 318],90,2,28976,4.244324007616815,20.0,0.0
46827,4,6827,[313 187 127 302 100],474,5,28981,4.244434680726421,0.0,40.0
46828,4,6828,[313 187 127 302 100],537,5,28986,4.244545321423342,0.0,40.0
46829,4,6829,[313 187 127 302 100],328,5,28991,4.244655929721816,0.0,40.0
46830,4,6830,[313 187 127 302 100],537,5,28996,4.244766505636071,0.0,40.0
46831,4,6831,[313 187 127 302 100],144,4,29000,4.244730679156909,0.0,40.0
46832,4,6832,[313 187 127 302 100],474,5,29005,4.244841211766428,0.0,40.0
46833,4,6833,[313 187 127 302 100],537,5,29010,4.244951712028095,0.0,40.0
46834,4,6834,[313 187 127 302 100],271,5,29015,4.245062179956109,0.0,40.0
46835,4,6835,[313 187 127 302 100],537,5,29020,4.245172615564658,0.0,40.0
46836,4,6836,[313 187 127 302 100],90,5,29025,4.245283018867925,0.0,40.0
46837,4,6837,[313 187 127 302 100],207,4,29029,4.245247148288973,0.0,40.0
46838,4,6838,[313 187 127 302 100],537,5,29034,4.245357508407662,0.0,40.0
46839,4,6839,[132 515 153 235   8],13,3,29037,4.245175438596491,0.0,0.0
46840,4,6840,[ 95 322  50 172 100],334,2,29039,4.244847244554889,0.0,40.0
46841,4,6841,[313 187 127 302 100],537,5,29044,4.2449576147325345,0.0,40.0
46842,4,6842,[313 187 127 302 100],144,4,29048,4.244921817916119,0.0,40.0
46843,4,6843,[313 187 127 302 100],144,4,29052,4.244886031560491,0.0,40.0
46844,4,6844,[313 187 127 302 100],144,4,29056,4.244850255661066,0.0,40.0
46845,4,6845,[276 181 385 211  69],538,2,29058,4.244522348816828,0.0,0.0
46846,4,6846,[168 357   7 483  71],380,4,29062,4.244486636483131,40.0,0.0
46847,4,6847,[313 187 127 302 100],207,4,29066,4.244450934579439,0.0,40.0
46848,4,6848,[403  96 132 357 180],7,5,29071,4.244561249817491,20.0,0.0
46849,4,6849,[568 515  71   4  25],308,4,29075,4.244525547445256,0.0,0.0
46850,4,6850,[313 187 127 302 100],334,5,29080,4.244635819588381,0.0,40.0
46851,4,6851,[313 187 127 302 100],13,5,29085,4.244746059544658,0.0,40.0
46852,4,6852,[313 187 127 302 100],207,4,29089,4.2447103458339415,0.0,40.0
46853,4,6853,[313 187 127 302 100],144,4,29093,4.244674642544499,0.0,40.0
46854,4,6854,[313 187 127 302 100],474,5,29098,4.244784828592269,0.0,40.0
46855,4,6855,[  9 195 300 181  64],87,4,29102,4.244749124854143,0.0,0.0
46856,4,6856,[ 89 222 144 195  22],234,1,29103,4.24427592241505,0.0,0.0
46857,4,6857,[  8 313 483 655  89],474,5,29108,4.2443861184018665,20.0,0.0
46858,4,6858,[483   1 385 100  98],788,3,29111,4.24420469456189,20.0,40.0
46859,4,6859,[235 742 100 191 194],271,3,29114,4.244023323615161,0.0,20.0
46860,4,6860,[313 187 127 302 100],334,5,29119,4.244133508234952,0.0,40.0
46861,4,6861,[313 187 127 302 100],271,5,29124,4.244243660740309,0.0,40.0
46862,4,6862,[313 187 127 302 100],537,5,29129,4.244353781145271,0.0,40.0
46863,4,6863,[197  25 204 186 132],318,5,29134,4.244463869463869,0.0,0.0
46864,4,6864,[313 187 127 302 100],207,4,29138,4.244428259286234,0.0,40.0
46865,4,6865,[195 135 132 187 176],326,2,29140,4.244101369064958,0.0,0.0
46866,4,6866,[313 127 187 302 100],207,4,29144,4.244065822047474,0.0,40.0
46867,4,6867,[197  25 121  22  79],452,4,29148,4.24403028538148,0.0,0.0
46868,4,6868,[313 127 187 302 100],207,4,29152,4.2439947590624545,0.0,40.0
46869,4,6869,[313 127 187 302 100],328,5,29157,4.24410480349345,0.0,40.0
46870,4,6870,[313 127 187 302 100],474,5,29162,4.244214815892883,0.0,40.0
46871,4,6871,[313 127 187 302 100],144,4,29166,4.244179278230501,0.0,40.0
46872,4,6872,[313 127 187 302 100],13,5,29171,4.244289247781173,0.0,40.0
46873,4,6873,[313 127 187 302 100],13,5,29176,4.244399185336049,0.0,40.0
46874,4,6874,[313 127 187 302 100],537,5,29181,4.244509090909091,0.0,40.0
46875,4,6875,[172 161 405 235 222],87,4,29185,4.244473531122746,0.0,0.0
46876,4,6876,[313 127 187 302 100],207,4,29189,4.2444379816780575,0.0,40.0
46877,4,6877,[313 127 187 302 100],271,5,29194,4.244547833672579,0.0,40.0
46878,4,6878,[313 127 187 302 100],13,5,29199,4.24465765372874,0.0,40.0
46879,4,6879,[313 127 187 302 100],90,5,29204,4.244767441860465,0.0,40.0
46880,4,6880,[313 127 187 302 100],474,5,29209,4.244877198081674,0.0,40.0
46881,4,6881,[313 127 187 302 100],13,5,29214,4.2449869224062775,0.0,40.0
46882,4,6882,[313 127 187 302 100],334,5,29219,4.245096614848177,0.0,40.0
46883,4,6883,[313 127 187 302 100],474,5,29224,4.245206275421267,0.0,40.0
46884,4,6884,[313 127 187 302 100],334,5,29229,4.245315904139433,0.0,40.0
46885,4,6885,[313 127 187 302 100],537,5,29234,4.245425501016555,0.0,40.0
46886,4,6886,[313 127 187 302 100],537,5,29239,4.245535066066502,0.0,40.0
46887,4,6887,[211 483   4 282 185],666,4,29243,4.245499419279907,20.0,0.0
46888,4,6888,[313 127 187 302 100],474,5,29248,4.245608941791262,0.0,40.0
46889,4,6889,[313 127 187 302 100],474,5,29253,4.245718432510885,0.0,40.0
46890,4,6890,[313 127 187 302 100],90,5,29258,4.2458278914526195,0.0,40.0
46891,4,6891,[228   7 197 118 216],881,3,29261,4.245647127103888,0.0,0.0
46892,4,6892,[313 127 187 302 100],13,5,29266,4.245756564630785,0.0,40.0
46893,4,6893,[313 127 187 302 100],474,5,29271,4.245865970409051,0.0,40.0
46894,4,6894,[168 357 423 182   1],843,0,29271,4.245250181290791,20.0,0.0
46895,4,6895,[313 127 187 302 100],13,5,29276,4.245359628770301,0.0,40.0
46896,4,6896,[313 127 187 302 100],334,5,29281,4.245469044512107,0.0,40.0
46897,4,6897,[313 127 187 302 100],334,5,29286,4.245578428530009,0.0,40.0
46898,4,6898,[313 127 187 302 100],537,5,29291,4.245687780837803,0.0,40.0
46899,4,6899,[144 238   4  28 294],387,2,29293,4.24536231884058,0.0,0.0
46900,4,6900,[313 127 187 302 100],474,5,29298,4.245471670772352,0.0,40.0
46901,4,6901,[222 300 427 186 403],843,0,29298,4.244856563314981,0.0,0.0
46902,4,6902,[313 127 187 302 100],13,5,29303,4.244965956830364,0.0,40.0
46903,4,6903,[135 132   8 328  28],13,4,29307,4.244930475086906,0.0,0.0
46904,4,6904,[313 127 187 302 100],271,5,29312,4.2450398262128894,0.0,40.0
46905,4,6905,[313 127 187 302 100],13,5,29317,4.245149145670432,0.0,40.0
46906,4,6906,[313 127 187 302 100],334,5,29322,4.245258433473288,0.0,40.0
46907,4,6907,[483   9  79 181 194],82,4,29326,4.245222929936306,20.0,0.0
46908,4,6908,[313 127 187 302 100],90,5,29331,4.245332175423361,0.0,40.0
46909,4,6909,[313 127 187 302 100],474,5,29336,4.245441389290883,0.0,40.0
46910,4,6910,[313 127 187 302 100],13,5,29341,4.245550571552597,0.0,40.0
46911,4,6911,[313 127 187 302 100],334,5,29346,4.245659722222222,0.0,40.0
46912,4,6912,[197 183  95 265 144],234,2,29348,4.245334876319977,0.0,0.0
46913,4,6913,[313 127 187 302 100],474,5,29353,4.24544402661267,0.0,40.0
46914,4,6914,[313 127 187 302 100],328,5,29358,4.245553145336226,0.0,40.0
46915,4,6915,[313 127 187 302 100],207,4,29362,4.245517640254483,0.0,40.0
46916,4,6916,[313 127 187 302 100],90,5,29367,4.2456267167847335,0.0,40.0
46917,4,6917,[313 127 187 302 100],271,5,29372,4.245735761780861,0.0,40.0
46918,4,6918,[100 151 118 423  89],7,4,29376,4.245700245700245,0.0,20.0
46919,4,6919,[313 127 187 302 100],334,5,29381,4.245809248554913,0.0,40.0
46920,4,6920,[313 127 187 302 100],207,4,29385,4.245773732119636,0.0,40.0
46921,4,6921,[313 127 187 302 100],271,5,29390,4.245882692863335,0.0,40.0
46922,4,6922,[313 127 187 302 100],144,4,29394,4.245847176079734,0.0,40.0
46923,4,6923,[427  96 435 328 202],537,1,29395,4.2453783939919125,0.0,0.0
46924,4,6924,[405 258 197 100 678],488,1,29396,4.244909747292419,0.0,20.0
46925,4,6925,[174  28   9 179 216],311,4,29400,4.244874386370199,0.0,20.0
46926,4,6926,[175 135 286 151 204],524,1,29401,4.2444059477407245,0.0,0.0
46927,4,6927,[313 127 187 302 100],328,5,29406,4.244515011547344,0.0,40.0
46928,4,6928,[313 127 187 302 100],90,5,29411,4.244624043873575,0.0,40.0
46929,4,6929,[483 197 151  69  11],749,5,29416,4.244733044733045,20.0,0.0
46930,4,6930,[313 127 187 302 100],334,5,29421,4.2448420141393735,0.0,40.0
46931,4,6931,[313 127 187 302 100],334,5,29426,4.244950952106175,0.0,40.0
46932,4,6932,[471  79   9 300 186],328,4,29430,4.244915620943314,0.0,0.0
46933,4,6933,[313 127 187 302 100],13,5,29435,4.245024516873378,0.0,40.0
46934,4,6934,[313 127 187 302 100],328,5,29440,4.245133381398702,0.0,40.0
46935,4,6935,[313 127 187 302 100],537,5,29445,4.245242214532872,0.0,40.0
46936,4,6936,[313 127 187 302 100],144,4,29449,4.245206861755802,0.0,40.0
46937,4,6937,[313 127 187 302 100],334,5,29454,4.245315652925915,0.0,40.0
46938,4,6938,[215  15 403  11 111],749,4,29458,4.245280299755008,0.0,0.0
46939,4,6939,[313 127 187 302 100],334,5,29463,4.245389048991354,0.0,40.0
46940,4,6940,[265 197   4 111 161],378,2,29465,4.245065552514047,0.0,0.0
46941,4,6941,[385  97  22 185 273],308,3,29468,4.24488619994238,0.0,0.0
46942,4,6942,[234 471 216   4 200],537,0,29468,4.244274809160306,0.0,0.0
46943,4,6943,[121 228 176 127 257],334,3,29471,4.244095622119816,0.0,20.0
46944,4,6944,[313 127 187 302 100],144,4,29475,4.244060475161987,0.0,40.0
46945,4,6945,[313 127 187 302 100],207,4,29479,4.2440253383242155,0.0,40.0
46946,4,6946,[282 204 196  82 185],42,5,29484,4.244134158629624,0.0,0.0
46947,4,6947,[313 127 187 302 100],90,5,29489,4.244242947610823,0.0,40.0
46948,4,6948,[313 127 187 302 100],144,4,29493,4.244207799683408,0.0,40.0
46949,4,6949,[313 127 187 302 100],207,4,29497,4.244172661870504,0.0,40.0
46950,4,6950,[313 127 187 302 100],271,5,29502,4.2442813983599486,0.0,40.0
46951,4,6951,[  7 118  96 276   1],881,4,29506,4.244246260069045,0.0,0.0
46952,4,6952,[313 127 187 302 100],207,4,29510,4.244211131885517,0.0,40.0
46953,4,6953,[ 79 127 174 313  11],653,4,29514,4.244176013805005,0.0,40.0
46954,4,6954,[313 127 187 302 100],334,5,29519,4.244284687275342,0.0,40.0
46955,4,6955,[ 56 185 182  70 151],334,3,29522,4.244105807935595,0.0,0.0
46956,4,6956,[313 127 187 302 100],207,4,29526,4.244070720137991,0.0,40.0
46957,4,6957,[313 127 187 302 100],90,5,29531,4.2441793618856,0.0,40.0
46958,4,6958,[ 89 678   8 100 200],387,4,29535,4.244144273602529,0.0,20.0
46959,4,6959,[313 127 187 302 100],144,4,29539,4.244109195402299,0.0,40.0
46960,4,6960,[313 127 187 302 100],537,5,29544,4.244217784801035,0.0,40.0
46961,4,6961,[313 127 187 302 100],90,5,29549,4.244326343004884,0.0,40.0
46962,4,6962,[313 127 187 302 100],144,4,29553,4.244291253769926,0.0,40.0
46963,4,6963,[200 195 588  96 175],95,3,29556,4.244112578977599,0.0,0.0
46964,4,6964,[313 127 187 302 100],334,5,29561,4.244221105527638,0.0,40.0
46965,4,6965,[588   1 471 258  50],360,3,29564,4.244042492104508,0.0,20.0
46966,4,6966,[313 127 187 302 100],328,5,29569,4.244150997559926,0.0,40.0
46967,4,6967,[144 176 216  69 423],95,4,29573,4.244115958668197,0.0,0.0
46968,4,6968,[313 127 187 302 100],13,5,29578,4.244224422442244,0.0,40.0
46969,4,6969,[125 323  50 403 597],59,3,29581,4.244045911047346,0.0,20.0
46970,4,6970,[313 127 187 302 100],144,4,29585,4.244010902309568,0.0,40.0
46971,4,6971,[313 127 187 302 100],207,4,29589,4.243975903614458,0.0,40.0
46972,4,6972,[ 71 125 435 211  82],194,3,29592,4.243797504660835,0.0,0.0
46973,4,6973,[143 357 200 176 186],313,2,29594,4.243475767135073,20.0,0.0
46974,4,6974,[313 127 187 302 100],13,5,29599,4.243584229390681,0.0,40.0
46975,4,6975,[174 191  25 216  15],271,3,29602,4.243405963302752,0.0,20.0
46976,4,6976,[313 127 187 302 100],537,5,29607,4.243514404471836,0.0,40.0
46977,4,6977,[300  70  22   4   7],653,2,29609,4.243192891946117,0.0,0.0
46978,4,6978,[121 132 196 172 153],13,5,29614,4.2433013325691356,0.0,0.0
46979,4,6979,[313 127 187 302 100],13,5,29619,4.243409742120344,0.0,40.0
46980,4,6980,[275 153 318 174 405],334,4,29623,4.243374874659791,20.0,20.0
46981,4,6981,[313 127 187 302 100],13,5,29628,4.24348324262389,0.0,40.0
46982,4,6982,[313   4  96  82 588],378,4,29632,4.243448374624087,0.0,0.0
46983,4,6983,[235   7 228 132 195],200,4,29636,4.243413516609393,0.0,0.0
46984,4,6984,[313 127 187 302 100],144,4,29640,4.243378668575519,0.0,40.0
46985,4,6985,[313 127 187 302 100],144,4,29644,4.243343830518179,0.0,40.0
46986,4,6986,[302 144 176 111 161],543,5,29649,4.243452125375698,0.0,0.0
46987,4,6987,[202 228 161 191 216],313,4,29653,4.2434172867773325,0.0,0.0
46988,4,6988,[313 127 187 302 100],474,5,29658,4.243525540134497,0.0,40.0
46989,4,6989,[313 127 187 302 100],207,4,29662,4.243490701001431,0.0,40.0
46990,4,6990,[183 237 276   7 125],455,3,29665,4.243312830782434,0.0,0.0
46991,4,6991,[313 127 187 302 100],207,4,29669,4.2432780320366135,0.0,40.0
46992,4,6992,[313 127 187 302 100],13,5,29674,4.243386243386244,0.0,40.0
46993,4,6993,[313 127 187 302 100],144,4,29678,4.243351444094938,0.0,40.0
46994,4,6994,[313 127 187 302 100],90,5,29683,4.243459614010007,0.0,40.0
46995,4,6995,[313 127 187 302 100],537,5,29688,4.243567753001715,0.0,40.0
46996,4,6996,[313 127 187 302 100],207,4,29692,4.243532942689725,0.0,40.0
46997,4,6997,[181 144  97 197 172],840,1,29693,4.2430694484138325,0.0,0.0
46998,4,6998,[182  88 118 276  28],92,2,29695,4.242748964137734,0.0,0.0
46999,4,6999,[313 127 187 302 100],474,5,29700,4.242857142857143,0.0,40.0
47000,4,7000,[228 174 135 132 385],13,4,29704,4.242822453935152,0.0,20.0
47001,4,7001,[313 127 187 302 100],13,5,29709,4.24293059125964,0.0,40.0
47002,4,7002,[313 127 187 302 100],474,5,29714,4.243038697700985,0.0,40.0
47003,4,7003,[174 176 211 357   7],14,3,29717,4.2428612221587665,20.0,20.0
47004,4,7004,[313 127 187 302 100],207,4,29721,4.242826552462526,0.0,40.0
47005,4,7005,[186 546 228 405 200],7,4,29725,4.242791892663432,0.0,0.0
47006,4,7006,[313 127 187 302 100],271,5,29730,4.242899957185672,0.0,40.0
47007,4,7007,[313 127 187 302 100],474,5,29735,4.2430079908675795,0.0,40.0
47008,4,7008,[  9  96 268 471 118],145,3,29738,4.242830646311885,0.0,0.0
47009,4,7009,[313 127 187 302 100],537,5,29743,4.242938659058487,0.0,40.0
47010,4,7010,[313 127 187 302 100],474,5,29748,4.243046640992726,0.0,40.0
47011,4,7011,[568 100 258 515 204],455,5,29753,4.243154592127781,0.0,20.0
47012,4,7012,[ 98 235   7 127 195],406,5,29758,4.243262512476829,0.0,40.0
47013,4,7013,[313 127 187 302 100],537,5,29763,4.243370402053037,0.0,40.0
47014,4,7014,[313 127 187 302 100],328,5,29768,4.243478260869566,0.0,40.0
47015,4,7015,[222 294 187 144 275],158,3,29771,4.24330102622577,0.0,0.0
47016,4,7016,[186 127 385 100 216],311,3,29774,4.243123842097763,0.0,40.0
47017,4,7017,[313 127 187 302 100],334,5,29779,4.243231689940154,0.0,40.0
47018,4,7018,[186  98 202 204 748],653,3,29782,4.243054566177518,0.0,20.0
47019,4,7019,[313 127 187 302 100],537,5,29787,4.243162393162393,0.0,40.0
47020,4,7020,[313 127 187 302 100],328,5,29792,4.243270189431705,0.0,40.0
47021,4,7021,[313 127 187 302 100],271,5,29797,4.243377954998576,0.0,40.0
47022,4,7022,[183 197  22  89 172],474,5,29802,4.243485689876121,0.0,0.0
47023,4,7023,[313 127 187 302 100],474,5,29807,4.243593394077449,0.0,40.0
47024,4,7024,[313 127 187 302 100],271,5,29812,4.243701067615659,0.0,40.0
47025,4,7025,[313 127 187 302 100],328,5,29817,4.243808710503843,0.0,40.0
47026,4,7026,[313 127 187 302 100],13,5,29822,4.243916322755087,0.0,40.0
47027,4,7027,[588  28   9  82 496],311,5,29827,4.24402390438247,0.0,0.0
47028,4,7028,[313 127 187 302 100],328,5,29832,4.244131455399061,0.0,40.0
47029,4,7029,[182 302 475 210  98],13,3,29835,4.243954480796586,0.0,20.0
47030,4,7030,[313 127 187 302 100],271,5,29840,4.244062011093728,0.0,40.0
47031,4,7031,[313 127 187 302 100],207,4,29844,4.244027303754266,0.0,40.0
47032,4,7032,[313 127 187 302 100],207,4,29848,4.2439926062846585,0.0,40.0
47033,4,7033,[185  96  79 216 268],145,5,29853,4.244100085299972,0.0,0.0
47034,4,7034,[313 127 187 302 318],474,5,29858,4.244207533759773,20.0,20.0
47035,4,7035,[313 127 187 302 318],144,4,29862,4.2441728254690165,20.0,20.0
47036,4,7036,[313 127 187 302 318],207,5,29867,4.244280233053858,20.0,20.0
47037,4,7037,[313 127 187 302 318],207,5,29872,4.244387610116511,20.0,20.0
47038,4,7038,[313 127 187 302 318],474,5,29877,4.244494956669982,20.0,20.0
47039,4,7039,[313 127 187 302 318],90,5,29882,4.244602272727272,20.0,20.0
47040,4,7040,[313 127 187 302 318],90,5,29887,4.244709558301378,20.0,20.0
47041,4,7041,[313 127 187 302 318],207,5,29892,4.244816813405283,20.0,20.0
47042,4,7042,[ 71 118  50 258 423],749,4,29896,4.244782053102371,0.0,20.0
47043,4,7043,[313 127 187 302 318],474,5,29901,4.244889267461669,20.0,20.0
47044,4,7044,[313 127 187 302 318],328,5,29906,4.24499645138396,20.0,20.0
47045,4,7045,[313 127 187 302 318],207,5,29911,4.245103604882202,20.0,20.0
47046,4,7046,[313 127 187 302 318],328,5,29916,4.245210727969349,20.0,20.0
47047,4,7047,[313 127 187 302 318],90,5,29921,4.245317820658343,20.0,20.0
47048,4,7048,[286   8  28 423 181],881,4,29925,4.245283018867925,0.0,0.0
47049,4,7049,[313 127 187 302 318],474,5,29930,4.245390070921986,20.0,20.0
47050,4,7050,[313 127 187 302 318],334,5,29935,4.245497092610977,20.0,20.0
47051,4,7051,[238 385 603 111 202],899,3,29938,4.245320476460579,20.0,0.0
47052,4,7052,[313 127 187 302 318],537,5,29943,4.245427477669077,20.0,20.0
47053,4,7053,[313 127 187 302 318],13,4,29947,4.245392685001417,20.0,20.0
47054,4,7054,[172 132 179 186 168],524,2,29949,4.2450744153082915,0.0,0.0
47055,4,7055,[313 127 187 302 318],13,4,29953,4.245039682539683,20.0,20.0
47056,4,7056,[313 127 187 302 318],144,4,29957,4.245004959614567,20.0,20.0
47057,4,7057,[313 127 187 302 318],90,5,29962,4.245111929725135,20.0,20.0
47058,4,7058,[313 127 187 302 318],207,5,29967,4.245218869528262,20.0,20.0
47059,4,7059,[313 127 187 302 318],474,5,29972,4.245325779036827,20.0,20.0
47060,4,7060,[313 127 187 302 318],144,4,29976,4.245291035264127,20.0,20.0
47061,4,7061,[313 127 187 302 318],474,5,29981,4.245397904276409,20.0,20.0
47062,4,7062,[187 143 172 597   8],213,4,29985,4.245363160130256,0.0,0.0
47063,4,7063,[313 127 187 302 318],334,5,29990,4.245469988674972,20.0,20.0
47064,4,7064,[313 127 187 302 318],271,5,29995,4.245576786978061,20.0,20.0
47065,4,7065,[313 127 187 302 318],144,4,29999,4.245542032267195,20.0,20.0
47066,4,7066,[313 127 187 302 318],13,4,30003,4.245507287392104,20.0,20.0
47067,4,7067,[313 127 187 302 318],271,5,30008,4.245614035087719,20.0,20.0
47068,4,7068,[313 127 187 302 318],537,5,30013,4.245720752581695,20.0,20.0
47069,4,7069,[313 127 187 302 318],474,5,30018,4.245827439886845,20.0,20.0
47070,4,7070,[313 127 187 302 318],328,5,30023,4.245934097015981,20.0,20.0
47071,4,7071,[313 127 187 302 318],90,5,30028,4.2460407239819,20.0,20.0
47072,4,7072,[313 127 187 302 318],334,5,30033,4.246147320797399,20.0,20.0
47073,4,7073,[435  71 234 273 546],234,1,30034,4.245688436528131,0.0,0.0
47074,4,7074,[127 588  89  79 423],881,4,30038,4.24565371024735,0.0,20.0
47075,4,7075,[168  71 197 228 568],387,2,30040,4.245336348219333,0.0,0.0
47076,4,7076,[ 88 302 655 228 195],339,4,30044,4.245301681503462,0.0,0.0
47077,4,7077,[313 127 187 302 318],90,5,30049,4.245408307431478,20.0,20.0
47078,4,7078,[313 127 187 302 318],90,5,30054,4.24551490323492,20.0,20.0
47079,4,7079,[313 127 187 302 318],90,5,30059,4.2456214689265535,20.0,20.0
47080,4,7080,[313 127 187 302 318],334,5,30064,4.245728004519136,20.0,20.0
47081,4,7081,[313 127 187 302 318],144,4,30068,4.245693306975431,20.0,20.0
47082,4,7082,[323 111 403 435 328],13,2,30070,4.245376253000141,0.0,0.0
47083,4,7083,[ 79 179 118 174 216],666,1,30071,4.244918125352908,0.0,20.0
47084,4,7084,[313 127 187 302 318],474,5,30076,4.245024700070571,20.0,20.0
47085,4,7085,[ 50 181  97  95 427],830,4,30080,4.244990121366074,0.0,20.0
47086,4,7086,[144  71 234 403 211],543,5,30085,4.245096655848737,0.0,0.0
47087,4,7087,[313 127 187 302 318],328,5,30090,4.24520316027088,20.0,20.0
47088,4,7088,[  1 222 403 143  25],339,4,30094,4.245168571025532,0.0,0.0
47089,4,7089,[313 127 187 302 318],537,5,30099,4.2452750352609305,20.0,20.0
47090,4,7090,[313 127 187 302 318],334,5,30104,4.24538146946834,20.0,20.0
47091,4,7091,[228  12 357 181  56],537,2,30106,4.245064861816131,40.0,0.0
47092,4,7092,[313 127 187 302 318],90,5,30111,4.245171295643592,20.0,20.0
47093,4,7093,[ 50 100 568  22 302],378,5,30116,4.245277699464336,0.0,40.0
47094,4,7094,[313 127 187 302 318],207,5,30121,4.24538407329105,20.0,20.0
47095,4,7095,[168 100 515 216 118],59,5,30126,4.2454904171364145,0.0,20.0
47096,4,7096,[153 275 175 222 508],378,4,30130,4.245455826405523,0.0,0.0
47097,4,7097,[655 588 161  50   1],194,4,30134,4.245421245421245,0.0,20.0
47098,4,7098,[202 144 403 175   9],13,3,30137,4.245245809268911,0.0,0.0
47099,4,7099,[153 118 269  98  50],666,3,30140,4.245070422535211,0.0,40.0
47100,4,7100,[313 127 187 302 318],271,5,30145,4.245176735671032,20.0,20.0
47101,4,7101,[597 180 153 125  69],378,1,30146,4.244719797240214,0.0,0.0
47102,4,7102,[313 127 187 302 318],144,4,30150,4.244685344220752,20.0,20.0
47103,4,7103,[313 127 187 302 318],537,5,30155,4.244791666666667,20.0,20.0
47104,4,7104,[174  79 403 475 237],374,3,30158,4.244616467276566,0.0,20.0
47105,4,7105,[496 100 127 427 245],666,4,30162,4.244582043343653,0.0,40.0
47106,4,7106,[313 127 187 302 318],537,5,30167,4.244688335443929,20.0,20.0
47107,4,7107,[313 127 187 302 318],207,5,30172,4.244794597636466,20.0,20.0
47108,4,7108,[313 127 187 302 318],13,4,30176,4.244760163173442,20.0,20.0
47109,4,7109,[313 127 187 302 318],144,4,30180,4.244725738396625,20.0,20.0
47110,4,7110,[313 127 187 302 318],474,5,30185,4.2448319504992265,20.0,20.0
47111,4,7111,[313 127 187 302 318],328,5,30190,4.244938132733409,20.0,20.0
47112,4,7112,[313 127 187 302 318],13,4,30194,4.244903697455364,20.0,20.0
47113,4,7113,[313 127 187 302 318],474,5,30199,4.2450098397526,20.0,20.0
47114,4,7114,[435 168 176 211 185],890,4,30203,4.244975404075896,0.0,0.0
47115,4,7115,[210 185 475  98  11],308,4,30207,4.2449409780775715,0.0,20.0
47116,4,7116,[313 127 187 302 318],271,5,30212,4.245047070394829,20.0,20.0
47117,4,7117,[313 127 187 302 318],13,4,30216,4.2450126440011235,20.0,20.0
47118,4,7118,[173  25 135 322   8],207,1,30217,4.244556819778059,0.0,0.0
47119,4,7119,[ 89 655 172   4  15],59,5,30222,4.244662921348315,0.0,0.0
47120,4,7120,[313 127 187 302 318],334,5,30227,4.244768993118944,20.0,20.0
47121,4,7121,[313 127 187 302 318],334,5,30232,4.244875035102499,20.0,20.0
47122,4,7122,[ 64 222 174 135 265],64,5,30237,4.244981047311526,0.0,20.0
47123,4,7123,[313 127 187 302 318],537,5,30242,4.245087029758563,20.0,20.0
47124,4,7124,[313 127 187 302 318],537,5,30247,4.245192982456141,20.0,20.0
47125,4,7125,[313 127 187 302 318],13,4,30251,4.245158574235195,20.0,20.0
47126,4,7126,[313 127 187 302 100],334,5,30256,4.245264487161498,0.0,40.0
47127,4,7127,[313 127 187 302 100],474,5,30261,4.24537037037037,0.0,40.0
47128,4,7128,[313 127 187 302 100],207,4,30265,4.245335951746388,0.0,40.0
47129,4,7129,[181  95  70 475  12],64,5,30270,4.245441795231416,20.0,0.0
47130,4,7130,[313 127 187 302 318],474,5,30275,4.245547609030991,20.0,20.0
47131,4,7131,[210 144 185 161 151],234,0,30275,4.244952327537858,0.0,0.0
47132,4,7132,[313 127 187 302 318],474,5,30280,4.245058180288798,20.0,20.0
47133,4,7133,[313 127 187 302 318],537,5,30285,4.245164003364172,20.0,20.0
47134,4,7134,[435 403 181  97 568],87,4,30289,4.245129642606868,0.0,0.0
47135,4,7135,[313 127 187 302 318],90,5,30294,4.245235426008969,20.0,20.0
47136,4,7136,[ 11  79 175 200  50],59,5,30299,4.24534117976741,0.0,20.0
47137,4,7137,[ 97 187   8 161 175],313,4,30303,4.245306808629868,0.0,0.0
47138,4,7138,[125 235 655 742 111],378,3,30306,4.2451323714806,0.0,0.0
47139,4,7139,[427 269 276 173 216],339,4,30310,4.245098039215686,0.0,0.0
47140,4,7140,[313 127 187 302 318],207,5,30315,4.245203752975773,20.0,20.0
47141,4,7141,[313 127 187 302 318],207,5,30320,4.245309437132456,20.0,20.0
47142,4,7142,[313 127 187 302 318],334,5,30325,4.245415091698166,20.0,20.0
47143,4,7143,[313 127 187 302 318],90,5,30330,4.245520716685331,20.0,20.0
47144,4,7144,[313 127 187 302 318],90,5,30335,4.245626312106368,20.0,20.0
47145,4,7145,[313 127 187 302 318],271,5,30340,4.245731877973691,20.0,20.0
47146,4,7146,[216   7  25  96 161],7,3,30343,4.245557576605568,0.0,0.0
47147,4,7147,[ 98 405 286 496 117],194,2,30345,4.245243424734191,0.0,20.0
47148,4,7148,[313 127 187 302 318],474,5,30350,4.24534899986012,20.0,20.0
47149,4,7149,[313 127 187 302 318],334,5,30355,4.245454545454545,20.0,20.0
47150,4,7150,[313 127 187 302 318],537,5,30360,4.245560061529856,20.0,20.0
47151,4,7151,[313 127 187 302 318],474,5,30365,4.245665548098434,20.0,20.0
47152,4,7152,[313 127 187 302 318],13,4,30369,4.245631203690759,20.0,20.0
47153,4,7153,[175 186 144 288 181],339,3,30372,4.245457086944366,0.0,0.0
47154,4,7154,[427 265 211  69 385],830,5,30377,4.245562543675751,0.0,0.0
47155,4,7155,[  9 204  98 181 276],881,4,30381,4.245528228060369,0.0,20.0
47156,4,7156,[313 127 187 302 318],271,5,30386,4.245633645382143,20.0,20.0
47157,4,7157,[216 168 195  11 483],749,5,30391,4.245739033249511,20.0,0.0
47158,4,7158,[  1 258 183  25 222],92,4,30395,4.245704707361363,0.0,0.0
47159,4,7159,[313 127 187 302 318],207,5,30400,4.245810055865922,20.0,20.0
47160,4,7160,[313 127 187 302 318],328,5,30405,4.245915374947633,20.0,20.0
47161,4,7161,[313 127 187 302 318],13,4,30409,4.245881038815973,20.0,20.0
47162,4,7162,[313 127 187 302 318],271,5,30414,4.2459863185816,20.0,20.0
47163,4,7163,[195 269 257 313 286],934,3,30417,4.2458123953098825,0.0,0.0
47164,4,7164,[313 127 187 302 318],271,5,30422,4.245917655268667,20.0,20.0
47165,4,7165,[313 127 187 302 318],144,4,30426,4.245883337984929,20.0,20.0
47166,4,7166,[313 127 187 302 318],13,4,30430,4.245849030277662,20.0,20.0
47167,4,7167,[ 50 515 168 176  96],387,4,30434,4.245814732142857,0.0,20.0
47168,4,7168,[200 161  97 597 186],328,3,30437,4.245640954107965,0.0,0.0
47169,4,7169,[313 127 187 302 100],13,5,30442,4.245746164574617,0.0,40.0
47170,4,7170,[313 127 187 302 100],537,5,30447,4.24585134569795,0.0,40.0
47171,4,7171,[313 127 187 302 100],13,5,30452,4.24595649749024,0.0,40.0
47172,4,7172,[ 89 204   1 161  96],308,4,30456,4.245922208281054,0.0,0.0
47173,4,7173,[313 127 187 302 100],13,5,30461,4.246027320880959,0.0,40.0
47174,4,7174,[313 127 187 302 100],13,5,30466,4.246132404181185,0.0,40.0
47175,4,7175,[210  28 135 197 265],334,2,30468,4.245819397993311,0.0,0.0
47176,4,7176,[313 127 187 302 100],207,4,30472,4.245785146997353,0.0,40.0
47177,4,7177,[313 127 187 302 100],328,5,30477,4.245890220117024,0.0,40.0
47178,4,7178,[302  50 275 174 286],145,3,30480,4.245716673631425,0.0,40.0
47179,4,7179,[313 127 187 302 100],334,5,30485,4.245821727019498,0.0,40.0
47180,4,7180,[197 245  96 185 125],207,3,30488,4.245648238406907,0.0,0.0
47181,4,7181,[ 95 597 475 313 173],455,4,30492,4.245614035087719,0.0,0.0
47182,4,7182,[ 22 333 127 276 144],298,4,30496,4.245579841291939,0.0,20.0
47183,4,7183,[313 127 187 302 100],90,5,30501,4.245684855233853,0.0,40.0
47184,4,7184,[313 127 187 302 100],537,5,30506,4.245789839944329,0.0,40.0
47185,4,7185,[313 127 187 302 100],328,5,30511,4.245894795435569,0.0,40.0
47186,4,7186,[121 185 181 405 172],328,5,30516,4.245999721719772,0.0,0.0
47187,4,7187,[132  64 186 121  22],308,3,30519,4.245826377295493,0.0,0.0
47188,4,7188,[313 127 187 302 100],334,5,30524,4.245931283905968,0.0,40.0
47189,4,7189,[ 82 186 211 222 173],60,4,30528,4.245897079276773,0.0,0.0
47190,4,7190,[235  56 118 678  22],82,0,30528,4.245306633291615,0.0,0.0
47191,4,7191,[313 127 187 302 100],474,5,30533,4.245411568409343,0.0,40.0
47192,4,7192,[313 127 187 302 100],90,5,30538,4.245516474350063,0.0,40.0
47193,4,7193,[471 153 508 180  70],605,3,30541,4.245343341673617,0.0,0.0
47194,4,7194,[ 56 211  82 175 100],788,2,30543,4.24503127171647,0.0,20.0
47195,4,7195,[313 127 187 302 100],144,4,30547,4.2449972206781545,0.0,40.0
47196,4,7196,[313 127 187 302 100],207,4,30551,4.244963179102403,0.0,40.0
47197,4,7197,[313 127 187 302 100],90,5,30556,4.245068074465129,0.0,40.0
47198,4,7198,[313 127 187 302 100],474,5,30561,4.245172940686206,0.0,40.0
47199,4,7199,[427  97 318 228 300],7,5,30566,4.245277777777778,20.0,0.0
47200,4,7200,[275 174  50 117 181],13,3,30569,4.245104846549091,0.0,40.0
47201,4,7201,[313 127 187 302 100],90,5,30574,4.245209663982227,0.0,40.0
47202,4,7202,[ 95   9 211  79 508],6,2,30576,4.244897959183674,0.0,0.0
47203,4,7203,[313 127 187 302 100],271,5,30581,4.245002776235425,0.0,40.0
47204,4,7204,[ 89 435 276 202 117],892,5,30586,4.2451075641915335,0.0,0.0
47205,4,7205,[265  64 196 300 143],537,0,30586,4.244518456841521,0.0,0.0
47206,4,7206,[313 127 187 302 100],328,5,30591,4.244623282919384,0.0,40.0
47207,4,7207,[313 127 187 302 100],474,5,30596,4.2447280799112095,0.0,40.0
47208,4,7208,[276 182  79 258 265],339,3,30599,4.244555416840061,0.0,0.0
47209,4,7209,[121  89 294 186 182],897,4,30603,4.244521497919556,0.0,0.0
47210,4,7210,[313 127 187 302 100],474,5,30608,4.244626265427819,0.0,40.0
47211,4,7211,[313 127 187 302 100],474,5,30613,4.244731003882418,0.0,40.0
47212,4,7212,[568 194 423 289 197],95,4,30617,4.244697074726189,0.0,0.0
47213,4,7213,[313 127 187 302 100],13,5,30622,4.244801774327696,0.0,40.0
47214,4,7214,[ 70 211 258 385 197],90,4,30626,4.2447678447678445,0.0,0.0
47215,4,7215,[313 127 187 302 100],90,5,30631,4.2448725055432375,0.0,40.0
47216,4,7216,[153  12 496  50 313],308,3,30634,4.244700013856173,20.0,20.0
47217,4,7217,[211 385 210  64 357],543,3,30637,4.244527569963979,20.0,0.0
47218,4,7218,[235 603 423 210 234],643,5,30642,4.24463222052916,20.0,0.0
47219,4,7219,[313 127 187 302 100],271,5,30647,4.244736842105263,0.0,40.0
47220,4,7220,[313 127 187 302 100],271,5,30652,4.244841434704335,0.0,40.0
47221,4,7221,[313 127 187 302 100],328,5,30657,4.244945998338411,0.0,40.0
47222,4,7222,[313 127 187 302 100],13,5,30662,4.245050533019521,0.0,40.0
47223,4,7223,[  4 176 183 151 423],64,3,30665,4.2448781838316725,0.0,0.0
47224,4,7224,[313 127 187 302 100],13,5,30670,4.2449826989619375,0.0,40.0
47225,4,7225,[313 127 187 302 100],144,4,30674,4.244948796014392,0.0,40.0
47226,4,7226,[228 168 748 655 385],102,1,30675,4.244499792444998,0.0,0.0
47227,4,7227,[143 275 748 568 176],533,3,30678,4.244327614831212,0.0,0.0
47228,4,7228,[ 95 117 173  82 172],200,5,30683,4.244432148291604,0.0,0.0
47229,4,7229,[313 127 187 302 100],271,5,30688,4.244536652835408,0.0,40.0
47230,4,7230,[313 127 187 302 100],144,4,30692,4.244502835015903,0.0,40.0
47231,4,7231,[313 127 187 302 100],334,5,30697,4.244607300884955,0.0,40.0
47232,4,7232,[313 127 187 302 100],271,5,30702,4.244711737868105,0.0,40.0
47233,4,7233,[132   7 143  12  50],339,5,30707,4.244816145977329,20.0,20.0
47234,4,7234,[313 127 187 302 100],537,5,30712,4.244920525224603,0.0,40.0
47235,4,7235,[172 186 204 742 151],298,3,30715,4.244748479823107,0.0,0.0
47236,4,7236,[216   1 121 234 435],194,2,30717,4.244438303164294,0.0,0.0
47237,4,7237,[313 127 187 302 100],334,5,30722,4.244542691351202,0.0,40.0
47238,4,7238,[313 127 187 302 100],271,5,30727,4.24464705069761,0.0,40.0
47239,4,7239,[258 588 197 483 678],263,2,30729,4.244337016574586,20.0,0.0
47240,4,7240,[313 127 187 302 100],271,5,30734,4.244441375500622,0.0,40.0
47241,4,7241,[ 96 427 222 132 143],474,5,30739,4.244545705606186,0.0,0.0
47242,4,7242,[313 127 187 302 100],90,5,30744,4.244650006903217,0.0,40.0
47243,4,7243,[313 127 187 302 100],537,5,30749,4.244754279403645,0.0,40.0
47244,4,7244,[313 127 187 302 100],90,5,30754,4.244858523119393,0.0,40.0
47245,4,7245,[313 127 187 302 100],207,4,30758,4.244824730886006,0.0,40.0
47246,4,7246,[313 127 187 302 100],328,5,30763,4.244928936111495,0.0,40.0
47247,4,7247,[313 127 187 302 100],207,4,30767,4.244895143487859,0.0,40.0
47248,4,7248,[313 127 187 302 100],207,4,30771,4.244861360187612,0.0,40.0
47249,4,7249,[748  82 228 483 423],200,4,30775,4.244827586206896,20.0,0.0
47250,4,7250,[313 127 187 302 483],13,5,30780,4.244931733553993,20.0,20.0
47251,4,7251,[185  95 471 176 496],537,2,30782,4.244622173193601,0.0,0.0
47252,4,7252,[215 168 182 135 176],385,1,30783,4.244174824210671,0.0,0.0
47253,4,7253,[313 127 187 302 483],207,5,30788,4.244279018472567,20.0,20.0
47254,4,7254,[496 117 176  69 127],263,4,30792,4.244245348035838,0.0,20.0
47255,4,7255,[313 127 187 302 483],90,5,30797,4.244349503858875,20.0,20.0
47256,4,7256,[313 127 187 302 483],207,5,30802,4.244453630976988,20.0,20.0
47257,4,7257,[313 127 187 302 483],13,5,30807,4.24455772940204,20.0,20.0
47258,4,7258,[186  69 202  82 153],398,4,30811,4.244524039123847,0.0,0.0
47259,4,7259,[313 127 187 302 483],13,5,30816,4.244628099173553,20.0,20.0
47260,4,7260,[234 322 276  70 318],533,3,30819,4.244456686406831,20.0,0.0
47261,4,7261,[313 127 187 302 483],334,5,30824,4.2445607270724315,20.0,20.0
47262,4,7262,[  4 135 357 234 195],881,3,30827,4.244389370783423,20.0,0.0
47263,4,7263,[313 127 187 302 483],207,5,30832,4.244493392070485,20.0,20.0
47264,4,7264,[313 127 187 302 483],207,5,30837,4.244597384721266,20.0,20.0
47265,4,7265,[173 475 132  79 742],334,3,30840,4.244426094137077,0.0,0.0
47266,4,7266,[313 127 187 302 483],90,5,30845,4.2445300674281,20.0,20.0
47267,4,7267,[ 56  11  89 282 202],145,5,30850,4.24463401210787,0.0,0.0
47268,4,7268,[ 70   9 496   4 100],87,5,30855,4.244737928188196,0.0,20.0
47269,4,7269,[ 50 143  89  71   8],479,3,30858,4.2445667125171935,0.0,20.0
47270,4,7270,[313 127 187 302 483],669,4,30862,4.244533076605694,20.0,20.0
47271,4,7271,[313 127 187 302 483],90,5,30867,4.24463696369637,20.0,20.0
47272,4,7272,[313 127 187 302 483],13,5,30872,4.244740822219167,20.0,20.0
47273,4,7273,[168 174 748 216 515],313,3,30875,4.244569700302447,0.0,20.0
47274,4,7274,[ 89 385 234 182  79],346,4,30879,4.244536082474227,0.0,0.0
47275,4,7275,[313 127 187 302 483],13,5,30884,4.244639912039582,20.0,20.0
47276,4,7276,[313 127 187 302 483],669,4,30888,4.244606293802391,20.0,20.0
47277,4,7277,[132 194 174  56 228],804,4,30892,4.244572684803518,0.0,20.0
47278,4,7278,[294  82 204 176 118],13,2,30894,4.244264322022256,0.0,0.0
47279,4,7279,[ 64 333  96  98 405],458,3,30897,4.244093406593406,0.0,20.0
47280,4,7280,[313 127 187 302 100],13,5,30902,4.2441972256558165,0.0,40.0
47281,4,7281,[313 127 187 302 100],271,5,30907,4.244301016204339,0.0,40.0
47282,4,7282,[313 127 187 302 100],474,5,30912,4.244404778250721,0.0,40.0
47283,4,7283,[168 475 471 174 294],13,2,30914,4.244096650192202,0.0,20.0
47284,4,7284,[313 127 187 302 100],13,5,30919,4.244200411805079,0.0,40.0
47285,4,7285,[313 127 187 302 100],90,5,30924,4.244304144935493,0.0,40.0
47286,4,7286,[ 56 302  64 191 235],378,5,30929,4.244407849595169,0.0,0.0
47287,4,7287,[313 127 187 302 100],271,5,30934,4.244511525795828,0.0,40.0
47288,4,7288,[181 168 228   1 385],59,4,30938,4.24447798051859,0.0,0.0
47289,4,7289,[313 127 187 302 100],13,5,30943,4.244581618655693,0.0,40.0
47290,4,7290,[313 127 187 302 100],334,5,30948,4.244685228363736,0.0,40.0
47291,4,7291,[204 100  95 121   4],738,4,30952,4.244651673066374,0.0,20.0
47292,4,7292,[ 25 181 127 294  98],308,3,30955,4.244481009186892,0.0,40.0
47293,4,7293,[313 127 187 302 100],207,4,30959,4.244447491088566,0.0,40.0
47294,4,7294,[ 71 100 276 222 194],378,4,30963,4.244413982179575,0.0,20.0
47295,4,7295,[313 127 187 302 318],90,5,30968,4.244517543859649,20.0,20.0
47296,4,7296,[313 127 187 302 318],90,5,30973,4.244621077154995,20.0,20.0
47297,4,7297,[313 127 187 302 318],328,5,30978,4.244724582077281,20.0,20.0
47298,4,7298,[196 151  50 318 194],295,5,30983,4.24482805863817,20.0,20.0
47299,4,7299,[403  22 265 181  88],311,5,30988,4.244931506849315,0.0,0.0
47300,4,7300,[313 127 187 302 318],90,5,30993,4.245034926722367,20.0,20.0
47301,4,7301,[313 127 187 302 318],144,4,30997,4.245001369487811,20.0,20.0
47302,4,7302,[313 127 187 302 318],271,5,31002,4.245104751471998,20.0,20.0
47303,4,7303,[313 127 187 302 318],90,5,31007,4.2452081051478645,20.0,20.0
47304,4,7304,[313 127 187 302 318],271,5,31012,4.245311430527036,20.0,20.0
47305,4,7305,[313 127 187 302 318],537,5,31017,4.245414727621133,20.0,20.0
47306,4,7306,[313 127 187 302 318],207,5,31022,4.245517996441768,20.0,20.0
47307,4,7307,[313 127 187 302 318],90,5,31027,4.245621237000547,20.0,20.0
47308,4,7308,[313 127 187 302 318],144,4,31031,4.245587631686961,20.0,20.0
47309,4,7309,[313 127 187 302 318],144,4,31035,4.245554035567715,20.0,20.0
47310,4,7310,[313 127 187 302 318],271,5,31040,4.245657228833265,20.0,20.0
47311,4,7311,[313 127 187 302 318],474,5,31045,4.245760393873085,20.0,20.0
47312,4,7312,[313 127 187 302 318],537,5,31050,4.245863530698756,20.0,20.0
47313,4,7313,[313 127 187 302 318],271,5,31055,4.245966639321849,20.0,20.0
47314,4,7314,[ 88 151 210  97 153],848,5,31060,4.2460697197539305,0.0,0.0
47315,4,7315,[313 127 187 302 318],537,5,31065,4.246172772006561,20.0,20.0
47316,4,7316,[313 127 187 302 318],474,5,31070,4.246275796091294,20.0,20.0
47317,4,7317,[313 127 187 302 318],474,5,31075,4.246378792019677,20.0,20.0
47318,4,7318,[200 222  50 216 197],881,2,31077,4.246071867741494,0.0,20.0
47319,4,7319,[313 127 187 302 318],271,5,31082,4.246174863387978,20.0,20.0
47320,4,7320,[313 127 187 302 318],13,4,31086,4.246141237535856,20.0,20.0
47321,4,7321,[323 195  96 385 172],197,3,31089,4.245971046162251,0.0,0.0
47322,4,7322,[313 127 187 302 318],90,5,31094,4.2460740133824935,20.0,20.0
47323,4,7323,[313 127 187 302 318],207,5,31099,4.246176952484981,20.0,20.0
47324,4,7324,[313 127 187 302 318],13,4,31103,4.246143344709898,20.0,20.0
47325,4,7325,[111 268 435  95  98],13,5,31108,4.246246246246246,0.0,20.0
47326,4,7326,[313 127 187 302 318],474,5,31113,4.2463491196942815,20.0,20.0
47327,4,7327,[313 127 187 302 318],328,5,31118,4.246451965065503,20.0,20.0
47328,4,7328,[313 127 187 302 318],90,5,31123,4.246554782371401,20.0,20.0
47329,4,7329,[313 127 187 302 318],90,5,31128,4.246657571623465,20.0,20.0
47330,4,7330,[313 127 187 302 318],144,4,31132,4.246623925794571,20.0,20.0
47331,4,7331,[423 265 300 245 427],313,4,31136,4.246590289143481,0.0,0.0
47332,4,7332,[313 127 187 302 318],90,5,31141,4.246693031501432,20.0,20.0
47333,4,7333,[313 127 187 302 318],537,5,31146,4.246795745841287,20.0,20.0
47334,4,7334,[313 127 187 302 318],474,5,31151,4.246898432174506,20.0,20.0
47335,4,7335,[313 127 187 302 318],328,5,31156,4.247001090512541,20.0,20.0
47336,4,7336,[313 127 187 302 318],144,4,31160,4.24696742537822,20.0,20.0
47337,4,7337,[191 195 187 183 655],379,4,31164,4.24693376941946,0.0,0.0
47338,4,7338,[313 127 187 302 318],13,4,31168,4.246900122632511,20.0,20.0
47339,4,7339,[313 127 187 302 318],537,5,31173,4.247002724795641,20.0,20.0
47340,4,7340,[313 127 187 302 318],271,5,31178,4.247105299005585,20.0,20.0
47341,4,7341,[313 127 187 302 318],537,5,31183,4.247207845273767,20.0,20.0
47342,4,7342,[313 127 187 302 318],328,5,31188,4.247310363611603,20.0,20.0
47343,4,7343,[ 98 427 176  95 546],374,4,31192,4.247276688453159,0.0,20.0
47344,4,7344,[313 127 187 302 318],207,5,31197,4.247379169503064,20.0,20.0
47345,4,7345,[313 127 187 302 318],207,5,31202,4.247481622651783,20.0,20.0
47346,4,7346,[313 127 187 302 318],90,5,31207,4.247584047910712,20.0,20.0
47347,4,7347,[313 127 187 302 318],474,5,31212,4.247686445291236,20.0,20.0
47348,4,7348,[313 127 187 302 318],13,4,31216,4.247652741869642,20.0,20.0
47349,4,7349,[211 216  28 186 196],13,4,31220,4.247619047619048,0.0,0.0
47350,4,7350,[313 127 187 302 318],90,5,31225,4.24772139844919,20.0,20.0
47351,4,7351,[ 97 258 195 161  70],7,3,31228,4.2475516866158864,0.0,0.0
47352,4,7352,[435 197 174 237 357],533,3,31231,4.247382020943832,20.0,20.0
47353,4,7353,[313 127 187 302 318],271,5,31236,4.247484362251836,20.0,20.0
47354,4,7354,[313 127 187 302 318],13,4,31240,4.247450713800136,20.0,20.0
47355,4,7355,[174 496 117 211 483],343,4,31244,4.247417074497009,20.0,20.0
47356,4,7356,[313 127 187 302 318],537,5,31249,4.247519369308142,20.0,20.0
47357,4,7357,[313 127 187 302 318],474,5,31254,4.247621636314216,20.0,20.0
47358,4,7358,[234 195 151 182 435],308,4,31258,4.247587987498301,0.0,0.0
47359,4,7359,[313 127 187 302 318],144,4,31262,4.247554347826087,20.0,20.0
47360,4,7360,[313 127 187 302 318],144,4,31266,4.247520717293846,20.0,20.0
47361,4,7361,[  8 117 182 176 125],892,5,31271,4.2476229285520235,0.0,0.0
47362,4,7362,[ 22  69 333 187 235],343,4,31275,4.2475892978405545,0.0,0.0
47363,4,7363,[313 127 187 302 318],328,5,31280,4.247691472026073,20.0,20.0
47364,4,7364,[313 127 187 302 318],271,5,31285,4.247793618465717,20.0,20.0
47365,4,7365,[313 127 187 302 318],90,5,31290,4.247895737170785,20.0,20.0
47366,4,7366,[313 127 187 302 318],328,5,31295,4.247997828152572,20.0,20.0
47367,4,7367,[313 127 187 302 318],90,5,31300,4.248099891422367,20.0,20.0
47368,4,7368,[678 186  11 174 265],488,3,31303,4.247930519744878,0.0,20.0
47369,4,7369,[313 127 187 302 318],13,4,31307,4.247896879240163,20.0,20.0
47370,4,7370,[313 127 187 302 318],328,5,31312,4.247998914665581,20.0,20.0
47371,4,7371,[313 127 187 302 318],537,5,31317,4.248100922409115,20.0,20.0
47372,4,7372,[121 204 282 471 234],479,5,31322,4.248202902482029,0.0,0.0
47373,4,7373,[181  12 187 210 235],385,2,31324,4.247898020070518,20.0,0.0
47374,4,7374,[313 127 187 302 318],271,5,31329,4.248,20.0,20.0
47375,4,7375,[234 318  70 215 168],233,5,31334,4.248101952277657,20.0,0.0
47376,4,7376,[200 258  95   8  97],506,5,31339,4.248203876914735,0.0,0.0
47377,4,7377,[313 127 187 302 318],13,4,31343,4.24817023583627,20.0,20.0
47378,4,7378,[176 175 405 125 200],92,3,31346,4.248001084157745,0.0,0.0
47379,4,7379,[313 127 187 302 318],207,5,31351,4.2481029810298105,20.0,20.0
47380,4,7380,[742   9 181 597 121],486,2,31353,4.247798401300637,0.0,0.0
47381,4,7381,[603 144  97  15 210],543,2,31355,4.247493904091033,20.0,0.0
47382,4,7382,[313 127 187 302 318],474,5,31360,4.247595828254097,20.0,20.0
47383,4,7383,[176 282 185 143 200],881,4,31364,4.247562296858072,0.0,0.0
47384,4,7384,[ 64 117 568 185 237],313,4,31368,4.247528774542992,0.0,0.0
47385,4,7385,[313 127 187 302 318],207,5,31373,4.247630652585974,20.0,20.0
47386,4,7386,[313 127 187 302 318],271,5,31378,4.247732503045891,20.0,20.0
47387,4,7387,[546 222 288 144  12],378,2,31380,4.247428262046562,20.0,0.0
47388,4,7388,[313 127 187 302 318],328,5,31385,4.247530112329138,20.0,20.0
47389,4,7389,[313 127 187 302 318],144,4,31389,4.247496617050068,20.0,20.0
47390,4,7390,[313 127 187 302 318],334,5,31394,4.24759843052361,20.0,20.0
47391,4,7391,[313 127 187 302 318],13,4,31398,4.247564935064935,20.0,20.0
47392,4,7392,[405 237  64 204 181],537,0,31398,4.246990396320844,0.0,0.0
47393,4,7393,[313 127 187 302 100],90,5,31403,4.247092236948878,0.0,40.0
47394,4,7394,[313 127 187 302 100],537,5,31408,4.247194050033807,0.0,40.0
47395,4,7395,[313 127 187 302 100],90,5,31413,4.247295835586804,0.0,40.0
47396,4,7396,[313 127 187 302 100],90,5,31418,4.247397593619035,0.0,40.0
47397,4,7397,[313 127 187 302 100],334,5,31423,4.24749932414166,0.0,40.0
47398,4,7398,[313 127 187 302 100],328,5,31428,4.2476010271658335,0.0,40.0
47399,4,7399,[238  22 289 286 174],234,2,31430,4.2472972972972975,0.0,20.0
47400,4,7400,[313 127 187 302 100],13,5,31435,4.2473990001351165,0.0,40.0
47401,4,7401,[313 127 187 302 100],144,4,31439,4.247365576871116,0.0,40.0
47402,4,7402,[313 127 187 302 100],537,5,31444,4.2474672430095906,0.0,40.0
47403,4,7403,[313 127 187 302 100],90,5,31449,4.2475688816855754,0.0,40.0
47404,4,7404,[222 268 200 135 180],387,4,31453,4.247535449020932,0.0,0.0
47405,4,7405,[313 127 187 302 100],13,5,31458,4.247637051039698,0.0,40.0
47406,4,7406,[313 127 187 302 100],144,4,31462,4.247603618199001,0.0,40.0
47407,4,7407,[313 127 187 302 100],207,4,31466,4.2475701943844495,0.0,40.0
47408,4,7408,[313 127 187 302 100],207,4,31470,4.247536779592387,0.0,40.0
47409,4,7409,[313 127 187 302 318],328,5,31475,4.247638326585695,20.0,20.0
47410,4,7410,[313 127 187 302 318],474,5,31480,4.247739846174605,20.0,20.0
47411,4,7411,[313 127 187 302 318],13,4,31484,4.247706422018348,20.0,20.0
47412,4,7412,[313 127 187 302 100],271,5,31489,4.247807905031701,0.0,40.0
47413,4,7413,[313 127 187 302 100],537,5,31494,4.247909360669005,0.0,40.0
47414,4,7414,[313 127 187 302 100],13,5,31499,4.248010788941335,0.0,40.0
47415,4,7415,[313 127 187 302 100],13,5,31504,4.2481121898597625,0.0,40.0
47416,4,7416,[313 127 187 302 100],90,5,31509,4.2482135634353515,0.0,40.0
47417,4,7417,[  9 237 423 235 117],334,3,31512,4.248045295227824,0.0,0.0
47418,4,7418,[313 127 187 302 100],207,4,31516,4.248011861436852,0.0,40.0
47419,4,7419,[515 427 318 475  12],537,4,31520,4.247978436657682,40.0,0.0
47420,4,7420,[ 50  69 276 172  88],298,4,31524,4.247945020886673,0.0,20.0
47421,4,7421,[313 127 187 302 100],144,4,31528,4.247911614120183,0.0,40.0
47422,4,7422,[655 204 435 318 182],474,5,31533,4.248012932776505,20.0,0.0
47423,4,7423,[403 234 176 135 185],766,3,31536,4.247844827586207,0.0,0.0
47424,4,7424,[313 127 187 302 318],271,5,31541,4.247946127946128,20.0,20.0
47425,4,7425,[118 179 515 168  64],543,3,31544,4.247778077026663,0.0,0.0
47426,4,7426,[313 127 187 302 318],207,5,31549,4.247879359095193,20.0,20.0
47427,4,7427,[313 127 187 302 318],334,5,31554,4.247980613893376,20.0,20.0
47428,4,7428,[313 127 187 302 318],328,5,31559,4.248081841432225,20.0,20.0
47429,4,7429,[313 127 187 302 318],334,5,31564,4.248183041722745,20.0,20.0
47430,4,7430,[313 127 187 302 318],144,4,31568,4.248149643385816,20.0,20.0
47431,4,7431,[313 127 187 302 318],144,4,31572,4.248116254036598,20.0,20.0
47432,4,7432,[313 127 187 302 318],328,5,31577,4.2482174088524145,20.0,20.0
47433,4,7433,[313 127 187 302 318],90,5,31582,4.248318536454129,20.0,20.0
47434,4,7434,[313 127 187 302 318],328,5,31587,4.248419636852724,20.0,20.0
47435,4,7435,[313 127 187 302 318],334,5,31592,4.2485207100591715,20.0,20.0
47436,4,7436,[313 127 187 302 318],474,5,31597,4.248621756084443,20.0,20.0
47437,4,7437,[313 127 187 302 318],334,5,31602,4.2487227749395,20.0,20.0
47438,4,7438,[313 127 187 302 318],334,5,31607,4.248823766635301,20.0,20.0
47439,4,7439,[313 127 187 302 318],207,5,31612,4.248924731182796,20.0,20.0
47440,4,7440,[313 127 187 302 318],144,4,31616,4.248891278054025,20.0,20.0
47441,4,7441,[  8 135   1 403  89],881,4,31620,4.248857833915614,0.0,0.0
47442,4,7442,[313 127 187 302 318],474,5,31625,4.248958753190918,20.0,20.0
47443,4,7443,[313 127 187 302 318],13,4,31629,4.2489253089736705,20.0,20.0
47444,4,7444,[313 127 187 302 318],271,5,31634,4.249026192075219,20.0,20.0
47445,4,7445,[313 127 187 302 318],144,4,31638,4.248992747784045,20.0,20.0
47446,4,7446,[313 127 187 302 318],90,5,31643,4.249093594736135,20.0,20.0
47447,4,7447,[423   1 603 194  79],13,3,31646,4.248925886143931,20.0,0.0
47448,4,7448,[423  50 318 597  12],455,2,31648,4.248623976372667,40.0,20.0
47449,4,7449,[313 127 187 302 318],144,4,31652,4.2485906040268455,20.0,20.0
47450,4,7450,[211 423 475 127 748],648,2,31654,4.248288820292578,0.0,20.0
47451,4,7451,[313 127 187 302 318],144,4,31658,4.24825550187869,20.0,20.0
47452,4,7452,[125 546 515 257 678],213,5,31663,4.2483563665638,0.0,0.0
47453,4,7453,[313 127 187 302 318],474,5,31668,4.248457204185672,20.0,20.0
47454,4,7454,[313 127 187 302 318],328,5,31673,4.248558014755198,20.0,20.0
47455,4,7455,[ 96 655 265 328 181],234,0,31673,4.247988197424893,0.0,0.0
47456,4,7456,[313 127 187 302 318],144,4,31677,4.247954941665549,20.0,20.0
47457,4,7457,[313 127 187 302 318],144,4,31681,4.24792169482435,20.0,20.0
47458,4,7458,[313 127 187 302 318],328,5,31686,4.248022523126425,20.0,20.0
47459,4,7459,[313 127 187 302 318],537,5,31691,4.248123324396783,20.0,20.0
47460,4,7460,[385   8 173 318 435],455,3,31694,4.247956038064602,20.0,0.0
47461,4,7461,[313 127 187 302 318],90,5,31699,4.248056821227553,20.0,20.0
47462,4,7462,[265 143  50 427 318],42,4,31703,4.248023583009513,20.0,20.0
47463,4,7463,[313 127 187 302 318],334,5,31708,4.248124330117899,20.0,20.0
47464,4,7464,[313 127 187 302 318],334,5,31713,4.248225050234427,20.0,20.0
47465,4,7465,[313 127 187 302 318],537,5,31718,4.248325743369944,20.0,20.0
47466,4,7466,[313 127 187 302 318],90,5,31723,4.248426409535289,20.0,20.0
47467,4,7467,[313 127 187 302 318],328,5,31728,4.2485270487412965,20.0,20.0
47468,4,7468,[313 127 187 302 318],144,4,31732,4.24849377426697,20.0,20.0
47469,4,7469,[161 483 168   1  22],10,5,31737,4.24859437751004,20.0,0.0
47470,4,7470,[273 186   7 276  70],374,3,31740,4.2484272520412265,0.0,0.0
47471,4,7471,[313 127 187 302 318],537,5,31745,4.2485278372591,20.0,20.0
47472,4,7472,[588 313 168 204 234],254,3,31748,4.248360765422187,0.0,0.0
47473,4,7473,[313 127 187 302 318],474,5,31753,4.2484613326197485,20.0,20.0
47474,4,7474,[313 127 187 302 318],328,5,31758,4.248561872909699,20.0,20.0
47475,4,7475,[313 127 187 302 318],90,5,31763,4.248662386302835,20.0,20.0
47476,4,7476,[313 127 187 302 318],474,5,31768,4.248762872809951,20.0,20.0
47477,4,7477,[313 127 187 302 318],13,4,31772,4.248729606846751,20.0,20.0
47478,4,7478,[313 127 187 302 318],90,5,31777,4.248830057494318,20.0,20.0
47479,4,7479,[313 127 187 302 318],537,5,31782,4.2489304812834225,20.0,20.0
47480,4,7480,[313 127 187 302 318],13,4,31786,4.248897206255848,20.0,20.0
47481,4,7481,[ 56 318 385 187 597],328,3,31789,4.24873028601978,20.0,0.0
47482,4,7482,[313 127 187 302 318],537,5,31794,4.248830682881198,20.0,20.0
47483,4,7483,[313 127 187 302 318],328,5,31799,4.248931052912881,20.0,20.0
47484,4,7484,[135 245  11  28 405],804,4,31803,4.248897795591183,0.0,0.0
47485,4,7485,[313 127 187 302 318],144,4,31807,4.248864547154689,20.0,20.0
47486,4,7486,[313 127 187 302 318],90,5,31812,4.248964872445573,20.0,20.0
47487,4,7487,[258   7 496 405 300],7,4,31816,4.2489316239316235,0.0,0.0
47488,4,7488,[313 127 187 302 318],328,5,31821,4.249031913473094,20.0,20.0
47489,4,7489,[313 127 187 302 318],474,5,31826,4.24913217623498,20.0,20.0
47490,4,7490,[ 56 234 603 385 742],313,3,31829,4.248965425176879,20.0,0.0
47491,4,7491,[496 427 318 211 173],385,2,31831,4.248665242925788,20.0,0.0
47492,4,7492,[313 127 187 302 100],474,5,31836,4.248765514480182,0.0,40.0
47493,4,7493,[313 127 187 302 100],328,5,31841,4.248865759274086,0.0,40.0
47494,4,7494,[313 127 187 302 100],328,5,31846,4.248965977318212,0.0,40.0
47495,4,7495,[313 127 187 302 100],207,4,31850,4.248932764140875,0.0,40.0
47496,4,7496,[313 127 187 302 318],144,4,31854,4.248899559823929,20.0,20.0
47497,4,7497,[ 79 318 202 211  25],666,3,31857,4.248732995465457,20.0,0.0
47498,4,7498,[313 127 187 302 318],334,5,31862,4.248833177757034,20.0,20.0
47499,4,7499,[313 127 187 302 318],328,5,31867,4.2489333333333335,20.0,20.0
47500,4,7500,[257 276 508 328 216],92,2,31869,4.248633515531263,0.0,0.0
47501,4,7501,[196 172  97 179 174],85,4,31873,4.2486003732338045,0.0,20.0
47502,4,7502,[313 127 187 302 318],13,4,31877,4.248567239770758,20.0,20.0
47503,4,7503,[313 127 187 302 100],271,5,31882,4.2486673773987205,0.0,40.0
47504,4,7504,[313 127 187 302 100],90,5,31887,4.248767488341106,0.0,40.0
47505,4,7505,[313 127 187 302 100],537,5,31892,4.24886757260858,0.0,40.0
47506,4,7506,[313 127 187 302 100],328,5,31897,4.248967630211802,0.0,40.0
47507,4,7507,[313 127 187 302 100],271,5,31902,4.249067661161428,0.0,40.0
47508,4,7508,[313 127 187 302 100],537,5,31907,4.2491676654681045,0.0,40.0
47509,4,7509,[313 127 187 302 100],537,5,31912,4.249267643142477,0.0,40.0
47510,4,7510,[313 127 187 302 100],13,5,31917,4.2493675941951805,0.0,40.0
47511,4,7511,[185  50 313 191 546],653,3,31920,4.2492012779552715,0.0,20.0
47512,4,7512,[313 127 187 302 100],90,5,31925,4.2493012112338615,0.0,40.0
47513,4,7513,[313 127 187 302 100],90,5,31930,4.249401117913228,0.0,40.0
47514,4,7514,[313 127 187 302 100],207,4,31934,4.2493679308050565,0.0,40.0
47515,4,7515,[ 82 568 216 385 195],13,0,31934,4.248802554550292,0.0,0.0
47516,4,7516,[121 202 302  56 313],13,5,31939,4.248902487694559,0.0,0.0
47517,4,7517,[333 196 204 174 302],537,1,31940,4.248470337855813,0.0,20.0
47518,4,7518,[286 202  50 588 174],82,5,31945,4.248570288602208,0.0,40.0
47519,4,7519,[313 127 187 302 100],13,5,31950,4.2486702127659575,0.0,40.0
47520,4,7520,[197 423 273 328 300],90,2,31952,4.248371227230422,0.0,0.0
47521,4,7521,[313 127 187 302 100],271,5,31957,4.248471151289551,0.0,40.0
47522,4,7522,[313 127 187 302 100],474,5,31962,4.24857104878373,0.0,40.0
47523,4,7523,[313 127 187 302 100],334,5,31967,4.248670919723551,0.0,40.0
47524,4,7524,[313 127 187 302 100],271,5,31972,4.248770764119602,0.0,40.0
47525,4,7525,[313 127 187 302 100],144,4,31976,4.248737709274515,0.0,40.0
47526,4,7526,[313 127 187 302 100],271,5,31981,4.24883751826757,0.0,40.0
47527,4,7527,[174  82 197 186 151],308,4,31985,4.248804463336875,0.0,20.0
47528,4,7528,[187 216 210 176 286],537,1,31986,4.248372957896135,0.0,0.0
47529,4,7529,[313 127 187 302 100],13,5,31991,4.248472775564409,0.0,40.0
47530,4,7530,[ 56 153 202 294 194],378,3,31994,4.248306997742664,0.0,0.0
47531,4,7531,[195 471  70  64   8],474,4,31998,4.248274030801912,0.0,0.0
47532,4,7532,[313 127 187 302 100],474,5,32003,4.2483738218505245,0.0,40.0
47533,4,7533,[313 127 187 302 100],474,5,32008,4.2484735864082825,0.0,40.0
47534,4,7534,[313 127 187 302 100],90,5,32013,4.248573324485733,0.0,40.0
47535,4,7535,[313 127 187 302 100],144,4,32017,4.24854033970276,0.0,40.0
47536,4,7536,[313 127 187 302 100],271,5,32022,4.248640042457211,0.0,40.0
47537,4,7537,[135 195 245 180  69],328,3,32025,4.248474396391615,0.0,0.0
47538,4,7538,[ 70 135 151 172  95],795,1,32026,4.2480435070964315,0.0,0.0
47539,4,7539,[289  50 210 174 300],533,4,32030,4.248010610079576,0.0,40.0
47540,4,7540,[313 127 187 302 100],144,4,32034,4.247977721787561,0.0,40.0
47541,4,7541,[313 127 187 302 100],90,5,32039,4.248077433041633,0.0,40.0
47542,4,7542,[313 127 187 302 100],271,5,32044,4.248177117857616,0.0,40.0
47543,4,7543,[313 127 187 302 100],144,4,32048,4.24814422057264,0.0,40.0
47544,4,7544,[313 127 187 302 100],537,5,32053,4.248243870112657,0.0,40.0
47545,4,7545,[313 127 187 302 100],537,5,32058,4.248343493241452,0.0,40.0
47546,4,7546,[313 127 187 302 100],537,5,32063,4.248443089969524,0.0,40.0
47547,4,7547,[135 181 588 748  25],881,2,32065,4.248145204027557,0.0,0.0
47548,4,7548,[143 204 174 276 273],892,4,32069,4.248112332759306,0.0,20.0
47549,4,7549,[125 289  12 204 403],194,2,32071,4.247814569536424,20.0,0.0
47550,4,7550,[ 71 273  79  12 200],234,1,32072,4.247384452390412,20.0,0.0
47551,4,7551,[313 127 187 302 100],144,4,32076,4.247351694915254,0.0,40.0
47552,4,7552,[313 127 187 302 100],474,5,32081,4.247451343836886,0.0,40.0
47553,4,7553,[313 127 187 302 100],207,4,32085,4.247418586179507,0.0,40.0
47554,4,7554,[181 238  71 288 143],308,5,32090,4.2475181998676375,0.0,0.0
47555,4,7555,[403  88 132  69 194],13,4,32094,4.247485442032821,0.0,0.0
47556,4,7556,[313 127 187 302 100],207,4,32098,4.24745269286754,0.0,40.0
47557,4,7557,[313 127 187 302 100],13,5,32103,4.247552262503308,0.0,40.0
47558,4,7558,[313 127 187 302 100],328,5,32108,4.247651805794417,0.0,40.0
47559,4,7559,[313 127 187 302 100],474,5,32113,4.247751322751323,0.0,40.0
47560,4,7560,[313 127 187 302 100],537,5,32118,4.247850813384473,0.0,40.0
47561,4,7561,[313 127 187 302 100],474,5,32123,4.247950277704311,0.0,40.0
47562,4,7562,[313 127 187 302 100],271,5,32128,4.248049715721274,0.0,40.0
47563,4,7563,[313 127 187 302 100],271,5,32133,4.248149127445796,0.0,40.0
47564,4,7564,[313 127 187 302 100],144,4,32137,4.248116325181758,0.0,40.0
47565,4,7565,[313 127 187 302 100],144,4,32141,4.248083531588686,0.0,40.0
47566,4,7566,[313 127 187 302 100],13,5,32146,4.248182899431743,0.0,40.0
47567,4,7567,[313 127 187 302 100],144,4,32150,4.248150105708246,0.0,40.0
47568,4,7568,[161  88 183 125  82],378,4,32154,4.24811732065002,0.0,0.0
47569,4,7569,[313 127 187 302 100],207,4,32158,4.248084544253633,0.0,40.0
47570,4,7570,[216  97  25 235 546],804,4,32162,4.248051776515652,0.0,0.0
47571,4,7571,[313 127 187 302 100],207,4,32166,4.248019017432647,0.0,40.0
47572,4,7572,[313 127 187 302 100],271,5,32171,4.248118315066685,0.0,40.0
47573,4,7573,[313 127 187 302 100],271,5,32176,4.248217586480063,0.0,40.0
47574,4,7574,[313 127 187 302 100],13,5,32181,4.2483168316831685,0.0,40.0
47575,4,7575,[ 50  97 100 300 196],378,5,32186,4.248416050686378,0.0,40.0
47576,4,7576,[313 127 187 302 100],334,5,32191,4.248515243500066,0.0,40.0
47577,4,7577,[135  12  71  89 318],543,4,32195,4.248482449195039,40.0,0.0
47578,4,7578,[313 127 187 302 100],207,4,32199,4.248449663544003,0.0,40.0
47579,4,7579,[ 96 204 323 215   7],881,2,32201,4.248153034300792,0.0,0.0
47580,4,7580,[313 127 187 302 100],474,5,32206,4.248252209471046,0.0,40.0
47581,4,7581,[313 127 187 302 100],207,4,32210,4.2482194671590605,0.0,40.0
47582,4,7582,[265 191 655 515   9],64,5,32215,4.248318607411314,0.0,0.0
47583,4,7583,[313 127 187 302 100],334,5,32220,4.2484177215189876,0.0,40.0
47584,4,7584,[132   9  69 568   4],194,3,32223,4.24825313117996,0.0,0.0
47585,4,7585,[ 50 195 194 318  70],87,5,32228,4.248352227788031,20.0,20.0
47586,4,7586,[313 127 187 302 100],537,5,32233,4.248451298273363,0.0,40.0
47587,4,7587,[403 185  70 121  98],308,3,32236,4.248286768581972,0.0,20.0
47588,4,7588,[313 127 187 302 100],90,5,32241,4.248385821583871,0.0,40.0
47589,4,7589,[111 475 318 118 143],374,1,32242,4.247957839262187,20.0,0.0
47590,4,7590,[ 15 179 125 515 276],881,4,32246,4.247925174548808,0.0,0.0
47591,4,7591,[313 127 187 302 100],334,5,32251,4.248024236037935,0.0,40.0
47592,4,7592,[276  25 172 183  82],234,1,32252,4.247596470433294,0.0,0.0
47593,4,7593,[ 79 153   9  28 186],60,4,32256,4.247563866210166,0.0,0.0
47594,4,7594,[313 127 187 302 100],144,4,32260,4.247531270572745,0.0,40.0
47595,4,7595,[313 127 187 302 100],207,4,32264,4.247498683517641,0.0,40.0
47596,4,7596,[215  71  50 546 185],64,3,32267,4.247334474134527,0.0,20.0
47597,4,7597,[483 403 588 515 265],194,4,32271,4.2473019215583045,20.0,0.0
47598,4,7598,[313 127 187 302 483],669,4,32275,4.247269377549678,20.0,20.0
47599,4,7599,[313 127 187 302 100],90,5,32280,4.247368421052632,0.0,40.0
47600,4,7600,[313 127 187 302 100],474,5,32285,4.247467438494935,0.0,40.0
47601,4,7601,[313 127 187 302 100],144,4,32289,4.247434885556433,0.0,40.0
47602,4,7602,[216 176 655 234  82],643,4,32293,4.247402341181113,0.0,0.0
47603,4,7603,[313 127 187 302 100],207,4,32297,4.247369805365597,0.0,40.0
47604,4,7604,[515 748 318 258 194],311,5,32302,4.2474687705456935,20.0,0.0
47605,4,7605,[238   1 121 196 117],650,3,32305,4.247304759400473,0.0,0.0
47606,4,7606,[211 132 216 435 143],313,4,32309,4.2472722492441175,0.0,0.0
47607,4,7607,[210 265  96 151 234],524,3,32312,4.247108307045216,0.0,0.0
47608,4,7608,[313 127 187 302 100],207,4,32316,4.247075831252464,0.0,40.0
47609,4,7609,[313 127 187 302 318],334,5,32321,4.247174770039422,20.0,20.0
47610,4,7610,[313 127 187 302 318],90,5,32326,4.247273682827487,20.0,20.0
47611,4,7611,[313 127 187 302 318],13,4,32330,4.2472411981082505,20.0,20.0
47612,4,7612,[313 127 187 302 100],90,5,32335,4.2473400761854725,0.0,40.0
47613,4,7613,[313 127 187 302 100],90,5,32340,4.247438928289992,0.0,40.0
47614,4,7614,[597 294 435 195  88],452,2,32342,4.247143795141168,0.0,0.0
47615,4,7615,[313 127 187 302 100],537,5,32347,4.247242647058823,0.0,40.0
47616,4,7616,[313 127 187 302 100],334,5,32352,4.2473414730208745,0.0,40.0
47617,4,7617,[12 15 82 70 56],537,2,32354,4.247046468889472,20.0,0.0
47618,4,7618,[173 385 508 273 202],387,3,32357,4.246882793017456,0.0,0.0
47619,4,7619,[ 97 216 357 294  79],328,2,32359,4.246587926509187,20.0,0.0
47620,4,7620,[313 127 187 302 100],334,5,32364,4.246686786510956,0.0,40.0
47621,4,7621,[313 127 187 302 100],474,5,32369,4.2467856205720285,0.0,40.0
47622,4,7622,[313 127 187 302 100],90,5,32374,4.246884428702611,0.0,40.0
47623,4,7623,[313 127 187 302 100],328,5,32379,4.246983210912907,0.0,40.0
47624,4,7624,[313 127 187 302 100],334,5,32384,4.247081967213115,0.0,40.0
47625,4,7625,[313 127 187 302 100],271,5,32389,4.247180697613428,0.0,40.0
47626,4,7626,[313 127 187 302 100],328,5,32394,4.247279402124033,0.0,40.0
47627,4,7627,[313 127 187 302 100],13,5,32399,4.247378080755113,0.0,40.0
47628,4,7628,[313 127 187 302 100],328,5,32404,4.2474767335168435,0.0,40.0
47629,4,7629,[313 127 187 302 100],537,5,32409,4.247575360419397,0.0,40.0
47630,4,7630,[ 97 173 483 180 194],897,3,32412,4.24741187262482,20.0,0.0
47631,4,7631,[313 127 187 302 100],271,5,32417,4.247510482180293,0.0,40.0
47632,4,7632,[313 127 187 302 100],13,5,32422,4.247609065898074,0.0,40.0
47633,4,7633,[313 127 187 302 100],537,5,32427,4.247707623788315,0.0,40.0
47634,4,7634,[313 127 187 302 100],13,5,32432,4.2478061558611655,0.0,40.0
47635,4,7635,[313 127 187 302 100],144,4,32436,4.247773703509691,0.0,40.0
47636,4,7636,[135 385 597 588 181],308,4,32440,4.247741259656934,0.0,0.0
47637,4,7637,[313 127 187 302 100],144,4,32444,4.247708824299555,0.0,40.0
47638,4,7638,[211 300 288 216  70],533,4,32448,4.247676397434219,0.0,0.0
47639,4,7639,[313 127 187 302 100],207,4,32452,4.2476439790575915,0.0,40.0
47640,4,7640,[313 127 187 302 100],474,5,32457,4.2477424420887315,0.0,40.0
47641,4,7641,[215  98 282 195 655],85,2,32459,4.24744831196022,0.0,20.0
47642,4,7642,[313 127 187 302 100],328,5,32464,4.247546774826639,0.0,40.0
47643,4,7643,[ 70 174 228  88 435],398,5,32469,4.2476452119309265,0.0,20.0
47644,4,7644,[313 127 187 302 100],207,4,32473,4.24761281883584,0.0,40.0
47645,4,7645,[313 127 187 302 100],334,5,32478,4.247711221553754,0.0,40.0
47646,4,7646,[313 127 187 302 100],537,5,32483,4.247809598535373,0.0,40.0
47647,4,7647,[187 222 302  70 100],158,4,32487,4.24777719665272,0.0,20.0
47648,4,7648,[313 127 187 302 100],537,5,32492,4.247875539286182,0.0,40.0
47649,4,7649,[313 127 187 302 100],144,4,32496,4.247843137254902,0.0,40.0
47650,4,7650,[313 127 187 302 100],537,5,32501,4.247941445562671,0.0,40.0
47651,4,7651,[313 127 187 302 100],334,5,32506,4.24803972817564,0.0,40.0
47652,4,7652,[313 127 187 302 100],90,5,32511,4.248137985103881,0.0,40.0
47653,4,7653,[313 127 187 302 100],537,5,32516,4.24823621635746,0.0,40.0
47654,4,7654,[313 127 187 302 100],207,4,32520,4.248203788373612,0.0,40.0
47655,4,7655,[313 127 187 302 100],537,5,32525,4.248301985370951,0.0,40.0
47656,4,7656,[313 127 187 302 100],328,5,32530,4.248400156719342,0.0,40.0
47657,4,7657,[313 127 187 302 100],474,5,32535,4.248498302428833,0.0,40.0
47658,4,7658,[313 127 187 302 100],474,5,32540,4.248596422509466,0.0,40.0
47659,4,7659,[322 195 318 204 182],374,3,32543,4.248433420365536,20.0,0.0
47660,4,7660,[100 496  98 475 187],409,4,32547,4.248400992037593,0.0,40.0
47661,4,7661,[313 127 187 302 100],271,5,32552,4.248499086400417,0.0,40.0
47662,4,7662,[385 603 483 515 322],13,2,32554,4.248205663578233,40.0,0.0
47663,4,7663,[313 127 187 302 100],90,5,32559,4.24830375782881,0.0,40.0
47664,4,7664,[313 127 187 302 100],90,5,32564,4.248401826484018,0.0,40.0
47665,4,7665,[215 328 181  88 288],533,4,32568,4.248369423428124,0.0,0.0
47666,4,7666,[313 127 187 302 100],90,5,32573,4.248467457936611,0.0,40.0
47667,4,7667,[313 127 187 302 100],537,5,32578,4.248565466875326,0.0,40.0
47668,4,7668,[211 200 204 496 127],313,4,32582,4.248533055157126,0.0,20.0
47669,4,7669,[179 603 197 269 117],339,4,32586,4.248500651890482,20.0,0.0
47670,4,7670,[222 333 286 300 288],141,4,32590,4.24846825707209,0.0,0.0
47671,4,7671,[313 127 187 302 100],144,4,32594,4.2484358706986445,0.0,40.0
47672,4,7672,[313 127 187 302 100],474,5,32599,4.248533819887919,0.0,40.0
47673,4,7673,[202 423 186   7 508],59,5,32604,4.248631743549648,0.0,0.0
47674,4,7674,[ 96 195 176  98 546],42,3,32607,4.248469055374593,0.0,20.0
47675,4,7675,[313 127 187 302 100],144,4,32611,4.24843668577384,0.0,40.0
47676,4,7676,[313 127 187 302 100],271,5,32616,4.248534583821805,0.0,40.0
47677,4,7677,[313 127 187 302 100],207,4,32620,4.24850221411826,0.0,40.0
47678,4,7678,[313 127 187 302 100],90,5,32625,4.248600078135174,0.0,40.0
47679,4,7679,[313 127 187 302 100],144,4,32629,4.248567708333334,0.0,40.0
47680,4,7680,[313 127 187 302 100],90,5,32634,4.248665538341362,0.0,40.0
47681,4,7681,[132 508  56 603 144],643,5,32639,4.2487633428794584,20.0,0.0
47682,4,7682,[313 127 187 302 100],474,5,32644,4.248861121957568,0.0,40.0
47683,4,7683,[313 127 187 302 100],474,5,32649,4.2489588755856325,0.0,40.0
47684,4,7684,[313 127 187 302 100],334,5,32654,4.249056603773585,0.0,40.0
47685,4,7685,[313 127 187 302 100],271,5,32659,4.249154306531356,0.0,40.0
47686,4,7686,[  8 268 127 191 286],85,5,32664,4.249251983868869,0.0,20.0
47687,4,7687,[313 127 187 302 100],334,5,32669,4.249349635796046,0.0,40.0
47688,4,7688,[313 127 187 302 100],144,4,32673,4.249317206398752,0.0,40.0
47689,4,7689,[313 127 187 302 100],90,5,32678,4.249414824447334,0.0,40.0
47690,4,7690,[313 127 187 302 100],334,5,32683,4.249512417110909,0.0,40.0
47691,4,7691,[100 121 204 742 238],313,4,32687,4.249479979199168,0.0,20.0
47692,4,7692,[194 161 603  97 385],804,5,32692,4.249577538021578,20.0,0.0
47693,4,7693,[313 127 187 302 100],13,5,32697,4.2496750714842735,0.0,40.0
47694,4,7694,[ 88 143 117   9  69],474,5,32702,4.249772579597141,0.0,0.0
47695,4,7695,[313 127 187 302 100],334,5,32707,4.2498700623700625,0.0,40.0
47696,4,7696,[313 127 187 302 100],207,4,32711,4.249837599064571,0.0,40.0
47697,4,7697,[546 181 405 237 234],95,1,32712,4.249415432579891,0.0,0.0
47698,4,7698,[313 127 187 302 100],537,5,32717,4.249512923756332,0.0,40.0
47699,4,7699,[313 127 187 302 100],328,5,32722,4.24961038961039,0.0,40.0
47700,4,7700,[322 180 176 127 200],234,2,32724,4.249318270354499,0.0,20.0
47701,4,7701,[313 127 187 302 100],334,5,32729,4.2494157361724225,0.0,40.0
47702,4,7702,[161 191 275  25 496],533,5,32734,4.249513176684409,0.0,0.0
47703,4,7703,[313 127 187 302 100],271,5,32739,4.2496105919003115,0.0,40.0
47704,4,7704,[313 127 187 302 100],334,5,32744,4.249707981829981,0.0,40.0
47705,4,7705,[313 127 187 302 100],271,5,32749,4.24980534648326,0.0,40.0
47706,4,7706,[118 289 427 111 185],271,3,32752,4.2496431815232905,0.0,0.0
47707,4,7707,[275 300 235   8 153],64,3,32755,4.249481058640374,0.0,0.0
47708,4,7708,[588 172   8 265 161],95,2,32757,4.249189259307303,0.0,0.0
47709,4,7709,[313 127 187 302 100],13,5,32762,4.2492866407263294,0.0,40.0
47710,4,7710,[313 127 187 302 100],271,5,32767,4.2493839968875635,0.0,40.0
47711,4,7711,[313 127 187 302 100],13,5,32772,4.249481327800829,0.0,40.0
47712,4,7712,[313 127 187 302 100],537,5,32777,4.2495786334759496,0.0,40.0
47713,4,7713,[313 127 187 302 100],474,5,32782,4.249675913922738,0.0,40.0
47714,4,7714,[313 127 187 302 100],207,4,32786,4.2496435515230075,0.0,40.0
47715,4,7715,[313 127 187 302 100],474,5,32791,4.24974079834111,0.0,40.0
47716,4,7716,[210 515 508 222  98],524,2,32793,4.249449267850201,0.0,20.0
47717,4,7717,[275 435 294 427 742],328,3,32796,4.249287380150298,0.0,0.0
47718,4,7718,[313 127 187 302 100],271,5,32801,4.249384635315455,0.0,40.0
47719,4,7719,[313 127 187 302 100],474,5,32806,4.249481865284974,0.0,40.0
47720,4,7720,[423 174 603 200 357],804,3,32809,4.2493200362647325,40.0,20.0
47721,4,7721,[313 127 187 302 100],144,4,32813,4.249287749287749,0.0,40.0
47722,4,7722,[313 127 187 302 100],271,5,32818,4.249384954033407,0.0,40.0
47723,4,7723,[202  98 191 222 181],215,5,32823,4.249482133609528,0.0,20.0
47724,4,7724,[313 127 187 302 100],474,5,32828,4.24957928802589,0.0,40.0
47725,4,7725,[228 181 546  50 176],643,3,32831,4.249417551126068,0.0,20.0
47726,4,7726,[ 12  71 175  95 435],234,0,32831,4.248867607092015,20.0,0.0
47727,4,7727,[313 127 187 302 100],90,5,32836,4.24896480331263,0.0,40.0
47728,4,7728,[ 79  69 215 117 508],343,4,32840,4.248932591538362,0.0,0.0
47729,4,7729,[313 127 187 302 100],271,5,32845,4.249029754204399,0.0,40.0
47730,4,7730,[313 127 187 302 100],328,5,32850,4.2491268917345755,0.0,40.0
47731,4,7731,[313 127 187 302 100],271,5,32855,4.249224004138645,0.0,40.0
47732,4,7732,[127 515  97  28 655],328,4,32859,4.2491917755075646,0.0,20.0
47733,4,7733,[313 127 187 302 100],537,5,32864,4.2492888544091025,0.0,40.0
47734,4,7734,[258 268  25 748 322],486,2,32866,4.248998060762767,0.0,0.0
47735,4,7735,[313 127 187 302 100],334,5,32871,4.249095139607032,0.0,40.0
47736,4,7736,[313 127 187 302 100],144,4,32875,4.249062944293654,0.0,40.0
47737,4,7737,[313 127 187 302 100],144,4,32879,4.249030757301628,0.0,40.0
47738,4,7738,[ 88   1 143 435   8],406,3,32882,4.248869362966792,0.0,0.0
47739,4,7739,[313 127 187 302 100],207,4,32886,4.248837209302326,0.0,40.0
47740,4,7740,[313 127 187 302 100],90,5,32891,4.248934246221419,0.0,40.0
47741,4,7741,[568  98 245  11 196],92,4,32895,4.248902092482562,0.0,20.0
47742,4,7742,[313 127 187 302 100],474,5,32900,4.24899909595764,0.0,40.0
47743,4,7743,[313 127 187 302 100],474,5,32905,4.249096074380165,0.0,40.0
47744,4,7744,[288 496  69  22 597],533,3,32908,4.248934796642995,0.0,0.0
47745,4,7745,[313 127 187 302 100],328,5,32913,4.249031758326878,0.0,40.0
47746,4,7746,[313 127 187 302 100],207,4,32917,4.248999612753324,0.0,40.0
47747,4,7747,[ 70  79 496 183 174],840,4,32921,4.248967475477542,0.0,20.0
47748,4,7748,[313 127 187 302 100],328,5,32926,4.249064395405859,0.0,40.0
47749,4,7749,[182  64 202 294  70],95,3,32929,4.248903225806451,0.0,0.0
47750,4,7750,[313 127 187 302 100],474,5,32934,4.249000129015611,0.0,40.0
47751,4,7751,[313 127 187 302 100],207,4,32938,4.248968008255934,0.0,40.0
47752,4,7752,[313 127 187 302 100],334,5,32943,4.249064878111699,0.0,40.0
47753,4,7753,[313 127 187 302 100],207,4,32947,4.249032757286562,0.0,40.0
47754,4,7754,[313 127 187 302 100],144,4,32951,4.249000644745325,0.0,40.0
47755,4,7755,[313 127 187 302 100],474,5,32956,4.249097472924188,0.0,40.0
47756,4,7756,[313 127 187 302 100],334,5,32961,4.249194276137682,0.0,40.0
47757,4,7757,[313 127 187 302 100],207,4,32965,4.249162155194638,0.0,40.0
47758,4,7758,[313 127 187 302 100],537,5,32970,4.249258925119216,0.0,40.0
47759,4,7759,[121 202 282  70 276],643,2,32972,4.2489690721649485,0.0,0.0
47760,4,7760,[313 127 187 302 100],13,5,32977,4.249065842030666,0.0,40.0
47761,4,7761,[313 127 187 302 100],334,5,32982,4.2491625869621235,0.0,40.0
47762,4,7762,[313 127 187 302 100],328,5,32987,4.2492593069689555,0.0,40.0
47763,4,7763,[313 127 187 302 100],334,5,32992,4.249356002060793,0.0,40.0
47764,4,7764,[ 79 357   1 265 100],295,5,32997,4.249452672247263,20.0,20.0
47765,4,7765,[313 127 187 302 100],334,5,33002,4.249549317537986,0.0,40.0
47766,4,7766,[197  79 228 176  56],343,5,33007,4.249645937942578,0.0,0.0
47767,4,7767,[313 127 187 302 100],328,5,33012,4.2497425334706485,0.0,40.0
47768,4,7768,[265 237 168 196  69],343,4,33016,4.249710387437251,0.0,0.0
47769,4,7769,[313 127 187 302 100],537,5,33021,4.24980694980695,0.0,40.0
47770,4,7770,[313 127 187 302 100],271,5,33026,4.249903487324668,0.0,40.0
47771,4,7771,[313 127 187 302 100],144,4,33030,4.249871332990221,0.0,40.0
47772,4,7772,[313 127 187 302 100],90,5,33035,4.249967837385823,0.0,40.0
47773,4,7773,[211 174 286 222 132],60,5,33040,4.250064316953949,0.0,20.0
47774,4,7774,[313 127 187 302 100],474,5,33045,4.25016077170418,0.0,40.0
47775,4,7775,[313 127 187 302 100],537,5,33050,4.25025720164609,0.0,40.0
47776,4,7776,[313 127 187 302 100],144,4,33054,4.25022502250225,0.0,40.0
47777,4,7777,[313 127 187 302 100],537,5,33059,4.250321419388017,0.0,40.0
47778,4,7778,[313 127 187 302 100],474,5,33064,4.250417791489909,0.0,40.0
47779,4,7779,[313 127 187 302 100],13,5,33069,4.250514138817481,0.0,40.0
47780,4,7780,[202 423 258  50  82],92,2,33071,4.250224906824315,0.0,20.0
47781,4,7781,[313 127 187 302 100],144,4,33075,4.250192752505782,0.0,40.0
47782,4,7782,[194 228  96 125   1],158,4,33079,4.250160606449955,0.0,0.0
47783,4,7783,[313 127 187 302 100],328,5,33084,4.250256937307297,0.0,40.0
47784,4,7784,[ 82   4  89  56 357],882,5,33089,4.250353243416828,20.0,0.0
47785,4,7785,[313 127 187 302 100],144,4,33093,4.250321089134344,0.0,40.0
47786,4,7786,[313 127 187 302 100],90,5,33098,4.250417362270451,0.0,40.0
47787,4,7787,[  7 318  15  28 483],892,5,33103,4.250513610683102,40.0,0.0
47788,4,7788,[313 127 187 302 100],90,5,33108,4.25060983438182,0.0,40.0
47789,4,7789,[282 211 181 313 179],207,4,33112,4.250577663671374,0.0,0.0
47790,4,7790,[313 127 187 302 100],271,5,33117,4.250673854447439,0.0,40.0
47791,4,7791,[603 183 423 151 117],234,3,33120,4.250513347022587,20.0,0.0
47792,4,7792,[265 127 202 603 748],13,5,33125,4.250609521365328,20.0,20.0
47793,4,7793,[313 127 187 302 100],144,4,33129,4.250577367205543,0.0,40.0
47794,4,7794,[313 127 187 302 100],334,5,33134,4.250673508659397,0.0,40.0
47795,4,7795,[313 127 187 302 100],207,4,33138,4.25064135454079,0.0,40.0
47796,4,7796,[273 202 568 181 143],13,2,33140,4.250352699756316,0.0,0.0
47797,4,7797,[313 127 187 302 100],334,5,33145,4.2504488330341115,0.0,40.0
47798,4,7798,[313 127 187 302 100],207,4,33149,4.2504167200923195,0.0,40.0
47799,4,7799,[172 174 143 181  56],666,1,33150,4.25,0.0,20.0
47800,4,7800,[174  50 257  98 302],71,2,33152,4.249711575439046,0.0,60.0
47801,4,7801,[568 151 143 228 197],313,2,33154,4.249423224814151,0.0,0.0
47802,4,7802,[313 127 187 302 100],537,5,33159,4.249519415609381,0.0,40.0
47803,4,7803,[313 127 187 302 100],271,5,33164,4.2496155817529475,0.0,40.0
47804,4,7804,[ 69  97 435 132  64],59,5,33169,4.2497117232543244,0.0,0.0
47805,4,7805,[313 127 187 302 100],537,5,33174,4.249807840122982,0.0,40.0
47806,4,7806,[257  22  79 546 127],479,4,33178,4.2497758421929035,0.0,20.0
47807,4,7807,[ 79   1 294 245 195],378,2,33180,4.249487704918033,0.0,0.0
47808,4,7808,[313 127 187 302 100],207,4,33184,4.249455756178768,0.0,40.0
47809,4,7809,[313 127 187 302 100],328,5,33189,4.24955185659411,0.0,40.0
47810,4,7810,[313 127 187 302 100],207,4,33193,4.249519907822302,0.0,40.0
47811,4,7811,[237 176 222 168 403],234,0,33193,4.248975934459805,0.0,0.0
47812,4,7812,[ 96 257 127  88 313],738,3,33196,4.248816075771151,0.0,20.0
47813,4,7813,[313 127 187 302 100],537,5,33201,4.2489122088558995,0.0,40.0
47814,4,7814,[313 127 187 302 100],328,5,33206,4.249008317338451,0.0,40.0
47815,4,7815,[313 127 187 302 100],328,5,33211,4.24910440122825,0.0,40.0
47816,4,7816,[127 471 435 194 655],144,5,33216,4.249200460534732,0.0,20.0
47817,4,7817,[313 127 187 302 100],474,5,33221,4.249296495267332,0.0,40.0
47818,4,7818,[ 15 276 265 405 603],474,5,33226,4.249392505435478,20.0,0.0
47819,4,7819,[313 127 187 302 100],90,5,33231,4.249488491048593,0.0,40.0
47820,4,7820,[168 215 204 597 210],92,4,33235,4.249456591228743,0.0,0.0
47821,4,7821,[313 127 187 302 100],474,5,33240,4.249552544106367,0.0,40.0
47822,4,7822,[313 127 187 302 100],328,5,33245,4.249648472453023,0.0,40.0
47823,4,7823,[313 127 187 302 100],537,5,33250,4.249744376278119,0.0,40.0
47824,4,7824,[275  97   4 174  50],455,4,33254,4.249712460063898,0.0,40.0
47825,4,7825,[313 127 187 302 100],474,5,33259,4.24980833120368,0.0,40.0
47826,4,7826,[313 127 187 302 100],90,5,33264,4.249904177845918,0.0,40.0
47827,4,7827,[313 127 187 302 100],144,4,33268,4.249872253449157,0.0,40.0
47828,4,7828,[313 127 187 302 100],474,5,33273,4.249968067441563,0.0,40.0
47829,4,7829,[313 127 187 302 100],207,4,33277,4.249936143039592,0.0,40.0
47830,4,7830,[483 357 215 748 228],13,4,33281,4.249904226790959,40.0,0.0
47831,4,7831,[313 127 187 302 100],328,5,33286,4.25,0.0,40.0
47832,4,7832,[200 175 174 194 235],343,4,33290,4.249968083748245,0.0,20.0
47833,4,7833,[313 127 187 302 100],90,5,33295,4.250063824355374,0.0,40.0
47834,4,7834,[313 127 187 302 100],13,5,33300,4.250159540523293,0.0,40.0
47835,4,7835,[313 127 187 302 100],334,5,33305,4.250255232261358,0.0,40.0
47836,4,7836,[ 79 135 197 176 546],666,4,33309,4.25022329973204,0.0,0.0
47837,4,7837,[ 69  11 568  12  25],387,1,33310,4.2498086246491455,20.0,0.0
47838,4,7838,[313 127 187 302 100],144,4,33314,4.249776757239443,0.0,40.0
47839,4,7839,[135   4  69 187 289],524,4,33318,4.249744897959184,0.0,0.0
47840,4,7840,[313 127 187 302 100],13,5,33323,4.249840581558475,0.0,40.0
47841,4,7841,[ 98 175 135 153 245],666,4,33327,4.249808722264729,0.0,20.0
47842,4,7842,[313 127 187 302 100],13,5,33332,4.249904373326533,0.0,40.0
47843,4,7843,[423 172   1 175 202],465,3,33335,4.249745028046915,0.0,0.0
47844,4,7844,[289 196 111 172 135],234,2,33337,4.249458253664755,0.0,0.0
47845,4,7845,[143 182 174 300 180],537,2,33339,4.24917155238338,0.0,20.0
47846,4,7846,[313 127 187 302 100],328,5,33344,4.249267235886326,0.0,40.0
47847,4,7847,[313 127 187 302 100],537,5,33349,4.249362895005097,0.0,40.0
47848,4,7848,[313 127 187 302 100],334,5,33354,4.249458529749012,0.0,40.0
47849,4,7849,[313 127 187 302 100],271,5,33359,4.249554140127389,0.0,40.0
47850,4,7850,[313 127 187 302 100],144,4,33363,4.249522353840275,0.0,40.0
47851,4,7851,[313 127 187 302 100],474,5,33368,4.249617931737137,0.0,40.0
47852,4,7852,[313 127 187 302 100],334,5,33373,4.249713485292245,0.0,40.0
47853,4,7853,[ 22 211  28 121  88],343,4,33377,4.249681690858162,0.0,0.0
47854,4,7854,[313 127 187 302 100],207,4,33381,4.249649904519415,0.0,40.0
47855,4,7855,[313 127 187 302 100],13,5,33386,4.249745417515275,0.0,40.0
47856,4,7856,[179 655 144  71 405],840,3,33389,4.249586356115565,0.0,0.0
47857,4,7857,[313 127 187 302 100],207,4,33393,4.2495545940442865,0.0,40.0
47858,4,7858,[313 127 187 302 100],207,4,33397,4.249522840055986,0.0,40.0
47859,4,7859,[222 273  64 471  15],537,0,33397,4.248982188295165,0.0,0.0
47860,4,7860,[313 127 187 302 100],207,4,33401,4.248950515201629,0.0,40.0
47861,4,7861,[215   1 405 328 286],653,3,33404,4.248791656067159,0.0,0.0
47862,4,7862,[318 678 151 265 238],308,3,33407,4.2486328373394375,20.0,0.0
47863,4,7863,[195 215 211  15  70],533,5,33412,4.248728382502543,0.0,0.0
47864,4,7864,[515   1 222 195 215],194,2,33414,4.248442466624285,0.0,0.0
47865,4,7865,[313 127 187 302 318],334,5,33419,4.248538011695906,20.0,20.0
47866,4,7866,[313 127 187 302 318],271,5,33424,4.248633532477437,20.0,20.0
47867,4,7867,[313 127 187 302 318],537,5,33429,4.248729028978139,20.0,20.0
47868,4,7868,[313 127 187 302 318],13,4,33433,4.248697420256703,20.0,20.0
47869,4,7869,[313 127 187 302 100],328,5,33438,4.24879288437103,0.0,40.0
47870,4,7870,[313 127 187 302 100],334,5,33443,4.248888324228179,0.0,40.0
47871,4,7871,[117 118 200 187 282],788,4,33447,4.248856707317073,0.0,0.0
47872,4,7872,[405  69   9 475 118],13,2,33449,4.248571065667471,0.0,0.0
47873,4,7873,[234 187 127 196  79],271,5,33454,4.248666497332994,0.0,20.0
47874,4,7874,[313 127 187 302 100],13,5,33459,4.2487619047619045,0.0,40.0
47875,4,7875,[313 127 187 302 100],271,5,33464,4.248857287963434,0.0,40.0
47876,4,7876,[234 143 186 172 483],524,2,33466,4.2485717912911,20.0,0.0
47877,4,7877,[276 357 151 427 143],339,5,33471,4.248667174409749,20.0,0.0
47878,4,7878,[197 603 161 273 195],10,5,33476,4.248762533316411,20.0,0.0
47879,4,7879,[313 127 187 302 100],474,5,33481,4.248857868020305,0.0,40.0
47880,4,7880,[300  69  12  96  89],90,3,33484,4.248699403628981,20.0,0.0
47881,4,7881,[313 127 187 302 100],537,5,33489,4.248794722151738,0.0,40.0
47882,4,7882,[313 127 187 302 100],207,4,33493,4.248763161233033,0.0,40.0
47883,4,7883,[313 127 187 302 318],271,5,33498,4.248858447488584,20.0,20.0
47884,4,7884,[313 127 187 302 318],271,5,33503,4.248953709575143,20.0,20.0
47885,4,7885,[ 82 471  64 183 234],13,3,33506,4.248795333502409,0.0,0.0
47886,4,7886,[313 127 187 302 318],271,5,33511,4.248890579434512,20.0,20.0
47887,4,7887,[313 127 187 302 318],13,4,33515,4.248859026369169,20.0,20.0
47888,4,7888,[135  95 678 238 276],308,4,33519,4.24882748130308,0.0,0.0
47889,4,7889,[313 127 187 302 100],271,5,33524,4.248922686945501,0.0,40.0
47890,4,7890,[313 127 187 302 100],90,5,33529,4.249017868457737,0.0,40.0
47891,4,7891,[161   1 186 748 185],653,4,33533,4.248986315255955,0.0,0.0
47892,4,7892,[313 127 187 302 100],207,4,33537,4.248954770049411,0.0,40.0
47893,4,7893,[216 508  64  70  82],378,5,33542,4.249049911325057,0.0,0.0
47894,4,7894,[313 127 187 302 318],144,4,33546,4.2490183660544645,20.0,20.0
47895,4,7895,[313 127 187 302 318],90,5,33551,4.249113475177305,20.0,20.0
47896,4,7896,[313 127 187 302 318],13,4,33555,4.249081929846778,20.0,20.0
47897,4,7897,[313 127 187 302 100],144,4,33559,4.249050392504431,0.0,40.0
47898,4,7898,[313 127 187 302 100],334,5,33564,4.249145461450817,0.0,40.0
47899,4,7899,[257 182 174 568 143],385,1,33565,4.24873417721519,0.0,20.0
47900,4,7900,[265 168 196 186 118],311,3,33568,4.248576129603848,0.0,0.0
47901,4,7901,[313 127 187 302 100],13,5,33573,4.2486712224753225,0.0,40.0
47902,4,7902,[135  95 357 238 276],406,4,33577,4.248639757054283,20.0,0.0
47903,4,7903,[313 127 187 302 100],13,5,33582,4.248734817813765,0.0,40.0
47904,4,7904,[151 323 496   7  88],474,3,33585,4.248576850094877,0.0,0.0
47905,4,7905,[313 127 187 302 100],334,5,33590,4.248671894763471,0.0,40.0
47906,4,7906,[313 127 187 302 100],537,5,33595,4.248766915391426,0.0,40.0
47907,4,7907,[313 127 187 302 100],207,4,33599,4.2487354577642895,0.0,40.0
47908,4,7908,[313 127 187 302 100],334,5,33604,4.248830446326969,0.0,40.0
47909,4,7909,[313 127 187 302 100],13,5,33609,4.248925410872314,0.0,40.0
47910,4,7910,[313 127 187 302 100],271,5,33614,4.24902035140943,0.0,40.0
47911,4,7911,[313 127 187 302 100],271,5,33619,4.249115267947421,0.0,40.0
47912,4,7912,[  1 172 176  22 181],254,3,33622,4.248957411853911,0.0,0.0
47913,4,7913,[403 210 172 294 180],308,4,33626,4.24892595400556,0.0,0.0
47914,4,7914,[191  70 196 173  22],95,5,33631,4.249020846493999,0.0,0.0
47915,4,7915,[313 127 187 302 100],90,5,33636,4.24911571500758,0.0,40.0
47916,4,7916,[313 127 187 302 100],328,5,33641,4.2492105595553875,0.0,40.0
47917,4,7917,[313 127 187 302 100],271,5,33646,4.2493053801465015,0.0,40.0
47918,4,7918,[313 127 187 302 100],271,5,33651,4.249400176789999,0.0,40.0
47919,4,7919,[  9 200 161 286 222],378,3,33654,4.249242424242424,0.0,0.0
47920,4,7920,[216  71  82 175  56],60,3,33657,4.249084711526322,0.0,0.0
47921,4,7921,[234 323  25 216  22],378,4,33661,4.24905326937642,0.0,0.0
47922,4,7922,[127 161 144 286 300],653,4,33665,4.249021835163449,0.0,20.0
47923,4,7923,[313 127 187 302 100],271,5,33670,4.249116607773852,0.0,40.0
47924,4,7924,[405 151 143  25   4],533,2,33672,4.248832807570978,0.0,0.0
47925,4,7925,[313 127 187 302 100],474,5,33677,4.2489275801160735,0.0,40.0
47926,4,7926,[313 127 187 302 100],207,4,33681,4.248896177620789,0.0,40.0
47927,4,7927,[313 127 187 302 100],144,4,33685,4.248864783047427,0.0,40.0
47928,4,7928,[313 127 187 302 100],207,4,33689,4.248833396392988,0.0,40.0
47929,4,7929,[ 79 187 100 194 405],804,5,33694,4.248928121059269,0.0,20.0
47930,4,7930,[313 127 187 302 100],474,5,33699,4.249022821838356,0.0,40.0
47931,4,7931,[313 127 187 302 100],271,5,33704,4.249117498739284,0.0,40.0
47932,4,7932,[313 127 187 302 100],328,5,33709,4.249212151771083,0.0,40.0
47933,4,7933,[313 127 187 302 100],334,5,33714,4.249306780942778,0.0,40.0
47934,4,7934,[313 127 187 302 100],13,5,33719,4.24940138626339,0.0,40.0
47935,4,7935,[289 197 173 216 301],871,2,33721,4.249117943548387,0.0,0.0
47936,4,7936,[655 182  56 183 508],527,3,33724,4.248960564445005,0.0,0.0
47937,4,7937,[313 127 187 302 100],90,5,33729,4.249055177626606,0.0,40.0
47938,4,7938,[313 127 187 302 100],207,4,33733,4.249023806524751,0.0,40.0
47939,4,7939,[238 323 216   1 385],883,3,33736,4.248866498740554,0.0,0.0
47940,4,7940,[313 127 187 302 318],144,4,33740,4.248835159299836,20.0,20.0
47941,4,7941,[313 127 187 302 318],474,5,33745,4.2489297406194915,20.0,20.0
47942,4,7942,[313 127 187 302 318],474,5,33750,4.249024298124135,20.0,20.0
47943,4,7943,[508  64 100 204  25],13,3,33753,4.248867069486405,0.0,20.0
47944,4,7944,[313 127 187 302 318],328,5,33758,4.248961611076148,20.0,20.0
47945,4,7945,[313 127 187 302 318],271,5,33763,4.249056128869872,20.0,20.0
47946,4,7946,[588 546 289 144 301],234,1,33764,4.248647288284888,0.0,0.0
47947,4,7947,[313 127 187 302 318],328,5,33769,4.248741821841973,20.0,20.0
47948,4,7948,[313 127 187 302 318],474,5,33774,4.248836331614039,20.0,20.0
47949,4,7949,[111 313 245 273 328],378,2,33776,4.2485534591194964,0.0,0.0
47950,4,7950,[ 69 216 483 265 125],82,4,33780,4.248522198465602,20.0,0.0
47951,4,7951,[313 127 187 302 318],207,5,33785,4.248616700201207,20.0,20.0
47952,4,7952,[180 258 302 174 603],666,4,33789,4.248585439456809,20.0,20.0
47953,4,7953,[313 127 187 302 318],144,4,33793,4.248554186572793,20.0,20.0
47954,4,7954,[597 508  25  70 197],59,3,33796,4.248397234443746,0.0,0.0
47955,4,7955,[222  98  50 427 318],454,3,33799,4.2482403217697335,20.0,40.0
47956,4,7956,[313 127 187 302 318],13,4,33803,4.248209124041725,20.0,20.0
47957,4,7957,[196  82 655 228 176],537,0,33803,4.2476752953003265,0.0,0.0
47958,4,7958,[118 216  11 228 176],92,3,33806,4.247518532478955,0.0,0.0
47959,4,7959,[318 300  95  98 258],537,2,33808,4.2472361809045225,20.0,20.0
47960,4,7960,[173 195 183 111  71],648,4,33812,4.247205124984299,0.0,0.0
47961,4,7961,[313 127 187 302 318],328,5,33817,4.247299673448882,20.0,20.0
47962,4,7962,[313 127 187 302 318],90,5,33822,4.24739419816652,20.0,20.0
47963,4,7963,[313 127 187 302 318],328,5,33827,4.247488699146158,20.0,20.0
47964,4,7964,[496  50 186  71 196],64,4,33831,4.247457627118644,0.0,20.0
47965,4,7965,[313 127 187 302 318],90,5,33836,4.247552096409741,20.0,20.0
47966,4,7966,[313 127 187 302 318],334,5,33841,4.247646541985691,20.0,20.0
47967,4,7967,[313 127 187 302 318],328,5,33846,4.2477409638554215,20.0,20.0
47968,4,7968,[313 127 187 302 318],207,5,33851,4.247835362027858,20.0,20.0
47969,4,7969,[313 127 187 302 318],537,5,33856,4.24792973651192,20.0,20.0
47970,4,7970,[313 127 187 302 318],537,5,33861,4.248024087316522,20.0,20.0
47971,4,7971,[313 127 187 302 318],334,5,33866,4.248118414450577,20.0,20.0
47972,4,7972,[313 127 187 302 318],474,5,33871,4.24821271792299,20.0,20.0
47973,4,7973,[216 125   8 435 180],378,3,33874,4.248056182593428,0.0,0.0
47974,4,7974,[313 127 187 302 318],207,5,33879,4.248150470219436,20.0,20.0
47975,4,7975,[313 127 187 302 318],334,5,33884,4.248244734202608,20.0,20.0
47976,4,7976,[313 127 187 302 318],474,5,33889,4.248338974551837,20.0,20.0
47977,4,7977,[313 127 187 302 318],90,5,33894,4.248433191276009,20.0,20.0
47978,4,7978,[313 127 187 302 318],271,5,33899,4.248527384384008,20.0,20.0
47979,4,7979,[185 294 597 265 385],207,1,33900,4.2481203007518795,0.0,0.0
47980,4,7980,[385  97 269 215  96],488,3,33903,4.247963914296454,0.0,0.0
47981,4,7981,[313 127 187 302 318],328,5,33908,4.248058130794287,20.0,20.0
47982,4,7982,[181 179 191  82 175],840,3,33911,4.247901791306527,0.0,0.0
47983,4,7983,[ 69 228   1  96  56],738,5,33916,4.247995991983968,0.0,0.0
47984,4,7984,[ 69 301 204  56 132],650,2,33918,4.247714464621165,0.0,0.0
47985,4,7985,[ 50 125 318 194 655],899,4,33922,4.247683446030553,20.0,20.0
47986,4,7986,[179 282 403 228 275],334,5,33927,4.247777638662827,0.0,0.0
47987,4,7987,[313 127 187 302 318],334,5,33932,4.247871807711567,20.0,20.0
47988,4,7988,[318 176   4 237   7],378,4,33936,4.247840781073977,20.0,0.0
47989,4,7989,[313 127 187 302 318],474,5,33941,4.24793491864831,20.0,20.0
47990,4,7990,[ 97 185 328 286 258],90,3,33944,4.247778751094982,0.0,0.0
47991,4,7991,[313 127 187 302 318],334,5,33949,4.247872872872873,20.0,20.0
47992,4,7992,[313 127 187 302 318],334,5,33954,4.2479669710997126,20.0,20.0
47993,4,7993,[313 127 187 302 318],207,5,33959,4.248061045784338,20.0,20.0
47994,4,7994,[313 127 187 302 318],474,5,33964,4.248155096935585,20.0,20.0
47995,4,7995,[313 127 187 302 318],537,5,33969,4.248249124562281,20.0,20.0
47996,4,7996,[313 127 187 302 318],13,4,33973,4.248218081780668,20.0,20.0
47997,4,7997,[313 127 187 302 318],334,5,33978,4.248312078019505,20.0,20.0
47998,4,7998,[276   7 288  12 182],308,5,33983,4.248406050756344,20.0,0.0
47999,4,7999,[313 127 187 302 318],207,5,33988,4.2485,20.0,20.0
48000,4,8000,[313 127 187 302 318],334,5,33993,4.24859392575928,20.0,20.0
48001,4,8001,[313 127 187 302 318],13,4,33997,4.248562859285179,20.0,20.0
48002,4,8002,[187 257 405  50  98],840,3,34000,4.2484068474322125,0.0,40.0
48003,4,8003,[313 127 187 302 318],144,4,34004,4.248375812093953,20.0,20.0
48004,4,8004,[313 127 187 302 318],334,5,34009,4.248469706433479,20.0,20.0
48005,4,8005,[313 127 187 302 318],271,5,34014,4.248563577317012,20.0,20.0
48006,4,8006,[313 127 187 302 318],207,5,34019,4.248657424753341,20.0,20.0
48007,4,8007,[215  82 294 172 286],533,5,34024,4.248751248751248,0.0,0.0
48008,4,8008,[313 127 187 302 318],474,5,34029,4.248845049319516,20.0,20.0
48009,4,8009,[245  89  56  64 568],92,4,34033,4.248813982521848,0.0,0.0
48010,4,8010,[748 328 187 471  12],328,3,34036,4.248658095119211,20.0,0.0
48011,4,8011,[313 127 187 302 318],271,5,34041,4.248751872191712,20.0,20.0
48012,4,8012,[153  22 182 187 132],788,3,34044,4.248596031448896,0.0,0.0
48013,4,8013,[313 127 187 302 318],13,4,34048,4.248565011230347,20.0,20.0
48014,4,8014,[313 127 187 302 318],13,4,34052,4.24853399875234,20.0,20.0
48015,4,8015,[153 357 655 515  56],666,5,34057,4.248627744510978,20.0,0.0
48016,4,8016,[282 117 186  50 257],374,3,34060,4.248471997006361,0.0,20.0
48017,4,8017,[313 127 187 302 318],334,5,34065,4.248565727113993,20.0,20.0
48018,4,8018,[216  79  88 181 100],538,3,34068,4.248410026187804,0.0,20.0
48019,4,8019,[313 127 187 302 318],334,5,34073,4.248503740648379,20.0,20.0
48020,4,8020,[313 127 187 302 318],207,5,34078,4.248597431741678,20.0,20.0
48021,4,8021,[313 127 187 302 318],474,5,34083,4.2486910994764395,20.0,20.0
48022,4,8022,[ 89   1 546 333 235],313,4,34087,4.248660102206157,0.0,0.0
48023,4,8023,[323 603 655 172 222],506,4,34091,4.248629112662014,20.0,0.0
48024,4,8024,[  4 288 435 194  89],650,3,34094,4.248473520249221,0.0,0.0
48025,4,8025,[313 127 187 302 318],474,5,34099,4.248567156740593,20.0,20.0
48026,4,8026,[269 257 313  70 180],659,4,34103,4.248536190357544,0.0,0.0
48027,4,8027,[313 127 187 302 318],537,5,34108,4.248629795714997,20.0,20.0
48028,4,8028,[ 64 153 357 318 176],653,3,34111,4.248474280732346,40.0,0.0
48029,4,8029,[313 127 187 302 318],334,5,34116,4.248567870485679,20.0,20.0
48030,4,8030,[215  22 173 172 181],454,2,34118,4.248287884447765,0.0,0.0
48031,4,8031,[ 98 748  70 181 678],488,3,34121,4.248132470119522,0.0,20.0
48032,4,8032,[313 127 187 302 318],144,4,34125,4.248101580978464,20.0,20.0
48033,4,8033,[313 127 187 302 318],90,5,34130,4.248195170525268,20.0,20.0
48034,4,8034,[313 127 187 302 318],474,5,34135,4.248288736776602,20.0,20.0
48035,4,8035,[313 127 187 302 318],207,5,34140,4.248382279741165,20.0,20.0
48036,4,8036,[313 127 187 302 318],13,4,34144,4.248351374891128,20.0,20.0
48037,4,8037,[313 127 187 302 318],13,4,34148,4.248320477730779,20.0,20.0
48038,4,8038,[313 127 187 302 603],90,5,34153,4.248413981838537,20.0,20.0
48039,4,8039,[313 127 187 302 603],334,5,34158,4.248507462686567,20.0,20.0
48040,4,8040,[313 127 187 302 603],13,5,34163,4.248600920283547,20.0,20.0
48041,4,8041,[161  28 357 195 215],308,2,34165,4.248321313106192,20.0,0.0
48042,4,8042,[313 127 187 302 603],474,5,34170,4.248414770607982,20.0,20.0
48043,4,8043,[313 127 187 302 603],13,5,34175,4.248508204873198,20.0,20.0
48044,4,8044,[313 127 187 302 603],271,5,34180,4.248601615910504,20.0,20.0
48045,4,8045,[ 98  69 435 238 168],766,3,34183,4.248446433010192,0.0,20.0
48046,4,8046,[313 127 187 302 603],537,5,34188,4.248539828507519,20.0,20.0
48047,4,8047,[313 127 187 302 603],669,5,34193,4.248633200795228,20.0,20.0
48048,4,8048,[435 185 202 144  98],666,4,34197,4.248602310846068,0.0,20.0
48049,4,8049,[313 127 187 302 603],537,5,34202,4.248695652173913,20.0,20.0
48050,4,8050,[313 127 187 302 603],90,5,34207,4.248788970314247,20.0,20.0
48051,4,8051,[427 597  22 172 385],650,3,34210,4.248633879781421,0.0,0.0
48052,4,8052,[313 127 187 302 603],334,5,34215,4.2487271824164905,20.0,20.0
48053,4,8053,[258 405 546 282 200],328,3,34218,4.248572138068041,0.0,0.0
48054,4,8054,[313 127 187 302 603],474,5,34223,4.248665425201738,20.0,20.0
48055,4,8055,[313 127 187 302 603],13,5,34228,4.248758689175769,20.0,20.0
48056,4,8056,[202 483 423 228  50],398,4,34232,4.248727814322949,20.0,20.0
48057,4,8057,[313 127 187 302 603],13,5,34237,4.248821047406304,20.0,20.0
48058,4,8058,[313 127 187 302 603],334,5,34242,4.248914257352029,20.0,20.0
48059,4,8059,[508  70 204 271  98],144,3,34245,4.2487593052109185,0.0,20.0
48060,4,8060,[300 235 265 211  97],774,0,34245,4.248232229251954,0.0,0.0
48061,4,8061,[313 127 187 302 603],116,3,34248,4.248077400148847,20.0,20.0
48062,4,8062,[313 127 187 302 603],13,5,34253,4.248170656083344,20.0,20.0
48063,4,8063,[313 127 187 302 603],116,3,34256,4.248015873015873,20.0,20.0
48064,4,8064,[313 127 187 302 100],328,5,34261,4.248109113453193,0.0,40.0
48065,4,8065,[313 127 187 302 100],90,5,34266,4.2482023307711385,0.0,40.0
48066,4,8066,[313 127 187 302 100],90,5,34271,4.248295524978307,0.0,40.0
48067,4,8067,[237 286  89 168 257],653,2,34273,4.248016856717898,0.0,0.0
48068,4,8068,[427  88  96 265 176],42,3,34276,4.247862188623126,0.0,0.0
48069,4,8069,[313 127 187 302 100],334,5,34281,4.247955390334573,0.0,40.0
48070,4,8070,[313 127 187 302 100],13,5,34286,4.248048568950564,0.0,40.0
48071,4,8071,[496 435 121 195 228],60,5,34291,4.248141724479683,0.0,0.0
48072,4,8072,[313 127 187 302 100],144,4,34295,4.248110987241422,0.0,40.0
48073,4,8073,[313 127 187 302 100],271,5,34300,4.24820411196433,0.0,40.0
48074,4,8074,[313 127 187 302 100],537,5,34305,4.248297213622291,0.0,40.0
48075,4,8075,[313 127 187 302 100],90,5,34310,4.248390292223873,0.0,40.0
48076,4,8076,[742 195 423 210 222],749,4,34314,4.248359539432958,0.0,0.0
48077,4,8077,[168  28 238 181 185],215,4,34318,4.248328794256004,0.0,0.0
48078,4,8078,[313 127 187 302 100],537,5,34323,4.248421834385444,0.0,40.0
48079,4,8079,[313 127 187 302 100],271,5,34328,4.248514851485148,0.0,40.0
48080,4,8080,[238 546 475 234 172],648,3,34331,4.2483603514416535,0.0,0.0
48081,4,8081,[313 127 187 302 100],90,5,34336,4.248453353130413,0.0,40.0
48082,4,8082,[302 357  25 181  82],207,3,34339,4.248298898923667,20.0,0.0
48083,4,8083,[313 127 187 302 100],334,5,34344,4.2483918852053435,0.0,40.0
48084,4,8084,[313 127 187 302 100],474,5,34349,4.248484848484848,0.0,40.0
48085,4,8085,[313 127 187 302 100],90,5,34354,4.248577788770715,0.0,40.0
48086,4,8086,[182   4 515  64 222],92,5,34359,4.248670706071473,0.0,0.0
48087,4,8087,[313 127 187 302 100],537,5,34364,4.248763600395648,0.0,40.0
48088,4,8088,[313 127 187 302 100],207,4,34368,4.248732847076276,0.0,40.0
48089,4,8089,[313 127 187 302 100],271,5,34373,4.2488257107540175,0.0,40.0
48090,4,8090,[313 127 187 302 100],90,5,34378,4.24891855147695,0.0,40.0
48091,4,8091,[222 515 357 385 168],774,0,34378,4.248393475037074,20.0,0.0
48092,4,8092,[313 127 187 302 100],474,5,34383,4.248486346225133,0.0,40.0
48093,4,8093,[313 127 187 302 100],144,4,34387,4.248455646157647,0.0,40.0
48094,4,8094,[ 79 135 127 435  97],313,5,34392,4.248548486720198,0.0,20.0
48095,4,8095,[ 15 235 176 403  11],374,2,34394,4.2482707509881426,0.0,0.0
48096,4,8096,[313 127 187 302 100],537,5,34399,4.248363591453625,0.0,40.0
48097,4,8097,[313 127 187 302 100],334,5,34404,4.248456408989874,0.0,40.0
48098,4,8098,[313 127 187 302 100],207,4,34408,4.248425731571799,0.0,40.0
48099,4,8099,[313 127 187 302 100],334,5,34413,4.248518518518519,0.0,40.0
48100,4,8100,[313 127 187 302 100],271,5,34418,4.248611282557709,0.0,40.0
48101,4,8101,[313 127 187 302 100],334,5,34423,4.248704023697853,0.0,40.0
48102,4,8102,[313 127 187 302 100],474,5,34428,4.248796741947427,0.0,40.0
48103,4,8103,[313 127 187 302 100],271,5,34433,4.248889437314906,0.0,40.0
48104,4,8104,[313 127 187 302 100],334,5,34438,4.24898210980876,0.0,40.0
48105,4,8105,[313 127 187 302 100],90,5,34443,4.249074759437454,0.0,40.0
48106,4,8106,[301  89 222 234 471],666,3,34446,4.248920685827063,0.0,0.0
48107,4,8107,[ 15  69 121 245 655],749,4,34450,4.248889985199803,0.0,0.0
48108,4,8108,[313 127 187 302 100],334,5,34455,4.248982611912689,0.0,40.0
48109,4,8109,[313 127 187 302 100],537,5,34460,4.249075215782984,0.0,40.0
48110,4,8110,[313 127 187 302 100],90,5,34465,4.249167796819134,0.0,40.0
48111,4,8111,[313 127 187 302 100],144,4,34469,4.24913708086785,0.0,40.0
48112,4,8112,[ 97 121   1 187 117],406,4,34473,4.2491063724885985,0.0,0.0
48113,4,8113,[313 127 187 302 100],13,5,34478,4.24919891545477,0.0,40.0
48114,4,8114,[313 127 187 302 100],537,5,34483,4.249291435613062,0.0,40.0
48115,4,8115,[313 127 187 302 100],90,5,34488,4.249383932971908,0.0,40.0
48116,4,8116,[313 127 187 302 100],90,5,34493,4.249476407539731,0.0,40.0
48117,4,8117,[313 127 187 302 100],328,5,34498,4.249568859324957,0.0,40.0
48118,4,8118,[  7 127 328 301 179],234,1,34499,4.249168616824732,0.0,20.0
48119,4,8119,[161  71  96 216 286],95,4,34503,4.249137931034483,0.0,0.0
48120,4,8120,[313 127 187 302 100],271,5,34508,4.249230390346017,0.0,40.0
48121,4,8121,[276 185 385 111  64],452,3,34511,4.24907658212263,0.0,0.0
48122,4,8122,[ 96 182 196 200  69],95,3,34514,4.2489228117690505,0.0,0.0
48123,4,8123,[222  69 202 125 515],881,4,34518,4.248892171344165,0.0,0.0
48124,4,8124,[313 127 187 302 100],13,5,34523,4.248984615384615,0.0,40.0
48125,4,8125,[ 97  71  56 546 655],328,3,34526,4.248830913118385,0.0,0.0
48126,4,8126,[185 471  15 288  95],537,1,34527,4.2484311554079,0.0,0.0
48127,4,8127,[313 127 187 302 100],144,4,34531,4.2484005905511815,0.0,40.0
48128,4,8128,[172 151  89  82  98],932,3,34534,4.248247016853242,0.0,20.0
48129,4,8129,[313 127 187 302 100],207,4,34538,4.248216482164822,0.0,40.0
48130,4,8130,[313 127 187 302 100],13,5,34543,4.248308941089657,0.0,40.0
48131,4,8131,[313 127 187 302 100],334,5,34548,4.248401377274963,0.0,40.0
48132,4,8132,[ 95 265 200 322 568],13,2,34550,4.248124923152588,0.0,0.0
48133,4,8133,[313 127 187 302 100],537,5,34555,4.24821735923285,0.0,40.0
48134,4,8134,[313 127 187 302 100],13,5,34560,4.248309772587585,0.0,40.0
48135,4,8135,[ 82 174 302  98 655],334,5,34565,4.2484021632251725,0.0,40.0
48136,4,8136,[313 127 187 302 100],334,5,34570,4.248494531153988,0.0,40.0
48137,4,8137,[313 127 187 302 100],271,5,34575,4.2485868763824035,0.0,40.0
48138,4,8138,[313 127 187 302 100],334,5,34580,4.248679198918786,0.0,40.0
48139,4,8139,[197 211 286 168  98],666,5,34585,4.248771498771498,0.0,20.0
48140,4,8140,[313 127 187 302 100],334,5,34590,4.248863775948901,0.0,40.0
48141,4,8141,[313 127 187 302 100],271,5,34595,4.248956030459347,0.0,40.0
48142,4,8142,[313 127 187 302 100],90,5,34600,4.249048262311187,0.0,40.0
48143,4,8143,[313 127 187 302 100],334,5,34605,4.24914047151277,0.0,40.0
48144,4,8144,[588 197 300 655  79],537,1,34606,4.2487415592387965,0.0,0.0
48145,4,8145,[210 187  89 121 186],406,3,34609,4.248588264178738,0.0,0.0
48146,4,8146,[313 127 187 302 100],271,5,34614,4.248680495888057,0.0,40.0
48147,4,8147,[100  25 508   4 117],533,4,34618,4.248649975454099,0.0,20.0
48148,4,8148,[313 127 187 302 100],207,4,34622,4.248619462510738,0.0,40.0
48149,4,8149,[ 79 568 275 234 200],343,2,34624,4.248343558282208,0.0,0.0
48150,4,8150,[313 127 187 302 100],334,5,34629,4.248435774751564,0.0,40.0
48151,4,8151,[313 127 187 302 100],90,5,34634,4.2485279685966635,0.0,40.0
48152,4,8152,[313 127 187 302 100],13,5,34639,4.248620139825831,0.0,40.0
48153,4,8153,[313 127 187 302 100],537,5,34644,4.248712288447388,0.0,40.0
48154,4,8154,[313 127 187 302 100],328,5,34649,4.24880441446965,0.0,40.0
48155,4,8155,[197 127  95 175 111],59,4,34653,4.248773908778813,0.0,20.0
48156,4,8156,[ 82 294 496 180   1],488,3,34656,4.248620816476646,0.0,0.0
48157,4,8157,[313 127 187 302 100],328,5,34661,4.2487129198332925,0.0,40.0
48158,4,8158,[313 127 187 302 100],13,5,34666,4.24880500061282,0.0,40.0
48159,4,8159,[117  98 289  64 318],84,5,34671,4.2488970588235295,20.0,20.0
48160,4,8160,[ 22 143 273 127 328],479,4,34675,4.248866560470531,0.0,20.0
48161,4,8161,[313 127 187 302 100],13,5,34680,4.24895858858123,0.0,40.0
48162,4,8162,[153  12 271 210 135],13,3,34683,4.248805586181551,20.0,0.0
48163,4,8163,[313 127 187 302 100],474,5,34688,4.248897599216071,0.0,40.0
48164,4,8164,[186  28 322 100 318],537,3,34691,4.248744641763626,20.0,20.0
48165,4,8165,[257   7 328  69 271],334,2,34693,4.248469262796963,0.0,0.0
48166,4,8166,[302 475 161 186 313],474,5,34698,4.24856128321293,0.0,0.0
48167,4,8167,[313 127 187 302 100],474,5,34703,4.2486532810969635,0.0,40.0
48168,4,8168,[313 127 187 302 100],90,5,34708,4.2487452564573385,0.0,40.0
48169,4,8169,[568 185 300  70 117],454,3,34711,4.24859241126071,0.0,0.0
48170,4,8170,[313 127 187 302 100],474,5,34716,4.248684371557949,0.0,40.0
48171,4,8171,[313 127 187 302 100],334,5,34721,4.2487763093489965,0.0,40.0
48172,4,8172,[ 56 275 568 294 496],311,5,34726,4.2488682246421146,0.0,0.0
48173,4,8173,[313 127 187 302 100],207,4,34730,4.248837778321507,0.0,40.0
48174,4,8174,[161 313 238 125 322],92,3,34733,4.24868501529052,0.0,0.0
48175,4,8175,[313 127 187 302 100],13,5,34738,4.248776908023483,0.0,40.0
48176,4,8176,[313 127 187 302 100],13,5,34743,4.248868778280543,0.0,40.0
48177,4,8177,[173 211 176 118 483],479,4,34747,4.248838346784055,20.0,0.0
48178,4,8178,[135 475 197 268  22],615,5,34752,4.248930187064433,0.0,0.0
48179,4,8179,[313 127 187 302 100],271,5,34757,4.249022004889976,0.0,40.0
48180,4,8180,[202 182 496  28  11],892,4,34761,4.248991565823249,0.0,0.0
48181,4,8181,[568 180 202 125 195],897,4,34765,4.2489611341970175,0.0,0.0
48182,4,8182,[313 127 187 302 100],271,5,34770,4.249052914579005,0.0,40.0
48183,4,8183,[313 127 187 302 100],207,4,34774,4.249022482893451,0.0,40.0
48184,4,8184,[234 423 546 483  96],7,5,34779,4.249114233353696,20.0,0.0
48185,4,8185,[313 127 187 302 100],537,5,34784,4.249205961397508,0.0,40.0
48186,4,8186,[ 95 197  50  12 100],406,5,34789,4.249297667033101,20.0,40.0
48187,4,8187,[313 127 187 302 100],271,5,34794,4.249389350268686,0.0,40.0
48188,4,8188,[313 127 187 302 100],334,5,34799,4.249481011112468,0.0,40.0
48189,4,8189,[313 127 187 302 100],13,5,34804,4.24957264957265,0.0,40.0
48190,4,8190,[180 258 176   7  12],474,5,34809,4.249664265657429,20.0,0.0
48191,4,8191,[168 210 191 135   1],533,4,34813,4.2496337890625,0.0,0.0
48192,4,8192,[313 127 187 302 100],90,5,34818,4.249725375320396,0.0,40.0
48193,4,8193,[313 127 187 302 100],474,5,34823,4.249816939223822,0.0,40.0
48194,4,8194,[313 127 187 302 100],90,5,34828,4.249908480780964,0.0,40.0
48195,4,8195,[313 127 187 302 100],13,5,34833,4.25,0.0,40.0
48196,4,8196,[313 127 187 302 100],13,5,34838,4.250091496889106,0.0,40.0
48197,4,8197,[161  71 385 216  25],378,5,34843,4.250182971456453,0.0,0.0
48198,4,8198,[313 127 187 302 100],90,5,34848,4.250274423710208,0.0,40.0
48199,4,8199,[313 127 187 302 100],144,4,34852,4.250243902439024,0.0,40.0
48200,4,8200,[313 127 187 302 100],537,5,34857,4.25033532496037,0.0,40.0
48201,4,8201,[313 127 187 302 100],537,5,34862,4.250426725188978,0.0,40.0
48202,4,8202,[313 127 187 302 100],207,4,34866,4.250396196513471,0.0,40.0
48203,4,8203,[237  70 186 288 216],452,1,34867,4.25,0.0,0.0
48204,4,8204,[313 127 187 302 100],207,4,34871,4.249969530773918,0.0,40.0
48205,4,8205,[313 127 187 302 100],90,5,34876,4.250060931026079,0.0,40.0
48206,4,8206,[313 127 187 302 100],90,5,34881,4.250152309004508,0.0,40.0
48207,4,8207,[313 127 187 302 100],271,5,34886,4.250243664717349,0.0,40.0
48208,4,8208,[313 127 187 302 100],328,5,34891,4.250334998172737,0.0,40.0
48209,4,8209,[180 405 234 289 588],406,3,34894,4.250182704019489,0.0,0.0
48210,4,8210,[435 132 176 175 121],339,4,34898,4.250152234806967,0.0,0.0
48211,4,8211,[678 603 483 185  22],13,3,34901,4.25,40.0,0.0
48212,4,8212,[313 127 187 302 100],334,5,34906,4.250091318641179,0.0,40.0
48213,4,8213,[258 568 172 238  22],378,4,34910,4.250060871682494,0.0,0.0
48214,4,8214,[313 127 187 302 100],144,4,34914,4.250030432136336,0.0,40.0
48215,4,8215,[313 127 187 302 100],144,4,34918,4.25,0.0,40.0
48216,4,8216,[313 127 187 302 100],90,5,34923,4.2500912741876595,0.0,40.0
48217,4,8217,[313 127 187 302 100],90,5,34928,4.250182526162083,0.0,40.0
48218,4,8218,[  8 121 258 603 238],387,4,34932,4.250152086628543,20.0,0.0
48219,4,8219,[423 323 496 182 322],454,2,34934,4.249878345498783,0.0,0.0
48220,4,8220,[186 197   7 275 202],406,2,34936,4.249604670964603,0.0,0.0
48221,4,8221,[313 127 187 302 603],13,5,34941,4.249695937728046,20.0,20.0
48222,4,8222,[313 127 187 302 603],13,5,34946,4.2497871822935664,20.0,20.0
48223,4,8223,[313 127 187 302 603],669,5,34951,4.249878404669261,20.0,20.0
48224,4,8224,[328   9 172  97 187],234,1,34952,4.249483282674772,0.0,0.0
48225,4,8225,[313 127 187 302 603],334,5,34957,4.24957451981522,20.0,20.0
48226,4,8226,[313 127 187 302 603],537,5,34962,4.249665734775738,20.0,20.0
48227,4,8227,[313 127 187 302 603],116,3,34965,4.2495138551288285,20.0,20.0
48228,4,8228,[313 127 187 302 100],13,5,34970,4.2496050552922595,0.0,40.0
48229,4,8229,[196 258 318 151 234],380,4,34974,4.249574726609963,20.0,0.0
48230,4,8230,[313 127 187 302 100],207,4,34978,4.249544405297048,0.0,40.0
48231,4,8231,[313 127 187 302 100],13,5,34983,4.24963556851312,0.0,40.0
48232,4,8232,[313 127 187 302 100],13,5,34988,4.249726709583384,0.0,40.0
48233,4,8233,[313 127 187 302 100],90,5,34993,4.249817828515909,0.0,40.0
48234,4,8234,[313 127 187 302 100],537,5,34998,4.249908925318762,0.0,40.0
48235,4,8235,[300 238 655 427 161],379,3,35001,4.249757163671685,0.0,0.0
48236,4,8236,[313 127 187 302 100],271,5,35006,4.249848245720529,0.0,40.0
48237,4,8237,[313 127 187 302 100],13,5,35011,4.249939305656713,0.0,40.0
48238,4,8238,[313 127 187 302 100],328,5,35016,4.250030343488287,0.0,40.0
48239,4,8239,[357  70 235 172 117],537,2,35018,4.249757281553398,20.0,0.0
48240,4,8240,[ 98 200 655 210  50],488,3,35021,4.249605630384662,0.0,40.0
48241,4,8241,[313 127 187 302 100],90,5,35026,4.249696675564183,0.0,40.0
48242,4,8242,[435 180 195 143  79],59,4,35030,4.249666383598204,0.0,0.0
48243,4,8243,[313 127 187 302 100],537,5,35035,4.2497573993207185,0.0,40.0
48244,4,8244,[313 127 187 302 100],537,5,35040,4.249848392965434,0.0,40.0
48245,4,8245,[313 127 187 302 100],271,5,35045,4.249939364540383,0.0,40.0
48246,4,8246,[313 127 187 302 100],537,5,35050,4.250030314053595,0.0,40.0
48247,4,8247,[ 98 273 111 197 125],207,4,35054,4.25,0.0,20.0
48248,4,8248,[258 234 742 678 100],488,3,35057,4.249848466480786,0.0,20.0
48249,4,8249,[313 127 187 302 100],328,5,35062,4.249939393939394,0.0,40.0
48250,4,8250,[313 127 187 302 100],207,4,35066,4.249909101927039,0.0,40.0
48251,4,8251,[313 127 187 302 100],144,4,35070,4.249878817256422,0.0,40.0
48252,4,8252,[238 405 196 742 237],334,3,35073,4.249727371864776,0.0,0.0
48253,4,8253,[313 127 187 302 100],207,4,35077,4.249697116549552,0.0,40.0
48254,4,8254,[313 127 187 302 100],334,5,35082,4.2497880072683225,0.0,40.0
48255,4,8255,[475 153 175 234  88],339,5,35087,4.249878875968992,0.0,0.0
48256,4,8256,[204 588 357 289 318],458,3,35090,4.249727503936055,40.0,0.0
48257,4,8257,[313 127 187 302 100],537,5,35095,4.249818357955921,0.0,40.0
48258,4,8258,[313 127 187 302 100],271,5,35100,4.249909189974574,0.0,40.0
48259,4,8259,[313 127 187 302 100],271,5,35105,4.25,0.0,40.0
48260,4,8260,[313 127 187 302 100],334,5,35110,4.250090788040189,0.0,40.0
48261,4,8261,[403 588 300  82 655],64,3,35113,4.249939481965626,0.0,0.0
48262,4,8262,[313 127 187 302 100],334,5,35118,4.250030255355198,0.0,40.0
48263,4,8263,[323 268  12 475 269],537,2,35120,4.249757986447241,20.0,0.0
48264,4,8264,[313 127 187 302 100],144,4,35124,4.2497277676950995,0.0,40.0
48265,4,8265,[313 127 187 302 100],90,5,35129,4.249818533752722,0.0,40.0
48266,4,8266,[111 322   9  70 742],533,5,35134,4.2499092778517,0.0,0.0
48267,4,8267,[ 71 405  82 258   8],488,2,35136,4.249637155297533,0.0,0.0
48268,4,8268,[313 127 187 302 100],334,5,35141,4.249727899383239,0.0,40.0
48269,4,8269,[313 127 187 302 100],207,4,35145,4.249697702539299,0.0,40.0
48270,4,8270,[187 300 318 286  12],239,2,35147,4.249425704267924,40.0,0.0
48271,4,8271,[313 127 187 302 100],13,5,35152,4.249516441005802,0.0,40.0
48272,4,8272,[313 127 187 302 100],474,5,35157,4.24960715580805,0.0,40.0
48273,4,8273,[286 289 546 216  95],194,0,35157,4.2490935460478605,0.0,0.0
48274,4,8274,[313 127 187 302 100],537,5,35162,4.249184290030212,0.0,40.0
48275,4,8275,[313 127 187 302 100],271,5,35167,4.249275012083132,0.0,40.0
48276,4,8276,[313 127 187 302 100],334,5,35172,4.249365712214571,0.0,40.0
48277,4,8277,[313 127 187 302 100],328,5,35177,4.249456390432472,0.0,40.0
48278,4,8278,[313 127 187 302 100],207,4,35181,4.24942625921005,0.0,40.0
48279,4,8279,[313 127 187 302 100],271,5,35186,4.24951690821256,0.0,40.0
48280,4,8280,[313 127 187 302 100],474,5,35191,4.249607535321821,0.0,40.0
48281,4,8281,[ 98  96 111 125 181],374,3,35194,4.249456652982372,0.0,20.0
48282,4,8282,[118  50  88 180 194],840,3,35197,4.249305807074731,0.0,20.0
48283,4,8283,[313 127 187 302 100],207,4,35201,4.2492757122163205,0.0,40.0
48284,4,8284,[313 127 187 302 100],271,5,35206,4.249366324683162,0.0,40.0
48285,4,8285,[ 15 238 196  70 111],653,0,35206,4.2488534878107656,0.0,0.0
48286,4,8286,[313 127 187 302 100],13,5,35211,4.248944129359237,0.0,40.0
48287,4,8287,[  8  79 179 204 187],881,5,35216,4.249034749034749,0.0,0.0
48288,4,8288,[300 483  97 127 568],188,5,35221,4.249125346845217,20.0,20.0
48289,4,8289,[313 127 187 302 100],334,5,35226,4.249215922798553,0.0,40.0
48290,4,8290,[313 127 187 302 100],90,5,35231,4.249306476902666,0.0,40.0
48291,4,8291,[289  96 195   8  97],881,2,35233,4.249035214664737,0.0,0.0
48292,4,8292,[ 89 143 234 323 182],90,3,35236,4.24888460147112,0.0,0.0
48293,4,8293,[  9 423  69 597   7],7,4,35240,4.2488545936821795,0.0,0.0
48294,4,8294,[313 127 187 302 100],207,4,35244,4.248824593128391,0.0,40.0
48295,4,8295,[313 127 187 302 100],144,4,35248,4.248794599807136,0.0,40.0
48296,4,8296,[496 191  96 181 196],650,5,35253,4.248885139206942,0.0,0.0
48297,4,8297,[678  89 176 234  28],488,4,35257,4.248855145818269,0.0,0.0
48298,4,8298,[313 127 187 302 100],334,5,35262,4.248945656103145,0.0,40.0
48299,4,8299,[313 127 187 302 100],537,5,35267,4.249036144578313,0.0,40.0
48300,4,8300,[423 210  22 265 257],479,4,35271,4.249006143838092,0.0,0.0
48301,4,8301,[174 588 515 200 186],843,1,35272,4.248614791616478,0.0,20.0
48302,4,8302,[313 127 187 302 100],334,5,35277,4.248705287245574,0.0,40.0
48303,4,8303,[196  22 161 228 234],479,4,35281,4.2486753371868975,0.0,0.0
48304,4,8304,[313 127 187 302 100],474,5,35286,4.248765803732691,0.0,40.0
48305,4,8305,[313 127 187 302 100],90,5,35291,4.248856248495064,0.0,40.0
48306,4,8306,[ 11   4 357 180 385],537,2,35293,4.248585530275671,20.0,0.0
48307,4,8307,[313 294 121 483 238],13,3,35296,4.248435243139143,20.0,0.0
48308,4,8308,[313 127 187 302 100],144,4,35300,4.248405343603322,0.0,40.0
48309,4,8309,[313 127 187 302 100],90,5,35305,4.24849578820698,0.0,40.0
48310,4,8310,[313 127 187 302 100],90,5,35310,4.248586211045602,0.0,40.0
48311,4,8311,[313 127 187 302 100],334,5,35315,4.248676612127046,0.0,40.0
48312,4,8312,[313 127 187 302 100],13,5,35320,4.24876699145916,0.0,40.0
48313,4,8313,[313 127 187 302 100],474,5,35325,4.248857349049795,0.0,40.0
48314,4,8314,[313 127 187 302 100],474,5,35330,4.248947684906795,0.0,40.0
48315,4,8315,[313 127 187 302 100],207,4,35334,4.248917748917749,0.0,40.0
48316,4,8316,[313 127 187 302 100],271,5,35339,4.249008055789347,0.0,40.0
48317,4,8317,[186  82 175 153 168],666,3,35342,4.248857898533301,0.0,0.0
48318,4,8318,[186 195 100 357 323],474,4,35346,4.248827984132708,20.0,20.0
48319,4,8319,[313 127 187 302 100],537,5,35351,4.248918269230769,0.0,40.0
48320,4,8320,[313 127 187 302 100],537,5,35356,4.24900853262829,0.0,40.0
48321,4,8321,[313 127 187 302 100],334,5,35361,4.249098774333093,0.0,40.0
48322,4,8322,[313 127 187 302 100],13,5,35366,4.2491889943529975,0.0,40.0
48323,4,8323,[313 127 187 302 100],537,5,35371,4.249279192695819,0.0,40.0
48324,4,8324,[313 127 187 302 100],474,5,35376,4.2493693693693695,0.0,40.0
48325,4,8325,[333 294 546 194  96],533,4,35380,4.249339418688446,0.0,0.0
48326,4,8326,[313 127 187 302 100],271,5,35385,4.249429566470518,0.0,40.0
48327,4,8327,[215  64 187 483 328],85,4,35389,4.249399615754083,20.0,0.0
48328,4,8328,[313 127 187 302 100],271,5,35394,4.249489734662024,0.0,40.0
48329,4,8329,[313 127 187 302 100],328,5,35399,4.249579831932773,0.0,40.0
48330,4,8330,[313 127 187 302 100],13,5,35404,4.249669907574121,0.0,40.0
48331,4,8331,[313 127 187 302 100],334,5,35409,4.249759961593855,0.0,40.0
48332,4,8332,[151 286 288  70 194],59,2,35411,4.249489979599184,0.0,0.0
48333,4,8333,[313 127 187 302 100],537,5,35416,4.249580033597312,0.0,40.0
48334,4,8334,[183 168 742 328 678],804,5,35421,4.249670065986803,0.0,0.0
48335,4,8335,[313 127 187 302 100],90,5,35426,4.2497600767754315,0.0,40.0
48336,4,8336,[313 127 187 302 100],90,5,35431,4.249850065970973,0.0,40.0
48337,4,8337,[313 127 187 302 100],474,5,35436,4.249940033581194,0.0,40.0
48338,4,8338,[ 64  70 405   9  12],144,5,35441,4.2500299796138625,20.0,0.0
48339,4,8339,[174  79 238 121 273],897,4,35445,4.25,0.0,20.0
48340,4,8340,[313 127 187 302 100],90,5,35450,4.250089917276106,0.0,40.0
48341,4,8341,[313 127 187 302 100],474,5,35455,4.250179812994486,0.0,40.0
48342,4,8342,[127 153 357 197 238],6,5,35460,4.250269687162891,20.0,20.0
48343,4,8343,[313 127 187 302 100],13,5,35465,4.25035953978907,0.0,40.0
48344,4,8344,[313 127 187 302 100],207,4,35469,4.250329538645896,0.0,40.0
48345,4,8345,[313 127 187 302 100],144,4,35473,4.250299544692068,0.0,40.0
48346,4,8346,[313 127 187 302 100],207,4,35477,4.250269557925003,0.0,40.0
48347,4,8347,[ 56 655 132 333  89],85,3,35480,4.250119789171059,0.0,0.0
48348,4,8348,[294   7 179  95 176],406,4,35484,4.250089831117499,0.0,0.0
48349,4,8349,[313 127 187 302 100],13,5,35489,4.250179640718563,0.0,40.0
48350,4,8350,[678 153 187 655 300],13,3,35492,4.250029936534546,0.0,0.0
48351,4,8351,[265  98 322  96 234],308,1,35493,4.249640804597701,0.0,20.0
48352,4,8352,[313 127 187 302 100],271,5,35498,4.249730635699748,0.0,40.0
48353,4,8353,[ 12  98 135 235 202],406,4,35502,4.249700742159445,20.0,20.0
48354,4,8354,[313 127 187 302 100],537,5,35507,4.249790544584082,0.0,40.0
48355,4,8355,[322 328 294  64 742],533,5,35512,4.2498803255146,0.0,0.0
48356,4,8356,[313 127 187 302 100],13,5,35517,4.249970084958718,0.0,40.0
48357,4,8357,[286  64 568 258  98],184,3,35520,4.2498205312275665,0.0,20.0
48358,4,8358,[313 127 187 302 100],537,5,35525,4.249910276348846,0.0,40.0
48359,4,8359,[313 127 187 302 100],271,5,35530,4.25,0.0,40.0
48360,4,8360,[313 127 187 302 100],537,5,35535,4.250089702188734,0.0,40.0
48361,4,8361,[313 127 187 302 100],334,5,35540,4.250179382922746,0.0,40.0
48362,4,8362,[313 127 187 302 100],90,5,35545,4.250269042209734,0.0,40.0
48363,4,8363,[313 127 187 302 100],537,5,35550,4.2503586800573885,0.0,40.0
48364,4,8364,[313 127 187 302 100],474,5,35555,4.250448296473401,0.0,40.0
48365,4,8365,[ 71 655 100 183 135],738,2,35557,4.250179297155152,0.0,20.0
48366,4,8366,[181 471 286 180 294],666,3,35560,4.250029879287678,0.0,0.0
48367,4,8367,[313 127 187 302 100],271,5,35565,4.250119502868069,0.0,40.0
48368,4,8368,[313 127 187 302 100],474,5,35570,4.25020910503047,0.0,40.0
48369,4,8369,[313 127 187 302 100],90,5,35575,4.250298685782557,0.0,40.0
48370,4,8370,[313 127 187 302 100],13,5,35580,4.250388245132004,0.0,40.0
48371,4,8371,[313 127 187 302 100],207,4,35584,4.250358337314859,0.0,40.0
48372,4,8372,[ 28 161 200 168 215],881,1,35585,4.249970142123492,0.0,0.0
48373,4,8373,[313 127 187 302 100],13,5,35590,4.250059708621925,0.0,40.0
48374,4,8374,[313 127 187 302 100],537,5,35595,4.250149253731343,0.0,40.0
48375,4,8375,[313 127 187 302 100],328,5,35600,4.2502387774594075,0.0,40.0
48376,4,8376,[313 127 187 302 100],328,5,35605,4.250328279813776,0.0,40.0
48377,4,8377,[ 56  89 179 210 357],738,4,35609,4.250298400572929,20.0,0.0
48378,4,8378,[313 127 187 302 100],328,5,35614,4.250387874448025,0.0,40.0
48379,4,8379,[313 127 187 302 100],90,5,35619,4.250477326968974,0.0,40.0
48380,4,8380,[202 118 403  12 204],308,4,35623,4.250447440639542,20.0,0.0
48381,4,8381,[313 127 187 302 100],13,5,35628,4.250536864710093,0.0,40.0
48382,4,8382,[216  69 222 121 237],899,4,35632,4.250506978408684,0.0,0.0
48383,4,8383,[313 127 187 302 100],144,4,35636,4.250477099236641,0.0,40.0
48384,4,8384,[  9  22 185 322  82],883,3,35639,4.250327966607037,0.0,0.0
48385,4,8385,[313 127 187 302 100],334,5,35644,4.250417362270451,0.0,40.0
48386,4,8386,[313 127 187 302 100],328,5,35649,4.250506736616192,0.0,40.0
48387,4,8387,[313 127 187 302 100],474,5,35654,4.250596089651884,0.0,40.0
48388,4,8388,[313 127 187 302 100],537,5,35659,4.250685421385147,0.0,40.0
48389,4,8389,[313 127 187 302 100],271,5,35664,4.2507747318236,0.0,40.0
48390,4,8390,[161   9 385 216 200],234,1,35665,4.2503873197473485,0.0,0.0
48391,4,8391,[175  22 181 546 234],648,4,35669,4.250357483317445,0.0,0.0
48392,4,8392,[313 127 187 302 100],13,5,35674,4.250446800905516,0.0,40.0
48393,4,8393,[423 117 135  56 282],144,5,35679,4.2505360972122945,0.0,0.0
48394,4,8394,[183   9 475 405 127],455,4,35683,4.250506253722454,0.0,20.0
48395,4,8395,[313 127 187 302 100],474,5,35688,4.250595521676989,0.0,40.0
48396,4,8396,[313 127 187 302 100],537,5,35693,4.250684768369656,0.0,40.0
48397,4,8397,[568 125  88 183 385],881,4,35697,4.25065491783758,0.0,0.0
48398,4,8398,[313 127 187 302 100],207,4,35701,4.2506250744136205,0.0,40.0
48399,4,8399,[313 127 187 302 100],144,4,35705,4.250595238095238,0.0,40.0
48400,4,8400,[313 127 187 302 100],144,4,35709,4.250565408879895,0.0,40.0
48401,4,8401,[313 127 187 302 100],144,4,35713,4.250535586765056,0.0,40.0
48402,4,8402,[313 127 187 302 100],334,5,35718,4.250624776865405,0.0,40.0
48403,4,8403,[204 117 175  50 180],648,2,35720,4.250356972870062,0.0,20.0
48404,4,8404,[313 127 187 302 100],537,5,35725,4.250446162998215,0.0,40.0
48405,4,8405,[294 182 678  96  89],804,5,35730,4.250535331905781,0.0,0.0
48406,4,8406,[313 127 187 302 100],334,5,35735,4.250624479600333,0.0,40.0
48407,4,8407,[313 127 187 302 100],328,5,35740,4.250713606089438,0.0,40.0
48408,4,8408,[313 127 187 302 100],537,5,35745,4.250802711380664,0.0,40.0
48409,4,8409,[313 127 187 302 100],271,5,35750,4.25089179548157,0.0,40.0
48410,4,8410,[ 11 238 180 427   4],13,3,35753,4.250743074545238,0.0,0.0
48411,4,8411,[313 127 187 302 100],207,4,35757,4.250713266761769,0.0,40.0
48412,4,8412,[313 127 187 302 100],474,5,35762,4.250802329727803,0.0,40.0
48413,4,8413,[313 127 187 302 100],271,5,35767,4.250891371523651,0.0,40.0
48414,4,8414,[405  70 234 173 294],666,2,35769,4.250623885918004,0.0,0.0
48415,4,8415,[ 64 143 195 269 191],537,1,35770,4.250237642585551,0.0,0.0
48416,4,8416,[313 127 187 302 100],537,5,35775,4.250326719733872,0.0,40.0
48417,4,8417,[313 127 187 302 100],144,4,35779,4.250296982656213,0.0,40.0
48418,4,8418,[313 127 187 302 100],474,5,35784,4.250386031595201,0.0,40.0
48419,4,8419,[313 127 187 302 100],334,5,35789,4.250475059382423,0.0,40.0
48420,4,8420,[313 127 187 302 100],207,4,35793,4.250445315283221,0.0,40.0
48421,4,8421,[313 127 187 302 100],328,5,35798,4.250534314889575,0.0,40.0
48422,4,8422,[174 603  56 204   4],379,5,35803,4.25062329336341,20.0,20.0
48423,4,8423,[300 318 179 187 111],64,4,35807,4.250593542260209,20.0,0.0
48424,4,8424,[313 127 187 302 100],334,5,35812,4.2506824925816025,0.0,40.0
48425,4,8425,[313 127 187 302 100],144,4,35816,4.250652741514361,0.0,40.0
48426,4,8426,[234 328 357  28  11],788,3,35819,4.250504331316008,20.0,0.0
48427,4,8427,[313 127 187 302 100],13,5,35824,4.250593260560038,0.0,40.0
48428,4,8428,[313 127 187 302 100],334,5,35829,4.250682168703286,0.0,40.0
48429,4,8429,[313 127 187 302 100],90,5,35834,4.250771055753262,0.0,40.0
48430,4,8430,[313 127 187 302 100],537,5,35839,4.250859921717471,0.0,40.0
48431,4,8431,[204 322   8 174 194],311,5,35844,4.250948766603416,0.0,20.0
48432,4,8432,[132 121 328 174 289],533,4,35848,4.250919008656469,0.0,20.0
48433,4,8433,[313 127 187 302 100],334,5,35853,4.251007825468342,0.0,40.0
48434,4,8434,[313 127 187 302 100],474,5,35858,4.2510966212211025,0.0,40.0
48435,4,8435,[313 127 187 302 100],474,5,35863,4.251185395922238,0.0,40.0
48436,4,8436,[194 132 313 323 597],328,2,35865,4.250918572952472,0.0,0.0
48437,4,8437,[313 127 187 302 100],271,5,35870,4.251007347712728,0.0,40.0
48438,4,8438,[313 127 187 302 100],537,5,35875,4.251096101433819,0.0,40.0
48439,4,8439,[313 127 187 302 100],207,4,35879,4.2510663507109,0.0,40.0
48440,4,8440,[313 127 187 302 100],144,4,35883,4.251036607037081,0.0,40.0
48441,4,8441,[313 127 187 302 100],474,5,35888,4.2511253257521915,0.0,40.0
48442,4,8442,[313 127 187 302 100],271,5,35893,4.2512140234513796,0.0,40.0
48443,4,8443,[313 127 187 302 100],328,5,35898,4.251302700142113,0.0,40.0
48444,4,8444,[265 435 202 313 117],102,1,35899,4.250917702782711,0.0,0.0
48445,4,8445,[313 127 187 302 100],474,5,35904,4.251006393559082,0.0,40.0
48446,4,8446,[313 127 187 302 100],271,5,35909,4.251095063336096,0.0,40.0
48447,4,8447,[357 496  89 204 175],148,3,35912,4.25094696969697,20.0,0.0
48448,4,8448,[269 271  28 302 742],334,1,35913,4.250562196709669,0.0,0.0
48449,4,8449,[202  71 228 276 603],533,4,35917,4.250532544378698,20.0,0.0
48450,4,8450,[  8  28  64 181 183],194,2,35919,4.250266240681576,0.0,0.0
48451,4,8451,[313 127 187 302 100],144,4,35923,4.250236630383341,0.0,40.0
48452,4,8452,[313 127 187 302 100],537,5,35928,4.2503253282858156,0.0,40.0
48453,4,8453,[313 127 187 302 100],328,5,35933,4.250414005204637,0.0,40.0
48454,4,8454,[313 127 187 302 100],537,5,35938,4.25050266114725,0.0,40.0
48455,4,8455,[313 127 187 302 100],328,5,35943,4.250591296121097,0.0,40.0
48456,4,8456,[313 127 187 302 100],474,5,35948,4.250679910133617,0.0,40.0
48457,4,8457,[313 127 187 302 100],537,5,35953,4.250768503192244,0.0,40.0
48458,4,8458,[ 71  89   8 238 286],488,1,35954,4.250384206170942,0.0,0.0
48459,4,8459,[313 127 187 302 100],328,5,35959,4.250472813238771,0.0,40.0
48460,4,8460,[234 603  95 265 328],13,4,35963,4.250443210022456,20.0,0.0
48461,4,8461,[173 568 234 195 202],538,2,35965,4.2501772630583785,0.0,0.0
48462,4,8462,[173 678 216 302 121],339,2,35967,4.249911378943637,0.0,0.0
48463,4,8463,[313 127 187 302 603],474,5,35972,4.25,20.0,20.0
48464,4,8464,[313 127 187 302 603],474,5,35977,4.250088600118134,20.0,20.0
48465,4,8465,[313 127 187 302 603],271,5,35982,4.2501771793054575,20.0,20.0
48466,4,8466,[357   9   4  50 496],115,4,35986,4.250147631982993,20.0,20.0
48467,4,8467,[313 127 187 302 603],669,5,35991,4.250236183278224,20.0,20.0
48468,4,8468,[257  12 202 144 174],454,3,35994,4.250088558271343,20.0,20.0
48469,4,8469,[257  97 185 215 135],815,2,35996,4.249822904368359,0.0,0.0
48470,4,8470,[313 127 187 302 603],334,5,36001,4.2499114626372325,20.0,20.0
48471,4,8471,[175 496 100 179 172],738,3,36004,4.2497639282341835,0.0,20.0
48472,4,8472,[187 127  71  22 144],406,1,36005,4.249380384751563,0.0,20.0
48473,4,8473,[313 127 187 302 603],669,5,36010,4.249468963889544,20.0,20.0
48474,4,8474,[172 333 237   1 742],298,4,36014,4.249439528023599,0.0,0.0
48475,4,8475,[313 127 187 302 603],537,5,36019,4.249528079282681,20.0,20.0
48476,4,8476,[313 127 187 302 603],90,5,36024,4.249616609649641,20.0,20.0
48477,4,8477,[ 12 237  69  15 121],455,2,36026,4.249351262090116,20.0,0.0
48478,4,8478,[313 127 187 302 603],334,5,36031,4.249439792428352,20.0,20.0
48479,4,8479,[300  98 196  82 174],892,4,36035,4.24941037735849,0.0,40.0
48480,4,8480,[313 127 187 302 603],116,3,36038,4.24926305860158,20.0,20.0
48481,4,8481,[215 603   1 318 515],804,5,36043,4.249351568026409,40.0,0.0
48482,4,8482,[313 127 187 302 603],537,5,36048,4.249440056583755,20.0,20.0
48483,4,8483,[423 742   4 288 180],666,2,36050,4.249174917491749,0.0,0.0
48484,4,8484,[313 127 187 302 603],474,5,36055,4.249263406010607,20.0,20.0
48485,4,8485,[313 127 187 302 603],474,5,36060,4.2493518736742875,20.0,20.0
48486,4,8486,[  1 153  69 143 174],92,4,36064,4.249322493224932,0.0,20.0
48487,4,8487,[ 69  95 257  25 179],378,3,36067,4.249175306314798,0.0,0.0
48488,4,8488,[313  70 202 655 276],207,2,36069,4.248910354576511,0.0,0.0
48489,4,8489,[ 56 427 273 258  50],328,3,36072,4.248763250883393,0.0,20.0
48490,4,8490,[121  79 196 568 515],92,4,36076,4.248733953597927,0.0,0.0
48491,4,8491,[313 127 187 302 603],90,5,36081,4.248822421102214,20.0,20.0
48492,4,8492,[313 127 187 302 603],474,5,36086,4.248910867773461,20.0,20.0
48493,4,8493,[ 25  96  69 196  28],59,5,36091,4.2489992936190255,0.0,0.0
48494,4,8494,[313 127 187 302 603],13,5,36096,4.249087698646263,20.0,20.0
48495,4,8495,[313 127 187 302 603],669,5,36101,4.249176082862523,20.0,20.0
48496,4,8496,[ 97 423 191 286 496],452,5,36106,4.249264446275156,0.0,0.0
48497,4,8497,[313 127 187 302 603],90,5,36111,4.249352788891504,20.0,20.0
48498,4,8498,[313 127 187 302 603],537,5,36116,4.249441110718908,20.0,20.0
48499,4,8499,[313 127 187 302 603],13,5,36121,4.249529411764706,20.0,20.0
48500,4,8500,[153 194 180 135   9],85,4,36125,4.24950005881661,0.0,0.0
48501,4,8501,[515  11 273 475 111],833,1,36126,4.249117854622442,0.0,0.0
48502,4,8502,[211  71 234 118 237],7,4,36130,4.249088556979889,0.0,0.0
48503,4,8503,[313 127 187 302 603],537,5,36135,4.2491768579492,20.0,20.0
48504,4,8504,[313 127 187 302 603],669,5,36140,4.249265138154027,20.0,20.0
48505,4,8505,[313 127 187 302 603],669,5,36145,4.249353397601693,20.0,20.0
48506,4,8506,[313 127 187 302 603],474,5,36150,4.249441636299518,20.0,20.0
48507,4,8507,[275 237  28 333 174],537,1,36151,4.2490597085096375,0.0,20.0
48508,4,8508,[313 127 187 302 603],116,3,36154,4.2489129157362795,20.0,20.0
48509,4,8509,[313 127 187 302 603],271,5,36159,4.249001175088131,20.0,20.0
48510,4,8510,[313 127 187 302 603],13,5,36164,4.2490894136999176,20.0,20.0
48511,4,8511,[200 187 313 179 238],474,4,36168,4.24906015037594,0.0,0.0
48512,4,8512,[313 127 187 302 603],271,5,36173,4.249148361329731,20.0,20.0
48513,4,8513,[313 127 187 302 603],474,5,36178,4.249236551562133,20.0,20.0
48514,4,8514,[135  89   8 678 125],881,4,36182,4.24920728126835,0.0,0.0
48515,4,8515,[313 127 187 302 603],334,5,36187,4.249295443870362,20.0,20.0
48516,4,8516,[ 82 423 318 179 588],387,2,36189,4.2490313490665725,20.0,0.0
48517,4,8517,[313 127 187 302 603],669,5,36194,4.249119511622447,20.0,20.0
48518,4,8518,[313 127 187 302 603],271,5,36199,4.249207653480456,20.0,20.0
48519,4,8519,[313 127 187 302 603],13,5,36204,4.249295774647887,20.0,20.0
48520,4,8520,[237  69  22 204  12],194,4,36208,4.249266518014317,20.0,0.0
48521,4,8521,[313 127 187 302 603],334,5,36213,4.249354611593523,20.0,20.0
48522,4,8522,[237  15 258 275 257],360,4,36217,4.249325354921976,0.0,0.0
48523,4,8523,[313 127 187 302 603],334,5,36222,4.249413420929141,20.0,20.0
48524,4,8524,[ 56  96   9 496 483],189,4,36226,4.249384164222874,20.0,0.0
48525,4,8525,[313 127 187 302 603],90,5,36231,4.249472202674173,20.0,20.0
48526,4,8526,[313 127 187 302 603],116,3,36234,4.24932567139674,20.0,20.0
48527,4,8527,[313 127 187 302 603],116,3,36237,4.249179174484053,20.0,20.0
48528,4,8528,[313 127 187 302 603],669,5,36242,4.249267206003048,20.0,20.0
48529,4,8529,[313 127 187 302 603],90,5,36247,4.249355216881594,20.0,20.0
48530,4,8530,[423 257  71  97 568],374,3,36250,4.249208768022506,0.0,0.0
48531,4,8531,[313 127 187 302 603],271,5,36255,4.24929676511955,20.0,20.0
48532,4,8532,[313 127 187 302 603],537,5,36260,4.249384741591468,20.0,20.0
48533,4,8533,[313 127 187 302 603],13,5,36265,4.249472697445512,20.0,20.0
48534,4,8534,[313 127 187 302 603],537,5,36270,4.249560632688928,20.0,20.0
48535,4,8535,[313 127 187 302 603],474,5,36275,4.24964854732896,20.0,20.0
48536,4,8536,[313 127 187 302 603],474,5,36280,4.249736441372848,20.0,20.0
48537,4,8537,[313 127 187 302 603],537,5,36285,4.249824314827829,20.0,20.0
48538,4,8538,[313 127 187 302 603],13,5,36290,4.249912167701136,20.0,20.0
48539,4,8539,[211 268 215 435  25],13,4,36294,4.2498829039812644,0.0,0.0
48540,4,8540,[ 22 216 289 168 153],409,3,36297,4.249736564805058,0.0,0.0
48541,4,8541,[215   1  56 187 135],313,4,36301,4.249707328494498,0.0,0.0
48542,4,8542,[238 405  25 265 125],804,5,36306,4.249795153927192,0.0,0.0
48543,4,8543,[313 127 187 302 603],90,5,36311,4.249882958801498,20.0,20.0
48544,4,8544,[313 127 187 302 603],537,5,36316,4.249970743124634,20.0,20.0
48545,4,8545,[313 127 187 302 603],90,5,36321,4.250058506903815,20.0,20.0
48546,4,8546,[313 127 187 302 603],116,3,36324,4.24991224991225,20.0,20.0
48547,4,8547,[183 471 496 132 286],666,5,36329,4.25,0.0,0.0
48548,4,8548,[313 127 187 302 603],90,5,36334,4.250087729559013,20.0,20.0
48549,4,8549,[313 127 187 302 603],474,5,36339,4.250175438596491,20.0,20.0
48550,4,8550,[313 127 187 302 603],116,3,36342,4.250029236346626,20.0,20.0
48551,4,8551,[313 127 187 302 603],537,5,36347,4.25011693171188,20.0,20.0
48552,4,8552,[313 127 187 302 603],13,5,36352,4.250204606570794,20.0,20.0
48553,4,8553,[313 127 187 302 603],13,5,36357,4.250292260930559,20.0,20.0
48554,4,8554,[175 127   4 183  82],883,4,36361,4.250263004091175,0.0,20.0
48555,4,8555,[313 127 187 302 603],13,5,36366,4.250350631136045,20.0,20.0
48556,4,8556,[ 97 294 143 301  50],13,2,36368,4.250087647540026,0.0,20.0
48557,4,8557,[313 127 187 302 603],537,5,36373,4.250175274596868,20.0,20.0
48558,4,8558,[313 127 187 302 603],669,5,36378,4.250262881177708,20.0,20.0
48559,4,8559,[235  25 222 423 111],13,2,36380,4.25,0.0,0.0
48560,4,8560,[313 127 187 302 603],90,5,36385,4.250087606588015,20.0,20.0
48561,4,8561,[313 127 187 302 603],13,5,36390,4.250175192711983,20.0,20.0
48562,4,8562,[313 127 187 302 603],334,5,36395,4.250262758379073,20.0,20.0
48563,4,8563,[313 127 187 302 603],669,5,36400,4.25035030359645,20.0,20.0
48564,4,8564,[186 286 121   1  70],102,1,36401,4.249970811441915,0.0,0.0
48565,4,8565,[313 127 187 302 603],537,5,36406,4.250058370301191,20.0,20.0
48566,4,8566,[ 64  69  95 118  82],92,2,36408,4.2497957277926925,0.0,0.0
48567,4,8567,[313 127 187 302 603],90,5,36413,4.249883286647992,20.0,20.0
48568,4,8568,[313 127 187 302 603],537,5,36418,4.249970825067102,20.0,20.0
48569,4,8569,[313 127 187 302 603],537,5,36423,4.250058343057177,20.0,20.0
48570,4,8570,[313 127 187 302 603],271,5,36428,4.250145840625365,20.0,20.0
48571,4,8571,[313 127 187 302 603],116,3,36431,4.25,20.0,20.0
48572,4,8572,[313 127 187 302 603],90,5,36436,4.2500874839612734,20.0,20.0
48573,4,8573,[313 127 187 302 603],537,5,36441,4.250174947515745,20.0,20.0
48574,4,8574,[597 678 508  97 191],82,2,36443,4.249912536443149,0.0,0.0
48575,4,8575,[127  64 483 183  11],215,4,36447,4.249883395522388,20.0,20.0
48576,4,8576,[313 127 187 302 603],474,5,36452,4.249970852279351,20.0,20.0
48577,4,8577,[  8 357 172 483 111],125,3,36455,4.249825134063884,40.0,0.0
48578,4,8578,[196 172 179  22 286],59,4,36459,4.249796013521389,0.0,0.0
48579,4,8579,[313 127 187 302 603],90,5,36464,4.24988344988345,20.0,20.0
48580,4,8580,[313 127 187 302 603],271,5,36469,4.249970865866449,20.0,20.0
48581,4,8581,[313 127 187 302 603],334,5,36474,4.250058261477511,20.0,20.0
48582,4,8582,[204 172 228 405  69],60,5,36479,4.250145636723756,0.0,0.0
48583,4,8583,[313 127 187 302 603],90,5,36484,4.250232991612302,20.0,20.0
48584,4,8584,[313 127 187 302 603],537,5,36489,4.250320326150262,20.0,20.0
48585,4,8585,[313 127 187 302 603],474,5,36494,4.250407640344747,20.0,20.0
48586,4,8586,[313 127 187 302 603],334,5,36499,4.250494934202865,20.0,20.0
48587,4,8587,[483 435  50 176 202],840,4,36503,4.250465766185375,20.0,20.0
48588,4,8588,[282 185 245 191 135],666,3,36506,4.250320176970543,0.0,0.0
48589,4,8589,[313 127 187 302 603],334,5,36511,4.250407450523865,20.0,20.0
48590,4,8590,[313 127 187 302 603],116,3,36514,4.250261901990455,20.0,20.0
48591,4,8591,[289 405 216 168  95],92,1,36515,4.249883612662942,0.0,0.0
48592,4,8592,[313 127 187 302 603],334,5,36520,4.2499709065518445,20.0,20.0
48593,4,8593,[427 179 200 333 111],666,3,36523,4.2498254596229925,0.0,0.0
48594,4,8594,[210  64 175  97 191],308,4,36527,4.2497963932518905,0.0,0.0
48595,4,8595,[313 127 187 302 603],90,5,36532,4.249883666821778,20.0,20.0
48596,4,8596,[313 127 187 302 603],474,5,36537,4.249970920088403,20.0,20.0
48597,4,8597,[313 127 187 302 603],271,5,36542,4.250058153058851,20.0,20.0
48598,4,8598,[471 175 276 172 204],537,2,36544,4.2497964879637165,0.0,0.0
48599,4,8599,[313 127 187 302 603],271,5,36549,4.2498837209302325,20.0,20.0
48600,4,8600,[313 127 187 302 603],116,3,36552,4.249738402511336,20.0,20.0
48601,4,8601,[132 210 435 423 187],313,5,36557,4.249825621948384,0.0,0.0
48602,4,8602,[313 127 187 302 603],271,5,36562,4.249912821108915,20.0,20.0
48603,4,8603,[182 475  56 127  69],213,4,36566,4.249883774988377,0.0,20.0
48604,4,8604,[151  89   7 211 183],346,4,36570,4.249854735618826,0.0,0.0
48605,4,8605,[176 174 568 508  79],378,5,36575,4.2499419009993025,0.0,20.0
48606,4,8606,[173   4 655 187  79],339,5,36580,4.250029046125247,0.0,0.0
48607,4,8607,[234 211 403 286 357],13,2,36582,4.249767657992565,20.0,0.0
48608,4,8608,[313 127 187 302 603],334,5,36587,4.249854803113021,20.0,20.0
48609,4,8609,[313 127 187 302 603],474,5,36592,4.249941927990709,20.0,20.0
48610,4,8610,[313 127 187 302 603],474,5,36597,4.250029032632679,20.0,20.0
48611,4,8611,[496 222 179  56 655],339,5,36602,4.250116117045982,0.0,0.0
48612,4,8612,[191 187 475 179 182],458,5,36607,4.250203181237664,0.0,0.0
48613,4,8613,[313 127 187 302 603],669,5,36612,4.2502902252147665,20.0,20.0
48614,4,8614,[176 323 194  79 132],263,4,36616,4.250261172373767,0.0,0.0
48615,4,8615,[313 127 187 302 603],271,5,36621,4.250348189415042,20.0,20.0
48616,4,8616,[ 79  96 125  64 100],378,4,36625,4.250319136590461,0.0,20.0
48617,4,8617,[313 127 187 302 603],116,3,36628,4.250174054304943,20.0,20.0
48618,4,8618,[313 127 187 302 603],334,5,36633,4.250261051166029,20.0,20.0
48619,4,8619,[204  98 215 125 135],815,4,36637,4.250232018561485,0.0,20.0
48620,4,8620,[313 127 187 302 603],13,5,36642,4.250318988516414,20.0,20.0
48621,4,8621,[313 127 187 302 603],334,5,36647,4.250405938297379,20.0,20.0
48622,4,8622,[313 127 187 302 603],271,5,36652,4.2504928679114,20.0,20.0
48623,4,8623,[313 127 187 302 603],537,5,36657,4.250579777365492,20.0,20.0
48624,4,8624,[313 127 187 302 603],537,5,36662,4.250666666666667,20.0,20.0
48625,4,8625,[187 181  79 117  56],158,3,36665,4.250521678645954,0.0,0.0
48626,4,8626,[313 127 187 302 603],13,5,36670,4.250608554538078,20.0,20.0
48627,4,8627,[ 11 151 204  89 216],666,2,36672,4.250347705146036,0.0,0.0
48628,4,8628,[313 127 187 302 603],271,5,36677,4.250434581063854,20.0,20.0
48629,4,8629,[313 127 187 302 603],537,5,36682,4.250521436848204,20.0,20.0
48630,4,8630,[313 127 187 302 603],537,5,36687,4.250608272506082,20.0,20.0
48631,4,8631,[313 127 187 302 603],90,5,36692,4.250695088044486,20.0,20.0
48632,4,8632,[313 127 187 302 603],13,5,36697,4.250781883470404,20.0,20.0
48633,4,8633,[118 161   4 179 471],543,3,36700,4.250637016446606,0.0,0.0
48634,4,8634,[313 127 187 302 603],116,3,36703,4.250492182976259,20.0,20.0
48635,4,8635,[313 127 187 302 603],13,5,36708,4.250578971746179,20.0,20.0
48636,4,8636,[132  71  28 483 210],536,5,36713,4.250665740419127,20.0,0.0
48637,4,8637,[313 127 187 302 603],669,5,36718,4.250752489002084,20.0,20.0
48638,4,8638,[179  70 258   8 186],85,4,36722,4.250723463363816,0.0,0.0
48639,4,8639,[313 127 187 302 603],13,5,36727,4.250810185185185,20.0,20.0
48640,4,8640,[228 222 200 135  82],774,1,36728,4.250433977548894,0.0,0.0
48641,4,8641,[313 127 187 302 603],474,5,36733,4.250520712797964,20.0,20.0
48642,4,8642,[313 127 187 302 603],13,5,36738,4.250607427976397,20.0,20.0
48643,4,8643,[121 385  82 435 175],308,4,36742,4.2505784359093015,0.0,0.0
48644,4,8644,[313 127 187 302 603],13,5,36747,4.250665124349335,20.0,20.0
48645,4,8645,[313 127 187 302 603],537,5,36752,4.2507517927365255,20.0,20.0
48646,4,8646,[179 245 121 588 288],200,4,36756,4.250722794032613,0.0,0.0
48647,4,8647,[144 515 179 322  82],13,1,36757,4.2503469010175765,0.0,0.0
48648,4,8648,[276 257 182 357 508],6,2,36759,4.2500867152271935,20.0,0.0
48649,4,8649,[313 127 187 302 603],537,5,36764,4.250173410404624,20.0,20.0
48650,4,8650,[313 127 187 302 603],669,5,36769,4.250260085539244,20.0,20.0
48651,4,8651,[357 588 435 546  95],804,2,36771,4.25,20.0,0.0
48652,4,8652,[313 127 187 302 603],334,5,36776,4.25008667514157,20.0,20.0
48653,4,8653,[313 127 187 302 603],669,5,36781,4.250173330251907,20.0,20.0
48654,4,8654,[313 127 187 302 603],90,5,36786,4.250259965337955,20.0,20.0
48655,4,8655,[313 127 187 302 603],474,5,36791,4.250346580406655,20.0,20.0
48656,4,8656,[313 127 187 302 603],537,5,36796,4.250433175464941,20.0,20.0
48657,4,8657,[318 300 196 237 186],666,1,36797,4.25005775005775,20.0,0.0
48658,4,8658,[313 127 187 302 603],116,3,36800,4.249913384917427,20.0,20.0
48659,4,8659,[313 127 187 302 603],474,5,36805,4.25,20.0,20.0
48660,4,8660,[276 143  88 318 546],92,1,36806,4.249624754647269,20.0,0.0
48661,4,8661,[313 127 187 302 603],116,3,36809,4.249480489494343,20.0,20.0
48662,4,8662,[  9 173 135 471 216],13,1,36810,4.249105390742237,0.0,0.0
48663,4,8663,[211 197 143  98  28],325,2,36812,4.248845798707294,0.0,20.0
48664,4,8664,[ 98 168 183 194 427],882,4,36816,4.248817080207732,0.0,20.0
48665,4,8665,[313 127 187 302 603],271,5,36821,4.248903761827833,20.0,20.0
48666,4,8666,[313 127 187 302 603],474,5,36826,4.248990423445252,20.0,20.0
48667,4,8667,[313 127 187 302 603],669,5,36831,4.2490770650669125,20.0,20.0
48668,4,8668,[161 182  88 678 423],454,3,36834,4.24893297958242,0.0,0.0
48669,4,8669,[313 127 187 302 603],13,5,36839,4.249019607843137,20.0,20.0
48670,4,8670,[475   9  82 265 405],343,4,36843,4.248990889170799,0.0,0.0
48671,4,8671,[313 127 187 302 603],474,5,36848,4.249077490774908,20.0,20.0
48672,4,8672,[200 742 273 121 276],145,3,36851,4.248933471693762,0.0,0.0
48673,4,8673,[313 127 187 302 603],334,5,36856,4.249020059949274,20.0,20.0
48674,4,8674,[194 191 546 483 216],295,5,36861,4.249106628242075,20.0,0.0
48675,4,8675,[313 127 187 302 603],13,5,36866,4.249193176579069,20.0,20.0
48676,4,8676,[313  28 174  64 172],92,4,36870,4.249164457761899,0.0,20.0
48677,4,8677,[313 127 187 302 603],334,5,36875,4.2492509794883615,20.0,20.0
48678,4,8678,[ 28 427 423  88  15],398,5,36880,4.249337481276645,0.0,0.0
48679,4,8679,[153 196 222 194 385],194,1,36881,4.248963133640553,0.0,0.0
48680,4,8680,[313 127 187 302 603],90,5,36886,4.249049648657989,20.0,20.0
48681,4,8681,[313 127 187 302 603],334,5,36891,4.249136143745681,20.0,20.0
48682,4,8682,[313 127 187 302 603],334,5,36896,4.2492226189105144,20.0,20.0
48683,4,8683,[210 204 175 153 197],385,3,36899,4.249078765545831,0.0,0.0
48684,4,8684,[313 127 187 302 603],474,5,36904,4.249165227403569,20.0,20.0
48685,4,8685,[196  82 215 127 191],537,2,36906,4.248906285977435,0.0,20.0
48686,4,8686,[313 127 187 302 603],669,5,36911,4.248992747784045,20.0,20.0
48687,4,8687,[313 127 187 302 603],116,3,36914,4.248848987108656,20.0,20.0
48688,4,8688,[483 151   1  56 222],669,2,36916,4.248590171481183,20.0,0.0
48689,4,8689,[313 127 187 302 603],13,5,36921,4.24867663981588,20.0,20.0
48690,4,8690,[313 127 187 302 603],90,5,36926,4.248763088252215,20.0,20.0
48691,4,8691,[197  50 237 275 196],537,3,36929,4.248619420156466,0.0,20.0
48692,4,8692,[313 127 187 302 603],537,5,36934,4.248705855285862,20.0,20.0
48693,4,8693,[313 127 187 302 603],537,5,36939,4.248792270531401,20.0,20.0
48694,4,8694,[313 127 187 302 603],334,5,36944,4.248878665899943,20.0,20.0
48695,4,8695,[313 127 187 302 603],271,5,36949,4.248965041398344,20.0,20.0
48696,4,8696,[405 204   4 173 187],379,4,36953,4.248936414855697,0.0,0.0
48697,4,8697,[313 127 187 302 603],474,5,36958,4.24902276385376,20.0,20.0
48698,4,8698,[313 127 187 302 603],537,5,36963,4.249109092999196,20.0,20.0
48699,4,8699,[172 403 286 742 483],524,3,36966,4.24896551724138,20.0,0.0
48700,4,8700,[ 79 216  89 333 234],506,5,36971,4.249051833122629,0.0,0.0
48701,4,8701,[271  64  22 111 475],833,1,36972,4.248678464720754,0.0,0.0
48702,4,8702,[435 257  97  50 333],666,2,36974,4.248420085028151,0.0,20.0
48703,4,8703,[313 127 187 302 603],537,5,36979,4.248506433823529,20.0,20.0
48704,4,8704,[301 174 143 257 322],334,2,36981,4.248248133256749,0.0,20.0
48705,4,8705,[265 144 210 121 328],313,5,36986,4.24833448196646,0.0,0.0
48706,4,8706,[568   1  15 179 276],200,5,36991,4.248420810841852,0.0,0.0
48707,4,8707,[357 258 238  79 180],650,2,36993,4.248162609095085,20.0,0.0
48708,4,8708,[403 185 597 265  71],308,3,36996,4.248019290389252,0.0,0.0
48709,4,8709,[313 127 187 302 603],334,5,37001,4.2481056257175664,20.0,20.0
48710,4,8710,[ 25 194 182  79 125],59,3,37004,4.2479623464585,0.0,0.0
48711,4,8711,[180  98  96 175 286],666,4,37008,4.24793388429752,0.0,20.0
48712,4,8712,[  4 435 182 191 655],194,4,37012,4.247905428669804,0.0,0.0
48713,4,8713,[183 403 121 222  96],788,2,37014,4.247647463851274,0.0,0.0
48714,4,8714,[313 127 187 302 603],334,5,37019,4.247733792312106,20.0,20.0
48715,4,8715,[313 127 187 302 603],474,5,37024,4.247820100963745,20.0,20.0
48716,4,8716,[655   1 216  22 168],881,4,37028,4.247791671446598,0.0,0.0
48717,4,8717,[ 56 333 173 282 568],85,1,37029,4.247419132828631,0.0,0.0
48718,4,8718,[237 100 275 301 216],85,1,37030,4.247046679665099,0.0,20.0
48719,4,8719,[313 127 187 302 603],669,5,37035,4.247133027522936,20.0,20.0
48720,4,8720,[313 127 187 302 603],334,5,37040,4.247219355578489,20.0,20.0
48721,4,8721,[405 185  88 200   4],749,4,37044,4.247191011235955,0.0,0.0
48722,4,8722,[257 357 121 202 143],479,4,37048,4.2471626733921815,20.0,0.0
48723,4,8723,[313 127 187 302 603],474,5,37053,4.247248968363136,20.0,20.0
48724,4,8724,[403  89 100 204 186],313,3,37056,4.247106017191977,0.0,20.0
48725,4,8725,[294 187 196 603 318],452,3,37059,4.24696309878524,40.0,0.0
48726,4,8726,[313 127 187 302 603],537,5,37064,4.247049386960009,20.0,20.0
48727,4,8727,[ 25 194 183 132 143],378,5,37069,4.247135655362053,0.0,0.0
48728,4,8728,[313 127 187 302 603],474,5,37074,4.247221903998167,20.0,20.0
48729,4,8729,[176 197 187 185 210],326,1,37075,4.246849942726231,0.0,0.0
48730,4,8730,[313 127 187 302 603],669,5,37080,4.246936204329401,20.0,20.0
48731,4,8731,[313 127 187 302 603],271,5,37085,4.247022446174989,20.0,20.0
48732,4,8732,[258 742  56 257 748],92,2,37087,4.246765143707775,0.0,0.0
48733,4,8733,[313 127 187 302 603],669,5,37092,4.246851385390428,20.0,20.0
48734,4,8734,[313 127 187 302 603],537,5,37097,4.246937607326846,20.0,20.0
48735,4,8735,[ 88 228 211  96 172],883,5,37102,4.247023809523809,0.0,0.0
48736,4,8736,[282 234 597  95 117],92,3,37105,4.246881080462401,0.0,0.0
48737,4,8737,[313 127 187 302 603],334,5,37110,4.246967269398032,20.0,20.0
48738,4,8738,[258 111 265 286  12],145,3,37113,4.246824579471335,20.0,0.0
48739,4,8739,[313 127 187 302 603],474,5,37118,4.2469107551487415,20.0,20.0
48740,4,8740,[215 300 258 288 588],537,1,37119,4.246539297563208,0.0,0.0
48741,4,8741,[313 127 187 302 603],271,5,37124,4.2466254861587736,20.0,20.0
48742,4,8742,[313 127 187 302 603],13,5,37129,4.246711655038316,20.0,20.0
48743,4,8743,[ 11 234 186 151 179],378,1,37130,4.246340347666972,0.0,0.0
48744,4,8744,[313 127 187 302 603],13,5,37135,4.246426529445397,20.0,20.0
48745,4,8745,[313 127 187 302 603],271,5,37140,4.246512691516122,20.0,20.0
48746,4,8746,[313 127 187 302 603],116,3,37143,4.246370184063108,20.0,20.0
48747,4,8747,[546 403  22 228  69],7,5,37148,4.246456332876086,0.0,0.0
48748,4,8748,[ 56 176   7  28  22],455,4,37152,4.246428163218654,0.0,0.0
48749,4,8749,[475 151 187 288  71],648,1,37153,4.2460571428571425,0.0,0.0
48750,4,8750,[ 96 153 200 403 475],308,5,37158,4.2461432979088105,0.0,0.0
48751,4,8751,[313 127 187 302 603],334,5,37163,4.246229433272394,20.0,20.0
48752,4,8752,[210 204 181   9 202],207,1,37164,4.2458585627784755,0.0,0.0
48753,4,8753,[313 127 187 302 603],271,5,37169,4.245944710989262,20.0,20.0
48754,4,8754,[ 71 200 121 186 588],313,3,37172,4.245802398629355,0.0,0.0
48755,4,8755,[313 127 187 302 603],90,5,37177,4.245888533576975,20.0,20.0
48756,4,8756,[313 127 187 302 603],669,5,37182,4.245974648852346,20.0,20.0
48757,4,8757,[357  15 238 471 588],95,4,37186,4.24594656314227,20.0,0.0
48758,4,8758,[597 302 286 268 121],486,1,37187,4.245575978993036,0.0,0.0
48759,4,8759,[313 127 187 302 603],474,5,37192,4.245662100456621,20.0,20.0
48760,4,8760,[423 100 151  50 357],650,3,37195,4.2455199178176,20.0,40.0
48761,4,8761,[313 127 187 302 603],271,5,37200,4.2456060260214565,20.0,20.0
48762,4,8762,[588 515 187 275 265],452,2,37202,4.245349766061851,0.0,0.0
48763,4,8763,[313 127 187 302 603],474,5,37207,4.2454358740301235,20.0,20.0
48764,4,8764,[313 127 187 302 603],474,5,37212,4.2455219623502565,20.0,20.0
48765,4,8765,[313 127 187 302 603],90,5,37217,4.245608031028976,20.0,20.0
48766,4,8766,[313 127 187 302 603],669,5,37222,4.245694080073001,20.0,20.0
48767,4,8767,[385 265 294 275 161],308,2,37224,4.24543795620438,0.0,0.0
48768,4,8768,[313 127 187 302 603],271,5,37229,4.245524005017676,20.0,20.0
48769,4,8769,[313 127 187 302 603],669,5,37234,4.245610034207526,20.0,20.0
48770,4,8770,[313 127 187 302 603],334,5,37239,4.245696043780641,20.0,20.0
48771,4,8771,[313 127 187 302 603],90,5,37244,4.24578203374373,20.0,20.0
48772,4,8772,[313 127 187 302 603],271,5,37249,4.2458680041034995,20.0,20.0
48773,4,8773,[22  8 11 95 56],64,5,37254,4.245953954866652,0.0,0.0
48774,4,8774,[  9 210 143 202 172],379,5,37259,4.2460398860398865,0.0,0.0
48775,4,8775,[313 127 187 302 603],116,3,37262,4.245897903372835,20.0,20.0
48776,4,8776,[313 127 187 302 603],474,5,37267,4.245983821351259,20.0,20.0
48777,4,8777,[313 127 187 302 603],271,5,37272,4.2460697197539305,20.0,20.0
48778,4,8778,[313 127 187 302 603],334,5,37277,4.2461555985875385,20.0,20.0
48779,4,8779,[313 127 187 302 603],474,5,37282,4.24624145785877,20.0,20.0
48780,4,8780,[313 127 187 302 603],537,5,37287,4.246327297574308,20.0,20.0
48781,4,8781,[313 127 187 302 603],537,5,37292,4.2464131177408335,20.0,20.0
48782,4,8782,[313 127 187 302 603],334,5,37297,4.246498918365023,20.0,20.0
48783,4,8783,[313 127 187 302 603],116,3,37300,4.2463570127504555,20.0,20.0
48784,4,8784,[313 127 187 302 603],13,5,37305,4.246442800227661,20.0,20.0
48785,4,8785,[197 222 151 237 183],406,2,37307,4.24618711586615,0.0,0.0
48786,4,8786,[ 71 173 471 288 597],92,2,37309,4.245931489700694,0.0,0.0
48787,4,8787,[313 127 187 302 603],116,3,37312,4.245789713245334,20.0,20.0
48788,4,8788,[211 117 153 174 333],13,3,37315,4.245647969052224,0.0,20.0
48789,4,8789,[313 127 187 302 603],537,5,37320,4.2457337883959045,20.0,20.0
48790,4,8790,[313 127 187 302 603],669,5,37325,4.2458195882152205,20.0,20.0
48791,4,8791,[313 127 187 302 603],116,3,37328,4.245677888989991,20.0,20.0
48792,4,8792,[181 328 117 200 204],95,4,37332,4.245649948822927,0.0,0.0
48793,4,8793,[144 121 265 318 175],64,3,37335,4.245508301114397,20.0,0.0
48794,4,8794,[313 127 187 302 603],474,5,37340,4.245594087549744,20.0,20.0
48795,4,8795,[313 127 187 302 603],90,5,37345,4.245679854479309,20.0,20.0
48796,4,8796,[588  98  71  89 173],59,3,37348,4.245538251676708,0.0,20.0
48797,4,8797,[313 127 187 302 603],537,5,37353,4.245624005455785,20.0,20.0
48798,4,8798,[313 127 187 302 603],669,5,37358,4.245709739743153,20.0,20.0
48799,4,8799,[313 127 187 302 603],537,5,37363,4.245795454545455,20.0,20.0
48800,4,8800,[385 191  50 515 475],64,5,37368,4.245881149869333,0.0,20.0
48801,4,8801,[318 175 185  28 181],334,4,37372,4.245853215178369,20.0,0.0
48802,4,8802,[ 98 357 197  22 234],339,5,37377,4.245938884471203,20.0,20.0
48803,4,8803,[ 12 185  28  22  79],6,2,37379,4.245683780099955,20.0,0.0
48804,4,8804,[294 273 515 111 245],825,4,37383,4.245655877342419,0.0,0.0
48805,4,8805,[ 71  89  96 151 318],374,2,37385,4.245400863047922,20.0,0.0
48806,4,8806,[313 127 187 302 603],537,5,37390,4.245486544793914,20.0,20.0
48807,4,8807,[135 508  22  11 174],537,2,37392,4.245231607629428,0.0,20.0
48808,4,8808,[313 127 187 302 603],13,5,37397,4.245317289136111,20.0,20.0
48809,4,8809,[597 483 135  98 118],200,5,37402,4.245402951191828,20.0,20.0
48810,4,8810,[313 127 187 302 603],271,5,37407,4.2454885938032,20.0,20.0
48811,4,8811,[313 127 187 302 603],334,5,37412,4.245574216976849,20.0,20.0
48812,4,8812,[313 127 187 302 603],271,5,37417,4.245659820719392,20.0,20.0
48813,4,8813,[186 182 286  50 191],13,3,37420,4.245518493306104,0.0,20.0
48814,4,8814,[313 127 187 302 603],669,5,37425,4.245604083947816,20.0,20.0
48815,4,8815,[313 127 187 302 603],669,5,37430,4.245689655172414,20.0,20.0
48816,4,8816,[313 127 187 302 603],116,3,37433,4.245548372462289,20.0,20.0
48817,4,8817,[603 211  69 151 197],666,3,37436,4.245407121796326,20.0,0.0
48818,4,8818,[313 127 187 302 603],13,5,37441,4.245492686245606,20.0,20.0
48819,4,8819,[313 127 187 302 603],669,5,37446,4.245578231292517,20.0,20.0
48820,4,8820,[117 294  28 204 196],200,5,37451,4.2456637569436575,0.0,0.0
48821,4,8821,[313 127 187 302 603],90,5,37456,4.245749263205623,20.0,20.0
48822,4,8822,[183 204 174 515 222],883,4,37460,4.245721409951264,0.0,20.0
48823,4,8823,[ 69 496 294 180  28],194,4,37464,4.245693563009973,0.0,0.0
48824,4,8824,[ 98 276 655 210 173],664,4,37468,4.245665722379603,0.0,20.0
48825,4,8825,[313 127 187 302 603],537,5,37473,4.245751189666893,20.0,20.0
48826,4,8826,[313 127 187 302 603],90,5,37478,4.245836637589215,20.0,20.0
48827,4,8827,[195 234 655 257  25],339,4,37482,4.245808790212958,0.0,0.0
48828,4,8828,[313 127 187 302 603],271,5,37487,4.2458942122550685,20.0,20.0
48829,4,8829,[111 603 423 197 143],524,3,37490,4.245753114382786,20.0,0.0
48830,4,8830,[176  96 127  22 194],313,4,37494,4.245725285924584,0.0,20.0
48831,4,8831,[313 127 187 302 603],271,5,37499,4.245810688405797,20.0,20.0
48832,4,8832,[313 127 187 302 603],90,5,37504,4.24589607154987,20.0,20.0
48833,4,8833,[143 191  95 204 125],749,4,37508,4.24586823635952,0.0,0.0
48834,4,8834,[313 127 187 302 603],474,5,37513,4.245953593661573,20.0,20.0
48835,4,8835,[313 127 187 302 603],669,5,37518,4.246038931643278,20.0,20.0
48836,4,8836,[153 603 200 215  96],804,4,37522,4.246011089736336,20.0,0.0
48837,4,8837,[121 235  89  98 678],537,1,37523,4.245643810816927,0.0,20.0
48838,4,8838,[ 98 197 100 508 211],774,1,37524,4.245276615001697,0.0,40.0
48839,4,8839,[313 127 187 302 603],13,5,37529,4.245361990950226,20.0,20.0
48840,4,8840,[313 127 187 302 603],116,3,37532,4.24522112883158,20.0,20.0
48841,4,8841,[357   8 748  79 185],207,3,37535,4.245080298574983,20.0,0.0
48842,4,8842,[313 127 187 302 603],116,3,37538,4.244939500169625,20.0,20.0
48843,4,8843,[174 183 121 210 403],158,4,37542,4.244911804613297,0.0,20.0
48844,4,8844,[313 127 187 302 603],271,5,37547,4.244997173544375,20.0,20.0
48845,4,8845,[313 127 187 302 603],90,5,37552,4.245082523174316,20.0,20.0
48846,4,8846,[313 127 187 302 603],116,3,37555,4.244941788176783,20.0,20.0
48847,4,8847,[313 127 187 302 603],116,3,37558,4.244801084990958,20.0,20.0
48848,4,8848,[313 127 187 302 100],207,4,37562,4.2447734207255055,0.0,40.0
48849,4,8849,[313 127 187 302 603],334,5,37567,4.244858757062147,20.0,20.0
48850,4,8850,[111 423  88 427  50],87,4,37571,4.244831092531918,0.0,20.0
48851,4,8851,[313 127 187 302 603],116,3,37574,4.244690465431541,20.0,20.0
48852,4,8852,[742  22 748 238 318],648,2,37576,4.244436914040438,20.0,0.0
48853,4,8853,[135 121 197 118 282],881,4,37580,4.244409306528123,0.0,0.0
48854,4,8854,[  4 288 678 176 655],339,3,37583,4.244268774703557,0.0,0.0
48855,4,8855,[313 127 187 302 100],207,4,37587,4.244241192411924,0.0,40.0
48856,4,8856,[ 22   4 100 200  25],455,3,37590,4.244100711301795,0.0,20.0
48857,4,8857,[313 127 187 302 100],328,5,37595,4.244186046511628,0.0,40.0
48858,4,8858,[313 127 187 302 100],207,4,37599,4.244158482898747,0.0,40.0
48859,4,8859,[475  12 275 678 508],13,1,37600,4.243792325056433,20.0,0.0
48860,4,8860,[313 127 187 302 100],328,5,37605,4.2438776661776325,0.0,40.0
48861,4,8861,[313 127 187 302 100],537,5,37610,4.243962988038818,0.0,40.0
48862,4,8862,[313 127 187 302 100],334,5,37615,4.244048290646508,0.0,40.0
48863,4,8863,[127 182 483  50 742],488,3,37618,4.243907942238267,20.0,40.0
48864,4,8864,[174 197 117 121 546],194,2,37620,4.243654822335025,0.0,20.0
48865,4,8865,[423 323 117 300 435],788,3,37623,4.243514549966163,0.0,0.0
48866,4,8866,[313 127 187 302 100],474,5,37628,4.243599864666741,0.0,40.0
48867,4,8867,[313 127 187 302 100],90,5,37633,4.243685160126296,0.0,40.0
48868,4,8868,[313 127 187 302 100],537,5,37638,4.243770436351336,0.0,40.0
48869,4,8869,[313 127 187 302 100],271,5,37643,4.243855693348365,0.0,40.0
48870,4,8870,[313 127 187 302 100],207,4,37647,4.243828204261075,0.0,40.0
48871,4,8871,[273 176 313 265  95],378,5,37652,4.243913435527502,0.0,0.0
48872,4,8872,[405 173 182 265 273],64,3,37655,4.243773244674856,0.0,0.0
48873,4,8873,[313 127 187 302 100],537,5,37660,4.2438584629254,0.0,40.0
48874,4,8874,[313 127 187 302 100],13,5,37665,4.243943661971831,0.0,40.0
48875,4,8875,[313 127 187 302 100],207,4,37669,4.243916178458766,0.0,40.0
48876,4,8876,[313 127 187 302 100],13,5,37674,4.244001351808043,0.0,40.0
48877,4,8877,[313 127 187 302 100],474,5,37679,4.244086505969813,0.0,40.0
48878,4,8878,[313 127 187 302 100],144,4,37683,4.2440590156549165,0.0,40.0
48879,4,8879,[313 127 187 302 100],13,5,37688,4.244144144144144,0.0,40.0
48880,4,8880,[313 127 187 302 100],90,5,37693,4.244229253462448,0.0,40.0
48881,4,8881,[ 64 161 176 153 597],653,3,37696,4.244089169106057,0.0,0.0
48882,4,8882,[313 127 187 302 100],90,5,37701,4.244174265450861,0.0,40.0
48883,4,8883,[313 127 187 302 100],328,5,37706,4.244259342638451,0.0,40.0
48884,4,8884,[313 127 187 302 100],537,5,37711,4.2443444006752955,0.0,40.0
48885,4,8885,[121 186 286 288   4],474,4,37715,4.244316902993473,0.0,0.0
48886,4,8886,[313 127 187 302 100],474,5,37720,4.2444019354112745,0.0,40.0
48887,4,8887,[313 127 187 302 100],144,4,37724,4.244374437443744,0.0,40.0
48888,4,8888,[273 403  79 234 174],833,0,37724,4.243896951288109,0.0,20.0
48889,4,8889,[313   7 276 405 204],13,3,37727,4.243757030371204,0.0,0.0
48890,4,8890,[313 127 187 302 100],90,5,37732,4.243842087504218,0.0,40.0
48891,4,8891,[313 127 187 302 100],271,5,37737,4.243927125506073,0.0,40.0
48892,4,8892,[313 127 187 302 100],474,5,37742,4.244012144383222,0.0,40.0
48893,4,8893,[313 127 187 302 100],271,5,37747,4.244097144142119,0.0,40.0
48894,4,8894,[ 15 121 151 197 273],378,3,37750,4.2439572793704325,0.0,0.0
48895,4,8895,[313 127 187 302 100],144,4,37754,4.243929856115108,0.0,40.0
48896,4,8896,[313 127 187 302 100],90,5,37759,4.244014836461728,0.0,40.0
48897,4,8897,[ 22  50 276  89 135],378,4,37763,4.243987412901776,0.0,20.0
48898,4,8898,[313 127 187 302 100],334,5,37768,4.244072367681762,0.0,40.0
48899,4,8899,[313 127 187 302 100],13,5,37773,4.244157303370787,0.0,40.0
48900,4,8900,[678  82 603 385 127],308,4,37777,4.244129873047972,20.0,20.0
48901,4,8901,[508  12 286 228 186],60,5,37782,4.244214783194788,20.0,0.0
48902,4,8902,[313 127 187 302 100],207,4,37786,4.244187352577783,0.0,40.0
48903,4,8903,[313 127 187 302 100],474,5,37791,4.244272237196766,0.0,40.0
48904,4,8904,[313 127 187 302 100],328,5,37796,4.244357102751263,0.0,40.0
48905,4,8905,[313 127 187 302 100],13,5,37801,4.244441949247698,0.0,40.0
48906,4,8906,[322 328 175 185 301],334,2,37803,4.244189962950489,0.0,0.0
48907,4,8907,[313 127 187 302 100],144,4,37807,4.24416255051639,0.0,40.0
48908,4,8908,[313 127 187 302 100],144,4,37811,4.244135144236166,0.0,40.0
48909,4,8909,[357 195 265 200 403],899,4,37815,4.244107744107744,20.0,0.0
48910,4,8910,[313 127 187 302 100],207,4,37819,4.244080350129054,0.0,40.0
48911,4,8911,[313 127 187 302 100],207,4,37823,4.244052962298025,0.0,40.0
48912,4,8912,[313 127 187 302 100],144,4,37827,4.244025580612588,0.0,40.0
48913,4,8913,[313 127 187 302 100],328,5,37832,4.244110388153467,0.0,40.0
48914,4,8914,[173  50 300  89 655],13,3,37835,4.243970835670218,0.0,20.0
48915,4,8915,[313 127 187 302 100],207,4,37839,4.2439434724091525,0.0,40.0
48916,4,8916,[313 127 187 302 100],90,5,37844,4.244028260625771,0.0,40.0
48917,4,8917,[313 127 187 302 100],474,5,37849,4.244113029827315,0.0,40.0
48918,4,8918,[286   7 222 211 275],474,4,37853,4.244085659827335,0.0,0.0
48919,4,8919,[191 196 153 182 496],664,4,37857,4.244058295964126,0.0,0.0
48920,4,8920,[427 276 300 202 204],13,4,37861,4.244030938235624,0.0,0.0
48921,4,8921,[202 187   4 135 186],234,3,37864,4.243891504147053,0.0,0.0
48922,4,8922,[313 127 187 302 100],328,5,37869,4.243976241174493,0.0,40.0
48923,4,8923,[313 127 187 302 100],537,5,37874,4.244060959211116,0.0,40.0
48924,4,8924,[313 127 187 302 100],537,5,37879,4.244145658263306,0.0,40.0
48925,4,8925,[313 127 187 302 100],474,5,37884,4.244230338337442,0.0,40.0
48926,4,8926,[ 89 143   9  50  98],474,5,37889,4.244314999439902,0.0,40.0
48927,4,8927,[313 127 187 302 100],328,5,37894,4.244399641577061,0.0,40.0
48928,4,8928,[313 127 187 302 100],537,5,37899,4.244484264755291,0.0,40.0
48929,4,8929,[313 127 187 302 100],207,4,37903,4.244456886898097,0.0,40.0
48930,4,8930,[313 127 187 302 100],144,4,37907,4.244429515171873,0.0,40.0
48931,4,8931,[313 127 187 302 100],537,5,37912,4.244514106583072,0.0,40.0
48932,4,8932,[313 127 187 302 100],271,5,37917,4.244598679055189,0.0,40.0
48933,4,8933,[174  96 245 234  69],533,3,37920,4.244459368703828,0.0,20.0
48934,4,8934,[313 127 187 302 100],537,5,37925,4.244543928371573,0.0,40.0
48935,4,8935,[174 175  69 405 111],537,1,37926,4.244180841539839,0.0,20.0
48936,4,8936,[258 515   9 168 678],488,4,37930,4.24415351907799,0.0,0.0
48937,4,8937,[313 127 187 302 100],474,5,37935,4.244238084582681,0.0,40.0
48938,4,8938,[ 79 196  11 265 176],334,3,37938,4.244098892493567,0.0,0.0
48939,4,8939,[313 127 187 302 100],537,5,37943,4.244183445190156,0.0,40.0
48940,4,8940,[313 127 187 302 100],90,5,37948,4.244267978973269,0.0,40.0
48941,4,8941,[ 71 153 172 228 427],899,4,37952,4.244240662044286,0.0,0.0
48942,4,8942,[313 127 187 302 100],144,4,37956,4.244213351224421,0.0,40.0
48943,4,8943,[313 127 187 302 100],328,5,37961,4.244297853309481,0.0,40.0
48944,4,8944,[313 127 187 302 100],90,5,37966,4.244382336500839,0.0,40.0
48945,4,8945,[313 127 187 302 100],90,5,37971,4.244466800804829,0.0,40.0
48946,4,8946,[313 127 187 302 100],271,5,37976,4.244551246227786,0.0,40.0
48947,4,8947,[144 313 143 546 132],650,3,37979,4.244412159141707,0.0,0.0
48948,4,8948,[313 127 187 302 100],474,5,37984,4.244496591797966,0.0,40.0
48949,4,8949,[313 127 187 302 100],334,5,37989,4.244581005586592,0.0,40.0
48950,4,8950,[222 127 202 328 276],13,3,37992,4.244441961791979,0.0,20.0
48951,4,8951,[313 127 187 302 100],474,5,37997,4.24452636282395,0.0,40.0
48952,4,8952,[  9 127 237 228  69],326,1,37998,4.244163967385234,0.0,20.0
48953,4,8953,[588 237 143 216 483],406,2,38000,4.243913334822426,20.0,0.0
48954,4,8954,[204 323 385 222  71],455,1,38001,4.243551088777219,0.0,0.0
48955,4,8955,[313 127 187 302 100],207,4,38005,4.243523894595802,0.0,40.0
48956,4,8956,[313 127 187 302 100],334,5,38010,4.243608351010383,0.0,40.0
48957,4,8957,[357 423 265 135 568],207,3,38013,4.243469524447422,20.0,0.0
48958,4,8958,[313 127 187 302 100],271,5,38018,4.243553968076794,0.0,40.0
48959,4,8959,[313 127 187 302 100],334,5,38023,4.243638392857143,0.0,40.0
48960,4,8960,[313 127 187 302 100],144,4,38027,4.243611204106685,0.0,40.0
48961,4,8961,[ 95  15 435  82 202],749,4,38031,4.243584021423789,0.0,0.0
48962,4,8962,[313 127 187 302 100],334,5,38036,4.243668414593328,0.0,40.0
48963,4,8963,[ 50 204 318  28 234],234,4,38040,4.243641231593039,20.0,20.0
48964,4,8964,[204 313 180 403 183],234,2,38042,4.243390964863358,0.0,0.0
48965,4,8965,[483 496 546 195 175],60,5,38047,4.243475351327236,20.0,0.0
48966,4,8966,[313 127 187 302 100],271,5,38052,4.243559718969555,0.0,40.0
48967,4,8967,[ 89 385   7 323 200],537,2,38054,4.243309545049064,0.0,0.0
48968,4,8968,[313 127 187 302 100],207,4,38058,4.243282417214851,0.0,40.0
48969,4,8969,[282   4  28 405 143],474,5,38063,4.243366778149387,0.0,0.0
48970,4,8970,[313 127 187 302 100],334,5,38068,4.243451120276446,0.0,40.0
48971,4,8971,[313 127 187 302 100],328,5,38073,4.243535443602318,0.0,40.0
48972,4,8972,[168 135 216  64 318],271,4,38077,4.243508302685835,20.0,0.0
48973,4,8973,[313 127 187 302 100],207,4,38081,4.243481167818142,0.0,40.0
48974,4,8974,[ 97 302 174 269 181],666,3,38084,4.243342618384401,0.0,20.0
48975,4,8975,[313 127 187 302 100],334,5,38089,4.243426916221034,0.0,40.0
48976,4,8976,[ 22 318 196 216 144],144,5,38094,4.2435111952768185,20.0,0.0
48977,4,8977,[ 15 179 135   9 143],60,4,38098,4.2434840721764315,0.0,0.0
48978,4,8978,[313 127 187 302 100],207,4,38102,4.243456955117496,0.0,40.0
48979,4,8979,[423 194 125 127  12],194,3,38105,4.243318485523385,20.0,20.0
48980,4,8980,[ 50 121 508 117 197],213,5,38110,4.243402739115911,0.0,20.0
48981,4,8981,[313 127 187 302 318],474,5,38115,4.2434869739478955,20.0,20.0
48982,4,8982,[313 127 187 302 318],13,4,38119,4.243459868640766,20.0,20.0
48983,4,8983,[313 127 187 302 100],474,5,38124,4.2435440783615315,0.0,40.0
48984,4,8984,[313 127 187 302 100],328,5,38129,4.243628269337785,0.0,40.0
48985,4,8985,[ 79 269 117 194 276],537,1,38130,4.243267304696194,0.0,0.0
48986,4,8986,[313 127 187 302 100],13,5,38135,4.243351507733393,0.0,40.0
48987,4,8987,[313 127 187 302 100],474,5,38140,4.243435692033823,0.0,40.0
48988,4,8988,[313 127 187 302 100],90,5,38145,4.243519857603738,0.0,40.0
48989,4,8989,[313 127 187 302 100],328,5,38150,4.243604004449388,0.0,40.0
48990,4,8990,[313 127 187 302 100],334,5,38155,4.243688132577021,0.0,40.0
48991,4,8991,[313 127 187 302 100],207,4,38159,4.24366103202847,0.0,40.0
48992,4,8992,[313 127 187 302 100],474,5,38164,4.2437451351050814,0.0,40.0
48993,4,8993,[313 127 187 302 100],474,5,38169,4.243829219479653,0.0,40.0
48994,4,8994,[313 127 187 302 100],334,5,38174,4.243913285158421,0.0,40.0
48995,4,8995,[313 127 187 302 100],90,5,38179,4.243997332147621,0.0,40.0
48996,4,8996,[313 127 187 302 100],334,5,38184,4.244081360453484,0.0,40.0
48997,4,8997,[313 127 187 302 100],144,4,38188,4.244054234274283,0.0,40.0
48998,4,8998,[313 127 187 302 100],207,4,38192,4.244027114123791,0.0,40.0
48999,4,8999,[313 127 187 302 100],13,5,38197,4.244111111111111,0.0,40.0
49000,4,9000,[313 127 187 302 100],537,5,38202,4.244195089434507,0.0,40.0
49001,4,9001,[216  97 435  64  79],82,4,38206,4.244167962674961,0.0,0.0
49002,4,9002,[313 127 187 302 100],144,4,38210,4.244140841941575,0.0,40.0
49003,4,9003,[313 127 187 302 100],90,5,38215,4.244224788982675,0.0,40.0
49004,4,9004,[313 127 187 302 100],271,5,38220,4.2443087173792335,0.0,40.0
49005,4,9005,[313 127 187 302 100],207,4,38224,4.244281590051077,0.0,40.0
49006,4,9006,[313 127 187 302 100],328,5,38229,4.244365493505051,0.0,40.0
49007,4,9007,[313 127 187 302 100],474,5,38234,4.244449378330373,0.0,40.0
49008,4,9008,[496 294  82 328 117],749,4,38238,4.244422244422244,0.0,0.0
49009,4,9009,[127 132 176  25 135],848,4,38242,4.244395116537181,0.0,20.0
49010,4,9010,[313 127 187 302 100],13,5,38247,4.244478970147598,0.0,40.0
49011,4,9011,[313 127 187 302 100],474,5,38252,4.244562805148691,0.0,40.0
49012,4,9012,[100 234 172 182 204],788,1,38253,4.2442028181515585,0.0,20.0
49013,4,9013,[313 127 187 302 100],328,5,38258,4.244286665187486,0.0,40.0
49014,4,9014,[151 603 143   7 125],64,2,38260,4.244037714919578,20.0,0.0
49015,4,9015,[313 127 187 302 100],474,5,38265,4.244121561668146,0.0,40.0
49016,4,9016,[313 127 187 302 100],334,5,38270,4.24420538981923,0.0,40.0
49017,4,9017,[313 127 187 302 100],474,5,38275,4.24428919937902,0.0,40.0
49018,4,9018,[471 210  71 127 313],308,3,38278,4.244151236278967,0.0,20.0
49019,4,9019,[313 127 187 302 100],328,5,38283,4.244235033259423,0.0,40.0
49020,4,9020,[313 127 187 302 100],90,5,38288,4.244318811661678,0.0,40.0
49021,4,9021,[313 127 187 302 100],207,4,38292,4.244291731323432,0.0,40.0
49022,4,9022,[313 127 187 302 100],334,5,38297,4.244375484871994,0.0,40.0
49023,4,9023,[125 174 183 258  79],334,4,38301,4.2443484042553195,0.0,20.0
49024,4,9024,[289  98  69 151   1],533,3,38304,4.24421052631579,0.0,20.0
49025,4,9025,[313 127 187 302 100],90,5,38309,4.244294261023709,0.0,40.0
49026,4,9026,[313 127 187 302 100],13,5,38314,4.244377977179572,0.0,40.0
49027,4,9027,[313 127 187 302 100],334,5,38319,4.244461674789544,0.0,40.0
49028,4,9028,[257 323 301 237 197],455,2,38321,4.244213091150736,0.0,0.0
49029,4,9029,[179  56  50 151 180],215,4,38325,4.244186046511628,0.0,20.0
49030,4,9030,[435 546   4  64   8],881,3,38328,4.244048278153029,0.0,0.0
49031,4,9031,[313 127 187 302 100],90,5,38333,4.244131975199291,0.0,40.0
49032,4,9032,[195 196 204 161 168],374,2,38335,4.243883538137939,0.0,0.0
49033,4,9033,[100 318  95 211 300],13,3,38338,4.243745849014833,20.0,20.0
49034,4,9034,[313 127 187 302 100],13,5,38343,4.243829551743221,0.0,40.0
49035,4,9035,[313 127 187 302 100],537,5,38348,4.243913235945109,0.0,40.0
49036,4,9036,[181 204   1  12 515],194,4,38352,4.243886245435432,20.0,0.0
49037,4,9037,[185 294 197   1 151],95,3,38355,4.243748616950652,0.0,0.0
49038,4,9038,[ 71 195 333 471 161],328,2,38357,4.2435003872109744,0.0,0.0
49039,4,9039,[403 100  98 357 183],59,5,38362,4.2435840707964605,20.0,40.0
49040,4,9040,[568 132 234  12  28],795,3,38365,4.2434465214024994,20.0,0.0
49041,4,9041,[313 127 187 302 100],271,5,38370,4.243530192435302,0.0,40.0
49042,4,9042,[313 127 187 302 100],13,5,38375,4.243613844962955,0.0,40.0
49043,4,9043,[289 748 678 282 117],825,4,38379,4.24358690844759,0.0,0.0
49044,4,9044,[313 127 187 302 100],328,5,38384,4.2436705362078495,0.0,40.0
49045,4,9045,[313 127 187 302 100],207,4,38388,4.243643599380942,0.0,40.0
49046,4,9046,[313 127 187 302 100],207,4,38392,4.243616668508898,0.0,40.0
49047,4,9047,[313 127 187 302 100],334,5,38397,4.24370026525199,0.0,40.0
49048,4,9048,[313 127 187 302 100],537,5,38402,4.243783843518621,0.0,40.0
49049,4,9049,[ 98 276 235 175 318],385,3,38405,4.243646408839779,20.0,20.0
49050,4,9050,[186 294  82 132 271],92,1,38406,4.2432880344713295,0.0,0.0
49051,4,9051,[ 97 269 216 186 210],524,3,38409,4.243150684931507,0.0,0.0
49052,4,9052,[121 258  25 176 257],825,5,38414,4.243234286976693,0.0,0.0
49053,4,9053,[313 127 187 302 100],13,5,38419,4.243317870554451,0.0,40.0
49054,4,9054,[483 318 215 185 294],766,2,38421,4.243070127001657,40.0,0.0
49055,4,9055,[313 127 187 302 100],13,5,38426,4.24315371024735,0.0,40.0
49056,4,9056,[313 127 187 302 100],271,5,38431,4.2432372750358835,0.0,40.0
49057,4,9057,[ 82   1 483 202 300],125,5,38436,4.243320821373372,20.0,0.0
49058,4,9058,[  1 475  64  95  89],374,3,38439,4.243183574345954,0.0,0.0
49059,4,9059,[  7 289 172  64 265],13,3,38442,4.243046357615894,0.0,0.0
49060,4,9060,[ 70 172  95 269 300],125,3,38445,4.24290917117316,0.0,0.0
49061,4,9061,[ 82 135 313 515 597],328,3,38448,4.242772015007724,0.0,0.0
49062,4,9062,[313 127 187 302 100],13,5,38453,4.242855566589429,0.0,40.0
49063,4,9063,[313 127 187 302 100],537,5,38458,4.242939099735216,0.0,40.0
49064,4,9064,[313 127 187 302 100],334,5,38463,4.243022614451186,0.0,40.0
49065,4,9065,[211 357 173 318 288],804,4,38467,4.242995808515332,40.0,0.0
49066,4,9066,[313 127 187 302 100],144,4,38471,4.242969008492335,0.0,40.0
49067,4,9067,[ 64 300 423 194  22],313,4,38475,4.242942214380238,0.0,0.0
49068,4,9068,[172 180 185  98  95],13,4,38479,4.2429154261770865,0.0,20.0
49069,4,9069,[313 127 187 302 100],328,5,38484,4.242998897464168,0.0,40.0
49070,4,9070,[313 127 187 302 100],271,5,38489,4.243082350347261,0.0,40.0
49071,4,9071,[313 127 187 302 100],328,5,38494,4.243165784832452,0.0,40.0
49072,4,9072,[313 127 187 302 100],144,4,38498,4.243138983798082,0.0,40.0
49073,4,9073,[313 127 187 302 100],328,5,38503,4.243222393652193,0.0,40.0
49074,4,9074,[176  50  56 179  64],659,3,38506,4.243085399449035,0.0,20.0
49075,4,9075,[313 127 187 302 100],90,5,38511,4.243168796826796,0.0,40.0
49076,4,9076,[ 50 568   9 588 322],13,2,38513,4.242921670155337,0.0,20.0
49077,4,9077,[228 153 183  82 211],650,4,38517,4.242894910773298,0.0,0.0
49078,4,9078,[ 22 237 179  11  69],343,5,38522,4.2429783015750635,0.0,0.0
49079,4,9079,[275 125 100 742 200],334,3,38525,4.24284140969163,0.0,20.0
49080,4,9080,[313 127 187 302 100],13,5,38530,4.24292478801894,0.0,40.0
49081,4,9081,[186 588 121  82 168],313,2,38532,4.2426778242677825,0.0,0.0
49082,4,9082,[423 121 237 161 185],7,4,38536,4.242651106462622,0.0,0.0
49083,4,9083,[313 127 187 302 100],207,4,38540,4.24262439453985,0.0,40.0
49084,4,9084,[  7 174 216 423 151],666,1,38541,4.242267473858008,0.0,20.0
49085,4,9085,[313 127 187 302 100],90,5,38546,4.242350869469513,0.0,40.0
49086,4,9086,[313 127 187 302 100],144,4,38550,4.242324199405744,0.0,40.0
49087,4,9087,[161 125 288 174 228],455,3,38553,4.2421875,0.0,20.0
49088,4,9088,[ 56 228 496 168  25],59,5,38558,4.242270876884145,0.0,0.0
49089,4,9089,[322   7 127  88  70],374,3,38561,4.242134213421342,0.0,20.0
49090,4,9090,[313 127 187 302 100],271,5,38566,4.2422175778242215,0.0,40.0
49091,4,9091,[313 127 187 302 100],334,5,38571,4.242300923889133,0.0,40.0
49092,4,9092,[313 127 187 302 100],207,4,38575,4.2422742769163095,0.0,40.0
49093,4,9093,[210  22 597 100  98],378,4,38579,4.242247635803826,0.0,40.0
49094,4,9094,[ 97 427 132 181 301],13,4,38583,4.242221000549753,0.0,0.0
49095,4,9095,[258 294 742   1  15],749,4,38587,4.242194371152155,0.0,0.0
49096,4,9096,[ 50 216  95 200   9],60,5,38592,4.242277673958448,0.0,20.0
49097,4,9097,[313 127 187 302 100],271,5,38597,4.242360958452407,0.0,40.0
49098,4,9098,[313 127 187 302 100],271,5,38602,4.24244422464007,0.0,40.0
49099,4,9099,[313 127 187 302 100],13,5,38607,4.242527472527472,0.0,40.0
49100,4,9100,[313 127 187 302 100],207,4,38611,4.2425008240852655,0.0,40.0
49101,4,9101,[269  56  28 100   8],207,3,38614,4.242364315535047,0.0,20.0
49102,4,9102,[313 127 187 302 100],537,5,38619,4.242447544765462,0.0,40.0
49103,4,9103,[313 127 187 302 100],90,5,38624,4.242530755711775,0.0,40.0
49104,4,9104,[313 127 187 302 100],13,5,38629,4.242613948380011,0.0,40.0
49105,4,9105,[313 127 187 302 100],144,4,38633,4.242587305073578,0.0,40.0
49106,4,9106,[313 127 187 302 100],13,5,38638,4.242670473262326,0.0,40.0
49107,4,9107,[111 151 222 185 118],374,3,38641,4.242534036012297,0.0,0.0
49108,4,9108,[313 127 187 302 100],90,5,38646,4.242617191788341,0.0,40.0
49109,4,9109,[313 127 187 302 100],144,4,38650,4.242590559824369,0.0,40.0
49110,4,9110,[313 127 187 302 100],334,5,38655,4.242673691142575,0.0,40.0
49111,4,9111,[313 127 187 302 100],13,5,38660,4.242756804214223,0.0,40.0
49112,4,9112,[313 127 187 302 100],334,5,38665,4.24283989904532,0.0,40.0
49113,4,9113,[313 127 187 302 100],334,5,38670,4.24292297564187,0.0,40.0
49114,4,9114,[313 127 187 302 100],90,5,38675,4.243006034009873,0.0,40.0
49115,4,9115,[ 25 322  88 211 333],533,5,38680,4.243089074155331,0.0,0.0
49116,4,9116,[265 127 174  89 211],95,2,38682,4.24284304047384,0.0,40.0
49117,4,9117,[313 127 187 302 100],271,5,38687,4.242926080280763,0.0,40.0
49118,4,9118,[313 127 187 302 100],90,5,38692,4.243009101875206,0.0,40.0
49119,4,9119,[313 127 187 302 100],90,5,38697,4.243092105263158,0.0,40.0
49120,4,9120,[ 70 258 271 385 302],328,3,38700,4.242955816248219,0.0,0.0
49121,4,9121,[313 127 187 302 100],271,5,38705,4.243038807279105,0.0,40.0
49122,4,9122,[238 216 125 118   1],313,4,38709,4.2430121670503125,0.0,0.0
49123,4,9123,[313 127 187 302 100],144,4,38713,4.2429855326611134,0.0,40.0
49124,4,9124,[313 127 187 302 100],271,5,38718,4.243068493150685,0.0,40.0
49125,4,9125,[313 127 187 302 100],334,5,38723,4.2431514354591275,0.0,40.0
49126,4,9126,[313 127 187 302 100],13,5,38728,4.243234359592418,0.0,40.0
49127,4,9127,[313 127 187 302 100],144,4,38732,4.2432077125328655,0.0,40.0
49128,4,9128,[313 127 187 302 100],90,5,38737,4.243290612334319,0.0,40.0
49129,4,9129,[313 127 187 302 100],474,5,38742,4.243373493975904,0.0,40.0
49130,4,9130,[313 127 187 302 100],537,5,38747,4.243456357463586,0.0,40.0
49131,4,9131,[313 127 187 302 100],13,5,38752,4.243539202803329,0.0,40.0
49132,4,9132,[313 127 187 302 100],207,4,38756,4.2435125369539035,0.0,40.0
49133,4,9133,[313 127 187 302 100],537,5,38761,4.243595358003065,0.0,40.0
49134,4,9134,[282 204 228 215 435],881,2,38763,4.243349753694582,0.0,0.0
49135,4,9135,[173 211  22  56 265],13,4,38767,4.2433231173380035,0.0,0.0
49136,4,9136,[313 127 187 302 100],207,4,38771,4.243296486811864,0.0,40.0
49137,4,9137,[ 70  69 288 111 161],648,2,38773,4.243050995841541,0.0,0.0
49138,4,9138,[313 127 187 302 100],328,5,38778,4.243133822081191,0.0,40.0
49139,4,9139,[313 127 187 302 100],271,5,38783,4.243216630196937,0.0,40.0
49140,4,9140,[313 127 187 302 100],474,5,38788,4.243299420194727,0.0,40.0
49141,4,9141,[313 127 187 302 100],271,5,38793,4.2433821920805075,0.0,40.0
49142,4,9142,[313 127 187 302 100],474,5,38798,4.243464945860221,0.0,40.0
49143,4,9143,[237 300 269 121 282],666,1,38799,4.243110236220472,0.0,0.0
49144,4,9144,[181 153  97 508 161],387,3,38802,4.242974302897759,0.0,0.0
49145,4,9145,[313 127 187 302 100],13,5,38807,4.243057074130768,0.0,40.0
49146,4,9146,[313 127 187 302 100],207,4,38811,4.2430305018038705,0.0,40.0
49147,4,9147,[313 127 187 302 100],271,5,38816,4.243113248797552,0.0,40.0
49148,4,9148,[313 127 187 302 100],328,5,38821,4.243195977702481,0.0,40.0
49149,4,9149,[313 127 187 302 100],537,5,38826,4.24327868852459,0.0,40.0
49150,4,9150,[313 127 187 302 100],537,5,38831,4.243361381269807,0.0,40.0
49151,4,9151,[313 127 187 302 100],334,5,38836,4.243444055944056,0.0,40.0
49152,4,9152,[313 127 187 302 100],13,5,38841,4.243526712553261,0.0,40.0
49153,4,9153,[655  97 228 195  69],890,4,38845,4.243500109241862,0.0,0.0
49154,4,9154,[313 127 187 302 100],537,5,38850,4.243582741671218,0.0,40.0
49155,4,9155,[496 180   9  82 174],59,5,38855,4.243665356050677,0.0,20.0
49156,4,9156,[313 127 187 302 100],207,4,38859,4.2436387463142955,0.0,40.0
49157,4,9157,[173 423 234 204 175],13,4,38863,4.243612142389168,0.0,0.0
49158,4,9158,[313 127 187 302 100],474,5,38868,4.243694726498526,0.0,40.0
49159,4,9159,[313 127 187 302 100],537,5,38873,4.243777292576419,0.0,40.0
49160,4,9160,[313 127 187 302 100],13,5,38878,4.243859840628752,0.0,40.0
49161,4,9161,[313 127 187 302 100],328,5,38883,4.243942370661427,0.0,40.0
49162,4,9162,[546 245   7  89 313],92,4,38887,4.243915748117429,0.0,0.0
49163,4,9163,[313 127 187 302 100],13,5,38892,4.243998254037538,0.0,40.0
49164,4,9164,[313 127 187 302 100],90,5,38897,4.244080741953082,0.0,40.0
49165,4,9165,[322 210 174 183 546],102,2,38899,4.2438359153392975,0.0,20.0
49166,4,9166,[313 127 187 302 100],537,5,38904,4.243918402967165,0.0,40.0
49167,4,9167,[313 127 187 302 100],207,4,38908,4.243891797556719,0.0,40.0
49168,4,9168,[313 127 187 302 100],537,5,38913,4.243974261097176,0.0,40.0
49169,4,9169,[313 127 187 302 100],334,5,38918,4.244056706652127,0.0,40.0
49170,4,9170,[313 127 187 302 100],271,5,38923,4.244139134227456,0.0,40.0
49171,4,9171,[313 127 187 302 100],334,5,38928,4.2442215438290445,0.0,40.0
49172,4,9172,[117   7 111 471 357],474,4,38932,4.244194919873542,20.0,0.0
49173,4,9173,[313 127 187 302 100],474,5,38937,4.244277305428384,0.0,40.0
49174,4,9174,[  4 385 357 144 288],234,2,38939,4.244032697547684,20.0,0.0
49175,4,9175,[ 88  89 175 151 172],474,4,38943,4.244006102877071,0.0,0.0
49176,4,9176,[143 238 286 111   7],378,3,38946,4.243870545930043,0.0,0.0
49177,4,9177,[313 127 187 302 100],474,5,38951,4.243952930921769,0.0,40.0
49178,4,9178,[313 127 187 302 100],328,5,38956,4.244035297962741,0.0,40.0
49179,4,9179,[313 127 187 302 100],271,5,38961,4.2441176470588236,0.0,40.0
49180,4,9180,[161 174  82 204   4],881,3,38964,4.243982137022111,0.0,20.0
49181,4,9181,[313 127 187 302 100],334,5,38969,4.244064473970813,0.0,40.0
49182,4,9182,[ 97 257 118 186 182],881,2,38971,4.243820102363062,0.0,0.0
49183,4,9183,[313 127 187 302 100],474,5,38976,4.2439024390243905,0.0,40.0
49184,4,9184,[313 127 187 302 100],207,4,38980,4.2438758845944475,0.0,40.0
49185,4,9185,[313 127 187 302 100],271,5,38985,4.243958197256695,0.0,40.0
49186,4,9186,[175 215 323 202  69],804,5,38990,4.244040491999565,0.0,0.0
49187,4,9187,[313 127 187 302 100],144,4,38994,4.244013931214628,0.0,40.0
49188,4,9188,[313 127 187 302 100],328,5,38999,4.244096201980629,0.0,40.0
49189,4,9189,[385 211 301 210 182],234,0,38999,4.243634385201306,0.0,0.0
49190,4,9190,[313 127 187 302 100],271,5,39004,4.243716679360244,0.0,40.0
49191,4,9191,[313 127 187 302 100],334,5,39009,4.243798955613577,0.0,40.0
49192,4,9192,[313 127 187 302 100],328,5,39014,4.243881213967149,0.0,40.0
49193,4,9193,[  9 471 597 174  12],145,4,39018,4.243854687839896,20.0,20.0
49194,4,9194,[313 127 187 302 100],207,4,39022,4.243828167482327,0.0,40.0
49195,4,9195,[313 127 187 302 100],328,5,39027,4.243910395824272,0.0,40.0
49196,4,9196,[313 127 187 302 100],328,5,39032,4.2439926062846585,0.0,40.0
49197,4,9197,[313 127 187 302 100],144,4,39036,4.243966079582518,0.0,40.0
49198,4,9198,[313 127 187 302 100],271,5,39041,4.2440482661158825,0.0,40.0
49199,4,9199,[313 127 187 302 100],90,5,39046,4.244130434782608,0.0,40.0
49200,4,9200,[313 127 187 302 100],537,5,39051,4.244212585588523,0.0,40.0
49201,4,9201,[313 127 187 302 100],271,5,39056,4.2442947185394475,0.0,40.0
49202,4,9202,[313 127 187 302 100],13,5,39061,4.244376833641204,0.0,40.0
49203,4,9203,[196 357 568 183 194],766,2,39063,4.24413298565841,20.0,0.0
49204,4,9204,[313 127 187 302 100],13,5,39068,4.244215100488865,0.0,40.0
49205,4,9205,[196 286   8   9 153],488,1,39069,4.243862698240278,0.0,0.0
49206,4,9206,[313 127 187 302 100],271,5,39074,4.243944824589986,0.0,40.0
49207,4,9207,[ 96  70 211 186   8],207,2,39076,4.24370112945265,0.0,0.0
49208,4,9208,[313 127 187 302 100],90,5,39081,4.243783255510913,0.0,40.0
49209,4,9209,[  8  71 135 125   7],64,3,39084,4.243648208469056,0.0,0.0
49210,4,9210,[313 127 187 302 100],328,5,39089,4.24373032244056,0.0,40.0
49211,4,9211,[313 127 187 302 100],328,5,39094,4.243812418584455,0.0,40.0
49212,4,9212,[ 15  28 132 483  56],406,4,39098,4.243785954629328,20.0,0.0
49213,4,9213,[313 127 187 302 100],334,5,39103,4.243868026915563,0.0,40.0
49214,4,9214,[313 127 187 302 100],474,5,39108,4.243950081389039,0.0,40.0
49215,4,9215,[313 127 187 302 100],334,5,39113,4.244032118055555,0.0,40.0
49216,4,9216,[313 127 187 302 100],328,5,39118,4.244114136920907,0.0,40.0
49217,4,9217,[313 127 187 302 100],271,5,39123,4.244196137990888,0.0,40.0
49218,4,9218,[313 127 187 302 100],474,5,39128,4.244278121271288,0.0,40.0
49219,4,9219,[313 127 187 302 100],207,4,39132,4.2442516268980475,0.0,40.0
49220,4,9220,[313 127 187 302 100],13,5,39137,4.244333586378918,0.0,40.0
49221,4,9221,[174 357 286 385  11],90,5,39142,4.244415528085014,20.0,20.0
49222,4,9222,[313 127 187 302 100],13,5,39147,4.244497452022118,0.0,40.0
49223,4,9223,[313 127 187 302 100],328,5,39152,4.2445793581960105,0.0,40.0
49224,4,9224,[313 127 187 302 100],144,4,39156,4.244552845528455,0.0,40.0
49225,4,9225,[313 127 187 302 100],207,4,39160,4.2445263386082805,0.0,40.0
49226,4,9226,[313 127 187 302 100],537,5,39165,4.244608215021134,0.0,40.0
49227,4,9227,[180 318  25 187 211],474,5,39170,4.244690073688774,20.0,0.0
49228,4,9228,[ 11 546  12 385 475],119,4,39174,4.244663560515765,20.0,0.0
49229,4,9229,[313 127 187 302 100],271,5,39179,4.244745395449621,0.0,40.0
49230,4,9230,[ 97 210 423  98  96],892,5,39184,4.244827212653017,0.0,20.0
49231,4,9231,[313 127 187 302 100],90,5,39189,4.244909012131716,0.0,40.0
49232,4,9232,[313 127 187 302 100],90,5,39194,4.244990793891477,0.0,40.0
49233,4,9233,[204 273 328  11  56],328,2,39196,4.244747671648256,0.0,0.0
49234,4,9234,[313 127 187 302 100],328,5,39201,4.2448294531672985,0.0,40.0
49235,4,9235,[313 127 187 302 100],537,5,39206,4.244911216977046,0.0,40.0
49236,4,9236,[ 22 385 568 196 174],95,5,39211,4.244992963083252,0.0,20.0
49237,4,9237,[161 187 237 318 204],85,4,39215,4.24496644295302,20.0,0.0
49238,4,9238,[313 127 187 302 100],474,5,39220,4.245048165385865,0.0,40.0
49239,4,9239,[313 127 187 302 100],474,5,39225,4.24512987012987,0.0,40.0
49240,4,9240,[496 483  12 180  15],406,5,39230,4.24521155719078,40.0,0.0
49241,4,9241,[313 127 187 302 100],144,4,39234,4.245185024886388,0.0,40.0
49242,4,9242,[237 185 276 546 301],234,0,39234,4.244725738396625,0.0,0.0
49243,4,9243,[313 127 187 302 100],474,5,39239,4.244807442665513,0.0,40.0
49244,4,9244,[143 135  89  79  28],194,1,39240,4.2444564629529475,0.0,0.0
49245,4,9245,[313 127 187 302 100],537,5,39245,4.244538178671858,0.0,40.0
49246,4,9246,[313 127 187 302 100],537,5,39250,4.244619876716773,0.0,40.0
49247,4,9247,[222 357 132 294 237],804,5,39255,4.244701557093426,20.0,0.0
49248,4,9248,[313 127 187 302 100],334,5,39260,4.244783219807546,0.0,40.0
49249,4,9249,[313 127 187 302 100],328,5,39265,4.244864864864865,0.0,40.0
49250,4,9250,[313 127 187 302 100],537,5,39270,4.244946492271106,0.0,40.0
49251,4,9251,[313 127 187 302 100],271,5,39275,4.245028102031993,0.0,40.0
49252,4,9252,[313 127 187 302 100],334,5,39280,4.245109694153248,0.0,40.0
49253,4,9253,[313 127 187 302 100],207,4,39284,4.245083207261724,0.0,40.0
49254,4,9254,[234 118   1  56 238],897,4,39288,4.2450567260940035,0.0,0.0
49255,4,9255,[313 127 187 302 100],271,5,39293,4.245138288677614,0.0,40.0
49256,4,9256,[168 216 174 423  12],543,3,39296,4.245003780922545,20.0,20.0
49257,4,9257,[313 127 187 302 100],537,5,39301,4.2450853316050985,0.0,40.0
49258,4,9258,[ 12  22 289  71 282],334,3,39304,4.244950858624041,20.0,0.0
49259,4,9259,[313 215 655 153  11],13,4,39308,4.244924406047517,0.0,0.0
49260,4,9260,[313 127 187 302 100],537,5,39313,4.24500593888349,0.0,40.0
49261,4,9261,[403  64 471 588  88],42,4,39317,4.244979486072123,0.0,0.0
49262,4,9262,[313 127 187 302 100],207,4,39321,4.244953038972255,0.0,40.0
49263,4,9263,[313 127 187 302 100],90,5,39326,4.245034542314335,0.0,40.0
49264,4,9264,[313 127 187 302 100],328,5,39331,4.2451160280626015,0.0,40.0
49265,4,9265,[313 127 187 302 100],207,4,39335,4.245089574789553,0.0,40.0
49266,4,9266,[313 127 187 302 100],207,4,39339,4.245063127225639,0.0,40.0
49267,4,9267,[313 127 187 302 100],271,5,39344,4.245144583513164,0.0,40.0
49268,4,9268,[118 132 204 515 276],643,3,39347,4.245010249217823,0.0,0.0
49269,4,9269,[313 127 187 302 100],537,5,39352,4.245091693635383,0.0,40.0
49270,4,9270,[313 127 187 302 100],328,5,39357,4.245173120483227,0.0,40.0
49271,4,9271,[211 194 127 318 173],188,4,39361,4.245146678170837,20.0,20.0
49272,4,9272,[185  82  50 403   4],643,3,39364,4.245012401596031,0.0,20.0
49273,4,9273,[313 127 187 302 100],90,5,39369,4.24509381065344,0.0,40.0
49274,4,9274,[186 111 210  64 121],653,4,39373,4.245067385444744,0.0,0.0
49275,4,9275,[180  64 289 197 546],524,4,39377,4.245040965933592,0.0,0.0
49276,4,9276,[483 435 127 273 405],7,3,39380,4.244906758650425,20.0,20.0
49277,4,9277,[313 127 187 302 100],13,5,39385,4.244988143996551,0.0,40.0
49278,4,9278,[313 127 187 302 100],537,5,39390,4.245069511800841,0.0,40.0
49279,4,9279,[405 237 202 435  56],295,5,39395,4.245150862068965,0.0,0.0
49280,4,9280,[313 127 187 302 100],207,4,39399,4.245124447796574,0.0,40.0
49281,4,9281,[313 127 187 302 100],144,4,39403,4.245098039215686,0.0,40.0
49282,4,9282,[313 127 187 302 100],334,5,39408,4.245179360120651,0.0,40.0
49283,4,9283,[313 127 187 302 100],537,5,39413,4.245260663507109,0.0,40.0
49284,4,9284,[313 127 187 302 100],537,5,39418,4.245341949380721,0.0,40.0
49285,4,9285,[258 183   1 211 176],311,4,39422,4.245315528752961,0.0,0.0
49286,4,9286,[313 127 187 302 100],537,5,39427,4.245396791213524,0.0,40.0
49287,4,9287,[313 127 187 302 100],144,4,39431,4.24537037037037,0.0,40.0
49288,4,9288,[257 289 132   4 197],881,1,39432,4.24502099257186,0.0,0.0
49289,4,9289,[195   1 301 111  96],378,2,39434,4.244779332615716,0.0,0.0
49290,4,9290,[172 186  89 403 423],506,5,39439,4.244860617802174,0.0,0.0
49291,4,9291,[313 127 187 302 100],271,5,39444,4.2449418854928975,0.0,40.0
49292,4,9292,[313 127 187 302 100],271,5,39449,4.245023135693533,0.0,40.0
49293,4,9293,[603 273  79 186  15],537,2,39451,4.244781579513664,20.0,0.0
49294,4,9294,[100 265 313 161 603],738,4,39455,4.244755244755245,20.0,20.0
49295,4,9295,[313 127 187 302 100],90,5,39460,4.244836488812393,0.0,40.0
49296,4,9296,[313 127 187 302 100],334,5,39465,4.244917715392062,0.0,40.0
49297,4,9297,[678  97   9 496 276],339,4,39469,4.2448913744891374,0.0,0.0
49298,4,9298,[313 127 187 302 100],328,5,39474,4.244972577696527,0.0,40.0
49299,4,9299,[313 127 187 302 100],207,4,39478,4.24494623655914,0.0,40.0
49300,4,9300,[132 435 275 568  28],7,5,39483,4.245027416406838,0.0,0.0
49301,4,9301,[313 127 187 302 318],207,5,39488,4.245108578800258,20.0,20.0
49302,4,9302,[313 127 187 302 318],207,5,39493,4.245189723745028,20.0,20.0
49303,4,9303,[313 127 187 302 318],328,5,39498,4.245270851246776,20.0,20.0
49304,4,9304,[313 127 187 302 318],90,5,39503,4.2453519613111235,20.0,20.0
49305,4,9305,[313 127 187 302 318],537,5,39508,4.245433053943692,20.0,20.0
49306,4,9306,[313 127 187 302 318],334,5,39513,4.245514129150102,20.0,20.0
49307,4,9307,[313 127 187 302 318],334,5,39518,4.245595186935969,20.0,20.0
49308,4,9308,[313 127 187 302 318],474,5,39523,4.245676227306907,20.0,20.0
49309,4,9309,[313 127 187 302 318],90,5,39528,4.245757250268529,20.0,20.0
49310,4,9310,[  7 179 568 127 273],13,1,39529,4.245408656427881,0.0,20.0
49311,4,9311,[286 143 204   7 182],339,4,39533,4.245382302405498,0.0,0.0
49312,4,9312,[313 127 187 302 318],207,5,39538,4.245463330827875,20.0,20.0
49313,4,9313,[313 127 187 302 318],207,5,39543,4.245544341850977,20.0,20.0
49314,4,9314,[300  70 161  69 172],378,4,39547,4.245517981749866,0.0,0.0
49315,4,9315,[161  82 357 228 143],311,4,39551,4.245491627307858,20.0,0.0
49316,4,9316,[194  12 100 182 301],666,4,39555,4.24546527852313,20.0,20.0
49317,4,9317,[483 121 216  25  56],184,3,39558,4.245331616226658,20.0,0.0
49318,4,9318,[313 127 187 302 318],13,4,39562,4.245305290267196,20.0,20.0
49319,4,9319,[313 127 187 302 318],90,5,39567,4.24538626609442,20.0,20.0
49320,4,9320,[313 127 187 302 318],13,4,39571,4.2453599399206094,20.0,20.0
49321,4,9321,[313 127 187 302 100],144,4,39575,4.245333619394979,0.0,40.0
49322,4,9322,[282  25 427 333 403],533,4,39579,4.2453073045157135,0.0,0.0
49323,4,9323,[313 127 187 302 100],328,5,39584,4.245388245388245,0.0,40.0
49324,4,9324,[ 69  95 111 405 222],648,3,39587,4.245254691689008,0.0,0.0
49325,4,9325,[ 79 228 568  64 202],537,0,39587,4.244799485309886,0.0,0.0
49326,4,9326,[313 127 187 302 100],334,5,39592,4.244880454594189,0.0,40.0
49327,4,9327,[294 183  82   9  96],200,5,39597,4.24496140651801,0.0,0.0
49328,4,9328,[313 127 187 302 100],334,5,39602,4.245042341086934,0.0,40.0
49329,4,9329,[313 127 187 302 100],207,4,39606,4.245016077170418,0.0,40.0
49330,4,9330,[313 127 187 302 100],328,5,39611,4.245096988532848,0.0,40.0
49331,4,9331,[313 127 187 302 100],207,4,39615,4.2450707243891985,0.0,40.0
49332,4,9332,[313 127 187 302 318],207,5,39620,4.245151612557591,20.0,20.0
49333,4,9333,[318 300  88  56 161],13,3,39623,4.245018212984787,20.0,0.0
49334,4,9334,[313 127 187 302 100],334,5,39628,4.2450990894483125,0.0,40.0
49335,4,9335,[313 127 187 302 100],328,5,39633,4.245179948586118,0.0,40.0
49336,4,9336,[313 127 187 302 100],207,4,39637,4.245153689621934,0.0,40.0
49337,4,9337,[313 127 187 302 318],474,5,39642,4.245234525594346,20.0,20.0
49338,4,9338,[204  69 210 196 313],207,3,39645,4.245101188564086,0.0,0.0
49339,4,9339,[313 127 187 302 318],334,5,39650,4.245182012847966,20.0,20.0
49340,4,9340,[183 357 294   4 186],328,3,39653,4.245048709988224,20.0,0.0
49341,4,9341,[313 127 187 302 183],334,5,39658,4.24512952258617,0.0,20.0
49342,4,9342,[168 546 191 121 172],13,3,39661,4.24499625387991,0.0,0.0
49343,4,9343,[313 127 187 302 183],207,4,39665,4.244970034246576,0.0,20.0
49344,4,9344,[568 172 275 215 427],308,4,39669,4.244943820224719,0.0,0.0
49345,4,9345,[313 127 187 302 318],144,4,39673,4.24491761181254,20.0,20.0
49346,4,9346,[ 70 258 187 216 143],311,4,39677,4.244891409008238,0.0,0.0
49347,4,9347,[318 222 265  79 186],328,4,39681,4.244865211810013,20.0,0.0
49348,4,9348,[313 127 187 302 318],474,5,39686,4.24494598352765,20.0,20.0
49349,4,9349,[313 127 187 302 318],90,5,39691,4.2450267379679145,20.0,20.0
49350,4,9350,[216 182 161 322 132],92,1,39692,4.244679713399637,0.0,0.0
49351,4,9351,[313 127 187 302 318],271,5,39697,4.244760479041916,20.0,20.0
49352,4,9352,[ 79  71 238  64 234],474,5,39702,4.244841227413664,0.0,0.0
49353,4,9353,[ 50  15 568 196 275],311,5,39707,4.244921958520419,0.0,20.0
49354,4,9354,[588 132 655 318 191],313,5,39712,4.2450026723677174,20.0,0.0
49355,4,9355,[ 64 313 161 322  97],533,4,39716,4.24497648567764,0.0,0.0
49356,4,9356,[313 127 187 302 318],13,4,39720,4.244950304584803,20.0,20.0
49357,4,9357,[313 127 187 302 318],334,5,39725,4.2450309895276765,20.0,20.0
49358,4,9358,[313 127 187 302 318],474,5,39730,4.245111657228336,20.0,20.0
49359,4,9359,[313 127 187 302 318],207,5,39735,4.2451923076923075,20.0,20.0
49360,4,9360,[ 95 186 135 200 176],650,4,39739,4.245166114731332,0.0,0.0
49361,4,9361,[313 127 187 302 318],13,4,39743,4.245139927365948,20.0,20.0
49362,4,9362,[313 127 187 302 100],271,5,39748,4.245220548969347,0.0,40.0
49363,4,9363,[313 127 187 302 100],271,5,39753,4.245301153353267,0.0,40.0
49364,4,9364,[313 127 187 302 100],13,5,39758,4.245381740523225,0.0,40.0
49365,4,9365,[313 127 187 302 100],144,4,39762,4.245355541319667,0.0,40.0
49366,4,9366,[313 127 187 302 100],537,5,39767,4.245436105476673,0.0,40.0
49367,4,9367,[313 127 187 302 100],328,5,39772,4.2455166524338175,0.0,40.0
49368,4,9368,[118  71  96 289 202],378,4,39776,4.245490447219554,0.0,0.0
49369,4,9369,[313 127 187 302 100],90,5,39781,4.245570971184632,0.0,40.0
49370,4,9370,[313 127 187 302 100],13,5,39786,4.245651477963931,0.0,40.0
49371,4,9371,[313 127 187 302 100],328,5,39791,4.2457319675629535,0.0,40.0
49372,4,9372,[286   1  79 168 161],234,0,39791,4.245278992851809,0.0,0.0
49373,4,9373,[313 127 187 302 100],334,5,39796,4.245359505013868,0.0,40.0
49374,4,9374,[313 127 187 302 100],207,4,39800,4.245333333333333,0.0,40.0
49375,4,9375,[313 127 187 302 100],271,5,39805,4.245413822525597,0.0,40.0
49376,4,9376,[117 185 168  95  96],648,3,39808,4.2452810067185665,0.0,0.0
49377,4,9377,[174 211  89  98 185],890,4,39812,4.245254851780763,0.0,40.0
49378,4,9378,[313 127 187 302 100],334,5,39817,4.245335323595266,0.0,40.0
49379,4,9379,[313 127 187 302 100],537,5,39822,4.2454157782515995,0.0,40.0
49380,4,9380,[313 127 187 302 100],90,5,39827,4.24549621575525,0.0,40.0
49381,4,9381,[313 127 187 302 100],144,4,39831,4.245470049030057,0.0,40.0
49382,4,9382,[313 127 187 302 100],271,5,39836,4.245550463604391,0.0,40.0
49383,4,9383,[313 127 187 302 100],144,4,39840,4.245524296675192,0.0,40.0
49384,4,9384,[313 127 187 302 100],474,5,39845,4.245604688332445,0.0,40.0
49385,4,9385,[313 127 187 302 100],537,5,39850,4.245685062859578,0.0,40.0
49386,4,9386,[ 79 235 175  50  22],313,3,39853,4.245552359646319,0.0,20.0
49387,4,9387,[182  28  70  88  56],506,5,39858,4.245632722624627,0.0,0.0
49388,4,9388,[313 127 187 302 100],207,4,39862,4.245606560869102,0.0,40.0
49389,4,9389,[228 117 385  25  79],650,3,39865,4.245473908413206,0.0,0.0
49390,4,9390,[313 127 187 302 100],207,4,39869,4.245447769140666,0.0,40.0
49391,4,9391,[313 127 187 302 100],207,4,39873,4.245421635434412,0.0,40.0
49392,4,9392,[187   8 210  69 471],313,4,39877,4.245395507292665,0.0,0.0
49393,4,9393,[ 79 357  56  28 265],537,2,39879,4.245156482861401,20.0,0.0
49394,4,9394,[322 175 172 180 483],524,3,39882,4.245023948908994,20.0,0.0
49395,4,9395,[313 127 187 302 318],207,5,39887,4.2451042997020005,20.0,20.0
49396,4,9396,[313 127 187 302 318],328,5,39892,4.245184633393636,20.0,20.0
49397,4,9397,[313 127 187 302 318],13,4,39896,4.245158544371143,20.0,20.0
49398,4,9398,[313 127 187 302 100],13,5,39901,4.245238855197361,0.0,40.0
49399,4,9399,[313 127 187 302 100],13,5,39906,4.24531914893617,0.0,40.0
49400,4,9400,[202 182 194 276 151],308,5,39911,4.245399425593022,0.0,0.0
49401,4,9401,[313 127 187 302 100],13,5,39916,4.245479685173367,0.0,40.0
49402,4,9402,[313 127 187 302 100],328,5,39921,4.245559927682654,0.0,40.0
49403,4,9403,[143 318 191 265 288],7,4,39925,4.245533815397703,20.0,0.0
49404,4,9404,[322 118 597  98 151],788,2,39927,4.245295055821372,0.0,20.0
49405,4,9405,[ 96  95 294 200 318],92,1,39928,4.244950031894535,20.0,0.0
49406,4,9406,[313 127 187 302 100],90,5,39933,4.245030296587648,0.0,40.0
49407,4,9407,[313 127 187 302 100],207,4,39937,4.2450042517006805,0.0,40.0
49408,4,9408,[313 127 187 302 100],271,5,39942,4.245084493569986,0.0,40.0
49409,4,9409,[313 127 187 302 100],328,5,39947,4.2451647183846974,0.0,40.0
49410,4,9410,[313 127 187 302 100],13,5,39952,4.245244926150249,0.0,40.0
49411,4,9411,[215 238 273 173  70],537,3,39955,4.245112622184445,0.0,0.0
49412,4,9412,[322 215  25  28 176],474,5,39960,4.24519281844258,0.0,0.0
49413,4,9413,[313 127 187 302 100],328,5,39965,4.245272997663055,0.0,40.0
49414,4,9414,[  1 405 185 471 323],699,2,39967,4.245034519383962,0.0,0.0
49415,4,9415,[176  71 121  79 235],788,3,39970,4.244902293967715,0.0,0.0
49416,4,9416,[ 28   1  22 151 135],897,4,39974,4.244876287565042,0.0,0.0
49417,4,9417,[313 127 187 302 100],271,5,39979,4.244956466341049,0.0,40.0
49418,4,9418,[313 127 187 302 100],328,5,39984,4.245036628092154,0.0,40.0
49419,4,9419,[313 127 187 302 100],144,4,39988,4.245010615711252,0.0,40.0
49420,4,9420,[144 151 588  97  70],234,0,39988,4.244560025475002,0.0,0.0
49421,4,9421,[313 127 187 302 100],334,5,39993,4.244640203778391,0.0,40.0
49422,4,9422,[313 127 187 302 100],90,5,39998,4.244720365064205,0.0,40.0
49423,4,9423,[ 50 186 202 118  64],833,1,39999,4.244376061120543,0.0,20.0
49424,4,9424,[313 127 187 302 100],271,5,40004,4.244456233421751,0.0,40.0
49425,4,9425,[ 97 328 151 294 186],653,2,40006,4.244218120093358,0.0,0.0
49426,4,9426,[313 127 187 302 100],207,4,40010,4.244192213853824,0.0,40.0
49427,4,9427,[313 127 187 302 100],207,4,40014,4.2441663131098855,0.0,40.0
49428,4,9428,[313 127 187 302 100],328,5,40019,4.244246473645138,0.0,40.0
49429,4,9429,[313 127 187 302 100],207,4,40023,4.244220572640509,0.0,40.0
49430,4,9430,[313 127 187 302 318],474,5,40028,4.244300710423073,20.0,20.0
49431,4,9431,[313 127 187 302 318],334,5,40033,4.244380831212892,20.0,20.0
49432,4,9432,[313 127 187 302 318],474,5,40038,4.244460935015372,20.0,20.0
49433,4,9433,[313 127 187 302 318],207,5,40043,4.2445410218359125,20.0,20.0
49434,4,9434,[313 127 187 302 318],90,5,40048,4.244621091679916,20.0,20.0
49435,4,9435,[655 273 318 300 118],774,0,40048,4.244171259008055,20.0,0.0
49436,4,9436,[313 127 187 302 318],13,4,40052,4.24414538518597,20.0,20.0
49437,4,9437,[313 127 187 302 100],328,5,40057,4.244225471498199,0.0,40.0
49438,4,9438,[ 89 143 196 117  95],650,4,40061,4.244199597414981,0.0,0.0
49439,4,9439,[313 127 187 302 100],90,5,40066,4.244279661016949,0.0,40.0
49440,4,9440,[313 127 187 302 100],13,5,40071,4.244359707658087,0.0,40.0
49441,4,9441,[313 127 187 302 100],13,5,40076,4.244439737343783,0.0,40.0
49442,4,9442,[313 127 187 302 100],474,5,40081,4.244519750079424,0.0,40.0
49443,4,9443,[235 210  69 118 237],378,4,40085,4.244493858534519,0.0,0.0
49444,4,9444,[313 127 187 302 100],328,5,40090,4.244573848597141,0.0,40.0
49445,4,9445,[ 88 427 294 161  28],379,3,40093,4.244442091890748,0.0,0.0
49446,4,9446,[313 127 187 302 100],271,5,40098,4.244522070498571,0.0,40.0
49447,4,9447,[313 127 187 302 100],334,5,40103,4.244602032176122,0.0,40.0
49448,4,9448,[313 127 187 302 100],90,5,40108,4.244681976928775,0.0,40.0
49449,4,9449,[313 127 187 302 100],90,5,40113,4.244761904761905,0.0,40.0
49450,4,9450,[161 202 183   8 403],311,5,40118,4.24484181568088,0.0,0.0
49451,4,9451,[181 515  15 183 423],95,5,40123,4.244921709691071,0.0,0.0
49452,4,9452,[237 313 204 257 111],92,3,40126,4.244790013752248,0.0,0.0
49453,4,9453,[313 127 187 302 100],207,4,40130,4.244764121006981,0.0,40.0
49454,4,9454,[313 127 187 302 100],144,4,40134,4.2447382337387625,0.0,40.0
49455,4,9455,[197 172 173 318 204],271,5,40139,4.244818104906938,20.0,0.0
49456,4,9456,[313 127 187 302 100],334,5,40144,4.244897959183674,0.0,40.0
49457,4,9457,[  8  25 269   4 172],455,3,40147,4.2447663353774585,0.0,0.0
49458,4,9458,[385  22 161 294  89],830,4,40151,4.244740458822285,0.0,0.0
49459,4,9459,[135 322 546  69 172],788,2,40153,4.2445031712473575,0.0,0.0
49460,4,9460,[257 173 183 655 268],92,3,40156,4.244371630905824,0.0,0.0
49461,4,9461,[313 127 187 302 100],328,5,40161,4.244451490171211,0.0,40.0
49462,4,9462,[313 127 187 302 100],334,5,40166,4.2445313325583856,0.0,40.0
49463,4,9463,[313 127 187 302 100],328,5,40171,4.244611158072696,0.0,40.0
49464,4,9464,[179  98 275 196 286],378,4,40175,4.2445853143159,0.0,20.0
49465,4,9465,[313 127 187 302 100],328,5,40180,4.244665117261779,0.0,40.0
49466,4,9466,[182  28  98 742 403],95,3,40183,4.244533643181578,0.0,20.0
49467,4,9467,[216  70 182   1 196],374,4,40187,4.244507815800591,0.0,0.0
49468,4,9468,[313 127 187 302 100],334,5,40192,4.244587601647481,0.0,40.0
49469,4,9469,[161 202 427 423  15],313,4,40196,4.244561774023231,0.0,0.0
49470,4,9470,[313 127 187 302 100],207,4,40200,4.244535951853025,0.0,40.0
49471,4,9471,[313 127 187 302 100],207,4,40204,4.244510135135135,0.0,40.0
49472,4,9472,[313 127 187 302 100],334,5,40209,4.244589887047398,0.0,40.0
49473,4,9473,[313 127 187 302 100],207,4,40213,4.244564070086553,0.0,40.0
49474,4,9474,[215 204 125 228 423],200,5,40218,4.244643799472295,0.0,0.0
49475,4,9475,[ 88 568 195 121 174],378,4,40222,4.244617982271,0.0,20.0
49476,4,9476,[313 127 187 302 318],90,5,40227,4.244697689142134,20.0,20.0
49477,4,9477,[ 56  50 333   8 197],13,4,40231,4.244671871702891,0.0,20.0
49478,4,9478,[132 125  98   4  11],749,5,40236,4.244751556071315,0.0,20.0
49479,4,9479,[313 127 187 302 318],13,4,40240,4.244725738396625,20.0,20.0
49480,4,9480,[273 385 135   8 271],92,4,40244,4.244699926168126,0.0,0.0
49481,4,9481,[168   1  96 300 196],311,5,40249,4.244779582366589,0.0,0.0
49482,4,9482,[196 323 357 405  98],13,2,40251,4.244542866181588,20.0,20.0
49483,4,9483,[ 79 237  97 202 742],313,3,40254,4.24441164065795,0.0,0.0
49484,4,9484,[313 127 187 302 100],144,4,40258,4.244385872430153,0.0,40.0
49485,4,9485,[313 127 187 302 100],13,5,40263,4.244465528146742,0.0,40.0
49486,4,9486,[313 127 187 302 100],90,5,40268,4.244545167070728,0.0,40.0
49487,4,9487,[471  28 568 100 294],533,5,40273,4.24462478920742,0.0,20.0
49488,4,9488,[ 28 183   4  88 204],13,5,40278,4.244704394562125,0.0,0.0
49489,4,9489,[313 127 187 302 100],207,4,40282,4.244678609062171,0.0,40.0
49490,4,9490,[597  64 496 197 168],533,4,40286,4.244652828995891,0.0,0.0
49491,4,9491,[ 89 294 185 403 118],749,3,40289,4.2445217024863044,0.0,0.0
49492,4,9492,[183 127  25 182  89],59,5,40294,4.244601285157485,0.0,20.0
49493,4,9493,[328 322 173 191 200],13,0,40294,4.244154202654308,0.0,0.0
49494,4,9494,[313 127 187 302 100],90,5,40299,4.2442338072669825,0.0,40.0
49495,4,9495,[313 127 187 302 100],144,4,40303,4.244208087615839,0.0,40.0
49496,4,9496,[313 127 187 302 100],207,4,40307,4.244182373381068,0.0,40.0
49497,4,9497,[313 127 187 302 318],474,5,40312,4.244261949884186,20.0,20.0
49498,4,9498,[313 127 187 302 318],271,5,40317,4.2443415096325925,20.0,20.0
49499,4,9499,[313 127 187 302 318],90,5,40322,4.244421052631579,20.0,20.0
49500,4,9500,[313 127 187 302 318],328,5,40327,4.244500578886433,20.0,20.0
49501,4,9501,[313 127 187 302 318],144,4,40331,4.244474847400547,20.0,20.0
49502,4,9502,[210 161  97  25 175],650,1,40332,4.244133431547932,0.0,0.0
49503,4,9503,[313 127 187 302 318],144,4,40336,4.244107744107744,20.0,20.0
49504,4,9504,[313 127 187 302 318],207,5,40341,4.24418726985797,20.0,20.0
49505,4,9505,[313 127 187 302 318],271,5,40346,4.244266778876499,20.0,20.0
49506,4,9506,[186 132 234 275   8],474,4,40350,4.244241085515935,0.0,0.0
49507,4,9507,[313 127 187 302 318],474,5,40355,4.2443205721497685,20.0,20.0
49508,4,9508,[678 183  71 475 117],648,1,40356,4.24397938794826,0.0,0.0
49509,4,9509,[313 127 187 302 183],207,4,40360,4.243953732912724,0.0,20.0
49510,4,9510,[313 127 187 302 318],334,5,40365,4.244033224687204,20.0,20.0
49511,4,9511,[313 127 187 302 318],334,5,40370,4.244112699747687,20.0,20.0
49512,4,9512,[144 515   8  89 202],543,5,40375,4.244192158099443,0.0,0.0
49513,4,9513,[313 127 187 302 318],537,5,40380,4.24427159974774,20.0,20.0
49514,4,9514,[313 127 187 302 318],334,5,40385,4.2443510246978455,20.0,20.0
49515,4,9515,[313 127 187 302 318],90,5,40390,4.244430432955023,20.0,20.0
49516,4,9516,[132 603 216  28 161],64,3,40393,4.244299674267101,20.0,0.0
49517,4,9517,[187 357 143   1 182],313,4,40397,4.244274007144358,20.0,0.0
49518,4,9518,[313 127 187 302 318],13,4,40401,4.244248345414435,20.0,20.0
49519,4,9519,[427 294  98  22   4],271,4,40405,4.24422268907563,0.0,20.0
49520,4,9520,[313 127 187 302 318],90,5,40410,4.244302069110388,20.0,20.0
49521,4,9521,[216 403 483  69   7],881,3,40413,4.244171392564588,20.0,0.0
49522,4,9522,[313 127 187 302 318],13,4,40417,4.244145752388953,20.0,20.0
49523,4,9523,[271 172  98 100 195],650,4,40421,4.244120117597648,0.0,40.0
49524,4,9524,[313 127 187 302 318],90,5,40426,4.244199475065617,20.0,20.0
49525,4,9525,[313 127 187 302 318],207,5,40431,4.24427881587235,20.0,20.0
49526,4,9526,[313 127 187 302 318],207,5,40436,4.244358140023092,20.0,20.0
49527,4,9527,[257 385 294 405 186],92,2,40438,4.244122586062133,0.0,0.0
49528,4,9528,[313 127 187 302 318],271,5,40443,4.244201909959072,20.0,20.0
49529,4,9529,[127 121  15  69 313],533,5,40448,4.2442812172088145,0.0,20.0
49530,4,9530,[ 70 183 508  88 187],207,2,40450,4.244045745462176,0.0,0.0
49531,4,9531,[313 127 187 302 318],90,5,40455,4.244125052454889,20.0,20.0
49532,4,9532,[313 127 187 302 318],207,5,40460,4.244204342809189,20.0,20.0
49533,4,9533,[313 127 187 302 318],328,5,40465,4.244283616530312,20.0,20.0
49534,4,9534,[202 222 125  82   4],378,1,40466,4.24394336654431,0.0,0.0
49535,4,9535,[286 471 210 269  64],207,2,40468,4.243708053691275,0.0,0.0
49536,4,9536,[313 127 187 302 318],328,5,40473,4.243787354513998,20.0,20.0
49537,4,9537,[597  89 153 435  50],328,3,40476,4.243656951142797,0.0,20.0
49538,4,9538,[313 127 187 302 318],537,5,40481,4.24373624069609,20.0,20.0
49539,4,9539,[211 200  64 179 194],13,3,40484,4.243605870020964,0.0,0.0
49540,4,9540,[ 56 197   4  79 288],7,5,40489,4.243685148307305,0.0,0.0
49541,4,9541,[186 173 515   4   7],7,4,40493,4.243659610144624,0.0,0.0
49542,4,9542,[313 127 187 302 318],328,5,40498,4.243738866184638,20.0,20.0
49543,4,9543,[313 127 187 302 318],207,5,40503,4.243818105616094,20.0,20.0
49544,4,9544,[313 127 187 302 318],271,5,40508,4.243897328444212,20.0,20.0
49545,4,9545,[313 127 187 302 318],334,5,40513,4.243976534674209,20.0,20.0
49546,4,9546,[313 127 187 302 318],334,5,40518,4.244055724311302,20.0,20.0
49547,4,9547,[313 127 187 302 318],144,4,40522,4.244030163385002,20.0,20.0
49548,4,9548,[ 71 301 257 268 235],334,2,40524,4.243795161797046,0.0,0.0
49549,4,9549,[313 127 187 302 318],474,5,40529,4.243874345549738,20.0,20.0
49550,4,9550,[313 127 187 302 318],537,5,40534,4.243953512721181,20.0,20.0
49551,4,9551,[313 127 187 302 318],328,5,40539,4.244032663316583,20.0,20.0
49552,4,9552,[742 179 471 427 678],308,3,40542,4.2439024390243905,0.0,0.0
49553,4,9553,[313 127 187 302 318],537,5,40547,4.243981578396483,20.0,20.0
49554,4,9554,[117 228 196 204 258],537,1,40548,4.2436420722135,0.0,0.0
49555,4,9555,[313 127 187 302 318],334,5,40553,4.243721222268731,20.0,20.0
49556,4,9556,[289 195 288  15  28],474,3,40556,4.2435910850685366,0.0,0.0
49557,4,9557,[313 127 187 302 318],271,5,40561,4.2436702238962125,20.0,20.0
49558,4,9558,[  1 271   8  97 144],13,3,40564,4.243540119259337,0.0,0.0
49559,4,9559,[313  71 121 196 588],308,2,40566,4.243305439330544,0.0,0.0
49560,4,9560,[313 127 187 302 318],334,5,40571,4.243384583202594,20.0,20.0
49561,4,9561,[313 127 187 302 318],13,4,40575,4.243359129889145,20.0,20.0
49562,4,9562,[313 127 187 302 318],144,4,40579,4.243333681898986,20.0,20.0
49563,4,9563,[234 597  82 313 423],328,4,40583,4.243308239230448,0.0,0.0
49564,4,9564,[313 127 187 302 318],474,5,40588,4.243387349712494,20.0,20.0
49565,4,9565,[121 191  56 153  89],650,3,40591,4.243257369851557,0.0,0.0
49566,4,9566,[313 127 187 302 318],474,5,40596,4.243336469112575,20.0,20.0
49567,4,9567,[313 127 187 302 318],207,5,40601,4.2434155518394645,20.0,20.0
49568,4,9568,[313 127 187 302 318],537,5,40606,4.2434946180374125,20.0,20.0
49569,4,9569,[313 127 187 302 318],207,5,40611,4.2435736677115985,20.0,20.0
49570,4,9570,[313 127 187 302 318],474,5,40616,4.243652700867203,20.0,20.0
49571,4,9571,[313 127 187 302 318],334,5,40621,4.2437317175094025,20.0,20.0
49572,4,9572,[475 176 202 234  95],506,4,40625,4.243706257181657,0.0,0.0
49573,4,9573,[294 204 318 427  70],7,3,40628,4.243576352621684,20.0,0.0
49574,4,9574,[313 127 187 302 427],90,5,40633,4.243655352480418,0.0,20.0
49575,4,9575,[313 127 187 302 427],474,5,40638,4.243734335839599,0.0,20.0
49576,4,9576,[153 238  64 588  28],378,4,40642,4.243708885872403,0.0,0.0
49577,4,9577,[313 127 187 302 427],334,5,40647,4.243787847149718,0.0,20.0
49578,4,9578,[313 127 187 302 427],334,5,40652,4.243866791940704,0.0,20.0
49579,4,9579,[313 127 187 302 427],328,4,40656,4.24384133611691,0.0,20.0
49580,4,9580,[313 127 187 302 318],144,4,40660,4.243815885606931,20.0,20.0
49581,4,9581,[313 127 187 302 318],537,5,40665,4.2438948027551655,20.0,20.0
49582,4,9582,[313 127 187 302 318],13,4,40669,4.24386935197746,20.0,20.0
49583,4,9583,[313 127 187 302 318],207,5,40674,4.243948247078464,20.0,20.0
49584,4,9584,[313 127 187 302 318],474,5,40679,4.244027125717267,20.0,20.0
49585,4,9585,[318 328 200  69 282],804,4,40683,4.244001669100772,20.0,0.0
49586,4,9586,[ 88  70   8 175 238],234,1,40684,4.243663294044018,0.0,0.0
49587,4,9587,[174 294 300 603  15],271,2,40686,4.243429286608261,20.0,20.0
49588,4,9588,[300 328 234 282 275],85,1,40687,4.243091041818751,0.0,0.0
49589,4,9589,[313 127 187 302 318],271,5,40692,4.243169968717414,20.0,20.0
49590,4,9590,[216   7  22 181   9],308,4,40696,4.243144614742988,0.0,0.0
49591,4,9591,[168 269  98 210 568],125,4,40700,4.243119266055046,0.0,20.0
49592,4,9592,[313 127 187 302 318],334,5,40705,4.243198165328885,20.0,20.0
49593,4,9593,[313 127 187 302 318],13,4,40709,4.243172816343548,20.0,20.0
49594,4,9594,[313 127 187 302 318],334,5,40714,4.243251693590412,20.0,20.0
49595,4,9595,[143  97 257  79 153],308,4,40718,4.243226344310129,0.0,0.0
49596,4,9596,[97 79 28 71 96],311,5,40723,4.243305199541523,0.0,0.0
49597,4,9597,[173 294 403 117 195],158,3,40726,4.243175661596166,0.0,0.0
49598,4,9598,[313 127 187 302 318],328,5,40731,4.243254505677675,20.0,20.0
49599,4,9599,[313 127 187 302 318],207,5,40736,4.243333333333333,20.0,20.0
49600,4,9600,[313 127 187 302 318],271,5,40741,4.243412144568274,20.0,20.0
49601,4,9601,[313 127 187 302 318],537,5,40746,4.243490939387628,20.0,20.0
49602,4,9602,[313 127 187 302 318],334,5,40751,4.243569717796522,20.0,20.0
49603,4,9603,[313 127 187 302 318],13,4,40755,4.243544356518117,20.0,20.0
49604,4,9604,[195 215  97 161 100],774,0,40755,4.2431025507548155,0.0,20.0
49605,4,9605,[269 328 204 111 176],13,2,40757,4.242869040183219,0.0,0.0
49606,4,9606,[132 200 151 301 265],537,0,40757,4.242427396689914,0.0,0.0
49607,4,9607,[313 127 187 302 318],144,4,40761,4.2424021648626145,20.0,20.0
49608,4,9608,[176 132 180  25 187],210,5,40766,4.242481007388906,0.0,0.0
49609,4,9609,[313 127 187 302 318],90,5,40771,4.242559833506764,20.0,20.0
49610,4,9610,[265 222 215 588 180],804,5,40776,4.242638643221309,0.0,0.0
49611,4,9611,[313 245 202 182 186],533,2,40778,4.24240532667499,0.0,0.0
49612,4,9612,[183 265 153 187 268],334,4,40782,4.242380110267346,0.0,0.0
49613,4,9613,[313 127 187 302 318],13,4,40786,4.242354899105472,20.0,20.0
49614,4,9614,[313 127 187 302 318],271,5,40791,4.242433697347894,20.0,20.0
49615,4,9615,[313 127 187 302 318],537,5,40796,4.242512479201331,20.0,20.0
49616,4,9616,[215 195 403  56   9],144,4,40800,4.24248726213996,0.0,0.0
49617,4,9617,[176 185 182   4  82],334,2,40802,4.242254106882928,0.0,0.0
49618,4,9618,[195  22 196 235 546],64,4,40806,4.242228921925356,0.0,0.0
49619,4,9619,[180  95  89 173 210],387,4,40810,4.242203742203742,0.0,0.0
49620,4,9620,[313 127 187 302 318],334,5,40815,4.2422825070159025,20.0,20.0
49621,4,9621,[181 288 257 143  22],334,3,40818,4.242153398461858,0.0,0.0
49622,4,9622,[313 127 187 302 318],271,5,40823,4.242232152135509,20.0,20.0
49623,4,9623,[313 127 187 302 318],474,5,40828,4.2423108894430595,20.0,20.0
49624,4,9624,[313 127 187 302 318],537,5,40833,4.24238961038961,20.0,20.0
49625,4,9625,[313 127 187 302 318],328,5,40838,4.242468314980262,20.0,20.0
49626,4,9626,[180 603  28 210 265],543,4,40842,4.24244312870053,20.0,0.0
49627,4,9627,[313 127 187 302 318],537,5,40847,4.242521811383465,20.0,20.0
49628,4,9628,[313 127 187 302 318],13,4,40851,4.242496624779313,20.0,20.0
49629,4,9629,[ 96 161 153 210  25],648,3,40854,4.242367601246106,0.0,0.0
49630,4,9630,[ 71 151 222  89 403],60,3,40857,4.242238604506282,0.0,0.0
49631,4,9631,[313 127 187 302 318],144,4,40861,4.242213455149502,20.0,20.0
49632,4,9632,[313 127 187 302 318],537,5,40866,4.242292120834631,20.0,20.0
49633,4,9633,[357  15 286 127 186],271,4,40870,4.242266971143866,20.0,20.0
49634,4,9634,[313 127 187 302 318],90,5,40875,4.242345614945511,20.0,20.0
49635,4,9635,[313 127 187 302 318],207,5,40880,4.242424242424242,20.0,20.0
49636,4,9636,[275  15 181 216 515],184,4,40884,4.242399086852755,0.0,0.0
49637,4,9637,[483 257 111  64 216],6,3,40887,4.242270180535381,20.0,0.0
49638,4,9638,[588   1 197 153 435],650,3,40890,4.24214130096483,0.0,0.0
49639,4,9639,[313 127 187 302 318],474,5,40895,4.242219917012448,20.0,20.0
49640,4,9640,[ 22  25 322 195 483],234,2,40897,4.241987345711026,20.0,0.0
49641,4,9641,[313 127 187 302 318],328,5,40902,4.242065961418793,20.0,20.0
49642,4,9642,[313 127 187 302 318],474,5,40907,4.2421445608213215,20.0,20.0
49643,4,9643,[313 127 187 302 318],537,5,40912,4.242223143923683,20.0,20.0
49644,4,9644,[135 234 546 185 333],328,2,40914,4.2419906687402795,0.0,0.0
49645,4,9645,[313 127 187 302 318],207,5,40919,4.242069251503214,20.0,20.0
49646,4,9646,[313 127 187 302 318],207,5,40924,4.2421478179745,20.0,20.0
49647,4,9647,[313 127 187 302 318],537,5,40929,4.242226368159204,20.0,20.0
49648,4,9648,[423 222  98  28 174],343,5,40934,4.24230490206239,0.0,40.0
49649,4,9649,[313 127 187 302 318],537,5,40939,4.242383419689119,20.0,20.0
49650,4,9650,[143  50 181 183 175],474,5,40944,4.242461921044451,0.0,20.0
49651,4,9651,[313 127 187 302 318],474,5,40949,4.242540406133444,20.0,20.0
49652,4,9652,[313 127 187 302 318],207,5,40954,4.242618874961152,20.0,20.0
49653,4,9653,[313 127 187 302 318],90,5,40959,4.242697327532629,20.0,20.0
49654,4,9654,[ 22 151 100 125 471],313,2,40961,4.242465044018643,0.0,20.0
49655,4,9655,[313 127 187 302 318],13,4,40965,4.242439933719967,20.0,20.0
49656,4,9656,[313 127 187 302 318],13,4,40969,4.242414828621725,20.0,20.0
49657,4,9657,[313 127 187 302 318],537,5,40974,4.242493269828122,20.0,20.0
49658,4,9658,[313 127 187 302 318],144,4,40978,4.242468164406254,20.0,20.0
49659,4,9659,[313 127 187 302 318],90,5,40983,4.242546583850932,20.0,20.0
49660,4,9660,[313 127 187 302 318],90,5,40988,4.242624987061381,20.0,20.0
49661,4,9661,[313 127 187 302 318],328,5,40993,4.242703374042641,20.0,20.0
49662,4,9662,[313 127 187 302 318],90,5,40998,4.242781744799752,20.0,20.0
49663,4,9663,[313 127 187 302 318],271,5,41003,4.242860099337748,20.0,20.0
49664,4,9664,[313 127 187 302 318],334,5,41008,4.242938437661666,20.0,20.0
49665,4,9665,[313 127 187 302 318],328,5,41013,4.243016759776537,20.0,20.0
49666,4,9666,[313 127 187 302 318],328,5,41018,4.24309506568739,20.0,20.0
49667,4,9667,[313 127 187 302 318],474,5,41023,4.243173355399255,20.0,20.0
49668,4,9668,[313 127 187 302 318],90,5,41028,4.243251628917158,20.0,20.0
49669,4,9669,[95 64  8 69  9],881,3,41031,4.243123061013444,0.0,0.0
49670,4,9670,[ 95   4  28  98 258],455,4,41035,4.2430979216213425,0.0,20.0
49671,4,9671,[313 127 187 302 318],207,5,41040,4.2431761786600495,20.0,20.0
49672,4,9672,[313 127 187 302 318],144,4,41044,4.243151038974465,20.0,20.0
49673,4,9673,[313 127 187 302 318],90,5,41049,4.2432292743436015,20.0,20.0
49674,4,9674,[175 234 180 228 268],13,5,41054,4.243307493540052,0.0,0.0
49675,4,9675,[313 127 187 302 318],334,5,41059,4.24338569656883,20.0,20.0
49676,4,9676,[132   7 183  82  95],194,0,41059,4.242947194378423,0.0,0.0
49677,4,9677,[313 127 187 302 318],537,5,41064,4.2430254184748915,20.0,20.0
49678,4,9678,[313 127 187 302 318],474,5,41069,4.243103626407687,20.0,20.0
49679,4,9679,[313 127 187 302 318],474,5,41074,4.243181818181818,20.0,20.0
49680,4,9680,[313 127 187 302 318],90,5,41079,4.243259993802293,20.0,20.0
49681,4,9681,[515 194 302 191 181],458,3,41082,4.243131584383391,0.0,0.0
49682,4,9682,[313 127 187 302 318],13,4,41086,4.24310647526593,20.0,20.0
49683,4,9683,[313 127 187 302 318],144,4,41090,4.243081371334159,20.0,20.0
49684,4,9684,[313 127 187 302 318],144,4,41094,4.2430562725864736,20.0,20.0
49685,4,9685,[313 127 187 302 318],13,4,41098,4.243031179021268,20.0,20.0
49686,4,9686,[194  89 173 300 161],13,3,41101,4.242902859502426,0.0,0.0
49687,4,9687,[313 127 187 302 318],537,5,41106,4.242981007431874,20.0,20.0
49688,4,9688,[176 568 182  82 237],59,4,41110,4.242955929404479,0.0,0.0
49689,4,9689,[228 265 515 172 100],92,5,41115,4.243034055727554,0.0,20.0
49690,4,9690,[313 127 187 302 318],144,4,41119,4.243008977401713,20.0,20.0
49691,4,9691,[313 127 187 302 318],334,5,41124,4.243087082129591,20.0,20.0
49692,4,9692,[294  22 597 276 265],200,5,41129,4.243165170741772,0.0,0.0
49693,4,9693,[313 127 187 302 318],144,4,41133,4.243140086651537,20.0,20.0
49694,4,9694,[313 127 187 302 318],334,5,41138,4.243218153687468,20.0,20.0
49695,4,9695,[313 127 187 302 318],271,5,41143,4.243296204620462,20.0,20.0
49696,4,9696,[313 127 187 302 318],474,5,41148,4.243374239455502,20.0,20.0
49697,4,9697,[313 127 187 302 318],537,5,41153,4.243452258197567,20.0,20.0
49698,4,9698,[194 282 180  95   8],881,4,41157,4.243427157438911,0.0,0.0
49699,4,9699,[202 181 228 117  69],643,1,41158,4.243092783505155,0.0,0.0
49700,4,9700,[313 127 187 302 318],474,5,41163,4.243170807133286,20.0,20.0
49701,4,9701,[202 204 210 200 185],210,5,41168,4.243248814677386,0.0,0.0
49702,4,9702,[313 127 187 302 318],537,5,41173,4.24332680614243,20.0,20.0
49703,4,9703,[288   9 475  28  12],458,3,41176,4.243198680956307,20.0,0.0
49704,4,9704,[313 127 187 302 318],474,5,41181,4.243276661514683,20.0,20.0
49705,4,9705,[313 127 187 302 318],328,5,41186,4.243354626004534,20.0,20.0
49706,4,9706,[ 50 204  98 655 234],371,5,41191,4.243432574430823,0.0,40.0
49707,4,9707,[313 127 187 302 318],328,5,41196,4.243510506798517,20.0,20.0
49708,4,9708,[313 127 187 302 318],334,5,41201,4.243588423112576,20.0,20.0
49709,4,9709,[313 127 187 302 318],207,5,41206,4.243666323377961,20.0,20.0
49710,4,9710,[313 127 187 302 318],328,5,41211,4.2437442075996294,20.0,20.0
49711,4,9711,[313 127 187 302 318],144,4,41215,4.243719110378913,20.0,20.0
49712,4,9712,[258 234 117 678 597],92,3,41218,4.243591063523113,0.0,0.0
49713,4,9713,[496 211 302 423 475],90,4,41222,4.243565987234919,0.0,0.0
49714,4,9714,[313 127 187 302 318],328,5,41227,4.243643849716933,20.0,20.0
49715,4,9715,[313 127 187 302 318],537,5,41232,4.243721696171264,20.0,20.0
49716,4,9716,[313 127 187 302 318],271,5,41237,4.243799526602861,20.0,20.0
49717,4,9717,[313 127 187 302 318],334,5,41242,4.24387734101667,20.0,20.0
49718,4,9718,[313 127 187 302 318],328,5,41247,4.243955139417635,20.0,20.0
49719,4,9719,[313 127 187 302 318],334,5,41252,4.2440329218107,20.0,20.0
49720,4,9720,[313 127 187 302 318],13,4,41256,4.2440078181257075,20.0,20.0
49721,4,9721,[313 127 187 302 318],334,5,41261,4.244085579098951,20.0,20.0
49722,4,9722,[313 127 187 302 318],90,5,41266,4.244163324076931,20.0,20.0
49723,4,9723,[276 748 153  22 211],447,4,41270,4.24413821472645,0.0,0.0
49724,4,9724,[313 127 187 302 318],537,5,41275,4.244215938303342,20.0,20.0
49725,4,9725,[742 496 216 515 483],488,3,41278,4.244088011515525,20.0,0.0
49726,4,9726,[313 127 187 302 318],537,5,41283,4.244165724272643,20.0,20.0
49727,4,9727,[313 127 187 302 318],207,5,41288,4.244243421052632,20.0,20.0
49728,4,9728,[215 196 151 182 168],308,3,41291,4.244115530887039,0.0,0.0
49729,4,9729,[313 127 187 302 318],474,5,41296,4.244193216855088,20.0,20.0
49730,4,9730,[313 127 187 302 318],13,4,41300,4.244168122495119,20.0,20.0
49731,4,9731,[313 127 187 302 318],90,5,41305,4.244245787094123,20.0,20.0
49732,4,9732,[313 127 187 302 318],90,5,41310,4.244323435734101,20.0,20.0
49733,4,9733,[313 127 187 302 318],207,5,41315,4.244401068419971,20.0,20.0
49734,4,9734,[  1 597 294 275 286],554,3,41318,4.244273240883411,0.0,0.0
49735,4,9735,[313 127 187 302 318],271,5,41323,4.244350862777321,20.0,20.0
49736,4,9736,[313 127 187 302 318],334,5,41328,4.244428468727534,20.0,20.0
49737,4,9737,[313 127 187 302 318],334,5,41333,4.244506058738961,20.0,20.0
49738,4,9738,[313 127 187 302 318],474,5,41338,4.244583632816511,20.0,20.0
49739,4,9739,[313 127 187 302 318],271,5,41343,4.244661190965092,20.0,20.0
49740,4,9740,[313 127 187 302 318],90,5,41348,4.244738733189611,20.0,20.0
49741,4,9741,[  8   9 191 294  12],940,4,41352,4.244713611168138,20.0,0.0
49742,4,9742,[ 25 215  50  95 202],848,5,41357,4.2447911320948375,0.0,20.0
49743,4,9743,[313 127 187 302 318],328,5,41362,4.244868637110017,20.0,20.0
49744,4,9744,[313 127 187 302 318],13,4,41366,4.244843509492047,20.0,20.0
49745,4,9745,[313 127 187 302 318],90,5,41371,4.244920993227991,20.0,20.0
49746,4,9746,[313 127 187 302 318],207,5,41376,4.244998461064943,20.0,20.0
49747,4,9747,[186 238 143 151 173],334,3,41379,4.244870742716454,0.0,0.0
49748,4,9748,[313 127 187 302 318],537,5,41384,4.244948199815366,20.0,20.0
49749,4,9749,[313 127 187 302 318],13,4,41388,4.244923076923077,20.0,20.0
49750,4,9750,[313 127 187 302 318],271,5,41393,4.245000512767922,20.0,20.0
49751,4,9751,[313 127 187 302 318],328,5,41398,4.245077932731747,20.0,20.0
49752,4,9752,[313 127 187 302 318],334,5,41403,4.24515533681944,20.0,20.0
49753,4,9753,[195 202 237 403  82],194,0,41403,4.244720114824688,0.0,0.0
49754,4,9754,[313 127 187 302 318],271,5,41408,4.244797539723219,20.0,20.0
49755,4,9755,[313 127 187 302 318],144,4,41412,4.244772447724477,20.0,20.0
49756,4,9756,[313 127 187 302 318],328,5,41417,4.2448498513887465,20.0,20.0
49757,4,9757,[313 127 187 302 318],271,5,41422,4.244927239188359,20.0,20.0
49758,4,9758,[313 127 187 302 318],474,5,41427,4.24500461112819,20.0,20.0
49759,4,9759,[318  71 168 257 385],92,3,41430,4.244877049180328,20.0,0.0
49760,4,9760,[313 127 187 302 318],144,4,41434,4.24485196188915,20.0,20.0
49761,4,9761,[182 185 194 179 135],271,3,41437,4.244724441712764,0.0,0.0
49762,4,9762,[313 127 187 302 318],537,5,41442,4.244801802724572,20.0,20.0
49763,4,9763,[313 127 187 302 318],271,5,41447,4.244879147890209,20.0,20.0
49764,4,9764,[568  22 546 597 195],92,1,41448,4.244546850998464,0.0,0.0
49765,4,9765,[313 127 187 302 318],90,5,41453,4.244624206430473,20.0,20.0
49766,4,9766,[  1 238  69 655 117],749,4,41457,4.24459916043821,0.0,0.0
49767,4,9767,[151 174  15 144 132],378,4,41461,4.24457411957412,0.0,20.0
49768,4,9768,[172 118 127 194 288],648,4,41465,4.244549083836626,0.0,20.0
49769,4,9769,[210 294 179 153  15],207,3,41468,4.244421699078813,0.0,0.0
49770,4,9770,[318 144  70 603 118],308,3,41471,4.244294340395046,40.0,0.0
49771,4,9771,[313 127 187 302 318],334,5,41476,4.244371674171101,20.0,20.0
49772,4,9772,[215 475 216  28 143],92,2,41478,4.2441420239435175,0.0,0.0
49773,4,9773,[313 127 187 302 318],537,5,41483,4.244219357479026,20.0,20.0
49774,4,9774,[313 127 187 302 318],90,5,41488,4.244296675191816,20.0,20.0
49775,4,9775,[ 56 200 237 210 179],374,4,41492,4.244271685761047,0.0,0.0
49776,4,9776,[313 127 187 302 318],537,5,41497,4.244348982305411,20.0,20.0
49777,4,9777,[273 176  96 204 135],328,2,41499,4.24411945183064,0.0,0.0
49778,4,9778,[210 187 235 121 427],59,4,41503,4.244094488188976,0.0,0.0
49779,4,9779,[181 161 496 275 151],899,3,41506,4.2439672801635995,0.0,0.0
49780,4,9780,[143 258  71 176 186],533,3,41509,4.243840098149473,0.0,0.0
49781,4,9781,[313 127 187 302 318],474,5,41514,4.243917399304846,20.0,20.0
49782,4,9782,[313 127 187 302 318],537,5,41519,4.243994684657058,20.0,20.0
49783,4,9783,[313 127 187 302 318],207,5,41524,4.244071954210956,20.0,20.0
49784,4,9784,[313 127 187 302 318],474,5,41529,4.244149207971385,20.0,20.0
49785,4,9785,[195 258 135   7 483],650,4,41533,4.2441242591457184,20.0,0.0
49786,4,9786,[313 127 187 302 318],90,5,41538,4.244201491774803,20.0,20.0
49787,4,9787,[313 127 187 302 318],537,5,41543,4.2442787086228035,20.0,20.0
49788,4,9788,[313 127 187 302 318],474,5,41548,4.244355909694555,20.0,20.0
49789,4,9789,[ 98 143 568 483 294],311,4,41552,4.244330949948927,20.0,20.0
49790,4,9790,[313 127 187 302 318],271,5,41557,4.244408129915228,20.0,20.0
49791,4,9791,[258 435 496 273 185],749,5,41562,4.244485294117647,0.0,0.0
49792,4,9792,[176 210 135  98   4],210,5,41567,4.244562442561013,0.0,20.0
49793,4,9793,[100 678 294 258 161],13,3,41570,4.244435368593016,0.0,20.0
49794,4,9794,[ 12 100 357 196 175],234,2,41572,4.244206227667177,40.0,20.0
49795,4,9795,[423 257 313  79  88],454,5,41577,4.244283380971825,0.0,0.0
49796,4,9796,[313 127 187 302 318],207,5,41582,4.244360518526079,20.0,20.0
49797,4,9797,[313 127 187 302 318],537,5,41587,4.244437640334763,20.0,20.0
49798,4,9798,[313 127 187 302 318],537,5,41592,4.244514746402694,20.0,20.0
49799,4,9799,[313 127 187 302 318],207,5,41597,4.244591836734694,20.0,20.0
49800,4,9800,[313 127 187 302 318],334,5,41602,4.244668911335578,20.0,20.0
49801,4,9801,[313 127 187 302 318],207,5,41607,4.244745970210161,20.0,20.0
49802,4,9802,[313 127 187 302 318],474,5,41612,4.2448230133632565,20.0,20.0
49803,4,9803,[313 127 187 302 318],90,5,41617,4.244900040799673,20.0,20.0
49804,4,9804,[313 127 187 302 318],271,5,41622,4.244977052524223,20.0,20.0
49805,4,9805,[313 127 187 302 318],334,5,41627,4.245054048541709,20.0,20.0
49806,4,9806,[313 127 187 302 318],13,4,41631,4.245029060874885,20.0,20.0
49807,4,9807,[313 127 187 302 318],271,5,41636,4.24510603588907,20.0,20.0
49808,4,9808,[313 127 187 302 318],474,5,41641,4.245182995208482,20.0,20.0
49809,4,9809,[313 127 187 302 318],207,5,41646,4.24525993883792,20.0,20.0
49810,4,9810,[313 127 187 302 318],328,5,41651,4.245336866782183,20.0,20.0
49811,4,9811,[228 181 118 748  22],92,2,41653,4.24510803098247,0.0,0.0
49812,4,9812,[313 127 187 302 318],474,5,41658,4.245184958728218,20.0,20.0
49813,4,9813,[313 127 187 302 318],13,4,41662,4.24515997554514,20.0,20.0
49814,4,9814,[313 127 187 302 318],334,5,41667,4.245236882322975,20.0,20.0
49815,4,9815,[515  64 121  71 385],64,3,41670,4.245110024449878,0.0,0.0
49816,4,9816,[132 318 151  12 144],666,3,41673,4.24498319242131,40.0,0.0
49817,4,9817,[313 127 187 302 318],474,5,41678,4.245060093705439,20.0,20.0
49818,4,9818,[132 195 172 588  71],298,5,41683,4.245136979325797,0.0,0.0
49819,4,9819,[313 127 187 302 318],271,5,41688,4.245213849287169,20.0,20.0
49820,4,9820,[313 127 187 302 318],90,5,41693,4.245290703594339,20.0,20.0
49821,4,9821,[313 127 187 302 318],13,4,41697,4.245265729993891,20.0,20.0
49822,4,9822,[313 127 187 302 318],328,5,41702,4.245342563371679,20.0,20.0
49823,4,9823,[313 127 187 302 318],328,5,41707,4.245419381107492,20.0,20.0
49824,4,9824,[313 127 187 302 318],271,5,41712,4.2454961832061064,20.0,20.0
49825,4,9825,[313 127 187 302 318],144,4,41716,4.245471198860167,20.0,20.0
49826,4,9826,[237 118 196  88 294],194,1,41717,4.245140938231403,0.0,0.0
49827,4,9827,[313 127 187 302 318],90,5,41722,4.2452177452177455,20.0,20.0
49828,4,9828,[313 127 187 302 318],328,5,41727,4.24529453657544,20.0,20.0
49829,4,9829,[313 127 187 302 318],334,5,41732,4.245371312309257,20.0,20.0
49830,4,9830,[234 515 191  69 211],474,5,41737,4.245448072423965,0.0,0.0
49831,4,9831,[313 127 187 302 318],271,5,41742,4.245524816924329,20.0,20.0
49832,4,9832,[313 127 187 302 318],334,5,41747,4.245601545815112,20.0,20.0
49833,4,9833,[313 127 187 302 318],144,4,41751,4.245576571079927,20.0,20.0
49834,4,9834,[313 127 187 302 318],271,5,41756,4.245653279105237,20.0,20.0
49835,4,9835,[313 127 187 302 318],13,4,41760,4.245628304188695,20.0,20.0
49836,4,9836,[  1  11 202 385 204],378,3,41763,4.245501677340653,0.0,0.0
49837,4,9837,[196  25  79 301  82],85,2,41765,4.2452734295588535,0.0,0.0
49838,4,9838,[313 127 187 302 318],334,5,41770,4.245350137209066,20.0,20.0
49839,4,9839,[313 127 187 302 318],334,5,41775,4.245426829268292,20.0,20.0
49840,4,9840,[313 127 187 302 318],207,5,41780,4.245503505741286,20.0,20.0
49841,4,9841,[313 127 187 302 318],90,5,41785,4.245580166632799,20.0,20.0
49842,4,9842,[176 216 174 168   9],374,3,41788,4.245453621863253,0.0,20.0
49843,4,9843,[135  82 427  71 471],13,3,41791,4.2453271028037385,0.0,0.0
49844,4,9844,[313 127 187 302 318],90,5,41796,4.2454037582529205,20.0,20.0
49845,4,9845,[313 127 187 302 318],144,4,41800,4.245378834044282,20.0,20.0
49846,4,9846,[435 151 191 405  56],533,2,41802,4.245150807352493,0.0,0.0
49847,4,9847,[313 127 187 302 318],90,5,41807,4.245227457351747,20.0,20.0
49848,4,9848,[121 258 180  25  79],666,2,41809,4.244999492334247,0.0,0.0
49849,4,9849,[357 385 742   9 568],749,3,41812,4.2448730964467005,20.0,0.0
49850,4,9850,[313 127 187 302 318],144,4,41816,4.244848238757487,20.0,20.0
49851,4,9851,[313 127 187 302 318],90,5,41821,4.244924888347543,20.0,20.0
49852,4,9852,[313 127 187 302 318],334,5,41826,4.2450015223789705,20.0,20.0
49853,4,9853,[276  70 143   9 328],533,4,41830,4.2449766592246805,0.0,0.0
49854,4,9854,[313 127 187 302 318],13,4,41834,4.244951801116184,20.0,20.0
49855,4,9855,[313 127 187 302 318],271,5,41839,4.245028409090909,20.0,20.0
49856,4,9856,[313 127 187 302 318],144,4,41843,4.245003550776098,20.0,20.0
49857,4,9857,[216  22 271 181 405],328,3,41846,4.244877257050112,0.0,0.0
49858,4,9858,[313 127 187 302 318],328,5,41851,4.244953849274775,20.0,20.0
49859,4,9859,[313 127 187 302 318],13,4,41855,4.244929006085193,20.0,20.0
49860,4,9860,[313 127 187 302 318],207,5,41860,4.2450055775276345,20.0,20.0
49861,4,9861,[313 127 187 302 318],474,5,41865,4.2450821334414925,20.0,20.0
49862,4,9862,[202 427 515 222 153],87,5,41870,4.245158673831491,0.0,0.0
49863,4,9863,[313 127 187 302 318],271,5,41875,4.2452351987023516,20.0,20.0
49864,4,9864,[282 265 182 483 294],533,3,41878,4.2451089711099845,20.0,0.0
49865,4,9865,[313 127 187 302 318],474,5,41883,4.245185485505777,20.0,20.0
49866,4,9866,[313 127 187 302 318],144,4,41887,4.245160636464984,20.0,20.0
49867,4,9867,[210 161  98 313 196],533,5,41892,4.245237130117552,0.0,20.0
49868,4,9868,[313 127 187 302 318],537,5,41897,4.245313608268315,20.0,20.0
49869,4,9869,[174  15  50 228 210],254,4,41901,4.245288753799392,0.0,40.0
49870,4,9870,[294 597  70 202 435],82,4,41905,4.245263904366325,0.0,0.0
49871,4,9871,[127 161 655 202  71],13,5,41910,4.24534035656402,0.0,20.0
49872,4,9872,[313 127 187 302 318],537,5,41915,4.245416793274587,20.0,20.0
49873,4,9873,[405  22 185 215 135],653,2,41917,4.245189386266964,0.0,0.0
49874,4,9874,[313 127 187 302 318],537,5,41922,4.24526582278481,20.0,20.0
49875,4,9875,[313 127 187 302 318],271,5,41927,4.24534224382341,20.0,20.0
49876,4,9876,[153 175  89 222 234],406,3,41930,4.245216158752657,0.0,0.0
49877,4,9877,[313 127 187 302 318],13,4,41934,4.245191334278194,20.0,20.0
49878,4,9878,[313 127 187 302 318],334,5,41939,4.245267739649762,20.0,20.0
49879,4,9879,[313 127 187 302 318],474,5,41944,4.245344129554656,20.0,20.0
49880,4,9880,[313 127 187 302 318],537,5,41949,4.245420503997571,20.0,20.0
49881,4,9881,[313 127 187 302 318],13,4,41953,4.245395668892937,20.0,20.0
49882,4,9882,[ 56 300 168 475  50],533,3,41956,4.245269654963068,0.0,20.0
49883,4,9883,[  4 286 357  89   7],234,2,41958,4.245042492917847,20.0,0.0
49884,4,9884,[313 127 187 302 318],334,5,41963,4.245118866970157,20.0,20.0
49885,4,9885,[313 127 187 302 318],334,5,41968,4.245195225571515,20.0,20.0
49886,4,9886,[405 273 143 301 234],13,1,41969,4.244866997066856,0.0,0.0
49887,4,9887,[313 127 187 302 318],271,5,41974,4.244943365695793,20.0,20.0
49888,4,9888,[313 127 187 302 318],207,5,41979,4.245019718879563,20.0,20.0
49889,4,9889,[313 127 187 302 318],271,5,41984,4.2450960566228515,20.0,20.0
49890,4,9890,[313 127 187 302 318],13,4,41988,4.24507127691841,20.0,20.0
49891,4,9891,[313 127 187 302 318],328,5,41993,4.245147594015366,20.0,20.0
49892,4,9892,[  4  64 508 186   9],339,5,41998,4.245223895683817,0.0,0.0
49893,4,9893,[176 294 318 483 180],804,5,42003,4.2453001819284415,40.0,0.0
49894,4,9894,[313 127 187 302 318],207,5,42008,4.245376452753916,20.0,20.0
49895,4,9895,[313 127 187 302 318],90,5,42013,4.245452708164915,20.0,20.0
49896,4,9896,[385 258 182 135  96],537,3,42016,4.245326866727291,0.0,0.0
49897,4,9897,[313 127 187 302 318],271,5,42021,4.245403111739745,20.0,20.0
49898,4,9898,[194 568 215 471  96],95,5,42026,4.245479341347611,0.0,0.0
49899,4,9899,[117 153 181  69 151],536,4,42030,4.245454545454545,0.0,0.0
49900,4,9900,[ 79 153 174 132 191],7,5,42035,4.245530754469246,0.0,20.0
49901,4,9901,[313 127 187 302 318],537,5,42040,4.245606948091295,20.0,20.0
49902,4,9902,[313 127 187 302 318],207,5,42045,4.245683126325356,20.0,20.0
49903,4,9903,[313 127 187 302 318],328,5,42050,4.245759289176091,20.0,20.0
49904,4,9904,[313 127 187 302 318],334,5,42055,4.245835436648157,20.0,20.0
49905,4,9905,[588  95 294   9  96],234,0,42055,4.245406824146982,0.0,0.0
49906,4,9906,[313 127 187 302 318],537,5,42060,4.2454829918239625,20.0,20.0
49907,4,9907,[313 127 187 302 318],13,4,42064,4.245458215583367,20.0,20.0
49908,4,9908,[313 127 187 302 318],334,5,42069,4.2455343627005755,20.0,20.0
49909,4,9909,[237 117 748 258  82],92,3,42072,4.245408678102926,0.0,0.0
49910,4,9910,[313 127 187 302 318],271,5,42077,4.245484814852184,20.0,20.0
49911,4,9911,[427  89 117 174 135],343,3,42080,4.245359160613398,0.0,20.0
49912,4,9912,[313 127 187 302 318],334,5,42085,4.245435286996873,20.0,20.0
49913,4,9913,[179   9  28  56  79],271,4,42089,4.2454105305628405,0.0,0.0
49914,4,9914,[313 127 187 302 318],13,4,42093,4.245385779122541,20.0,20.0
49915,4,9915,[313 127 187 302 427],13,5,42098,4.245461879790238,0.0,20.0
49916,4,9916,[313 127 187 302 427],13,5,42103,4.245537965110416,0.0,20.0
49917,4,9917,[313 127 187 302 427],90,5,42108,4.245614035087719,0.0,20.0
49918,4,9918,[181 302 191 515 204],13,3,42111,4.245488456497631,0.0,0.0
49919,4,9919,[313 127 187 302 427],90,5,42116,4.245564516129032,0.0,20.0
49920,4,9920,[313 127 187 302 427],13,5,42121,4.245640560427376,0.0,20.0
49921,4,9921,[313 127 187 302 427],537,5,42126,4.245716589397299,0.0,20.0
49922,4,9922,[597  50 132 179 172],308,3,42129,4.245591051093419,0.0,20.0
49923,4,9923,[313 127 187 302 427],271,5,42134,4.245667069729947,0.0,20.0
49924,4,9924,[313 127 187 302 427],669,5,42139,4.245743073047859,0.0,20.0
49925,4,9925,[313 127 187 302 427],271,5,42144,4.245819061051783,0.0,20.0
49926,4,9926,[313 127 187 302 427],669,5,42149,4.245895033746348,0.0,20.0
49927,4,9927,[313 127 187 302 427],13,5,42154,4.245970991136181,0.0,20.0
49928,4,9928,[313 127 187 302 427],328,4,42158,4.245946218148857,0.0,20.0
49929,4,9929,[313 127 187 302 427],328,4,42162,4.245921450151058,0.0,20.0
49930,4,9930,[313 127 187 302 318],334,5,42167,4.245997381935354,20.0,20.0
49931,4,9931,[313 127 187 302 318],334,5,42172,4.2460732984293195,20.0,20.0
49932,4,9932,[100 237 742 132 294],447,4,42176,4.246048525118293,0.0,20.0
49933,4,9933,[313 127 187 302 318],144,4,42180,4.246023756794846,20.0,20.0
49934,4,9934,[313 127 187 302 318],334,5,42185,4.246099647710116,20.0,20.0
49935,4,9935,[179 322 234 588  96],311,4,42189,4.246074879227053,0.0,0.0
49936,4,9936,[197 275  69   8 471],95,4,42193,4.246050115729093,0.0,0.0
49937,4,9937,[313 127 187 302 318],328,5,42198,4.246125981082713,20.0,20.0
49938,4,9938,[313 127 187 302 318],537,5,42203,4.246201831170138,20.0,20.0
49939,4,9939,[313 127 187 302 318],271,5,42208,4.246277665995976,20.0,20.0
49940,4,9940,[313 127 187 302 318],474,5,42213,4.246353485564833,20.0,20.0
49941,4,9941,[313 127 187 302 318],207,5,42218,4.246429289881312,20.0,20.0
49942,4,9942,[313 127 187 302 318],474,5,42223,4.246505078950015,20.0,20.0
49943,4,9943,[313 127 187 302 318],328,5,42228,4.246580852775543,20.0,20.0
49944,4,9944,[313 127 187 302 318],207,5,42233,4.246656611362494,20.0,20.0
49945,4,9945,[313 127 187 302 318],144,4,42237,4.246631811783631,20.0,20.0
49946,4,9946,[  4 318 210 276  15],234,2,42239,4.246405951543179,20.0,0.0
49947,4,9947,[183 187 127 135 222],311,5,42244,4.2464817048653,0.0,20.0
49948,4,9948,[313 127 187 302 318],474,5,42249,4.246557442959092,20.0,20.0
49949,4,9949,[313 127 187 302 318],537,5,42254,4.246633165829146,20.0,20.0
49950,4,9950,[ 98 176  12 144  56],343,5,42259,4.246708873480053,20.0,20.0
49951,4,9951,[313 127 187 302 318],328,5,42264,4.246784565916399,20.0,20.0
49952,4,9952,[655  11   1 135  82],234,1,42265,4.246458354265045,0.0,0.0
49953,4,9953,[313 127 187 302 318],334,5,42270,4.246534056660639,20.0,20.0
49954,4,9954,[ 98 175  22 289 483],788,4,42274,4.246509291813159,20.0,20.0
49955,4,9955,[313 127 187 302 318],271,5,42279,4.246584973885095,20.0,20.0
49956,4,9956,[313 127 187 302 318],474,5,42284,4.246660640755247,20.0,20.0
49957,4,9957,[ 98 125 100 742 508],334,2,42286,4.246435027113878,0.0,40.0
49958,4,9958,[313 127 187 302 318],537,5,42291,4.246510693844764,20.0,20.0
49959,4,9959,[313 127 187 302 318],537,5,42296,4.246586345381526,20.0,20.0
49960,4,9960,[313 127 187 302 318],474,5,42301,4.246661981728742,20.0,20.0
49961,4,9961,[313 127 187 302 318],334,5,42306,4.246737602890986,20.0,20.0
49962,4,9962,[258  69 200  28 151],380,5,42311,4.24681320887283,0.0,0.0
49963,4,9963,[313 127 187 302 318],13,4,42315,4.246788438378162,20.0,20.0
49964,4,9964,[289 127  70 121 161],533,4,42319,4.246763672854993,0.0,20.0
49965,4,9965,[313 127 187 302 318],334,5,42324,4.24683925346177,20.0,20.0
49966,4,9966,[313 127 187 302 318],271,5,42329,4.246914818902378,20.0,20.0
49967,4,9967,[313 127 187 302 318],90,5,42334,4.246990369181381,20.0,20.0
49968,4,9968,[313 127 187 302 318],328,5,42339,4.247065904303341,20.0,20.0
49969,4,9969,[313 127 187 302 318],328,5,42344,4.247141424272819,20.0,20.0
49970,4,9970,[313 127 187 302 318],271,5,42349,4.247216929094374,20.0,20.0
49971,4,9971,[313 127 187 302 318],144,4,42353,4.247192137986362,20.0,20.0
49972,4,9972,[ 98 427 333 588 471],298,5,42358,4.247267622580969,0.0,20.0
49973,4,9973,[313 127 187 302 318],334,5,42363,4.247343092039302,20.0,20.0
49974,4,9974,[313 127 187 302 318],13,4,42367,4.2473182957393485,20.0,20.0
49975,4,9975,[313 127 187 302 318],328,5,42372,4.2473937449879715,20.0,20.0
49976,4,9976,[313 127 187 302 318],334,5,42377,4.247469179111958,20.0,20.0
49977,4,9977,[168  11 135 175 275],82,3,42380,4.2473441571457204,0.0,0.0
49978,4,9978,[294 300 385 215 328],13,1,42381,4.24701873935264,0.0,0.0
49979,4,9979,[313 127 187 302 318],328,5,42386,4.247094188376754,20.0,20.0
49980,4,9980,[313 127 187 302 318],328,5,42391,4.247169622282336,20.0,20.0
49981,4,9981,[ 98 318 153 294 210],452,4,42395,4.247144860749349,20.0,20.0
49982,4,9982,[313 127 187 302 318],328,5,42400,4.247220274466593,20.0,20.0
49983,4,9983,[313 127 187 302 318],144,4,42404,4.247195512820513,20.0,20.0
49984,4,9984,[313 127 187 302 318],144,4,42408,4.247170756134201,20.0,20.0
49985,4,9985,[286 175   4 180 100],339,5,42413,4.247246144602443,0.0,20.0
49986,4,9986,[313 127 187 302 318],90,5,42418,4.247321517973365,20.0,20.0
49987,4,9987,[168   1 742 181 471],648,5,42423,4.247396876251502,0.0,0.0
49988,4,9988,[313 127 187 302 318],271,5,42428,4.247472219441385,20.0,20.0
49989,4,9989,[313 127 187 302 318],537,5,42433,4.247547547547548,20.0,20.0
49990,4,9990,[313 127 187 302 318],271,5,42438,4.247622860574517,20.0,20.0
49991,4,9991,[313 127 187 302 318],271,5,42443,4.247698158526822,20.0,20.0
49992,4,9992,[313 127 187 302 318],207,5,42448,4.247773441408986,20.0,20.0
49993,4,9993,[385 403 187 127 172],600,3,42451,4.247648589153492,0.0,20.0
49994,4,9994,[313 127 187 302 318],207,5,42456,4.247723861930965,20.0,20.0
49995,4,9995,[313 127 187 302 318],537,5,42461,4.247799119647859,20.0,20.0
49996,4,9996,[286 143 427 496 435],458,4,42465,4.24777433229969,0.0,0.0
49997,4,9997,[161 235 121  96 211],308,2,42467,4.24754950990198,0.0,0.0
49998,4,9998,[ 11 132 323  98 471],378,2,42469,4.247324732473247,0.0,20.0
49999,4,9999,[202 127 302 191 655],666,5,42474,4.2474,0.0,20.0
