,iteration,visit,item_id_list,visitor_id,reward,total_reward,fraction_relevant,percentage_overlap_rating,percentage_overlap_like
0,0,0,[241 219 231 227 452],92,1,1,1.0,0.0,0.0
1,0,1,[300 299 261 264 211],13,2,3,1.5,0.0,40.0
2,0,2,[226 275 326 212 485],311,2,5,1.6666666666666667,0.0,20.0
3,0,3,[226 264 211 275 219],308,2,7,1.75,0.0,40.0
4,0,4,[211 275 226 264 219],13,3,10,2.0,0.0,40.0
5,0,5,[211 275 226 264 219],13,3,13,2.1666666666666665,0.0,40.0
6,0,6,[211 226 264 275 219],308,2,15,2.142857142857143,0.0,40.0
7,0,7,[431 218 303 212 202],13,3,18,2.25,0.0,0.0
8,0,8,[202 211 303 275 226],13,4,22,2.4444444444444446,0.0,40.0
9,0,9,[300 216 240 316 259],145,3,25,2.5,20.0,20.0
10,0,10,[227 230 220 231 583],92,0,25,2.272727272727273,0.0,0.0
11,0,11,[481 209 213 241 221],524,5,30,2.5,0.0,0.0
12,0,12,[316 221 209 303 213],90,5,35,2.6923076923076925,20.0,0.0
13,0,13,[293 481 420 219 275],308,4,39,2.7857142857142856,0.0,20.0
14,0,14,[216 211 481 221 293],6,4,43,2.8666666666666667,0.0,20.0
15,0,15,[226 254 321 259 276],308,1,44,2.75,0.0,20.0
16,0,16,[413 420 250 298 208],843,1,45,2.6470588235294117,0.0,0.0
17,0,17,[508 509 243 217 481],13,1,46,2.5555555555555554,0.0,0.0
18,0,18,[226 303 431 300 230],537,2,48,2.526315789473684,0.0,20.0
19,0,19,[226 243 452 331 217],13,1,49,2.45,0.0,0.0
20,0,20,[226 350 509 326 272],13,3,52,2.4761904761904763,0.0,0.0
21,0,21,[250 276 303 272 209],392,4,56,2.5454545454545454,0.0,20.0
22,0,22,[243 239 275 392 216],537,1,57,2.4782608695652173,0.0,20.0
23,0,23,[218 202 250 429 378],804,5,62,2.5833333333333335,0.0,0.0
24,0,24,[508 246 230 232 378],85,2,64,2.56,0.0,0.0
25,0,25,[255 254 481 485 259],308,2,66,2.5384615384615383,0.0,0.0
26,0,26,[218 240 508 509 231],643,2,68,2.5185185185185186,0.0,0.0
27,0,27,[303 256 344 290 508],894,2,70,2.5,0.0,0.0
28,0,28,[240 378 202 255 303],533,3,73,2.5172413793103448,0.0,0.0
29,0,29,[429 202 209 303 272],537,3,76,2.533333333333333,0.0,0.0
30,0,30,[209 303 272 213 246],6,3,79,2.5483870967741935,0.0,0.0
31,0,31,[276 209 272 213 221],537,4,83,2.59375,0.0,20.0
32,0,32,[226 367 202 222 227],650,1,84,2.5454545454545454,0.0,20.0
33,0,33,[300 420 208 392 485],311,3,87,2.5588235294117645,0.0,20.0
34,0,34,[420 429 254 232 230],749,3,90,2.5714285714285716,0.0,0.0
35,0,35,[303 299 218 394 230],13,1,91,2.5277777777777777,0.0,0.0
36,0,36,[215 218 350 315 226],13,3,94,2.5405405405405403,20.0,0.0
37,0,37,[316 215 272 222 378],454,3,97,2.5526315789473686,20.0,20.0
38,0,38,[316 344 272 209 276],392,5,102,2.6153846153846154,20.0,20.0
39,0,39,[316 344 272 209 276],13,3,105,2.625,20.0,20.0
40,0,40,[218 275 227 222 215],60,5,110,2.682926829268293,0.0,40.0
41,0,41,[316 213 272 276 215],161,3,113,2.6904761904761907,20.0,20.0
42,0,42,[208 378 481 321 275],308,3,116,2.697674418604651,0.0,20.0
43,0,43,[316 315 272 276 211],13,5,121,2.75,40.0,40.0
44,0,44,[244 336 255 297 220],486,1,122,2.7111111111111112,20.0,0.0
45,0,45,[315 316 367 485 283],454,4,126,2.739130434782609,40.0,0.0
46,0,46,[378 213 275 209 231],537,3,129,2.74468085106383,0.0,20.0
47,0,47,[509 315 485 272 452],13,3,132,2.75,20.0,0.0
48,0,48,[315 431 507 485 221],537,3,135,2.7551020408163267,20.0,0.0
49,0,49,[481 222 326 336 276],13,1,136,2.72,0.0,40.0
50,0,50,[295 227 202 231 206],387,2,138,2.7058823529411766,0.0,0.0
51,0,51,[211 276 478 209 284],474,5,143,2.75,0.0,40.0
52,0,52,[220 478 272 268 509],90,5,148,2.792452830188679,0.0,0.0
53,0,53,[216 230 217 226 290],648,3,151,2.7962962962962963,0.0,0.0
54,0,54,[280 216 331 507 243],13,1,152,2.7636363636363637,0.0,0.0
55,0,55,[218 250 211 215 367],648,2,154,2.75,0.0,20.0
56,0,56,[431 429 291 230 219],833,1,155,2.719298245614035,0.0,0.0
57,0,57,[230 220 202 583 216],59,4,159,2.7413793103448274,0.0,0.0
58,0,58,[481 384 431 215 508],13,1,160,2.711864406779661,0.0,0.0
59,0,59,[211 276 367 420 290],13,4,164,2.7333333333333334,0.0,40.0
60,0,60,[231 201 268 509 300],13,2,166,2.721311475409836,0.0,20.0
61,0,61,[211 206 321 230 209],537,2,168,2.7096774193548385,0.0,20.0
62,0,62,[218 321 276 431 336],13,1,169,2.6825396825396823,0.0,20.0
63,0,63,[478 276 280 272 315],13,5,174,2.71875,20.0,20.0
64,0,64,[231 344 208 315 211],13,3,177,2.723076923076923,20.0,20.0
65,0,65,[481 301 212 215 211],90,4,181,2.742424242424242,0.0,20.0
66,0,66,[485 254 208 293 429],749,4,185,2.7611940298507465,0.0,0.0
67,0,67,[301 211 478 272 297],6,3,188,2.764705882352941,20.0,20.0
68,0,68,[222 230 315 452 215],650,2,190,2.753623188405797,20.0,20.0
69,0,69,[316 211 478 272 276],13,5,195,2.7857142857142856,20.0,40.0
70,0,70,[316 211 478 272 276],90,5,200,2.816901408450704,20.0,40.0
71,0,71,[316 211 478 272 276],90,5,205,2.8472222222222223,20.0,40.0
72,0,72,[316 211 478 272 276],13,5,210,2.8767123287671232,20.0,40.0
73,0,73,[303 218 295 211 243],533,3,213,2.8783783783783785,0.0,20.0
74,0,74,[280 211 316 272 268],13,5,218,2.9066666666666667,20.0,20.0
75,0,75,[280 211 316 272 268],13,5,223,2.9342105263157894,20.0,20.0
76,0,76,[272 413 331 326 215],13,2,225,2.9220779220779223,0.0,0.0
77,0,77,[276 280 478 272 268],13,5,230,2.948717948717949,0.0,20.0
78,0,78,[276 280 478 272 268],13,5,235,2.9746835443037973,0.0,20.0
79,0,79,[276 280 478 272 268],13,5,240,3.0,0.0,20.0
80,0,80,[276 280 478 272 268],13,5,245,3.0246913580246915,0.0,20.0
81,0,81,[276 280 478 272 268],13,5,250,3.048780487804878,0.0,20.0
82,0,82,[251 209 283 216 367],883,4,254,3.0602409638554215,20.0,0.0
83,0,83,[272 291 208 209 290],537,3,257,3.0595238095238093,0.0,0.0
84,0,84,[268 221 291 378 213],537,2,259,3.0470588235294116,0.0,0.0
85,0,85,[394 227 452 316 276],13,3,262,3.046511627906977,20.0,20.0
86,0,86,[208 206 291 303 201],537,2,264,3.0344827586206895,0.0,0.0
87,0,87,[326 429 481 367 420],13,2,266,3.022727272727273,0.0,0.0
88,0,88,[216 394 231 223 232],13,1,267,3.0,20.0,0.0
89,0,89,[283 241 481 276 243],234,1,268,2.977777777777778,0.0,20.0
90,0,90,[326 220 239 365 276],378,1,269,2.956043956043956,0.0,20.0
91,0,91,[227 298 216 230 241],378,2,271,2.9456521739130435,0.0,0.0
92,0,92,[275 212 226 272 231],13,3,274,2.946236559139785,0.0,20.0
93,0,93,[217 212 215 202 344],13,3,277,2.9468085106382977,0.0,0.0
94,0,94,[384 215 481 218 241],13,1,278,2.9263157894736844,0.0,0.0
95,0,95,[202 452 232 254 218],774,1,279,2.90625,0.0,0.0
96,0,96,[232 213 226 485 321],194,0,279,2.8762886597938144,0.0,0.0
97,0,97,[420 315 508 413 452],13,2,281,2.86734693877551,20.0,0.0
98,0,98,[276 222 261 227 485],13,2,283,2.8585858585858586,0.0,40.0
99,0,99,[485 508 331 481 226],13,1,284,2.84,0.0,0.0
100,0,100,[299 301 413 246 216],145,4,288,2.8514851485148514,0.0,0.0
101,0,101,[215 429 251 217 283],385,1,289,2.8333333333333335,20.0,0.0
102,0,102,[316 284 223 478 268],234,1,290,2.8155339805825244,40.0,0.0
103,0,103,[344 212 290 223 429],13,4,294,2.826923076923077,20.0,0.0
104,0,104,[316 211 272 280 276],13,5,299,2.8476190476190477,20.0,40.0
105,0,105,[316 211 272 280 276],13,5,304,2.8679245283018866,20.0,40.0
106,0,106,[201 216 239 485 275],13,1,305,2.850467289719626,0.0,20.0
107,0,107,[218 230 275 280 321],13,1,306,2.8333333333333335,0.0,20.0
108,0,108,[209 509 431 315 215],474,5,311,2.853211009174312,20.0,0.0
109,0,109,[239 212 223 350 384],13,3,314,2.8545454545454545,20.0,0.0
110,0,110,[272 226 485 232 231],650,1,315,2.8378378378378377,0.0,0.0
111,0,111,[316 211 272 280 276],13,5,320,2.857142857142857,20.0,40.0
112,0,112,[316 211 272 280 276],13,5,325,2.8761061946902653,20.0,40.0
113,0,113,[316 211 272 280 276],13,5,330,2.8947368421052633,20.0,40.0
114,0,114,[316 211 272 280 276],13,5,335,2.9130434782608696,20.0,40.0
115,0,115,[316 211 272 280 276],13,5,340,2.9310344827586206,20.0,40.0
116,0,116,[250 218 227 226 202],506,3,343,2.9316239316239314,0.0,0.0
117,0,117,[583 291 226 243 218],92,2,345,2.9237288135593222,0.0,0.0
118,0,118,[316 211 272 280 276],13,5,350,2.9411764705882355,20.0,40.0
119,0,119,[316 211 272 280 276],13,5,355,2.9583333333333335,20.0,40.0
120,0,120,[219 365 227 284 206],804,3,358,2.958677685950413,0.0,0.0
121,0,121,[275 508 268 298 297],894,2,360,2.9508196721311477,20.0,20.0
122,0,122,[315 232 226 299 431],328,1,361,2.934959349593496,20.0,0.0
123,0,123,[367 227 303 394 431],13,2,363,2.9274193548387095,0.0,0.0
124,0,124,[208 431 485 213 219],406,0,363,2.904,0.0,0.0
125,0,125,[211 272 316 280 276],13,5,368,2.9206349206349205,20.0,40.0
126,0,126,[211 272 316 280 276],13,5,373,2.937007874015748,20.0,40.0
127,0,127,[223 240 452 276 202],92,2,375,2.9296875,20.0,20.0
128,0,128,[316 272 280 211 276],13,5,380,2.945736434108527,20.0,40.0
129,0,129,[316 272 280 211 276],13,5,385,2.9615384615384617,20.0,40.0
130,0,130,[316 272 280 211 276],13,5,390,2.9770992366412212,20.0,40.0
131,0,131,[316 272 280 211 276],13,5,395,2.992424242424242,20.0,40.0
132,0,132,[316 272 280 211 276],13,5,400,3.007518796992481,20.0,40.0
133,0,133,[316 272 280 211 276],13,5,405,3.0223880597014925,20.0,40.0
134,0,134,[508 211 276 431 220],59,4,409,3.0296296296296297,0.0,40.0
135,0,135,[223 236 293 255 272],334,3,412,3.0294117647058822,20.0,0.0
136,0,136,[219 378 316 241 429],234,3,415,3.0291970802919708,20.0,0.0
137,0,137,[429 508 211 303 227],13,4,419,3.036231884057971,0.0,20.0
138,0,138,[478 239 209 280 222],749,4,423,3.0431654676258995,0.0,20.0
139,0,139,[201 507 485 290 250],385,2,425,3.0357142857142856,0.0,0.0
140,0,140,[241 276 202 283 236],234,0,425,3.0141843971631204,0.0,20.0
141,0,141,[316 211 272 280 276],13,5,430,3.028169014084507,20.0,40.0
142,0,142,[316 211 272 280 276],13,5,435,3.041958041958042,20.0,40.0
143,0,143,[315 250 508 255 297],931,4,439,3.048611111111111,40.0,0.0
144,0,144,[316 211 272 280 276],13,5,444,3.0620689655172413,20.0,40.0
145,0,145,[316 211 272 280 276],13,5,449,3.0753424657534247,20.0,40.0
146,0,146,[316 211 272 280 276],13,5,454,3.0884353741496597,20.0,40.0
147,0,147,[378 211 478 231 291],537,2,456,3.081081081081081,0.0,20.0
148,0,148,[208 246 222 508 218],92,5,461,3.0939597315436242,0.0,20.0
149,0,149,[316 211 272 280 276],13,5,466,3.1066666666666665,20.0,40.0
150,0,150,[250 217 508 275 218],334,1,467,3.0927152317880795,0.0,20.0
151,0,151,[316 211 272 280 276],13,5,472,3.1052631578947367,20.0,40.0
152,0,152,[316 211 272 280 276],13,5,477,3.1176470588235294,20.0,40.0
153,0,153,[316 211 272 280 276],13,5,482,3.1298701298701297,20.0,40.0
154,0,154,[316 211 272 280 276],13,5,487,3.141935483870968,20.0,40.0
155,0,155,[316 211 272 280 276],13,5,492,3.1538461538461537,20.0,40.0
156,0,156,[316 211 272 280 276],13,5,497,3.1656050955414012,20.0,40.0
157,0,157,[316 211 272 280 276],13,5,502,3.1772151898734178,20.0,40.0
158,0,158,[316 211 272 280 276],13,5,507,3.188679245283019,20.0,40.0
159,0,159,[316 211 272 280 276],13,5,512,3.2,20.0,40.0
160,0,160,[316 211 272 280 276],13,5,517,3.2111801242236027,20.0,40.0
161,0,161,[303 367 216 276 481],13,2,519,3.2037037037037037,0.0,20.0
162,0,162,[331 268 316 240 212],145,3,522,3.2024539877300615,20.0,0.0
163,0,163,[222 231 431 301 202],13,1,523,3.1890243902439024,0.0,20.0
164,0,164,[280 211 316 272 276],13,5,528,3.2,20.0,40.0
165,0,165,[280 211 316 272 276],13,5,533,3.210843373493976,20.0,40.0
166,0,166,[280 211 316 272 276],13,5,538,3.2215568862275448,20.0,40.0
167,0,167,[261 299 478 316 508],13,2,540,3.2142857142857144,20.0,0.0
168,0,168,[280 211 316 272 276],13,5,545,3.224852071005917,20.0,40.0
169,0,169,[280 211 316 272 276],13,5,550,3.235294117647059,20.0,40.0
170,0,170,[209 243 429 223 268],13,3,553,3.2339181286549707,20.0,0.0
171,0,171,[365 272 231 485 223],378,3,556,3.2325581395348837,20.0,0.0
172,0,172,[212 218 250 413 290],804,4,560,3.2369942196531793,0.0,0.0
173,0,173,[324 230 255 211 261],479,2,562,3.2298850574712645,0.0,20.0
174,0,174,[280 211 272 316 276],13,5,567,3.24,20.0,40.0
175,0,175,[280 211 272 316 276],13,5,572,3.25,20.0,40.0
176,0,176,[280 211 272 316 276],13,5,577,3.2598870056497176,20.0,40.0
177,0,177,[213 215 209 283 268],537,4,581,3.264044943820225,0.0,0.0
178,0,178,[217 315 275 384 227],13,2,583,3.2569832402234637,20.0,20.0
179,0,179,[215 367 508 213 509],653,1,584,3.2444444444444445,0.0,0.0
180,0,180,[213 230 508 239 227],653,1,585,3.2320441988950277,0.0,0.0
181,0,181,[280 211 272 316 276],13,5,590,3.241758241758242,20.0,40.0
182,0,182,[280 211 272 316 276],13,5,595,3.251366120218579,20.0,40.0
183,0,183,[413 239 212 452 508],13,2,597,3.244565217391304,0.0,0.0
184,0,184,[431 367 275 239 226],158,3,600,3.2432432432432434,0.0,20.0
185,0,185,[390 268 264 299 350],116,2,602,3.236559139784946,0.0,0.0
186,0,186,[268 275 272 508 298],6,2,604,3.229946524064171,0.0,20.0
187,0,187,[331 276 284 336 344],894,3,607,3.228723404255319,0.0,20.0
188,0,188,[276 293 350 244 324],894,3,610,3.2275132275132274,0.0,20.0
189,0,189,[226 211 299 218 243],13,2,612,3.221052631578947,0.0,20.0
190,0,190,[268 300 226 216 202],234,0,612,3.2041884816753927,0.0,20.0
191,0,191,[275 413 280 350 208],13,2,614,3.1979166666666665,0.0,20.0
192,0,192,[231 212 226 384 223],7,2,616,3.1917098445595853,20.0,0.0
193,0,193,[303 316 300 215 209],144,3,619,3.1907216494845363,20.0,20.0
194,0,194,[508 272 315 509 230],537,4,623,3.194871794871795,20.0,0.0
195,0,195,[485 215 429 211 208],897,4,627,3.1989795918367347,0.0,20.0
196,0,196,[303 217 315 218 239],13,3,630,3.197969543147208,20.0,0.0
197,0,197,[367 264 429 241 219],7,4,634,3.202020202020202,0.0,0.0
198,0,198,[243 485 300 226 211],13,2,636,3.1959798994974875,0.0,40.0
199,0,199,[331 394 264 272 212],13,3,639,3.195,0.0,0.0
200,0,200,[321 365 420 295 215],308,1,640,3.18407960199005,0.0,0.0
201,0,201,[264 212 303 295 256],894,2,642,3.1782178217821784,0.0,0.0
202,0,202,[298 223 239 218 276],378,2,644,3.1724137931034484,20.0,20.0
203,0,203,[250 222 208 300 211],85,2,646,3.1666666666666665,0.0,60.0
204,0,204,[268 299 276 316 202],13,4,650,3.1707317073170733,20.0,20.0
205,0,205,[231 507 206 508 222],537,2,652,3.1650485436893203,0.0,20.0
206,0,206,[276 283 254 227 280],378,2,654,3.1594202898550723,0.0,20.0
207,0,207,[299 300 326 331 272],724,2,656,3.1538461538461537,0.0,20.0
208,0,208,[367 478 226 431 239],194,1,657,3.1435406698564594,0.0,0.0
209,0,209,[250 217 275 298 226],648,3,660,3.142857142857143,0.0,20.0
210,0,210,[268 251 295 508 220],486,2,662,3.137440758293839,20.0,0.0
211,0,211,[268 431 365 384 507],7,3,665,3.1367924528301887,0.0,0.0
212,0,212,[420 276 326 280 254],378,2,667,3.131455399061033,0.0,20.0
213,0,213,[211 378 236 275 284],537,2,669,3.1261682242990654,0.0,40.0
214,0,214,[583 231 429 239 201],308,3,672,3.125581395348837,0.0,0.0
215,0,215,[481 485 299 300 215],13,1,673,3.115740740740741,0.0,20.0
216,0,216,[218 216 231 291 215],648,1,674,3.1059907834101383,0.0,0.0
217,0,217,[326 221 336 290 236],894,2,676,3.1009174311926606,0.0,0.0
218,0,218,[321 241 350 290 384],13,1,677,3.0913242009132422,0.0,0.0
219,0,219,[227 201 275 280 326],13,2,679,3.0863636363636364,0.0,20.0
220,0,220,[219 283 485 250 201],385,2,681,3.081447963800905,0.0,0.0
221,0,221,[272 336 326 324 246],894,2,683,3.0765765765765765,0.0,0.0
222,0,222,[227 420 315 223 290],650,0,683,3.062780269058296,40.0,0.0
223,0,223,[300 275 202 272 301],871,3,686,3.0625,0.0,40.0
224,0,224,[429 420 223 213 218],308,5,691,3.071111111111111,20.0,0.0
225,0,225,[220 284 276 291 226],92,2,693,3.066371681415929,0.0,20.0
226,0,226,[283 217 216 230 280],378,2,695,3.0616740088105727,0.0,0.0
227,0,227,[507 326 303 222 272],13,2,697,3.057017543859649,0.0,20.0
228,0,228,[367 202 431 272 216],766,1,698,3.0480349344978164,0.0,0.0
229,0,229,[350 231 481 478 276],13,2,700,3.0434782608695654,0.0,20.0
230,0,230,[268 226 413 239 215],13,4,704,3.0476190476190474,0.0,0.0
231,0,231,[350 413 275 201 241],13,0,704,3.0344827586206895,0.0,20.0
232,0,232,[206 239 215 276 216],406,1,705,3.0257510729613735,0.0,20.0
233,0,233,[420 216 321 217 301],13,1,706,3.017094017094017,0.0,0.0
234,0,234,[240 241 431 284 321],59,3,709,3.0170212765957447,0.0,0.0
235,0,235,[350 211 202 344 431],13,2,711,3.01271186440678,0.0,20.0
236,0,236,[208 275 272 217 255],334,3,714,3.0126582278481013,0.0,20.0
237,0,237,[452 212 326 336 300],13,1,715,3.004201680672269,0.0,20.0
238,0,238,[350 241 481 239 276],13,2,717,3.0,0.0,20.0
239,0,239,[226 215 293 255 420],308,3,720,3.0,0.0,0.0
240,0,240,[256 280 244 221 326],894,2,722,2.995850622406639,0.0,0.0
241,0,241,[221 316 300 315 293],334,3,725,2.9958677685950414,40.0,20.0
242,0,242,[213 212 315 209 236],537,3,728,2.9958847736625516,20.0,0.0
243,0,243,[367 452 508 485 216],406,2,730,2.9918032786885247,0.0,0.0
244,0,244,[316 256 276 331 241],883,4,734,2.9959183673469387,20.0,20.0
245,0,245,[259 378 236 216 284],537,0,734,2.983739837398374,0.0,0.0
246,0,246,[231 217 241 239 227],378,1,735,2.9757085020242915,0.0,0.0
247,0,247,[264 276 392 429 293],308,4,739,2.9798387096774195,0.0,20.0
248,0,248,[507 213 276 212 230],537,3,742,2.9799196787148596,0.0,20.0
249,0,249,[227 431 478 231 223],749,5,747,2.988,20.0,0.0
250,0,250,[223 241 218 300 220],90,4,751,2.99203187250996,20.0,20.0
251,0,251,[246 300 268 276 222],486,2,753,2.988095238095238,0.0,60.0
252,0,252,[223 211 293 226 230],387,3,756,2.9881422924901186,20.0,20.0
253,0,253,[324 508 208 201 211],527,2,758,2.984251968503937,0.0,20.0
254,0,254,[298 284 259 240 216],145,3,761,2.984313725490196,0.0,0.0
255,0,255,[222 478 212 291 211],537,2,763,2.98046875,0.0,40.0
256,0,256,[283 284 226 301 291],234,0,763,2.9688715953307394,0.0,0.0
257,0,257,[301 394 290 315 243],13,2,765,2.9651162790697674,20.0,0.0
258,0,258,[321 218 215 227 280],378,1,766,2.9575289575289574,0.0,0.0
259,0,259,[284 218 220 227 291],374,2,768,2.953846153846154,0.0,0.0
260,0,260,[268 216 280 429 413],13,3,771,2.954022988505747,0.0,0.0
261,0,261,[241 326 298 254 295],378,1,772,2.946564885496183,0.0,0.0
262,0,262,[226 394 230 315 215],13,3,775,2.946768060836502,20.0,0.0
263,0,263,[202 230 259 390 431],279,3,778,2.946969696969697,0.0,0.0
264,0,264,[316 211 272 276 303],13,5,783,2.9547169811320755,20.0,40.0
265,0,265,[316 211 272 276 303],13,5,788,2.962406015037594,20.0,40.0
266,0,266,[481 223 485 413 315],13,2,790,2.958801498127341,40.0,0.0
267,0,267,[316 211 272 276 303],13,5,795,2.966417910447761,20.0,40.0
268,0,268,[316 211 272 276 303],13,5,800,2.973977695167286,20.0,40.0
269,0,269,[316 211 272 276 303],13,5,805,2.9814814814814814,20.0,40.0
270,0,270,[316 211 272 276 303],13,5,810,2.988929889298893,20.0,40.0
271,0,271,[316 211 272 276 303],13,5,815,2.9963235294117645,20.0,40.0
272,0,272,[241 222 264 215 394],13,2,817,2.9926739926739927,0.0,20.0
273,0,273,[316 211 272 276 303],90,5,822,3.0,20.0,40.0
274,0,274,[316 211 272 276 303],13,5,827,3.0072727272727273,20.0,40.0
275,0,275,[316 211 272 276 303],90,5,832,3.0144927536231885,20.0,40.0
276,0,276,[316 211 272 276 303],13,5,837,3.0216606498194944,20.0,40.0
277,0,277,[316 211 272 276 303],13,5,842,3.028776978417266,20.0,40.0
278,0,278,[316 211 272 276 303],13,5,847,3.03584229390681,20.0,40.0
279,0,279,[316 211 272 276 303],13,5,852,3.0428571428571427,20.0,40.0
280,0,280,[316 211 272 276 303],90,5,857,3.0498220640569396,20.0,40.0
281,0,281,[316 211 272 276 303],13,5,862,3.0567375886524824,20.0,40.0
282,0,282,[316 211 272 276 303],90,5,867,3.0636042402826855,20.0,40.0
283,0,283,[316 211 272 276 303],13,5,872,3.0704225352112675,20.0,40.0
284,0,284,[261 275 222 272 241],13,1,873,3.0631578947368423,0.0,40.0
285,0,285,[316 211 272 276 303],90,5,878,3.06993006993007,20.0,40.0
286,0,286,[316 211 272 276 303],90,5,883,3.076655052264808,20.0,40.0
287,0,287,[316 211 272 276 303],13,5,888,3.0833333333333335,20.0,40.0
288,0,288,[300 208 509 378 431],311,4,892,3.086505190311419,0.0,20.0
289,0,289,[316 211 272 276 303],90,5,897,3.093103448275862,20.0,40.0
290,0,290,[429 336 316 268 350],13,3,900,3.0927835051546393,20.0,0.0
291,0,291,[316 211 272 276 303],13,5,905,3.0993150684931505,20.0,40.0
292,0,292,[316 211 272 276 303],90,5,910,3.10580204778157,20.0,40.0
293,0,293,[316 211 272 276 303],13,5,915,3.1122448979591835,20.0,40.0
294,0,294,[316 211 272 276 303],90,5,920,3.1186440677966103,20.0,40.0
295,0,295,[316 211 272 276 303],90,5,925,3.125,20.0,40.0
296,0,296,[316 211 272 276 303],13,5,930,3.1313131313131315,20.0,40.0
297,0,297,[316 211 272 276 303],13,5,935,3.1375838926174495,20.0,40.0
298,0,298,[316 211 272 276 303],13,5,940,3.1438127090301005,20.0,40.0
299,0,299,[316 211 272 276 303],90,5,945,3.15,20.0,40.0
300,0,300,[316 211 272 276 303],90,5,950,3.1561461794019934,20.0,40.0
301,0,301,[280 303 315 284 283],894,2,952,3.152317880794702,20.0,0.0
302,0,302,[316 211 272 276 303],90,5,957,3.1584158415841586,20.0,40.0
303,0,303,[316 211 272 276 303],13,5,962,3.164473684210526,20.0,40.0
304,0,304,[316 211 272 276 303],90,5,967,3.1704918032786886,20.0,40.0
305,0,305,[316 211 272 276 303],13,5,972,3.176470588235294,20.0,40.0
306,0,306,[316 211 272 276 303],90,5,977,3.182410423452769,20.0,40.0
307,0,307,[316 211 272 276 303],90,5,982,3.188311688311688,20.0,40.0
308,0,308,[316 211 272 276 303],13,5,987,3.1941747572815533,20.0,40.0
309,0,309,[230 293 431 429 223],749,4,991,3.196774193548387,20.0,0.0
310,0,310,[316 211 272 276 303],90,5,996,3.202572347266881,20.0,40.0
311,0,311,[246 239 220 268 583],92,3,999,3.201923076923077,0.0,0.0
312,0,312,[275 215 250 208 211],843,1,1000,3.194888178913738,0.0,40.0
313,0,313,[316 272 211 276 303],90,5,1005,3.200636942675159,20.0,40.0
314,0,314,[316 272 211 276 303],90,5,1010,3.2063492063492065,20.0,40.0
315,0,315,[222 212 241 429 211],524,3,1013,3.2056962025316458,0.0,40.0
316,0,316,[221 350 324 246 508],894,2,1015,3.2018927444794953,0.0,0.0
317,0,317,[316 272 211 276 303],13,5,1020,3.207547169811321,20.0,40.0
318,0,318,[300 243 420 394 478],13,2,1022,3.2037617554858935,0.0,20.0
319,0,319,[316 272 211 276 303],90,5,1027,3.209375,20.0,40.0
320,0,320,[316 272 211 276 303],13,5,1032,3.2149532710280373,20.0,40.0
321,0,321,[378 231 212 431 232],650,0,1032,3.2049689440993787,0.0,0.0
322,0,322,[316 272 211 276 303],13,5,1037,3.210526315789474,20.0,40.0
323,0,323,[316 272 211 303 276],90,5,1042,3.2160493827160495,20.0,40.0
324,0,324,[316 272 211 303 276],13,5,1047,3.2215384615384615,20.0,40.0
325,0,325,[316 272 211 303 276],90,5,1052,3.226993865030675,20.0,40.0
326,0,326,[316 272 211 303 276],90,5,1057,3.232415902140673,20.0,40.0
327,0,327,[316 272 211 303 276],13,5,1062,3.2378048780487805,20.0,40.0
328,0,328,[316 272 211 303 276],90,5,1067,3.243161094224924,20.0,40.0
329,0,329,[316 272 211 303 276],13,5,1072,3.2484848484848485,20.0,40.0
330,0,330,[208 256 367 236 201],385,3,1075,3.2477341389728096,0.0,0.0
331,0,331,[217 243 367 216 303],13,1,1076,3.2409638554216866,0.0,0.0
332,0,332,[316 272 211 303 276],90,5,1081,3.2462462462462462,20.0,40.0
333,0,333,[264 485 209 478 231],13,2,1083,3.2425149700598803,0.0,0.0
334,0,334,[284 297 509 246 508],6,1,1084,3.235820895522388,20.0,0.0
335,0,335,[222 420 227 280 272],378,2,1086,3.232142857142857,0.0,20.0
336,0,336,[316 272 211 303 276],13,5,1091,3.2373887240356085,20.0,40.0
337,0,337,[316 272 211 303 276],90,5,1096,3.242603550295858,20.0,40.0
338,0,338,[316 272 211 303 276],13,5,1101,3.247787610619469,20.0,40.0
339,0,339,[316 272 211 303 276],13,5,1106,3.2529411764705882,20.0,40.0
340,0,340,[316 272 211 303 276],90,5,1111,3.2580645161290325,20.0,40.0
341,0,341,[316 272 211 303 276],90,5,1116,3.263157894736842,20.0,40.0
342,0,342,[208 202 431 232 240],749,4,1120,3.2653061224489797,0.0,0.0
343,0,343,[316 272 211 303 276],13,5,1125,3.270348837209302,20.0,40.0
344,0,344,[344 394 485 202 208],13,2,1127,3.2666666666666666,0.0,0.0
345,0,345,[316 272 211 303 276],90,5,1132,3.2716763005780347,20.0,40.0
346,0,346,[316 272 211 303 276],13,5,1137,3.276657060518732,20.0,40.0
347,0,347,[316 272 211 303 276],13,5,1142,3.281609195402299,20.0,40.0
348,0,348,[316 272 211 303 276],13,5,1147,3.286532951289398,20.0,40.0
349,0,349,[316 272 211 303 276],90,5,1152,3.2914285714285714,20.0,40.0
350,0,350,[316 272 211 303 276],13,5,1157,3.2962962962962963,20.0,40.0
351,0,351,[316 272 211 303 276],90,5,1162,3.3011363636363638,20.0,40.0
352,0,352,[350 300 336 384 264],13,1,1163,3.2946175637393766,0.0,20.0
353,0,353,[316 272 211 303 276],13,5,1168,3.2994350282485874,20.0,40.0
354,0,354,[316 272 211 303 276],90,5,1173,3.304225352112676,20.0,40.0
355,0,355,[316 272 211 303 276],90,5,1178,3.308988764044944,20.0,40.0
356,0,356,[316 272 211 303 276],90,5,1183,3.3137254901960786,20.0,40.0
357,0,357,[209 236 239 268 255],334,2,1185,3.310055865921788,0.0,0.0
358,0,358,[316 272 211 303 276],13,5,1190,3.3147632311977717,20.0,40.0
359,0,359,[268 507 211 241 429],537,3,1193,3.313888888888889,0.0,20.0
360,0,360,[226 508 272 293 219],653,1,1194,3.3074792243767313,0.0,0.0
361,0,361,[316 272 211 303 276],90,5,1199,3.3121546961325965,20.0,40.0
362,0,362,[316 272 211 303 276],13,5,1204,3.316804407713499,20.0,40.0
363,0,363,[316 272 211 303 276],90,5,1209,3.3214285714285716,20.0,40.0
364,0,364,[291 222 280 223 231],374,2,1211,3.317808219178082,20.0,20.0
365,0,365,[316 272 211 303 276],13,5,1216,3.3224043715846996,20.0,40.0
366,0,366,[316 272 211 303 276],90,5,1221,3.326975476839237,20.0,40.0
367,0,367,[316 272 211 303 276],13,5,1226,3.3315217391304346,20.0,40.0
368,0,368,[316 272 211 303 276],90,5,1231,3.3360433604336044,20.0,40.0
369,0,369,[219 485 290 481 241],234,1,1232,3.32972972972973,0.0,0.0
370,0,370,[316 272 211 303 276],13,5,1237,3.334231805929919,20.0,40.0
371,0,371,[316 272 211 303 276],90,5,1242,3.338709677419355,20.0,40.0
372,0,372,[300 213 227 232 507],7,2,1244,3.3351206434316354,0.0,20.0
373,0,373,[227 316 420 208 222],13,4,1248,3.336898395721925,20.0,20.0
374,0,374,[316 272 211 303 276],13,5,1253,3.3413333333333335,20.0,40.0
375,0,375,[303 321 212 481 268],13,3,1256,3.3404255319148937,0.0,0.0
376,0,376,[301 326 429 367 227],13,2,1258,3.336870026525199,0.0,0.0
377,0,377,[316 272 211 303 276],13,5,1263,3.3412698412698414,20.0,40.0
378,0,378,[316 272 211 303 276],90,5,1268,3.345646437994723,20.0,40.0
379,0,379,[344 331 481 232 394],13,0,1268,3.336842105263158,0.0,0.0
380,0,380,[316 272 211 303 276],13,5,1273,3.341207349081365,20.0,40.0
381,0,381,[316 272 211 303 276],13,5,1278,3.345549738219895,20.0,40.0
382,0,382,[316 272 211 303 276],13,5,1283,3.349869451697128,20.0,40.0
383,0,383,[478 378 216 431 232],650,2,1285,3.3463541666666665,0.0,0.0
384,0,384,[316 272 211 303 276],90,5,1290,3.3506493506493507,20.0,40.0
385,0,385,[316 272 211 303 276],13,5,1295,3.354922279792746,20.0,40.0
386,0,386,[316 272 211 303 276],90,5,1300,3.359173126614987,20.0,40.0
387,0,387,[316 272 211 303 276],13,5,1305,3.36340206185567,20.0,40.0
388,0,388,[208 212 290 206 202],804,3,1308,3.3624678663239074,0.0,0.0
389,0,389,[316 272 211 303 276],90,5,1313,3.3666666666666667,20.0,40.0
390,0,390,[316 272 211 303 276],90,5,1318,3.370843989769821,20.0,40.0
391,0,391,[316 272 211 303 276],90,5,1323,3.375,20.0,40.0
392,0,392,[316 272 211 303 276],13,5,1328,3.3791348600508906,20.0,40.0
393,0,393,[316 272 211 303 276],13,5,1333,3.383248730964467,20.0,40.0
394,0,394,[316 272 211 303 276],90,5,1338,3.3873417721518986,20.0,40.0
395,0,395,[316 272 211 303 276],90,5,1343,3.3914141414141414,20.0,40.0
396,0,396,[316 272 211 303 276],13,5,1348,3.395465994962217,20.0,40.0
397,0,397,[316 272 211 303 276],90,5,1353,3.399497487437186,20.0,40.0
398,0,398,[316 272 211 303 276],13,5,1358,3.4035087719298245,20.0,40.0
399,0,399,[316 272 211 303 276],13,5,1363,3.4075,20.0,40.0
400,0,400,[316 272 211 303 276],90,5,1368,3.4114713216957604,20.0,40.0
401,0,401,[316 272 211 303 276],13,5,1373,3.415422885572139,20.0,40.0
402,0,402,[316 272 211 303 276],90,5,1378,3.4193548387096775,20.0,40.0
403,0,403,[316 272 211 303 276],90,5,1383,3.4232673267326734,20.0,40.0
404,0,404,[264 324 275 301 284],486,3,1386,3.422222222222222,0.0,20.0
405,0,405,[316 272 211 303 276],90,5,1391,3.4261083743842367,20.0,40.0
406,0,406,[316 272 211 303 276],13,5,1396,3.42997542997543,20.0,40.0
407,0,407,[241 215 283 213 478],85,3,1399,3.428921568627451,0.0,0.0
408,0,408,[316 272 211 303 276],13,5,1404,3.432762836185819,20.0,40.0
409,0,409,[280 209 223 268 326],13,3,1407,3.4317073170731707,20.0,0.0
410,0,410,[316 272 211 303 276],90,5,1412,3.435523114355231,20.0,40.0
411,0,411,[230 232 246 283 478],85,2,1414,3.4320388349514563,0.0,0.0
412,0,412,[316 272 211 303 276],13,5,1419,3.4358353510895885,20.0,40.0
413,0,413,[316 272 211 303 276],13,5,1424,3.4396135265700485,20.0,40.0
414,0,414,[316 272 211 303 276],13,5,1429,3.4433734939759035,20.0,40.0
415,0,415,[208 212 272 215 230],85,3,1432,3.4423076923076925,0.0,0.0
416,0,416,[392 212 507 230 321],59,4,1436,3.4436450839328536,0.0,0.0
417,0,417,[316 272 211 303 276],90,5,1441,3.4473684210526314,20.0,40.0
418,0,418,[316 272 211 303 276],13,5,1446,3.451073985680191,20.0,40.0
419,0,419,[316 272 211 303 276],90,5,1451,3.454761904761905,20.0,40.0
420,0,420,[316 272 211 303 276],13,5,1456,3.4584323040380047,20.0,40.0
421,0,421,[481 218 243 413 231],13,0,1456,3.4502369668246446,0.0,0.0
422,0,422,[316 272 211 303 276],90,5,1461,3.4539007092198584,20.0,40.0
423,0,423,[232 211 420 215 429],64,3,1464,3.452830188679245,0.0,20.0
424,0,424,[452 230 326 201 211],13,1,1465,3.447058823529412,0.0,20.0
425,0,425,[316 272 211 303 276],13,5,1470,3.4507042253521125,20.0,40.0
426,0,426,[316 272 211 303 276],90,5,1475,3.4543325526932085,20.0,40.0
427,0,427,[316 272 211 303 276],90,5,1480,3.457943925233645,20.0,40.0
428,0,428,[508 218 217 344 509],13,1,1481,3.4522144522144522,0.0,0.0
429,0,429,[316 272 211 303 276],13,5,1486,3.4558139534883723,20.0,40.0
430,0,430,[384 226 275 280 321],13,2,1488,3.4524361948955917,0.0,20.0
431,0,431,[211 216 208 240 431],339,4,1492,3.4537037037037037,0.0,20.0
432,0,432,[316 272 211 303 276],13,5,1497,3.4572748267898383,20.0,40.0
433,0,433,[316 272 211 303 276],13,5,1502,3.4608294930875574,20.0,40.0
434,0,434,[316 272 211 303 276],90,5,1507,3.464367816091954,20.0,40.0
435,0,435,[316 272 211 303 276],13,5,1512,3.467889908256881,20.0,40.0
436,0,436,[295 264 283 213 284],894,1,1513,3.462242562929062,0.0,0.0
437,0,437,[316 272 211 303 276],90,5,1518,3.4657534246575343,20.0,40.0
438,0,438,[222 276 246 331 244],486,1,1519,3.4601366742596813,0.0,40.0
439,0,439,[316 272 211 303 276],13,5,1524,3.463636363636364,20.0,40.0
440,0,440,[217 230 202 226 241],7,3,1527,3.4625850340136055,0.0,0.0
441,0,441,[316 272 211 303 276],13,5,1532,3.4660633484162897,20.0,40.0
442,0,442,[208 283 315 485 215],537,3,1535,3.4650112866817158,20.0,0.0
443,0,443,[316 272 211 303 276],90,5,1540,3.4684684684684686,20.0,40.0
444,0,444,[316 272 211 303 276],90,5,1545,3.4719101123595504,20.0,40.0
445,0,445,[316 272 211 303 276],13,5,1550,3.475336322869955,20.0,40.0
446,0,446,[276 321 268 217 326],13,2,1552,3.472035794183445,0.0,20.0
447,0,447,[316 272 211 303 276],90,5,1557,3.4754464285714284,20.0,40.0
448,0,448,[212 226 241 231 202],13,3,1560,3.4743875278396437,0.0,0.0
449,0,449,[316 272 211 303 276],13,5,1565,3.477777777777778,20.0,40.0
450,0,450,[316 272 211 303 276],13,5,1570,3.481152993348115,20.0,40.0
451,0,451,[316 272 211 303 276],90,5,1575,3.484513274336283,20.0,40.0
452,0,452,[316 272 211 303 276],13,5,1580,3.487858719646799,20.0,40.0
453,0,453,[316 272 211 303 276],90,5,1585,3.4911894273127753,20.0,40.0
454,0,454,[283 293 284 276 255],548,2,1587,3.487912087912088,0.0,20.0
455,0,455,[316 293 244 215 209],474,5,1592,3.491228070175439,20.0,0.0
456,0,456,[241 420 226 231 583],308,3,1595,3.490153172866521,0.0,0.0
457,0,457,[316 272 211 303 276],90,5,1600,3.493449781659389,20.0,40.0
458,0,458,[303 255 218 290 246],334,2,1602,3.4901960784313726,0.0,0.0
459,0,459,[206 213 211 291 218],234,1,1603,3.484782608695652,0.0,20.0
460,0,460,[290 208 367 283 212],234,2,1605,3.4815618221258133,0.0,0.0
461,0,461,[316 272 303 211 276],90,5,1610,3.484848484848485,20.0,40.0
462,0,462,[316 272 303 211 276],13,5,1615,3.488120950323974,20.0,40.0
463,0,463,[316 272 303 211 276],13,5,1620,3.4913793103448274,20.0,40.0
464,0,464,[316 272 303 211 276],90,5,1625,3.4946236559139785,20.0,40.0
465,0,465,[316 272 303 211 276],90,5,1630,3.4978540772532187,20.0,40.0
466,0,466,[394 230 367 215 208],13,2,1632,3.4946466809421843,0.0,0.0
467,0,467,[316 272 303 211 276],90,5,1637,3.497863247863248,20.0,40.0
468,0,468,[316 272 303 211 276],13,5,1642,3.5010660980810235,20.0,40.0
469,0,469,[211 429 481 452 232],326,2,1644,3.497872340425532,0.0,20.0
470,0,470,[295 221 299 250 293],486,1,1645,3.492569002123142,0.0,0.0
471,0,471,[202 241 280 227 268],13,4,1649,3.4936440677966103,0.0,0.0
472,0,472,[316 272 303 211 276],90,5,1654,3.496828752642706,20.0,40.0
473,0,473,[283 236 290 429 413],279,4,1658,3.49789029535865,0.0,0.0
474,0,474,[316 272 303 211 276],90,5,1663,3.5010526315789474,20.0,40.0
475,0,475,[202 216 223 232 227],194,1,1664,3.495798319327731,20.0,0.0
476,0,476,[316 272 303 211 276],90,5,1669,3.49895178197065,20.0,40.0
477,0,477,[316 272 303 211 276],90,5,1674,3.502092050209205,20.0,40.0
478,0,478,[316 272 303 211 276],90,5,1679,3.5052192066805845,20.0,40.0
479,0,479,[316 272 303 211 276],13,5,1684,3.5083333333333333,20.0,40.0
480,0,480,[316 272 303 211 276],90,5,1689,3.5114345114345116,20.0,40.0
481,0,481,[316 272 303 211 276],90,5,1694,3.5145228215767634,20.0,40.0
482,0,482,[316 272 303 211 276],13,5,1699,3.5175983436853,20.0,40.0
483,0,483,[316 272 303 211 276],90,5,1704,3.520661157024793,20.0,40.0
484,0,484,[219 392 284 481 295],308,3,1707,3.5195876288659793,0.0,0.0
485,0,485,[316 272 303 211 276],13,5,1712,3.522633744855967,20.0,40.0
486,0,486,[316 272 303 211 276],13,5,1717,3.5256673511293632,20.0,40.0
487,0,487,[316 272 303 211 276],90,5,1722,3.528688524590164,20.0,40.0
488,0,488,[211 290 301 261 201],13,2,1724,3.525562372188139,0.0,20.0
489,0,489,[431 321 508 211 243],13,1,1725,3.520408163265306,0.0,20.0
490,0,490,[316 272 303 211 276],90,5,1730,3.523421588594705,20.0,40.0
491,0,491,[316 272 303 211 276],90,5,1735,3.5264227642276422,20.0,40.0
492,0,492,[316 272 303 211 276],90,5,1740,3.5294117647058822,20.0,40.0
493,0,493,[316 272 303 211 276],13,5,1745,3.532388663967611,20.0,40.0
494,0,494,[316 272 303 211 276],90,5,1750,3.5353535353535355,20.0,40.0
495,0,495,[202 431 392 216 284],59,3,1753,3.534274193548387,0.0,0.0
496,0,496,[316 272 303 211 276],90,5,1758,3.5372233400402413,20.0,40.0
497,0,497,[216 290 209 211 239],13,3,1761,3.536144578313253,0.0,20.0
498,0,498,[316 272 303 211 276],90,5,1766,3.5390781563126255,20.0,40.0
499,0,499,[246 275 429 230 217],334,4,1770,3.54,0.0,20.0
500,0,500,[298 219 264 367 213],308,3,1773,3.538922155688623,0.0,0.0
501,0,501,[316 272 303 211 276],13,5,1778,3.541832669322709,20.0,40.0
502,0,502,[316 272 303 211 276],13,5,1783,3.5447316103379722,20.0,40.0
503,0,503,[316 272 303 211 276],90,5,1788,3.5476190476190474,20.0,40.0
504,0,504,[392 226 301 507 209],537,2,1790,3.5445544554455446,0.0,0.0
505,0,505,[316 272 303 211 276],13,5,1795,3.547430830039526,20.0,40.0
506,0,506,[316 272 303 211 276],13,5,1800,3.5502958579881656,20.0,40.0
507,0,507,[316 272 303 211 276],13,5,1805,3.5531496062992125,20.0,40.0
508,0,508,[316 272 303 211 276],13,5,1810,3.555992141453831,20.0,40.0
509,0,509,[316 272 303 211 276],13,5,1815,3.5588235294117645,20.0,40.0
510,0,510,[316 272 303 211 276],13,5,1820,3.5616438356164384,20.0,40.0
511,0,511,[508 300 217 280 321],13,1,1821,3.556640625,0.0,20.0
512,0,512,[316 272 303 211 276],90,5,1826,3.5594541910331383,20.0,40.0
513,0,513,[316 272 303 211 276],90,5,1831,3.562256809338521,20.0,40.0
514,0,514,[316 272 303 211 276],13,5,1836,3.5650485436893202,20.0,40.0
515,0,515,[250 209 293 218 240],385,2,1838,3.562015503875969,0.0,0.0
516,0,516,[316 272 303 211 276],90,5,1843,3.5647969052224373,20.0,40.0
517,0,517,[316 272 303 211 276],13,5,1848,3.5675675675675675,20.0,40.0
518,0,518,[230 211 275 221 276],537,3,1851,3.566473988439306,0.0,60.0
519,0,519,[231 321 222 212 264],13,2,1853,3.5634615384615387,0.0,20.0
520,0,520,[316 272 303 211 276],13,5,1858,3.566218809980806,20.0,40.0
521,0,521,[316 272 303 211 276],90,5,1863,3.5689655172413794,20.0,40.0
522,0,522,[316 272 303 211 276],90,5,1868,3.5717017208413,20.0,40.0
523,0,523,[316 272 303 211 276],13,5,1873,3.5744274809160306,20.0,40.0
524,0,524,[316 272 303 211 276],13,5,1878,3.577142857142857,20.0,40.0
525,0,525,[316 272 303 211 276],13,5,1883,3.579847908745247,20.0,40.0
526,0,526,[226 216 219 481 298],308,2,1885,3.57685009487666,0.0,0.0
527,0,527,[316 272 303 211 276],13,5,1890,3.5795454545454546,20.0,40.0
528,0,528,[316 272 303 211 276],90,5,1895,3.5822306238185253,20.0,40.0
529,0,529,[284 431 429 222 227],279,3,1898,3.581132075471698,0.0,20.0
530,0,530,[316 272 303 211 276],90,5,1903,3.583804143126177,20.0,40.0
531,0,531,[316 272 303 211 276],90,5,1908,3.5864661654135337,20.0,40.0
532,0,532,[316 272 303 211 276],13,5,1913,3.5891181988742966,20.0,40.0
533,0,533,[316 272 303 211 276],13,5,1918,3.5917602996254683,20.0,40.0
534,0,534,[208 452 336 508 250],833,1,1919,3.586915887850467,0.0,0.0
535,0,535,[316 272 303 211 276],90,5,1924,3.58955223880597,20.0,40.0
536,0,536,[316 272 303 211 276],90,5,1929,3.5921787709497206,20.0,40.0
537,0,537,[583 250 217 240 220],92,1,1930,3.587360594795539,0.0,0.0
538,0,538,[316 272 303 211 276],90,5,1935,3.589981447124304,20.0,40.0
539,0,539,[316 272 303 211 276],13,5,1940,3.5925925925925926,20.0,40.0
540,0,540,[413 209 264 331 299],13,1,1941,3.587800369685767,0.0,0.0
541,0,541,[316 272 303 211 276],90,5,1946,3.5904059040590406,20.0,40.0
542,0,542,[316 272 303 211 276],13,5,1951,3.593001841620626,20.0,40.0
543,0,543,[275 246 331 324 303],116,1,1952,3.588235294117647,0.0,20.0
544,0,544,[316 272 211 303 276],13,5,1957,3.5908256880733944,20.0,40.0
545,0,545,[316 272 211 303 276],13,5,1962,3.5934065934065935,20.0,40.0
546,0,546,[316 272 211 303 276],13,5,1967,3.5959780621572213,20.0,40.0
547,0,547,[316 272 211 303 276],13,5,1972,3.5985401459854014,20.0,40.0
548,0,548,[316 272 211 303 276],13,5,1977,3.601092896174863,20.0,40.0
549,0,549,[316 272 211 303 276],90,5,1982,3.6036363636363635,20.0,40.0
550,0,550,[316 272 211 303 276],90,5,1987,3.6061705989110706,20.0,40.0
551,0,551,[316 272 211 303 276],90,5,1992,3.608695652173913,20.0,40.0
552,0,552,[316 272 211 303 276],13,5,1997,3.61121157323689,20.0,40.0
553,0,553,[316 272 211 303 276],13,5,2002,3.6137184115523464,20.0,40.0
554,0,554,[226 420 276 431 218],200,5,2007,3.616216216216216,0.0,20.0
555,0,555,[222 508 230 284 216],524,2,2009,3.6133093525179856,0.0,20.0
556,0,556,[303 244 298 324 315],894,3,2012,3.6122082585278275,20.0,0.0
557,0,557,[316 272 211 303 276],90,5,2017,3.6146953405017923,20.0,40.0
558,0,558,[316 272 211 303 276],90,5,2022,3.6171735241502683,20.0,40.0
559,0,559,[316 272 211 303 276],13,5,2027,3.619642857142857,20.0,40.0
560,0,560,[316 272 211 303 276],90,5,2032,3.622103386809269,20.0,40.0
561,0,561,[316 272 211 303 276],90,5,2037,3.6245551601423487,20.0,40.0
562,0,562,[429 284 208 280 206],234,3,2040,3.6234458259325044,0.0,0.0
563,0,563,[316 272 211 303 276],13,5,2045,3.625886524822695,20.0,40.0
564,0,564,[316 272 211 303 276],13,5,2050,3.6283185840707963,20.0,40.0
565,0,565,[509 268 246 284 272],85,4,2054,3.628975265017668,0.0,0.0
566,0,566,[316 272 211 303 276],90,5,2059,3.631393298059965,20.0,40.0
567,0,567,[316 272 211 303 276],90,5,2064,3.6338028169014085,20.0,40.0
568,0,568,[316 272 211 303 276],13,5,2069,3.6362038664323375,20.0,40.0
569,0,569,[230 344 219 420 231],13,1,2070,3.6315789473684212,0.0,0.0
570,0,570,[316 272 211 303 276],13,5,2075,3.633975481611208,20.0,40.0
571,0,571,[316 272 211 303 276],13,5,2080,3.6363636363636362,20.0,40.0
572,0,572,[316 272 211 303 276],13,5,2085,3.6387434554973823,20.0,40.0
573,0,573,[316 272 211 303 276],90,5,2090,3.6411149825783973,20.0,40.0
574,0,574,[316 272 211 303 276],13,5,2095,3.643478260869565,20.0,40.0
575,0,575,[209 420 226 223 429],13,4,2099,3.6440972222222223,20.0,0.0
576,0,576,[316 272 211 303 276],90,5,2104,3.6464471403812824,20.0,40.0
577,0,577,[316 272 211 303 276],90,5,2109,3.64878892733564,20.0,40.0
578,0,578,[241 268 272 264 315],13,4,2113,3.6493955094991364,20.0,0.0
579,0,579,[316 272 211 303 276],90,5,2118,3.6517241379310343,20.0,40.0
580,0,580,[316 272 211 303 276],90,5,2123,3.6540447504302924,20.0,40.0
581,0,581,[231 218 315 226 232],311,4,2127,3.654639175257732,20.0,0.0
582,0,582,[316 272 211 303 276],13,5,2132,3.6569468267581473,20.0,40.0
583,0,583,[316 272 211 303 276],90,5,2137,3.6592465753424657,20.0,40.0
584,0,584,[316 272 211 303 276],90,5,2142,3.6615384615384614,20.0,40.0
585,0,585,[509 261 241 485 226],479,1,2143,3.656996587030717,0.0,0.0
586,0,586,[316 272 211 303 276],13,5,2148,3.659284497444634,20.0,40.0
587,0,587,[316 272 211 303 276],13,5,2153,3.6615646258503403,20.0,40.0
588,0,588,[316 272 211 303 276],13,5,2158,3.6638370118845502,20.0,40.0
589,0,589,[316 272 211 303 276],90,5,2163,3.666101694915254,20.0,40.0
590,0,590,[316 272 211 303 276],13,5,2168,3.6683587140439933,20.0,40.0
591,0,591,[316 272 211 303 276],13,5,2173,3.670608108108108,20.0,40.0
592,0,592,[202 272 209 509 290],650,1,2174,3.6661045531197303,0.0,0.0
593,0,593,[275 230 429 315 220],334,4,2178,3.6666666666666665,20.0,20.0
594,0,594,[316 272 211 303 276],13,5,2183,3.66890756302521,20.0,40.0
595,0,595,[316 272 211 303 276],90,5,2188,3.6711409395973154,20.0,40.0
596,0,596,[231 222 280 367 300],13,1,2189,3.6666666666666665,0.0,40.0
597,0,597,[316 272 211 303 276],13,5,2194,3.668896321070234,20.0,40.0
598,0,598,[316 272 211 303 276],90,5,2199,3.671118530884808,20.0,40.0
599,0,599,[316 272 211 303 276],13,5,2204,3.6733333333333333,20.0,40.0
600,0,600,[316 272 211 303 276],13,5,2209,3.675540765391015,20.0,40.0
601,0,601,[316 272 211 303 276],90,5,2214,3.6777408637873754,20.0,40.0
602,0,602,[316 272 211 303 276],13,5,2219,3.6799336650082917,20.0,40.0
603,0,603,[291 298 276 284 202],207,0,2219,3.673841059602649,0.0,20.0
604,0,604,[276 413 280 336 290],13,3,2222,3.672727272727273,0.0,20.0
605,0,605,[316 272 211 303 276],13,5,2227,3.674917491749175,20.0,40.0
606,0,606,[212 321 276 509 268],664,3,2230,3.673805601317957,0.0,20.0
607,0,607,[316 272 211 303 276],13,5,2235,3.6759868421052633,20.0,40.0
608,0,608,[316 272 211 303 276],13,5,2240,3.67816091954023,20.0,40.0
609,0,609,[316 272 211 303 276],90,5,2245,3.680327868852459,20.0,40.0
610,0,610,[316 272 211 303 276],90,5,2250,3.6824877250409167,20.0,40.0
611,0,611,[316 272 211 303 276],13,5,2255,3.684640522875817,20.0,40.0
612,0,612,[316 272 211 303 276],90,5,2260,3.686786296900489,20.0,40.0
613,0,613,[316 272 211 303 276],13,5,2265,3.688925081433225,20.0,40.0
614,0,614,[303 321 202 211 264],13,4,2269,3.689430894308943,0.0,20.0
615,0,615,[316 272 211 303 276],90,5,2274,3.6915584415584415,20.0,40.0
616,0,616,[230 291 283 508 293],474,2,2276,3.6888168557536467,0.0,0.0
617,0,617,[316 272 211 303 276],90,5,2281,3.690938511326861,20.0,40.0
618,0,618,[316 272 211 303 276],90,5,2286,3.6930533117932147,20.0,40.0
619,0,619,[316 272 211 303 276],90,5,2291,3.695161290322581,20.0,40.0
620,0,620,[316 272 211 303 276],13,5,2296,3.6972624798711755,20.0,40.0
621,0,621,[316 272 211 303 276],13,5,2301,3.6993569131832795,20.0,40.0
622,0,622,[316 272 211 303 276],90,5,2306,3.701444622792937,20.0,40.0
623,0,623,[316 272 211 303 276],90,5,2311,3.703525641025641,20.0,40.0
624,0,624,[481 420 485 321 293],308,3,2314,3.7024,0.0,0.0
625,0,625,[316 272 211 303 276],90,5,2319,3.7044728434504792,20.0,40.0
626,0,626,[316 272 211 303 276],13,5,2324,3.7065390749601277,20.0,40.0
627,0,627,[216 219 215 208 206],406,0,2324,3.700636942675159,0.0,0.0
628,0,628,[223 284 336 509 508],894,2,2326,3.697933227344992,20.0,0.0
629,0,629,[316 272 211 303 276],13,5,2331,3.7,20.0,40.0
630,0,630,[243 478 209 202 316],234,2,2333,3.6973058637083995,20.0,0.0
631,0,631,[316 272 211 303 276],90,5,2338,3.699367088607595,20.0,40.0
632,0,632,[316 272 211 303 276],90,5,2343,3.7014218009478674,20.0,40.0
633,0,633,[507 239 367 301 217],13,1,2344,3.697160883280757,0.0,0.0
634,0,634,[316 272 211 303 276],90,5,2349,3.6992125984251967,20.0,40.0
635,0,635,[316 272 211 303 276],90,5,2354,3.70125786163522,20.0,40.0
636,0,636,[344 509 413 272 226],13,3,2357,3.7001569858712715,0.0,0.0
637,0,637,[331 301 316 275 276],145,2,2359,3.697492163009404,20.0,40.0
638,0,638,[316 272 211 303 276],13,5,2364,3.699530516431925,20.0,40.0
639,0,639,[316 272 211 303 276],90,5,2369,3.7015625,20.0,40.0
640,0,640,[250 208 268 326 485],334,2,2371,3.6989079563182528,0.0,0.0
641,0,641,[316 272 211 303 276],13,5,2376,3.7009345794392523,20.0,40.0
642,0,642,[478 275 321 216 276],537,3,2379,3.699844479004666,0.0,40.0
643,0,643,[316 272 211 303 276],90,5,2384,3.701863354037267,20.0,40.0
644,0,644,[316 272 211 303 276],90,5,2389,3.7038759689922482,20.0,40.0
645,0,645,[316 272 211 303 276],90,5,2394,3.7058823529411766,20.0,40.0
646,0,646,[316 272 211 303 276],13,5,2399,3.7078825347758886,20.0,40.0
647,0,647,[326 452 243 218 216],13,0,2399,3.7021604938271606,0.0,0.0
648,0,648,[316 272 211 303 276],90,5,2404,3.704160246533128,20.0,40.0
649,0,649,[316 272 211 303 276],90,5,2409,3.706153846153846,20.0,40.0
650,0,650,[316 272 211 303 276],13,5,2414,3.708141321044547,20.0,40.0
651,0,651,[316 272 211 303 276],13,5,2419,3.710122699386503,20.0,40.0
652,0,652,[316 272 211 303 276],13,5,2424,3.7120980091883613,20.0,40.0
653,0,653,[217 509 295 213 218],378,2,2426,3.709480122324159,0.0,0.0
654,0,654,[316 272 211 303 276],90,5,2431,3.711450381679389,20.0,40.0
655,0,655,[316 272 211 303 276],13,5,2436,3.7134146341463414,20.0,40.0
656,0,656,[316 272 211 303 276],13,5,2441,3.715372907153729,20.0,40.0
657,0,657,[316 272 211 303 276],90,5,2446,3.717325227963526,20.0,40.0
658,0,658,[316 272 211 303 276],13,5,2451,3.7192716236722307,20.0,40.0
659,0,659,[300 221 321 208 507],537,2,2453,3.716666666666667,0.0,20.0
660,0,660,[316 272 211 303 276],13,5,2458,3.718608169440242,20.0,40.0
661,0,661,[316 272 211 303 276],90,5,2463,3.7205438066465257,20.0,40.0
662,0,662,[316 272 211 303 276],13,5,2468,3.722473604826546,20.0,40.0
663,0,663,[316 272 211 303 276],13,5,2473,3.7243975903614457,20.0,40.0
664,0,664,[316 272 211 303 276],13,5,2478,3.7263157894736842,20.0,40.0
665,0,665,[316 272 211 303 276],90,5,2483,3.7282282282282284,20.0,40.0
666,0,666,[316 272 211 303 276],90,5,2488,3.730134932533733,20.0,40.0
667,0,667,[316 272 211 303 276],13,5,2493,3.7320359281437128,20.0,40.0
668,0,668,[316 272 211 303 276],13,5,2498,3.733931240657698,20.0,40.0
669,0,669,[316 272 211 303 276],90,5,2503,3.735820895522388,20.0,40.0
670,0,670,[316 272 211 303 276],90,5,2508,3.737704918032787,20.0,40.0
671,0,671,[316 272 211 303 276],90,5,2513,3.7395833333333335,20.0,40.0
672,0,672,[298 431 378 230 392],843,0,2513,3.734026745913819,0.0,0.0
673,0,673,[316 272 211 303 276],13,5,2518,3.735905044510386,20.0,40.0
674,0,674,[290 303 230 243 268],537,2,2520,3.7333333333333334,0.0,0.0
675,0,675,[316 272 211 303 276],13,5,2525,3.735207100591716,20.0,40.0
676,0,676,[223 227 215 217 315],650,0,2525,3.7296898079763663,40.0,0.0
677,0,677,[316 272 211 303 276],13,5,2530,3.7315634218289087,20.0,40.0
678,0,678,[316 272 211 303 276],90,5,2535,3.7334315169366716,20.0,40.0
679,0,679,[316 272 211 303 276],90,5,2540,3.735294117647059,20.0,40.0
680,0,680,[316 272 211 303 276],13,5,2545,3.737151248164464,20.0,40.0
681,0,681,[316 272 211 303 276],13,5,2550,3.7390029325513194,20.0,40.0
682,0,682,[316 272 211 303 276],90,5,2555,3.7408491947291362,20.0,40.0
683,0,683,[316 272 211 303 276],13,5,2560,3.742690058479532,20.0,40.0
684,0,684,[316 272 211 303 276],90,5,2565,3.7445255474452557,20.0,40.0
685,0,685,[316 272 211 303 276],13,5,2570,3.746355685131195,20.0,40.0
686,0,686,[316 272 211 303 276],13,5,2575,3.7481804949053856,20.0,40.0
687,0,687,[316 272 211 303 276],13,5,2580,3.75,20.0,40.0
688,0,688,[316 272 211 303 276],90,5,2585,3.7518142235123366,20.0,40.0
689,0,689,[316 272 211 303 276],13,5,2590,3.753623188405797,20.0,40.0
690,0,690,[218 216 420 429 211],843,1,2591,3.7496382054992763,0.0,20.0
691,0,691,[316 272 303 211 276],90,5,2596,3.7514450867052025,20.0,40.0
692,0,692,[316 272 303 211 276],13,5,2601,3.7532467532467533,20.0,40.0
693,0,693,[316 272 303 211 276],13,5,2606,3.755043227665706,20.0,40.0
694,0,694,[243 429 226 212 315],650,1,2607,3.7510791366906475,20.0,0.0
695,0,695,[344 230 509 208 508],13,2,2609,3.7485632183908044,0.0,0.0
696,0,696,[316 272 303 211 276],13,5,2614,3.750358680057389,20.0,40.0
697,0,697,[316 272 303 211 276],90,5,2619,3.7521489971346704,20.0,40.0
698,0,698,[316 272 303 211 276],13,5,2624,3.7539341917024323,20.0,40.0
699,0,699,[316 272 303 211 276],90,5,2629,3.755714285714286,20.0,40.0
700,0,700,[316 272 303 211 276],13,5,2634,3.7574893009985733,20.0,40.0
701,0,701,[316 272 303 211 276],13,5,2639,3.759259259259259,20.0,40.0
702,0,702,[283 324 211 226 261],479,2,2641,3.7567567567567566,0.0,20.0
703,0,703,[316 272 303 211 276],13,5,2646,3.758522727272727,20.0,40.0
704,0,704,[316 272 303 211 276],13,5,2651,3.7602836879432626,20.0,40.0
705,0,705,[316 272 303 211 276],13,5,2656,3.762039660056657,20.0,40.0
706,0,706,[316 272 303 211 276],13,5,2661,3.763790664780764,20.0,40.0
707,0,707,[316 272 303 211 276],90,5,2666,3.7655367231638417,20.0,40.0
708,0,708,[316 272 303 211 276],90,5,2671,3.767277856135402,20.0,40.0
709,0,709,[316 272 303 211 276],13,5,2676,3.769014084507042,20.0,40.0
710,0,710,[216 223 213 583 392],308,4,2680,3.769338959212377,20.0,0.0
711,0,711,[316 272 303 211 276],13,5,2685,3.771067415730337,20.0,40.0
712,0,712,[316 272 303 211 276],90,5,2690,3.772791023842917,20.0,40.0
713,0,713,[316 272 303 211 276],90,5,2695,3.7745098039215685,20.0,40.0
714,0,714,[316 272 303 211 276],13,5,2700,3.7762237762237763,20.0,40.0
715,0,715,[227 275 429 326 244],334,2,2702,3.7737430167597767,0.0,20.0
716,0,716,[316 272 303 211 276],90,5,2707,3.775453277545328,20.0,40.0
717,0,717,[316 272 303 211 276],90,5,2712,3.777158774373259,20.0,40.0
718,0,718,[316 272 303 211 276],13,5,2717,3.7788595271210013,20.0,40.0
719,0,719,[316 272 303 211 276],90,5,2722,3.7805555555555554,20.0,40.0
720,0,720,[321 222 413 211 239],13,2,2724,3.778085991678225,0.0,40.0
721,0,721,[316 272 303 211 276],90,5,2729,3.7797783933518008,20.0,40.0
722,0,722,[316 272 303 211 276],13,5,2734,3.7814661134163208,20.0,40.0
723,0,723,[239 384 420 202 212],13,4,2738,3.781767955801105,0.0,0.0
724,0,724,[316 272 303 211 276],90,5,2743,3.783448275862069,20.0,40.0
725,0,725,[316 272 303 211 276],90,5,2748,3.7851239669421486,20.0,40.0
726,0,726,[250 321 206 429 243],387,2,2750,3.782668500687758,0.0,0.0
727,0,727,[316 272 303 211 276],90,5,2755,3.784340659340659,20.0,40.0
728,0,728,[272 276 316 481 478],13,4,2759,3.784636488340192,20.0,20.0
729,0,729,[316 272 303 211 276],90,5,2764,3.786301369863014,20.0,40.0
730,0,730,[316 272 303 211 276],90,5,2769,3.7879616963064295,20.0,40.0
731,0,731,[316 272 303 211 276],90,5,2774,3.789617486338798,20.0,40.0
732,0,732,[316 272 303 211 276],13,5,2779,3.791268758526603,20.0,40.0
733,0,733,[316 272 303 211 276],90,5,2784,3.79291553133515,20.0,40.0
734,0,734,[316 272 303 211 276],90,5,2789,3.7945578231292516,20.0,40.0
735,0,735,[316 272 303 211 276],90,5,2794,3.796195652173913,20.0,40.0
736,0,736,[316 272 303 211 276],90,5,2799,3.7978290366350067,20.0,40.0
737,0,737,[316 272 303 211 276],13,5,2804,3.799457994579946,20.0,40.0
738,0,738,[316 272 303 211 276],90,5,2809,3.801082543978349,20.0,40.0
739,0,739,[316 272 303 211 276],90,5,2814,3.8027027027027027,20.0,40.0
740,0,740,[218 239 283 223 276],308,3,2817,3.8016194331983804,20.0,20.0
741,0,741,[316 272 303 211 276],13,5,2822,3.803234501347709,20.0,40.0
742,0,742,[316 272 303 211 276],13,5,2827,3.8048452220726783,20.0,40.0
743,0,743,[316 272 303 211 276],13,5,2832,3.806451612903226,20.0,40.0
744,0,744,[316 272 303 211 276],13,5,2837,3.808053691275168,20.0,40.0
745,0,745,[316 272 303 211 276],13,5,2842,3.809651474530831,20.0,40.0
746,0,746,[284 218 227 226 326],788,3,2845,3.8085676037483265,0.0,0.0
747,0,747,[316 272 303 211 276],90,5,2850,3.8101604278074865,20.0,40.0
748,0,748,[316 272 303 211 276],90,5,2855,3.8117489986648865,20.0,40.0
749,0,749,[231 239 303 301 431],537,2,2857,3.8093333333333335,0.0,0.0
750,0,750,[316 272 303 211 276],13,5,2862,3.810918774966711,20.0,40.0
751,0,751,[316 272 303 211 276],13,5,2867,3.8125,20.0,40.0
752,0,752,[316 272 303 211 276],90,5,2872,3.814077025232404,20.0,40.0
753,0,753,[316 272 303 211 276],90,5,2877,3.815649867374005,20.0,40.0
754,0,754,[316 272 303 211 276],90,5,2882,3.8172185430463577,20.0,40.0
755,0,755,[429 218 284 202 215],308,4,2886,3.8174603174603177,0.0,0.0
756,0,756,[300 212 298 276 275],145,0,2886,3.8124174372523116,0.0,60.0
757,0,757,[316 272 303 211 276],13,5,2891,3.8139841688654355,20.0,40.0
758,0,758,[316 272 303 211 276],13,5,2896,3.8155467720685112,20.0,40.0
759,0,759,[276 240 222 268 202],145,4,2900,3.8157894736842106,0.0,40.0
760,0,760,[316 272 303 211 276],90,5,2905,3.8173455978975035,20.0,40.0
761,0,761,[316 272 303 211 276],13,5,2910,3.8188976377952755,20.0,40.0
762,0,762,[316 272 303 211 276],90,5,2915,3.820445609436435,20.0,40.0
763,0,763,[239 303 420 280 344],13,4,2919,3.8206806282722514,0.0,0.0
764,0,764,[316 272 303 211 276],13,5,2924,3.8222222222222224,20.0,40.0
765,0,765,[316 272 303 211 276],90,5,2929,3.8237597911227152,20.0,40.0
766,0,766,[280 239 231 240 209],749,4,2933,3.8239895697522814,0.0,0.0
767,0,767,[316 272 303 211 276],13,5,2938,3.8255208333333335,20.0,40.0
768,0,768,[316 272 303 211 276],13,5,2943,3.8270481144343305,20.0,40.0
769,0,769,[239 231 290 232 230],13,2,2945,3.824675324675325,0.0,0.0
770,0,770,[316 272 303 211 276],90,5,2950,3.826199740596628,20.0,40.0
771,0,771,[316 272 303 211 276],90,5,2955,3.827720207253886,20.0,40.0
772,0,772,[316 272 303 211 276],90,5,2960,3.8292367399741267,20.0,40.0
773,0,773,[316 272 303 211 276],90,5,2965,3.830749354005168,20.0,40.0
774,0,774,[230 507 212 509 208],537,3,2968,3.8296774193548386,0.0,0.0
775,0,775,[316 272 303 211 276],90,5,2973,3.8311855670103094,20.0,40.0
776,0,776,[316 272 303 211 276],90,5,2978,3.832689832689833,20.0,40.0
777,0,777,[316 272 303 211 276],13,5,2983,3.834190231362468,20.0,40.0
778,0,778,[316 272 303 211 276],90,5,2988,3.8356867779204107,20.0,40.0
779,0,779,[509 201 365 275 219],7,3,2991,3.8346153846153848,0.0,20.0
780,0,780,[316 272 303 211 276],13,5,2996,3.8361075544174135,20.0,40.0
781,0,781,[431 268 223 231 219],387,1,2997,3.8324808184143224,20.0,0.0
782,0,782,[316 272 303 211 276],13,5,3002,3.83397190293742,20.0,40.0
783,0,783,[316 272 303 211 276],13,5,3007,3.8354591836734695,20.0,40.0
784,0,784,[316 272 303 211 276],13,5,3012,3.8369426751592357,20.0,40.0
785,0,785,[485 218 367 254 223],378,2,3014,3.8346055979643765,20.0,0.0
786,0,786,[316 272 303 211 276],90,5,3019,3.836086404066074,20.0,40.0
787,0,787,[481 217 301 241 420],13,1,3020,3.83248730964467,0.0,0.0
788,0,788,[378 301 300 367 276],234,2,3022,3.830164765525982,0.0,40.0
789,0,789,[218 301 275 226 452],13,1,3023,3.8265822784810126,0.0,20.0
790,0,790,[209 201 384 226 283],279,4,3027,3.826801517067004,0.0,0.0
791,0,791,[316 272 303 211 276],90,5,3032,3.8282828282828283,20.0,40.0
792,0,792,[316 272 303 211 276],90,5,3037,3.829760403530895,20.0,40.0
793,0,793,[378 215 420 315 222],650,1,3038,3.8261964735516374,20.0,20.0
794,0,794,[316 272 303 211 276],13,5,3043,3.8276729559748426,20.0,40.0
795,0,795,[298 208 218 508 276],339,3,3046,3.8266331658291457,0.0,20.0
796,0,796,[230 239 216 217 221],158,1,3047,3.823086574654956,0.0,0.0
797,0,797,[394 350 227 202 384],13,2,3049,3.8208020050125313,0.0,0.0
798,0,798,[316 272 303 211 276],90,5,3054,3.8222778473091363,20.0,40.0
799,0,799,[384 272 367 219 420],13,2,3056,3.82,0.0,0.0
800,0,800,[213 208 230 264 420],7,3,3059,3.8189762796504367,0.0,0.0
801,0,801,[316 272 303 211 276],13,5,3064,3.8204488778054864,20.0,40.0
802,0,802,[303 300 295 298 221],486,3,3067,3.8194271481942716,0.0,20.0
803,0,803,[316 272 303 211 276],13,5,3072,3.8208955223880596,20.0,40.0
804,0,804,[378 509 299 216 431],537,2,3074,3.8186335403726708,0.0,0.0
805,0,805,[316 272 303 211 276],90,5,3079,3.8200992555831266,20.0,40.0
806,0,806,[316 272 303 211 276],90,5,3084,3.8215613382899627,20.0,40.0
807,0,807,[316 272 303 211 276],13,5,3089,3.823019801980198,20.0,40.0
808,0,808,[507 291 283 429 321],308,1,3090,3.819530284301607,0.0,0.0
809,0,809,[316 272 303 211 276],90,5,3095,3.8209876543209877,20.0,40.0
810,0,810,[217 303 276 227 481],13,3,3098,3.8199753390875464,0.0,20.0
811,0,811,[217 222 201 293 452],774,0,3098,3.815270935960591,0.0,20.0
812,0,812,[316 272 303 211 276],13,5,3103,3.816728167281673,20.0,40.0
813,0,813,[291 208 293 452 264],308,2,3105,3.8144963144963144,0.0,0.0
814,0,814,[316 272 303 211 276],90,5,3110,3.815950920245399,20.0,40.0
815,0,815,[284 209 429 230 223],749,4,3114,3.8161764705882355,20.0,0.0
816,0,816,[219 223 324 431 230],387,2,3116,3.813953488372093,20.0,0.0
817,0,817,[219 264 321 478 230],13,2,3118,3.8117359413202934,0.0,0.0
818,0,818,[316 272 303 211 276],13,5,3123,3.8131868131868134,20.0,40.0
819,0,819,[316 272 303 211 276],13,5,3128,3.8146341463414632,20.0,40.0
820,0,820,[241 209 213 508 429],537,3,3131,3.8136419001218025,0.0,0.0
821,0,821,[231 583 295 507 481],308,2,3133,3.8114355231143553,0.0,0.0
822,0,822,[316 272 303 211 276],90,5,3138,3.812879708383961,20.0,40.0
823,0,823,[316 272 303 211 276],90,5,3143,3.8143203883495147,20.0,40.0
824,0,824,[316 272 303 211 276],90,5,3148,3.815757575757576,20.0,40.0
825,0,825,[299 331 256 255 284],894,1,3149,3.8123486682808716,0.0,0.0
826,0,826,[316 272 303 211 276],90,5,3154,3.8137847642079805,20.0,40.0
827,0,827,[316 272 303 211 276],13,5,3159,3.8152173913043477,20.0,40.0
828,0,828,[316 272 303 211 276],13,5,3164,3.8166465621230397,20.0,40.0
829,0,829,[268 202 201 264 222],13,3,3167,3.81566265060241,0.0,20.0
830,0,830,[316 272 303 211 276],90,5,3172,3.8170878459687123,20.0,40.0
831,0,831,[316 272 303 211 276],90,5,3177,3.8185096153846154,20.0,40.0
832,0,832,[316 272 303 211 276],13,5,3182,3.8199279711884753,20.0,40.0
833,0,833,[316 272 303 211 276],90,5,3187,3.821342925659472,20.0,40.0
834,0,834,[212 208 213 507 367],840,5,3192,3.8227544910179643,0.0,0.0
835,0,835,[316 272 303 211 276],90,5,3197,3.824162679425837,20.0,40.0
836,0,836,[316 272 303 211 276],13,5,3202,3.825567502986858,20.0,40.0
837,0,837,[316 272 303 211 276],13,5,3207,3.8269689737470167,20.0,40.0
838,0,838,[316 272 303 211 276],90,5,3212,3.828367103694875,20.0,40.0
839,0,839,[275 299 226 508 315],13,2,3214,3.8261904761904764,20.0,20.0
840,0,840,[316 272 303 211 276],13,5,3219,3.8275862068965516,20.0,40.0
841,0,841,[316 272 303 211 276],90,5,3224,3.828978622327791,20.0,40.0
842,0,842,[222 243 509 218 485],13,1,3225,3.8256227758007118,0.0,20.0
843,0,843,[216 215 367 509 508],653,1,3226,3.822274881516588,0.0,0.0
844,0,844,[276 290 261 299 208],13,3,3229,3.821301775147929,0.0,20.0
845,0,845,[241 485 378 208 264],7,5,3234,3.8226950354609928,0.0,0.0
846,0,846,[299 226 344 272 481],13,2,3236,3.820543093270366,0.0,0.0
847,0,847,[303 232 316 276 212],13,4,3240,3.8207547169811322,20.0,20.0
848,0,848,[316 272 303 211 276],90,5,3245,3.822143698468787,20.0,40.0
849,0,849,[316 272 303 211 276],13,5,3250,3.823529411764706,20.0,40.0
850,0,850,[316 272 303 211 276],13,5,3255,3.8249118683901293,20.0,40.0
851,0,851,[316 272 303 211 276],90,5,3260,3.8262910798122065,20.0,40.0
852,0,852,[316 272 303 211 276],13,5,3265,3.827667057444314,20.0,40.0
853,0,853,[222 431 202 290 429],650,2,3267,3.8255269320843093,0.0,20.0
854,0,854,[316 272 303 211 276],13,5,3272,3.8269005847953217,20.0,40.0
855,0,855,[316 272 303 211 276],90,5,3277,3.828271028037383,20.0,40.0
856,0,856,[223 583 241 231 219],92,2,3279,3.826137689614936,20.0,0.0
857,0,857,[316 272 303 211 276],13,5,3284,3.8275058275058274,20.0,40.0
858,0,858,[316 272 303 211 276],90,5,3289,3.828870779976717,20.0,40.0
859,0,859,[215 241 209 413 420],13,2,3291,3.8267441860465117,0.0,0.0
860,0,860,[316 272 303 211 276],13,5,3296,3.8281068524970965,20.0,40.0
861,0,861,[316 272 303 211 276],13,5,3301,3.8294663573085845,20.0,40.0
862,0,862,[316 272 303 211 276],13,5,3306,3.8308227114716105,20.0,40.0
863,0,863,[295 452 508 223 222],92,3,3309,3.829861111111111,20.0,20.0
864,0,864,[507 481 227 478 508],474,4,3313,3.830057803468208,0.0,0.0
865,0,865,[420 301 290 239 226],13,4,3317,3.8302540415704387,0.0,0.0
866,0,866,[316 272 303 211 276],13,5,3322,3.8316032295271047,20.0,40.0
867,0,867,[316 272 303 211 276],13,5,3327,3.8329493087557602,20.0,40.0
868,0,868,[316 272 303 211 276],90,5,3332,3.8342922899884924,20.0,40.0
869,0,869,[215 429 367 212 413],804,3,3335,3.8333333333333335,0.0,0.0
870,0,870,[316 272 303 211 276],13,5,3340,3.8346727898966706,20.0,40.0
871,0,871,[209 216 431 378 485],474,5,3345,3.8360091743119265,0.0,0.0
872,0,872,[316 272 303 211 276],13,5,3350,3.8373424971363117,20.0,40.0
873,0,873,[481 429 478 316 259],234,3,3353,3.836384439359268,20.0,0.0
874,0,874,[264 232 219 300 275],7,3,3356,3.8354285714285714,0.0,40.0
875,0,875,[316 272 303 211 276],13,5,3361,3.83675799086758,20.0,40.0
876,0,876,[316 272 303 211 276],13,5,3366,3.838084378563284,20.0,40.0
877,0,877,[316 272 303 211 276],13,5,3371,3.8394077448747153,20.0,40.0
878,0,878,[216 209 230 301 250],334,1,3372,3.83617747440273,0.0,0.0
879,0,879,[321 276 227 291 239],892,5,3377,3.8375,0.0,20.0
880,0,880,[316 272 303 211 276],13,5,3382,3.8388195232690125,20.0,40.0
881,0,881,[316 272 303 211 276],90,5,3387,3.8401360544217686,20.0,40.0
882,0,882,[485 429 268 303 221],334,4,3391,3.840317100792752,0.0,0.0
883,0,883,[212 509 213 221 378],537,2,3393,3.838235294117647,0.0,0.0
884,0,884,[223 215 212 367 431],234,1,3394,3.8350282485875704,20.0,0.0
885,0,885,[316 272 303 211 276],90,5,3399,3.8363431151241536,20.0,40.0
886,0,886,[316 272 303 211 276],13,5,3404,3.8376550169109356,20.0,40.0
887,0,887,[316 272 303 211 276],13,5,3409,3.838963963963964,20.0,40.0
888,0,888,[326 350 301 264 227],13,2,3411,3.83689538807649,0.0,0.0
889,0,889,[316 272 303 211 276],13,5,3416,3.838202247191011,20.0,40.0
890,0,890,[316 272 303 211 276],13,5,3421,3.8395061728395063,20.0,40.0
891,0,891,[298 268 223 367 211],6,2,3423,3.837443946188341,20.0,20.0
892,0,892,[316 272 303 211 276],90,5,3428,3.8387458006718926,20.0,40.0
893,0,893,[201 331 223 216 431],13,1,3429,3.835570469798658,20.0,0.0
894,0,894,[326 218 303 276 227],334,2,3431,3.833519553072626,0.0,20.0
895,0,895,[316 272 303 211 276],90,5,3436,3.8348214285714284,20.0,40.0
896,0,896,[316 272 303 211 276],13,5,3441,3.8361204013377925,20.0,40.0
897,0,897,[217 231 481 239 275],334,2,3443,3.834075723830735,0.0,20.0
898,0,898,[316 272 303 211 276],13,5,3448,3.835372636262514,20.0,40.0
899,0,899,[316 272 303 211 276],90,5,3453,3.8366666666666664,20.0,40.0
900,0,900,[202 239 240 301 290],279,5,3458,3.8379578246392896,0.0,0.0
901,0,901,[223 213 276 230 239],334,4,3462,3.838137472283814,20.0,20.0
902,0,902,[316 272 303 211 276],90,5,3467,3.8394241417497232,20.0,40.0
903,0,903,[316 272 303 211 276],90,5,3472,3.84070796460177,20.0,40.0
904,0,904,[316 272 303 211 276],13,5,3477,3.841988950276243,20.0,40.0
905,0,905,[316 272 303 211 276],90,5,3482,3.8432671081677703,20.0,40.0
906,0,906,[316 272 303 211 276],13,5,3487,3.8445424476295478,20.0,40.0
907,0,907,[201 231 367 230 264],7,2,3489,3.842511013215859,0.0,0.0
908,0,908,[316 272 303 211 276],13,5,3494,3.8437843784378436,20.0,40.0
909,0,909,[316 272 303 211 276],90,5,3499,3.845054945054945,20.0,40.0
910,0,910,[429 301 227 390 321],279,4,3503,3.845225027442371,0.0,0.0
911,0,911,[316 272 303 211 276],90,5,3508,3.8464912280701755,20.0,40.0
912,0,912,[316 272 303 211 276],90,5,3513,3.8477546549835706,20.0,40.0
913,0,913,[316 272 303 211 276],90,5,3518,3.849015317286652,20.0,40.0
914,0,914,[276 202 301 299 290],13,3,3521,3.848087431693989,0.0,20.0
915,0,915,[316 272 303 211 276],13,5,3526,3.849344978165939,20.0,40.0
916,0,916,[316 272 303 211 276],90,5,3531,3.850599781897492,20.0,40.0
917,0,917,[316 272 303 211 276],90,5,3536,3.8518518518518516,20.0,40.0
918,0,918,[316 272 303 211 276],90,5,3541,3.85310119695321,20.0,40.0
919,0,919,[316 272 303 211 276],90,5,3546,3.8543478260869564,20.0,40.0
920,0,920,[206 300 222 250 298],843,1,3547,3.8512486427795873,0.0,40.0
921,0,921,[316 272 303 211 276],90,5,3552,3.8524945770065075,20.0,40.0
922,0,922,[316 272 303 211 276],13,5,3557,3.85373781148429,20.0,40.0
923,0,923,[316 272 303 211 276],90,5,3562,3.854978354978355,20.0,40.0
924,0,924,[316 272 303 211 276],90,5,3567,3.8562162162162164,20.0,40.0
925,0,925,[316 272 303 211 276],90,5,3572,3.857451403887689,20.0,40.0
926,0,926,[316 272 303 211 276],90,5,3577,3.858683926645092,20.0,40.0
927,0,927,[316 272 303 211 276],13,5,3582,3.8599137931034484,20.0,40.0
928,0,928,[219 232 226 324 218],387,1,3583,3.8568353067814853,0.0,0.0
929,0,929,[316 272 303 211 276],13,5,3588,3.858064516129032,20.0,40.0
930,0,930,[316 272 303 211 276],90,5,3593,3.859291084854995,20.0,40.0
931,0,931,[316 272 303 211 276],90,5,3598,3.8605150214592276,20.0,40.0
932,0,932,[316 272 303 211 276],90,5,3603,3.8617363344051445,20.0,40.0
933,0,933,[316 272 303 211 276],90,5,3608,3.862955032119914,20.0,40.0
934,0,934,[316 272 303 211 276],13,5,3613,3.8641711229946525,20.0,40.0
935,0,935,[316 272 303 211 276],13,5,3618,3.8653846153846154,20.0,40.0
936,0,936,[299 276 255 268 508],486,2,3620,3.863393810032017,0.0,20.0
937,0,937,[316 272 303 211 276],13,5,3625,3.8646055437100215,20.0,40.0
938,0,938,[316 272 303 211 276],90,5,3630,3.865814696485623,20.0,40.0
939,0,939,[316 272 303 211 276],13,5,3635,3.867021276595745,20.0,40.0
940,0,940,[316 272 303 211 276],13,5,3640,3.8682252922422955,20.0,40.0
941,0,941,[316 272 303 211 276],13,5,3645,3.8694267515923566,20.0,40.0
942,0,942,[316 272 303 211 276],13,5,3650,3.870625662778367,20.0,40.0
943,0,943,[227 299 202 230 259],145,4,3654,3.8707627118644066,0.0,0.0
944,0,944,[316 272 303 211 276],13,5,3659,3.871957671957672,20.0,40.0
945,0,945,[316 272 303 211 276],13,5,3664,3.873150105708245,20.0,40.0
946,0,946,[478 316 201 261 321],13,2,3666,3.87117212249208,20.0,0.0
947,0,947,[316 272 303 211 276],90,5,3671,3.8723628691983123,20.0,40.0
948,0,948,[316 272 303 211 276],13,5,3676,3.873551106427819,20.0,40.0
949,0,949,[316 272 303 211 276],90,5,3681,3.8747368421052633,20.0,40.0
950,0,950,[316 272 303 211 276],90,5,3686,3.8759200841219767,20.0,40.0
951,0,951,[316 272 303 211 276],90,5,3691,3.8771008403361344,20.0,40.0
952,0,952,[316 272 303 211 276],13,5,3696,3.8782791185729275,20.0,40.0
953,0,953,[316 272 303 211 276],13,5,3701,3.879454926624738,20.0,40.0
954,0,954,[316 272 303 211 276],90,5,3706,3.880628272251309,20.0,40.0
955,0,955,[316 222 232 243 264],13,2,3708,3.8786610878661087,20.0,20.0
956,0,956,[316 272 303 211 276],90,5,3713,3.8798328108672937,20.0,40.0
957,0,957,[316 272 303 211 276],13,5,3718,3.8810020876826723,20.0,40.0
958,0,958,[316 272 303 211 276],13,5,3723,3.8821689259645464,20.0,40.0
959,0,959,[301 216 259 509 321],279,2,3725,3.8802083333333335,0.0,0.0
960,0,960,[316 272 303 211 276],90,5,3730,3.881373569198751,20.0,40.0
961,0,961,[316 272 303 211 276],13,5,3735,3.8825363825363826,20.0,40.0
962,0,962,[316 272 303 211 276],90,5,3740,3.8836967808930427,20.0,40.0
963,0,963,[326 485 208 226 452],313,2,3742,3.8817427385892116,0.0,0.0
964,0,964,[429 216 420 209 291],308,3,3745,3.8808290155440415,0.0,0.0
965,0,965,[316 272 303 211 276],90,5,3750,3.8819875776397517,20.0,40.0
966,0,966,[316 272 303 211 276],90,5,3755,3.8831437435367113,20.0,40.0
967,0,967,[316 272 303 211 276],13,5,3760,3.884297520661157,20.0,40.0
968,0,968,[316 272 303 211 276],13,5,3765,3.8854489164086687,20.0,40.0
969,0,969,[250 276 202 478 221],184,4,3769,3.8855670103092783,0.0,20.0
970,0,970,[211 321 241 264 201],308,3,3772,3.8846549948506692,0.0,20.0
971,0,971,[316 272 303 211 276],90,5,3777,3.8858024691358026,20.0,40.0
972,0,972,[316 272 303 211 276],13,5,3782,3.8869475847893113,20.0,40.0
973,0,973,[316 272 303 211 276],13,5,3787,3.8880903490759753,20.0,40.0
974,0,974,[316 272 303 211 276],90,5,3792,3.8892307692307693,20.0,40.0
975,0,975,[316 272 303 211 276],13,5,3797,3.8903688524590163,20.0,40.0
976,0,976,[316 272 303 211 276],13,5,3802,3.8915046059365404,20.0,40.0
977,0,977,[216 230 202 232 420],295,4,3806,3.8916155419222904,0.0,0.0
978,0,978,[316 272 303 211 276],90,5,3811,3.892747701736466,20.0,40.0
979,0,979,[284 209 230 215 208],92,3,3814,3.8918367346938774,0.0,0.0
980,0,980,[316 272 303 211 276],13,5,3819,3.8929663608562692,20.0,40.0
981,0,981,[316 272 303 211 276],13,5,3824,3.894093686354379,20.0,40.0
982,0,982,[452 276 215 280 336],13,3,3827,3.8931841302136316,0.0,20.0
983,0,983,[429 303 239 275 202],537,2,3829,3.891260162601626,0.0,20.0
984,0,984,[217 230 222 452 219],648,3,3832,3.8903553299492386,0.0,20.0
985,0,985,[316 272 303 211 276],90,5,3837,3.891480730223124,20.0,40.0
986,0,986,[236 344 223 316 284],894,4,3841,3.891590678824721,40.0,0.0
987,0,987,[316 272 303 211 276],13,5,3846,3.8927125506072873,20.0,40.0
988,0,988,[316 272 303 211 276],13,5,3851,3.8938321536905964,20.0,40.0
989,0,989,[316 272 303 211 276],13,5,3856,3.894949494949495,20.0,40.0
990,0,990,[316 272 303 211 276],13,5,3861,3.8960645812310797,20.0,40.0
991,0,991,[284 508 212 299 509],537,2,3863,3.8941532258064515,0.0,0.0
992,0,992,[291 221 239 284 509],537,1,3864,3.891238670694864,0.0,0.0
993,0,993,[478 481 212 508 485],13,2,3866,3.8893360160965793,0.0,0.0
994,0,994,[316 272 303 211 276],13,5,3871,3.8904522613065327,20.0,40.0
995,0,995,[316 272 303 211 276],90,5,3876,3.891566265060241,20.0,40.0
996,0,996,[316 272 303 211 276],90,5,3881,3.892678034102307,20.0,40.0
997,0,997,[316 272 303 211 276],13,5,3886,3.8937875751503004,20.0,40.0
998,0,998,[316 272 303 211 276],90,5,3891,3.894894894894895,20.0,40.0
999,0,999,[429 272 208 293 255],334,3,3894,3.894,0.0,0.0
1000,0,1000,[316 272 303 211 276],90,5,3899,3.895104895104895,20.0,40.0
1001,0,1001,[316 272 303 211 276],90,5,3904,3.8962075848303392,20.0,40.0
1002,0,1002,[316 272 303 211 276],90,5,3909,3.897308075772682,20.0,40.0
1003,0,1003,[232 508 231 201 215],13,1,3910,3.894422310756972,0.0,0.0
1004,0,1004,[316 272 303 211 276],13,5,3915,3.8955223880597014,20.0,40.0
1005,0,1005,[316 272 303 211 276],90,5,3920,3.89662027833002,20.0,40.0
1006,0,1006,[316 272 303 211 276],13,5,3925,3.8977159880834162,20.0,40.0
1007,0,1007,[316 272 303 211 276],13,5,3930,3.8988095238095237,20.0,40.0
1008,0,1008,[316 272 303 211 276],90,5,3935,3.8999008919722495,20.0,40.0
1009,0,1009,[316 272 303 211 276],90,5,3940,3.900990099009901,20.0,40.0
1010,0,1010,[316 272 303 211 276],13,5,3945,3.9020771513353116,20.0,40.0
1011,0,1011,[316 272 303 211 276],13,5,3950,3.9031620553359683,20.0,40.0
1012,0,1012,[316 272 303 211 276],13,5,3955,3.904244817374136,20.0,40.0
1013,0,1013,[316 272 303 211 276],13,5,3960,3.905325443786982,20.0,40.0
1014,0,1014,[231 280 478 507 223],13,3,3963,3.904433497536946,20.0,0.0
1015,0,1015,[316 272 303 211 276],90,5,3968,3.905511811023622,20.0,40.0
1016,0,1016,[316 272 303 211 276],90,5,3973,3.9065880039331367,20.0,40.0
1017,0,1017,[316 272 303 211 276],13,5,3978,3.907662082514735,20.0,40.0
1018,0,1018,[283 293 300 259 485],454,4,3982,3.9077526987242392,0.0,20.0
1019,0,1019,[316 272 303 211 276],13,5,3987,3.9088235294117646,20.0,40.0
1020,0,1020,[316 272 303 211 276],13,5,3992,3.909892262487757,20.0,40.0
1021,0,1021,[316 272 303 211 276],13,5,3997,3.910958904109589,20.0,40.0
1022,0,1022,[316 272 303 211 276],90,5,4002,3.9120234604105573,20.0,40.0
1023,0,1023,[316 272 303 211 276],13,5,4007,3.9130859375,20.0,40.0
1024,0,1024,[280 350 509 299 336],894,1,4008,3.9102439024390243,0.0,0.0
1025,0,1025,[316 272 303 211 276],90,5,4013,3.9113060428849904,20.0,40.0
1026,0,1026,[316 272 303 211 276],13,5,4018,3.9123661148977606,20.0,40.0
1027,0,1027,[301 211 218 239 303],13,3,4021,3.9114785992217898,0.0,20.0
1028,0,1028,[316 272 303 211 276],13,5,4026,3.912536443148688,20.0,40.0
1029,0,1029,[316 272 303 211 276],13,5,4031,3.913592233009709,20.0,40.0
1030,0,1030,[283 272 211 239 216],271,3,4034,3.91270611057226,0.0,20.0
1031,0,1031,[275 216 509 300 280],378,4,4038,3.9127906976744184,0.0,40.0
1032,0,1032,[316 272 303 211 276],90,5,4043,3.913843175217812,20.0,40.0
1033,0,1033,[213 275 202 508 223],378,4,4047,3.913926499032882,20.0,20.0
1034,0,1034,[209 216 241 485 232],194,0,4047,3.9101449275362317,0.0,0.0
1035,0,1035,[316 272 303 211 276],13,5,4052,3.911196911196911,20.0,40.0
1036,0,1036,[201 509 236 283 508],537,3,4055,3.910318225650916,0.0,0.0
1037,0,1037,[227 216 378 230 211],653,0,4055,3.9065510597302504,0.0,20.0
1038,0,1038,[255 367 283 208 284],899,3,4058,3.9056785370548606,0.0,0.0
1039,0,1039,[365 298 321 231 509],308,2,4060,3.9038461538461537,0.0,0.0
1040,0,1040,[316 272 303 211 276],90,5,4065,3.9048991354466858,20.0,40.0
1041,0,1041,[316 272 303 211 276],13,5,4070,3.9059500959692897,20.0,40.0
1042,0,1042,[316 272 303 211 276],13,5,4075,3.906999041227229,20.0,40.0
1043,0,1043,[316 272 303 211 276],13,5,4080,3.9080459770114944,20.0,40.0
1044,0,1044,[316 272 303 211 276],13,5,4085,3.909090909090909,20.0,40.0
1045,0,1045,[507 230 301 231 431],13,0,4085,3.9053537284894837,0.0,0.0
1046,0,1046,[316 272 303 211 276],13,5,4090,3.90639923591213,20.0,40.0
1047,0,1047,[316 272 303 211 276],13,5,4095,3.907442748091603,20.0,40.0
1048,0,1048,[316 272 303 211 276],90,5,4100,3.9084842707340326,20.0,40.0
1049,0,1049,[211 316 241 336 268],13,3,4103,3.9076190476190478,20.0,20.0
1050,0,1050,[316 272 303 211 276],13,5,4108,3.9086584205518555,20.0,40.0
1051,0,1051,[283 276 268 208 324],334,5,4113,3.909695817490494,0.0,20.0
1052,0,1052,[316 272 303 211 276],13,5,4118,3.9107312440645776,20.0,40.0
1053,0,1053,[316 272 303 211 276],90,5,4123,3.911764705882353,20.0,40.0
1054,0,1054,[316 272 303 211 276],13,5,4128,3.9127962085308057,20.0,40.0
1055,0,1055,[316 272 303 211 276],13,5,4133,3.913825757575758,20.0,40.0
1056,0,1056,[316 272 303 211 276],13,5,4138,3.914853358561968,20.0,40.0
1057,0,1057,[316 272 303 211 276],13,5,4143,3.9158790170132325,20.0,40.0
1058,0,1058,[316 272 303 211 276],13,5,4148,3.9169027384324835,20.0,40.0
1059,0,1059,[316 272 303 211 276],90,5,4153,3.917924528301887,20.0,40.0
1060,0,1060,[213 219 509 324 208],7,2,4155,3.9161168708765315,0.0,0.0
1061,0,1061,[316 272 303 211 276],13,5,4160,3.9171374764595104,20.0,40.0
1062,0,1062,[316 272 303 211 276],13,5,4165,3.9181561618062086,20.0,40.0
1063,0,1063,[316 272 303 211 276],13,5,4170,3.919172932330827,20.0,40.0
1064,0,1064,[316 272 303 211 276],13,5,4175,3.92018779342723,20.0,40.0
1065,0,1065,[316 272 303 211 276],90,5,4180,3.921200750469043,20.0,40.0
1066,0,1066,[316 272 303 211 276],90,5,4185,3.922211808809747,20.0,40.0
1067,0,1067,[316 272 303 211 276],90,5,4190,3.9232209737827715,20.0,40.0
1068,0,1068,[215 336 478 211 299],13,3,4193,3.922357343311506,0.0,20.0
1069,0,1069,[316 272 303 211 276],90,5,4198,3.9233644859813084,20.0,40.0
1070,0,1070,[316 272 303 211 276],90,5,4203,3.9243697478991595,20.0,40.0
1071,0,1071,[218 429 316 413 219],13,2,4205,3.922574626865672,20.0,0.0
1072,0,1072,[316 272 303 211 276],90,5,4210,3.9235787511649582,20.0,40.0
1073,0,1073,[316 272 303 211 276],13,5,4215,3.9245810055865924,20.0,40.0
1074,0,1074,[316 272 303 211 276],90,5,4220,3.925581395348837,20.0,40.0
1075,0,1075,[316 272 303 211 276],13,5,4225,3.926579925650558,20.0,40.0
1076,0,1076,[394 275 264 227 243],13,2,4227,3.9247910863509747,0.0,20.0
1077,0,1077,[283 300 241 209 223],234,1,4228,3.9220779220779223,20.0,20.0
1078,0,1078,[316 272 303 211 276],13,5,4233,3.923076923076923,20.0,40.0
1079,0,1079,[284 301 290 481 215],524,2,4235,3.9212962962962963,0.0,0.0
1080,0,1080,[316 272 303 211 276],90,5,4240,3.9222941720629048,20.0,40.0
1081,0,1081,[316 272 303 211 276],13,5,4245,3.9232902033271717,20.0,40.0
1082,0,1082,[222 201 221 392 208],537,1,4246,3.920590951061865,0.0,20.0
1083,0,1083,[316 272 303 211 276],90,5,4251,3.9215867158671585,20.0,40.0
1084,0,1084,[485 429 431 284 507],234,2,4253,3.919815668202765,0.0,0.0
1085,0,1085,[222 431 239 217 232],64,2,4255,3.91804788213628,0.0,20.0
1086,0,1086,[394 431 243 275 509],13,1,4256,3.9153633854645813,0.0,20.0
1087,0,1087,[241 336 239 218 300],13,1,4257,3.9126838235294117,0.0,20.0
1088,0,1088,[316 272 303 211 276],13,5,4262,3.913682277318641,20.0,40.0
1089,0,1089,[316 272 303 211 276],13,5,4267,3.9146788990825687,20.0,40.0
1090,0,1090,[316 272 303 211 276],90,5,4272,3.915673693858845,20.0,40.0
1091,0,1091,[316 272 303 211 276],13,5,4277,3.9166666666666665,20.0,40.0
1092,0,1092,[316 272 303 211 276],90,5,4282,3.917657822506862,20.0,40.0
1093,0,1093,[394 268 326 218 201],13,1,4283,3.9149908592321756,0.0,0.0
1094,0,1094,[316 272 303 211 276],13,5,4288,3.9159817351598174,20.0,40.0
1095,0,1095,[331 264 299 478 344],13,2,4290,3.914233576642336,0.0,0.0
1096,0,1096,[316 272 303 211 276],90,5,4295,3.9152233363719233,20.0,40.0
1097,0,1097,[316 272 303 211 276],90,5,4300,3.916211293260474,20.0,40.0
1098,0,1098,[316 272 303 211 276],13,5,4305,3.917197452229299,20.0,40.0
1099,0,1099,[216 507 367 221 226],234,2,4307,3.9154545454545455,0.0,0.0
1100,0,1100,[316 272 303 211 276],90,5,4312,3.916439600363306,20.0,40.0
1101,0,1101,[316 272 303 211 276],90,5,4317,3.917422867513612,20.0,40.0
1102,0,1102,[316 272 303 211 276],13,5,4322,3.9184043517679057,20.0,40.0
1103,0,1103,[316 272 303 211 276],90,5,4327,3.9193840579710146,20.0,40.0
1104,0,1104,[316 272 303 211 276],13,5,4332,3.920361990950226,20.0,40.0
1105,0,1105,[316 272 303 211 276],90,5,4337,3.921338155515371,20.0,40.0
1106,0,1106,[316 272 303 211 276],13,5,4342,3.922312556458898,20.0,40.0
1107,0,1107,[254 507 231 583 239],308,1,4343,3.9196750902527078,0.0,0.0
1108,0,1108,[316 272 303 211 276],13,5,4348,3.9206492335437333,20.0,40.0
1109,0,1109,[316 272 303 211 276],90,5,4353,3.9216216216216218,20.0,40.0
1110,0,1110,[316 272 303 211 276],90,5,4358,3.922592259225923,20.0,40.0
1111,0,1111,[316 272 303 211 276],90,5,4363,3.9235611510791366,20.0,40.0
1112,0,1112,[300 222 232 316 275],85,0,4363,3.9200359389038635,20.0,60.0
1113,0,1113,[222 300 216 230 315],537,1,4364,3.9174147217235187,20.0,40.0
1114,0,1114,[261 429 231 218 290],13,2,4366,3.915695067264574,0.0,0.0
1115,0,1115,[316 272 303 211 276],90,5,4371,3.9166666666666665,20.0,40.0
1116,0,1116,[222 508 324 264 255],294,3,4374,3.9158460161145925,0.0,20.0
1117,0,1117,[507 367 232 481 508],326,0,4374,3.9123434704830053,0.0,0.0
1118,0,1118,[316 272 303 211 276],90,5,4379,3.9133154602323503,20.0,40.0
1119,0,1119,[316 272 303 211 276],13,5,4384,3.914285714285714,20.0,40.0
1120,0,1120,[429 230 222 254 295],648,4,4388,3.9143621766280106,0.0,20.0
1121,0,1121,[316 272 303 211 276],90,5,4393,3.915329768270945,20.0,40.0
1122,0,1122,[316 272 303 211 276],90,5,4398,3.9162956366874444,20.0,40.0
1123,0,1123,[316 272 303 211 276],90,5,4403,3.917259786476868,20.0,40.0
1124,0,1124,[284 216 226 291 429],279,2,4405,3.9155555555555557,0.0,0.0
1125,0,1125,[208 202 211 216 219],406,1,4406,3.9129662522202486,0.0,20.0
1126,0,1126,[316 272 303 211 276],90,5,4411,3.9139307897071873,20.0,40.0
1127,0,1127,[316 272 303 211 276],90,5,4416,3.9148936170212765,20.0,40.0
1128,0,1128,[316 272 303 211 276],90,5,4421,3.91585473870682,20.0,40.0
1129,0,1129,[316 272 303 211 276],90,5,4426,3.9168141592920356,20.0,40.0
1130,0,1130,[231 230 215 254 283],308,1,4427,3.914235190097259,0.0,0.0
1131,0,1131,[216 275 509 378 316],474,4,4431,3.914310954063604,20.0,20.0
1132,0,1132,[316 272 303 211 276],13,5,4436,3.915269196822595,20.0,40.0
1133,0,1133,[316 272 303 211 276],13,5,4441,3.916225749559083,20.0,40.0
1134,0,1134,[201 478 508 394 280],13,2,4443,3.9145374449339205,0.0,0.0
1135,0,1135,[316 272 303 211 276],13,5,4448,3.915492957746479,20.0,40.0
1136,0,1136,[316 272 303 211 276],13,5,4453,3.916446789797713,20.0,40.0
1137,0,1137,[316 272 303 211 276],13,5,4458,3.9173989455184532,20.0,40.0
1138,0,1138,[316 272 303 211 276],90,5,4463,3.9183494293239685,20.0,40.0
1139,0,1139,[223 211 209 300 485],409,3,4466,3.9175438596491228,20.0,40.0
1140,0,1140,[283 230 216 206 231],537,1,4467,3.9149868536371604,0.0,0.0
1141,0,1141,[316 272 303 211 276],90,5,4472,3.915936952714536,20.0,40.0
1142,0,1142,[316 272 303 211 276],90,5,4477,3.916885389326334,20.0,40.0
1143,0,1143,[316 272 303 211 276],13,5,4482,3.917832167832168,20.0,40.0
1144,0,1144,[316 272 303 211 276],90,5,4487,3.918777292576419,20.0,40.0
1145,0,1145,[316 272 303 211 276],13,5,4492,3.919720767888307,20.0,40.0
1146,0,1146,[316 272 303 211 276],90,5,4497,3.920662598081953,20.0,40.0
1147,0,1147,[316 272 303 211 276],13,5,4502,3.921602787456446,20.0,40.0
1148,0,1148,[219 202 231 264 208],7,2,4504,3.919930374238468,0.0,0.0
1149,0,1149,[211 321 215 420 275],311,2,4506,3.9182608695652172,0.0,40.0
1150,0,1150,[241 219 213 223 221],234,0,4506,3.9148566463944396,20.0,0.0
1151,0,1151,[316 272 303 211 276],90,5,4511,3.915798611111111,20.0,40.0
1152,0,1152,[316 272 303 211 276],90,5,4516,3.9167389418907197,20.0,40.0
1153,0,1153,[316 272 303 211 276],13,5,4521,3.917677642980936,20.0,40.0
1154,0,1154,[316 272 303 211 276],13,5,4526,3.9186147186147187,20.0,40.0
1155,0,1155,[316 272 303 211 276],90,5,4531,3.919550173010381,20.0,40.0
1156,0,1156,[216 315 209 316 299],145,5,4536,3.9204840103716507,40.0,0.0
1157,0,1157,[316 272 303 211 276],13,5,4541,3.9214162348877375,20.0,40.0
1158,0,1158,[316 272 303 211 276],13,5,4546,3.922346850733391,20.0,40.0
1159,0,1159,[316 272 303 211 276],90,5,4551,3.9232758620689654,20.0,40.0
1160,0,1160,[316 272 303 211 276],13,5,4556,3.9242032730404826,20.0,40.0
1161,0,1161,[316 272 303 211 276],90,5,4561,3.9251290877796903,20.0,40.0
1162,0,1162,[316 272 303 211 276],90,5,4566,3.9260533104041273,20.0,40.0
1163,0,1163,[316 272 303 211 276],90,5,4571,3.926975945017182,20.0,40.0
1164,0,1164,[316 272 303 211 276],90,5,4576,3.9278969957081546,20.0,40.0
1165,0,1165,[316 272 303 211 276],13,5,4581,3.9288164665523158,20.0,40.0
1166,0,1166,[316 272 303 211 276],90,5,4586,3.929734361610968,20.0,40.0
1167,0,1167,[220 246 201 241 223],92,2,4588,3.9280821917808217,20.0,0.0
1168,0,1168,[316 272 303 211 276],13,5,4593,3.928999144568007,20.0,40.0
1169,0,1169,[250 208 420 275 211],85,3,4596,3.928205128205128,0.0,40.0
1170,0,1170,[316 272 303 211 276],90,5,4601,3.929120409906063,20.0,40.0
1171,0,1171,[485 420 384 481 227],13,2,4603,3.9274744027303754,0.0,0.0
1172,0,1172,[316 272 303 211 276],90,5,4608,3.928388746803069,20.0,40.0
1173,0,1173,[316 272 303 211 276],90,5,4613,3.9293015332197614,20.0,40.0
1174,0,1174,[316 272 303 211 276],13,5,4618,3.930212765957447,20.0,40.0
1175,0,1175,[316 272 303 211 276],90,5,4623,3.931122448979592,20.0,40.0
1176,0,1176,[316 272 303 211 276],13,5,4628,3.9320305862361935,20.0,40.0
1177,0,1177,[316 272 303 211 276],90,5,4633,3.932937181663837,20.0,40.0
1178,0,1178,[316 272 303 211 276],90,5,4638,3.9338422391857506,20.0,40.0
1179,0,1179,[316 272 303 211 276],90,5,4643,3.9347457627118643,20.0,40.0
1180,0,1180,[420 223 481 431 507],7,5,4648,3.935647756138865,20.0,0.0
1181,0,1181,[316 272 303 211 276],13,5,4653,3.936548223350254,20.0,40.0
1182,0,1182,[316 272 303 211 276],90,5,4658,3.937447168216399,20.0,40.0
1183,0,1183,[316 272 303 211 276],90,5,4663,3.9383445945945947,20.0,40.0
1184,0,1184,[429 280 209 276 241],13,3,4666,3.9375527426160337,0.0,20.0
1185,0,1185,[316 272 303 211 276],90,5,4671,3.938448566610455,20.0,40.0
1186,0,1186,[316 272 303 211 276],13,5,4676,3.9393428812131424,20.0,40.0
1187,0,1187,[316 272 303 211 276],13,5,4681,3.9402356902356903,20.0,40.0
1188,0,1188,[316 272 303 211 276],13,5,4686,3.9411269974768715,20.0,40.0
1189,0,1189,[259 212 507 485 509],474,4,4690,3.9411764705882355,0.0,0.0
1190,0,1190,[316 272 303 211 276],13,5,4695,3.9420654911838793,20.0,40.0
1191,0,1191,[316 272 303 211 276],13,5,4700,3.942953020134228,20.0,40.0
1192,0,1192,[316 272 303 211 276],90,5,4705,3.9438390611902765,20.0,40.0
1193,0,1193,[316 272 303 211 276],90,5,4710,3.9447236180904524,20.0,40.0
1194,0,1194,[316 272 303 211 276],13,5,4715,3.9456066945606696,20.0,40.0
1195,0,1195,[316 272 303 211 276],13,5,4720,3.9464882943143813,20.0,40.0
1196,0,1196,[384 431 485 378 268],7,3,4723,3.945697577276525,0.0,0.0
1197,0,1197,[316 272 303 211 276],90,5,4728,3.946577629382304,20.0,40.0
1198,0,1198,[316 272 303 211 276],90,5,4733,3.947456213511259,20.0,40.0
1199,0,1199,[301 452 226 231 300],13,1,4734,3.945,0.0,20.0
1200,0,1200,[241 508 478 367 507],13,1,4735,3.9425478767693587,0.0,0.0
1201,0,1201,[316 272 303 211 276],90,5,4740,3.9434276206322796,20.0,40.0
1202,0,1202,[316 272 303 211 276],90,5,4745,3.944305901911887,20.0,40.0
1203,0,1203,[316 272 303 211 276],90,5,4750,3.9451827242524917,20.0,40.0
1204,0,1204,[222 241 239 293 230],387,2,4752,3.9435684647302907,0.0,20.0
1205,0,1205,[240 298 222 365 326],749,2,4754,3.94195688225539,0.0,20.0
1206,0,1206,[316 272 303 211 276],90,5,4759,3.9428334714167357,20.0,40.0
1207,0,1207,[316 272 303 211 276],90,5,4764,3.943708609271523,20.0,40.0
1208,0,1208,[316 272 303 211 276],13,5,4769,3.944582299421009,20.0,40.0
1209,0,1209,[452 201 226 431 420],13,2,4771,3.94297520661157,0.0,0.0
1210,0,1210,[316 272 303 211 276],90,5,4776,3.943848059454996,20.0,40.0
1211,0,1211,[316 272 303 211 276],90,5,4781,3.9447194719471947,20.0,40.0
1212,0,1212,[350 244 268 344 221],894,3,4784,3.9439406430338004,0.0,0.0
1213,0,1213,[227 215 208 211 378],311,4,4788,3.943986820428336,0.0,20.0
1214,0,1214,[316 272 303 211 276],13,5,4793,3.944855967078189,20.0,40.0
1215,0,1215,[316 272 303 211 276],13,5,4798,3.945723684210526,20.0,40.0
1216,0,1216,[367 290 230 301 211],524,3,4801,3.9449465899753493,0.0,20.0
1217,0,1217,[316 272 303 211 276],13,5,4806,3.9458128078817736,20.0,40.0
1218,0,1218,[316 272 303 211 276],13,5,4811,3.9466776045939294,20.0,40.0
1219,0,1219,[211 216 215 241 290],59,4,4815,3.94672131147541,0.0,20.0
1220,0,1220,[316 272 303 211 276],90,5,4820,3.9475839475839476,20.0,40.0
1221,0,1221,[316 272 303 211 276],13,5,4825,3.948445171849427,20.0,40.0
1222,0,1222,[208 394 280 212 223],13,4,4829,3.9484873262469335,20.0,0.0
1223,0,1223,[316 272 303 211 276],13,5,4834,3.9493464052287583,20.0,40.0
1224,0,1224,[316 272 303 211 276],90,5,4839,3.950204081632653,20.0,40.0
1225,0,1225,[316 272 303 211 276],13,5,4844,3.9510603588907016,20.0,40.0
1226,0,1226,[316 272 303 211 276],90,5,4849,3.951915240423798,20.0,40.0
1227,0,1227,[481 344 272 420 218],13,2,4851,3.9503257328990227,0.0,0.0
1228,0,1228,[316 272 303 211 276],13,5,4856,3.951179820992677,20.0,40.0
1229,0,1229,[316 272 303 211 276],13,5,4861,3.9520325203252034,20.0,40.0
1230,0,1230,[316 272 303 211 276],90,5,4866,3.952883834281072,20.0,40.0
1231,0,1231,[508 298 297 326 331],894,2,4868,3.9512987012987013,20.0,0.0
1232,0,1232,[316 272 303 211 276],90,5,4873,3.9521492295214924,20.0,40.0
1233,0,1233,[316 272 303 211 276],90,5,4878,3.952998379254457,20.0,40.0
1234,0,1234,[316 272 303 211 276],90,5,4883,3.953846153846154,20.0,40.0
1235,0,1235,[316 272 303 211 276],90,5,4888,3.954692556634304,20.0,40.0
1236,0,1236,[316 272 303 211 276],13,5,4893,3.955537590945837,20.0,40.0
1237,0,1237,[280 344 301 222 507],13,1,4894,3.9531502423263327,0.0,20.0
1238,0,1238,[316 272 303 211 276],13,5,4899,3.953995157384988,20.0,40.0
1239,0,1239,[481 212 300 232 378],7,3,4902,3.953225806451613,0.0,20.0
1240,0,1240,[316 272 303 211 276],90,5,4907,3.9540692989524575,20.0,40.0
1241,0,1241,[316 272 303 211 276],13,5,4912,3.9549114331723025,20.0,40.0
1242,0,1242,[508 321 272 202 201],13,2,4914,3.9533386967015285,0.0,0.0
1243,0,1243,[316 272 303 211 276],13,5,4919,3.9541800643086815,20.0,40.0
1244,0,1244,[316 272 303 211 276],13,5,4924,3.955020080321285,20.0,40.0
1245,0,1245,[215 301 291 378 202],537,0,4924,3.951845906902087,0.0,0.0
1246,0,1246,[507 201 232 280 290],13,2,4926,3.95028067361668,0.0,0.0
1247,0,1247,[316 272 303 211 276],90,5,4931,3.9511217948717947,20.0,40.0
1248,0,1248,[226 507 264 295 583],308,1,4932,3.948759007205765,0.0,0.0
1249,0,1249,[316 272 303 211 276],13,5,4937,3.9496,20.0,40.0
1250,0,1250,[259 244 509 507 211],474,4,4941,3.949640287769784,0.0,20.0
1251,0,1251,[316 272 303 211 276],90,5,4946,3.950479233226837,20.0,40.0
1252,0,1252,[301 213 226 221 321],524,3,4949,3.9497206703910615,0.0,0.0
1253,0,1253,[316 272 303 211 276],13,5,4954,3.9505582137161084,20.0,40.0
1254,0,1254,[365 276 485 295 217],378,2,4956,3.949003984063745,0.0,20.0
1255,0,1255,[215 268 208 420 241],85,4,4960,3.949044585987261,0.0,0.0
1256,0,1256,[316 272 303 211 276],13,5,4965,3.9498806682577565,20.0,40.0
1257,0,1257,[316 272 303 211 276],13,5,4970,3.9507154213036566,20.0,40.0
1258,0,1258,[431 217 239 478 268],13,3,4973,3.949960285941223,0.0,0.0
1259,0,1259,[316 272 303 211 276],13,5,4978,3.950793650793651,20.0,40.0
1260,0,1260,[316 272 303 211 276],90,5,4983,3.9516256938937353,20.0,40.0
1261,0,1261,[316 272 303 211 276],90,5,4988,3.9524564183835182,20.0,40.0
1262,0,1262,[316 272 303 211 276],90,5,4993,3.9532858273950913,20.0,40.0
1263,0,1263,[316 272 303 211 276],90,5,4998,3.954113924050633,20.0,40.0
1264,0,1264,[222 216 478 378 431],537,2,5000,3.952569169960474,0.0,20.0
1265,0,1265,[241 268 394 264 211],13,3,5003,3.9518167456556084,0.0,20.0
1266,0,1266,[316 272 303 211 276],90,5,5008,3.952644041041831,20.0,40.0
1267,0,1267,[316 272 303 211 276],13,5,5013,3.9534700315457414,20.0,40.0
1268,0,1268,[316 272 303 211 276],13,5,5018,3.954294720252167,20.0,40.0
1269,0,1269,[316 272 303 211 276],90,5,5023,3.9551181102362203,20.0,40.0
1270,0,1270,[316 272 303 211 276],90,5,5028,3.955940204563336,20.0,40.0
1271,0,1271,[331 264 452 275 350],13,1,5029,3.9536163522012577,0.0,20.0
1272,0,1272,[316 272 303 211 276],13,5,5034,3.9544383346425764,20.0,40.0
1273,0,1273,[431 250 219 227 283],279,2,5036,3.9529042386185242,0.0,0.0
1274,0,1274,[316 272 303 211 276],13,5,5041,3.9537254901960783,20.0,40.0
1275,0,1275,[316 272 303 211 276],13,5,5046,3.9545454545454546,20.0,40.0
1276,0,1276,[316 272 303 211 276],13,5,5051,3.955364134690681,20.0,40.0
1277,0,1277,[316 272 303 211 276],90,5,5056,3.956181533646322,20.0,40.0
1278,0,1278,[316 272 303 211 276],13,5,5061,3.956997654417514,20.0,40.0
1279,0,1279,[316 272 303 211 276],90,5,5066,3.9578125,20.0,40.0
1280,0,1280,[316 272 303 211 276],90,5,5071,3.958626073380172,20.0,40.0
1281,0,1281,[316 272 303 211 276],13,5,5076,3.9594383775351014,20.0,40.0
1282,0,1282,[316 272 303 211 276],13,5,5081,3.96024941543258,20.0,40.0
1283,0,1283,[316 272 303 211 276],90,5,5086,3.9610591900311527,20.0,40.0
1284,0,1284,[316 272 303 211 276],13,5,5091,3.9618677042801558,20.0,40.0
1285,0,1285,[316 272 303 211 276],13,5,5096,3.962674961119751,20.0,40.0
1286,0,1286,[431 230 243 231 215],92,2,5098,3.961149961149961,0.0,0.0
1287,0,1287,[316 272 303 211 276],90,5,5103,3.9619565217391304,20.0,40.0
1288,0,1288,[431 216 201 299 212],13,1,5104,3.9596586501163693,0.0,0.0
1289,0,1289,[316 272 303 211 276],90,5,5109,3.9604651162790696,20.0,40.0
1290,0,1290,[268 221 230 227 250],334,3,5112,3.9597211463981408,0.0,0.0
1291,0,1291,[208 367 291 215 301],234,2,5114,3.958204334365325,0.0,0.0
1292,0,1292,[316 272 303 211 276],13,5,5119,3.9590100541376643,20.0,40.0
1293,0,1293,[316 272 303 211 276],13,5,5124,3.9598145285935087,20.0,40.0
1294,0,1294,[316 272 303 211 276],13,5,5129,3.960617760617761,20.0,40.0
1295,0,1295,[316 272 303 211 276],13,5,5134,3.9614197530864197,20.0,40.0
1296,0,1296,[316 272 303 211 276],90,5,5139,3.9622205088666154,20.0,40.0
1297,0,1297,[316 272 303 211 276],13,5,5144,3.963020030816641,20.0,40.0
1298,0,1298,[316 272 303 211 276],13,5,5149,3.9638183217859893,20.0,40.0
1299,0,1299,[316 272 303 211 276],13,5,5154,3.9646153846153847,20.0,40.0
1300,0,1300,[316 272 303 211 276],90,5,5159,3.965411222136818,20.0,40.0
1301,0,1301,[316 272 303 211 276],13,5,5164,3.9662058371735793,20.0,40.0
1302,0,1302,[367 481 272 230 215],766,2,5166,3.964696853415196,0.0,0.0
1303,0,1303,[316 272 303 211 276],13,5,5171,3.9654907975460123,20.0,40.0
1304,0,1304,[316 272 303 211 276],90,5,5176,3.9662835249042145,20.0,40.0
1305,0,1305,[316 272 303 211 276],90,5,5181,3.967075038284839,20.0,40.0
1306,0,1306,[413 226 209 223 272],13,3,5184,3.966335118592196,20.0,0.0
1307,0,1307,[316 272 303 211 276],13,5,5189,3.967125382262997,20.0,40.0
1308,0,1308,[316 272 303 211 276],90,5,5194,3.9679144385026737,20.0,40.0
1309,0,1309,[316 272 303 211 276],13,5,5199,3.968702290076336,20.0,40.0
1310,0,1310,[316 272 303 211 276],13,5,5204,3.969488939740656,20.0,40.0
1311,0,1311,[316 272 303 211 276],13,5,5209,3.9702743902439024,20.0,40.0
1312,0,1312,[316 272 303 211 276],90,5,5214,3.971058644325971,20.0,40.0
1313,0,1313,[316 272 303 211 276],13,5,5219,3.971841704718417,20.0,40.0
1314,0,1314,[316 272 303 211 276],90,5,5224,3.9726235741444866,20.0,40.0
1315,0,1315,[507 227 209 259 284],194,1,5225,3.9703647416413372,0.0,0.0
1316,0,1316,[316 272 303 211 276],90,5,5230,3.971146545178436,20.0,40.0
1317,0,1317,[240 230 300 394 316],145,3,5233,3.97040971168437,20.0,20.0
1318,0,1318,[316 272 303 211 276],90,5,5238,3.9711902956785443,20.0,40.0
1319,0,1319,[244 223 239 303 236],334,3,5241,3.9704545454545452,20.0,0.0
1320,0,1320,[316 272 303 211 276],13,5,5246,3.971233913701741,20.0,40.0
1321,0,1321,[316 272 303 211 276],13,5,5251,3.972012102874433,20.0,40.0
1322,0,1322,[316 272 303 211 276],90,5,5256,3.9727891156462585,20.0,40.0
1323,0,1323,[316 272 303 211 276],90,5,5261,3.9735649546827796,20.0,40.0
1324,0,1324,[316 272 303 211 276],90,5,5266,3.9743396226415095,20.0,40.0
1325,0,1325,[212 209 276 284 293],474,5,5271,3.975113122171946,0.0,20.0
1326,0,1326,[230 344 201 268 431],13,1,5272,3.972871137905049,0.0,0.0
1327,0,1327,[316 272 303 211 276],13,5,5277,3.973644578313253,20.0,40.0
1328,0,1328,[316 272 303 211 276],13,5,5282,3.9744168547780285,20.0,40.0
1329,0,1329,[316 272 303 211 276],13,5,5287,3.975187969924812,20.0,40.0
1330,0,1330,[316 272 303 211 276],13,5,5292,3.9759579263711493,20.0,40.0
1331,0,1331,[226 272 508 217 276],378,3,5295,3.975225225225225,0.0,20.0
1332,0,1332,[431 485 250 283 324],479,3,5298,3.9744936234058517,0.0,0.0
1333,0,1333,[316 272 303 211 276],90,5,5303,3.975262368815592,20.0,40.0
1334,0,1334,[316 272 303 211 276],13,5,5308,3.9760299625468165,20.0,40.0
1335,0,1335,[232 219 324 202 209],387,2,5310,3.9745508982035926,0.0,0.0
1336,0,1336,[316 272 303 211 276],13,5,5315,3.9753178758414363,20.0,40.0
1337,0,1337,[316 272 303 211 276],13,5,5320,3.976083707025411,20.0,40.0
1338,0,1338,[298 221 230 378 508],533,4,5324,3.976101568334578,0.0,0.0
1339,0,1339,[316 272 303 211 276],90,5,5329,3.976865671641791,20.0,40.0
1340,0,1340,[283 230 300 326 250],334,2,5331,3.975391498881432,0.0,20.0
1341,0,1341,[293 222 367 508 211],533,3,5334,3.9746646795827125,0.0,40.0
1342,0,1342,[316 272 303 211 276],90,5,5339,3.975428145941921,20.0,40.0
1343,0,1343,[222 220 212 201 208],92,3,5342,3.974702380952381,0.0,20.0
1344,0,1344,[316 272 303 211 276],90,5,5347,3.9754646840148697,20.0,40.0
1345,0,1345,[316 272 303 211 276],90,5,5352,3.976225854383358,20.0,40.0
1346,0,1346,[316 272 303 211 276],13,5,5357,3.976985894580549,20.0,40.0
1347,0,1347,[316 272 303 211 276],90,5,5362,3.977744807121662,20.0,40.0
1348,0,1348,[316 272 303 211 276],13,5,5367,3.978502594514455,20.0,40.0
1349,0,1349,[316 272 303 211 276],13,5,5372,3.9792592592592593,20.0,40.0
1350,0,1350,[316 272 303 211 276],13,5,5377,3.980014803849001,20.0,40.0
1351,0,1351,[316 272 303 211 276],90,5,5382,3.980769230769231,20.0,40.0
1352,0,1352,[316 272 303 211 276],13,5,5387,3.981522542498152,20.0,40.0
1353,0,1353,[316 272 303 211 276],90,5,5392,3.982274741506647,20.0,40.0
1354,0,1354,[316 272 303 211 276],13,5,5397,3.9830258302583026,20.0,40.0
1355,0,1355,[316 272 303 211 276],90,5,5402,3.9837758112094397,20.0,40.0
1356,0,1356,[481 290 202 336 231],13,2,5404,3.9823139277818718,0.0,0.0
1357,0,1357,[316 272 303 211 276],13,5,5409,3.9830633284241532,20.0,40.0
1358,0,1358,[316 272 303 211 276],90,5,5414,3.9838116261957324,20.0,40.0
1359,0,1359,[316 272 303 211 276],13,5,5419,3.9845588235294116,20.0,40.0
1360,0,1360,[316 272 303 211 276],13,5,5424,3.985304922850845,20.0,40.0
1361,0,1361,[420 222 321 217 215],13,2,5426,3.983847283406755,0.0,20.0
1362,0,1362,[316 272 303 211 276],13,5,5431,3.9845928099779897,20.0,40.0
1363,0,1363,[316 272 303 211 276],90,5,5436,3.9853372434017595,20.0,40.0
1364,0,1364,[316 272 303 211 276],13,5,5441,3.986080586080586,20.0,40.0
1365,0,1365,[316 272 303 211 276],13,5,5446,3.986822840409956,20.0,40.0
1366,0,1366,[316 272 303 211 276],13,5,5451,3.987564008778347,20.0,40.0
1367,0,1367,[219 211 217 267 227],833,1,5452,3.9853801169590644,0.0,20.0
1368,0,1368,[316 272 303 211 276],13,5,5457,3.9861212563915265,20.0,40.0
1369,0,1369,[316 272 303 211 276],90,5,5462,3.986861313868613,20.0,40.0
1370,0,1370,[293 259 431 218 213],346,1,5463,3.984682713347921,0.0,0.0
1371,0,1371,[316 272 303 211 276],90,5,5468,3.9854227405247813,20.0,40.0
1372,0,1372,[236 291 222 212 478],537,1,5469,3.9832483612527314,0.0,20.0
1373,0,1373,[316 272 303 211 276],13,5,5474,3.9839883551673947,20.0,40.0
1374,0,1374,[316 272 303 211 276],90,5,5479,3.9847272727272727,20.0,40.0
1375,0,1375,[202 429 209 452 243],650,1,5480,3.9825581395348837,0.0,0.0
1376,0,1376,[254 420 326 431 239],749,4,5484,3.982570806100218,0.0,0.0
1377,0,1377,[316 272 303 211 276],13,5,5489,3.983309143686502,20.0,40.0
1378,0,1378,[222 509 230 217 223],378,2,5491,3.981870920957215,20.0,20.0
1379,0,1379,[301 485 212 216 239],524,3,5494,3.9811594202898553,0.0,0.0
1380,0,1380,[316 272 303 211 276],13,5,5499,3.9818971759594497,20.0,40.0
1381,0,1381,[316 272 303 211 276],90,5,5504,3.9826338639652676,20.0,40.0
1382,0,1382,[316 272 303 211 276],13,5,5509,3.9833694866232827,20.0,40.0
1383,0,1383,[316 272 303 211 276],13,5,5514,3.9841040462427744,20.0,40.0
1384,0,1384,[316 272 303 211 276],90,5,5519,3.9848375451263536,20.0,40.0
1385,0,1385,[222 275 303 276 264],486,3,5522,3.984126984126984,0.0,60.0
1386,0,1386,[420 300 276 275 232],311,3,5525,3.9834174477289115,0.0,60.0
1387,0,1387,[316 272 303 211 276],90,5,5530,3.984149855907781,20.0,40.0
1388,0,1388,[216 507 215 259 241],85,2,5532,3.9827213822894167,0.0,0.0
1389,0,1389,[301 272 303 276 507],537,4,5536,3.98273381294964,0.0,20.0
1390,0,1390,[316 272 303 211 276],90,5,5541,3.983465132997843,20.0,40.0
1391,0,1391,[316 272 303 211 276],13,5,5546,3.9841954022988504,20.0,40.0
1392,0,1392,[255 256 324 295 236],894,1,5547,3.9820531227566405,0.0,0.0
1393,0,1393,[211 240 321 222 250],560,3,5550,3.981348637015782,0.0,40.0
1394,0,1394,[481 239 201 218 485],308,3,5553,3.9806451612903224,0.0,0.0
1395,0,1395,[316 272 303 211 276],90,5,5558,3.981375358166189,20.0,40.0
1396,0,1396,[316 272 303 211 276],90,5,5563,3.9821045096635648,20.0,40.0
1397,0,1397,[316 272 303 211 276],90,5,5568,3.982832618025751,20.0,40.0
1398,0,1398,[316 272 303 211 276],13,5,5573,3.9835596854896353,20.0,40.0
1399,0,1399,[316 272 303 211 276],13,5,5578,3.9842857142857144,20.0,40.0
1400,0,1400,[378 208 481 431 244],474,4,5582,3.9842969307637404,0.0,0.0
1401,0,1401,[316 272 303 211 276],90,5,5587,3.985021398002853,20.0,40.0
1402,0,1402,[316 272 303 211 276],90,5,5592,3.9857448325017817,20.0,40.0
1403,0,1403,[316 272 303 211 276],13,5,5597,3.9864672364672367,20.0,40.0
1404,0,1404,[290 315 276 216 300],334,2,5599,3.9850533807829183,20.0,40.0
1405,0,1405,[316 272 303 211 276],90,5,5604,3.9857752489331437,20.0,40.0
1406,0,1406,[316 272 303 211 276],13,5,5609,3.986496090973703,20.0,40.0
1407,0,1407,[316 272 303 211 276],90,5,5614,3.987215909090909,20.0,40.0
1408,0,1408,[316 272 303 211 276],13,5,5619,3.987934705464869,20.0,40.0
1409,0,1409,[316 272 303 211 276],90,5,5624,3.9886524822695035,20.0,40.0
1410,0,1410,[316 272 303 211 276],13,5,5629,3.9893692416725726,20.0,40.0
1411,0,1411,[316 272 303 211 276],90,5,5634,3.990084985835694,20.0,40.0
1412,0,1412,[217 378 209 206 227],843,1,5635,3.9879688605803256,0.0,0.0
1413,0,1413,[316 272 303 211 276],13,5,5640,3.9886845827439887,20.0,40.0
1414,0,1414,[272 509 202 324 211],543,2,5642,3.9872791519434627,0.0,20.0
1415,0,1415,[316 303 272 211 276],90,5,5647,3.9879943502824857,20.0,40.0
1416,0,1416,[239 217 508 293 218],334,0,5647,3.9851799576570217,0.0,0.0
1417,0,1417,[222 259 213 202 254],804,4,5651,3.9851904090267984,0.0,20.0
1418,0,1418,[215 226 255 276 231],378,3,5654,3.9844961240310077,0.0,20.0
1419,0,1419,[226 240 429 367 202],774,1,5655,3.982394366197183,0.0,0.0
1420,0,1420,[316 303 272 211 276],13,5,5660,3.98311048557354,20.0,40.0
1421,0,1421,[316 303 272 211 276],13,5,5665,3.9838255977496484,20.0,40.0
1422,0,1422,[268 211 485 201 227],7,2,5667,3.9824314827828533,0.0,20.0
1423,0,1423,[316 303 272 211 276],90,5,5672,3.9831460674157304,20.0,40.0
1424,0,1424,[378 301 276 303 221],537,2,5674,3.9817543859649125,0.0,20.0
1425,0,1425,[230 431 219 217 293],145,4,5678,3.981767180925666,0.0,0.0
1426,0,1426,[276 301 220 254 212],184,2,5680,3.9803784162578837,0.0,20.0
1427,0,1427,[508 211 276 240 367],82,3,5683,3.9796918767507004,0.0,40.0
1428,0,1428,[384 509 215 230 508],13,2,5685,3.9783065080475857,0.0,0.0
1429,0,1429,[316 303 272 211 276],13,5,5690,3.979020979020979,20.0,40.0
1430,0,1430,[316 303 272 211 276],13,5,5695,3.9797344514325648,20.0,40.0
1431,0,1431,[316 303 272 211 276],90,5,5700,3.9804469273743015,20.0,40.0
1432,0,1432,[316 303 272 211 276],13,5,5705,3.98115840893231,20.0,40.0
1433,0,1433,[316 303 272 211 276],13,5,5710,3.9818688981868897,20.0,40.0
1434,0,1434,[316 303 272 211 276],13,5,5715,3.9825783972125435,20.0,40.0
1435,0,1435,[226 209 367 218 213],234,2,5717,3.981197771587744,0.0,0.0
1436,0,1436,[316 303 272 211 276],90,5,5722,3.9819067501739736,20.0,40.0
1437,0,1437,[316 303 272 211 276],90,5,5727,3.9826147426981917,20.0,40.0
1438,0,1438,[316 303 272 211 276],90,5,5732,3.9833217512161223,20.0,40.0
1439,0,1439,[316 303 272 211 276],90,5,5737,3.984027777777778,20.0,40.0
1440,0,1440,[316 303 272 211 276],13,5,5742,3.984732824427481,20.0,40.0
1441,0,1441,[316 303 272 211 276],13,5,5747,3.9854368932038833,20.0,40.0
1442,0,1442,[316 303 272 211 276],90,5,5752,3.986139986139986,20.0,40.0
1443,0,1443,[316 303 272 211 276],90,5,5757,3.986842105263158,20.0,40.0
1444,0,1444,[316 303 272 211 276],90,5,5762,3.9875432525951555,20.0,40.0
1445,0,1445,[316 303 272 211 276],90,5,5767,3.988243430152144,20.0,40.0
1446,0,1446,[316 303 272 211 276],90,5,5772,3.988942639944713,20.0,40.0
1447,0,1447,[316 303 272 211 276],90,5,5777,3.9896408839779007,20.0,40.0
1448,0,1448,[316 303 272 211 276],90,5,5782,3.9903381642512077,20.0,40.0
1449,0,1449,[231 303 211 232 331],13,2,5784,3.9889655172413794,0.0,20.0
1450,0,1450,[268 507 223 478 243],13,3,5787,3.9882839421088905,20.0,0.0
1451,0,1451,[316 303 272 211 276],13,5,5792,3.9889807162534434,20.0,40.0
1452,0,1452,[316 303 272 211 276],90,5,5797,3.9896765313145215,20.0,40.0
1453,0,1453,[316 303 272 211 276],13,5,5802,3.9903713892709765,20.0,40.0
1454,0,1454,[316 303 272 211 276],90,5,5807,3.99106529209622,20.0,40.0
1455,0,1455,[316 303 272 211 276],90,5,5812,3.991758241758242,20.0,40.0
1456,0,1456,[316 303 272 211 276],13,5,5817,3.9924502402196294,20.0,40.0
1457,0,1457,[213 509 315 326 212],311,2,5819,3.9910836762688615,20.0,0.0
1458,0,1458,[316 303 272 211 276],13,5,5824,3.991775188485264,20.0,40.0
1459,0,1459,[316 303 272 211 276],13,5,5829,3.9924657534246575,20.0,40.0
1460,0,1460,[508 226 295 298 236],533,5,5834,3.99315537303217,0.0,0.0
1461,0,1461,[316 303 272 211 276],90,5,5839,3.993844049247606,20.0,40.0
1462,0,1462,[481 217 241 485 507],13,0,5839,3.9911141490088857,0.0,0.0
1463,0,1463,[316 303 272 211 276],90,5,5844,3.9918032786885247,20.0,40.0
1464,0,1464,[316 303 272 211 276],90,5,5849,3.9924914675767917,20.0,40.0
1465,0,1465,[316 303 272 211 276],13,5,5854,3.9931787175989086,20.0,40.0
1466,0,1466,[316 303 272 211 276],13,5,5859,3.9938650306748467,20.0,40.0
1467,0,1467,[431 452 227 301 230],650,1,5860,3.991825613079019,0.0,0.0
1468,0,1468,[209 264 216 485 283],308,1,5861,3.989788972089857,0.0,0.0
1469,0,1469,[316 303 272 211 276],90,5,5866,3.9904761904761905,20.0,40.0
1470,0,1470,[316 303 272 211 276],90,5,5871,3.991162474507138,20.0,40.0
1471,0,1471,[478 507 212 222 223],13,3,5874,3.9904891304347827,20.0,20.0
1472,0,1472,[316 303 272 211 276],90,5,5879,3.991174473862865,20.0,40.0
1473,0,1473,[316 303 272 211 276],90,5,5884,3.9918588873812753,20.0,40.0
1474,0,1474,[213 429 254 240 378],804,4,5888,3.991864406779661,0.0,0.0
1475,0,1475,[316 303 272 211 276],13,5,5893,3.9925474254742546,20.0,40.0
1476,0,1476,[316 303 272 211 276],13,5,5898,3.9932295192958702,20.0,40.0
1477,0,1477,[316 303 272 211 276],13,5,5903,3.993910690121786,20.0,40.0
1478,0,1478,[316 303 272 211 276],90,5,5908,3.9945909398242057,20.0,40.0
1479,0,1479,[316 303 272 211 276],13,5,5913,3.9952702702702703,20.0,40.0
1480,0,1480,[290 232 223 264 201],13,3,5916,3.9945982444294397,20.0,0.0
1481,0,1481,[290 236 206 208 478],234,2,5918,3.9932523616734144,0.0,0.0
1482,0,1482,[216 276 215 211 239],271,3,5921,3.992582602832097,0.0,40.0
1483,0,1483,[316 303 272 211 276],13,5,5926,3.9932614555256065,20.0,40.0
1484,0,1484,[326 231 222 230 227],102,1,5927,3.9912457912457913,0.0,20.0
1485,0,1485,[316 303 272 211 276],90,5,5932,3.9919246298788695,20.0,40.0
1486,0,1486,[241 384 378 220 218],271,1,5933,3.9899125756556826,0.0,0.0
1487,0,1487,[283 255 485 508 272],378,5,5938,3.9905913978494625,0.0,0.0
1488,0,1488,[316 303 272 211 276],13,5,5943,3.9912693082605775,20.0,40.0
1489,0,1489,[250 452 239 216 212],92,3,5946,3.9906040268456375,0.0,0.0
1490,0,1490,[420 284 507 222 208],85,3,5949,3.9899396378269616,0.0,20.0
1491,0,1491,[316 303 272 211 276],13,5,5954,3.9906166219839143,20.0,40.0
1492,0,1492,[316 303 272 211 276],13,5,5959,3.9912926992632283,20.0,40.0
1493,0,1493,[316 303 272 211 276],90,5,5964,3.9919678714859437,20.0,40.0
1494,0,1494,[321 378 478 392 299],537,1,5965,3.9899665551839463,0.0,0.0
1495,0,1495,[316 303 272 211 276],90,5,5970,3.9906417112299466,20.0,40.0
1496,0,1496,[316 303 272 211 276],13,5,5975,3.991315965263861,20.0,40.0
1497,0,1497,[316 303 272 211 276],13,5,5980,3.9919893190921227,20.0,40.0
1498,0,1498,[316 303 272 211 276],90,5,5985,3.9926617745163444,20.0,40.0
1499,0,1499,[392 226 254 509 241],308,3,5988,3.992,0.0,0.0
1500,0,1500,[316 303 272 211 276],90,5,5993,3.9926715522984675,20.0,40.0
1501,0,1501,[316 303 272 211 276],13,5,5998,3.993342210386152,20.0,40.0
1502,0,1502,[316 303 272 211 276],13,5,6003,3.9940119760479043,20.0,40.0
1503,0,1503,[316 303 272 211 276],13,5,6008,3.99468085106383,20.0,40.0
1504,0,1504,[316 303 272 211 276],90,5,6013,3.9953488372093022,20.0,40.0
1505,0,1505,[316 303 272 211 276],13,5,6018,3.99601593625498,20.0,40.0
1506,0,1506,[316 303 272 211 276],13,5,6023,3.9966821499668215,20.0,40.0
1507,0,1507,[367 208 244 230 217],158,4,6027,3.996684350132626,0.0,0.0
1508,0,1508,[241 201 315 216 217],13,1,6028,3.994698475811796,20.0,0.0
1509,0,1509,[316 303 272 211 276],13,5,6033,3.995364238410596,20.0,40.0
1510,0,1510,[284 291 293 508 267],833,2,6035,3.9940436796823295,0.0,0.0
1511,0,1511,[316 303 272 211 276],90,5,6040,3.994708994708995,20.0,40.0
1512,0,1512,[316 303 272 211 276],90,5,6045,3.995373430270985,20.0,40.0
1513,0,1513,[316 303 272 211 276],90,5,6050,3.9960369881109643,20.0,40.0
1514,0,1514,[316 303 272 211 276],13,5,6055,3.9966996699669965,20.0,40.0
1515,0,1515,[316 303 272 211 276],13,5,6060,3.9973614775725594,20.0,40.0
1516,0,1516,[316 303 272 211 276],90,5,6065,3.998022412656559,20.0,40.0
1517,0,1517,[316 303 272 211 276],90,5,6070,3.9986824769433467,20.0,40.0
1518,0,1518,[316 303 272 211 276],90,5,6075,3.999341672152732,20.0,40.0
1519,0,1519,[290 220 240 284 583],59,1,6076,3.9973684210526317,0.0,0.0
1520,0,1520,[316 303 272 211 276],90,5,6081,3.998027613412229,20.0,40.0
1521,0,1521,[316 303 272 211 276],90,5,6086,3.9986859395532193,20.0,40.0
1522,0,1522,[316 303 272 211 276],90,5,6091,3.999343401181878,20.0,40.0
1523,0,1523,[331 280 218 231 272],13,2,6093,3.998031496062992,0.0,0.0
1524,0,1524,[246 478 222 420 485],85,4,6097,3.998032786885246,0.0,20.0
1525,0,1525,[316 303 272 211 276],90,5,6102,3.998689384010485,20.0,40.0
1526,0,1526,[316 303 272 211 276],90,5,6107,3.9993451211525866,20.0,40.0
1527,0,1527,[202 209 211 201 431],387,3,6110,3.99869109947644,0.0,20.0
1528,0,1528,[316 303 272 211 276],13,5,6115,3.999345977763244,20.0,40.0
1529,0,1529,[316 303 272 211 276],13,5,6120,4.0,20.0,40.0
1530,0,1530,[276 217 223 344 420],13,3,6123,3.999346832135859,20.0,20.0
1531,0,1531,[316 303 272 211 276],90,5,6128,4.0,20.0,40.0
1532,0,1532,[316 303 272 211 276],13,5,6133,4.000652315720809,20.0,40.0
1533,0,1533,[236 300 508 218 268],334,2,6135,3.999348109517601,0.0,20.0
1534,0,1534,[280 215 227 201 218],13,3,6138,3.9986970684039087,0.0,0.0
1535,0,1535,[283 211 215 259 208],615,4,6142,3.9986979166666665,0.0,20.0
1536,0,1536,[316 303 272 211 276],90,5,6147,3.999349381912817,20.0,40.0
1537,0,1537,[316 303 272 211 276],13,5,6152,4.0,20.0,40.0
1538,0,1538,[316 303 272 211 276],90,5,6157,4.000649772579597,20.0,40.0
1539,0,1539,[392 291 429 280 276],200,4,6161,4.000649350649351,0.0,20.0
1540,0,1540,[316 303 272 211 276],13,5,6166,4.00129785853342,20.0,40.0
1541,0,1541,[316 303 272 211 276],13,5,6171,4.001945525291829,20.0,40.0
1542,0,1542,[316 303 272 211 276],13,5,6176,4.002592352559948,20.0,40.0
1543,0,1543,[316 303 272 211 276],13,5,6181,4.0032383419689115,20.0,40.0
1544,0,1544,[316 303 272 211 276],90,5,6186,4.003883495145631,20.0,40.0
1545,0,1545,[316 303 272 211 276],13,5,6191,4.004527813712807,20.0,40.0
1546,0,1546,[272 241 221 275 208],271,2,6193,4.0032320620555915,0.0,20.0
1547,0,1547,[316 303 272 211 276],90,5,6198,4.003875968992248,20.0,40.0
1548,0,1548,[316 303 272 211 276],13,5,6203,4.0045190445448675,20.0,40.0
1549,0,1549,[316 303 272 211 276],90,5,6208,4.00516129032258,20.0,40.0
1550,0,1550,[316 303 272 211 276],90,5,6213,4.005802707930368,20.0,40.0
1551,0,1551,[316 303 272 211 276],13,5,6218,4.006443298969073,20.0,40.0
1552,0,1552,[236 272 284 293 276],894,4,6222,4.006439150032196,0.0,20.0
1553,0,1553,[316 303 272 211 276],13,5,6227,4.007078507078507,20.0,40.0
1554,0,1554,[316 303 272 211 276],13,5,6232,4.007717041800643,20.0,40.0
1555,0,1555,[212 201 378 243 211],537,1,6233,4.005784061696658,0.0,20.0
1556,0,1556,[508 215 240 201 291],92,3,6236,4.005138086062941,0.0,0.0
1557,0,1557,[316 223 212 350 303],894,4,6240,4.005134788189987,40.0,0.0
1558,0,1558,[316 303 272 211 276],13,5,6245,4.00577293136626,20.0,40.0
1559,0,1559,[226 211 507 429 259],308,2,6247,4.00448717948718,0.0,20.0
1560,0,1560,[316 303 272 211 276],13,5,6252,4.0051249199231265,20.0,40.0
1561,0,1561,[316 303 272 211 276],13,5,6257,4.005761843790013,20.0,40.0
1562,0,1562,[316 303 272 211 276],90,5,6262,4.00639795265515,20.0,40.0
1563,0,1563,[316 303 272 211 276],90,5,6267,4.007033248081841,20.0,40.0
1564,0,1564,[226 509 236 219 216],279,2,6269,4.005750798722045,0.0,0.0
1565,0,1565,[226 231 222 272 301],102,0,6269,4.003192848020435,0.0,20.0
1566,0,1566,[316 303 272 211 276],90,5,6274,4.00382897255903,20.0,40.0
1567,0,1567,[316 303 272 211 276],90,5,6279,4.004464285714286,20.0,40.0
1568,0,1568,[392 429 478 365 243],200,4,6283,4.004461440407903,0.0,0.0
1569,0,1569,[316 303 272 211 276],13,5,6288,4.005095541401274,20.0,40.0
1570,0,1570,[316 303 272 211 276],90,5,6293,4.005728835136855,20.0,40.0
1571,0,1571,[316 303 272 211 276],90,5,6298,4.006361323155216,20.0,40.0
1572,0,1572,[316 303 272 211 276],90,5,6303,4.006993006993007,20.0,40.0
1573,0,1573,[367 275 429 240 390],279,2,6305,4.00571791613723,0.0,20.0
1574,0,1574,[316 303 272 211 276],90,5,6310,4.006349206349206,20.0,40.0
1575,0,1575,[316 303 272 211 276],90,5,6315,4.006979695431472,20.0,40.0
1576,0,1576,[316 303 272 211 276],90,5,6320,4.007609384908053,20.0,40.0
1577,0,1577,[316 303 272 211 276],13,5,6325,4.008238276299113,20.0,40.0
1578,0,1578,[316 303 272 211 276],13,5,6330,4.008866371120963,20.0,40.0
1579,0,1579,[316 303 272 211 276],90,5,6335,4.0094936708860756,20.0,40.0
1580,0,1580,[216 303 300 241 208],90,3,6338,4.008855154965212,0.0,20.0
1581,0,1581,[316 303 272 211 276],13,5,6343,4.009481668773704,20.0,40.0
1582,0,1582,[316 303 272 211 276],13,5,6348,4.01010739102969,20.0,40.0
1583,0,1583,[219 264 254 231 230],308,1,6349,4.008207070707071,0.0,0.0
1584,0,1584,[316 303 272 211 276],13,5,6354,4.008832807570978,20.0,40.0
1585,0,1585,[316 303 272 211 276],13,5,6359,4.009457755359395,20.0,40.0
1586,0,1586,[216 394 478 219 452],13,1,6360,4.007561436672968,0.0,0.0
1587,0,1587,[429 291 216 300 431],749,5,6365,4.008186397984887,0.0,20.0
1588,0,1588,[316 303 272 211 276],90,5,6370,4.008810572687224,20.0,40.0
1589,0,1589,[316 303 272 211 276],13,5,6375,4.009433962264151,20.0,40.0
1590,0,1590,[316 303 272 211 276],90,5,6380,4.010056568196103,20.0,40.0
1591,0,1591,[316 303 272 211 276],13,5,6385,4.010678391959799,20.0,40.0
1592,0,1592,[316 303 272 211 276],13,5,6390,4.011299435028248,20.0,40.0
1593,0,1593,[315 316 216 231 211],650,2,6392,4.010037641154328,40.0,20.0
1594,0,1594,[392 230 211 239 226],308,3,6395,4.009404388714733,0.0,20.0
1595,0,1595,[316 303 272 211 276],90,5,6400,4.010025062656641,20.0,40.0
1596,0,1596,[316 303 272 211 276],90,5,6405,4.010644959298685,20.0,40.0
1597,0,1597,[478 275 231 301 209],13,1,6406,4.008760951188986,0.0,20.0
1598,0,1598,[316 303 272 211 276],13,5,6411,4.009380863039399,20.0,40.0
1599,0,1599,[227 208 429 300 378],749,5,6416,4.01,0.0,20.0
1600,0,1600,[316 303 272 211 276],13,5,6421,4.0106183635227985,20.0,40.0
1601,0,1601,[316 303 272 211 276],90,5,6426,4.01123595505618,20.0,40.0
1602,0,1602,[316 303 272 211 276],90,5,6431,4.011852776044916,20.0,40.0
1603,0,1603,[316 481 218 213 259],474,4,6435,4.011845386533666,20.0,0.0
1604,0,1604,[316 303 272 211 276],90,5,6440,4.012461059190031,20.0,40.0
1605,0,1605,[316 303 272 211 276],90,5,6445,4.01307596513076,20.0,40.0
1606,0,1606,[276 226 452 261 212],13,3,6448,4.012445550715619,0.0,20.0
1607,0,1607,[283 223 226 218 583],308,3,6451,4.01181592039801,20.0,0.0
1608,0,1608,[316 303 272 211 276],13,5,6456,4.012430080795525,20.0,40.0
1609,0,1609,[316 303 272 211 276],13,5,6461,4.01304347826087,20.0,40.0
1610,0,1610,[316 303 272 211 276],90,5,6466,4.013656114214774,20.0,40.0
1611,0,1611,[316 303 272 211 276],13,5,6471,4.014267990074441,20.0,40.0
1612,0,1612,[316 303 272 211 276],13,5,6476,4.014879107253565,20.0,40.0
1613,0,1613,[268 303 394 201 226],13,3,6479,4.014250309789343,0.0,0.0
1614,0,1614,[316 303 272 211 276],13,5,6484,4.014860681114551,20.0,40.0
1615,0,1615,[316 303 272 211 276],90,5,6489,4.015470297029703,20.0,40.0
1616,0,1616,[429 481 509 209 231],308,4,6493,4.015460729746444,0.0,0.0
1617,0,1617,[222 208 431 212 481],194,1,6494,4.013597033374537,0.0,20.0
1618,0,1618,[316 303 272 211 276],13,5,6499,4.0142063001852994,20.0,40.0
1619,0,1619,[316 303 272 211 276],90,5,6504,4.014814814814815,20.0,40.0
1620,0,1620,[316 303 272 211 276],90,5,6509,4.015422578655151,20.0,40.0
1621,0,1621,[226 219 429 206 209],387,2,6511,4.014180024660912,0.0,0.0
1622,0,1622,[316 303 272 211 276],13,5,6516,4.014787430683919,20.0,40.0
1623,0,1623,[202 208 255 259 301],184,1,6517,4.012931034482759,0.0,0.0
1624,0,1624,[507 301 212 276 261],13,2,6519,4.011692307692308,0.0,20.0
1625,0,1625,[316 303 272 211 276],13,5,6524,4.01230012300123,20.0,40.0
1626,0,1626,[316 303 272 211 276],13,5,6529,4.012907191149354,20.0,40.0
1627,0,1627,[241 350 367 509 485],13,1,6530,4.011056511056511,0.0,0.0
1628,0,1628,[316 303 272 211 276],13,5,6535,4.0116635972989565,20.0,40.0
1629,0,1629,[316 303 272 211 276],90,5,6540,4.012269938650307,20.0,40.0
1630,0,1630,[316 303 272 211 276],13,5,6545,4.012875536480687,20.0,40.0
1631,0,1631,[316 303 272 211 276],90,5,6550,4.013480392156863,20.0,40.0
1632,0,1632,[250 240 216 452 367],92,1,6551,4.011635027556644,0.0,0.0
1633,0,1633,[316 301 215 429 478],650,2,6553,4.010403916768666,20.0,0.0
1634,0,1634,[303 316 272 211 276],13,5,6558,4.011009174311926,20.0,40.0
1635,0,1635,[303 316 272 211 276],13,5,6563,4.01161369193154,20.0,40.0
1636,0,1636,[303 316 272 211 276],90,5,6568,4.012217470983506,20.0,40.0
1637,0,1637,[303 316 272 211 276],13,5,6573,4.012820512820513,20.0,40.0
1638,0,1638,[299 276 301 431 300],13,1,6574,4.01098230628432,0.0,40.0
1639,0,1639,[303 316 272 211 276],90,5,6579,4.011585365853659,20.0,40.0
1640,0,1640,[315 295 344 331 272],548,2,6581,4.010359536867764,20.0,0.0
1641,0,1641,[231 218 429 268 272],13,3,6584,4.009744214372716,0.0,0.0
1642,0,1642,[303 316 272 211 276],90,5,6589,4.01034692635423,20.0,40.0
1643,0,1643,[429 215 227 239 211],843,1,6590,4.0085158150851585,0.0,20.0
1644,0,1644,[243 478 284 211 213],537,3,6593,4.00790273556231,0.0,20.0
1645,0,1645,[303 316 272 211 276],90,5,6598,4.008505467800729,20.0,40.0
1646,0,1646,[303 316 272 211 276],13,5,6603,4.009107468123862,20.0,40.0
1647,0,1647,[202 206 209 509 208],650,2,6605,4.007888349514563,0.0,0.0
1648,0,1648,[303 316 272 211 276],13,5,6610,4.008489993935719,20.0,40.0
1649,0,1649,[241 336 218 222 429],13,1,6611,4.006666666666667,0.0,20.0
1650,0,1650,[303 316 272 211 276],90,5,6616,4.007268322228952,20.0,40.0
1651,0,1651,[303 316 272 211 276],90,5,6621,4.007869249394673,20.0,40.0
1652,0,1652,[303 316 272 211 276],13,5,6626,4.0084694494857835,20.0,40.0
1653,0,1653,[303 316 272 211 276],90,5,6631,4.00906892382104,20.0,40.0
1654,0,1654,[303 316 272 211 276],90,5,6636,4.009667673716012,20.0,40.0
1655,0,1655,[303 316 272 211 276],13,5,6641,4.0102657004830915,20.0,40.0
1656,0,1656,[303 316 272 211 276],90,5,6646,4.010863005431503,20.0,40.0
1657,0,1657,[303 316 272 211 276],13,5,6651,4.01145958986731,20.0,40.0
1658,0,1658,[303 316 272 211 276],90,5,6656,4.01205545509343,20.0,40.0
1659,0,1659,[303 316 272 211 276],13,5,6661,4.0126506024096384,20.0,40.0
1660,0,1660,[303 316 272 211 276],13,5,6666,4.013245033112582,20.0,40.0
1661,0,1661,[303 316 272 211 276],90,5,6671,4.013838748495788,20.0,40.0
1662,0,1662,[303 316 272 211 276],90,5,6676,4.0144317498496696,20.0,40.0
1663,0,1663,[303 316 272 211 276],90,5,6681,4.015024038461538,20.0,40.0
1664,0,1664,[303 316 272 211 276],13,5,6686,4.015615615615616,20.0,40.0
1665,0,1665,[420 272 216 431 299],13,2,6688,4.014405762304922,0.0,0.0
1666,0,1666,[507 227 216 508 219],13,1,6689,4.012597480503899,0.0,0.0
1667,0,1667,[303 316 272 211 276],90,5,6694,4.013189448441247,20.0,40.0
1668,0,1668,[303 316 272 211 276],90,5,6699,4.013780707010186,20.0,40.0
1669,0,1669,[303 316 272 211 276],13,5,6704,4.01437125748503,20.0,40.0
1670,0,1670,[303 316 272 211 276],90,5,6709,4.014961101137044,20.0,40.0
1671,0,1671,[303 316 272 211 276],13,5,6714,4.01555023923445,20.0,40.0
1672,0,1672,[303 316 272 211 276],90,5,6719,4.016138673042438,20.0,40.0
1673,0,1673,[303 316 272 211 276],13,5,6724,4.016726403823178,20.0,40.0
1674,0,1674,[303 316 272 211 276],90,5,6729,4.017313432835821,20.0,40.0
1675,0,1675,[303 316 272 211 276],90,5,6734,4.0178997613365155,20.0,40.0
1676,0,1676,[507 326 509 301 217],13,1,6735,4.016100178890877,0.0,0.0
1677,0,1677,[202 230 226 239 222],200,4,6739,4.016090584028605,0.0,20.0
1678,0,1678,[241 268 217 280 394],13,2,6741,4.014889815366289,0.0,0.0
1679,0,1679,[303 316 272 211 276],13,5,6746,4.015476190476191,20.0,40.0
1680,0,1680,[303 316 272 211 276],13,5,6751,4.016061867935752,20.0,40.0
1681,0,1681,[303 316 272 211 276],13,5,6756,4.016646848989298,20.0,40.0
1682,0,1682,[303 316 272 211 276],90,5,6761,4.017231134878194,20.0,40.0
1683,0,1683,[303 316 272 211 276],90,5,6766,4.0178147268408555,20.0,40.0
1684,0,1684,[222 429 378 215 509],653,1,6767,4.016023738872404,0.0,20.0
1685,0,1685,[303 316 272 211 276],90,5,6772,4.016607354685647,20.0,40.0
1686,0,1686,[384 478 268 212 321],13,3,6775,4.016004742145821,0.0,0.0
1687,0,1687,[303 316 272 211 276],90,5,6780,4.016587677725118,20.0,40.0
1688,0,1688,[276 295 299 251 297],486,3,6783,4.015985790408526,40.0,20.0
1689,0,1689,[303 316 272 211 276],13,5,6788,4.0165680473372785,20.0,40.0
1690,0,1690,[303 316 272 211 276],90,5,6793,4.017149615612064,20.0,40.0
1691,0,1691,[303 316 272 211 276],90,5,6798,4.0177304964539005,20.0,40.0
1692,0,1692,[303 316 272 211 276],90,5,6803,4.018310691080922,20.0,40.0
1693,0,1693,[215 276 255 485 316],474,5,6808,4.018890200708382,20.0,20.0
1694,0,1694,[208 202 300 230 216],506,4,6812,4.018879056047198,0.0,20.0
1695,0,1695,[290 378 367 223 429],653,0,6812,4.0165094339622645,20.0,0.0
1696,0,1696,[303 316 272 211 276],90,5,6817,4.017088980553918,20.0,40.0
1697,0,1697,[303 316 272 211 276],90,5,6822,4.017667844522968,20.0,40.0
1698,0,1698,[290 255 222 219 315],210,4,6826,4.0176574455562095,20.0,20.0
1699,0,1699,[303 316 272 211 276],90,5,6831,4.018235294117647,20.0,40.0
1700,0,1700,[227 219 367 508 232],326,0,6831,4.015873015873016,0.0,0.0
1701,0,1701,[227 250 230 481 303],334,3,6834,4.015276145710929,0.0,0.0
1702,0,1702,[303 316 272 211 276],13,5,6839,4.015854374633,20.0,40.0
1703,0,1703,[303 316 272 211 276],90,5,6844,4.016431924882629,20.0,40.0
1704,0,1704,[303 316 272 211 276],13,5,6849,4.017008797653959,20.0,40.0
1705,0,1705,[303 316 272 211 276],90,5,6854,4.0175849941383355,20.0,40.0
1706,0,1706,[303 316 272 211 276],13,5,6859,4.018160515524312,20.0,40.0
1707,0,1707,[303 316 272 211 276],90,5,6864,4.018735362997658,20.0,40.0
1708,0,1708,[303 316 272 211 276],90,5,6869,4.0193095377413695,20.0,40.0
1709,0,1709,[303 316 272 211 276],13,5,6874,4.019883040935673,20.0,40.0
1710,0,1710,[303 316 272 211 276],13,5,6879,4.020455873758036,20.0,40.0
1711,0,1711,[336 276 217 264 452],13,2,6881,4.019275700934579,0.0,20.0
1712,0,1712,[303 316 272 211 276],13,5,6886,4.019848219497957,20.0,40.0
1713,0,1713,[303 316 272 211 276],90,5,6891,4.020420070011669,20.0,40.0
1714,0,1714,[202 290 240 215 219],59,3,6894,4.019825072886297,0.0,0.0
1715,0,1715,[303 316 272 211 276],13,5,6899,4.020396270396271,20.0,40.0
1716,0,1716,[303 316 272 211 276],90,5,6904,4.020966802562609,20.0,40.0
1717,0,1717,[254 429 230 367 298],738,1,6905,4.0192083818393485,0.0,0.0
1718,0,1718,[303 316 272 211 276],13,5,6910,4.01977894124491,20.0,40.0
1719,0,1719,[303 316 272 211 276],90,5,6915,4.020348837209302,20.0,40.0
1720,0,1720,[303 316 272 211 276],90,5,6920,4.020918070889018,20.0,40.0
1721,0,1721,[303 316 272 211 276],90,5,6925,4.021486643437863,20.0,40.0
1722,0,1722,[219 218 316 202 509],650,0,6925,4.01915264074289,20.0,0.0
1723,0,1723,[303 316 272 211 276],90,5,6930,4.0197215777262185,20.0,40.0
1724,0,1724,[303 316 272 211 276],90,5,6935,4.0202898550724635,20.0,40.0
1725,0,1725,[367 276 201 316 485],13,2,6937,4.019119351100811,20.0,20.0
1726,0,1726,[303 316 272 211 276],13,5,6942,4.019687319050377,20.0,40.0
1727,0,1727,[303 316 272 211 276],13,5,6947,4.02025462962963,20.0,40.0
1728,0,1728,[303 316 272 211 276],13,5,6952,4.020821283979179,20.0,40.0
1729,0,1729,[303 316 272 211 276],13,5,6957,4.021387283236995,20.0,40.0
1730,0,1730,[303 316 272 211 276],13,5,6962,4.0219526285384175,20.0,40.0
1731,0,1731,[303 316 272 211 276],13,5,6967,4.022517321016166,20.0,40.0
1732,0,1732,[303 316 272 211 276],13,5,6972,4.0230813618003465,20.0,40.0
1733,0,1733,[268 452 336 420 232],13,2,6974,4.021914648212226,0.0,0.0
1734,0,1734,[303 316 272 211 276],13,5,6979,4.022478386167147,20.0,40.0
1735,0,1735,[301 221 212 431 299],537,1,6980,4.02073732718894,0.0,0.0
1736,0,1736,[276 485 222 219 209],234,1,6981,4.018998272884283,0.0,40.0
1737,0,1737,[303 316 272 211 276],13,5,6986,4.019562715765248,20.0,40.0
1738,0,1738,[303 316 272 211 276],90,5,6991,4.020126509488212,20.0,40.0
1739,0,1739,[303 316 272 211 276],13,5,6996,4.020689655172414,20.0,40.0
1740,0,1740,[303 316 272 211 276],13,5,7001,4.021252153934521,20.0,40.0
1741,0,1741,[303 316 272 211 276],90,5,7006,4.021814006888634,20.0,40.0
1742,0,1742,[206 213 284 218 452],406,0,7006,4.019506597819851,0.0,0.0
1743,0,1743,[303 316 272 211 276],13,5,7011,4.02006880733945,20.0,40.0
1744,0,1744,[303 316 272 211 276],90,5,7016,4.020630372492836,20.0,40.0
1745,0,1745,[303 316 272 211 276],13,5,7021,4.021191294387171,20.0,40.0
1746,0,1746,[303 316 272 211 276],13,5,7026,4.021751574127075,20.0,40.0
1747,0,1747,[303 316 272 211 276],90,5,7031,4.022311212814645,20.0,40.0
1748,0,1748,[303 316 272 211 276],90,5,7036,4.022870211549457,20.0,40.0
1749,0,1749,[303 316 272 211 276],90,5,7041,4.023428571428571,20.0,40.0
1750,0,1750,[303 316 272 211 276],13,5,7046,4.023986293546545,20.0,40.0
1751,0,1751,[220 284 272 202 221],271,1,7047,4.022260273972603,0.0,0.0
1752,0,1752,[303 316 272 211 276],90,5,7052,4.0228180262407305,20.0,40.0
1753,0,1753,[303 316 272 211 276],13,5,7057,4.023375142531357,20.0,40.0
1754,0,1754,[303 316 272 211 276],90,5,7062,4.023931623931624,20.0,40.0
1755,0,1755,[303 316 272 211 276],13,5,7067,4.024487471526196,20.0,40.0
1756,0,1756,[275 431 276 301 299],13,1,7068,4.022766078542971,0.0,40.0
1757,0,1757,[268 276 264 350 326],13,3,7071,4.022184300341297,0.0,20.0
1758,0,1758,[243 478 240 230 226],881,2,7073,4.02103467879477,0.0,0.0
1759,0,1759,[303 316 272 211 276],13,5,7078,4.021590909090909,20.0,40.0
1760,0,1760,[303 316 272 211 276],13,5,7083,4.022146507666099,20.0,40.0
1761,0,1761,[303 316 272 211 276],13,5,7088,4.022701475595913,20.0,40.0
1762,0,1762,[220 222 227 216 226],648,3,7091,4.022121384004538,0.0,20.0
1763,0,1763,[303 316 272 211 276],13,5,7096,4.022675736961451,20.0,40.0
1764,0,1764,[202 297 223 485 261],6,2,7098,4.021529745042493,40.0,0.0
1765,0,1765,[303 316 272 211 276],13,5,7103,4.022083805209513,20.0,40.0
1766,0,1766,[303 316 272 211 276],13,5,7108,4.022637238256933,20.0,40.0
1767,0,1767,[303 316 272 211 276],90,5,7113,4.023190045248869,20.0,40.0
1768,0,1768,[303 316 272 211 276],13,5,7118,4.023742227247032,20.0,40.0
1769,0,1769,[280 202 206 431 268],234,1,7119,4.022033898305085,0.0,0.0
1770,0,1770,[303 316 272 211 276],13,5,7124,4.022586109542631,20.0,40.0
1771,0,1771,[202 301 219 216 290],279,3,7127,4.022009029345372,0.0,0.0
1772,0,1772,[303 316 272 211 276],13,5,7132,4.022560631697687,20.0,40.0
1773,0,1773,[216 280 239 209 321],13,2,7134,4.021420518602029,0.0,0.0
1774,0,1774,[303 316 272 211 276],90,5,7139,4.021971830985915,20.0,40.0
1775,0,1775,[303 316 272 211 276],13,5,7144,4.0225225225225225,20.0,40.0
1776,0,1776,[208 276 255 220 315],334,3,7147,4.021947101857062,20.0,20.0
1777,0,1777,[303 316 272 211 276],90,5,7152,4.022497187851519,20.0,40.0
1778,0,1778,[303 316 272 211 276],13,5,7157,4.0230466554243955,20.0,40.0
1779,0,1779,[303 316 272 211 276],13,5,7162,4.023595505617978,20.0,40.0
1780,0,1780,[303 316 272 211 276],90,5,7167,4.024143739472207,20.0,40.0
1781,0,1781,[212 315 321 231 378],311,3,7170,4.023569023569023,20.0,0.0
1782,0,1782,[303 316 272 211 276],13,5,7175,4.024116657319125,20.0,40.0
1783,0,1783,[303 316 272 211 276],13,5,7180,4.024663677130045,20.0,40.0
1784,0,1784,[211 272 326 259 300],454,4,7184,4.0246498599439775,0.0,40.0
1785,0,1785,[303 316 272 211 276],90,5,7189,4.025195968645017,20.0,40.0
1786,0,1786,[303 316 272 211 276],90,5,7194,4.0257414661443764,20.0,40.0
1787,0,1787,[303 316 272 211 276],13,5,7199,4.026286353467562,20.0,40.0
1788,0,1788,[303 316 272 211 276],90,5,7204,4.026830631637787,20.0,40.0
1789,0,1789,[303 316 272 211 276],13,5,7209,4.0273743016759775,20.0,40.0
1790,0,1790,[303 316 272 211 276],13,5,7214,4.027917364600782,20.0,40.0
1791,0,1791,[303 316 272 211 276],90,5,7219,4.028459821428571,20.0,40.0
1792,0,1792,[303 316 272 211 276],90,5,7224,4.029001673173452,20.0,40.0
1793,0,1793,[303 316 272 211 276],13,5,7229,4.029542920847269,20.0,40.0
1794,0,1794,[303 316 272 211 276],90,5,7234,4.03008356545961,20.0,40.0
1795,0,1795,[301 481 211 367 485],6,3,7237,4.029510022271715,0.0,20.0
1796,0,1796,[303 316 272 211 276],90,5,7242,4.030050083472454,20.0,40.0
1797,0,1797,[208 231 297 276 227],334,3,7245,4.029477196885428,20.0,20.0
1798,0,1798,[303 316 272 211 276],13,5,7250,4.030016675931073,20.0,40.0
1799,0,1799,[303 316 272 211 276],90,5,7255,4.030555555555556,20.0,40.0
1800,0,1800,[303 316 272 211 276],13,5,7260,4.031093836757357,20.0,40.0
1801,0,1801,[303 316 272 211 276],90,5,7265,4.031631520532741,20.0,40.0
1802,0,1802,[284 218 202 276 243],59,3,7268,4.031059345535219,0.0,20.0
1803,0,1803,[217 481 384 212 201],7,2,7270,4.029933481152994,0.0,0.0
1804,0,1804,[303 316 272 211 276],90,5,7275,4.030470914127424,20.0,40.0
1805,0,1805,[303 316 272 211 276],90,5,7280,4.0310077519379846,20.0,40.0
1806,0,1806,[303 316 272 211 276],13,5,7285,4.031543995572773,20.0,40.0
1807,0,1807,[231 478 218 220 508],184,2,7287,4.030420353982301,0.0,0.0
1808,0,1808,[481 336 384 485 280],13,1,7288,4.028745163073522,0.0,0.0
1809,0,1809,[303 316 272 211 276],13,5,7293,4.029281767955801,20.0,40.0
1810,0,1810,[280 413 202 230 232],13,2,7295,4.0281612368856985,0.0,0.0
1811,0,1811,[303 316 272 211 276],90,5,7300,4.02869757174393,20.0,40.0
1812,0,1812,[303 316 272 211 276],90,5,7305,4.029233314947601,20.0,40.0
1813,0,1813,[303 316 272 211 276],90,5,7310,4.029768467475193,20.0,40.0
1814,0,1814,[303 316 272 211 276],13,5,7315,4.03030303030303,20.0,40.0
1815,0,1815,[378 255 298 239 276],308,3,7318,4.029735682819383,0.0,20.0
1816,0,1816,[303 316 272 211 276],90,5,7323,4.030269675288938,20.0,40.0
1817,0,1817,[303 316 272 211 276],13,5,7328,4.030803080308031,20.0,40.0
1818,0,1818,[227 211 413 290 239],804,5,7333,4.031335898845519,0.0,20.0
1819,0,1819,[303 316 272 211 276],13,5,7338,4.031868131868132,20.0,40.0
1820,0,1820,[303 316 272 211 276],13,5,7343,4.032399780340472,20.0,40.0
1821,0,1821,[208 478 315 221 206],537,3,7346,4.031833150384193,20.0,0.0
1822,0,1822,[303 316 272 211 276],90,5,7351,4.032364234777838,20.0,40.0
1823,0,1823,[219 268 264 413 241],13,2,7353,4.03125,0.0,0.0
1824,0,1824,[303 316 272 211 276],13,5,7358,4.031780821917808,20.0,40.0
1825,0,1825,[303 316 272 211 276],90,5,7363,4.032311062431544,20.0,40.0
1826,0,1826,[202 420 232 384 275],13,2,7365,4.0311986863711,0.0,20.0
1827,0,1827,[303 316 272 211 276],90,5,7370,4.031728665207877,20.0,40.0
1828,0,1828,[303 316 272 211 276],90,5,7375,4.032258064516129,20.0,40.0
1829,0,1829,[303 316 272 211 276],90,5,7380,4.032786885245901,20.0,40.0
1830,0,1830,[206 219 420 222 315],650,2,7382,4.031676679410158,20.0,20.0
1831,0,1831,[321 291 509 216 301],537,1,7383,4.030021834061135,0.0,0.0
1832,0,1832,[303 316 272 211 276],13,5,7388,4.030551009274413,20.0,40.0
1833,0,1833,[208 276 226 211 485],308,3,7391,4.029989094874591,0.0,40.0
1834,0,1834,[303 316 272 211 276],90,5,7396,4.030517711171662,20.0,40.0
1835,0,1835,[303 316 272 211 276],90,5,7401,4.031045751633987,20.0,40.0
1836,0,1836,[303 316 272 211 276],13,5,7406,4.031573217201959,20.0,40.0
1837,0,1837,[303 316 272 211 276],13,5,7411,4.032100108813928,20.0,40.0
1838,0,1838,[303 316 272 211 276],90,5,7416,4.032626427406199,20.0,40.0
1839,0,1839,[268 221 222 315 202],537,2,7418,4.031521739130435,20.0,20.0
1840,0,1840,[303 316 272 211 276],90,5,7423,4.032047800108637,20.0,40.0
1841,0,1841,[303 316 272 211 276],90,5,7428,4.03257328990228,20.0,40.0
1842,0,1842,[212 429 217 452 211],13,3,7431,4.032013022246337,0.0,20.0
1843,0,1843,[211 226 295 231 583],308,2,7433,4.030911062906725,0.0,20.0
1844,0,1844,[219 300 216 452 276],145,2,7435,4.029810298102981,0.0,40.0
1845,0,1845,[303 316 272 211 276],90,5,7440,4.030335861321777,20.0,40.0
1846,0,1846,[303 316 272 211 276],13,5,7445,4.030860855441256,20.0,40.0
1847,0,1847,[303 316 272 211 276],90,5,7450,4.0313852813852815,20.0,40.0
1848,0,1848,[303 316 272 211 276],13,5,7455,4.031909140075717,20.0,40.0
1849,0,1849,[303 316 272 211 276],13,5,7460,4.032432432432432,20.0,40.0
1850,0,1850,[303 316 272 211 276],90,5,7465,4.032955159373311,20.0,40.0
1851,0,1851,[303 316 272 211 276],13,5,7470,4.033477321814255,20.0,40.0
1852,0,1852,[303 316 272 211 276],13,5,7475,4.033998920669185,20.0,40.0
1853,0,1853,[303 316 272 211 276],13,5,7480,4.034519956850054,20.0,40.0
1854,0,1854,[303 316 272 211 276],13,5,7485,4.035040431266847,20.0,40.0
1855,0,1855,[303 316 272 211 276],13,5,7490,4.035560344827586,20.0,40.0
1856,0,1856,[303 316 272 211 276],13,5,7495,4.036079698438342,20.0,40.0
1857,0,1857,[303 316 272 211 276],90,5,7500,4.036598493003229,20.0,40.0
1858,0,1858,[303 316 272 211 276],90,5,7505,4.0371167294244215,20.0,40.0
1859,0,1859,[384 261 209 268 299],13,1,7506,4.035483870967742,0.0,0.0
1860,0,1860,[481 284 221 236 507],234,2,7508,4.034390112842558,0.0,0.0
1861,0,1861,[303 316 272 211 276],90,5,7513,4.034908700322235,20.0,40.0
1862,0,1862,[303 316 272 211 276],13,5,7518,4.035426731078905,20.0,40.0
1863,0,1863,[303 316 272 211 276],13,5,7523,4.035944206008583,20.0,40.0
1864,0,1864,[293 219 295 291 226],308,1,7524,4.0343163538874,0.0,0.0
1865,0,1865,[212 280 264 211 509],13,5,7529,4.034833869239014,0.0,20.0
1866,0,1866,[303 316 272 211 276],90,5,7534,4.035350830208891,20.0,40.0
1867,0,1867,[303 316 272 211 276],90,5,7539,4.035867237687366,20.0,40.0
1868,0,1868,[303 316 272 211 276],13,5,7544,4.036383092562867,20.0,40.0
1869,0,1869,[481 226 219 331 316],13,2,7546,4.035294117647059,20.0,0.0
1870,0,1870,[208 431 261 243 344],13,1,7547,4.033671833244254,0.0,0.0
1871,0,1871,[303 316 272 211 276],13,5,7552,4.034188034188034,20.0,40.0
1872,0,1872,[241 213 208 221 209],90,4,7556,4.03416978109984,0.0,0.0
1873,0,1873,[303 316 272 211 276],13,5,7561,4.034685165421558,20.0,40.0
1874,0,1874,[303 316 272 211 276],90,5,7566,4.0352,20.0,40.0
1875,0,1875,[303 316 272 211 276],13,5,7571,4.035714285714286,20.0,40.0
1876,0,1876,[303 316 272 211 276],13,5,7576,4.036228023441662,20.0,40.0
1877,0,1877,[303 316 272 211 276],13,5,7581,4.036741214057508,20.0,40.0
1878,0,1878,[222 218 230 201 227],13,1,7582,4.035125066524747,0.0,20.0
1879,0,1879,[303 316 272 211 276],90,5,7587,4.035638297872341,20.0,40.0
1880,0,1880,[303 316 272 211 276],90,5,7592,4.036150983519405,20.0,40.0
1881,0,1881,[202 201 300 241 213],7,2,7594,4.035069075451648,0.0,20.0
1882,0,1882,[303 316 272 211 276],13,5,7599,4.0355815188528945,20.0,40.0
1883,0,1883,[303 316 272 211 276],13,5,7604,4.036093418259023,20.0,40.0
1884,0,1884,[303 316 272 211 276],13,5,7609,4.036604774535809,20.0,40.0
1885,0,1885,[303 316 272 211 276],13,5,7614,4.03711558854719,20.0,40.0
1886,0,1886,[303 316 272 211 276],13,5,7619,4.037625861155273,20.0,40.0
1887,0,1887,[303 316 272 211 276],13,5,7624,4.038135593220339,20.0,40.0
1888,0,1888,[303 316 272 211 276],13,5,7629,4.038644785600847,20.0,40.0
1889,0,1889,[303 316 272 211 276],90,5,7634,4.039153439153439,20.0,40.0
1890,0,1890,[303 316 272 211 276],13,5,7639,4.0396615547329455,20.0,40.0
1891,0,1891,[215 378 485 276 211],311,3,7642,4.039112050739957,0.0,40.0
1892,0,1892,[303 316 272 211 276],90,5,7647,4.039619651347068,20.0,40.0
1893,0,1893,[303 316 272 211 276],13,5,7652,4.04012671594509,20.0,40.0
1894,0,1894,[303 301 236 221 275],486,4,7656,4.040105540897097,0.0,20.0
1895,0,1895,[350 222 209 212 413],13,1,7657,4.038502109704641,0.0,20.0
1896,0,1896,[303 316 272 211 276],13,5,7662,4.039008961518187,20.0,40.0
1897,0,1897,[211 420 268 321 264],13,4,7666,4.038988408851423,0.0,20.0
1898,0,1898,[303 316 272 211 276],90,5,7671,4.039494470774091,20.0,40.0
1899,0,1899,[297 324 268 216 244],334,3,7674,4.038947368421053,20.0,0.0
1900,0,1900,[303 316 272 211 276],13,5,7679,4.0394529195160445,20.0,40.0
1901,0,1901,[303 316 272 211 276],13,5,7684,4.0399579390115665,20.0,40.0
1902,0,1902,[303 316 272 211 276],90,5,7689,4.040462427745664,20.0,40.0
1903,0,1903,[303 316 272 211 276],13,5,7694,4.040966386554622,20.0,40.0
1904,0,1904,[213 206 276 208 221],234,2,7696,4.03989501312336,0.0,20.0
1905,0,1905,[303 316 272 211 276],90,5,7701,4.040398740818468,20.0,40.0
1906,0,1906,[303 316 272 211 276],13,5,7706,4.040901940220241,20.0,40.0
1907,0,1907,[275 413 219 209 217],843,1,7707,4.039308176100629,0.0,20.0
1908,0,1908,[222 230 293 365 420],749,2,7709,4.038239916186485,0.0,20.0
1909,0,1909,[303 316 272 211 276],13,5,7714,4.038743455497382,20.0,40.0
1910,0,1910,[227 299 219 478 394],13,2,7716,4.037676609105181,0.0,0.0
1911,0,1911,[303 316 272 211 276],13,5,7721,4.038179916317992,20.0,40.0
1912,0,1912,[223 485 291 276 509],308,3,7724,4.0376372190277054,20.0,20.0
1913,0,1913,[303 316 272 211 276],90,5,7729,4.038140020898641,20.0,40.0
1914,0,1914,[303 316 272 211 276],90,5,7734,4.038642297650131,20.0,40.0
1915,0,1915,[420 259 365 209 367],308,3,7737,4.038100208768268,0.0,0.0
1916,0,1916,[303 316 272 211 276],13,5,7742,4.0386019822639545,20.0,40.0
1917,0,1917,[303 316 272 211 276],90,5,7747,4.03910323253389,20.0,40.0
1918,0,1918,[303 316 272 211 276],90,5,7752,4.03960396039604,20.0,40.0
1919,0,1919,[239 276 240 226 202],374,3,7755,4.0390625,0.0,20.0
1920,0,1920,[303 316 272 211 276],13,5,7760,4.039562727745966,20.0,40.0
1921,0,1921,[303 316 272 211 276],13,5,7765,4.04006243496358,20.0,40.0
1922,0,1922,[303 316 272 211 276],13,5,7770,4.040561622464899,20.0,40.0
1923,0,1923,[303 316 272 211 276],90,5,7775,4.041060291060291,20.0,40.0
1924,0,1924,[303 316 272 211 276],90,5,7780,4.041558441558442,20.0,40.0
1925,0,1925,[315 222 481 276 216],334,4,7784,4.041536863966771,20.0,40.0
1926,0,1926,[206 276 243 231 508],537,2,7786,4.040477426050856,0.0,20.0
1927,0,1927,[303 316 272 211 276],90,5,7791,4.04097510373444,20.0,40.0
1928,0,1928,[303 316 272 211 276],13,5,7796,4.041472265422499,20.0,40.0
1929,0,1929,[431 429 201 217 240],833,2,7798,4.040414507772021,0.0,0.0
1930,0,1930,[378 209 211 230 431],843,0,7798,4.038322112894873,0.0,20.0
1931,0,1931,[303 316 272 211 276],13,5,7803,4.038819875776397,20.0,40.0
1932,0,1932,[303 316 272 211 276],90,5,7808,4.039317123642007,20.0,40.0
1933,0,1933,[413 236 216 227 208],279,4,7812,4.0392967942088935,0.0,0.0
1934,0,1934,[303 316 272 211 276],90,5,7817,4.039793281653747,20.0,40.0
1935,0,1935,[431 213 291 239 240],804,4,7821,4.0397727272727275,0.0,0.0
1936,0,1936,[303 316 272 211 276],90,5,7826,4.040268456375839,20.0,40.0
1937,0,1937,[303 316 272 211 276],13,5,7831,4.040763673890609,20.0,40.0
1938,0,1938,[303 316 272 211 276],90,5,7836,4.041258380608561,20.0,40.0
1939,0,1939,[303 316 272 211 276],90,5,7841,4.0417525773195875,20.0,40.0
1940,0,1940,[303 316 272 211 276],90,5,7846,4.042246264811952,20.0,40.0
1941,0,1941,[303 316 272 211 276],13,5,7851,4.042739443872296,20.0,40.0
1942,0,1942,[303 316 272 211 276],13,5,7856,4.043232115285641,20.0,40.0
1943,0,1943,[303 316 272 211 276],13,5,7861,4.0437242798353905,20.0,40.0
1944,0,1944,[303 316 272 211 276],13,5,7866,4.044215938303342,20.0,40.0
1945,0,1945,[303 316 272 211 276],13,5,7871,4.044707091469681,20.0,40.0
1946,0,1946,[215 216 202 208 222],882,5,7876,4.045197740112994,0.0,20.0
1947,0,1947,[303 316 272 211 276],13,5,7881,4.045687885010267,20.0,40.0
1948,0,1948,[231 255 365 202 259],308,2,7883,4.044638276038994,0.0,0.0
1949,0,1949,[303 316 272 211 276],13,5,7888,4.045128205128205,20.0,40.0
1950,0,1950,[303 316 272 211 276],13,5,7893,4.045617631983598,20.0,40.0
1951,0,1951,[303 316 272 211 276],13,5,7898,4.046106557377049,20.0,40.0
1952,0,1952,[303 316 272 211 276],13,5,7903,4.046594982078853,20.0,40.0
1953,0,1953,[303 316 272 211 276],90,5,7908,4.047082906857728,20.0,40.0
1954,0,1954,[303 316 272 211 276],90,5,7913,4.047570332480818,20.0,40.0
1955,0,1955,[303 316 272 211 276],90,5,7918,4.048057259713701,20.0,40.0
1956,0,1956,[303 316 272 211 276],90,5,7923,4.048543689320389,20.0,40.0
1957,0,1957,[220 293 213 250 316],334,2,7925,4.047497446373851,20.0,0.0
1958,0,1958,[303 316 272 211 276],13,5,7930,4.047983665135273,20.0,40.0
1959,0,1959,[303 316 272 211 276],90,5,7935,4.048469387755102,20.0,40.0
1960,0,1960,[303 316 272 211 276],13,5,7940,4.0489546149923505,20.0,40.0
1961,0,1961,[303 316 272 211 276],90,5,7945,4.049439347604485,20.0,40.0
1962,0,1962,[303 316 272 211 276],90,5,7950,4.049923586347427,20.0,40.0
1963,0,1963,[303 316 272 211 276],90,5,7955,4.05040733197556,20.0,40.0
1964,0,1964,[303 316 272 211 276],13,5,7960,4.0508905852417305,20.0,40.0
1965,0,1965,[303 316 272 211 276],90,5,7965,4.051373346897253,20.0,40.0
1966,0,1966,[303 316 272 211 276],13,5,7970,4.051855617691917,20.0,40.0
1967,0,1967,[303 316 272 211 276],90,5,7975,4.052337398373984,20.0,40.0
1968,0,1968,[213 255 209 290 217],334,1,7976,4.05078720162519,0.0,0.0
1969,0,1969,[303 316 272 211 276],13,5,7981,4.051269035532995,20.0,40.0
1970,0,1970,[231 394 209 201 336],13,0,7981,4.049213597158802,0.0,0.0
1971,0,1971,[303 316 272 211 276],90,5,7986,4.049695740365111,20.0,40.0
1972,0,1972,[303 316 272 211 276],13,5,7991,4.050177394830208,20.0,40.0
1973,0,1973,[303 316 272 211 276],90,5,7996,4.050658561296859,20.0,40.0
1974,0,1974,[226 276 290 283 299],537,2,7998,4.049620253164557,0.0,20.0
1975,0,1975,[303 316 272 211 276],13,5,8003,4.050101214574899,20.0,40.0
1976,0,1976,[507 223 254 365 215],308,1,8004,4.04855842185129,20.0,0.0
1977,0,1977,[303 316 272 211 276],13,5,8009,4.049039433771487,20.0,40.0
1978,0,1978,[303 316 272 211 276],13,5,8014,4.049519959575544,20.0,40.0
1979,0,1979,[303 316 272 211 276],13,5,8019,4.05,20.0,40.0
1980,0,1980,[303 316 272 211 276],90,5,8024,4.050479555779909,20.0,40.0
1981,0,1981,[303 316 272 211 276],90,5,8029,4.050958627648839,20.0,40.0
1982,0,1982,[303 316 272 211 276],13,5,8034,4.05143721633888,20.0,40.0
1983,0,1983,[259 231 239 420 284],308,2,8036,4.050403225806452,0.0,0.0
1984,0,1984,[303 316 272 211 276],13,5,8041,4.05088161209068,20.0,40.0
1985,0,1985,[303 316 272 211 276],13,5,8046,4.051359516616314,20.0,40.0
1986,0,1986,[303 316 272 211 276],90,5,8051,4.05183694011072,20.0,40.0
1987,0,1987,[303 316 272 211 276],90,5,8056,4.0523138832997985,20.0,40.0
1988,0,1988,[303 316 272 211 276],13,5,8061,4.052790346907994,20.0,40.0
1989,0,1989,[303 316 272 211 276],13,5,8066,4.053266331658292,20.0,40.0
1990,0,1990,[303 316 272 211 276],13,5,8071,4.0537418382722255,20.0,40.0
1991,0,1991,[303 316 272 211 276],13,5,8076,4.054216867469879,20.0,40.0
1992,0,1992,[303 316 272 211 276],13,5,8081,4.0546914199698945,20.0,40.0
1993,0,1993,[239 429 272 202 431],653,3,8084,4.054162487462387,0.0,0.0
1994,0,1994,[303 316 272 211 276],13,5,8089,4.054636591478697,20.0,40.0
1995,0,1995,[303 316 272 211 276],13,5,8094,4.0551102204408815,20.0,40.0
1996,0,1996,[303 316 272 211 276],13,5,8099,4.055583375062594,20.0,40.0
1997,0,1997,[303 316 272 211 276],90,5,8104,4.056056056056056,20.0,40.0
1998,0,1998,[303 316 272 211 276],90,5,8109,4.056528264132066,20.0,40.0
1999,0,1999,[201 217 290 211 236],385,1,8110,4.055,0.0,20.0
2000,0,2000,[232 301 216 280 452],13,1,8111,4.053473263368316,0.0,0.0
2001,0,2001,[231 478 215 331 211],313,2,8113,4.0524475524475525,0.0,20.0
2002,0,2002,[303 316 272 276 211],90,5,8118,4.052920619071393,20.0,40.0
2003,0,2003,[303 316 272 276 211],90,5,8123,4.053393213572854,20.0,40.0
2004,0,2004,[303 316 272 276 211],13,5,8128,4.053865336658354,20.0,40.0
2005,0,2005,[384 243 264 231 201],13,1,8129,4.052342971086739,0.0,0.0
2006,0,2006,[280 326 300 299 272],13,2,8131,4.051320378674639,0.0,20.0
2007,0,2007,[303 316 272 276 211],13,5,8136,4.051792828685259,20.0,40.0
2008,0,2008,[303 316 272 276 211],90,5,8141,4.052264808362369,20.0,40.0
2009,0,2009,[331 255 300 298 291],548,5,8146,4.05273631840796,0.0,20.0
2010,0,2010,[429 290 239 315 206],537,1,8147,4.051218299353556,20.0,0.0
2011,0,2011,[303 316 272 276 211],90,5,8152,4.0516898608349905,20.0,40.0
2012,0,2012,[303 316 272 276 211],13,5,8157,4.052160953800298,20.0,40.0
2013,0,2013,[303 316 272 276 211],90,5,8162,4.052631578947368,20.0,40.0
2014,0,2014,[303 316 272 276 211],90,5,8167,4.053101736972705,20.0,40.0
2015,0,2015,[208 217 223 452 267],833,1,8168,4.051587301587301,20.0,0.0
2016,0,2016,[303 316 272 276 211],13,5,8173,4.052057511155181,20.0,40.0
2017,0,2017,[303 316 272 276 211],13,5,8178,4.052527254707631,20.0,40.0
2018,0,2018,[215 272 206 213 230],537,2,8180,4.051510648836057,0.0,0.0
2019,0,2019,[243 215 507 216 209],13,1,8181,4.05,0.0,0.0
2020,0,2020,[303 316 272 276 211],90,5,8186,4.050470064324592,20.0,40.0
2021,0,2021,[230 315 429 290 268],334,4,8190,4.050445103857567,20.0,0.0
2022,0,2022,[303 316 272 276 211],13,5,8195,4.050914483440435,20.0,40.0
2023,0,2023,[219 254 211 291 429],804,4,8199,4.050889328063241,0.0,20.0
2024,0,2024,[303 316 272 276 211],90,5,8204,4.051358024691358,20.0,40.0
2025,0,2025,[223 217 275 215 413],13,2,8206,4.050345508390918,20.0,20.0
2026,0,2026,[303 316 272 276 211],13,5,8211,4.050814010853478,20.0,40.0
2027,0,2027,[303 316 272 276 211],90,5,8216,4.051282051282051,20.0,40.0
2028,0,2028,[303 316 272 276 211],13,5,8221,4.051749630359783,20.0,40.0
2029,0,2029,[303 316 272 276 211],90,5,8226,4.052216748768473,20.0,40.0
2030,0,2030,[303 316 272 276 211],90,5,8231,4.052683407188577,20.0,40.0
2031,0,2031,[303 316 272 276 211],13,5,8236,4.053149606299213,20.0,40.0
2032,0,2032,[303 316 272 276 211],90,5,8241,4.053615346778161,20.0,40.0
2033,0,2033,[303 316 272 276 211],90,5,8246,4.054080629301868,20.0,40.0
2034,0,2034,[303 316 272 276 211],90,5,8251,4.054545454545455,20.0,40.0
2035,0,2035,[303 316 272 276 211],90,5,8256,4.055009823182711,20.0,40.0
2036,0,2036,[221 276 478 291 211],234,0,8256,4.053019145802651,0.0,40.0
2037,0,2037,[507 276 284 244 315],474,5,8261,4.053483807654564,20.0,20.0
2038,0,2038,[254 365 431 226 240],749,2,8263,4.052476704266797,0.0,0.0
2039,0,2039,[303 316 272 276 211],90,5,8268,4.052941176470588,20.0,40.0
2040,0,2040,[303 316 272 276 211],13,5,8273,4.053405193532582,20.0,40.0
2041,0,2041,[378 212 509 218 431],311,3,8276,4.052889324191969,0.0,0.0
2042,0,2042,[485 336 209 216 230],13,0,8276,4.050905531081742,0.0,0.0
2043,0,2043,[507 201 485 365 239],308,1,8277,4.049412915851272,0.0,0.0
2044,0,2044,[303 316 272 276 211],90,5,8282,4.049877750611247,20.0,40.0
2045,0,2045,[303 316 272 276 211],13,5,8287,4.050342130987293,20.0,40.0
2046,0,2046,[303 316 272 276 211],13,5,8292,4.050806057645334,20.0,40.0
2047,0,2047,[223 202 268 230 246],92,3,8295,4.05029296875,20.0,0.0
2048,0,2048,[303 316 272 276 211],13,5,8300,4.050756466569058,20.0,40.0
2049,0,2049,[232 218 367 276 429],59,4,8304,4.050731707317073,0.0,20.0
2050,0,2050,[226 250 295 293 431],749,3,8307,4.05021940516821,0.0,0.0
2051,0,2051,[303 316 272 276 211],90,5,8312,4.050682261208577,20.0,40.0
2052,0,2052,[303 316 272 276 211],13,5,8317,4.051144666341939,20.0,40.0
2053,0,2053,[303 316 272 276 211],90,5,8322,4.051606621226874,20.0,40.0
2054,0,2054,[508 481 315 350 478],13,2,8324,4.050608272506083,20.0,0.0
2055,0,2055,[303 316 272 276 211],13,5,8329,4.051070038910506,20.0,40.0
2056,0,2056,[303 316 272 276 211],90,5,8334,4.05153135634419,20.0,40.0
2057,0,2057,[303 316 272 276 211],13,5,8339,4.051992225461613,20.0,40.0
2058,0,2058,[303 316 272 276 211],13,5,8344,4.052452646915978,20.0,40.0
2059,0,2059,[303 316 272 276 211],90,5,8349,4.052912621359224,20.0,40.0
2060,0,2060,[303 316 272 276 211],90,5,8354,4.053372149442018,20.0,40.0
2061,0,2061,[303 316 272 276 211],90,5,8359,4.053831231813773,20.0,40.0
2062,0,2062,[303 316 272 276 211],13,5,8364,4.054289869122637,20.0,40.0
2063,0,2063,[303 316 272 276 211],13,5,8369,4.054748062015504,20.0,40.0
2064,0,2064,[303 316 272 276 211],13,5,8374,4.0552058111380145,20.0,40.0
2065,0,2065,[303 316 272 276 211],13,5,8379,4.05566311713456,20.0,40.0
2066,0,2066,[303 316 272 276 211],13,5,8384,4.056119980648282,20.0,40.0
2067,0,2067,[303 316 272 276 211],90,5,8389,4.056576402321083,20.0,40.0
2068,0,2068,[301 227 485 272 213],334,2,8391,4.055582406959884,0.0,0.0
2069,0,2069,[303 316 272 276 211],13,5,8396,4.056038647342995,20.0,40.0
2070,0,2070,[303 316 272 276 211],13,5,8401,4.056494447126992,20.0,40.0
2071,0,2071,[276 452 259 298 315],145,1,8402,4.055019305019305,20.0,20.0
2072,0,2072,[303 316 272 211 276],90,5,8407,4.055475156777617,20.0,40.0
2073,0,2073,[303 316 272 211 276],13,5,8412,4.055930568948891,20.0,40.0
2074,0,2074,[367 236 431 284 215],234,1,8413,4.054457831325301,0.0,0.0
2075,0,2075,[303 316 272 211 276],13,5,8418,4.054913294797688,20.0,40.0
2076,0,2076,[303 316 272 211 276],90,5,8423,4.055368319691863,20.0,40.0
2077,0,2077,[303 316 272 211 276],90,5,8428,4.0558229066410005,20.0,40.0
2078,0,2078,[303 316 272 211 276],90,5,8433,4.0562770562770565,20.0,40.0
2079,0,2079,[201 507 226 227 223],13,3,8436,4.055769230769231,20.0,0.0
2080,0,2080,[303 316 272 211 276],13,5,8441,4.056222969726093,20.0,40.0
2081,0,2081,[303 316 272 211 276],13,5,8446,4.0566762728146015,20.0,40.0
2082,0,2082,[218 215 293 255 222],474,5,8451,4.057129140662506,0.0,20.0
2083,0,2083,[221 226 284 509 378],537,1,8452,4.0556621880998085,0.0,0.0
2084,0,2084,[303 316 272 211 276],13,5,8457,4.056115107913669,20.0,40.0
2085,0,2085,[303 316 272 211 276],13,5,8462,4.056567593480345,20.0,40.0
2086,0,2086,[212 268 201 202 239],537,1,8463,4.05510301868711,0.0,0.0
2087,0,2087,[303 316 272 211 276],13,5,8468,4.055555555555555,20.0,40.0
2088,0,2088,[303 316 272 211 276],13,5,8473,4.056007659167066,20.0,40.0
2089,0,2089,[452 280 303 222 350],13,2,8475,4.055023923444976,0.0,20.0
2090,0,2090,[303 316 272 211 276],90,5,8480,4.055475848876136,20.0,40.0
2091,0,2091,[478 215 216 222 213],537,2,8482,4.0544933078393885,0.0,20.0
2092,0,2092,[303 316 272 211 276],90,5,8487,4.054945054945055,20.0,40.0
2093,0,2093,[216 230 223 222 583],92,2,8489,4.05396370582617,20.0,20.0
2094,0,2094,[218 431 227 239 201],387,2,8491,4.052983293556086,0.0,0.0
2095,0,2095,[259 284 275 211 241],308,4,8495,4.052958015267175,0.0,40.0
2096,0,2096,[303 316 272 211 276],90,5,8500,4.0534096328087745,20.0,40.0
2097,0,2097,[303 316 272 211 276],13,5,8505,4.053860819828408,20.0,40.0
2098,0,2098,[303 316 272 211 276],13,5,8510,4.054311576941401,20.0,40.0
2099,0,2099,[303 316 272 211 276],90,5,8515,4.054761904761905,20.0,40.0
2100,0,2100,[303 316 272 211 276],13,5,8520,4.055211803902903,20.0,40.0
2101,0,2101,[303 316 272 211 276],90,5,8525,4.055661274976213,20.0,40.0
2102,0,2102,[303 316 272 211 276],13,5,8530,4.056110318592487,20.0,40.0
2103,0,2103,[303 316 272 211 276],90,5,8535,4.056558935361217,20.0,40.0
2104,0,2104,[303 316 272 211 276],90,5,8540,4.0570071258907365,20.0,40.0
2105,0,2105,[303 316 272 211 276],90,5,8545,4.057454890788224,20.0,40.0
2106,0,2106,[303 316 272 211 276],90,5,8550,4.057902230659706,20.0,40.0
2107,0,2107,[507 222 478 284 431],406,2,8552,4.056925996204933,0.0,20.0
2108,0,2108,[303 316 272 211 276],13,5,8557,4.0573731626363205,20.0,40.0
2109,0,2109,[303 316 272 211 276],90,5,8562,4.05781990521327,20.0,40.0
2110,0,2110,[217 429 394 222 231],13,1,8563,4.056371387967788,0.0,20.0
2111,0,2111,[303 316 272 211 276],90,5,8568,4.056818181818182,20.0,40.0
2112,0,2112,[303 316 272 211 276],90,5,8573,4.057264552768576,20.0,40.0
2113,0,2113,[478 250 212 227 208],339,4,8577,4.057237464522233,0.0,0.0
2114,0,2114,[303 316 272 211 276],90,5,8582,4.057683215130024,20.0,40.0
2115,0,2115,[303 316 272 211 276],13,5,8587,4.0581285444234405,20.0,40.0
2116,0,2116,[246 239 213 230 315],334,4,8591,4.05810108644308,20.0,0.0
2117,0,2117,[303 316 272 211 276],90,5,8596,4.0585457979225685,20.0,40.0
2118,0,2118,[303 316 272 211 276],90,5,8601,4.0589900896649365,20.0,40.0
2119,0,2119,[303 316 272 211 276],13,5,8606,4.059433962264151,20.0,40.0
2120,0,2120,[303 316 272 211 276],90,5,8611,4.05987741631306,20.0,40.0
2121,0,2121,[303 316 272 211 276],90,5,8616,4.060320452403393,20.0,40.0
2122,0,2122,[299 344 231 239 316],13,2,8618,4.059349976448422,20.0,0.0
2123,0,2123,[303 316 272 211 276],90,5,8623,4.059792843691149,20.0,40.0
2124,0,2124,[303 316 272 211 276],90,5,8628,4.060235294117647,20.0,40.0
2125,0,2125,[303 316 272 211 276],90,5,8633,4.060677328316086,20.0,40.0
2126,0,2126,[303 316 272 211 276],90,5,8638,4.061118946873531,20.0,40.0
2127,0,2127,[211 218 350 331 290],13,2,8640,4.06015037593985,0.0,20.0
2128,0,2128,[303 316 272 211 276],90,5,8645,4.0605918271488965,20.0,40.0
2129,0,2129,[303 316 272 211 276],90,5,8650,4.061032863849765,20.0,40.0
2130,0,2130,[272 244 300 255 209],392,2,8652,4.060065696855936,0.0,20.0
2131,0,2131,[303 316 272 211 276],13,5,8657,4.060506566604127,20.0,40.0
2132,0,2132,[303 316 272 211 276],90,5,8662,4.060947022972339,20.0,40.0
2133,0,2133,[429 315 216 212 509],13,4,8666,4.060918462980319,20.0,0.0
2134,0,2134,[303 316 272 211 276],90,5,8671,4.061358313817331,20.0,40.0
2135,0,2135,[303 316 272 211 276],13,5,8676,4.061797752808989,20.0,40.0
2136,0,2136,[272 276 221 217 259],184,3,8679,4.061300889096865,0.0,20.0
2137,0,2137,[303 316 272 211 276],90,5,8684,4.061739943872778,20.0,40.0
2138,0,2138,[303 316 272 211 276],90,5,8689,4.062178588125292,20.0,40.0
2139,0,2139,[413 508 209 215 481],13,1,8690,4.0607476635514015,0.0,0.0
2140,0,2140,[300 241 227 275 299],13,1,8691,4.059318075665577,0.0,40.0
2141,0,2141,[303 316 272 211 276],90,5,8696,4.059757236227824,20.0,40.0
2142,0,2142,[509 413 276 216 211],13,3,8699,4.059262715818946,0.0,40.0
2143,0,2143,[303 316 272 211 276],13,5,8704,4.059701492537314,20.0,40.0
2144,0,2144,[215 220 284 276 216],271,2,8706,4.058741258741259,0.0,20.0
2145,0,2145,[303 316 272 211 276],13,5,8711,4.059179869524697,20.0,40.0
2146,0,2146,[303 316 272 211 276],90,5,8716,4.059618071727993,20.0,40.0
2147,0,2147,[303 316 272 211 276],90,5,8721,4.060055865921788,20.0,40.0
2148,0,2148,[259 299 211 231 236],537,1,8722,4.058631921824104,0.0,20.0
2149,0,2149,[303 316 272 211 276],13,5,8727,4.05906976744186,20.0,40.0
2150,0,2150,[215 216 429 226 315],650,2,8729,4.05811250581125,20.0,0.0
2151,0,2151,[303 316 272 211 276],13,5,8734,4.058550185873606,20.0,40.0
2152,0,2152,[303 316 272 211 276],13,5,8739,4.058987459359034,20.0,40.0
2153,0,2153,[293 255 275 230 283],474,2,8741,4.058031569173631,0.0,20.0
2154,0,2154,[303 316 272 211 276],13,5,8746,4.0584686774942,20.0,40.0
2155,0,2155,[303 316 272 211 276],13,5,8751,4.058905380333952,20.0,40.0
2156,0,2156,[303 316 272 211 276],13,5,8756,4.059341678256838,20.0,40.0
2157,0,2157,[303 316 272 211 276],13,5,8761,4.059777571825765,20.0,40.0
2158,0,2158,[303 316 272 211 276],13,5,8766,4.060213061602594,20.0,40.0
2159,0,2159,[303 316 272 211 276],13,5,8771,4.0606481481481485,20.0,40.0
2160,0,2160,[216 232 394 272 202],13,2,8773,4.059694585839889,0.0,0.0
2161,0,2161,[303 316 272 211 276],13,5,8778,4.060129509713229,20.0,40.0
2162,0,2162,[201 276 211 431 227],13,3,8781,4.0596393897364775,0.0,40.0
2163,0,2163,[303 316 272 211 276],90,5,8786,4.06007393715342,20.0,40.0
2164,0,2164,[431 367 420 215 208],650,1,8787,4.058660508083141,0.0,0.0
2165,0,2165,[303 316 272 211 276],90,5,8792,4.059095106186519,20.0,40.0
2166,0,2166,[303 316 272 211 276],13,5,8797,4.059529303184125,20.0,40.0
2167,0,2167,[303 316 272 211 276],90,5,8802,4.0599630996309966,20.0,40.0
2168,0,2168,[303 316 272 211 276],90,5,8807,4.060396496081143,20.0,40.0
2169,0,2169,[202 239 284 275 227],64,3,8810,4.059907834101383,0.0,20.0
2170,0,2170,[215 478 206 202 218],650,2,8812,4.058959005066789,0.0,0.0
2171,0,2171,[301 291 283 211 241],85,2,8814,4.058011049723757,0.0,20.0
2172,0,2172,[303 316 272 211 276],90,5,8819,4.058444546709618,20.0,40.0
2173,0,2173,[507 299 272 321 429],13,2,8821,4.0574977000919965,0.0,0.0
2174,0,2174,[429 243 452 336 413],13,1,8822,4.056091954022989,0.0,0.0
2175,0,2175,[303 316 272 211 276],90,5,8827,4.056525735294118,20.0,40.0
2176,0,2176,[303 316 272 211 276],13,5,8832,4.056959118052365,20.0,40.0
2177,0,2177,[326 315 275 272 420],13,3,8835,4.056473829201102,20.0,20.0
2178,0,2178,[350 394 420 300 301],13,1,8836,4.055071133547499,0.0,20.0
2179,0,2179,[231 264 485 219 261],13,1,8837,4.053669724770642,0.0,0.0
2180,0,2180,[239 202 261 300 212],13,3,8840,4.0531866116460336,0.0,20.0
2181,0,2181,[303 316 272 211 276],13,5,8845,4.053620531622365,20.0,40.0
2182,0,2182,[303 316 272 211 276],90,5,8850,4.054054054054054,20.0,40.0
2183,0,2183,[303 316 272 211 276],13,5,8855,4.05448717948718,20.0,40.0
2184,0,2184,[240 215 485 227 295],749,3,8858,4.054004576659039,0.0,0.0
2185,0,2185,[261 216 226 394 299],13,1,8859,4.052607502287283,0.0,0.0
2186,0,2186,[303 316 272 211 276],90,5,8864,4.053040695016004,20.0,40.0
2187,0,2187,[331 298 212 219 226],145,1,8865,4.051645338208409,0.0,0.0
2188,0,2188,[244 429 315 268 250],334,3,8868,4.051164915486524,20.0,0.0
2189,0,2189,[303 316 272 211 276],90,5,8873,4.051598173515981,20.0,40.0
2190,0,2190,[303 316 272 211 276],13,5,8878,4.052031036056595,20.0,40.0
2191,0,2191,[303 316 272 211 276],13,5,8883,4.052463503649635,20.0,40.0
2192,0,2192,[303 316 272 211 276],13,5,8888,4.052895576835385,20.0,40.0
2193,0,2193,[264 315 291 431 413],548,3,8891,4.052415679124886,20.0,0.0
2194,0,2194,[303 316 272 211 276],90,5,8896,4.0528473804100225,20.0,40.0
2195,0,2195,[303 316 272 211 276],13,5,8901,4.05327868852459,20.0,40.0
2196,0,2196,[303 316 272 211 276],13,5,8906,4.053709604005462,20.0,40.0
2197,0,2197,[303 316 272 211 276],90,5,8911,4.054140127388535,20.0,40.0
2198,0,2198,[303 316 272 211 276],13,5,8916,4.054570259208731,20.0,40.0
2199,0,2199,[303 316 272 211 276],13,5,8921,4.055,20.0,40.0
2200,0,2200,[303 316 272 211 276],13,5,8926,4.05542935029532,20.0,40.0
2201,0,2201,[303 316 272 211 276],90,5,8931,4.055858310626703,20.0,40.0
2202,0,2202,[202 420 219 478 239],13,4,8935,4.05583295506128,0.0,0.0
2203,0,2203,[303 316 272 211 276],13,5,8940,4.056261343012705,20.0,40.0
2204,0,2204,[303 316 272 211 276],13,5,8945,4.0566893424036286,20.0,40.0
2205,0,2205,[303 316 272 211 276],90,5,8950,4.057116953762466,20.0,40.0
2206,0,2206,[303 316 272 211 276],90,5,8955,4.057544177616674,20.0,40.0
2207,0,2207,[298 223 211 231 218],447,4,8959,4.057518115942029,20.0,20.0
2208,0,2208,[303 316 272 211 276],90,5,8964,4.057944771389769,20.0,40.0
2209,0,2209,[303 316 272 211 276],90,5,8969,4.058371040723982,20.0,40.0
2210,0,2210,[272 290 208 223 315],650,2,8971,4.057440072365446,40.0,0.0
2211,0,2211,[216 384 208 429 256],385,2,8973,4.056509945750452,0.0,0.0
2212,0,2212,[284 222 301 208 215],537,1,8974,4.055128784455491,0.0,20.0
2213,0,2213,[303 316 272 211 276],90,5,8979,4.055555555555555,20.0,40.0
2214,0,2214,[303 316 272 211 276],90,5,8984,4.0559819413092555,20.0,40.0
2215,0,2215,[303 316 272 211 276],90,5,8989,4.056407942238267,20.0,40.0
2216,0,2216,[350 344 227 201 507],13,1,8990,4.055029318899414,0.0,0.0
2217,0,2217,[303 316 272 211 276],90,5,8995,4.055455365193868,20.0,40.0
2218,0,2218,[303 316 272 211 276],90,5,9000,4.0558810274898605,20.0,40.0
2219,0,2219,[303 316 272 211 276],90,5,9005,4.056306306306307,20.0,40.0
2220,0,2220,[213 268 212 272 215],90,4,9009,4.056280954524989,0.0,0.0
2221,0,2221,[303 316 272 211 276],13,5,9014,4.056705670567057,20.0,40.0
2222,0,2222,[223 218 231 420 326],378,2,9016,4.0557804768331085,20.0,0.0
2223,0,2223,[212 509 275 299 508],13,2,9018,4.054856115107913,0.0,20.0
2224,0,2224,[303 316 272 211 276],13,5,9023,4.055280898876404,20.0,40.0
2225,0,2225,[303 316 272 211 276],90,5,9028,4.05570530098832,20.0,40.0
2226,0,2226,[303 316 272 211 276],13,5,9033,4.0561293219577905,20.0,40.0
2227,0,2227,[303 316 272 211 276],13,5,9038,4.056552962298025,20.0,40.0
2228,0,2228,[303 316 272 211 276],13,5,9043,4.05697622252131,20.0,40.0
2229,0,2229,[303 316 272 211 276],90,5,9048,4.057399103139013,20.0,40.0
2230,0,2230,[303 316 272 211 276],13,5,9053,4.057821604661587,20.0,40.0
2231,0,2231,[303 316 272 211 276],13,5,9058,4.058243727598566,20.0,40.0
2232,0,2232,[272 378 216 221 315],537,2,9060,4.057321988356471,20.0,0.0
2233,0,2233,[303 316 272 211 276],13,5,9065,4.0577439570277525,20.0,40.0
2234,0,2234,[303 316 272 211 276],13,5,9070,4.058165548098434,20.0,40.0
2235,0,2235,[303 316 272 211 276],13,5,9075,4.058586762075135,20.0,40.0
2236,0,2236,[303 316 272 211 276],90,5,9080,4.059007599463567,20.0,40.0
2237,0,2237,[300 275 268 485 230],334,3,9083,4.058534405719392,0.0,40.0
2238,0,2238,[303 316 272 211 276],13,5,9088,4.05895489057615,20.0,40.0
2239,0,2239,[303 316 272 211 276],13,5,9093,4.059375,20.0,40.0
2240,0,2240,[303 316 272 211 276],13,5,9098,4.059794734493529,20.0,40.0
2241,0,2241,[303 316 272 211 276],13,5,9103,4.06021409455843,20.0,40.0
2242,0,2242,[420 507 208 241 217],13,2,9105,4.059295586268391,0.0,0.0
2243,0,2243,[303 316 272 211 276],90,5,9110,4.0597147950089125,20.0,40.0
2244,0,2244,[201 280 219 215 211],13,3,9113,4.0592427616926505,0.0,20.0
2245,0,2245,[303 316 272 211 276],90,5,9118,4.059661620658949,20.0,40.0
2246,0,2246,[303 316 272 211 276],13,5,9123,4.060080106809079,20.0,40.0
2247,0,2247,[303 316 272 211 276],13,5,9128,4.06049822064057,20.0,40.0
2248,0,2248,[303 316 272 211 276],90,5,9133,4.060915962650067,20.0,40.0
2249,0,2249,[303 316 272 211 276],13,5,9138,4.061333333333334,20.0,40.0
2250,0,2250,[303 316 272 211 276],13,5,9143,4.061750333185251,20.0,40.0
2251,0,2251,[217 272 264 209 452],13,2,9145,4.0608348134991115,0.0,0.0
2252,0,2252,[303 316 272 211 276],90,5,9150,4.061251664447403,20.0,40.0
2253,0,2253,[507 378 275 293 272],454,2,9152,4.0603371783496005,0.0,20.0
2254,0,2254,[303 316 272 211 276],90,5,9157,4.060753880266075,20.0,40.0
2255,0,2255,[485 303 301 201 420],13,2,9159,4.059840425531915,0.0,0.0
2256,0,2256,[303 316 272 211 276],90,5,9164,4.0602569782897655,20.0,40.0
2257,0,2257,[303 316 272 211 276],13,5,9169,4.060673162090345,20.0,40.0
2258,0,2258,[303 316 272 211 276],13,5,9174,4.061088977423639,20.0,40.0
2259,0,2259,[508 301 236 246 331],486,2,9176,4.060176991150443,0.0,0.0
2260,0,2260,[303 316 272 211 276],13,5,9181,4.060592658115878,20.0,40.0
2261,0,2261,[213 367 222 321 218],194,1,9182,4.059239610963749,0.0,20.0
2262,0,2262,[303 316 272 211 276],90,5,9187,4.059655324790102,20.0,40.0
2263,0,2263,[201 264 211 230 367],308,4,9191,4.059628975265018,0.0,20.0
2264,0,2264,[303 316 272 211 276],90,5,9196,4.060044150110375,20.0,40.0
2265,0,2265,[303 316 272 211 276],13,5,9201,4.060458958517211,20.0,40.0
2266,0,2266,[303 316 272 211 276],90,5,9206,4.060873400970445,20.0,40.0
2267,0,2267,[507 216 222 220 208],406,1,9207,4.059523809523809,0.0,20.0
2268,0,2268,[303 316 272 211 276],13,5,9212,4.0599382988100485,20.0,40.0
2269,0,2269,[303 316 272 211 276],13,5,9217,4.0603524229074885,20.0,40.0
2270,0,2270,[255 246 290 268 303],334,3,9220,4.059885512989872,0.0,0.0
2271,0,2271,[213 507 223 241 259],308,3,9223,4.059419014084507,20.0,0.0
2272,0,2272,[303 316 272 211 276],13,5,9228,4.059832820061593,20.0,40.0
2273,0,2273,[413 219 300 350 344],13,0,9228,4.058047493403694,0.0,20.0
2274,0,2274,[241 326 212 431 202],64,2,9230,4.057142857142857,0.0,0.0
2275,0,2275,[241 212 344 216 209],13,1,9231,4.055799648506151,0.0,0.0
2276,0,2276,[303 316 272 211 276],90,5,9236,4.0562143170838825,20.0,40.0
2277,0,2277,[485 507 232 321 431],194,2,9238,4.05531167690957,0.0,0.0
2278,0,2278,[223 336 230 231 272],13,2,9240,4.054409828872313,20.0,0.0
2279,0,2279,[206 392 315 378 509],537,2,9242,4.053508771929825,20.0,0.0
2280,0,2280,[230 367 300 275 211],64,4,9246,4.053485313459009,0.0,60.0
2281,0,2281,[303 316 272 211 276],90,5,9251,4.053900087642419,20.0,40.0
2282,0,2282,[303 316 272 211 276],90,5,9256,4.05431449846693,20.0,40.0
2283,0,2283,[429 239 268 218 201],387,1,9257,4.052977232924693,0.0,0.0
2284,0,2284,[303 316 272 211 276],13,5,9262,4.0533916849015315,20.0,40.0
2285,0,2285,[211 201 300 284 226],537,1,9263,4.052055993000875,0.0,40.0
2286,0,2286,[303 316 272 211 276],13,5,9268,4.052470485351989,20.0,40.0
2287,0,2287,[250 290 254 239 378],804,5,9273,4.052884615384615,0.0,0.0
2288,0,2288,[303 316 272 211 276],90,5,9278,4.053298383573613,20.0,40.0
2289,0,2289,[303 316 272 211 276],13,5,9283,4.053711790393013,20.0,40.0
2290,0,2290,[303 316 272 211 276],13,5,9288,4.054124836316019,20.0,40.0
2291,0,2291,[212 208 303 321 280],13,4,9292,4.054101221640488,0.0,0.0
2292,0,2292,[276 211 485 315 212],311,2,9294,4.053205407762756,20.0,40.0
2293,0,2293,[303 316 272 211 276],90,5,9299,4.053618134263296,20.0,40.0
2294,0,2294,[303 316 272 211 276],90,5,9304,4.054030501089325,20.0,40.0
2295,0,2295,[303 316 272 211 276],13,5,9309,4.054442508710801,20.0,40.0
2296,0,2296,[303 316 272 211 276],90,5,9314,4.054854157596865,20.0,40.0
2297,0,2297,[303 316 272 211 276],13,5,9319,4.05526544821584,20.0,40.0
2298,0,2298,[303 316 272 211 276],90,5,9324,4.055676381035233,20.0,40.0
2299,0,2299,[378 452 208 209 276],308,3,9327,4.055217391304348,0.0,20.0
2300,0,2300,[284 230 259 321 221],537,0,9327,4.053455019556714,0.0,0.0
2301,0,2301,[303 316 272 211 276],13,5,9332,4.053866203301477,20.0,40.0
2302,0,2302,[213 508 221 223 220],184,4,9336,4.053842813721233,20.0,0.0
2303,0,2303,[303 316 272 211 276],90,5,9341,4.054253472222222,20.0,40.0
2304,0,2304,[303 316 272 211 276],90,5,9346,4.054663774403471,20.0,40.0
2305,0,2305,[452 413 217 509 212],13,2,9348,4.053772766695577,0.0,0.0
2306,0,2306,[321 221 209 213 236],537,2,9350,4.052882531426095,0.0,0.0
2307,0,2307,[303 316 272 211 276],90,5,9355,4.053292894280762,20.0,40.0
2308,0,2308,[303 316 272 211 276],90,5,9360,4.053702901689043,20.0,40.0
2309,0,2309,[303 316 272 211 276],90,5,9365,4.054112554112554,20.0,40.0
2310,0,2310,[303 316 272 211 276],13,5,9370,4.054521852012116,20.0,40.0
2311,0,2311,[303 316 272 211 276],13,5,9375,4.054930795847751,20.0,40.0
2312,0,2312,[303 316 272 211 276],13,5,9380,4.0553393860786855,20.0,40.0
2313,0,2313,[481 231 324 268 246],334,4,9384,4.055315471045808,0.0,0.0
2314,0,2314,[223 250 509 272 218],184,4,9388,4.055291576673866,20.0,0.0
2315,0,2315,[227 222 202 254 208],279,3,9391,4.054835924006908,0.0,20.0
2316,0,2316,[276 243 299 429 241],537,1,9392,4.0535174794993525,0.0,20.0
2317,0,2317,[303 316 272 211 276],13,5,9397,4.053925798101812,20.0,40.0
2318,0,2318,[303 316 272 211 276],90,5,9402,4.054333764553687,20.0,40.0
2319,0,2319,[303 316 272 211 276],90,5,9407,4.054741379310345,20.0,40.0
2320,0,2320,[303 316 272 211 276],90,5,9412,4.055148642826368,20.0,40.0
2321,0,2321,[303 316 272 211 276],90,5,9417,4.055555555555555,20.0,40.0
2322,0,2322,[303 316 272 211 276],13,5,9422,4.0559621179509255,20.0,40.0
2323,0,2323,[303 316 272 211 276],90,5,9427,4.056368330464716,20.0,40.0
2324,0,2324,[303 316 272 211 276],90,5,9432,4.056774193548387,20.0,40.0
2325,0,2325,[303 316 272 211 276],13,5,9437,4.057179707652622,20.0,40.0
2326,0,2326,[303 316 272 211 276],90,5,9442,4.057584873227332,20.0,40.0
2327,0,2327,[303 316 272 211 276],13,5,9447,4.05798969072165,20.0,40.0
2328,0,2328,[303 316 272 211 276],90,5,9452,4.0583941605839415,20.0,40.0
2329,0,2329,[303 316 272 211 276],13,5,9457,4.058798283261803,20.0,40.0
2330,0,2330,[481 394 215 280 216],13,2,9459,4.057915057915058,0.0,0.0
2331,0,2331,[303 316 272 211 276],90,5,9464,4.058319039451115,20.0,40.0
2332,0,2332,[303 316 272 211 276],90,5,9469,4.05872267466781,20.0,40.0
2333,0,2333,[303 316 272 211 276],90,5,9474,4.059125964010283,20.0,40.0
2334,0,2334,[303 316 272 211 276],90,5,9479,4.059528907922912,20.0,40.0
2335,0,2335,[303 316 272 211 276],90,5,9484,4.059931506849315,20.0,40.0
2336,0,2336,[303 316 272 211 276],13,5,9489,4.060333761232349,20.0,40.0
2337,0,2337,[303 316 272 211 276],90,5,9494,4.060735671514115,20.0,40.0
2338,0,2338,[303 316 272 211 276],90,5,9499,4.061137238135956,20.0,40.0
2339,0,2339,[303 316 272 211 276],13,5,9504,4.061538461538461,20.0,40.0
2340,0,2340,[303 316 272 211 276],13,5,9509,4.06193934216147,20.0,40.0
2341,0,2341,[303 316 272 211 276],13,5,9514,4.062339880444065,20.0,40.0
2342,0,2342,[303 316 272 211 276],13,5,9519,4.062740076824584,20.0,40.0
2343,0,2343,[259 303 211 241 300],537,2,9521,4.061860068259386,0.0,40.0
2344,0,2344,[243 212 211 272 201],537,2,9523,4.0609808102345415,0.0,20.0
2345,0,2345,[485 365 223 255 452],308,2,9525,4.060102301790281,20.0,0.0
2346,0,2346,[303 316 272 211 276],13,5,9530,4.060502769492969,20.0,40.0
2347,0,2347,[303 316 272 211 276],90,5,9535,4.060902896081772,20.0,40.0
2348,0,2348,[303 316 272 211 276],90,5,9540,4.061302681992337,20.0,40.0
2349,0,2349,[303 316 272 211 276],13,5,9545,4.061702127659575,20.0,40.0
2350,0,2350,[209 268 246 295 321],387,1,9546,4.060399829859634,0.0,0.0
2351,0,2351,[315 239 276 485 216],13,3,9549,4.059948979591836,20.0,20.0
2352,0,2352,[303 316 272 211 276],13,5,9554,4.0603484912877175,20.0,40.0
2353,0,2353,[303 316 272 211 276],13,5,9559,4.0607476635514015,20.0,40.0
2354,0,2354,[303 316 272 211 276],90,5,9564,4.061146496815287,20.0,40.0
2355,0,2355,[303 316 272 211 276],13,5,9569,4.0615449915110355,20.0,40.0
2356,0,2356,[303 316 272 211 276],90,5,9574,4.06194314806958,20.0,40.0
2357,0,2357,[239 215 212 300 209],13,3,9577,4.061492790500424,0.0,20.0
2358,0,2358,[303 316 272 211 276],90,5,9582,4.0618906316235694,20.0,40.0
2359,0,2359,[303 316 272 211 276],13,5,9587,4.062288135593221,20.0,40.0
2360,0,2360,[508 321 202 301 211],6,1,9588,4.060991105463787,0.0,20.0
2361,0,2361,[303 316 272 211 276],90,5,9593,4.061388653683319,20.0,40.0
2362,0,2362,[303 316 272 211 276],90,5,9598,4.061785865425307,20.0,40.0
2363,0,2363,[429 509 202 321 431],279,4,9602,4.06175972927242,0.0,0.0
2364,0,2364,[303 316 272 211 276],13,5,9607,4.06215644820296,20.0,40.0
2365,0,2365,[303 316 272 211 276],90,5,9612,4.062552831783601,20.0,40.0
2366,0,2366,[303 316 272 211 276],13,5,9617,4.062948880439374,20.0,40.0
2367,0,2367,[303 316 272 211 276],90,5,9622,4.063344594594595,20.0,40.0
2368,0,2368,[239 250 201 209 211],387,4,9626,4.063317855635289,0.0,20.0
2369,0,2369,[218 507 290 429 259],234,2,9628,4.062447257383966,0.0,0.0
2370,0,2370,[290 218 209 211 216],524,3,9631,4.061999156474061,0.0,20.0
2371,0,2371,[303 316 272 211 276],90,5,9636,4.062394603709949,20.0,40.0
2372,0,2372,[303 316 272 211 276],90,5,9641,4.062789717656974,20.0,40.0
2373,0,2373,[303 316 272 211 276],13,5,9646,4.06318449873631,20.0,40.0
2374,0,2374,[303 316 272 211 276],13,5,9651,4.063578947368421,20.0,40.0
2375,0,2375,[303 316 272 211 276],90,5,9656,4.063973063973064,20.0,40.0
2376,0,2376,[303 316 272 211 276],90,5,9661,4.064366848969289,20.0,40.0
2377,0,2377,[303 316 272 211 276],13,5,9666,4.064760302775442,20.0,40.0
2378,0,2378,[303 316 272 211 276],90,5,9671,4.0651534258091635,20.0,40.0
2379,0,2379,[507 236 299 291 201],537,1,9672,4.063865546218487,0.0,0.0
2380,0,2380,[239 215 208 226 300],215,2,9674,4.0629987400252,0.0,20.0
2381,0,2381,[303 316 272 211 276],13,5,9679,4.063392107472712,20.0,40.0
2382,0,2382,[246 295 212 290 293],894,3,9682,4.062945866554763,0.0,0.0
2383,0,2383,[303 316 272 211 276],90,5,9687,4.063338926174497,20.0,40.0
2384,0,2384,[303 316 272 211 276],90,5,9692,4.063731656184486,20.0,40.0
2385,0,2385,[303 316 272 211 276],13,5,9697,4.0641240569991615,20.0,40.0
2386,0,2386,[303 316 272 211 276],90,5,9702,4.064516129032258,20.0,40.0
2387,0,2387,[202 478 509 303 429],840,2,9704,4.063651591289783,0.0,0.0
2388,0,2388,[303 316 272 211 276],13,5,9709,4.064043532858936,20.0,40.0
2389,0,2389,[303 316 272 211 276],90,5,9714,4.064435146443515,20.0,40.0
2390,0,2390,[202 276 239 264 315],13,5,9719,4.06482643245504,20.0,20.0
2391,0,2391,[299 315 215 231 384],13,2,9721,4.063963210702341,20.0,0.0
2392,0,2392,[201 209 429 250 336],833,2,9723,4.063100710405349,0.0,0.0
2393,0,2393,[303 316 272 211 276],90,5,9728,4.063492063492063,20.0,40.0
2394,0,2394,[303 316 272 211 276],90,5,9733,4.063883089770355,20.0,40.0
2395,0,2395,[431 300 378 276 231],537,2,9735,4.063021702838063,0.0,40.0
2396,0,2396,[303 316 272 211 276],90,5,9740,4.063412599082186,20.0,40.0
2397,0,2397,[485 240 431 232 241],59,2,9742,4.06255212677231,0.0,0.0
2398,0,2398,[303 316 272 211 276],90,5,9747,4.06294289287203,20.0,40.0
2399,0,2399,[303 316 272 211 276],13,5,9752,4.0633333333333335,20.0,40.0
2400,0,2400,[452 481 367 298 216],308,3,9755,4.062890462307372,0.0,0.0
2401,0,2401,[303 316 272 211 276],13,5,9760,4.063280599500416,20.0,40.0
2402,0,2402,[303 316 272 211 276],13,5,9765,4.063670411985019,20.0,40.0
2403,0,2403,[316 336 452 290 231],13,2,9767,4.062811980033278,20.0,0.0
2404,0,2404,[241 239 259 201 275],308,3,9770,4.0623700623700625,0.0,20.0
2405,0,2405,[300 223 452 280 239],13,3,9773,4.061928512053201,20.0,20.0
2406,0,2406,[276 509 392 293 365],308,4,9777,4.061902783547985,0.0,20.0
2407,0,2407,[303 316 272 211 276],90,5,9782,4.062292358803987,20.0,40.0
2408,0,2408,[241 227 221 429 367],524,3,9785,4.061851390618514,0.0,0.0
2409,0,2409,[250 219 431 206 227],387,3,9788,4.0614107883817425,0.0,0.0
2410,0,2410,[303 316 272 211 276],13,5,9793,4.061800082953131,20.0,40.0
2411,0,2411,[223 226 452 211 321],13,3,9796,4.061359867330016,20.0,20.0
2412,0,2412,[303 316 272 211 276],13,5,9801,4.061748860339826,20.0,40.0
2413,0,2413,[303 316 272 211 276],90,5,9806,4.062137531068766,20.0,40.0
2414,0,2414,[303 316 272 211 276],13,5,9811,4.062525879917184,20.0,40.0
2415,0,2415,[303 316 272 211 276],13,5,9816,4.062913907284768,20.0,40.0
2416,0,2416,[201 413 350 300 208],13,1,9817,4.061646669424907,0.0,20.0
2417,0,2417,[344 275 350 290 261],13,1,9818,4.0603804797353185,0.0,20.0
2418,0,2418,[202 223 301 300 243],13,2,9820,4.059528730880529,20.0,20.0
2419,0,2419,[303 316 272 211 276],13,5,9825,4.059917355371901,20.0,40.0
2420,0,2420,[303 316 272 211 276],13,5,9830,4.06030565881867,20.0,40.0
2421,0,2421,[303 316 272 211 276],13,5,9835,4.0606936416184976,20.0,40.0
2422,0,2422,[478 241 367 429 236],343,4,9839,4.060668592653735,0.0,0.0
2423,0,2423,[303 316 272 211 276],90,5,9844,4.061056105610561,20.0,40.0
2424,0,2424,[303 316 272 211 276],13,5,9849,4.061443298969072,20.0,40.0
2425,0,2425,[303 316 272 211 276],13,5,9854,4.061830173124485,20.0,40.0
2426,0,2426,[303 316 272 211 276],90,5,9859,4.0622167284713635,20.0,40.0
2427,0,2427,[367 215 218 209 321],308,3,9862,4.061779242174629,0.0,0.0
2428,0,2428,[303 316 272 211 276],90,5,9867,4.062165500205846,20.0,40.0
2429,0,2429,[303 316 272 211 276],13,5,9872,4.062551440329218,20.0,40.0
2430,0,2430,[303 316 272 211 276],13,5,9877,4.062937062937063,20.0,40.0
2431,0,2431,[303 316 272 211 276],13,5,9882,4.063322368421052,20.0,40.0
2432,0,2432,[303 316 272 211 276],13,5,9887,4.063707357172215,20.0,40.0
2433,0,2433,[255 222 227 429 508],334,2,9889,4.062859490550534,0.0,20.0
2434,0,2434,[303 316 272 211 276],90,5,9894,4.063244353182752,20.0,40.0
2435,0,2435,[303 316 272 211 276],90,5,9899,4.063628899835797,20.0,40.0
2436,0,2436,[303 316 272 211 276],90,5,9904,4.064013130898646,20.0,40.0
2437,0,2437,[303 316 272 211 276],13,5,9909,4.064397046759639,20.0,40.0
2438,0,2438,[303 316 272 211 276],90,5,9914,4.064780647806478,20.0,40.0
2439,0,2439,[509 272 507 209 208],537,5,9919,4.06516393442623,0.0,0.0
2440,0,2440,[303 316 272 211 276],13,5,9924,4.065546907005325,20.0,40.0
2441,0,2441,[303 316 272 211 276],13,5,9929,4.065929565929566,20.0,40.0
2442,0,2442,[315 429 211 222 209],13,3,9932,4.065493246009005,20.0,40.0
2443,0,2443,[303 316 272 211 276],13,5,9937,4.065875613747954,20.0,40.0
2444,0,2444,[303 316 272 211 276],13,5,9942,4.066257668711656,20.0,40.0
2445,0,2445,[218 231 211 240 326],64,1,9943,4.0650040883074405,0.0,20.0
2446,0,2446,[218 239 255 315 324],334,2,9945,4.064160196158562,20.0,0.0
2447,0,2447,[303 316 272 211 276],90,5,9950,4.064542483660131,20.0,40.0
2448,0,2448,[303 316 272 211 276],90,5,9955,4.064924458962842,20.0,40.0
2449,0,2449,[303 316 272 211 276],13,5,9960,4.0653061224489795,20.0,40.0
2450,0,2450,[303 316 272 211 276],13,5,9965,4.065687474500204,20.0,40.0
2451,0,2451,[303 316 272 211 276],90,5,9970,4.066068515497553,20.0,40.0
2452,0,2452,[215 220 216 429 240],59,3,9973,4.065633917651855,0.0,0.0
2453,0,2453,[303 316 272 211 276],13,5,9978,4.06601466992665,20.0,40.0
2454,0,2454,[303 316 272 211 276],13,5,9983,4.066395112016293,20.0,40.0
2455,0,2455,[303 316 272 211 276],13,5,9988,4.0667752442996745,20.0,40.0
2456,0,2456,[206 208 509 300 222],537,2,9990,4.065934065934066,0.0,40.0
2457,0,2457,[326 350 478 227 316],13,3,9993,4.0655004068348255,20.0,0.0
2458,0,2458,[303 316 272 211 276],13,5,9998,4.065880439202928,20.0,40.0
2459,0,2459,[367 295 246 293 243],387,1,9999,4.064634146341463,0.0,0.0
2460,0,2460,[303 316 272 211 276],13,5,10004,4.065014221861032,20.0,40.0
2461,0,2461,[303 316 272 211 276],13,5,10009,4.065393988627132,20.0,40.0
2462,0,2462,[303 316 272 211 276],90,5,10014,4.065773447015834,20.0,40.0
2463,0,2463,[303 316 272 211 276],13,5,10019,4.066152597402597,20.0,40.0
2464,0,2464,[259 208 384 485 231],7,2,10021,4.065314401622718,0.0,0.0
2465,0,2465,[276 321 297 326 222],743,3,10024,4.064882400648824,20.0,40.0
2466,0,2466,[384 431 218 231 202],64,2,10026,4.064045399270369,0.0,0.0
2467,0,2467,[240 431 284 211 452],406,2,10028,4.06320907617504,0.0,20.0
2468,0,2468,[303 316 272 211 276],90,5,10033,4.0635884973673555,20.0,40.0
2469,0,2469,[303 316 272 211 276],90,5,10038,4.063967611336032,20.0,40.0
2470,0,2470,[303 316 272 211 276],90,5,10043,4.064346418454067,20.0,40.0
2471,0,2471,[303 316 272 211 276],13,5,10048,4.064724919093851,20.0,40.0
2472,0,2472,[301 481 276 367 485],13,1,10049,4.0634856449656285,0.0,20.0
2473,0,2473,[303 316 272 211 276],13,5,10054,4.063864187550525,20.0,40.0
2474,0,2474,[275 219 211 284 298],308,4,10058,4.063838383838384,0.0,40.0
2475,0,2475,[303 316 272 211 276],13,5,10063,4.06421647819063,20.0,40.0
2476,0,2476,[303 316 272 211 276],90,5,10068,4.064594267258781,20.0,40.0
2477,0,2477,[303 316 272 211 276],13,5,10073,4.064971751412429,20.0,40.0
2478,0,2478,[212 236 216 231 378],537,0,10073,4.063331988705123,0.0,0.0
2479,0,2479,[218 481 232 222 300],13,0,10073,4.061693548387097,0.0,40.0
2480,0,2480,[303 316 272 211 276],13,5,10078,4.0620717452640065,20.0,40.0
2481,0,2481,[378 218 284 254 452],308,2,10080,4.061240934730057,0.0,0.0
2482,0,2482,[303 316 272 211 276],13,5,10085,4.061619009262988,20.0,40.0
2483,0,2483,[303 316 272 211 276],90,5,10090,4.061996779388084,20.0,40.0
2484,0,2484,[303 316 272 211 276],13,5,10095,4.062374245472837,20.0,40.0
2485,0,2485,[303 316 272 211 276],13,5,10100,4.062751407884151,20.0,40.0
2486,0,2486,[303 316 272 211 276],13,5,10105,4.06312826698834,20.0,40.0
2487,0,2487,[246 259 394 217 293],145,2,10107,4.062299035369775,0.0,0.0
2488,0,2488,[303 316 272 211 276],90,5,10112,4.062675773402973,20.0,40.0
2489,0,2489,[303 316 272 211 276],90,5,10117,4.063052208835342,20.0,40.0
2490,0,2490,[485 211 283 243 226],537,2,10119,4.062224006423123,0.0,20.0
2491,0,2491,[485 291 429 209 215],308,2,10121,4.061396468699839,0.0,0.0
2492,0,2492,[303 316 272 211 276],90,5,10126,4.06177296430004,20.0,40.0
2493,0,2493,[303 316 272 211 276],13,5,10131,4.0621491579791495,20.0,40.0
2494,0,2494,[303 316 272 211 276],13,5,10136,4.0625250501002,20.0,40.0
2495,0,2495,[321 300 276 213 211],409,3,10139,4.062099358974359,0.0,60.0
2496,0,2496,[303 316 272 211 276],90,5,10144,4.062474969963957,20.0,40.0
2497,0,2497,[303 316 272 211 276],90,5,10149,4.062850280224179,20.0,40.0
2498,0,2498,[431 222 276 509 212],194,1,10150,4.061624649859944,0.0,40.0
2499,0,2499,[275 485 236 326 222],334,3,10153,4.0612,0.0,40.0
2500,0,2500,[232 222 209 300 217],13,0,10153,4.059576169532187,0.0,40.0
2501,0,2501,[231 213 283 202 284],308,3,10156,4.059152677857714,0.0,0.0
2502,0,2502,[303 316 272 211 276],13,5,10161,4.059528565721135,20.0,40.0
2503,0,2503,[303 316 272 211 276],90,5,10166,4.0599041533546325,20.0,40.0
2504,0,2504,[303 316 272 211 276],90,5,10171,4.060279441117764,20.0,40.0
2505,0,2505,[232 211 431 226 241],13,2,10173,4.059457302474062,0.0,20.0
2506,0,2506,[303 316 272 211 276],13,5,10178,4.059832469086557,20.0,40.0
2507,0,2507,[303 316 272 211 276],90,5,10183,4.060207336523126,20.0,40.0
2508,0,2508,[303 316 272 211 276],13,5,10188,4.060581905141491,20.0,40.0
2509,0,2509,[290 231 216 240 429],279,3,10191,4.0601593625498005,0.0,0.0
2510,0,2510,[303 316 272 211 276],90,5,10196,4.060533651931501,20.0,40.0
2511,0,2511,[222 216 280 509 321],378,2,10198,4.0597133757961785,0.0,20.0
2512,0,2512,[378 344 303 509 485],381,3,10201,4.059291683247115,0.0,0.0
2513,0,2513,[303 316 272 211 276],90,5,10206,4.059665871121719,20.0,40.0
2514,0,2514,[303 316 272 211 276],90,5,10211,4.060039761431412,20.0,40.0
2515,0,2515,[226 212 241 221 508],537,1,10212,4.0588235294117645,0.0,0.0
2516,0,2516,[303 316 272 211 276],13,5,10217,4.059197457290425,20.0,40.0
2517,0,2517,[303 316 272 211 276],90,5,10222,4.05957108816521,20.0,40.0
2518,0,2518,[303 316 272 211 276],13,5,10227,4.0599444223898375,20.0,40.0
2519,0,2519,[202 299 293 276 316],145,4,10231,4.059920634920635,20.0,20.0
2520,0,2520,[303 316 272 211 276],90,5,10236,4.060293534311781,20.0,40.0
2521,0,2521,[303 316 272 211 276],13,5,10241,4.060666137985725,20.0,40.0
2522,0,2522,[303 316 272 211 276],90,5,10246,4.061038446294094,20.0,40.0
2523,0,2523,[298 255 218 508 295],378,2,10248,4.060221870047544,0.0,0.0
2524,0,2524,[303 316 272 211 276],90,5,10253,4.060594059405941,20.0,40.0
2525,0,2525,[303 316 272 211 276],90,5,10258,4.060965954077593,20.0,40.0
2526,0,2526,[303 316 272 211 276],90,5,10263,4.061337554412346,20.0,40.0
2527,0,2527,[303 316 272 211 276],90,5,10268,4.061708860759493,20.0,40.0
2528,0,2528,[303 316 272 211 276],90,5,10273,4.062079873467773,20.0,40.0
2529,0,2529,[303 316 272 211 276],90,5,10278,4.062450592885376,20.0,40.0
2530,0,2530,[303 316 272 211 276],13,5,10283,4.062821019359937,20.0,40.0
2531,0,2531,[255 509 298 226 216],378,3,10286,4.062401263823065,0.0,0.0
2532,0,2532,[303 316 272 211 276],13,5,10291,4.062771417291749,20.0,40.0
2533,0,2533,[303 316 272 211 276],13,5,10296,4.063141278610892,20.0,40.0
2534,0,2534,[303 316 272 211 276],13,5,10301,4.063510848126232,20.0,40.0
2535,0,2535,[303 316 272 211 276],13,5,10306,4.063880126182966,20.0,40.0
2536,0,2536,[303 316 272 211 276],90,5,10311,4.064249113125739,20.0,40.0
2537,0,2537,[303 316 272 211 276],13,5,10316,4.06461780929866,20.0,40.0
2538,0,2538,[303 316 272 211 276],13,5,10321,4.064986215045294,20.0,40.0
2539,0,2539,[303 316 272 211 276],13,5,10326,4.0653543307086615,20.0,40.0
2540,0,2540,[303 316 272 211 276],90,5,10331,4.065722156631248,20.0,40.0
2541,0,2541,[303 316 272 211 276],13,5,10336,4.066089693154996,20.0,40.0
2542,0,2542,[303 316 272 211 276],13,5,10341,4.066456940621314,20.0,40.0
2543,0,2543,[321 478 283 231 241],537,2,10343,4.06564465408805,0.0,0.0
2544,0,2544,[303 316 272 211 276],13,5,10348,4.066011787819254,20.0,40.0
2545,0,2545,[303 316 272 211 276],13,5,10353,4.066378633150039,20.0,40.0
2546,0,2546,[208 276 209 324 508],334,3,10356,4.0659599528857475,0.0,20.0
2547,0,2547,[303 316 272 211 276],13,5,10361,4.066326530612245,20.0,40.0
2548,0,2548,[303 316 272 211 276],90,5,10366,4.066692820714006,20.0,40.0
2549,0,2549,[303 316 272 211 276],13,5,10371,4.067058823529412,20.0,40.0
2550,0,2550,[303 316 272 211 276],13,5,10376,4.067424539396315,20.0,40.0
2551,0,2551,[290 315 316 394 303],13,4,10380,4.067398119122257,40.0,0.0
2552,0,2552,[303 316 272 211 276],90,5,10385,4.067763415589503,20.0,40.0
2553,0,2553,[303 316 272 211 276],13,5,10390,4.068128425998434,20.0,40.0
2554,0,2554,[478 219 239 212 232],650,1,10391,4.066927592954991,0.0,0.0
2555,0,2555,[394 226 481 303 218],13,2,10393,4.066118935837245,0.0,0.0
2556,0,2556,[431 485 275 216 215],843,0,10393,4.064528744622605,0.0,20.0
2557,0,2557,[303 316 272 211 276],90,5,10398,4.064894448788116,20.0,40.0
2558,0,2558,[303 316 272 211 276],13,5,10403,4.0652598671356,20.0,40.0
2559,0,2559,[243 213 299 209 507],537,3,10406,4.06484375,0.0,0.0
2560,0,2560,[303 316 272 211 276],13,5,10411,4.065208902772355,20.0,40.0
2561,0,2561,[202 218 216 230 240],59,4,10415,4.065183450429352,0.0,0.0
2562,0,2562,[303 316 272 211 276],13,5,10420,4.06554818571986,20.0,40.0
2563,0,2563,[303 316 272 211 276],90,5,10425,4.06591263650546,20.0,40.0
2564,0,2564,[303 316 272 211 276],13,5,10430,4.0662768031189085,20.0,40.0
2565,0,2565,[303 316 272 211 276],13,5,10435,4.066640685892439,20.0,40.0
2566,0,2566,[272 208 299 321 202],13,3,10438,4.066225165562914,0.0,0.0
2567,0,2567,[303 316 272 211 276],13,5,10443,4.066588785046729,20.0,40.0
2568,0,2568,[303 316 272 211 276],13,5,10448,4.066952121448034,20.0,40.0
2569,0,2569,[303 316 272 211 276],90,5,10453,4.067315175097276,20.0,40.0
2570,0,2570,[303 316 272 211 276],13,5,10458,4.0676779463243875,20.0,40.0
2571,0,2571,[303 316 272 211 276],90,5,10463,4.068040435458787,20.0,40.0
2572,0,2572,[246 429 241 232 218],387,0,10463,4.06645938593082,0.0,0.0
2573,0,2573,[303 316 272 211 276],13,5,10468,4.066822066822067,20.0,40.0
2574,0,2574,[303 316 272 211 276],90,5,10473,4.067184466019418,20.0,40.0
2575,0,2575,[303 316 272 211 276],13,5,10478,4.067546583850931,20.0,40.0
2576,0,2576,[212 223 336 431 215],13,3,10481,4.0671323244082265,20.0,0.0
2577,0,2577,[303 316 272 211 276],90,5,10486,4.067494181536074,20.0,40.0
2578,0,2578,[303 316 272 211 276],13,5,10491,4.067855758045754,20.0,40.0
2579,0,2579,[216 219 208 202 230],379,4,10495,4.067829457364341,0.0,0.0
2580,0,2580,[303 316 272 211 276],90,5,10500,4.068190623789229,20.0,40.0
2581,0,2581,[303 316 272 211 276],13,5,10505,4.06855151045701,20.0,40.0
2582,0,2582,[303 316 272 211 276],13,5,10510,4.068912117692605,20.0,40.0
2583,0,2583,[259 509 254 223 507],308,2,10512,4.068111455108359,20.0,0.0
2584,0,2584,[275 232 201 208 367],13,1,10513,4.0669245647969055,0.0,20.0
2585,0,2585,[261 276 478 219 241],13,2,10515,4.066125290023201,0.0,20.0
2586,0,2586,[509 268 226 241 239],13,4,10519,4.066099729416313,0.0,0.0
2587,0,2587,[303 316 272 211 276],13,5,10524,4.06646058732612,20.0,40.0
2588,0,2588,[303 316 272 211 276],13,5,10529,4.066821166473542,20.0,40.0
2589,0,2589,[303 316 272 211 276],13,5,10534,4.0671814671814674,20.0,40.0
2590,0,2590,[303 316 272 211 276],90,5,10539,4.067541489772289,20.0,40.0
2591,0,2591,[303 316 272 211 276],13,5,10544,4.067901234567901,20.0,40.0
2592,0,2592,[222 230 284 217 201],92,1,10545,4.066718087157732,0.0,20.0
2593,0,2593,[293 223 208 209 213],334,3,10548,4.066306861989206,20.0,0.0
2594,0,2594,[303 316 272 211 276],90,5,10553,4.066666666666666,20.0,40.0
2595,0,2595,[303 316 272 211 276],13,5,10558,4.067026194144838,20.0,40.0
2596,0,2596,[303 316 272 211 276],90,5,10563,4.067385444743936,20.0,40.0
2597,0,2597,[303 316 272 211 276],90,5,10568,4.06774441878368,20.0,40.0
2598,0,2598,[303 316 272 211 276],90,5,10573,4.068103116583301,20.0,40.0
2599,0,2599,[303 316 272 211 276],13,5,10578,4.068461538461539,20.0,40.0
2600,0,2600,[303 316 272 211 276],90,5,10583,4.068819684736639,20.0,40.0
2601,0,2601,[303 316 272 211 276],13,5,10588,4.069177555726364,20.0,40.0
2602,0,2602,[303 316 272 211 276],90,5,10593,4.069535151747983,20.0,40.0
2603,0,2603,[303 316 272 211 276],90,5,10598,4.06989247311828,20.0,40.0
2604,0,2604,[303 316 272 211 276],13,5,10603,4.070249520153551,20.0,40.0
2605,0,2605,[226 367 201 240 431],59,4,10607,4.070222563315426,0.0,0.0
2606,0,2606,[303 316 272 211 276],13,5,10612,4.070579209819716,20.0,40.0
2607,0,2607,[303 316 272 211 276],13,5,10617,4.070935582822086,20.0,40.0
2608,0,2608,[303 316 272 211 276],13,5,10622,4.071291682637026,20.0,40.0
2609,0,2609,[303 316 272 211 276],90,5,10627,4.071647509578544,20.0,40.0
2610,0,2610,[230 241 485 300 272],479,2,10629,4.070854078896974,0.0,20.0
2611,0,2611,[303 316 272 211 276],13,5,10634,4.071209800918836,20.0,40.0
2612,0,2612,[303 316 272 211 276],90,5,10639,4.071565250669728,20.0,40.0
2613,0,2613,[303 316 272 211 276],13,5,10644,4.071920428462127,20.0,40.0
2614,0,2614,[303 316 272 211 276],90,5,10649,4.0722753346080305,20.0,40.0
2615,0,2615,[303 316 272 211 276],90,5,10654,4.07262996941896,20.0,40.0
2616,0,2616,[216 272 226 280 202],378,2,10656,4.071837982422621,0.0,0.0
2617,0,2617,[231 284 246 431 218],92,3,10659,4.071428571428571,0.0,0.0
2618,0,2618,[303 316 272 211 276],13,5,10664,4.071783123329515,20.0,40.0
2619,0,2619,[303 316 272 211 276],90,5,10669,4.072137404580153,20.0,40.0
2620,0,2620,[303 316 272 211 276],13,5,10674,4.072491415490271,20.0,40.0
2621,0,2621,[303 316 272 211 276],13,5,10679,4.072845156369183,20.0,40.0
2622,0,2622,[303 316 272 211 276],13,5,10684,4.073198627525734,20.0,40.0
2623,0,2623,[223 254 215 509 326],378,3,10687,4.072789634146342,20.0,0.0
2624,0,2624,[303 316 272 211 276],13,5,10692,4.073142857142857,20.0,40.0
2625,0,2625,[303 316 272 211 276],90,5,10697,4.073495811119574,20.0,40.0
2626,0,2626,[431 243 223 316 218],650,0,10697,4.071945184621241,40.0,0.0
2627,0,2627,[303 316 272 211 276],90,5,10702,4.072298325722984,20.0,40.0
2628,0,2628,[303 316 272 211 276],13,5,10707,4.072651198174211,20.0,40.0
2629,0,2629,[303 316 272 211 276],90,5,10712,4.073003802281368,20.0,40.0
2630,0,2630,[303 316 272 211 276],90,5,10717,4.073356138350437,20.0,40.0
2631,0,2631,[303 264 326 222 384],13,2,10719,4.072568389057751,0.0,20.0
2632,0,2632,[303 316 272 211 276],90,5,10724,4.072920622863654,20.0,40.0
2633,0,2633,[284 219 452 223 264],833,2,10726,4.07213363705391,20.0,0.0
2634,0,2634,[220 300 272 227 298],378,2,10728,4.07134724857685,0.0,20.0
2635,0,2635,[206 223 284 211 507],666,2,10730,4.070561456752656,20.0,20.0
2636,0,2636,[303 316 272 211 276],13,5,10735,4.0709139173303,20.0,40.0
2637,0,2637,[344 272 478 208 315],13,4,10739,4.0708870356330555,20.0,0.0
2638,0,2638,[303 316 272 211 276],13,5,10744,4.071239105721864,20.0,40.0
2639,0,2639,[303 316 272 211 276],13,5,10749,4.071590909090909,20.0,40.0
2640,0,2640,[272 316 331 244 280],894,4,10753,4.071563801590306,20.0,0.0
2641,0,2641,[202 239 507 299 429],537,1,10754,4.070401211203634,0.0,0.0
2642,0,2642,[213 280 222 217 300],378,2,10756,4.069617858494135,0.0,40.0
2643,0,2643,[232 218 239 509 264],13,3,10759,4.0692133131618755,0.0,0.0
2644,0,2644,[230 255 202 272 215],479,3,10762,4.068809073724007,0.0,0.0
2645,0,2645,[303 316 272 211 276],13,5,10767,4.069160997732427,20.0,40.0
2646,0,2646,[303 316 272 211 276],13,5,10772,4.069512655836796,20.0,40.0
2647,0,2647,[303 316 272 211 276],90,5,10777,4.069864048338369,20.0,40.0
2648,0,2648,[303 316 272 211 276],13,5,10782,4.070215175537939,20.0,40.0
2649,0,2649,[303 316 272 211 276],13,5,10787,4.0705660377358495,20.0,40.0
2650,0,2650,[509 230 268 284 283],537,3,10790,4.070162202942286,0.0,0.0
2651,0,2651,[303 316 272 211 276],90,5,10795,4.07051282051282,20.0,40.0
2652,0,2652,[303 316 272 211 276],90,5,10800,4.070863173765549,20.0,40.0
2653,0,2653,[303 316 272 211 276],90,5,10805,4.071213262999247,20.0,40.0
2654,0,2654,[303 316 272 211 276],90,5,10810,4.071563088512241,20.0,40.0
2655,0,2655,[303 316 272 211 276],13,5,10815,4.0719126506024095,20.0,40.0
2656,0,2656,[303 316 272 211 276],90,5,10820,4.0722619495671815,20.0,40.0
2657,0,2657,[303 316 272 211 276],13,5,10825,4.072610985703537,20.0,40.0
2658,0,2658,[303 316 272 211 276],13,5,10830,4.07295975930801,20.0,40.0
2659,0,2659,[365 481 216 209 283],308,2,10832,4.07218045112782,0.0,0.0
2660,0,2660,[239 255 303 230 213],334,3,10835,4.071777527245397,0.0,0.0
2661,0,2661,[227 315 272 208 217],13,4,10839,4.071750563486101,20.0,0.0
2662,0,2662,[218 206 226 431 217],387,1,10840,4.070597070972587,0.0,0.0
2663,0,2663,[303 316 272 211 276],13,5,10845,4.070945945945946,20.0,40.0
2664,0,2664,[303 316 272 211 276],90,5,10850,4.071294559099437,20.0,40.0
2665,0,2665,[303 316 272 211 276],90,5,10855,4.071642910727682,20.0,40.0
2666,0,2666,[303 316 272 211 276],13,5,10860,4.071991001124859,20.0,40.0
2667,0,2667,[303 316 272 211 276],90,5,10865,4.072338830584708,20.0,40.0
2668,0,2668,[303 316 272 211 276],90,5,10870,4.072686399400524,20.0,40.0
2669,0,2669,[303 316 272 211 276],13,5,10875,4.073033707865169,20.0,40.0
2670,0,2670,[303 316 272 211 276],90,5,10880,4.073380756271059,20.0,40.0
2671,0,2671,[303 316 272 211 276],90,5,10885,4.07372754491018,20.0,40.0
2672,0,2672,[303 316 272 211 276],13,5,10890,4.074074074074074,20.0,40.0
2673,0,2673,[303 316 272 211 276],13,5,10895,4.074420344053852,20.0,40.0
2674,0,2674,[303 316 272 211 276],13,5,10900,4.074766355140187,20.0,40.0
2675,0,2675,[231 239 290 254 230],804,5,10905,4.075112107623318,0.0,0.0
2676,0,2676,[303 316 272 211 276],13,5,10910,4.075457601793052,20.0,40.0
2677,0,2677,[303 316 272 211 276],90,5,10915,4.0758028379387605,20.0,40.0
2678,0,2678,[303 316 272 211 276],13,5,10920,4.076147816349384,20.0,40.0
2679,0,2679,[303 316 272 211 276],13,5,10925,4.076492537313433,20.0,40.0
2680,0,2680,[303 316 272 211 276],13,5,10930,4.076837001118985,20.0,40.0
2681,0,2681,[299 276 290 243 209],13,2,10932,4.076062639821029,0.0,20.0
2682,0,2682,[303 316 272 211 276],13,5,10937,4.076407007081625,20.0,40.0
2683,0,2683,[303 316 272 211 276],90,5,10942,4.076751117734724,20.0,40.0
2684,0,2684,[303 316 272 211 276],13,5,10947,4.077094972067039,20.0,40.0
2685,0,2685,[303 316 272 211 276],90,5,10952,4.077438570364855,20.0,40.0
2686,0,2686,[316 303 331 290 300],13,3,10955,4.077037588388538,20.0,20.0
2687,0,2687,[303 316 272 211 276],90,5,10960,4.0773809523809526,20.0,40.0
2688,0,2688,[303 316 272 211 276],90,5,10965,4.077724060989215,20.0,40.0
2689,0,2689,[303 316 272 211 276],13,5,10970,4.078066914498141,20.0,40.0
2690,0,2690,[384 264 431 280 216],13,2,10972,4.0772946859903385,0.0,0.0
2691,0,2691,[303 316 272 211 276],90,5,10977,4.077637444279346,20.0,40.0
2692,0,2692,[290 272 336 413 232],13,2,10979,4.076865948756034,0.0,0.0
2693,0,2693,[303 316 272 211 276],13,5,10984,4.07720861172977,20.0,40.0
2694,0,2694,[223 300 211 268 284],234,0,10984,4.07569573283859,20.0,40.0
2695,0,2695,[303 316 272 211 276],90,5,10989,4.076038575667655,20.0,40.0
2696,0,2696,[303 316 272 211 276],13,5,10994,4.076381164256581,20.0,40.0
2697,0,2697,[213 215 208 259 221],234,1,10995,4.075240919199407,0.0,0.0
2698,0,2698,[222 429 301 268 300],234,1,10996,4.074101519081141,0.0,40.0
2699,0,2699,[303 316 272 211 276],13,5,11001,4.0744444444444445,20.0,40.0
2700,0,2700,[202 222 230 280 218],13,2,11003,4.0736764161421695,0.0,20.0
2701,0,2701,[303 316 272 211 276],13,5,11008,4.074019245003701,20.0,40.0
2702,0,2702,[303 316 272 211 276],90,5,11013,4.074361820199778,20.0,40.0
2703,0,2703,[303 316 272 211 276],90,5,11018,4.074704142011834,20.0,40.0
2704,0,2704,[303 316 272 211 276],13,5,11023,4.075046210720887,20.0,40.0
2705,0,2705,[244 293 216 217 255],334,0,11023,4.073540280857354,0.0,0.0
2706,0,2706,[303 316 272 211 276],90,5,11028,4.073882526782416,20.0,40.0
2707,0,2707,[303 316 272 211 276],90,5,11033,4.074224519940916,20.0,40.0
2708,0,2708,[209 365 239 231 259],804,4,11037,4.074197120708749,0.0,0.0
2709,0,2709,[243 216 202 367 272],13,2,11039,4.073431734317343,0.0,0.0
2710,0,2710,[485 284 315 291 211],537,2,11041,4.072666912578384,20.0,20.0
2711,0,2711,[303 316 272 211 276],90,5,11046,4.073008849557522,20.0,40.0
2712,0,2712,[303 316 272 211 276],13,5,11051,4.073350534463693,20.0,40.0
2713,0,2713,[303 316 272 211 276],13,5,11056,4.0736919675755345,20.0,40.0
2714,0,2714,[303 316 272 211 276],13,5,11061,4.074033149171271,20.0,40.0
2715,0,2715,[303 316 272 211 276],90,5,11066,4.074374079528718,20.0,40.0
2716,0,2716,[303 316 272 211 276],13,5,11071,4.0747147589252855,20.0,40.0
2717,0,2717,[392 213 431 241 326],311,3,11074,4.074319352465047,0.0,0.0
2718,0,2718,[239 215 208 283 241],537,2,11076,4.073556454578889,0.0,0.0
2719,0,2719,[226 431 392 201 291],537,1,11077,4.072426470588235,0.0,0.0
2720,0,2720,[303 316 272 211 276],90,5,11082,4.07276736493936,20.0,40.0
2721,0,2721,[303 316 272 211 276],90,5,11087,4.073108008817046,20.0,40.0
2722,0,2722,[284 201 215 283 218],308,3,11090,4.072713918472274,0.0,0.0
2723,0,2723,[241 481 326 394 272],13,1,11091,4.0715859030837,0.0,0.0
2724,0,2724,[303 316 272 211 276],13,5,11096,4.071926605504587,20.0,40.0
2725,0,2725,[303 316 272 211 276],13,5,11101,4.0722670579603815,20.0,40.0
2726,0,2726,[303 290 507 272 344],13,3,11104,4.071873854052072,0.0,0.0
2727,0,2727,[303 316 272 211 276],13,5,11109,4.072214076246334,20.0,40.0
2728,0,2728,[236 243 431 509 231],537,2,11111,4.071454745327959,0.0,0.0
2729,0,2729,[303 316 272 211 276],13,5,11116,4.0717948717948715,20.0,40.0
2730,0,2730,[303 316 272 211 276],13,5,11121,4.072134749176126,20.0,40.0
2731,0,2731,[303 316 272 211 276],90,5,11126,4.072474377745242,20.0,40.0
2732,0,2732,[303 316 272 211 276],13,5,11131,4.0728137577753385,20.0,40.0
2733,0,2733,[211 378 509 208 213],537,4,11135,4.072787125091441,0.0,20.0
2734,0,2734,[241 231 217 239 268],387,0,11135,4.071297989031079,0.0,0.0
2735,0,2735,[303 316 272 211 276],13,5,11140,4.071637426900585,20.0,40.0
2736,0,2736,[303 316 272 211 276],90,5,11145,4.07197661673365,20.0,40.0
2737,0,2737,[303 316 272 211 276],90,5,11150,4.072315558802045,20.0,40.0
2738,0,2738,[324 216 226 295 261],506,3,11153,4.071924059875867,0.0,0.0
2739,0,2739,[291 508 275 246 301],85,2,11155,4.071167883211679,0.0,20.0
2740,0,2740,[316 272 218 507 420],13,3,11158,4.070777088653776,20.0,0.0
2741,0,2741,[211 509 315 215 222],13,4,11162,4.0707512764405545,20.0,40.0
2742,0,2742,[303 316 272 211 276],90,5,11167,4.071090047393365,20.0,40.0
2743,0,2743,[213 222 232 485 276],311,3,11170,4.070699708454811,0.0,40.0
2744,0,2744,[303 316 272 211 276],13,5,11175,4.0710382513661205,20.0,40.0
2745,0,2745,[303 316 272 211 276],90,5,11180,4.0713765477057535,20.0,40.0
2746,0,2746,[303 316 272 211 276],90,5,11185,4.071714597742992,20.0,40.0
2747,0,2747,[303 316 272 211 276],90,5,11190,4.072052401746725,20.0,40.0
2748,0,2748,[303 316 272 211 276],13,5,11195,4.07238995998545,20.0,40.0
2749,0,2749,[303 316 272 211 276],13,5,11200,4.072727272727272,20.0,40.0
2750,0,2750,[321 227 259 213 208],194,0,11200,4.071246819338422,0.0,0.0
2751,0,2751,[303 316 272 211 276],13,5,11205,4.071584302325581,20.0,40.0
2752,0,2752,[303 316 272 211 276],13,5,11210,4.071921540138031,20.0,40.0
2753,0,2753,[215 211 243 378 276],533,3,11213,4.071532316630356,0.0,40.0
2754,0,2754,[303 316 272 211 276],13,5,11218,4.071869328493648,20.0,40.0
2755,0,2755,[303 316 272 211 276],90,5,11223,4.072206095791001,20.0,40.0
2756,0,2756,[378 208 275 218 209],308,4,11227,4.072179905694596,0.0,20.0
2757,0,2757,[303 316 272 211 276],90,5,11232,4.072516316171138,20.0,40.0
2758,0,2758,[303 316 272 211 276],13,5,11237,4.072852482783618,20.0,40.0
2759,0,2759,[303 316 272 211 276],13,5,11242,4.073188405797102,20.0,40.0
2760,0,2760,[303 316 272 211 276],13,5,11247,4.073524085476277,20.0,40.0
2761,0,2761,[303 316 272 211 276],90,5,11252,4.073859522085446,20.0,40.0
2762,0,2762,[303 316 272 211 276],13,5,11257,4.0741947158885266,20.0,40.0
2763,0,2763,[303 316 272 211 276],90,5,11262,4.07452966714906,20.0,40.0
2764,0,2764,[206 392 478 431 300],537,2,11264,4.0737793851717905,0.0,20.0
2765,0,2765,[303 316 272 211 276],13,5,11269,4.07411424439624,20.0,40.0
2766,0,2766,[303 316 272 211 276],13,5,11274,4.074448861582942,20.0,40.0
2767,0,2767,[303 316 272 211 276],13,5,11279,4.07478323699422,20.0,40.0
2768,0,2768,[303 316 272 211 276],90,5,11284,4.075117370892019,20.0,40.0
2769,0,2769,[221 283 213 215 275],474,3,11287,4.0747292418772565,0.0,20.0
2770,0,2770,[303 316 272 211 276],90,5,11292,4.075063154095994,20.0,40.0
2771,0,2771,[350 219 326 212 508],13,1,11293,4.073953823953824,0.0,0.0
2772,0,2772,[303 316 272 211 276],13,5,11298,4.074287774972953,20.0,40.0
2773,0,2773,[303 316 272 211 276],13,5,11303,4.074621485219899,20.0,40.0
2774,0,2774,[303 316 272 211 276],90,5,11308,4.074954954954955,20.0,40.0
2775,0,2775,[303 316 272 211 276],13,5,11313,4.07528818443804,20.0,40.0
2776,0,2776,[303 316 272 211 276],90,5,11318,4.0756211739287,20.0,40.0
2777,0,2777,[219 431 243 276 220],59,3,11321,4.075233981281498,0.0,20.0
2778,0,2778,[219 275 209 215 211],843,0,11321,4.073767542281396,0.0,40.0
2779,0,2779,[303 316 272 211 276],13,5,11326,4.07410071942446,20.0,40.0
2780,0,2780,[303 316 272 211 276],13,5,11331,4.074433656957929,20.0,40.0
2781,0,2781,[303 316 272 211 276],13,5,11336,4.074766355140187,20.0,40.0
2782,0,2782,[303 316 272 211 276],13,5,11341,4.075098814229249,20.0,40.0
2783,0,2783,[303 316 272 211 276],90,5,11346,4.075431034482759,20.0,40.0
2784,0,2784,[303 316 272 211 276],13,5,11351,4.075763016157989,20.0,40.0
2785,0,2785,[303 316 272 211 276],13,5,11356,4.076094759511845,20.0,40.0
2786,0,2786,[303 316 272 211 276],90,5,11361,4.076426264800861,20.0,40.0
2787,0,2787,[303 316 272 211 276],90,5,11366,4.0767575322812055,20.0,40.0
2788,0,2788,[303 316 272 211 276],90,5,11371,4.077088562208677,20.0,40.0
2789,0,2789,[227 290 485 301 420],650,0,11371,4.075627240143369,0.0,0.0
2790,0,2790,[303 316 272 211 276],90,5,11376,4.075958437835901,20.0,40.0
2791,0,2791,[303 316 272 211 276],13,5,11381,4.076289398280802,20.0,40.0
2792,0,2792,[303 316 272 211 276],90,5,11386,4.076620121732904,20.0,40.0
2793,0,2793,[303 316 272 211 276],13,5,11391,4.076950608446672,20.0,40.0
2794,0,2794,[303 316 272 211 276],90,5,11396,4.0772808586762075,20.0,40.0
2795,0,2795,[303 316 272 211 276],90,5,11401,4.07761087267525,20.0,40.0
2796,0,2796,[303 316 272 211 276],13,5,11406,4.077940650697175,20.0,40.0
2797,0,2797,[303 316 272 211 276],90,5,11411,4.078270192994997,20.0,40.0
2798,0,2798,[315 321 216 509 226],537,2,11413,4.077527688460164,20.0,0.0
2799,0,2799,[303 316 272 211 276],13,5,11418,4.077857142857143,20.0,40.0
2800,0,2800,[226 485 299 259 378],537,0,11418,4.076401285255266,0.0,0.0
2801,0,2801,[303 316 272 211 276],13,5,11423,4.07673090649536,20.0,40.0
2802,0,2802,[303 290 239 485 508],334,1,11424,4.07563325008919,0.0,0.0
2803,0,2803,[230 213 211 298 321],308,4,11428,4.075606276747504,0.0,20.0
2804,0,2804,[222 240 254 231 212],804,4,11432,4.075579322638146,0.0,20.0
2805,0,2805,[303 316 272 211 276],90,5,11437,4.075908766928011,20.0,40.0
2806,0,2806,[293 236 215 367 221],385,2,11439,4.0751692198076235,0.0,0.0
2807,0,2807,[303 316 272 211 276],13,5,11444,4.0754985754985755,20.0,40.0
2808,0,2808,[303 316 272 211 276],13,5,11449,4.075827696689213,20.0,40.0
2809,0,2809,[303 316 272 211 276],90,5,11454,4.076156583629893,20.0,40.0
2810,0,2810,[303 316 272 211 276],13,5,11459,4.0764852365706155,20.0,40.0
2811,0,2811,[303 316 272 211 276],13,5,11464,4.076813655761025,20.0,40.0
2812,0,2812,[303 316 272 211 276],90,5,11469,4.077141841450409,20.0,40.0
2813,0,2813,[303 316 272 211 276],90,5,11474,4.077469793887705,20.0,40.0
2814,0,2814,[295 508 280 344 298],894,1,11475,4.076376554174067,0.0,0.0
2815,0,2815,[303 316 272 211 276],90,5,11480,4.076704545454546,20.0,40.0
2816,0,2816,[303 316 272 211 276],90,5,11485,4.077032303869364,20.0,40.0
2817,0,2817,[507 420 215 272 508],60,5,11490,4.07735982966643,0.0,0.0
2818,0,2818,[303 316 272 211 276],90,5,11495,4.077687123093296,20.0,40.0
2819,0,2819,[303 316 272 211 276],13,5,11500,4.078014184397163,20.0,40.0
2820,0,2820,[303 316 272 211 276],13,5,11505,4.078341013824885,20.0,40.0
2821,0,2821,[303 316 272 211 276],90,5,11510,4.078667611622962,20.0,40.0
2822,0,2822,[303 316 272 211 276],13,5,11515,4.078993978037548,20.0,40.0
2823,0,2823,[303 316 272 211 276],13,5,11520,4.079320113314448,20.0,40.0
2824,0,2824,[303 316 272 211 276],90,5,11525,4.079646017699115,20.0,40.0
2825,0,2825,[303 316 272 211 276],13,5,11530,4.0799716914366595,20.0,40.0
2826,0,2826,[303 316 272 211 276],13,5,11535,4.080297134771843,20.0,40.0
2827,0,2827,[485 276 231 315 259],537,2,11537,4.07956152758133,20.0,20.0
2828,0,2828,[303 316 272 211 276],90,5,11542,4.07988688582538,20.0,40.0
2829,0,2829,[303 316 272 211 276],90,5,11547,4.0802120141342755,20.0,40.0
2830,0,2830,[291 301 215 478 508],85,3,11550,4.079830448604733,0.0,0.0
2831,0,2831,[303 316 272 211 276],90,5,11555,4.080155367231638,20.0,40.0
2832,0,2832,[303 316 272 211 276],13,5,11560,4.080480056477232,20.0,40.0
2833,0,2833,[300 413 384 303 507],13,1,11561,4.07939308398024,0.0,20.0
2834,0,2834,[303 316 272 211 276],13,5,11566,4.079717813051146,20.0,40.0
2835,0,2835,[303 316 272 211 276],90,5,11571,4.080042313117066,20.0,40.0
2836,0,2836,[429 507 202 283 226],308,2,11573,4.079309129362002,0.0,0.0
2837,0,2837,[303 316 272 211 276],90,5,11578,4.079633544749824,20.0,40.0
2838,0,2838,[264 384 227 481 326],13,2,11580,4.0789010214864385,0.0,0.0
2839,0,2839,[303 316 272 211 276],13,5,11585,4.079225352112676,20.0,40.0
2840,0,2840,[293 223 215 485 295],308,2,11587,4.078493488208378,20.0,0.0
2841,0,2841,[243 367 478 232 300],13,1,11588,4.07741027445461,0.0,20.0
2842,0,2842,[272 221 478 420 481],85,4,11592,4.077383046078086,0.0,0.0
2843,0,2843,[303 316 272 211 276],13,5,11597,4.077707454289733,20.0,40.0
2844,0,2844,[303 316 272 211 276],90,5,11602,4.078031634446397,20.0,40.0
2845,0,2845,[202 365 217 429 215],774,1,11603,4.076950105411103,0.0,0.0
2846,0,2846,[303 316 272 211 276],13,5,11608,4.077274323849666,20.0,40.0
2847,0,2847,[250 429 295 216 254],749,2,11610,4.076544943820225,0.0,0.0
2848,0,2848,[303 316 272 211 276],13,5,11615,4.076869076869077,20.0,40.0
2849,0,2849,[303 316 272 211 276],13,5,11620,4.077192982456141,20.0,40.0
2850,0,2850,[244 222 290 255 326],334,1,11621,4.0761136443353205,0.0,20.0
2851,0,2851,[303 316 272 211 276],90,5,11626,4.076437587657784,20.0,40.0
2852,0,2852,[303 316 272 211 276],90,5,11631,4.076761303890642,20.0,40.0
2853,0,2853,[259 507 209 241 478],234,2,11633,4.076033637000701,0.0,0.0
2854,0,2854,[202 507 226 215 259],7,3,11636,4.075656742556918,0.0,0.0
2855,0,2855,[507 231 217 508 208],13,1,11637,4.074579831932773,0.0,0.0
2856,0,2856,[303 316 272 211 276],13,5,11642,4.074903745187259,20.0,40.0
2857,0,2857,[303 316 272 211 276],13,5,11647,4.075227431770469,20.0,40.0
2858,0,2858,[216 301 241 280 231],13,1,11648,4.074151801329136,0.0,0.0
2859,0,2859,[303 316 272 211 276],13,5,11653,4.074475524475525,20.0,40.0
2860,0,2860,[222 213 227 298 218],378,1,11654,4.073400908773157,0.0,20.0
2861,0,2861,[303 316 272 211 276],13,5,11659,4.0737246680642905,20.0,40.0
2862,0,2862,[303 316 272 211 276],13,5,11664,4.074048201187566,20.0,40.0
2863,0,2863,[303 316 272 211 276],13,5,11669,4.074371508379889,20.0,40.0
2864,0,2864,[303 316 272 211 276],13,5,11674,4.074694589877836,20.0,40.0
2865,0,2865,[303 316 272 211 276],13,5,11679,4.075017445917656,20.0,40.0
2866,0,2866,[303 316 272 211 276],13,5,11684,4.075340076735263,20.0,40.0
2867,0,2867,[303 316 272 211 276],90,5,11689,4.075662482566249,20.0,40.0
2868,0,2868,[231 508 452 507 344],13,0,11689,4.074241896131056,0.0,0.0
2869,0,2869,[392 226 230 295 211],308,3,11692,4.0738675958188155,0.0,20.0
2870,0,2870,[303 316 272 211 276],90,5,11697,4.074190177638454,20.0,40.0
2871,0,2871,[218 280 272 384 239],13,3,11700,4.073816155988858,0.0,0.0
2872,0,2872,[303 316 272 211 276],13,5,11705,4.074138531152106,20.0,40.0
2873,0,2873,[303 316 272 211 276],90,5,11710,4.07446068197634,20.0,40.0
2874,0,2874,[303 316 272 211 276],13,5,11715,4.074782608695652,20.0,40.0
2875,0,2875,[241 226 429 212 315],13,4,11719,4.0747566063977745,20.0,0.0
2876,0,2876,[303 316 272 211 276],13,5,11724,4.075078206465068,20.0,40.0
2877,0,2877,[303 316 272 211 276],13,5,11729,4.07539958304378,20.0,40.0
2878,0,2878,[303 316 272 211 276],13,5,11734,4.075720736366794,20.0,40.0
2879,0,2879,[241 350 315 275 344],328,4,11738,4.075694444444444,20.0,20.0
2880,0,2880,[303 316 272 211 276],90,5,11743,4.0760152724748355,20.0,40.0
2881,0,2881,[240 211 291 239 259],804,5,11748,4.076335877862595,0.0,20.0
2882,0,2882,[303 316 272 211 276],90,5,11753,4.076656260839403,20.0,40.0
2883,0,2883,[303 316 272 211 276],13,5,11758,4.0769764216366156,20.0,40.0
2884,0,2884,[284 431 227 241 216],59,3,11761,4.076603119584055,0.0,0.0
2885,0,2885,[303 316 272 211 276],90,5,11766,4.076923076923077,20.0,40.0
2886,0,2886,[244 246 316 272 509],894,5,11771,4.077242812608244,20.0,0.0
2887,0,2887,[303 316 272 211 276],13,5,11776,4.077562326869806,20.0,40.0
2888,0,2888,[201 202 301 215 284],537,0,11776,4.076150917272413,0.0,0.0
2889,0,2889,[216 429 367 231 211],738,0,11776,4.074740484429066,0.0,20.0
2890,0,2890,[478 219 350 299 275],13,1,11777,4.073676928398478,0.0,20.0
2891,0,2891,[303 316 272 211 276],13,5,11782,4.073997233748271,20.0,40.0
2892,0,2892,[303 316 272 211 276],13,5,11787,4.074317317663326,20.0,40.0
2893,0,2893,[206 221 219 223 213],234,1,11788,4.0732550103662755,20.0,0.0
2894,0,2894,[303 316 272 211 276],13,5,11793,4.073575129533679,20.0,40.0
2895,0,2895,[303 316 272 211 276],13,5,11798,4.073895027624309,20.0,40.0
2896,0,2896,[209 431 215 217 284],64,4,11802,4.073869520193304,0.0,0.0
2897,0,2897,[509 284 215 481 230],194,0,11802,4.072463768115942,0.0,0.0
2898,0,2898,[303 316 272 211 276],13,5,11807,4.072783718523628,20.0,40.0
2899,0,2899,[303 316 272 211 276],13,5,11812,4.073103448275862,20.0,40.0
2900,0,2900,[246 350 244 255 223],894,3,11815,4.072733540158566,20.0,0.0
2901,0,2901,[303 316 272 211 276],90,5,11820,4.073053066850448,20.0,40.0
2902,0,2902,[315 232 509 429 272],650,2,11822,4.072338959696865,20.0,0.0
2903,0,2903,[303 316 272 211 276],13,5,11827,4.0726584022038566,20.0,40.0
2904,0,2904,[303 316 272 211 276],13,5,11832,4.072977624784854,20.0,40.0
2905,0,2905,[227 431 230 202 293],653,1,11833,4.071920165175499,0.0,0.0
2906,0,2906,[303 316 272 211 276],90,5,11838,4.072239422084623,20.0,40.0
2907,0,2907,[276 300 326 283 223],409,3,11841,4.071870701513068,20.0,40.0
2908,0,2908,[211 208 290 202 367],234,2,11843,4.071158473702303,0.0,20.0
2909,0,2909,[481 213 297 272 276],334,5,11848,4.07147766323024,20.0,20.0
2910,0,2910,[303 316 272 276 211],90,5,11853,4.071796633459292,20.0,40.0
2911,0,2911,[303 316 272 276 211],90,5,11858,4.072115384615385,20.0,40.0
2912,0,2912,[303 316 272 276 211],13,5,11863,4.072433916924133,20.0,40.0
2913,0,2913,[316 284 212 218 315],145,3,11866,4.072065888812629,40.0,0.0
2914,0,2914,[303 316 272 276 211],13,5,11871,4.0723842195540305,20.0,40.0
2915,0,2915,[250 219 246 394 218],145,3,11874,4.07201646090535,0.0,0.0
2916,0,2916,[303 316 272 276 211],13,5,11879,4.072334590332534,20.0,40.0
2917,0,2917,[303 316 272 276 211],13,5,11884,4.0726525017135025,20.0,40.0
2918,0,2918,[303 316 272 276 211],90,5,11889,4.072970195272354,20.0,40.0
2919,0,2919,[303 316 272 276 211],90,5,11894,4.073287671232877,20.0,40.0
2920,0,2920,[295 209 201 213 264],479,3,11897,4.072920232796987,0.0,0.0
2921,0,2921,[208 429 201 218 215],385,2,11899,4.072210814510609,0.0,0.0
2922,0,2922,[303 316 272 276 211],90,5,11904,4.072528224426959,20.0,40.0
2923,0,2923,[303 316 272 276 211],13,5,11909,4.072845417236662,20.0,40.0
2924,0,2924,[303 316 272 276 211],90,5,11914,4.073162393162393,20.0,40.0
2925,0,2925,[303 316 272 276 211],90,5,11919,4.073479152426521,20.0,40.0
2926,0,2926,[303 316 272 276 211],13,5,11924,4.0737956952511105,20.0,40.0
2927,0,2927,[303 316 272 276 211],90,5,11929,4.074112021857924,20.0,40.0
2928,0,2928,[303 316 272 276 211],13,5,11934,4.0744281324684195,20.0,40.0
2929,0,2929,[303 316 272 276 211],90,5,11939,4.074744027303754,20.0,40.0
2930,0,2930,[303 316 272 276 211],90,5,11944,4.075059706584783,20.0,40.0
2931,0,2931,[303 316 272 276 211],90,5,11949,4.07537517053206,20.0,40.0
2932,0,2932,[303 316 272 276 211],90,5,11954,4.075690419365837,20.0,40.0
2933,0,2933,[303 316 272 276 211],13,5,11959,4.076005453306067,20.0,40.0
2934,0,2934,[303 316 272 276 211],13,5,11964,4.076320272572402,20.0,40.0
2935,0,2935,[303 316 272 276 211],13,5,11969,4.076634877384196,20.0,40.0
2936,0,2936,[303 316 272 276 211],13,5,11974,4.0769492679605035,20.0,40.0
2937,0,2937,[222 367 226 208 206],738,2,11976,4.076242341729067,0.0,20.0
2938,0,2938,[201 303 219 226 230],13,2,11978,4.075535896563457,0.0,0.0
2939,0,2939,[303 316 272 276 211],13,5,11983,4.075850340136054,20.0,40.0
2940,0,2940,[303 316 272 276 211],90,5,11988,4.076164569874193,20.0,40.0
2941,0,2941,[303 316 272 276 211],13,5,11993,4.076478585995921,20.0,40.0
2942,0,2942,[212 367 218 300 478],90,4,11997,4.07645259938838,0.0,20.0
2943,0,2943,[303 316 272 276 211],13,5,12002,4.076766304347826,20.0,40.0
2944,0,2944,[209 211 378 280 290],234,2,12004,4.076061120543294,0.0,20.0
2945,0,2945,[303 316 272 276 211],90,5,12009,4.076374745417516,20.0,40.0
2946,0,2946,[303 316 272 276 211],90,5,12014,4.0766881574482525,20.0,40.0
2947,0,2947,[303 316 272 276 211],13,5,12019,4.0770013568521035,20.0,40.0
2948,0,2948,[303 316 272 276 211],13,5,12024,4.077314343845371,20.0,40.0
2949,0,2949,[420 219 485 218 239],308,2,12026,4.076610169491525,0.0,0.0
2950,0,2950,[303 316 272 276 211],90,5,12031,4.076923076923077,20.0,40.0
2951,0,2951,[303 316 272 276 211],13,5,12036,4.0772357723577235,20.0,40.0
2952,0,2952,[303 316 272 276 211],90,5,12041,4.077548256010837,20.0,40.0
2953,0,2953,[303 316 272 276 211],90,5,12046,4.077860528097495,20.0,40.0
2954,0,2954,[303 316 272 276 211],90,5,12051,4.078172588832487,20.0,40.0
2955,0,2955,[280 290 315 261 384],13,3,12054,4.077807848443843,20.0,0.0
2956,0,2956,[303 316 272 276 211],13,5,12059,4.078119715928306,20.0,40.0
2957,0,2957,[208 290 291 209 275],279,3,12062,4.077755240027045,0.0,20.0
2958,0,2958,[303 316 272 276 211],90,5,12067,4.078066914498141,20.0,40.0
2959,0,2959,[508 216 227 284 293],474,4,12071,4.078040540540541,0.0,0.0
2960,0,2960,[219 367 413 208 254],648,2,12073,4.077338736913205,0.0,0.0
2961,0,2961,[231 301 211 241 431],328,2,12075,4.076637407157326,0.0,20.0
2962,0,2962,[303 316 272 276 211],13,5,12080,4.076949038137023,20.0,40.0
2963,0,2963,[303 316 272 276 211],13,5,12085,4.077260458839406,20.0,40.0
2964,0,2964,[303 316 272 276 211],13,5,12090,4.077571669477234,20.0,40.0
2965,0,2965,[303 316 272 276 211],13,5,12095,4.07788267026298,20.0,40.0
2966,0,2966,[303 316 272 276 211],90,5,12100,4.078193461408831,20.0,40.0
2967,0,2967,[303 316 272 276 211],90,5,12105,4.078504043126685,20.0,40.0
2968,0,2968,[303 316 272 276 211],13,5,12110,4.078814415628158,20.0,40.0
2969,0,2969,[303 316 272 276 211],13,5,12115,4.079124579124579,20.0,40.0
2970,0,2970,[303 316 272 276 211],13,5,12120,4.079434533826994,20.0,40.0
2971,0,2971,[303 316 272 276 211],90,5,12125,4.079744279946164,20.0,40.0
2972,0,2972,[226 321 209 232 367],387,1,12126,4.0787083753784055,0.0,0.0
2973,0,2973,[303 316 272 276 211],90,5,12131,4.079018157363819,20.0,40.0
2974,0,2974,[303 316 272 276 211],13,5,12136,4.079327731092437,20.0,40.0
2975,0,2975,[303 316 272 276 211],13,5,12141,4.079637096774194,20.0,40.0
2976,0,2976,[303 316 272 276 211],90,5,12146,4.0799462546187435,20.0,40.0
2977,0,2977,[303 316 272 276 211],13,5,12151,4.08025520483546,20.0,40.0
2978,0,2978,[303 316 272 276 211],90,5,12156,4.080563947633434,20.0,40.0
2979,0,2979,[303 316 272 276 211],13,5,12161,4.080872483221476,20.0,40.0
2980,0,2980,[222 213 283 223 202],378,3,12164,4.080509896008051,20.0,20.0
2981,0,2981,[303 316 272 276 211],90,5,12169,4.080818242790074,20.0,40.0
2982,0,2982,[303 316 272 276 211],90,5,12174,4.081126382836071,20.0,40.0
2983,0,2983,[303 316 272 276 211],13,5,12179,4.081434316353888,20.0,40.0
2984,0,2984,[478 481 300 394 303],13,2,12181,4.08073701842546,0.0,20.0
2985,0,2985,[303 316 272 276 211],90,5,12186,4.081044876088413,20.0,40.0
2986,0,2986,[303 316 272 276 211],90,5,12191,4.081352527619686,20.0,40.0
2987,0,2987,[241 431 507 508 272],13,1,12192,4.080321285140562,0.0,0.0
2988,0,2988,[303 316 272 276 211],90,5,12197,4.0806289729006355,20.0,40.0
2989,0,2989,[303 316 272 276 211],90,5,12202,4.080936454849498,20.0,40.0
2990,0,2990,[303 316 272 276 211],90,5,12207,4.081243731193581,20.0,40.0
2991,0,2991,[303 316 272 276 211],13,5,12212,4.081550802139038,20.0,40.0
2992,0,2992,[344 481 431 384 452],13,0,12212,4.080187103240895,0.0,0.0
2993,0,2993,[303 316 272 276 211],90,5,12217,4.080494321977288,20.0,40.0
2994,0,2994,[303 316 272 276 211],90,5,12222,4.080801335559266,20.0,40.0
2995,0,2995,[272 226 301 223 222],328,2,12224,4.080106809078772,20.0,20.0
2996,0,2996,[303 316 272 276 211],13,5,12229,4.080413747080414,20.0,40.0
2997,0,2997,[303 316 272 276 211],90,5,12234,4.080720480320213,20.0,40.0
2998,0,2998,[303 316 272 276 211],90,5,12239,4.081027009003001,20.0,40.0
2999,0,2999,[303 316 272 276 211],13,5,12244,4.081333333333333,20.0,40.0
3000,0,3000,[303 316 272 276 211],90,5,12249,4.0816394535154945,20.0,40.0
3001,0,3001,[300 276 275 315 331],634,3,12252,4.081279147235176,20.0,60.0
3002,0,3002,[303 316 272 276 211],90,5,12257,4.081585081585081,20.0,40.0
3003,0,3003,[303 316 272 276 211],13,5,12262,4.081890812250333,20.0,40.0
3004,0,3004,[239 226 213 254 297],934,5,12267,4.082196339434276,20.0,0.0
3005,0,3005,[303 316 272 276 211],90,5,12272,4.082501663339987,20.0,40.0
3006,0,3006,[303 316 272 276 211],90,5,12277,4.08280678417027,20.0,40.0
3007,0,3007,[431 226 301 222 367],279,3,12280,4.082446808510638,0.0,20.0
3008,0,3008,[303 316 272 276 211],90,5,12285,4.0827517447657025,20.0,40.0
3009,0,3009,[431 315 226 367 202],650,0,12285,4.0813953488372094,20.0,0.0
3010,0,3010,[301 254 378 231 485],184,2,12287,4.080704085021588,0.0,0.0
3011,0,3011,[303 316 272 276 211],90,5,12292,4.081009296148738,20.0,40.0
3012,0,3012,[299 300 241 291 201],537,0,12292,4.079654829074013,0.0,20.0
3013,0,3013,[303 316 272 276 211],13,5,12297,4.079960185799602,20.0,40.0
3014,0,3014,[303 316 272 276 211],90,5,12302,4.080265339966832,20.0,40.0
3015,0,3015,[509 481 211 275 209],6,5,12307,4.080570291777188,0.0,40.0
3016,0,3016,[367 284 291 219 218],234,1,12308,4.079549221080543,0.0,0.0
3017,0,3017,[303 316 272 276 211],90,5,12313,4.079854208084824,20.0,40.0
3018,0,3018,[303 316 272 276 211],13,5,12318,4.080158993044054,20.0,40.0
3019,0,3019,[303 316 272 276 211],13,5,12323,4.08046357615894,20.0,40.0
3020,0,3020,[303 316 272 276 211],90,5,12328,4.080767957629924,20.0,40.0
3021,0,3021,[283 246 485 222 326],334,3,12331,4.08041032428855,0.0,20.0
3022,0,3022,[303 316 272 276 211],13,5,12336,4.080714521998015,20.0,40.0
3023,0,3023,[583 217 244 222 293],158,3,12339,4.080357142857143,0.0,20.0
3024,0,3024,[216 272 331 239 413],13,2,12341,4.079669421487603,0.0,0.0
3025,0,3025,[300 223 239 293 290],334,1,12342,4.078651685393258,20.0,20.0
3026,0,3026,[303 316 272 276 211],13,5,12347,4.0789560621076975,20.0,40.0
3027,0,3027,[303 316 272 276 211],90,5,12352,4.079260237780713,20.0,40.0
3028,0,3028,[303 316 272 276 211],13,5,12357,4.079564212611423,20.0,40.0
3029,0,3029,[324 336 300 276 297],894,3,12360,4.079207920792079,20.0,40.0
3030,0,3030,[303 316 272 276 211],90,5,12365,4.07951171230617,20.0,40.0
3031,0,3031,[303 316 272 276 211],90,5,12370,4.079815303430079,20.0,40.0
3032,0,3032,[303 316 272 276 211],90,5,12375,4.080118694362018,20.0,40.0
3033,0,3033,[303 316 272 276 211],13,5,12380,4.080421885299934,20.0,40.0
3034,0,3034,[303 316 272 276 211],90,5,12385,4.080724876441516,20.0,40.0
3035,0,3035,[303 316 272 276 211],13,5,12390,4.0810276679841895,20.0,40.0
3036,0,3036,[303 316 272 276 211],90,5,12395,4.081330260125124,20.0,40.0
3037,0,3037,[223 212 268 481 291],234,1,12396,4.0803159973666885,20.0,0.0
3038,0,3038,[507 218 243 431 209],59,4,12400,4.08028956893715,0.0,0.0
3039,0,3039,[303 316 272 276 211],13,5,12405,4.0805921052631575,20.0,40.0
3040,0,3040,[303 316 272 276 211],13,5,12410,4.08089444261756,20.0,40.0
3041,0,3041,[275 299 300 297 264],486,3,12413,4.080539119000657,20.0,40.0
3042,0,3042,[303 316 272 276 211],90,5,12418,4.080841275057509,20.0,40.0
3043,0,3043,[303 316 272 276 211],90,5,12423,4.081143232588699,20.0,40.0
3044,0,3044,[303 316 272 276 211],13,5,12428,4.0814449917898195,20.0,40.0
3045,0,3045,[315 218 227 216 236],334,2,12430,4.080761654629022,20.0,0.0
3046,0,3046,[201 290 336 331 344],13,1,12431,4.079750574335412,0.0,0.0
3047,0,3047,[378 293 227 202 213],653,0,12431,4.078412073490814,0.0,0.0
3048,0,3048,[303 316 272 276 211],13,5,12436,4.0787143325680555,20.0,40.0
3049,0,3049,[303 316 272 276 211],90,5,12441,4.079016393442623,20.0,40.0
3050,0,3050,[303 316 272 276 211],13,5,12446,4.079318256309406,20.0,40.0
3051,0,3051,[303 316 272 276 211],90,5,12451,4.07961992136304,20.0,40.0
3052,0,3052,[303 316 272 276 211],90,5,12456,4.079921388797904,20.0,40.0
3053,0,3053,[303 316 272 276 211],13,5,12461,4.08022265880812,20.0,40.0
3054,0,3054,[303 316 272 276 211],90,5,12466,4.0805237315875615,20.0,40.0
3055,0,3055,[208 218 259 509 507],474,3,12469,4.080170157068062,0.0,0.0
3056,0,3056,[303 316 272 276 211],90,5,12474,4.080471050049067,20.0,40.0
3057,0,3057,[303 316 272 276 211],90,5,12479,4.080771746239372,20.0,40.0
3058,0,3058,[485 213 293 507 264],308,2,12481,4.080091533180778,0.0,0.0
3059,0,3059,[316 216 485 255 268],334,2,12483,4.079411764705882,20.0,0.0
3060,0,3060,[303 316 272 276 211],13,5,12488,4.079712512250898,20.0,40.0
3061,0,3061,[303 316 272 276 211],13,5,12493,4.080013063357283,20.0,40.0
3062,0,3062,[303 316 272 276 211],90,5,12498,4.080313418217434,20.0,40.0
3063,0,3063,[303 316 272 276 211],90,5,12503,4.080613577023499,20.0,40.0
3064,0,3064,[303 316 272 276 211],13,5,12508,4.080913539967374,20.0,40.0
3065,0,3065,[303 316 272 276 211],90,5,12513,4.081213307240705,20.0,40.0
3066,0,3066,[303 316 272 276 211],13,5,12518,4.081512879034888,20.0,40.0
3067,0,3067,[303 316 272 276 211],13,5,12523,4.081812255541069,20.0,40.0
3068,0,3068,[303 316 272 276 211],13,5,12528,4.0821114369501466,20.0,40.0
3069,0,3069,[303 316 272 276 211],90,5,12533,4.082410423452769,20.0,40.0
3070,0,3070,[303 316 272 276 211],90,5,12538,4.082709215239336,20.0,40.0
3071,0,3071,[250 206 284 226 298],833,2,12540,4.08203125,0.0,0.0
3072,0,3072,[303 316 272 276 211],13,5,12545,4.082329970712658,20.0,40.0
3073,0,3073,[208 222 254 209 298],738,3,12548,4.081977878985036,0.0,20.0
3074,0,3074,[303 316 272 276 211],90,5,12553,4.082276422764227,20.0,40.0
3075,0,3075,[303 316 272 276 211],90,5,12558,4.082574772431729,20.0,40.0
3076,0,3076,[303 316 272 276 211],90,5,12563,4.082872928176796,20.0,40.0
3077,0,3077,[264 315 481 208 232],13,3,12566,4.082521117608837,20.0,0.0
3078,0,3078,[303 316 272 276 211],13,5,12571,4.082819097109451,20.0,40.0
3079,0,3079,[303 316 272 276 211],90,5,12576,4.083116883116883,20.0,40.0
3080,0,3080,[303 316 272 276 211],13,5,12581,4.083414475819539,20.0,40.0
3081,0,3081,[243 431 485 301 208],650,1,12582,4.0824140168721605,0.0,0.0
3082,0,3082,[303 316 272 276 211],13,5,12587,4.082711644502108,20.0,40.0
3083,0,3083,[239 394 217 350 384],13,1,12588,4.081712062256809,0.0,0.0
3084,0,3084,[303 316 272 276 211],90,5,12593,4.082009724473258,20.0,40.0
3085,0,3085,[303 316 272 276 211],13,5,12598,4.0823071937783535,20.0,40.0
3086,0,3086,[303 316 272 276 211],90,5,12603,4.0826044703595725,20.0,40.0
3087,0,3087,[231 208 232 202 222],13,2,12605,4.081930051813472,0.0,20.0
3088,0,3088,[303 316 272 276 211],13,5,12610,4.082227258012302,20.0,40.0
3089,0,3089,[221 276 264 268 350],894,2,12612,4.081553398058253,0.0,20.0
3090,0,3090,[303 316 272 276 211],13,5,12617,4.081850533807829,20.0,40.0
3091,0,3091,[239 420 326 275 215],311,2,12619,4.08117723156533,0.0,20.0
3092,0,3092,[276 481 219 246 508],643,5,12624,4.081474296799224,0.0,20.0
3093,0,3093,[276 392 211 201 208],59,4,12628,4.081447963800905,0.0,40.0
3094,0,3094,[303 316 272 276 211],90,5,12633,4.0817447495961225,20.0,40.0
3095,0,3095,[303 316 272 276 211],13,5,12638,4.082041343669251,20.0,40.0
3096,0,3096,[226 222 261 394 230],13,1,12639,4.0810461737165,0.0,20.0
3097,0,3097,[218 429 208 431 507],406,2,12641,4.080374435119432,0.0,0.0
3098,0,3098,[226 211 478 276 217],339,3,12644,4.080025814778961,0.0,40.0
3099,0,3099,[209 507 509 392 298],308,4,12648,4.08,0.0,0.0
3100,0,3100,[350 315 232 218 211],13,2,12650,4.079329248629475,20.0,20.0
3101,0,3101,[384 201 227 336 429],13,2,12652,4.078658929722759,0.0,0.0
3102,0,3102,[217 507 290 429 485],13,2,12654,4.077989042861747,0.0,0.0
3103,0,3103,[303 316 272 276 211],13,5,12659,4.078286082474227,20.0,40.0
3104,0,3104,[303 316 272 276 211],13,5,12664,4.078582930756844,20.0,40.0
3105,0,3105,[303 316 272 276 211],13,5,12669,4.078879587894398,20.0,40.0
3106,0,3106,[215 481 291 378 283],308,1,12670,4.077888638558095,0.0,0.0
3107,0,3107,[298 201 508 211 231],387,3,12673,4.077541827541827,0.0,20.0
3108,0,3108,[202 215 226 231 259],537,0,12673,4.076230299131554,0.0,0.0
3109,0,3109,[303 316 272 276 211],90,5,12678,4.076527331189711,20.0,40.0
3110,0,3110,[303 316 272 276 211],90,5,12683,4.076824172291867,20.0,40.0
3111,0,3111,[303 316 272 276 211],13,5,12688,4.077120822622108,20.0,40.0
3112,0,3112,[303 316 272 276 211],90,5,12693,4.077417282364279,20.0,40.0
3113,0,3113,[220 231 208 429 254],648,2,12695,4.076750160565189,0.0,0.0
3114,0,3114,[303 316 272 276 211],90,5,12700,4.077046548956662,20.0,40.0
3115,0,3115,[303 316 272 276 211],90,5,12705,4.077342747111682,20.0,40.0
3116,0,3116,[206 243 223 301 213],234,1,12706,4.076355470003208,20.0,0.0
3117,0,3117,[303 316 272 276 211],90,5,12711,4.076651699807569,20.0,40.0
3118,0,3118,[303 316 272 276 211],90,5,12716,4.076947739660148,20.0,40.0
3119,0,3119,[303 316 272 276 211],13,5,12721,4.07724358974359,20.0,40.0
3120,0,3120,[303 316 272 276 211],13,5,12726,4.077539250240307,20.0,40.0
3121,0,3121,[303 316 272 276 211],13,5,12731,4.077834721332479,20.0,40.0
3122,0,3122,[303 316 272 276 211],13,5,12736,4.078130003202049,20.0,40.0
3123,0,3123,[303 316 272 276 211],13,5,12741,4.07842509603073,20.0,40.0
3124,0,3124,[303 316 272 276 211],90,5,12746,4.07872,20.0,40.0
3125,0,3125,[303 316 272 276 211],13,5,12751,4.079014715291107,20.0,40.0
3126,0,3126,[303 316 272 276 211],13,5,12756,4.079309242085065,20.0,40.0
3127,0,3127,[303 316 272 276 211],90,5,12761,4.07960358056266,20.0,40.0
3128,0,3128,[315 239 226 344 219],13,3,12764,4.079258549057207,20.0,0.0
3129,0,3129,[303 316 272 276 211],13,5,12769,4.079552715654952,20.0,40.0
3130,0,3130,[303 316 272 276 211],13,5,12774,4.079846694346854,20.0,40.0
3131,0,3131,[303 316 272 276 211],13,5,12779,4.080140485312899,20.0,40.0
3132,0,3132,[303 316 272 276 211],13,5,12784,4.080434088732844,20.0,40.0
3133,0,3133,[303 316 272 276 211],13,5,12789,4.080727504786216,20.0,40.0
3134,0,3134,[202 227 259 365 300],7,2,12791,4.0800637958532695,0.0,20.0
3135,0,3135,[303 316 272 276 211],13,5,12796,4.080357142857143,20.0,40.0
3136,0,3136,[303 316 272 276 211],90,5,12801,4.080650302837106,20.0,40.0
3137,0,3137,[303 316 272 276 211],13,5,12806,4.080943275971957,20.0,40.0
3138,0,3138,[303 316 272 276 211],13,5,12811,4.081236062440268,20.0,40.0
3139,0,3139,[303 316 272 276 211],90,5,12816,4.081528662420382,20.0,40.0
3140,0,3140,[216 276 303 297 227],533,4,12820,4.08150270614454,20.0,20.0
3141,0,3141,[303 316 272 276 211],13,5,12825,4.081795035009548,20.0,40.0
3142,0,3142,[303 316 272 276 211],13,5,12830,4.082087177855552,20.0,40.0
3143,0,3143,[303 316 272 276 211],13,5,12835,4.082379134860051,20.0,40.0
3144,0,3144,[303 316 272 276 211],90,5,12840,4.082670906200318,20.0,40.0
3145,0,3145,[303 316 272 276 211],13,5,12845,4.082962492053401,20.0,40.0
3146,0,3146,[303 316 272 276 211],13,5,12850,4.083253892596123,20.0,40.0
3147,0,3147,[222 276 392 478 243],200,4,12854,4.0832274459974585,0.0,40.0
3148,0,3148,[299 300 212 227 508],13,2,12856,4.082565893934582,0.0,20.0
3149,0,3149,[452 211 255 283 209],308,3,12859,4.082222222222223,0.0,20.0
3150,0,3150,[303 316 272 276 211],13,5,12864,4.0825134877816565,20.0,40.0
3151,0,3151,[509 367 202 321 246],6,1,12865,4.081535532994923,0.0,0.0
3152,0,3152,[303 316 272 276 211],13,5,12870,4.0818268315889625,20.0,40.0
3153,0,3153,[303 316 272 276 211],90,5,12875,4.0821179454660745,20.0,40.0
3154,0,3154,[303 316 272 276 211],13,5,12880,4.082408874801902,20.0,40.0
3155,0,3155,[303 316 272 276 211],90,5,12885,4.082699619771863,20.0,40.0
3156,0,3156,[250 212 226 293 240],339,4,12889,4.082673424136839,0.0,0.0
3157,0,3157,[215 283 226 212 301],537,1,12890,4.081697276757441,0.0,0.0
3158,0,3158,[303 316 272 276 211],90,5,12895,4.08198797087686,20.0,40.0
3159,0,3159,[303 316 272 276 211],13,5,12900,4.082278481012659,20.0,40.0
3160,0,3160,[303 316 272 276 211],13,5,12905,4.08256880733945,20.0,40.0
3161,0,3161,[303 316 272 276 211],13,5,12910,4.082858950031626,20.0,40.0
3162,0,3162,[303 316 272 276 211],90,5,12915,4.0831489092633575,20.0,40.0
3163,0,3163,[303 316 272 276 211],13,5,12920,4.083438685208597,20.0,40.0
3164,0,3164,[303 316 272 276 211],90,5,12925,4.083728278041074,20.0,40.0
3165,0,3165,[303 316 272 276 211],90,5,12930,4.084017687934302,20.0,40.0
3166,0,3166,[303 316 272 276 211],13,5,12935,4.084306915061572,20.0,40.0
3167,0,3167,[297 293 220 275 208],334,3,12938,4.083964646464646,20.0,20.0
3168,0,3168,[303 316 272 276 211],13,5,12943,4.0842537077942564,20.0,40.0
3169,0,3169,[303 316 272 276 211],90,5,12948,4.084542586750788,20.0,40.0
3170,0,3170,[243 209 206 509 219],650,1,12949,4.083569851781772,0.0,0.0
3171,0,3171,[301 239 394 316 413],13,2,12951,4.082912988650693,20.0,0.0
3172,0,3172,[303 316 272 276 211],90,5,12956,4.0832020170185945,20.0,40.0
3173,0,3173,[367 219 291 481 231],308,2,12958,4.082545683679899,0.0,0.0
3174,0,3174,[303 316 272 276 211],13,5,12963,4.082834645669291,20.0,40.0
3175,0,3175,[212 255 209 227 326],474,4,12967,4.082808564231738,0.0,0.0
3176,0,3176,[303 316 272 276 211],13,5,12972,4.0830972615675165,20.0,40.0
3177,0,3177,[303 316 272 276 211],13,5,12977,4.083385777218377,20.0,40.0
3178,0,3178,[303 316 272 276 211],13,5,12982,4.083674111355772,20.0,40.0
3179,0,3179,[303 316 272 276 211],13,5,12987,4.083962264150943,20.0,40.0
3180,0,3180,[303 316 272 276 211],13,5,12992,4.084250235774913,20.0,40.0
3181,0,3181,[303 316 272 276 211],13,5,12997,4.084538026398492,20.0,40.0
3182,0,3182,[509 201 336 268 280],13,3,13000,4.084197298146403,0.0,0.0
3183,0,3183,[222 365 230 209 284],804,4,13004,4.084170854271357,0.0,20.0
3184,0,3184,[303 316 272 276 211],90,5,13009,4.084458398744113,20.0,40.0
3185,0,3185,[303 316 272 276 211],13,5,13014,4.084745762711864,20.0,40.0
3186,0,3186,[290 218 212 211 239],524,2,13016,4.084091622215249,0.0,20.0
3187,0,3187,[222 268 232 509 261],13,2,13018,4.083437892095358,0.0,20.0
3188,0,3188,[303 316 272 276 211],13,5,13023,4.083725305738476,20.0,40.0
3189,0,3189,[283 509 298 326 275],894,2,13025,4.08307210031348,0.0,20.0
3190,0,3190,[303 316 272 276 211],90,5,13030,4.083359448448762,20.0,40.0
3191,0,3191,[303 316 272 276 211],90,5,13035,4.083646616541353,20.0,40.0
3192,0,3192,[303 316 272 276 211],13,5,13040,4.083933604760413,20.0,40.0
3193,0,3193,[226 219 240 367 209],795,1,13041,4.082968065122104,0.0,0.0
3194,0,3194,[303 316 272 276 211],13,5,13046,4.083255086071987,20.0,40.0
3195,0,3195,[303 316 272 276 211],90,5,13051,4.083541927409262,20.0,40.0
3196,0,3196,[303 316 272 276 211],90,5,13056,4.083828589302471,20.0,40.0
3197,0,3197,[303 316 272 276 211],13,5,13061,4.08411507191995,20.0,40.0
3198,0,3198,[303 316 272 276 211],90,5,13066,4.084401375429822,20.0,40.0
3199,0,3199,[303 316 272 276 211],13,5,13071,4.0846875,20.0,40.0
3200,0,3200,[303 316 272 276 211],13,5,13076,4.084973445798188,20.0,40.0
3201,0,3201,[331 299 218 275 452],13,0,13076,4.08369768894441,0.0,20.0
3202,0,3202,[303 316 272 276 211],13,5,13081,4.083983765220106,20.0,40.0
3203,0,3203,[303 316 272 276 211],90,5,13086,4.084269662921348,20.0,40.0
3204,0,3204,[303 316 272 276 211],90,5,13091,4.084555382215289,20.0,40.0
3205,0,3205,[303 316 272 276 211],90,5,13096,4.084840923268871,20.0,40.0
3206,0,3206,[303 316 272 276 211],90,5,13101,4.085126286248831,20.0,40.0
3207,0,3207,[303 316 272 276 211],13,5,13106,4.085411471321696,20.0,40.0
3208,0,3208,[303 316 272 276 211],90,5,13111,4.085696478653786,20.0,40.0
3209,0,3209,[284 226 230 213 202],378,1,13112,4.084735202492212,0.0,0.0
3210,0,3210,[303 316 272 276 211],90,5,13117,4.08502024291498,20.0,40.0
3211,0,3211,[241 478 215 230 283],537,2,13119,4.084371108343711,0.0,0.0
3212,0,3212,[303 316 272 276 211],13,5,13124,4.084656084656085,20.0,40.0
3213,0,3213,[303 316 272 276 211],13,5,13129,4.084940883634101,20.0,40.0
3214,0,3214,[303 316 272 276 211],90,5,13134,4.085225505443235,20.0,40.0
3215,0,3215,[303 316 272 276 211],13,5,13139,4.085509950248756,20.0,40.0
3216,0,3216,[303 316 272 276 211],13,5,13144,4.085794218215729,20.0,40.0
3217,0,3217,[303 316 272 276 211],13,5,13149,4.086078309509012,20.0,40.0
3218,0,3218,[303 316 272 276 211],90,5,13154,4.086362224293259,20.0,40.0
3219,0,3219,[303 316 272 276 211],13,5,13159,4.086645962732919,20.0,40.0
3220,0,3220,[303 316 272 276 211],90,5,13164,4.086929524992239,20.0,40.0
3221,0,3221,[303 316 272 276 211],90,5,13169,4.087212911235258,20.0,40.0
3222,0,3222,[303 316 272 276 211],90,5,13174,4.087496121625814,20.0,40.0
3223,0,3223,[303 316 272 276 211],90,5,13179,4.087779156327543,20.0,40.0
3224,0,3224,[303 316 272 276 211],90,5,13184,4.088062015503876,20.0,40.0
3225,0,3225,[303 316 272 276 211],13,5,13189,4.088344699318041,20.0,40.0
3226,0,3226,[303 316 272 276 211],90,5,13194,4.088627207933064,20.0,40.0
3227,0,3227,[303 316 272 276 211],13,5,13199,4.088909541511772,20.0,40.0
3228,0,3228,[303 316 272 276 211],13,5,13204,4.0891917002167855,20.0,40.0
3229,0,3229,[303 316 272 276 211],13,5,13209,4.089473684210526,20.0,40.0
3230,0,3230,[303 316 272 276 211],90,5,13214,4.089755493655215,20.0,40.0
3231,0,3231,[303 316 272 276 211],90,5,13219,4.090037128712871,20.0,40.0
3232,0,3232,[303 316 272 276 211],90,5,13224,4.090318589545314,20.0,40.0
3233,0,3233,[303 316 272 276 211],90,5,13229,4.090599876314162,20.0,40.0
3234,0,3234,[303 316 272 276 211],13,5,13234,4.090880989180834,20.0,40.0
3235,0,3235,[303 316 272 276 211],13,5,13239,4.091161928306551,20.0,40.0
3236,0,3236,[218 261 300 331 508],13,0,13239,4.089898053753475,0.0,20.0
3237,0,3237,[303 316 272 276 211],90,5,13244,4.09017912291538,20.0,40.0
3238,0,3238,[303 316 272 276 211],13,5,13249,4.090460018524236,20.0,40.0
3239,0,3239,[367 217 250 230 295],387,1,13250,4.089506172839506,0.0,0.0
3240,0,3240,[303 316 272 276 211],90,5,13255,4.089787102746066,20.0,40.0
3241,0,3241,[303 316 272 276 211],90,5,13260,4.090067859346083,20.0,40.0
3242,0,3242,[303 316 272 276 211],90,5,13265,4.090348442799876,20.0,40.0
3243,0,3243,[283 378 276 291 202],533,2,13267,4.089704069050555,0.0,20.0
3244,0,3244,[303 316 272 211 276],90,5,13272,4.089984591679507,20.0,40.0
3245,0,3245,[303 316 272 211 276],13,5,13277,4.09026494146642,20.0,40.0
3246,0,3246,[509 264 218 231 243],13,2,13279,4.089621188789652,0.0,0.0
3247,0,3247,[222 219 413 280 290],42,2,13281,4.088977832512315,0.0,20.0
3248,0,3248,[303 316 272 211 276],13,5,13286,4.089258233302554,20.0,40.0
3249,0,3249,[303 316 272 211 276],90,5,13291,4.089538461538462,20.0,40.0
3250,0,3250,[303 316 272 211 276],90,5,13296,4.089818517379268,20.0,40.0
3251,0,3251,[331 485 420 216 212],13,2,13298,4.089175891758917,0.0,0.0
3252,0,3252,[303 316 272 211 276],13,5,13303,4.0894558868736555,20.0,40.0
3253,0,3253,[303 316 272 211 276],90,5,13308,4.089735709895513,20.0,40.0
3254,0,3254,[298 241 216 209 221],85,2,13310,4.089093701996928,0.0,0.0
3255,0,3255,[303 316 272 211 276],90,5,13315,4.089373464373464,20.0,40.0
3256,0,3256,[303 316 272 211 276],13,5,13320,4.089653054958551,20.0,40.0
3257,0,3257,[272 255 283 244 239],334,2,13322,4.089011663597299,0.0,0.0
3258,0,3258,[303 316 272 211 276],13,5,13327,4.089291193617674,20.0,40.0
3259,0,3259,[303 316 272 211 276],90,5,13332,4.089570552147239,20.0,40.0
3260,0,3260,[303 316 272 211 276],90,5,13337,4.08984973934376,20.0,40.0
3261,0,3261,[316 298 284 301 218],145,3,13340,4.089515634580012,20.0,0.0
3262,0,3262,[303 316 272 211 276],90,5,13345,4.08979466748391,20.0,40.0
3263,0,3263,[284 212 583 276 240],92,2,13347,4.089154411764706,0.0,20.0
3264,0,3264,[303 316 272 211 276],90,5,13352,4.089433384379785,20.0,40.0
3265,0,3265,[485 218 215 290 212],59,3,13355,4.089099816289038,0.0,0.0
3266,0,3266,[429 216 209 239 218],843,1,13356,4.088154269972452,0.0,0.0
3267,0,3267,[303 316 272 211 276],90,5,13361,4.08843329253366,20.0,40.0
3268,0,3268,[303 316 272 211 276],13,5,13366,4.088712144386663,20.0,40.0
3269,0,3269,[303 316 272 211 276],90,5,13371,4.088990825688073,20.0,40.0
3270,0,3270,[303 316 272 211 276],13,5,13376,4.089269336594314,20.0,40.0
3271,0,3271,[303 316 272 211 276],90,5,13381,4.0895476772616135,20.0,40.0
3272,0,3272,[303 316 272 211 276],90,5,13386,4.089825847846013,20.0,40.0
3273,0,3273,[303 316 272 211 276],90,5,13391,4.09010384850336,20.0,40.0
3274,0,3274,[431 326 291 254 216],749,4,13395,4.090076335877862,0.0,0.0
3275,0,3275,[215 218 259 209 509],194,1,13396,4.089133089133089,0.0,0.0
3276,0,3276,[303 316 272 211 276],90,5,13401,4.089411046689045,20.0,40.0
3277,0,3277,[290 243 300 232 301],13,1,13402,4.088468578401464,0.0,20.0
3278,0,3278,[303 316 272 211 276],90,5,13407,4.088746569075938,20.0,40.0
3279,0,3279,[303 316 272 211 276],13,5,13412,4.089024390243902,20.0,40.0
3280,0,3280,[272 431 485 216 261],13,1,13413,4.0880829015544045,0.0,0.0
3281,0,3281,[303 316 272 211 276],13,5,13418,4.088360755636807,20.0,40.0
3282,0,3282,[303 316 272 211 276],13,5,13423,4.088638440450807,20.0,40.0
3283,0,3283,[481 241 420 276 215],308,4,13427,4.088611449451888,0.0,20.0
3284,0,3284,[303 316 272 211 276],90,5,13432,4.088888888888889,20.0,40.0
3285,0,3285,[303 316 272 211 276],13,5,13437,4.089166159464394,20.0,40.0
3286,0,3286,[303 316 272 211 276],90,5,13442,4.089443261332522,20.0,40.0
3287,0,3287,[344 227 231 218 211],328,3,13445,4.089111922141119,0.0,20.0
3288,0,3288,[303 316 272 211 276],13,5,13450,4.089388871997568,20.0,40.0
3289,0,3289,[303 316 272 211 276],13,5,13455,4.089665653495441,20.0,40.0
3290,0,3290,[208 226 223 213 429],7,4,13459,4.089638407778791,20.0,0.0
3291,0,3291,[303 316 272 211 276],90,5,13464,4.0899149453219925,20.0,40.0
3292,0,3292,[303 316 272 211 276],13,5,13469,4.090191314910416,20.0,40.0
3293,0,3293,[303 316 272 211 276],13,5,13474,4.090467516697025,20.0,40.0
3294,0,3294,[303 316 272 211 276],90,5,13479,4.090743550834598,20.0,40.0
3295,0,3295,[303 316 272 211 276],90,5,13484,4.091019417475728,20.0,40.0
3296,0,3296,[303 316 272 211 276],90,5,13489,4.091295116772824,20.0,40.0
3297,0,3297,[303 316 272 211 276],13,5,13494,4.091570648878108,20.0,40.0
3298,0,3298,[303 316 272 211 276],13,5,13499,4.091846013943619,20.0,40.0
3299,0,3299,[303 316 272 211 276],13,5,13504,4.092121212121212,20.0,40.0
3300,0,3300,[429 392 478 216 211],537,2,13506,4.091487428052106,0.0,20.0
3301,0,3301,[303 316 272 211 276],90,5,13511,4.0917625681405205,20.0,40.0
3302,0,3302,[300 275 268 509 301],90,4,13515,4.091734786557675,0.0,40.0
3303,0,3303,[293 259 481 223 485],308,3,13518,4.091404358353511,20.0,0.0
3304,0,3304,[303 316 272 211 276],90,5,13523,4.091679273827534,20.0,40.0
3305,0,3305,[232 284 326 300 392],64,1,13524,4.090744101633394,0.0,20.0
3306,0,3306,[303 316 272 211 276],90,5,13529,4.091019050498941,20.0,40.0
3307,0,3307,[213 201 507 452 216],7,3,13532,4.090689238210399,0.0,0.0
3308,0,3308,[303 316 272 211 276],90,5,13537,4.090964037473557,20.0,40.0
3309,0,3309,[303 316 272 211 276],13,5,13542,4.091238670694864,20.0,40.0
3310,0,3310,[303 316 272 211 276],90,5,13547,4.091513138024766,20.0,40.0
3311,0,3311,[303 316 272 211 276],90,5,13552,4.091787439613527,20.0,40.0
3312,0,3312,[303 316 272 211 276],13,5,13557,4.092061575611228,20.0,40.0
3313,0,3313,[303 316 272 211 276],13,5,13562,4.0923355461677735,20.0,40.0
3314,0,3314,[303 316 272 211 276],13,5,13567,4.0926093514328805,20.0,40.0
3315,0,3315,[246 324 206 209 431],387,3,13570,4.092279855247286,0.0,0.0
3316,0,3316,[303 316 272 211 276],13,5,13575,4.092553512209828,20.0,40.0
3317,0,3317,[303 316 272 211 276],13,5,13580,4.0928270042194095,20.0,40.0
3318,0,3318,[303 316 272 211 276],13,5,13585,4.093100331425128,20.0,40.0
3319,0,3319,[303 316 272 211 276],13,5,13590,4.093373493975903,20.0,40.0
3320,0,3320,[303 316 272 211 276],90,5,13595,4.093646492020476,20.0,40.0
3321,0,3321,[394 316 211 202 413],13,3,13598,4.093317278747742,20.0,20.0
3322,0,3322,[485 239 216 209 208],537,2,13600,4.092687330725249,0.0,0.0
3323,0,3323,[315 478 300 299 201],13,2,13602,4.092057761732852,20.0,20.0
3324,0,3324,[303 316 272 211 276],90,5,13607,4.092330827067669,20.0,40.0
3325,0,3325,[303 316 272 211 276],90,5,13612,4.092603728202045,20.0,40.0
3326,0,3326,[303 316 272 211 276],90,5,13617,4.092876465284039,20.0,40.0
3327,0,3327,[303 316 272 211 276],13,5,13622,4.093149038461538,20.0,40.0
3328,0,3328,[303 316 272 211 276],13,5,13627,4.093421447882247,20.0,40.0
3329,0,3329,[303 316 272 211 276],13,5,13632,4.093693693693694,20.0,40.0
3330,0,3330,[231 226 429 222 219],795,1,13633,4.092764935454818,0.0,20.0
3331,0,3331,[216 452 211 283 259],308,1,13634,4.091836734693878,0.0,20.0
3332,0,3332,[261 232 216 315 219],13,1,13635,4.090909090909091,20.0,0.0
3333,0,3333,[283 250 297 256 303],894,3,13638,4.090581883623275,20.0,0.0
3334,0,3334,[303 316 272 211 276],90,5,13643,4.090854572713643,20.0,40.0
3335,0,3335,[481 315 478 276 420],13,4,13647,4.090827338129497,20.0,20.0
3336,0,3336,[303 316 272 211 276],90,5,13652,4.091099790230746,20.0,40.0
3337,0,3337,[303 316 272 211 276],13,5,13657,4.091372079089275,20.0,40.0
3338,0,3338,[303 316 272 211 276],90,5,13662,4.091644204851752,20.0,40.0
3339,0,3339,[293 239 272 209 316],334,2,13664,4.091017964071856,20.0,0.0
3340,0,3340,[303 316 272 211 276],90,5,13669,4.091290032924274,20.0,40.0
3341,0,3341,[303 316 272 211 276],13,5,13674,4.091561938958708,20.0,40.0
3342,0,3342,[303 316 272 211 276],90,5,13679,4.091833682321268,20.0,40.0
3343,0,3343,[303 316 272 211 276],90,5,13684,4.092105263157895,20.0,40.0
3344,0,3344,[303 316 272 211 276],13,5,13689,4.09237668161435,20.0,40.0
3345,0,3345,[300 420 485 227 231],13,2,13691,4.0917513448894205,0.0,20.0
3346,0,3346,[303 316 272 211 276],13,5,13696,4.092022706901703,20.0,40.0
3347,0,3347,[303 316 272 211 276],13,5,13701,4.092293906810036,20.0,40.0
3348,0,3348,[303 316 272 211 276],90,5,13706,4.09256494475963,20.0,40.0
3349,0,3349,[303 316 272 211 276],90,5,13711,4.092835820895522,20.0,40.0
3350,0,3350,[303 316 272 211 276],13,5,13716,4.093106535362578,20.0,40.0
3351,0,3351,[213 275 276 216 507],474,4,13720,4.093078758949881,0.0,40.0
3352,0,3352,[303 316 272 211 276],90,5,13725,4.093349239487027,20.0,40.0
3353,0,3353,[303 316 272 211 276],13,5,13730,4.0936195587358375,20.0,40.0
3354,0,3354,[303 316 272 211 276],13,5,13735,4.093889716840536,20.0,40.0
3355,0,3355,[222 429 223 300 218],788,3,13738,4.093563766388558,20.0,40.0
3356,0,3356,[303 316 272 211 276],13,5,13743,4.093833780160858,20.0,40.0
3357,0,3357,[217 215 219 431 216],13,1,13744,4.092912447885646,0.0,0.0
3358,0,3358,[303 316 272 211 276],13,5,13749,4.093182494790116,20.0,40.0
3359,0,3359,[219 222 431 272 315],13,2,13751,4.092559523809523,20.0,20.0
3360,0,3360,[303 316 272 211 276],90,5,13756,4.09282951502529,20.0,40.0
3361,0,3361,[303 209 321 452 413],13,1,13757,4.091909577632362,0.0,0.0
3362,0,3362,[303 316 272 211 276],90,5,13762,4.092179601546238,20.0,40.0
3363,0,3363,[303 316 272 211 276],90,5,13767,4.092449464922711,20.0,40.0
3364,0,3364,[230 290 392 226 315],537,1,13768,4.091530460624071,20.0,0.0
3365,0,3365,[303 316 272 211 276],13,5,13773,4.091800356506239,20.0,40.0
3366,0,3366,[303 316 272 211 276],90,5,13778,4.092070092070092,20.0,40.0
3367,0,3367,[303 316 272 211 276],13,5,13783,4.0923396674584325,20.0,40.0
3368,0,3368,[303 316 272 211 276],13,5,13788,4.092609082813891,20.0,40.0
3369,0,3369,[240 208 226 223 218],690,3,13791,4.092284866468843,20.0,0.0
3370,0,3370,[303 316 272 211 276],90,5,13796,4.092554138237912,20.0,40.0
3371,0,3371,[303 316 272 211 276],13,5,13801,4.09282325029656,20.0,40.0
3372,0,3372,[303 316 272 211 276],90,5,13806,4.093092202786837,20.0,40.0
3373,0,3373,[303 316 272 211 276],13,5,13811,4.093360995850622,20.0,40.0
3374,0,3374,[303 316 272 211 276],13,5,13816,4.093629629629629,20.0,40.0
3375,0,3375,[303 316 272 211 276],13,5,13821,4.093898104265403,20.0,40.0
3376,0,3376,[303 316 272 211 276],90,5,13826,4.094166419899319,20.0,40.0
3377,0,3377,[303 316 272 211 276],13,5,13831,4.094434576672588,20.0,40.0
3378,0,3378,[303 316 272 211 276],90,5,13836,4.09470257472625,20.0,40.0
3379,0,3379,[216 239 213 303 212],934,4,13840,4.094674556213017,0.0,0.0
3380,0,3380,[303 316 272 211 276],90,5,13845,4.09494232475599,20.0,40.0
3381,0,3381,[303 316 272 211 276],13,5,13850,4.095209934949734,20.0,40.0
3382,0,3382,[321 508 297 236 301],486,3,13853,4.094886195684304,20.0,0.0
3383,0,3383,[303 316 272 211 276],13,5,13858,4.0951536643026,20.0,40.0
3384,0,3384,[221 378 300 219 276],234,1,13859,4.09423929098966,0.0,40.0
3385,0,3385,[275 367 301 300 230],378,2,13861,4.093620791494389,0.0,40.0
3386,0,3386,[303 316 272 211 276],13,5,13866,4.093888396811337,20.0,40.0
3387,0,3387,[303 316 272 211 276],13,5,13871,4.0941558441558445,20.0,40.0
3388,0,3388,[268 215 509 243 212],13,4,13875,4.094128061375037,0.0,0.0
3389,0,3389,[303 316 272 211 276],90,5,13880,4.094395280235989,20.0,40.0
3390,0,3390,[303 316 272 211 276],13,5,13885,4.094662341492185,20.0,40.0
3391,0,3391,[303 316 272 211 276],13,5,13890,4.094929245283019,20.0,40.0
3392,0,3392,[303 316 272 211 276],13,5,13895,4.095195991747716,20.0,40.0
3393,0,3393,[303 316 272 211 276],13,5,13900,4.0954625810253384,20.0,40.0
3394,0,3394,[303 316 272 211 276],90,5,13905,4.095729013254786,20.0,40.0
3395,0,3395,[209 243 301 236 221],234,1,13906,4.0948174322732624,0.0,0.0
3396,0,3396,[303 316 272 211 276],90,5,13911,4.095083897556668,20.0,40.0
3397,0,3397,[303 316 272 211 276],13,5,13916,4.095350206003531,20.0,40.0
3398,0,3398,[367 485 301 239 222],524,2,13918,4.094733745219182,0.0,20.0
3399,0,3399,[303 316 272 211 276],90,5,13923,4.095,20.0,40.0
3400,0,3400,[241 222 367 208 202],82,2,13925,4.094384004704499,0.0,20.0
3401,0,3401,[303 316 272 211 276],90,5,13930,4.094650205761317,20.0,40.0
3402,0,3402,[291 240 208 202 293],533,2,13932,4.094034675286512,0.0,0.0
3403,0,3403,[303 316 272 211 276],13,5,13937,4.094300822561692,20.0,40.0
3404,0,3404,[303 316 272 211 276],13,5,13942,4.0945668135095445,20.0,40.0
3405,0,3405,[303 316 272 211 276],90,5,13947,4.094832648267762,20.0,40.0
3406,0,3406,[250 293 299 283 275],894,3,13950,4.094511300264162,0.0,20.0
3407,0,3407,[290 300 226 478 218],234,0,13950,4.09330985915493,0.0,20.0
3408,0,3408,[303 316 272 211 276],90,5,13955,4.093575828688765,20.0,40.0
3409,0,3409,[303 316 272 211 276],90,5,13960,4.093841642228739,20.0,40.0
3410,0,3410,[303 316 272 211 276],90,5,13965,4.094107299912049,20.0,40.0
3411,0,3411,[264 209 431 239 226],13,3,13968,4.093786635404455,0.0,0.0
3412,0,3412,[303 316 272 211 276],90,5,13973,4.094052153530618,20.0,40.0
3413,0,3413,[303 316 272 211 276],13,5,13978,4.094317516110134,20.0,40.0
3414,0,3414,[303 316 272 211 276],90,5,13983,4.094582723279649,20.0,40.0
3415,0,3415,[303 429 239 202 230],537,1,13984,4.0936768149882905,0.0,0.0
3416,0,3416,[303 316 272 211 276],13,5,13989,4.093942054433714,20.0,40.0
3417,0,3417,[300 324 508 272 217],334,2,13991,4.093329432416618,0.0,20.0
3418,0,3418,[303 316 272 211 276],90,5,13996,4.093594618309448,20.0,40.0
3419,0,3419,[303 316 272 211 276],13,5,14001,4.093859649122807,20.0,40.0
3420,0,3420,[303 316 272 211 276],13,5,14006,4.094124524992692,20.0,40.0
3421,0,3421,[303 316 272 211 276],13,5,14011,4.094389246054939,20.0,40.0
3422,0,3422,[485 219 213 215 216],7,3,14014,4.0940695296523515,0.0,0.0
3423,0,3423,[303 316 272 211 276],90,5,14019,4.094334112149533,20.0,40.0
3424,0,3424,[303 316 272 211 276],13,5,14024,4.094598540145985,20.0,40.0
3425,0,3425,[452 217 202 331 226],145,1,14025,4.093695271453591,0.0,0.0
3426,0,3426,[303 316 272 211 276],13,5,14030,4.093959731543624,20.0,40.0
3427,0,3427,[303 316 272 211 276],13,5,14035,4.094224037339557,20.0,40.0
3428,0,3428,[303 316 272 211 276],90,5,14040,4.094488188976378,20.0,40.0
3429,0,3429,[303 316 272 211 276],90,5,14045,4.094752186588921,20.0,40.0
3430,0,3430,[298 213 284 254 241],378,2,14047,4.094141649664821,0.0,0.0
3431,0,3431,[303 316 272 211 276],90,5,14052,4.094405594405594,20.0,40.0
3432,0,3432,[303 316 272 211 276],90,5,14057,4.094669385377221,20.0,40.0
3433,0,3433,[301 507 316 239 276],13,3,14060,4.094350611531741,20.0,20.0
3434,0,3434,[303 316 272 211 276],13,5,14065,4.094614264919942,20.0,40.0
3435,0,3435,[321 211 429 283 291],234,1,14066,4.09371362048894,0.0,20.0
3436,0,3436,[300 367 230 243 315],13,1,14067,4.092813500145476,20.0,20.0
3437,0,3437,[303 316 272 211 276],90,5,14072,4.093077370564282,20.0,40.0
3438,0,3438,[291 413 226 231 295],648,2,14074,4.0924687409130565,0.0,0.0
3439,0,3439,[303 316 272 211 276],90,5,14079,4.092732558139535,20.0,40.0
3440,0,3440,[300 250 326 378 291],749,4,14083,4.092705608834641,0.0,20.0
3441,0,3441,[303 316 272 211 276],13,5,14088,4.092969203951191,20.0,40.0
3442,0,3442,[303 316 272 211 276],13,5,14093,4.093232645948301,20.0,40.0
3443,0,3443,[291 209 212 290 583],524,4,14097,4.093205574912892,0.0,0.0
3444,0,3444,[303 316 272 211 276],13,5,14102,4.093468795355588,20.0,40.0
3445,0,3445,[303 316 272 211 276],13,5,14107,4.0937318630296,20.0,40.0
3446,0,3446,[303 316 272 211 276],13,5,14112,4.093994778067885,20.0,40.0
3447,0,3447,[303 316 272 211 276],90,5,14117,4.094257540603248,20.0,40.0
3448,0,3448,[276 239 336 280 231],13,3,14120,4.093940272542766,0.0,20.0
3449,0,3449,[303 316 272 211 276],90,5,14125,4.094202898550725,20.0,40.0
3450,0,3450,[303 316 272 211 276],13,5,14130,4.094465372355839,20.0,40.0
3451,0,3451,[241 350 218 481 367],13,0,14130,4.093279258400927,0.0,0.0
3452,0,3452,[303 316 272 211 276],90,5,14135,4.093541847668694,20.0,40.0
3453,0,3453,[303 316 272 211 276],13,5,14140,4.093804284887088,20.0,40.0
3454,0,3454,[303 316 272 211 276],90,5,14145,4.094066570188133,20.0,40.0
3455,0,3455,[303 316 272 211 276],90,5,14150,4.094328703703703,20.0,40.0
3456,0,3456,[303 316 272 211 276],13,5,14155,4.094590685565519,20.0,40.0
3457,0,3457,[478 226 223 208 209],194,1,14156,4.093695777906304,20.0,0.0
3458,0,3458,[303 316 272 211 276],13,5,14161,4.093957791269153,20.0,40.0
3459,0,3459,[232 268 384 420 394],13,2,14163,4.093352601156069,0.0,0.0
3460,0,3460,[303 316 272 211 276],13,5,14168,4.093614562265241,20.0,40.0
3461,0,3461,[209 250 220 283 429],334,2,14170,4.093009820912767,0.0,0.0
3462,0,3462,[303 316 272 211 276],13,5,14175,4.093271729714121,20.0,40.0
3463,0,3463,[303 316 272 211 276],90,5,14180,4.093533487297922,20.0,40.0
3464,0,3464,[303 316 272 211 276],90,5,14185,4.0937950937950935,20.0,40.0
3465,0,3465,[303 316 272 211 276],13,5,14190,4.094056549336411,20.0,40.0
3466,0,3466,[226 367 217 420 230],378,1,14191,4.093164118834728,0.0,0.0
3467,0,3467,[326 298 231 250 240],749,3,14194,4.09284890426759,0.0,0.0
3468,0,3468,[211 293 201 232 230],387,3,14197,4.092533871432689,0.0,20.0
3469,0,3469,[509 290 217 215 452],650,0,14197,4.09135446685879,0.0,0.0
3470,0,3470,[303 316 272 211 276],13,5,14202,4.091616248919619,20.0,40.0
3471,0,3471,[303 316 272 211 276],13,5,14207,4.091877880184332,20.0,40.0
3472,0,3472,[303 316 272 211 276],13,5,14212,4.092139360783184,20.0,40.0
3473,0,3473,[303 316 272 211 276],13,5,14217,4.092400690846286,20.0,40.0
3474,0,3474,[303 316 272 211 276],90,5,14222,4.092661870503597,20.0,40.0
3475,0,3475,[303 316 272 211 276],90,5,14227,4.092922899884925,20.0,40.0
3476,0,3476,[241 300 367 209 321],311,1,14228,4.092033362093759,0.0,20.0
3477,0,3477,[303 316 272 211 276],13,5,14233,4.092294422081656,20.0,40.0
3478,0,3478,[303 316 272 211 276],13,5,14238,4.092555331991952,20.0,40.0
3479,0,3479,[303 316 272 211 276],90,5,14243,4.092816091954023,20.0,40.0
3480,0,3480,[485 290 326 211 507],13,2,14245,4.092214880781385,0.0,20.0
3481,0,3481,[215 300 283 239 206],537,1,14246,4.091326823664561,0.0,20.0
3482,0,3482,[420 300 226 223 232],13,3,14249,4.09101349411427,20.0,20.0
3483,0,3483,[452 201 215 202 230],308,3,14252,4.090700344431688,0.0,0.0
3484,0,3484,[303 316 272 211 276],13,5,14257,4.090961262553802,20.0,40.0
3485,0,3485,[303 316 272 211 276],90,5,14262,4.091222030981067,20.0,40.0
3486,0,3486,[300 413 219 261 344],13,0,14262,4.09004875250932,0.0,20.0
3487,0,3487,[303 316 272 211 276],90,5,14267,4.090309633027523,20.0,40.0
3488,0,3488,[303 316 272 211 276],13,5,14272,4.090570364001146,20.0,40.0
3489,0,3489,[303 316 272 211 276],13,5,14277,4.090830945558739,20.0,40.0
3490,0,3490,[509 290 215 241 218],13,3,14280,4.090518476081352,0.0,0.0
3491,0,3491,[485 211 230 213 295],479,3,14283,4.09020618556701,0.0,20.0
3492,0,3492,[303 316 272 211 276],90,5,14288,4.090466647580876,20.0,40.0
3493,0,3493,[303 316 272 211 276],13,5,14293,4.090726960503721,20.0,40.0
3494,0,3494,[303 316 272 211 276],13,5,14298,4.09098712446352,20.0,40.0
3495,0,3495,[303 316 272 211 276],13,5,14303,4.0912471395881,20.0,40.0
3496,0,3496,[303 316 272 211 276],13,5,14308,4.0915070060051475,20.0,40.0
3497,0,3497,[303 316 272 211 276],90,5,14313,4.091766723842196,20.0,40.0
3498,0,3498,[303 316 272 211 276],90,5,14318,4.0920262932266365,20.0,40.0
3499,0,3499,[261 429 272 243 227],13,3,14321,4.091714285714286,0.0,0.0
3500,0,3500,[303 316 272 211 276],13,5,14326,4.0919737217937735,20.0,40.0
3501,0,3501,[478 315 230 218 202],13,3,14329,4.0916619074814395,20.0,0.0
3502,0,3502,[303 316 272 211 276],13,5,14334,4.091921210391093,20.0,40.0
3503,0,3503,[485 254 384 201 221],385,3,14337,4.091609589041096,0.0,0.0
3504,0,3504,[303 316 272 211 276],90,5,14342,4.091868758915835,20.0,40.0
3505,0,3505,[429 202 218 300 299],13,2,14344,4.091272104962921,0.0,20.0
3506,0,3506,[303 316 272 211 276],13,5,14349,4.09153122326775,20.0,40.0
3507,0,3507,[481 232 209 215 243],13,1,14350,4.090649942987457,0.0,0.0
3508,0,3508,[303 316 272 211 276],13,5,14355,4.090909090909091,20.0,40.0
3509,0,3509,[244 275 283 217 216],158,4,14359,4.090883190883191,0.0,20.0
3510,0,3510,[217 222 219 208 272],13,2,14361,4.0902876673312445,0.0,20.0
3511,0,3511,[303 316 272 211 276],13,5,14366,4.090546697038724,20.0,40.0
3512,0,3512,[303 316 272 211 276],90,5,14371,4.090805579276971,20.0,40.0
3513,0,3513,[303 316 272 211 276],90,5,14376,4.091064314171884,20.0,40.0
3514,0,3514,[321 394 227 275 350],13,1,14377,4.0901849217638695,0.0,20.0
3515,0,3515,[485 243 429 208 300],13,2,14379,4.089590443686006,0.0,20.0
3516,0,3516,[303 316 272 211 276],13,5,14384,4.0898493033835654,20.0,40.0
3517,0,3517,[303 316 272 211 276],13,5,14389,4.090108015918135,20.0,40.0
3518,0,3518,[291 226 429 326 241],788,4,14393,4.090082409775504,0.0,0.0
3519,0,3519,[240 202 227 215 431],804,5,14398,4.0903409090909095,0.0,0.0
3520,0,3520,[321 284 298 255 239],308,3,14401,4.090031241124681,0.0,0.0
3521,0,3521,[222 241 239 219 202],92,3,14404,4.089721749006246,0.0,20.0
3522,0,3522,[223 336 413 218 452],13,1,14405,4.088844734601192,20.0,0.0
3523,0,3523,[303 316 272 211 276],90,5,14410,4.089103291713961,20.0,40.0
3524,0,3524,[303 316 272 211 276],13,5,14415,4.089361702127659,20.0,40.0
3525,0,3525,[303 316 272 211 276],13,5,14420,4.089619965967102,20.0,40.0
3526,0,3526,[303 316 272 211 276],13,5,14425,4.089878083356961,20.0,40.0
3527,0,3527,[303 316 272 211 276],90,5,14430,4.090136054421769,20.0,40.0
3528,0,3528,[303 316 272 211 276],13,5,14435,4.090393879285917,20.0,40.0
3529,0,3529,[303 316 272 211 276],13,5,14440,4.090651558073654,20.0,40.0
3530,0,3530,[303 316 272 211 276],90,5,14445,4.090909090909091,20.0,40.0
3531,0,3531,[303 316 272 211 276],90,5,14450,4.091166477916195,20.0,40.0
3532,0,3532,[303 316 272 211 276],90,5,14455,4.0914237192187946,20.0,40.0
3533,0,3533,[303 316 272 211 276],90,5,14460,4.0916808149405774,20.0,40.0
3534,0,3534,[259 254 452 239 298],308,1,14461,4.090806223479491,0.0,0.0
3535,0,3535,[303 316 272 211 276],13,5,14466,4.09106334841629,20.0,40.0
3536,0,3536,[303 316 272 211 276],13,5,14471,4.091320327961549,20.0,40.0
3537,0,3537,[303 316 272 211 276],90,5,14476,4.091577162238553,20.0,40.0
3538,0,3538,[303 316 272 211 276],90,5,14481,4.091833851370444,20.0,40.0
3539,0,3539,[303 316 272 211 276],13,5,14486,4.092090395480226,20.0,40.0
3540,0,3540,[303 316 272 211 276],13,5,14491,4.092346794690766,20.0,40.0
3541,0,3541,[315 212 241 226 276],883,3,14494,4.092038396386222,20.0,20.0
3542,0,3542,[303 316 272 211 276],90,5,14499,4.09229466553768,20.0,40.0
3543,0,3543,[284 208 321 365 259],308,2,14501,4.091704288939052,0.0,0.0
3544,0,3544,[303 316 272 211 276],13,5,14506,4.091960507757404,20.0,40.0
3545,0,3545,[303 316 272 211 276],90,5,14511,4.092216582064298,20.0,40.0
3546,0,3546,[508 392 284 208 220],59,2,14513,4.0916267268113895,0.0,0.0
3547,0,3547,[259 231 481 227 429],7,2,14515,4.091037204058624,0.0,0.0
3548,0,3548,[303 316 272 211 276],90,5,14520,4.091293322062553,20.0,40.0
3549,0,3549,[303 316 272 211 276],90,5,14525,4.091549295774648,20.0,40.0
3550,0,3550,[303 316 272 211 276],90,5,14530,4.091805125316812,20.0,40.0
3551,0,3551,[303 316 272 211 276],90,5,14535,4.0920608108108105,20.0,40.0
3552,0,3552,[303 316 272 211 276],90,5,14540,4.092316352378272,20.0,40.0
3553,0,3553,[303 316 272 211 276],90,5,14545,4.092571750140687,20.0,40.0
3554,0,3554,[303 316 272 211 276],13,5,14550,4.0928270042194095,20.0,40.0
3555,0,3555,[303 316 272 211 276],13,5,14555,4.093082114735658,20.0,40.0
3556,0,3556,[367 452 219 208 226],13,2,14557,4.092493674444757,0.0,0.0
3557,0,3557,[284 507 295 211 509],308,3,14560,4.092186621697583,0.0,20.0
3558,0,3558,[303 316 272 211 276],13,5,14565,4.0924416971059285,20.0,40.0
3559,0,3559,[222 259 431 202 211],194,2,14567,4.09185393258427,0.0,40.0
3560,0,3560,[303 316 272 211 276],90,5,14572,4.092108958157821,20.0,40.0
3561,0,3561,[250 276 290 208 230],334,3,14575,4.091802358225716,0.0,20.0
3562,0,3562,[303 316 272 211 276],13,5,14580,4.092057255122088,20.0,40.0
3563,0,3563,[303 316 272 211 276],13,5,14585,4.092312008978675,20.0,40.0
3564,0,3564,[303 316 272 211 276],13,5,14590,4.092566619915848,20.0,40.0
3565,0,3565,[303 316 272 211 276],13,5,14595,4.092821088053842,20.0,40.0
3566,0,3566,[202 201 209 452 227],13,2,14597,4.092234370619568,0.0,0.0
3567,0,3567,[303 316 272 211 276],90,5,14602,4.0924887892376685,20.0,40.0
3568,0,3568,[303 316 272 211 276],90,5,14607,4.0927430652843935,20.0,40.0
3569,0,3569,[209 431 227 216 239],92,3,14610,4.092436974789916,0.0,0.0
3570,0,3570,[326 217 216 507 344],13,0,14610,4.09129095491459,0.0,0.0
3571,0,3571,[303 316 272 211 276],13,5,14615,4.0915453527435615,20.0,40.0
3572,0,3572,[303 316 272 211 276],13,5,14620,4.091799608172404,20.0,40.0
3573,0,3573,[303 316 272 211 276],13,5,14625,4.092053721320649,20.0,40.0
3574,0,3574,[303 316 272 211 276],13,5,14630,4.092307692307692,20.0,40.0
3575,0,3575,[231 239 218 420 215],13,3,14633,4.092002237136465,0.0,0.0
3576,0,3576,[303 316 272 211 276],90,5,14638,4.092256080514398,20.0,40.0
3577,0,3577,[251 283 315 226 275],883,3,14641,4.091950810508664,40.0,20.0
3578,0,3578,[241 243 321 230 226],387,0,14641,4.090807488125175,0.0,0.0
3579,0,3579,[481 239 280 321 227],13,3,14644,4.090502793296089,0.0,0.0
3580,0,3580,[303 316 272 211 276],13,5,14649,4.090756771851438,20.0,40.0
3581,0,3581,[303 316 272 211 276],13,5,14654,4.091010608598548,20.0,40.0
3582,0,3582,[250 202 209 239 231],899,2,14656,4.090427016466648,0.0,0.0
3583,0,3583,[303 316 272 211 276],13,5,14661,4.090680803571429,20.0,40.0
3584,0,3584,[303 316 272 211 276],90,5,14666,4.090934449093445,20.0,40.0
3585,0,3585,[303 316 272 211 276],13,5,14671,4.0911879531511435,20.0,40.0
3586,0,3586,[275 326 284 255 303],894,2,14673,4.090604962364092,0.0,20.0
3587,0,3587,[259 211 241 272 208],537,3,14676,4.090301003344481,0.0,20.0
3588,0,3588,[303 316 272 211 276],13,5,14681,4.090554471997771,20.0,40.0
3589,0,3589,[303 316 272 211 276],90,5,14686,4.090807799442897,20.0,40.0
3590,0,3590,[303 316 272 211 276],13,5,14691,4.091060985797828,20.0,40.0
3591,0,3591,[303 316 272 211 276],90,5,14696,4.091314031180401,20.0,40.0
3592,0,3592,[303 316 272 211 276],13,5,14701,4.091566935708322,20.0,40.0
3593,0,3593,[303 316 272 211 276],90,5,14706,4.091819699499165,20.0,40.0
3594,0,3594,[303 316 272 211 276],13,5,14711,4.092072322670376,20.0,40.0
3595,0,3595,[378 230 243 226 291],804,4,14715,4.092046718576196,0.0,0.0
3596,0,3596,[303 316 272 211 276],13,5,14720,4.092299138170698,20.0,40.0
3597,0,3597,[303 316 272 211 276],90,5,14725,4.092551417454141,20.0,40.0
3598,0,3598,[275 508 244 293 283],334,2,14727,4.091969991664351,0.0,20.0
3599,0,3599,[303 316 272 211 276],13,5,14732,4.092222222222222,20.0,40.0
3600,0,3600,[303 316 272 211 276],90,5,14737,4.0924743126909195,20.0,40.0
3601,0,3601,[481 223 202 226 213],308,4,14741,4.092448639644642,20.0,0.0
3602,0,3602,[303 316 272 211 276],13,5,14746,4.092700527338329,20.0,40.0
3603,0,3603,[303 316 272 211 276],13,5,14751,4.092952275249723,20.0,40.0
3604,0,3604,[303 316 272 211 276],13,5,14756,4.093203883495145,20.0,40.0
3605,0,3605,[303 316 272 211 276],13,5,14761,4.0934553521907935,20.0,40.0
3606,0,3606,[303 316 272 211 276],90,5,14766,4.093706681452731,20.0,40.0
3607,0,3607,[303 316 272 211 276],13,5,14771,4.093957871396896,20.0,40.0
3608,0,3608,[303 316 272 211 276],90,5,14776,4.094208922139097,20.0,40.0
3609,0,3609,[303 316 272 211 276],90,5,14781,4.094459833795014,20.0,40.0
3610,0,3610,[303 316 272 211 276],90,5,14786,4.0947106064801995,20.0,40.0
3611,0,3611,[303 316 272 211 276],90,5,14791,4.094961240310077,20.0,40.0
3612,0,3612,[303 316 272 211 276],90,5,14796,4.095211735399944,20.0,40.0
3613,0,3613,[254 295 283 300 255],548,3,14799,4.094908688433868,0.0,20.0
3614,0,3614,[218 223 232 222 209],13,1,14800,4.094052558782849,20.0,20.0
3615,0,3615,[303 316 272 211 276],90,5,14805,4.094303097345133,20.0,40.0
3616,0,3616,[303 316 272 211 276],90,5,14810,4.094553497373514,20.0,40.0
3617,0,3617,[303 316 272 211 276],13,5,14815,4.094803758982864,20.0,40.0
3618,0,3618,[303 316 272 211 276],90,5,14820,4.0950538822879246,20.0,40.0
3619,0,3619,[201 223 259 452 202],308,3,14823,4.094751381215469,20.0,0.0
3620,0,3620,[478 217 301 315 485],650,1,14824,4.093896713615023,20.0,0.0
3621,0,3621,[303 316 272 211 276],13,5,14829,4.094146880176698,20.0,40.0
3622,0,3622,[420 216 261 384 509],13,2,14831,4.09356886558101,0.0,0.0
3623,0,3623,[303 316 272 211 276],13,5,14836,4.093818984547461,20.0,40.0
3624,0,3624,[303 316 272 211 276],90,5,14841,4.094068965517241,20.0,40.0
3625,0,3625,[481 478 211 209 246],6,4,14845,4.094043022614451,0.0,20.0
3626,0,3626,[303 316 272 211 276],13,5,14850,4.094292803970223,20.0,40.0
3627,0,3627,[284 213 485 230 212],85,2,14852,4.093715545755237,0.0,0.0
3628,0,3628,[303 316 272 211 276],13,5,14857,4.093965279691375,20.0,40.0
3629,0,3629,[303 316 272 211 276],13,5,14862,4.094214876033058,20.0,40.0
3630,0,3630,[275 429 208 431 211],406,2,14864,4.093638116221427,0.0,40.0
3631,0,3631,[303 316 272 211 276],13,5,14869,4.093887665198238,20.0,40.0
3632,0,3632,[303 316 272 211 276],13,5,14874,4.094137076796036,20.0,40.0
3633,0,3633,[303 316 272 211 276],90,5,14879,4.094386351128233,20.0,40.0
3634,0,3634,[303 316 272 211 276],13,5,14884,4.094635488308116,20.0,40.0
3635,0,3635,[303 316 272 211 276],90,5,14889,4.0948844884488445,20.0,40.0
3636,0,3636,[303 316 272 211 276],13,5,14894,4.095133351663459,20.0,40.0
3637,0,3637,[303 316 272 211 276],13,5,14899,4.095382078064871,20.0,40.0
3638,0,3638,[303 316 272 211 276],13,5,14904,4.09563066776587,20.0,40.0
3639,0,3639,[303 316 272 211 276],13,5,14909,4.095879120879121,20.0,40.0
3640,0,3640,[268 350 299 241 215],13,2,14911,4.095303488052733,0.0,0.0
3641,0,3641,[303 316 272 211 276],90,5,14916,4.095551894563426,20.0,40.0
3642,0,3642,[303 316 272 211 276],13,5,14921,4.0958001646994235,20.0,40.0
3643,0,3643,[303 316 272 211 276],90,5,14926,4.096048298572997,20.0,40.0
3644,0,3644,[303 316 272 211 276],13,5,14931,4.0962962962962965,20.0,40.0
3645,0,3645,[218 239 232 321 367],194,1,14932,4.095447065277016,0.0,0.0
3646,0,3646,[303 316 272 211 276],90,5,14937,4.09569509185632,20.0,40.0
3647,0,3647,[303 316 272 211 276],13,5,14942,4.09594298245614,20.0,40.0
3648,0,3648,[344 250 246 298 303],392,3,14945,4.095642641819676,0.0,0.0
3649,0,3649,[303 316 272 211 276],90,5,14950,4.095890410958904,20.0,40.0
3650,0,3650,[303 316 272 211 276],13,5,14955,4.096138044371405,20.0,40.0
3651,0,3651,[303 316 272 211 276],90,5,14960,4.096385542168675,20.0,40.0
3652,0,3652,[303 316 272 211 276],13,5,14965,4.096632904462086,20.0,40.0
3653,0,3653,[226 219 280 206 367],234,2,14967,4.096059113300493,0.0,0.0
3654,0,3654,[303 316 272 211 276],13,5,14972,4.096306429548564,20.0,40.0
3655,0,3655,[303 316 272 211 276],13,5,14977,4.096553610503283,20.0,40.0
3656,0,3656,[303 316 272 211 276],90,5,14982,4.096800656275636,20.0,40.0
3657,0,3657,[303 316 272 211 276],13,5,14987,4.09704756697649,20.0,40.0
3658,0,3658,[303 316 272 211 276],13,5,14992,4.097294342716589,20.0,40.0
3659,0,3659,[303 316 272 211 276],90,5,14997,4.0975409836065575,20.0,40.0
3660,0,3660,[230 209 212 223 507],194,2,14999,4.096968041518711,20.0,0.0
3661,0,3661,[284 222 508 230 321],537,1,15000,4.09612233752048,0.0,20.0
3662,0,3662,[303 316 272 211 276],13,5,15005,4.096369096369096,20.0,40.0
3663,0,3663,[303 316 272 211 276],13,5,15010,4.096615720524017,20.0,40.0
3664,0,3664,[303 316 272 211 276],13,5,15015,4.096862210095498,20.0,40.0
3665,0,3665,[303 316 272 211 276],90,5,15020,4.097108565193672,20.0,40.0
3666,0,3666,[431 212 208 219 223],7,3,15023,4.096809380965367,20.0,0.0
3667,0,3667,[303 316 272 211 276],13,5,15028,4.097055616139586,20.0,40.0
3668,0,3668,[303 316 272 211 276],13,5,15033,4.097301717089125,20.0,40.0
3669,0,3669,[303 316 272 211 276],90,5,15038,4.097547683923706,20.0,40.0
3670,0,3670,[303 316 272 211 276],90,5,15043,4.097793516752929,20.0,40.0
3671,0,3671,[303 316 272 211 276],13,5,15048,4.098039215686274,20.0,40.0
3672,0,3672,[303 316 272 211 276],13,5,15053,4.098284780833106,20.0,40.0
3673,0,3673,[303 316 272 211 276],90,5,15058,4.098530212302667,20.0,40.0
3674,0,3674,[284 213 226 275 216],378,3,15061,4.098231292517007,0.0,20.0
3675,0,3675,[303 316 272 211 276],13,5,15066,4.098476605005441,20.0,40.0
3676,0,3676,[303 316 272 211 276],90,5,15071,4.098721784063095,20.0,40.0
3677,0,3677,[303 316 272 211 276],13,5,15076,4.098966829798804,20.0,40.0
3678,0,3678,[303 316 272 211 276],13,5,15081,4.099211742321283,20.0,40.0
3679,0,3679,[303 316 272 211 276],90,5,15086,4.09945652173913,20.0,40.0
3680,0,3680,[420 276 316 275 509],13,4,15090,4.099429502852486,20.0,40.0
3681,0,3681,[303 316 272 211 276],90,5,15095,4.099674090168387,20.0,40.0
3682,0,3682,[303 316 272 211 276],13,5,15100,4.099918544664676,20.0,40.0
3683,0,3683,[303 316 272 211 276],13,5,15105,4.100162866449511,20.0,40.0
3684,0,3684,[216 223 284 241 222],234,0,15105,4.099050203527815,20.0,20.0
3685,0,3685,[303 316 272 211 276],13,5,15110,4.099294628323386,20.0,40.0
3686,0,3686,[212 240 276 217 301],145,2,15112,4.0987252508814755,0.0,20.0
3687,0,3687,[208 365 213 259 264],7,3,15115,4.098427331887201,0.0,0.0
3688,0,3688,[303 316 272 211 276],90,5,15120,4.098671726755218,20.0,40.0
3689,0,3689,[303 316 272 211 276],13,5,15125,4.098915989159892,20.0,40.0
3690,0,3690,[303 316 272 211 276],90,5,15130,4.099160119208887,20.0,40.0
3691,0,3691,[303 316 272 211 276],90,5,15135,4.099404117009751,20.0,40.0
3692,0,3692,[384 211 452 336 202],13,2,15137,4.098835634985107,0.0,20.0
3693,0,3693,[303 316 272 211 276],13,5,15142,4.099079588521928,20.0,40.0
3694,0,3694,[420 509 215 222 392],378,3,15145,4.098782138024357,0.0,20.0
3695,0,3695,[276 301 250 508 275],413,3,15148,4.098484848484849,0.0,40.0
3696,0,3696,[303 316 272 211 276],90,5,15153,4.098728698945091,20.0,40.0
3697,0,3697,[303 316 272 211 276],90,5,15158,4.098972417522986,20.0,40.0
3698,0,3698,[264 272 284 413 291],548,2,15160,4.098404974317383,0.0,0.0
3699,0,3699,[303 316 272 211 276],90,5,15165,4.098648648648648,20.0,40.0
3700,0,3700,[303 316 272 211 276],13,5,15170,4.098892191299648,20.0,40.0
3701,0,3701,[223 232 284 215 316],328,2,15172,4.098325229605619,40.0,0.0
3702,0,3702,[303 316 272 211 276],90,5,15177,4.098568728058331,20.0,40.0
3703,0,3703,[231 295 508 216 208],92,2,15179,4.098002159827214,0.0,0.0
3704,0,3704,[303 316 272 211 276],13,5,15184,4.098245614035088,20.0,40.0
3705,0,3705,[431 216 208 429 227],7,4,15188,4.098219104155423,0.0,0.0
3706,0,3706,[303 316 272 211 276],90,5,15193,4.098462368492042,20.0,40.0
3707,0,3707,[241 293 208 222 232],387,2,15195,4.09789644012945,0.0,20.0
3708,0,3708,[303 316 272 211 276],90,5,15200,4.098139660285791,20.0,40.0
3709,0,3709,[390 301 283 211 236],279,3,15203,4.0978436657681945,0.0,20.0
3710,0,3710,[303 316 272 211 276],13,5,15208,4.098086769064942,20.0,40.0
3711,0,3711,[303 316 272 211 276],13,5,15213,4.0983297413793105,20.0,40.0
3712,0,3712,[303 316 272 211 276],13,5,15218,4.098572582817129,20.0,40.0
3713,0,3713,[303 316 272 211 276],13,5,15223,4.098815293484114,20.0,40.0
3714,0,3714,[303 316 272 211 276],90,5,15228,4.099057873485868,20.0,40.0
3715,0,3715,[303 316 272 211 276],90,5,15233,4.0993003229278795,20.0,40.0
3716,0,3716,[303 316 272 211 276],90,5,15238,4.099542641915523,20.0,40.0
3717,0,3717,[298 365 227 321 509],378,1,15239,4.098708983324368,0.0,0.0
3718,0,3718,[485 429 212 275 241],524,2,15241,4.098144662543694,0.0,20.0
3719,0,3719,[303 316 272 211 276],13,5,15246,4.098387096774194,20.0,40.0
3720,0,3720,[392 284 507 420 215],308,3,15249,4.098091910776673,0.0,0.0
3721,0,3721,[303 316 272 211 276],13,5,15254,4.098334228909189,20.0,40.0
3722,0,3722,[303 316 272 211 276],13,5,15259,4.098576416868117,20.0,40.0
3723,0,3723,[303 316 272 211 276],13,5,15264,4.098818474758325,20.0,40.0
3724,0,3724,[240 216 230 431 392],59,3,15267,4.0985234899328855,0.0,0.0
3725,0,3725,[303 316 272 211 276],13,5,15272,4.098765432098766,20.0,40.0
3726,0,3726,[303 316 272 211 276],13,5,15277,4.09900724443252,20.0,40.0
3727,0,3727,[303 316 272 211 276],13,5,15282,4.0992489270386265,20.0,40.0
3728,0,3728,[303 316 272 211 276],90,5,15287,4.099490480021453,20.0,40.0
3729,0,3729,[303 316 272 211 276],90,5,15292,4.099731903485255,20.0,40.0
3730,0,3730,[303 316 272 211 276],13,5,15297,4.099973197534173,20.0,40.0
3731,0,3731,[303 316 272 211 276],13,5,15302,4.10021436227224,20.0,40.0
3732,0,3732,[303 316 272 211 276],13,5,15307,4.100455397803375,20.0,40.0
3733,0,3733,[232 336 215 223 507],13,2,15309,4.0998928762720945,20.0,0.0
3734,0,3734,[303 316 272 211 276],13,5,15314,4.100133868808568,20.0,40.0
3735,0,3735,[303 316 272 211 276],90,5,15319,4.100374732334047,20.0,40.0
3736,0,3736,[303 316 272 211 276],13,5,15324,4.1006154669521,20.0,40.0
3737,0,3737,[264 250 299 298 297],486,1,15325,4.099785981808454,20.0,0.0
3738,0,3738,[303 316 272 211 276],13,5,15330,4.100026745119016,20.0,40.0
3739,0,3739,[275 231 429 216 222],648,4,15334,4.1,0.0,40.0
3740,0,3740,[303 316 272 211 276],13,5,15339,4.100240577385725,20.0,40.0
3741,0,3741,[303 316 272 211 276],90,5,15344,4.100481026189204,20.0,40.0
3742,0,3742,[303 316 272 211 276],90,5,15349,4.100721346513492,20.0,40.0
3743,0,3743,[303 316 272 211 276],90,5,15354,4.100961538461538,20.0,40.0
3744,0,3744,[303 316 272 211 276],90,5,15359,4.1012016021361815,20.0,40.0
3745,0,3745,[216 220 324 293 231],334,1,15360,4.100373731980779,0.0,0.0
3746,0,3746,[303 316 272 211 276],90,5,15365,4.100613824392847,20.0,40.0
3747,0,3747,[303 316 272 211 276],90,5,15370,4.1008537886873,20.0,40.0
3748,0,3748,[272 230 291 246 301],85,3,15373,4.100560149373166,0.0,0.0
3749,0,3749,[250 413 217 293 226],145,2,15375,4.1,0.0,0.0
3750,0,3750,[303 316 272 211 276],13,5,15380,4.100239936017062,20.0,40.0
3751,0,3751,[272 202 212 315 284],537,2,15382,4.099680170575693,20.0,0.0
3752,0,3752,[250 431 413 283 239],279,3,15385,4.0993871569411136,0.0,0.0
3753,0,3753,[321 452 208 222 420],13,2,15387,4.098827916888652,0.0,20.0
3754,0,3754,[303 316 272 211 276],90,5,15392,4.099067909454061,20.0,40.0
3755,0,3755,[303 316 272 211 276],90,5,15397,4.099307774227902,20.0,40.0
3756,0,3756,[303 316 272 211 276],90,5,15402,4.099547511312217,20.0,40.0
3757,0,3757,[303 316 272 211 276],90,5,15407,4.099787120808941,20.0,40.0
3758,0,3758,[303 316 272 211 276],90,5,15412,4.100026602819899,20.0,40.0
3759,0,3759,[303 316 272 211 276],13,5,15417,4.100265957446808,20.0,40.0
3760,0,3760,[367 298 216 254 227],378,1,15418,4.099441637862271,0.0,0.0
3761,0,3761,[303 316 272 211 276],90,5,15423,4.0996810207336525,20.0,40.0
3762,0,3762,[303 316 272 211 276],90,5,15428,4.099920276375233,20.0,40.0
3763,0,3763,[303 316 272 211 276],13,5,15433,4.100159404888417,20.0,40.0
3764,0,3764,[300 384 201 452 272],13,1,15434,4.09933598937583,0.0,20.0
3765,0,3765,[303 316 272 211 276],90,5,15439,4.099575146043548,20.0,40.0
3766,0,3766,[303 316 272 211 276],13,5,15444,4.09981417573666,20.0,40.0
3767,0,3767,[303 316 272 211 276],90,5,15449,4.100053078556264,20.0,40.0
3768,0,3768,[344 211 232 452 275],13,1,15450,4.099230565136641,0.0,40.0
3769,0,3769,[303 316 272 211 276],13,5,15455,4.099469496021221,20.0,40.0
3770,0,3770,[254 508 213 420 223],378,4,15459,4.099443118536198,20.0,0.0
3771,0,3771,[303 316 272 211 276],90,5,15464,4.099681866383881,20.0,40.0
3772,0,3772,[303 316 272 211 276],13,5,15469,4.09992048767559,20.0,40.0
3773,0,3773,[303 316 272 211 276],13,5,15474,4.100158982511924,20.0,40.0
3774,0,3774,[226 243 261 420 429],13,3,15477,4.099867549668875,0.0,0.0
3775,0,3775,[303 316 272 211 276],13,5,15482,4.10010593220339,20.0,40.0
3776,0,3776,[209 276 509 367 213],406,2,15484,4.099549907333863,0.0,20.0
3777,0,3777,[303 316 272 211 276],90,5,15489,4.099788247750133,20.0,40.0
3778,0,3778,[303 316 272 211 276],90,5,15494,4.1000264620269915,20.0,40.0
3779,0,3779,[226 222 299 232 209],13,1,15495,4.099206349206349,0.0,20.0
3780,0,3780,[303 316 272 211 276],90,5,15500,4.099444591377942,20.0,40.0
3781,0,3781,[303 316 272 211 276],13,5,15505,4.0996827075621365,20.0,40.0
3782,0,3782,[243 226 208 209 231],650,1,15506,4.098863335976738,0.0,0.0
3783,0,3783,[303 316 272 211 276],90,5,15511,4.099101479915434,20.0,40.0
3784,0,3784,[303 316 272 211 276],90,5,15516,4.099339498018494,20.0,40.0
3785,0,3785,[303 316 272 211 276],90,5,15521,4.099577390385631,20.0,40.0
3786,0,3786,[303 316 272 211 276],13,5,15526,4.099815157116451,20.0,40.0
3787,0,3787,[303 316 272 211 276],13,5,15531,4.100052798310454,20.0,40.0
3788,0,3788,[206 241 239 222 236],537,0,15531,4.098970704671418,0.0,20.0
3789,0,3789,[303 316 272 211 276],90,5,15536,4.099208443271768,20.0,40.0
3790,0,3790,[365 507 485 431 264],7,5,15541,4.0994460564494855,0.0,0.0
3791,0,3791,[303 316 272 211 276],13,5,15546,4.099683544303797,20.0,40.0
3792,0,3792,[303 316 272 211 276],13,5,15551,4.099920906933826,20.0,40.0
3793,0,3793,[243 321 209 201 301],537,1,15552,4.099103848181339,0.0,0.0
3794,0,3794,[303 316 272 211 276],90,5,15557,4.099341238471673,20.0,40.0
3795,0,3795,[303 316 272 211 276],90,5,15562,4.099578503688092,20.0,40.0
3796,0,3796,[303 316 272 211 276],90,5,15567,4.099815643929418,20.0,40.0
3797,0,3797,[303 316 272 211 276],13,5,15572,4.100052659294366,20.0,40.0
3798,0,3798,[303 316 272 211 276],90,5,15577,4.1002895498815475,20.0,40.0
3799,0,3799,[218 275 280 227 316],13,3,15580,4.1,20.0,20.0
3800,0,3800,[303 316 272 211 276],90,5,15585,4.100236779794791,20.0,40.0
3801,0,3801,[211 290 280 300 243],13,3,15588,4.099947396107312,0.0,40.0
3802,0,3802,[303 316 272 211 276],90,5,15593,4.100184065211675,20.0,40.0
3803,0,3803,[298 301 365 254 217],378,0,15593,4.0991062039957935,0.0,0.0
3804,0,3804,[303 316 272 211 276],13,5,15598,4.099342969776609,20.0,40.0
3805,0,3805,[508 218 243 226 280],13,2,15600,4.098791382028376,0.0,0.0
3806,0,3806,[239 321 230 413 222],279,4,15604,4.098765432098766,0.0,20.0
3807,0,3807,[303 316 272 211 276],90,5,15609,4.099002100840337,20.0,40.0
3808,0,3808,[275 508 283 221 230],537,3,15612,4.098713573116304,0.0,20.0
3809,0,3809,[303 316 272 211 276],90,5,15617,4.098950131233596,20.0,40.0
3810,0,3810,[303 316 272 211 276],90,5,15622,4.099186565205983,20.0,40.0
3811,0,3811,[303 316 272 211 276],13,5,15627,4.0994228751311645,20.0,40.0
3812,0,3812,[303 316 272 211 276],90,5,15632,4.09965906110674,20.0,40.0
3813,0,3813,[303 316 272 211 276],13,5,15637,4.099895123230205,20.0,40.0
3814,0,3814,[303 316 272 211 276],90,5,15642,4.100131061598952,20.0,40.0
3815,0,3815,[303 316 272 211 276],90,5,15647,4.1003668763102725,20.0,40.0
3816,0,3816,[303 316 272 211 276],90,5,15652,4.100602567461357,20.0,40.0
3817,0,3817,[429 208 226 201 268],537,2,15654,4.1000523834468305,0.0,0.0
3818,0,3818,[303 316 272 211 276],13,5,15659,4.100288033516628,20.0,40.0
3819,0,3819,[211 268 232 583 215],7,2,15661,4.099738219895288,0.0,20.0
3820,0,3820,[223 284 241 222 291],788,3,15664,4.099450405652971,20.0,20.0
3821,0,3821,[321 293 206 222 431],387,3,15667,4.099162742019885,0.0,20.0
3822,0,3822,[227 268 275 216 241],13,2,15669,4.098613654198274,0.0,20.0
3823,0,3823,[303 316 272 211 276],90,5,15674,4.0988493723849375,20.0,40.0
3824,0,3824,[303 350 321 216 316],13,2,15676,4.098300653594771,20.0,0.0
3825,0,3825,[344 202 280 218 413],13,2,15678,4.097752221641401,0.0,0.0
3826,0,3826,[303 316 272 211 276],90,5,15683,4.097987980141102,20.0,40.0
3827,0,3827,[303 316 272 211 276],90,5,15688,4.0982236154649945,20.0,40.0
3828,0,3828,[293 250 350 331 324],294,5,15693,4.098459127709584,0.0,0.0
3829,0,3829,[303 316 272 211 276],90,5,15698,4.098694516971279,20.0,40.0
3830,0,3830,[211 290 259 321 230],524,1,15699,4.0978856695379795,0.0,20.0
3831,0,3831,[303 316 272 211 276],90,5,15704,4.09812108559499,20.0,40.0
3832,0,3832,[215 508 251 240 384],385,1,15705,4.097312809809549,20.0,0.0
3833,0,3833,[303 316 272 211 276],90,5,15710,4.0975482524778295,20.0,40.0
3834,0,3834,[232 413 209 218 208],13,1,15711,4.096740547588006,0.0,0.0
3835,0,3835,[303 316 272 211 276],13,5,15716,4.096976016684046,20.0,40.0
3836,0,3836,[303 316 272 211 276],90,5,15721,4.097211363044045,20.0,40.0
3837,0,3837,[303 316 272 211 276],90,5,15726,4.097446586763939,20.0,40.0
3838,0,3838,[303 316 272 211 276],13,5,15731,4.097681687939567,20.0,40.0
3839,0,3839,[255 216 211 215 431],479,2,15733,4.097135416666666,0.0,20.0
3840,0,3840,[303 316 272 211 276],13,5,15738,4.097370476438427,20.0,40.0
3841,0,3841,[303 316 272 211 276],13,5,15743,4.097605413846955,20.0,40.0
3842,0,3842,[303 316 272 211 276],13,5,15748,4.09784022898777,20.0,40.0
3843,0,3843,[303 316 272 211 276],90,5,15753,4.098074921956296,20.0,40.0
3844,0,3844,[303 316 272 211 276],90,5,15758,4.0983094928478545,20.0,40.0
3845,0,3845,[303 316 272 211 276],13,5,15763,4.09854394175767,20.0,40.0
3846,0,3846,[303 316 272 211 276],90,5,15768,4.098778268780868,20.0,40.0
3847,0,3847,[303 316 272 211 276],90,5,15773,4.099012474012474,20.0,40.0
3848,0,3848,[303 316 272 211 276],90,5,15778,4.099246557547415,20.0,40.0
3849,0,3849,[303 316 272 211 276],13,5,15783,4.09948051948052,20.0,40.0
3850,0,3850,[303 316 272 211 276],13,5,15788,4.099714359906518,20.0,40.0
3851,0,3851,[303 316 272 211 276],90,5,15793,4.0999480789200415,20.0,40.0
3852,0,3852,[303 316 272 211 276],13,5,15798,4.100181676615624,20.0,40.0
3853,0,3853,[303 316 272 211 276],90,5,15803,4.100415153087701,20.0,40.0
3854,0,3854,[303 316 272 211 276],13,5,15808,4.100648508430609,20.0,40.0
3855,0,3855,[303 316 272 211 276],90,5,15813,4.100881742738589,20.0,40.0
3856,0,3856,[365 219 202 300 431],7,3,15816,4.100596318382162,0.0,20.0
3857,0,3857,[303 316 272 211 276],90,5,15821,4.10082944530845,20.0,40.0
3858,0,3858,[303 316 272 211 276],90,5,15826,4.101062451412283,20.0,40.0
3859,0,3859,[284 209 213 481 211],6,4,15830,4.101036269430052,0.0,20.0
3860,0,3860,[303 316 272 211 276],13,5,15835,4.101269101269101,20.0,40.0
3861,0,3861,[303 316 272 211 276],90,5,15840,4.101501812532367,20.0,40.0
3862,0,3862,[303 316 272 211 276],13,5,15845,4.101734403313487,20.0,40.0
3863,0,3863,[431 301 218 232 243],650,0,15845,4.100672877846791,0.0,0.0
3864,0,3864,[303 316 272 211 276],13,5,15850,4.100905562742561,20.0,40.0
3865,0,3865,[303 316 272 211 276],13,5,15855,4.101138127263321,20.0,40.0
3866,0,3866,[303 316 272 211 276],90,5,15860,4.101370571502457,20.0,40.0
3867,0,3867,[431 222 216 226 239],92,3,15863,4.101085832471561,0.0,20.0
3868,0,3868,[303 316 272 211 276],13,5,15868,4.101318170069786,20.0,40.0
3869,0,3869,[303 316 272 211 276],13,5,15873,4.101550387596899,20.0,40.0
3870,0,3870,[384 208 413 431 481],13,1,15874,4.100749160423663,0.0,0.0
3871,0,3871,[509 316 507 431 211],13,3,15877,4.100464876033058,20.0,20.0
3872,0,3872,[303 316 272 211 276],13,5,15882,4.100697134004648,20.0,40.0
3873,0,3873,[303 316 272 211 276],90,5,15887,4.1009292720702115,20.0,40.0
3874,0,3874,[303 316 272 211 276],90,5,15892,4.1011612903225805,20.0,40.0
3875,0,3875,[209 208 239 367 268],13,3,15895,4.100877192982456,0.0,0.0
3876,0,3876,[303 316 272 211 276],90,5,15900,4.101109104978076,20.0,40.0
3877,0,3877,[303 316 272 211 276],90,5,15905,4.101340897369778,20.0,40.0
3878,0,3878,[367 208 212 485 290],13,3,15908,4.101056973446765,0.0,0.0
3879,0,3879,[303 316 272 211 276],13,5,15913,4.1012886597938145,20.0,40.0
3880,0,3880,[284 583 485 218 221],524,2,15915,4.100747230095336,0.0,0.0
3881,0,3881,[303 316 272 211 276],13,5,15920,4.100978876867594,20.0,40.0
3882,0,3882,[303 316 272 211 276],90,5,15925,4.101210404326552,20.0,40.0
3883,0,3883,[217 315 250 301 268],145,4,15929,4.101184346035016,20.0,0.0
3884,0,3884,[303 316 272 211 276],13,5,15934,4.101415701415702,20.0,40.0
3885,0,3885,[303 316 272 211 276],90,5,15939,4.101646937725167,20.0,40.0
3886,0,3886,[303 316 272 211 276],13,5,15944,4.1018780550553124,20.0,40.0
3887,0,3887,[303 316 272 211 276],13,5,15949,4.1021090534979425,20.0,40.0
3888,0,3888,[303 316 272 211 276],13,5,15954,4.102339933144767,20.0,40.0
3889,0,3889,[236 259 202 219 481],234,1,15955,4.1015424164524426,0.0,0.0
3890,0,3890,[303 316 272 211 276],90,5,15960,4.1017733230532,20.0,40.0
3891,0,3891,[303 316 272 211 276],90,5,15965,4.1020041109969165,20.0,40.0
3892,0,3892,[303 316 272 211 276],13,5,15970,4.102234780375032,20.0,40.0
3893,0,3893,[344 431 243 350 211],13,1,15971,4.101438109912686,0.0,20.0
3894,0,3894,[303 243 291 236 392],537,1,15972,4.100641848523749,0.0,0.0
3895,0,3895,[222 208 231 299 344],13,1,15973,4.099845995893224,0.0,20.0
3896,0,3896,[303 316 272 211 276],90,5,15978,4.100076982294072,20.0,40.0
3897,0,3897,[303 316 272 211 276],90,5,15983,4.100307850179579,20.0,40.0
3898,0,3898,[303 316 272 211 276],13,5,15988,4.100538599640934,20.0,40.0
3899,0,3899,[241 227 202 222 283],378,2,15990,4.1,0.0,20.0
3900,0,3900,[303 316 272 211 276],90,5,15995,4.10023071007434,20.0,40.0
3901,0,3901,[303 316 272 211 276],90,5,16000,4.1004613018964635,20.0,40.0
3902,0,3902,[303 316 272 211 276],90,5,16005,4.100691775557264,20.0,40.0
3903,0,3903,[303 316 272 211 276],90,5,16010,4.100922131147541,20.0,40.0
3904,0,3904,[303 316 272 211 276],90,5,16015,4.101152368758003,20.0,40.0
3905,0,3905,[303 316 272 211 276],90,5,16020,4.1013824884792625,20.0,40.0
3906,0,3906,[303 316 272 211 276],90,5,16025,4.101612490401843,20.0,40.0
3907,0,3907,[298 218 243 378 275],533,3,16028,4.1013306038894575,0.0,20.0
3908,0,3908,[326 218 336 384 209],13,0,16028,4.100281401893067,0.0,0.0
3909,0,3909,[299 239 216 215 413],13,2,16030,4.099744245524296,0.0,0.0
3910,0,3910,[299 212 429 219 211],13,3,16033,4.09946305292764,0.0,20.0
3911,0,3911,[303 316 272 211 276],13,5,16038,4.0996932515337425,20.0,40.0
3912,0,3912,[303 316 272 211 276],90,5,16043,4.099923332481472,20.0,40.0
3913,0,3913,[303 316 272 211 276],13,5,16048,4.100153295861012,20.0,40.0
3914,0,3914,[303 316 272 211 276],90,5,16053,4.100383141762452,20.0,40.0
3915,0,3915,[303 316 272 211 276],90,5,16058,4.100612870275792,20.0,40.0
3916,0,3916,[303 316 272 211 276],13,5,16063,4.100842481490937,20.0,40.0
3917,0,3917,[303 316 272 211 276],13,5,16068,4.101071975497703,20.0,40.0
3918,0,3918,[303 316 272 211 276],90,5,16073,4.101301352385812,20.0,40.0
3919,0,3919,[303 316 272 211 276],13,5,16078,4.101530612244898,20.0,40.0
3920,0,3920,[206 239 227 222 250],387,4,16082,4.101504718184136,0.0,20.0
3921,0,3921,[303 316 272 211 276],90,5,16087,4.101733809280979,20.0,40.0
3922,0,3922,[303 316 272 211 276],90,5,16092,4.101962783583992,20.0,40.0
3923,0,3923,[303 316 272 211 276],13,5,16097,4.102191641182467,20.0,40.0
3924,0,3924,[303 316 272 211 276],13,5,16102,4.102420382165605,20.0,40.0
3925,0,3925,[303 316 272 211 276],90,5,16107,4.102649006622516,20.0,40.0
3926,0,3926,[222 202 213 227 216],804,4,16111,4.1026228673287495,0.0,20.0
3927,0,3927,[303 316 272 211 276],90,5,16116,4.10285132382892,20.0,40.0
3928,0,3928,[420 211 232 378 226],650,1,16117,4.102061593280733,0.0,20.0
3929,0,3929,[303 316 272 211 276],90,5,16122,4.102290076335878,20.0,40.0
3930,0,3930,[303 316 272 211 276],90,5,16127,4.1025184431442385,20.0,40.0
3931,0,3931,[303 316 272 211 276],13,5,16132,4.102746693794507,20.0,40.0
3932,0,3932,[295 213 365 230 583],308,3,16135,4.102466310704297,0.0,0.0
3933,0,3933,[303 316 272 211 276],90,5,16140,4.1026944585663445,20.0,40.0
3934,0,3934,[303 316 272 211 276],90,5,16145,4.10292249047014,20.0,40.0
3935,0,3935,[303 316 272 211 276],13,5,16150,4.103150406504065,20.0,40.0
3936,0,3936,[223 321 216 429 275],308,3,16153,4.102870205740412,20.0,20.0
3937,0,3937,[206 324 367 218 211],387,3,16156,4.102590147282885,0.0,20.0
3938,0,3938,[303 316 272 211 276],90,5,16161,4.102817974105103,20.0,40.0
3939,0,3939,[303 316 272 211 276],90,5,16166,4.103045685279188,20.0,40.0
3940,0,3940,[303 316 272 211 276],13,5,16171,4.103273280893174,20.0,40.0
3941,0,3941,[303 316 272 211 276],90,5,16176,4.103500761035008,20.0,40.0
3942,0,3942,[303 316 272 211 276],13,5,16181,4.103728125792544,20.0,40.0
3943,0,3943,[303 316 272 211 276],90,5,16186,4.10395537525355,20.0,40.0
3944,0,3944,[300 315 264 478 201],13,3,16189,4.103675538656527,20.0,20.0
3945,0,3945,[303 316 272 211 276],13,5,16194,4.103902686264572,20.0,40.0
3946,0,3946,[324 431 226 298 231],387,1,16195,4.103116290853813,0.0,0.0
3947,0,3947,[303 316 272 211 276],13,5,16200,4.103343465045593,20.0,40.0
3948,0,3948,[303 316 272 211 276],13,5,16205,4.103570524183337,20.0,40.0
3949,0,3949,[303 316 272 211 276],13,5,16210,4.10379746835443,20.0,40.0
3950,0,3950,[303 316 272 211 276],90,5,16215,4.104024297646165,20.0,40.0
3951,0,3951,[303 316 272 211 276],90,5,16220,4.104251012145749,20.0,40.0
3952,0,3952,[350 367 336 202 326],13,1,16221,4.103465722236276,0.0,0.0
3953,0,3953,[303 316 272 211 276],90,5,16226,4.103692463328275,20.0,40.0
3954,0,3954,[241 209 284 244 275],158,5,16231,4.103919089759798,0.0,20.0
3955,0,3955,[303 316 272 211 276],90,5,16236,4.1041456016177955,20.0,40.0
3956,0,3956,[206 219 222 202 218],387,2,16238,4.103613848875411,0.0,20.0
3957,0,3957,[303 316 272 211 276],90,5,16243,4.103840323395654,20.0,40.0
3958,0,3958,[303 316 272 211 276],13,5,16248,4.104066683505936,20.0,40.0
3959,0,3959,[206 429 219 223 211],833,3,16251,4.1037878787878785,20.0,20.0
3960,0,3960,[485 508 208 216 236],537,2,16253,4.103256753345115,0.0,0.0
3961,0,3961,[303 316 272 211 276],13,5,16258,4.1034830893488135,20.0,40.0
3962,0,3962,[303 316 272 211 276],90,5,16263,4.1037093111279335,20.0,40.0
3963,0,3963,[303 316 272 211 276],90,5,16268,4.10393541876892,20.0,40.0
3964,0,3964,[303 316 272 211 276],13,5,16273,4.104161412358134,20.0,40.0
3965,0,3965,[303 316 272 211 276],90,5,16278,4.104387291981846,20.0,40.0
3966,0,3966,[344 201 226 509 326],13,2,16280,4.103856818754727,0.0,0.0
3967,0,3967,[303 316 272 211 276],13,5,16285,4.104082661290323,20.0,40.0
3968,0,3968,[303 316 272 211 276],90,5,16290,4.104308390022676,20.0,40.0
3969,0,3969,[303 316 272 211 276],13,5,16295,4.104534005037784,20.0,40.0
3970,0,3970,[211 208 367 209 413],804,3,16298,4.104255854948375,0.0,20.0
3971,0,3971,[303 316 272 211 276],13,5,16303,4.10448136958711,20.0,40.0
3972,0,3972,[303 316 272 211 276],13,5,16308,4.10470677070224,20.0,40.0
3973,0,3973,[485 429 367 276 209],308,4,16312,4.104680422747861,0.0,20.0
3974,0,3974,[251 367 507 290 215],385,1,16313,4.103899371069183,20.0,0.0
3975,0,3975,[303 316 272 211 276],13,5,16318,4.104124748490945,20.0,40.0
3976,0,3976,[303 316 272 211 276],90,5,16323,4.104350012572291,20.0,40.0
3977,0,3977,[303 316 272 211 276],13,5,16328,4.104575163398692,20.0,40.0
3978,0,3978,[303 316 272 211 276],90,5,16333,4.104800201055542,20.0,40.0
3979,0,3979,[303 316 272 211 276],13,5,16338,4.105025125628141,20.0,40.0
3980,0,3980,[303 316 272 211 276],90,5,16343,4.105249937201708,20.0,40.0
3981,0,3981,[303 316 272 211 276],13,5,16348,4.105474635861376,20.0,40.0
3982,0,3982,[303 316 272 211 276],13,5,16353,4.105699221692192,20.0,40.0
3983,0,3983,[303 316 272 211 276],90,5,16358,4.105923694779117,20.0,40.0
3984,0,3984,[303 316 272 211 276],13,5,16363,4.106148055207027,20.0,40.0
3985,0,3985,[303 316 272 211 276],13,5,16368,4.106372303060713,20.0,40.0
3986,0,3986,[303 316 272 211 276],13,5,16373,4.106596438424881,20.0,40.0
3987,0,3987,[264 232 429 365 481],7,4,16377,4.106569709127382,0.0,0.0
3988,0,3988,[261 509 478 299 231],13,2,16379,4.106041614439709,0.0,0.0
3989,0,3989,[303 316 272 211 276],90,5,16384,4.106265664160401,20.0,40.0
3990,0,3990,[303 316 272 211 276],13,5,16389,4.1064896016036085,20.0,40.0
3991,0,3991,[264 331 215 217 420],13,3,16392,4.1062124248497,0.0,0.0
3992,0,3992,[303 316 272 211 276],13,5,16397,4.106436263461057,20.0,40.0
3993,0,3993,[303 316 272 211 276],13,5,16402,4.106659989984977,20.0,40.0
3994,0,3994,[303 316 272 211 276],13,5,16407,4.106883604505632,20.0,40.0
3995,0,3995,[303 316 272 211 276],90,5,16412,4.107107107107107,20.0,40.0
3996,0,3996,[303 316 272 211 276],90,5,16417,4.107330497873405,20.0,40.0
3997,0,3997,[232 243 508 367 583],59,3,16420,4.107053526763382,0.0,0.0
3998,0,3998,[284 291 241 326 231],788,3,16423,4.1067766941735435,0.0,0.0
3999,0,3999,[303 316 272 211 276],90,5,16428,4.107,20.0,40.0
4000,1,0,[324 431 321 231 209],387,2,2,2.0,0.0,0.0
4001,1,1,[336 244 276 508 221],486,3,5,2.5,0.0,20.0
4002,1,2,[508 209 276 324 221],334,3,8,2.6666666666666665,0.0,20.0
4003,1,3,[315 208 216 230 272],650,4,12,3.0,20.0,0.0
4004,1,4,[272 230 276 208 324],334,5,17,3.4,0.0,20.0
4005,1,5,[283 215 276 219 223],234,0,17,2.8333333333333335,20.0,20.0
4006,1,6,[272 230 208 324 221],334,5,22,3.142857142857143,0.0,0.0
4007,1,7,[272 230 208 324 221],334,5,27,3.375,0.0,0.0
4008,1,8,[208 213 321 259 218],234,1,28,3.111111111111111,0.0,0.0
4009,1,9,[429 222 485 291 223],749,4,32,3.2,20.0,20.0
4010,1,10,[272 208 221 216 291],537,2,34,3.090909090909091,0.0,0.0
4011,1,11,[272 324 485 208 230],334,4,38,3.1666666666666665,0.0,0.0
4012,1,12,[272 324 208 230 429],334,5,43,3.3076923076923075,0.0,0.0
4013,1,13,[230 392 215 478 202],881,4,47,3.357142857142857,0.0,0.0
4014,1,14,[478 392 272 230 208],537,3,50,3.3333333333333335,0.0,0.0
4015,1,15,[232 275 222 367 420],64,3,53,3.3125,0.0,40.0
4016,1,16,[218 216 583 215 291],92,3,56,3.2941176470588234,0.0,0.0
4017,1,17,[223 219 431 227 218],650,0,56,3.111111111111111,20.0,0.0
4018,1,18,[208 219 431 508 250],92,5,61,3.210526315789474,0.0,0.0
4019,1,19,[478 202 272 367 429],13,4,65,3.25,0.0,0.0
4020,1,20,[276 221 280 344 255],894,3,68,3.238095238095238,0.0,20.0
4021,1,21,[315 209 331 452 241],13,1,69,3.1363636363636362,20.0,0.0
4022,1,22,[315 507 316 367 280],13,3,72,3.130434782608696,40.0,0.0
4023,1,23,[216 236 290 211 301],234,0,72,3.0,0.0,20.0
4024,1,24,[315 452 211 384 272],13,3,75,3.0,20.0,20.0
4025,1,25,[221 290 251 293 485],385,2,77,2.9615384615384617,20.0,0.0
4026,1,26,[202 239 344 268 350],13,3,80,2.962962962962963,0.0,0.0
4027,1,27,[301 315 413 299 431],13,1,81,2.892857142857143,20.0,0.0
4028,1,28,[431 209 429 272 230],13,2,83,2.8620689655172415,0.0,0.0
4029,1,29,[478 272 239 429 275],13,4,87,2.9,0.0,20.0
4030,1,30,[478 272 239 429 316],13,5,92,2.967741935483871,20.0,0.0
4031,1,31,[350 413 303 315 367],13,2,94,2.9375,20.0,0.0
4032,1,32,[231 211 300 227 223],7,3,97,2.9393939393939394,20.0,40.0
4033,1,33,[478 303 239 429 208],537,3,100,2.9411764705882355,0.0,0.0
4034,1,34,[508 223 250 275 291],455,3,103,2.942857142857143,20.0,20.0
4035,1,35,[293 378 284 291 478],474,5,108,3.0,0.0,0.0
4036,1,36,[478 272 284 208 268],85,4,112,3.027027027027027,0.0,0.0
4037,1,37,[478 272 316 208 378],85,4,116,3.0526315789473686,20.0,0.0
4038,1,38,[299 222 429 216 284],537,0,116,2.9743589743589745,0.0,20.0
4039,1,39,[429 202 284 367 275],308,5,121,3.025,0.0,20.0
4040,1,40,[241 209 239 367 217],64,2,123,3.0,0.0,0.0
4041,1,41,[508 231 209 215 216],643,3,126,3.0,0.0,0.0
4042,1,42,[331 221 256 336 350],894,2,128,2.9767441860465116,0.0,0.0
4043,1,43,[303 202 300 272 378],537,2,130,2.9545454545454546,0.0,20.0
4044,1,44,[226 264 299 431 367],13,2,132,2.933333333333333,0.0,0.0
4045,1,45,[303 264 226 208 272],13,5,137,2.9782608695652173,0.0,0.0
4046,1,46,[303 264 226 208 272],13,5,142,3.021276595744681,0.0,0.0
4047,1,47,[481 276 202 236 226],234,1,143,2.9791666666666665,0.0,20.0
4048,1,48,[429 223 219 217 394],13,2,145,2.9591836734693877,20.0,0.0
4049,1,49,[508 583 284 367 243],92,1,146,2.92,0.0,0.0
4050,1,50,[275 208 276 239 315],311,4,150,2.9411764705882355,20.0,40.0
4051,1,51,[303 208 478 268 272],537,5,155,2.980769230769231,0.0,0.0
4052,1,52,[303 208 478 268 272],537,5,160,3.018867924528302,0.0,0.0
4053,1,53,[303 208 478 268 272],6,3,163,3.0185185185185186,0.0,0.0
4054,1,54,[297 485 268 216 246],6,2,165,3.0,20.0,0.0
4055,1,55,[209 284 223 280 230],749,4,169,3.017857142857143,20.0,0.0
4056,1,56,[211 478 215 272 230],537,3,172,3.017543859649123,0.0,20.0
4057,1,57,[218 211 485 481 222],234,1,173,2.9827586206896552,0.0,40.0
4058,1,58,[367 226 208 431 429],653,1,174,2.9491525423728815,0.0,0.0
4059,1,59,[216 209 243 240 212],59,3,177,2.95,0.0,0.0
4060,1,60,[272 478 481 212 264],13,4,181,2.9672131147540983,0.0,0.0
4061,1,61,[481 290 300 212 378],234,2,183,2.9516129032258065,0.0,20.0
4062,1,62,[275 208 212 509 508],537,4,187,2.9682539682539684,0.0,20.0
4063,1,63,[365 420 216 276 255],378,4,191,2.984375,0.0,20.0
4064,1,64,[213 291 226 478 259],524,2,193,2.9692307692307693,0.0,0.0
4065,1,65,[268 485 367 280 226],234,1,194,2.9393939393939394,0.0,0.0
4066,1,66,[508 236 290 213 202],537,2,196,2.925373134328358,0.0,0.0
4067,1,67,[209 226 367 215 218],650,0,196,2.8823529411764706,0.0,0.0
4068,1,68,[300 217 212 280 264],13,3,199,2.8840579710144927,0.0,20.0
4069,1,69,[272 209 485 215 300],90,3,202,2.8857142857142857,0.0,20.0
4070,1,70,[219 218 272 222 507],13,1,203,2.859154929577465,0.0,20.0
4071,1,71,[222 239 215 208 508],533,4,207,2.875,0.0,20.0
4072,1,72,[321 507 201 218 384],13,0,207,2.835616438356164,0.0,0.0
4073,1,73,[212 509 485 301 241],13,2,209,2.824324324324324,0.0,0.0
4074,1,74,[216 227 208 481 485],7,4,213,2.84,0.0,0.0
4075,1,75,[223 231 202 217 212],184,2,215,2.8289473684210527,20.0,0.0
4076,1,76,[227 239 202 316 326],102,2,217,2.8181818181818183,20.0,0.0
4077,1,77,[331 413 243 321 367],13,0,217,2.782051282051282,0.0,0.0
4078,1,78,[232 215 226 218 231],774,0,217,2.7468354430379747,0.0,0.0
4079,1,79,[301 420 350 272 201],13,2,219,2.7375,0.0,0.0
4080,1,80,[202 321 215 295 284],308,2,221,2.728395061728395,0.0,0.0
4081,1,81,[208 223 221 291 222],234,1,222,2.707317073170732,20.0,20.0
4082,1,82,[284 293 239 365 367],308,3,225,2.710843373493976,0.0,0.0
4083,1,83,[367 209 429 293 201],833,3,228,2.7142857142857144,0.0,0.0
4084,1,84,[326 299 300 211 226],13,2,230,2.7058823529411766,0.0,40.0
4085,1,85,[301 239 316 429 208],334,3,233,2.7093023255813953,20.0,0.0
4086,1,86,[241 211 230 202 583],387,2,235,2.7011494252873565,0.0,20.0
4087,1,87,[244 298 344 246 250],392,2,237,2.6931818181818183,0.0,0.0
4088,1,88,[485 275 478 212 481],406,1,238,2.6741573033707864,0.0,20.0
4089,1,89,[321 230 208 264 261],13,2,240,2.6666666666666665,0.0,0.0
4090,1,90,[209 283 431 268 300],234,1,241,2.6483516483516483,0.0,20.0
4091,1,91,[232 223 211 413 321],13,2,243,2.641304347826087,20.0,20.0
4092,1,92,[241 300 211 478 230],13,2,245,2.6344086021505375,0.0,40.0
4093,1,93,[336 508 315 219 261],13,1,246,2.617021276595745,20.0,0.0
4094,1,94,[508 220 301 239 481],334,1,247,2.6,0.0,0.0
4095,1,95,[316 315 264 300 336],894,3,250,2.6041666666666665,40.0,20.0
4096,1,96,[298 429 295 216 378],749,4,254,2.618556701030928,0.0,0.0
4097,1,97,[344 394 217 299 429],13,1,255,2.6020408163265305,0.0,0.0
4098,1,98,[211 301 284 213 216],666,3,258,2.606060606060606,0.0,20.0
4099,1,99,[215 227 208 202 239],387,1,259,2.59,0.0,0.0
4100,1,100,[299 429 392 259 431],537,1,260,2.5742574257425743,0.0,0.0
4101,1,101,[299 350 215 336 209],13,1,261,2.5588235294117645,0.0,0.0
4102,1,102,[299 227 452 485 316],13,2,263,2.5533980582524274,20.0,0.0
4103,1,103,[212 315 365 392 202],311,4,267,2.5673076923076925,20.0,0.0
4104,1,104,[239 261 431 429 222],13,2,269,2.5619047619047617,0.0,20.0
4105,1,105,[215 275 509 202 217],64,3,272,2.5660377358490565,0.0,20.0
4106,1,106,[420 508 300 367 429],13,2,274,2.560747663551402,0.0,20.0
4107,1,107,[301 221 259 509 206],537,1,275,2.5462962962962963,0.0,0.0
4108,1,108,[316 230 303 239 420],13,4,279,2.5596330275229358,20.0,0.0
4109,1,109,[222 217 215 239 431],13,2,281,2.5545454545454547,0.0,20.0
4110,1,110,[280 481 219 290 275],13,2,283,2.5495495495495497,0.0,20.0
4111,1,111,[216 209 240 227 394],145,4,287,2.5625,0.0,0.0
4112,1,112,[227 226 216 583 275],7,3,290,2.566371681415929,0.0,20.0
4113,1,113,[275 209 509 246 230],85,3,293,2.5701754385964914,0.0,20.0
4114,1,114,[284 241 508 202 208],82,2,295,2.5652173913043477,0.0,0.0
4115,1,115,[268 232 478 485 227],13,3,298,2.5689655172413794,0.0,0.0
4116,1,116,[239 221 478 208 213],537,3,301,2.572649572649573,0.0,0.0
4117,1,117,[303 331 261 367 336],13,1,302,2.559322033898305,0.0,0.0
4118,1,118,[213 420 367 226 291],892,2,304,2.5546218487394956,0.0,0.0
4119,1,119,[481 208 508 485 301],334,2,306,2.55,0.0,0.0
4120,1,120,[211 478 431 429 315],650,3,309,2.553719008264463,20.0,20.0
4121,1,121,[300 394 217 420 485],13,1,310,2.540983606557377,0.0,20.0
4122,1,122,[452 326 331 485 218],13,0,310,2.5203252032520327,0.0,0.0
4123,1,123,[378 243 316 206 452],650,1,311,2.5080645161290325,20.0,0.0
4124,1,124,[209 239 291 301 367],524,4,315,2.52,0.0,0.0
4125,1,125,[223 321 485 239 298],308,2,317,2.515873015873016,20.0,0.0
4126,1,126,[241 324 211 222 261],479,2,319,2.5118110236220472,0.0,40.0
4127,1,127,[222 240 429 211 206],406,3,322,2.515625,0.0,40.0
4128,1,128,[215 284 239 255 378],533,2,324,2.511627906976744,0.0,0.0
4129,1,129,[481 222 485 509 213],85,4,328,2.523076923076923,0.0,20.0
4130,1,130,[272 239 283 231 268],334,3,331,2.5267175572519083,0.0,0.0
4131,1,131,[326 212 221 284 478],144,3,334,2.5303030303030303,0.0,0.0
4132,1,132,[261 280 315 209 215],13,3,337,2.5338345864661656,20.0,0.0
4133,1,133,[378 303 206 241 208],537,2,339,2.529850746268657,0.0,0.0
4134,1,134,[212 211 226 241 227],311,2,341,2.525925925925926,0.0,20.0
4135,1,135,[293 268 223 299 350],894,2,343,2.5220588235294117,20.0,0.0
4136,1,136,[350 316 303 321 243],13,2,345,2.5182481751824817,20.0,0.0
4137,1,137,[324 293 300 290 481],334,2,347,2.5144927536231885,0.0,20.0
4138,1,138,[236 275 297 217 485],334,3,350,2.5179856115107913,20.0,20.0
4139,1,139,[392 429 275 230 315],537,2,352,2.5142857142857142,20.0,20.0
4140,1,140,[217 216 209 276 243],13,1,353,2.50354609929078,0.0,20.0
4141,1,141,[272 212 216 208 300],537,2,355,2.5,0.0,20.0
4142,1,142,[429 239 384 326 261],13,2,357,2.4965034965034967,0.0,0.0
4143,1,143,[219 211 217 280 478],13,3,360,2.5,0.0,20.0
4144,1,144,[350 218 481 316 275],328,3,363,2.503448275862069,20.0,20.0
4145,1,145,[201 227 250 429 231],387,3,366,2.506849315068493,0.0,0.0
4146,1,146,[291 301 201 268 243],537,1,367,2.496598639455782,0.0,0.0
4147,1,147,[509 215 272 217 230],378,3,370,2.5,0.0,0.0
4148,1,148,[241 280 202 509 220],378,2,372,2.4966442953020134,0.0,0.0
4149,1,149,[239 295 211 275 208],308,3,375,2.5,0.0,40.0
4150,1,150,[326 213 295 272 331],894,3,378,2.5033112582781456,0.0,0.0
4151,1,151,[429 209 230 583 223],308,5,383,2.5197368421052633,20.0,0.0
4152,1,152,[219 452 243 268 321],13,1,384,2.5098039215686274,0.0,0.0
4153,1,153,[508 290 324 268 300],669,1,385,2.5,0.0,20.0
4154,1,154,[272 478 303 208 509],13,5,390,2.5161290322580645,0.0,0.0
4155,1,155,[272 478 303 208 509],6,4,394,2.5256410256410255,0.0,0.0
4156,1,156,[272 478 208 509 264],13,5,399,2.5414012738853504,0.0,0.0
4157,1,157,[272 478 208 509 264],13,5,404,2.5569620253164556,0.0,0.0
4158,1,158,[272 478 208 509 264],13,5,409,2.5723270440251573,0.0,0.0
4159,1,159,[272 478 509 208 264],13,5,414,2.5875,0.0,0.0
4160,1,160,[508 209 507 272 301],13,1,415,2.577639751552795,0.0,0.0
4161,1,161,[272 478 509 208 264],13,5,420,2.5925925925925926,0.0,0.0
4162,1,162,[272 478 509 208 264],13,5,425,2.607361963190184,0.0,0.0
4163,1,163,[272 478 509 208 264],13,5,430,2.6219512195121952,0.0,0.0
4164,1,164,[272 478 509 264 208],13,5,435,2.6363636363636362,0.0,0.0
4165,1,165,[216 300 232 431 264],13,1,436,2.6265060240963853,0.0,20.0
4166,1,166,[272 478 509 264 208],13,5,441,2.6407185628742513,0.0,0.0
4167,1,167,[226 481 218 209 255],308,4,445,2.6488095238095237,0.0,0.0
4168,1,168,[299 259 326 344 275],116,2,447,2.6449704142011834,0.0,20.0
4169,1,169,[272 478 509 264 208],13,5,452,2.6588235294117646,0.0,0.0
4170,1,170,[212 211 394 290 275],13,3,455,2.6608187134502925,0.0,40.0
4171,1,171,[218 452 264 284 295],308,2,457,2.6569767441860463,0.0,0.0
4172,1,172,[315 201 508 243 268],13,2,459,2.653179190751445,20.0,0.0
4173,1,173,[230 264 202 219 255],308,3,462,2.6551724137931036,0.0,0.0
4174,1,174,[231 216 365 230 209],311,4,466,2.662857142857143,0.0,0.0
4175,1,175,[272 478 509 208 303],6,4,470,2.6704545454545454,0.0,0.0
4176,1,176,[272 478 509 208 315],537,5,475,2.6836158192090394,20.0,0.0
4177,1,177,[272 478 509 208 315],650,3,478,2.6853932584269664,20.0,0.0
4178,1,178,[272 478 208 509 264],13,5,483,2.6983240223463687,0.0,0.0
4179,1,179,[208 243 507 230 216],650,4,487,2.7055555555555557,0.0,0.0
4180,1,180,[272 478 208 509 264],13,5,492,2.718232044198895,0.0,0.0
4181,1,181,[272 478 208 509 264],13,5,497,2.730769230769231,0.0,0.0
4182,1,182,[365 259 223 378 202],7,3,500,2.73224043715847,20.0,0.0
4183,1,183,[508 321 378 290 431],537,2,502,2.7282608695652173,0.0,0.0
4184,1,184,[272 478 208 509 264],13,5,507,2.7405405405405405,0.0,0.0
4185,1,185,[272 478 208 509 264],13,5,512,2.752688172043011,0.0,0.0
4186,1,186,[431 208 215 222 478],474,4,516,2.7593582887700534,0.0,20.0
4187,1,187,[272 478 509 208 264],13,5,521,2.771276595744681,0.0,0.0
4188,1,188,[272 478 509 208 264],13,5,526,2.7830687830687832,0.0,0.0
4189,1,189,[272 478 509 208 264],13,5,531,2.794736842105263,0.0,0.0
4190,1,190,[272 478 509 208 264],13,5,536,2.806282722513089,0.0,0.0
4191,1,191,[272 478 509 208 264],13,5,541,2.8177083333333335,0.0,0.0
4192,1,192,[272 478 509 208 264],13,5,546,2.8290155440414506,0.0,0.0
4193,1,193,[272 478 509 208 264],13,5,551,2.8402061855670104,0.0,0.0
4194,1,194,[219 452 231 413 367],13,0,551,2.825641025641026,0.0,0.0
4195,1,195,[272 478 509 208 264],13,5,556,2.836734693877551,0.0,0.0
4196,1,196,[272 478 509 208 264],13,5,561,2.8477157360406093,0.0,0.0
4197,1,197,[485 216 201 326 508],13,0,561,2.8333333333333335,0.0,0.0
4198,1,198,[272 478 509 208 264],13,5,566,2.8442211055276383,0.0,0.0
4199,1,199,[231 222 226 202 378],311,5,571,2.855,0.0,20.0
4200,1,200,[272 478 509 208 264],13,5,576,2.8656716417910446,0.0,0.0
4201,1,201,[293 241 275 264 202],308,4,580,2.871287128712871,0.0,20.0
4202,1,202,[239 321 315 344 216],13,2,582,2.8669950738916254,20.0,0.0
4203,1,203,[336 226 268 211 222],13,3,585,2.8676470588235294,0.0,40.0
4204,1,204,[272 478 509 208 264],13,5,590,2.8780487804878048,0.0,0.0
4205,1,205,[208 202 218 431 243],59,4,594,2.883495145631068,0.0,0.0
4206,1,206,[272 478 509 208 264],13,5,599,2.893719806763285,0.0,0.0
4207,1,207,[272 478 509 208 264],13,5,604,2.9038461538461537,0.0,0.0
4208,1,208,[213 367 321 509 241],308,4,608,2.909090909090909,0.0,0.0
4209,1,209,[272 478 509 208 264],13,5,613,2.919047619047619,0.0,0.0
4210,1,210,[378 202 201 507 230],308,3,616,2.919431279620853,0.0,0.0
4211,1,211,[272 478 509 208 264],13,5,621,2.9292452830188678,0.0,0.0
4212,1,212,[226 378 321 276 420],892,3,624,2.9295774647887325,0.0,20.0
4213,1,213,[272 478 509 208 264],13,5,629,2.939252336448598,0.0,0.0
4214,1,214,[202 220 291 250 201],92,2,631,2.9348837209302325,0.0,0.0
4215,1,215,[272 478 509 208 264],13,5,636,2.9444444444444446,0.0,0.0
4216,1,216,[367 290 485 272 218],650,1,637,2.935483870967742,0.0,0.0
4217,1,217,[272 478 509 208 264],13,5,642,2.944954128440367,0.0,0.0
4218,1,218,[250 429 324 431 291],833,0,642,2.9315068493150687,0.0,0.0
4219,1,219,[272 478 509 208 264],13,5,647,2.940909090909091,0.0,0.0
4220,1,220,[485 202 215 509 216],7,4,651,2.9457013574660635,0.0,0.0
4221,1,221,[508 241 321 250 301],184,3,654,2.945945945945946,0.0,0.0
4222,1,222,[509 392 276 481 272],271,1,655,2.937219730941704,0.0,20.0
4223,1,223,[255 216 326 218 508],334,0,655,2.924107142857143,0.0,0.0
4224,1,224,[222 507 378 232 215],650,2,657,2.92,0.0,20.0
4225,1,225,[272 478 509 208 264],13,5,662,2.9292035398230087,0.0,0.0
4226,1,226,[272 478 509 208 264],13,5,667,2.9383259911894273,0.0,0.0
4227,1,227,[239 264 211 394 331],13,3,670,2.93859649122807,0.0,20.0
4228,1,228,[272 478 509 208 264],13,5,675,2.947598253275109,0.0,0.0
4229,1,229,[295 220 227 239 298],378,0,675,2.9347826086956523,0.0,0.0
4230,1,230,[268 217 218 202 215],387,0,675,2.9220779220779223,0.0,0.0
4231,1,231,[272 478 509 208 264],13,5,680,2.9310344827586206,0.0,0.0
4232,1,232,[321 230 211 394 331],13,1,681,2.92274678111588,0.0,20.0
4233,1,233,[394 261 215 507 202],13,2,683,2.9188034188034186,0.0,0.0
4234,1,234,[272 478 509 208 264],13,5,688,2.927659574468085,0.0,0.0
4235,1,235,[272 478 509 208 264],13,5,693,2.9364406779661016,0.0,0.0
4236,1,236,[394 384 429 321 508],13,1,694,2.928270042194093,0.0,0.0
4237,1,237,[223 218 241 321 509],184,3,697,2.9285714285714284,20.0,0.0
4238,1,238,[272 478 509 208 264],13,5,702,2.937238493723849,0.0,0.0
4239,1,239,[231 300 284 211 230],749,4,706,2.941666666666667,0.0,40.0
4240,1,240,[272 478 509 208 264],13,5,711,2.9502074688796682,0.0,0.0
4241,1,241,[272 478 509 208 264],13,5,716,2.958677685950413,0.0,0.0
4242,1,242,[272 478 509 208 264],13,5,721,2.9670781893004117,0.0,0.0
4243,1,243,[272 478 509 208 264],13,5,726,2.9754098360655736,0.0,0.0
4244,1,244,[272 478 509 208 264],13,5,731,2.983673469387755,0.0,0.0
4245,1,245,[384 367 420 264 452],13,2,733,2.9796747967479673,0.0,0.0
4246,1,246,[209 293 284 216 367],6,2,735,2.9757085020242915,0.0,0.0
4247,1,247,[272 478 509 208 264],13,5,740,2.9838709677419355,0.0,0.0
4248,1,248,[367 202 298 276 241],207,0,740,2.9718875502008033,0.0,20.0
4249,1,249,[481 336 216 217 230],13,0,740,2.96,0.0,0.0
4250,1,250,[284 239 291 299 213],537,1,741,2.952191235059761,0.0,0.0
4251,1,251,[272 478 509 208 264],13,5,746,2.9603174603174605,0.0,0.0
4252,1,252,[221 509 211 276 241],271,2,748,2.9565217391304346,0.0,40.0
4253,1,253,[272 478 509 208 264],13,5,753,2.9645669291338583,0.0,0.0
4254,1,254,[272 478 509 208 264],13,5,758,2.9725490196078432,0.0,0.0
4255,1,255,[222 254 202 243 239],804,4,762,2.9765625,0.0,20.0
4256,1,256,[230 293 301 429 231],334,2,764,2.972762645914397,0.0,0.0
4257,1,257,[413 211 212 216 508],82,3,767,2.9728682170542635,0.0,20.0
4258,1,258,[254 272 478 509 208],184,4,771,2.976833976833977,0.0,0.0
4259,1,259,[272 478 509 208 264],13,5,776,2.9846153846153847,0.0,0.0
4260,1,260,[331 261 276 326 241],13,1,777,2.9770114942528734,0.0,20.0
4261,1,261,[272 478 509 208 264],13,5,782,2.984732824427481,0.0,0.0
4262,1,262,[272 478 509 208 264],13,5,787,2.9923954372623576,0.0,0.0
4263,1,263,[272 478 509 208 264],13,5,792,3.0,0.0,0.0
4264,1,264,[226 508 223 231 583],92,2,794,2.9962264150943394,20.0,0.0
4265,1,265,[272 478 509 208 264],13,5,799,3.0037593984962405,0.0,0.0
4266,1,266,[272 300 276 429 299],13,3,802,3.0037453183520597,0.0,40.0
4267,1,267,[272 478 509 208 264],13,5,807,3.0111940298507465,0.0,0.0
4268,1,268,[272 478 509 208 264],13,5,812,3.0185873605947955,0.0,0.0
4269,1,269,[255 315 431 259 215],454,4,816,3.022222222222222,20.0,0.0
4270,1,270,[216 268 321 316 236],234,1,817,3.014760147601476,20.0,0.0
4271,1,271,[227 211 420 231 392],311,3,820,3.014705882352941,0.0,20.0
4272,1,272,[316 326 218 246 217],334,2,822,3.010989010989011,20.0,0.0
4273,1,273,[272 478 509 208 264],13,5,827,3.0182481751824817,0.0,0.0
4274,1,274,[217 230 211 481 485],13,1,828,3.0109090909090908,0.0,20.0
4275,1,275,[272 478 509 208 264],13,5,833,3.0181159420289854,0.0,0.0
4276,1,276,[272 478 509 208 264],13,5,838,3.0252707581227436,0.0,0.0
4277,1,277,[272 478 509 208 264],13,5,843,3.0323741007194243,0.0,0.0
4278,1,278,[272 478 509 208 264],13,5,848,3.039426523297491,0.0,0.0
4279,1,279,[272 478 509 208 264],13,5,853,3.0464285714285713,0.0,0.0
4280,1,280,[202 209 507 384 509],13,2,855,3.0427046263345194,0.0,0.0
4281,1,281,[272 478 509 208 264],13,5,860,3.049645390070922,0.0,0.0
4282,1,282,[209 452 202 226 275],308,3,863,3.049469964664311,0.0,20.0
4283,1,283,[272 478 509 208 264],13,5,868,3.056338028169014,0.0,0.0
4284,1,284,[243 202 219 216 227],650,1,869,3.049122807017544,0.0,0.0
4285,1,285,[272 478 509 208 264],13,5,874,3.055944055944056,0.0,0.0
4286,1,286,[272 478 509 208 264],13,5,879,3.062717770034843,0.0,0.0
4287,1,287,[272 478 509 208 264],13,5,884,3.0694444444444446,0.0,0.0
4288,1,288,[272 478 509 208 264],13,5,889,3.0761245674740483,0.0,0.0
4289,1,289,[420 481 583 264 431],7,4,893,3.079310344827586,0.0,0.0
4290,1,290,[344 300 394 217 211],13,1,894,3.0721649484536084,0.0,40.0
4291,1,291,[211 208 239 220 217],406,2,896,3.0684931506849313,0.0,20.0
4292,1,292,[230 218 226 420 219],13,2,898,3.0648464163822524,0.0,0.0
4293,1,293,[331 420 336 202 303],13,3,901,3.064625850340136,0.0,0.0
4294,1,294,[272 478 509 208 264],13,5,906,3.071186440677966,0.0,0.0
4295,1,295,[413 215 216 261 226],13,2,908,3.0675675675675675,0.0,0.0
4296,1,296,[223 291 420 208 254],308,3,911,3.0673400673400675,20.0,0.0
4297,1,297,[246 272 481 208 223],6,4,915,3.0704697986577183,20.0,0.0
4298,1,298,[452 321 208 384 303],13,2,917,3.0668896321070234,0.0,0.0
4299,1,299,[272 478 509 208 264],13,5,922,3.0733333333333333,0.0,0.0
4300,1,300,[280 218 394 344 507],13,1,923,3.0664451827242525,0.0,0.0
4301,1,301,[268 507 206 315 291],537,3,926,3.066225165562914,20.0,0.0
4302,1,302,[272 478 509 208 264],13,5,931,3.072607260726073,0.0,0.0
4303,1,303,[230 392 299 241 209],537,1,932,3.0657894736842106,0.0,0.0
4304,1,304,[272 478 509 208 264],13,5,937,3.0721311475409836,0.0,0.0
4305,1,305,[272 478 509 208 264],13,5,942,3.0784313725490198,0.0,0.0
4306,1,306,[326 283 300 297 315],334,3,945,3.0781758957654723,40.0,20.0
4307,1,307,[222 221 321 212 290],537,0,945,3.0681818181818183,0.0,20.0
4308,1,308,[452 509 272 227 420],650,1,946,3.0614886731391584,0.0,0.0
4309,1,309,[507 243 301 230 413],13,0,946,3.0516129032258066,0.0,0.0
4310,1,310,[272 478 509 208 264],13,5,951,3.057877813504823,0.0,0.0
4311,1,311,[272 478 509 208 264],13,5,956,3.0641025641025643,0.0,0.0
4312,1,312,[272 478 509 208 264],13,5,961,3.070287539936102,0.0,0.0
4313,1,313,[272 478 509 208 264],13,5,966,3.0764331210191083,0.0,0.0
4314,1,314,[272 478 509 208 264],13,5,971,3.0825396825396827,0.0,0.0
4315,1,315,[272 478 509 208 264],13,5,976,3.088607594936709,0.0,0.0
4316,1,316,[272 478 509 208 264],13,5,981,3.0946372239747633,0.0,0.0
4317,1,317,[272 478 509 208 264],13,5,986,3.10062893081761,0.0,0.0
4318,1,318,[485 284 321 299 429],537,0,986,3.090909090909091,0.0,0.0
4319,1,319,[272 478 509 208 264],13,5,991,3.096875,0.0,0.0
4320,1,320,[316 326 227 219 243],13,2,993,3.0934579439252334,20.0,0.0
4321,1,321,[272 478 509 208 264],13,5,998,3.099378881987578,0.0,0.0
4322,1,322,[272 478 509 208 264],13,5,1003,3.1052631578947367,0.0,0.0
4323,1,323,[272 478 509 208 264],13,5,1008,3.111111111111111,0.0,0.0
4324,1,324,[272 478 509 208 264],13,5,1013,3.116923076923077,0.0,0.0
4325,1,325,[272 478 509 208 264],13,5,1018,3.1226993865030677,0.0,0.0
4326,1,326,[331 431 226 268 344],13,2,1020,3.1192660550458715,0.0,0.0
4327,1,327,[226 321 215 230 509],308,2,1022,3.1158536585365852,0.0,0.0
4328,1,328,[272 478 509 208 264],13,5,1027,3.121580547112462,0.0,0.0
4329,1,329,[299 301 261 215 243],13,1,1028,3.1151515151515152,0.0,0.0
4330,1,330,[272 478 509 208 264],13,5,1033,3.120845921450151,0.0,0.0
4331,1,331,[272 478 509 208 264],13,5,1038,3.1265060240963853,0.0,0.0
4332,1,332,[272 478 509 208 264],13,5,1043,3.1321321321321323,0.0,0.0
4333,1,333,[272 478 509 208 264],13,5,1048,3.1377245508982035,0.0,0.0
4334,1,334,[272 478 509 208 264],13,5,1053,3.1432835820895524,0.0,0.0
4335,1,335,[272 478 509 208 264],13,5,1058,3.1488095238095237,0.0,0.0
4336,1,336,[272 478 509 208 264],13,5,1063,3.1543026706231454,0.0,0.0
4337,1,337,[331 301 284 226 202],145,3,1066,3.1538461538461537,0.0,0.0
4338,1,338,[272 478 509 208 264],13,5,1071,3.15929203539823,0.0,0.0
4339,1,339,[272 478 509 208 264],13,5,1076,3.164705882352941,0.0,0.0
4340,1,340,[272 478 509 208 264],13,5,1081,3.1700879765395893,0.0,0.0
4341,1,341,[208 431 326 202 218],102,2,1083,3.1666666666666665,0.0,0.0
4342,1,342,[227 218 222 280 220],378,0,1083,3.1574344023323615,0.0,20.0
4343,1,343,[272 478 509 208 264],13,5,1088,3.1627906976744184,0.0,0.0
4344,1,344,[272 213 420 254 239],378,3,1091,3.1623188405797102,0.0,0.0
4345,1,345,[276 202 485 259 230],308,3,1094,3.161849710982659,0.0,20.0
4346,1,346,[272 478 509 208 264],13,5,1099,3.1671469740634004,0.0,0.0
4347,1,347,[272 478 509 208 264],13,5,1104,3.1724137931034484,0.0,0.0
4348,1,348,[243 485 208 300 378],234,2,1106,3.169054441260745,0.0,20.0
4349,1,349,[215 420 230 280 431],749,4,1110,3.1714285714285713,0.0,0.0
4350,1,350,[509 303 326 293 300],894,4,1114,3.173789173789174,0.0,20.0
4351,1,351,[272 478 509 208 264],13,5,1119,3.178977272727273,0.0,0.0
4352,1,352,[272 478 509 208 264],13,5,1124,3.1841359773371103,0.0,0.0
4353,1,353,[272 478 509 208 264],13,5,1129,3.189265536723164,0.0,0.0
4354,1,354,[431 378 284 232 239],749,5,1134,3.1943661971830988,0.0,0.0
4355,1,355,[429 226 284 365 227],749,4,1138,3.196629213483146,0.0,0.0
4356,1,356,[272 478 509 208 264],13,5,1143,3.2016806722689077,0.0,0.0
4357,1,357,[275 268 344 297 331],894,4,1147,3.2039106145251397,20.0,20.0
4358,1,358,[272 478 509 208 264],13,5,1152,3.2089136490250696,0.0,0.0
4359,1,359,[315 507 232 420 367],650,1,1153,3.202777777777778,20.0,0.0
4360,1,360,[272 478 509 208 264],13,5,1158,3.2077562326869806,0.0,0.0
4361,1,361,[272 478 509 208 264],13,5,1163,3.212707182320442,0.0,0.0
4362,1,362,[216 429 283 321 367],234,2,1165,3.209366391184573,0.0,0.0
4363,1,363,[272 478 509 208 264],13,5,1170,3.2142857142857144,0.0,0.0
4364,1,364,[272 478 509 208 264],13,5,1175,3.219178082191781,0.0,0.0
4365,1,365,[272 478 509 208 264],13,5,1180,3.2240437158469946,0.0,0.0
4366,1,366,[272 478 509 208 264],13,5,1185,3.2288828337874658,0.0,0.0
4367,1,367,[272 478 509 208 264],13,5,1190,3.233695652173913,0.0,0.0
4368,1,368,[295 227 326 223 485],378,2,1192,3.230352303523035,20.0,0.0
4369,1,369,[272 478 509 208 264],13,5,1197,3.235135135135135,0.0,0.0
4370,1,370,[272 478 509 208 264],13,5,1202,3.2398921832884096,0.0,0.0
4371,1,371,[283 392 209 452 231],308,2,1204,3.236559139784946,0.0,0.0
4372,1,372,[272 478 509 208 264],13,5,1209,3.2412868632707776,0.0,0.0
4373,1,373,[272 478 509 208 264],13,5,1214,3.2459893048128343,0.0,0.0
4374,1,374,[272 478 509 208 264],13,5,1219,3.2506666666666666,0.0,0.0
4375,1,375,[272 478 509 208 264],13,5,1224,3.25531914893617,0.0,0.0
4376,1,376,[272 478 509 208 264],13,5,1229,3.259946949602122,0.0,0.0
4377,1,377,[239 275 211 276 231],537,3,1232,3.259259259259259,0.0,60.0
4378,1,378,[272 478 509 208 264],13,5,1237,3.2638522427440635,0.0,0.0
4379,1,379,[291 243 230 478 231],200,3,1240,3.263157894736842,0.0,0.0
4380,1,380,[303 208 394 315 384],13,3,1243,3.2624671916010497,20.0,0.0
4381,1,381,[212 284 291 290 508],524,3,1246,3.261780104712042,0.0,0.0
4382,1,382,[272 478 509 208 264],13,5,1251,3.266318537859008,0.0,0.0
4383,1,383,[336 208 202 481 508],13,2,1253,3.2630208333333335,0.0,0.0
4384,1,384,[272 478 509 208 264],13,5,1258,3.2675324675324675,0.0,0.0
4385,1,385,[272 478 509 208 264],13,5,1263,3.272020725388601,0.0,0.0
4386,1,386,[272 478 509 208 264],13,5,1268,3.2764857881136953,0.0,0.0
4387,1,387,[275 301 226 219 259],279,2,1270,3.2731958762886597,0.0,20.0
4388,1,388,[485 509 429 218 216],13,2,1272,3.269922879177378,0.0,0.0
4389,1,389,[215 298 208 316 508],85,3,1275,3.269230769230769,20.0,0.0
4390,1,390,[276 231 230 367 218],311,4,1279,3.2710997442455243,0.0,20.0
4391,1,391,[272 478 509 208 264],13,5,1284,3.2755102040816326,0.0,0.0
4392,1,392,[272 478 509 208 264],13,5,1289,3.2798982188295165,0.0,0.0
4393,1,393,[280 239 208 230 431],200,4,1293,3.281725888324873,0.0,0.0
4394,1,394,[222 509 202 243 226],537,1,1294,3.2759493670886077,0.0,20.0
4395,1,395,[272 478 509 208 264],13,5,1299,3.2803030303030303,0.0,0.0
4396,1,396,[272 478 509 208 264],13,5,1304,3.2846347607052895,0.0,0.0
4397,1,397,[272 478 509 208 264],13,5,1309,3.2889447236180906,0.0,0.0
4398,1,398,[272 478 509 208 264],13,5,1314,3.293233082706767,0.0,0.0
4399,1,399,[268 216 209 508 231],13,1,1315,3.2875,0.0,0.0
4400,1,400,[230 259 509 478 378],474,3,1318,3.2867830423940148,0.0,0.0
4401,1,401,[272 478 509 208 264],13,5,1323,3.291044776119403,0.0,0.0
4402,1,402,[276 297 316 508 344],894,4,1327,3.292803970223325,40.0,20.0
4403,1,403,[272 478 509 208 264],13,5,1332,3.297029702970297,0.0,0.0
4404,1,404,[272 478 509 208 264],13,5,1337,3.3012345679012345,0.0,0.0
4405,1,405,[331 218 222 236 227],145,2,1339,3.2980295566502464,0.0,20.0
4406,1,406,[272 478 509 208 264],13,5,1344,3.302211302211302,0.0,0.0
4407,1,407,[239 230 227 202 384],102,2,1346,3.299019607843137,0.0,0.0
4408,1,408,[209 478 208 202 239],13,4,1350,3.3007334963325183,0.0,0.0
4409,1,409,[272 478 509 208 264],13,5,1355,3.3048780487804876,0.0,0.0
4410,1,410,[216 208 276 227 259],474,3,1358,3.3041362530413627,0.0,20.0
4411,1,411,[485 232 223 202 218],650,0,1358,3.296116504854369,20.0,0.0
4412,1,412,[485 284 295 231 217],378,1,1359,3.290556900726392,0.0,0.0
4413,1,413,[272 478 509 264 208],13,5,1364,3.2946859903381642,0.0,0.0
4414,1,414,[231 431 367 321 284],279,2,1366,3.291566265060241,0.0,0.0
4415,1,415,[227 209 216 217 378],843,1,1367,3.2860576923076925,0.0,0.0
4416,1,416,[213 283 226 392 300],537,2,1369,3.2829736211031175,0.0,20.0
4417,1,417,[272 478 509 264 208],13,5,1374,3.287081339712919,0.0,0.0
4418,1,418,[216 201 226 219 452],92,1,1375,3.2816229116945106,0.0,0.0
4419,1,419,[316 272 268 275 303],13,4,1379,3.283333333333333,20.0,20.0
4420,1,420,[272 478 509 264 208],13,5,1384,3.2874109263657956,0.0,0.0
4421,1,421,[272 478 509 264 208],13,5,1389,3.2914691943127963,0.0,0.0
4422,1,422,[378 268 452 275 226],7,4,1393,3.293144208037825,0.0,20.0
4423,1,423,[272 478 509 264 208],13,5,1398,3.297169811320755,0.0,0.0
4424,1,424,[215 290 212 230 420],13,4,1402,3.2988235294117647,0.0,0.0
4425,1,425,[231 223 240 276 209],643,4,1406,3.300469483568075,20.0,20.0
4426,1,426,[272 478 509 264 208],13,5,1411,3.3044496487119437,0.0,0.0
4427,1,427,[268 284 209 295 431],92,3,1414,3.303738317757009,0.0,0.0
4428,1,428,[272 478 509 264 208],13,5,1419,3.3076923076923075,0.0,0.0
4429,1,429,[272 478 509 264 208],13,5,1424,3.311627906976744,0.0,0.0
4430,1,430,[272 478 509 264 208],13,5,1429,3.3155452436194897,0.0,0.0
4431,1,431,[208 259 481 384 264],7,3,1432,3.314814814814815,0.0,0.0
4432,1,432,[272 478 509 264 208],13,5,1437,3.3187066974595845,0.0,0.0
4433,1,433,[272 478 509 264 208],13,5,1442,3.3225806451612905,0.0,0.0
4434,1,434,[272 478 509 264 208],13,5,1447,3.3264367816091953,0.0,0.0
4435,1,435,[272 478 509 264 208],13,5,1452,3.330275229357798,0.0,0.0
4436,1,436,[272 478 509 264 208],13,5,1457,3.334096109839817,0.0,0.0
4437,1,437,[272 478 509 264 208],13,5,1462,3.3378995433789953,0.0,0.0
4438,1,438,[508 284 213 256 297],894,2,1464,3.334851936218679,20.0,0.0
4439,1,439,[243 241 223 507 485],13,1,1465,3.3295454545454546,20.0,0.0
4440,1,440,[272 478 509 264 208],13,5,1470,3.3333333333333335,0.0,0.0
4441,1,441,[272 478 509 264 208],13,5,1475,3.33710407239819,0.0,0.0
4442,1,442,[209 283 276 295 202],308,3,1478,3.3363431151241536,0.0,20.0
4443,1,443,[272 478 509 264 208],13,5,1483,3.34009009009009,0.0,0.0
4444,1,444,[272 478 509 264 208],13,5,1488,3.343820224719101,0.0,0.0
4445,1,445,[272 478 509 264 208],13,5,1493,3.3475336322869955,0.0,0.0
4446,1,446,[222 208 212 431 202],194,1,1494,3.3422818791946307,0.0,20.0
4447,1,447,[272 478 509 264 208],13,5,1499,3.345982142857143,0.0,0.0
4448,1,448,[509 220 365 300 254],378,2,1501,3.3429844097995547,0.0,20.0
4449,1,449,[272 478 509 264 208],13,5,1506,3.3466666666666667,0.0,0.0
4450,1,450,[217 283 276 509 218],378,3,1509,3.3458980044345896,0.0,20.0
4451,1,451,[272 478 509 264 208],13,5,1514,3.349557522123894,0.0,0.0
4452,1,452,[272 478 509 264 208],13,5,1519,3.3532008830022075,0.0,0.0
4453,1,453,[508 217 239 300 275],334,1,1520,3.3480176211453743,0.0,40.0
4454,1,454,[290 220 293 326 209],334,0,1520,3.340659340659341,0.0,0.0
4455,1,455,[209 365 429 276 378],308,3,1523,3.3399122807017543,0.0,20.0
4456,1,456,[301 485 508 216 420],13,1,1524,3.334792122538293,0.0,0.0
4457,1,457,[275 231 223 211 216],328,3,1527,3.334061135371179,20.0,40.0
4458,1,458,[272 478 509 264 208],13,5,1532,3.337690631808279,0.0,0.0
4459,1,459,[222 209 211 429 509],64,4,1536,3.3391304347826085,0.0,40.0
4460,1,460,[272 478 509 264 208],13,5,1541,3.3427331887201737,0.0,0.0
4461,1,461,[272 478 509 264 208],13,5,1546,3.346320346320346,0.0,0.0
4462,1,462,[272 478 509 264 208],13,5,1551,3.349892008639309,0.0,0.0
4463,1,463,[272 478 509 264 208],13,5,1556,3.353448275862069,0.0,0.0
4464,1,464,[272 478 509 264 208],13,5,1561,3.356989247311828,0.0,0.0
4465,1,465,[239 222 254 227 236],279,3,1564,3.356223175965665,0.0,20.0
4466,1,466,[272 478 509 264 208],13,5,1569,3.359743040685225,0.0,0.0
4467,1,467,[300 239 508 367 275],378,3,1572,3.358974358974359,0.0,40.0
4468,1,468,[272 478 509 264 208],13,5,1577,3.3624733475479744,0.0,0.0
4469,1,469,[507 280 299 394 268],13,2,1579,3.3595744680851065,0.0,0.0
4470,1,470,[326 324 216 236 217],334,2,1581,3.356687898089172,0.0,0.0
4471,1,471,[272 478 509 264 208],13,5,1586,3.360169491525424,0.0,0.0
4472,1,472,[272 478 509 264 208],13,5,1591,3.3636363636363638,0.0,0.0
4473,1,473,[272 478 509 264 208],13,5,1596,3.367088607594937,0.0,0.0
4474,1,474,[209 384 216 231 226],13,1,1597,3.3621052631578947,0.0,0.0
4475,1,475,[272 478 509 264 208],13,5,1602,3.365546218487395,0.0,0.0
4476,1,476,[272 478 509 264 208],13,5,1607,3.368972746331237,0.0,0.0
4477,1,477,[272 478 509 264 208],13,5,1612,3.3723849372384938,0.0,0.0
4478,1,478,[429 255 485 297 276],334,3,1615,3.37160751565762,20.0,20.0
4479,1,479,[272 478 509 264 208],13,5,1620,3.375,0.0,0.0
4480,1,480,[272 478 509 264 208],13,5,1625,3.3783783783783785,0.0,0.0
4481,1,481,[208 481 321 264 201],13,2,1627,3.37551867219917,0.0,0.0
4482,1,482,[272 478 509 264 208],13,5,1632,3.37888198757764,0.0,0.0
4483,1,483,[272 478 509 264 208],13,5,1637,3.3822314049586777,0.0,0.0
4484,1,484,[272 478 509 264 208],13,5,1642,3.3855670103092783,0.0,0.0
4485,1,485,[231 276 367 217 275],13,1,1643,3.380658436213992,0.0,40.0
4486,1,486,[272 478 509 264 208],13,5,1648,3.383983572895277,0.0,0.0
4487,1,487,[272 478 509 264 208],13,5,1653,3.387295081967213,0.0,0.0
4488,1,488,[272 478 509 264 208],13,5,1658,3.390593047034765,0.0,0.0
4489,1,489,[315 222 326 218 244],474,4,1662,3.3918367346938774,20.0,20.0
4490,1,490,[275 291 431 290 367],648,2,1664,3.389002036659878,0.0,20.0
4491,1,491,[272 478 509 264 208],13,5,1669,3.3922764227642275,0.0,0.0
4492,1,492,[272 478 509 264 208],13,5,1674,3.3955375253549698,0.0,0.0
4493,1,493,[255 202 206 429 300],666,4,1678,3.396761133603239,0.0,20.0
4494,1,494,[272 478 509 264 208],13,5,1683,3.4,0.0,0.0
4495,1,495,[272 478 509 264 208],13,5,1688,3.403225806451613,0.0,0.0
4496,1,496,[272 478 509 264 208],13,5,1693,3.4064386317907447,0.0,0.0
4497,1,497,[272 478 509 264 208],13,5,1698,3.4096385542168677,0.0,0.0
4498,1,498,[272 478 509 264 208],13,5,1703,3.4128256513026054,0.0,0.0
4499,1,499,[321 413 230 284 301],279,4,1707,3.414,0.0,0.0
4500,1,500,[272 478 509 264 208],13,5,1712,3.417165668662675,0.0,0.0
4501,1,501,[231 268 219 211 295],387,1,1713,3.412350597609562,0.0,20.0
4502,1,502,[272 478 509 264 208],13,5,1718,3.415506958250497,0.0,0.0
4503,1,503,[272 478 509 264 208],13,5,1723,3.4186507936507935,0.0,0.0
4504,1,504,[216 254 431 227 429],648,3,1726,3.4178217821782177,0.0,0.0
4505,1,505,[272 478 509 264 208],13,5,1731,3.4209486166007905,0.0,0.0
4506,1,506,[218 216 268 284 243],92,2,1733,3.418145956607495,0.0,0.0
4507,1,507,[367 255 222 217 321],378,1,1734,3.4133858267716537,0.0,20.0
4508,1,508,[272 478 509 264 208],13,5,1739,3.416502946954813,0.0,0.0
4509,1,509,[272 478 509 264 208],13,5,1744,3.4196078431372547,0.0,0.0
4510,1,510,[272 478 509 264 208],13,5,1749,3.4227005870841487,0.0,0.0
4511,1,511,[272 478 509 264 208],13,5,1754,3.42578125,0.0,0.0
4512,1,512,[272 478 509 264 208],13,5,1759,3.4288499025341133,0.0,0.0
4513,1,513,[367 216 429 290 217],650,2,1761,3.4260700389105057,0.0,0.0
4514,1,514,[272 478 509 264 208],13,5,1766,3.429126213592233,0.0,0.0
4515,1,515,[291 208 275 243 230],537,2,1768,3.4263565891472867,0.0,20.0
4516,1,516,[272 478 509 264 208],13,5,1773,3.4294003868471954,0.0,0.0
4517,1,517,[272 478 509 264 208],13,5,1778,3.4324324324324325,0.0,0.0
4518,1,518,[272 478 509 264 208],13,5,1783,3.4354527938342967,0.0,0.0
4519,1,519,[202 298 223 378 208],308,4,1787,3.4365384615384613,20.0,0.0
4520,1,520,[264 202 232 316 431],13,3,1790,3.435700575815739,20.0,0.0
4521,1,521,[272 478 509 264 208],13,5,1795,3.4386973180076628,0.0,0.0
4522,1,522,[208 367 481 316 216],13,2,1797,3.4359464627151053,20.0,0.0
4523,1,523,[272 478 509 264 208],13,5,1802,3.4389312977099236,0.0,0.0
4524,1,524,[231 230 239 276 392],200,4,1806,3.44,0.0,20.0
4525,1,525,[272 478 509 264 208],13,5,1811,3.4429657794676807,0.0,0.0
4526,1,526,[227 232 212 239 431],194,1,1812,3.4383301707779887,0.0,0.0
4527,1,527,[485 209 226 303 300],13,2,1814,3.4356060606060606,0.0,20.0
4528,1,528,[201 219 217 326 508],13,0,1814,3.429111531190926,0.0,0.0
4529,1,529,[272 478 509 264 208],13,5,1819,3.4320754716981132,0.0,0.0
4530,1,530,[272 478 509 264 208],13,5,1824,3.4350282485875705,0.0,0.0
4531,1,531,[272 478 509 264 208],13,5,1829,3.43796992481203,0.0,0.0
4532,1,532,[272 478 509 264 208],13,5,1834,3.4409005628517826,0.0,0.0
4533,1,533,[272 478 509 264 208],13,5,1839,3.443820224719101,0.0,0.0
4534,1,534,[272 478 509 264 208],13,5,1844,3.446728971962617,0.0,0.0
4535,1,535,[272 478 509 264 208],13,5,1849,3.449626865671642,0.0,0.0
4536,1,536,[272 478 509 264 208],13,5,1854,3.452513966480447,0.0,0.0
4537,1,537,[272 478 509 264 208],13,5,1859,3.4553903345724906,0.0,0.0
4538,1,538,[272 478 509 264 208],13,5,1864,3.458256029684601,0.0,0.0
4539,1,539,[485 208 219 240 236],385,2,1866,3.4555555555555557,0.0,0.0
4540,1,540,[291 231 222 216 298],648,2,1868,3.4528650646950094,0.0,20.0
4541,1,541,[211 227 429 208 344],13,4,1872,3.4538745387453873,0.0,20.0
4542,1,542,[268 431 478 301 202],13,3,1875,3.453038674033149,0.0,0.0
4543,1,543,[378 208 254 209 280],749,4,1879,3.454044117647059,0.0,0.0
4544,1,544,[272 478 509 264 208],13,5,1884,3.456880733944954,0.0,0.0
4545,1,545,[272 478 509 264 208],13,5,1889,3.45970695970696,0.0,0.0
4546,1,546,[272 478 509 264 208],13,5,1894,3.4625228519195614,0.0,0.0
4547,1,547,[268 202 276 221 219],234,0,1894,3.4562043795620436,0.0,20.0
4548,1,548,[272 478 509 264 208],13,5,1899,3.459016393442623,0.0,0.0
4549,1,549,[272 478 509 264 208],13,5,1904,3.461818181818182,0.0,0.0
4550,1,550,[272 478 509 264 208],13,5,1909,3.4646098003629766,0.0,0.0
4551,1,551,[272 478 509 264 208],13,5,1914,3.467391304347826,0.0,0.0
4552,1,552,[508 241 452 254 367],774,1,1915,3.4629294755877034,0.0,0.0
4553,1,553,[272 478 509 264 208],13,5,1920,3.4657039711191335,0.0,0.0
4554,1,554,[452 301 321 413 336],13,0,1920,3.4594594594594597,0.0,0.0
4555,1,555,[290 222 215 367 227],650,1,1921,3.4550359712230216,0.0,20.0
4556,1,556,[301 508 215 315 300],13,2,1923,3.452423698384201,20.0,20.0
4557,1,557,[283 241 250 213 485],479,3,1926,3.4516129032258065,0.0,0.0
4558,1,558,[272 478 509 264 208],13,5,1931,3.45438282647585,0.0,0.0
4559,1,559,[254 481 215 226 367],308,2,1933,3.4517857142857142,0.0,0.0
4560,1,560,[272 478 509 264 208],13,5,1938,3.4545454545454546,0.0,0.0
4561,1,561,[272 478 509 264 208],13,5,1943,3.4572953736654806,0.0,0.0
4562,1,562,[272 478 509 264 208],13,5,1948,3.4600355239786857,0.0,0.0
4563,1,563,[250 331 300 240 202],145,3,1951,3.4592198581560285,0.0,20.0
4564,1,564,[481 507 211 367 303],13,2,1953,3.456637168141593,0.0,20.0
4565,1,565,[272 478 509 264 208],13,5,1958,3.4593639575971733,0.0,0.0
4566,1,566,[272 478 509 264 208],13,5,1963,3.4620811287477955,0.0,0.0
4567,1,567,[429 367 208 216 219],406,2,1965,3.459507042253521,0.0,0.0
4568,1,568,[232 215 261 218 299],13,1,1966,3.4551845342706504,0.0,0.0
4569,1,569,[272 478 509 264 208],13,5,1971,3.457894736842105,0.0,0.0
4570,1,570,[275 259 215 213 509],90,3,1974,3.457092819614711,0.0,20.0
4571,1,571,[272 478 509 264 208],13,5,1979,3.4597902097902096,0.0,0.0
4572,1,572,[336 222 241 211 413],13,1,1980,3.4554973821989527,0.0,40.0
4573,1,573,[336 208 301 239 315],13,3,1983,3.4547038327526134,20.0,0.0
4574,1,574,[272 218 220 209 297],334,2,1985,3.4521739130434783,20.0,0.0
4575,1,575,[326 283 259 222 293],474,2,1987,3.4496527777777777,0.0,20.0
4576,1,576,[272 478 509 264 208],13,5,1992,3.4523396880415946,0.0,0.0
4577,1,577,[272 478 509 264 208],13,5,1997,3.4550173010380623,0.0,0.0
4578,1,578,[213 209 367 481 272],6,4,2001,3.4559585492227978,0.0,0.0
4579,1,579,[272 478 509 264 208],13,5,2006,3.4586206896551723,0.0,0.0
4580,1,580,[272 478 509 264 208],13,5,2011,3.4612736660929433,0.0,0.0
4581,1,581,[264 275 509 231 276],308,3,2014,3.4604810996563575,0.0,40.0
4582,1,582,[231 481 223 209 230],308,4,2018,3.4614065180102918,20.0,0.0
4583,1,583,[272 478 509 264 208],13,5,2023,3.464041095890411,0.0,0.0
4584,1,584,[202 209 583 231 201],795,4,2027,3.464957264957265,0.0,0.0
4585,1,585,[264 303 384 394 301],13,2,2029,3.462457337883959,0.0,0.0
4586,1,586,[215 226 365 231 392],311,5,2034,3.4650766609880748,0.0,0.0
4587,1,587,[272 478 509 264 208],13,5,2039,3.4676870748299318,0.0,0.0
4588,1,588,[220 246 298 280 299],486,0,2039,3.461799660441426,0.0,0.0
4589,1,589,[272 478 509 264 208],13,5,2044,3.464406779661017,0.0,0.0
4590,1,590,[216 255 300 298 295],533,4,2048,3.4653130287648053,0.0,20.0
4591,1,591,[316 431 232 227 394],13,2,2050,3.4628378378378377,20.0,0.0
4592,1,592,[290 243 300 485 211],13,2,2052,3.460370994940978,0.0,40.0
4593,1,593,[384 290 316 394 367],13,2,2054,3.457912457912458,20.0,0.0
4594,1,594,[272 478 509 264 208],13,5,2059,3.4605042016806724,0.0,0.0
4595,1,595,[227 209 431 231 222],311,4,2063,3.4614093959731544,0.0,20.0
4596,1,596,[272 478 509 264 208],13,5,2068,3.4639865996649917,0.0,0.0
4597,1,597,[272 478 509 264 208],13,5,2073,3.4665551839464883,0.0,0.0
4598,1,598,[301 321 326 212 452],13,1,2074,3.4624373956594323,0.0,0.0
4599,1,599,[485 222 283 481 208],85,3,2077,3.4616666666666664,0.0,20.0
4600,1,600,[272 478 509 264 208],13,5,2082,3.464226289517471,0.0,0.0
4601,1,601,[217 300 208 223 316],13,3,2085,3.463455149501661,40.0,20.0
4602,1,602,[272 478 509 264 208],13,5,2090,3.4660033167495854,0.0,0.0
4603,1,603,[272 478 509 264 208],13,5,2095,3.468543046357616,0.0,0.0
4604,1,604,[272 478 509 264 208],13,5,2100,3.4710743801652892,0.0,0.0
4605,1,605,[272 478 509 264 208],13,5,2105,3.4735973597359737,0.0,0.0
4606,1,606,[275 202 384 276 268],13,3,2108,3.4728171334431632,0.0,40.0
4607,1,607,[220 367 384 208 222],648,3,2111,3.4720394736842106,0.0,20.0
4608,1,608,[272 478 509 264 208],13,5,2116,3.4745484400656816,0.0,0.0
4609,1,609,[272 478 509 264 208],13,5,2121,3.4770491803278687,0.0,0.0
4610,1,610,[413 219 211 202 290],13,3,2124,3.476268412438625,0.0,20.0
4611,1,611,[272 478 509 264 208],13,5,2129,3.4787581699346406,0.0,0.0
4612,1,612,[272 478 509 264 208],13,5,2134,3.4812398042414356,0.0,0.0
4613,1,613,[272 478 509 264 208],13,5,2139,3.48371335504886,0.0,0.0
4614,1,614,[272 478 509 264 208],13,5,2144,3.486178861788618,0.0,0.0
4615,1,615,[218 300 431 276 283],234,0,2144,3.4805194805194803,0.0,40.0
4616,1,616,[272 478 509 264 208],13,5,2149,3.4829821717990277,0.0,0.0
4617,1,617,[284 259 481 215 211],234,1,2150,3.4789644012944985,0.0,20.0
4618,1,618,[272 478 509 264 208],13,5,2155,3.481421647819063,0.0,0.0
4619,1,619,[216 378 206 290 243],234,2,2157,3.479032258064516,0.0,0.0
4620,1,620,[272 478 509 264 208],13,5,2162,3.4814814814814814,0.0,0.0
4621,1,621,[272 478 509 264 208],13,5,2167,3.4839228295819935,0.0,0.0
4622,1,622,[272 478 509 264 208],13,5,2172,3.4863563402889244,0.0,0.0
4623,1,623,[272 478 509 264 208],13,5,2177,3.488782051282051,0.0,0.0
4624,1,624,[291 264 298 420 283],308,2,2179,3.4864,0.0,0.0
4625,1,625,[272 478 509 264 208],13,5,2184,3.488817891373802,0.0,0.0
4626,1,626,[481 478 290 239 508],13,3,2187,3.488038277511962,0.0,0.0
4627,1,627,[272 206 218 227 315],650,2,2189,3.4856687898089174,20.0,0.0
4628,1,628,[272 478 509 264 208],13,5,2194,3.4880763116057234,0.0,0.0
4629,1,629,[272 478 509 264 208],13,5,2199,3.4904761904761905,0.0,0.0
4630,1,630,[431 508 201 246 231],387,2,2201,3.4881141045958794,0.0,0.0
4631,1,631,[583 216 429 222 259],524,2,2203,3.4857594936708862,0.0,20.0
4632,1,632,[202 226 222 275 583],158,2,2205,3.4834123222748814,0.0,40.0
4633,1,633,[321 213 223 284 429],234,1,2206,3.4794952681388014,20.0,0.0
4634,1,634,[276 429 212 367 222],13,3,2209,3.478740157480315,0.0,40.0
4635,1,635,[272 478 509 264 208],13,5,2214,3.481132075471698,0.0,0.0
4636,1,636,[272 478 509 264 208],13,5,2219,3.4835164835164836,0.0,0.0
4637,1,637,[272 478 509 264 208],13,5,2224,3.4858934169278997,0.0,0.0
4638,1,638,[272 478 509 264 208],13,5,2229,3.488262910798122,0.0,0.0
4639,1,639,[429 231 259 250 239],804,5,2234,3.490625,0.0,0.0
4640,1,640,[272 478 509 264 208],13,5,2239,3.4929797191887677,0.0,0.0
4641,1,641,[272 478 509 264 208],13,5,2244,3.4953271028037385,0.0,0.0
4642,1,642,[272 478 509 264 208],13,5,2249,3.4976671850699845,0.0,0.0
4643,1,643,[211 209 508 290 241],13,2,2251,3.4953416149068324,0.0,20.0
4644,1,644,[303 213 324 246 223],334,5,2256,3.4976744186046513,20.0,0.0
4645,1,645,[272 478 509 264 208],13,5,2261,3.5,0.0,0.0
4646,1,646,[326 295 275 236 293],937,4,2265,3.500772797527048,0.0,20.0
4647,1,647,[344 315 507 202 485],13,2,2267,3.498456790123457,20.0,0.0
4648,1,648,[272 478 509 264 208],13,5,2272,3.500770416024653,0.0,0.0
4649,1,649,[272 478 509 264 208],13,5,2277,3.503076923076923,0.0,0.0
4650,1,650,[478 291 280 221 213],234,0,2277,3.4976958525345623,0.0,0.0
4651,1,651,[272 478 509 264 208],13,5,2282,3.5,0.0,0.0
4652,1,652,[378 239 420 276 215],892,4,2286,3.5007656967840735,0.0,20.0
4653,1,653,[272 478 509 264 208],13,5,2291,3.503058103975535,0.0,0.0
4654,1,654,[301 272 275 218 413],13,1,2292,3.499236641221374,0.0,20.0
4655,1,655,[272 478 509 264 208],13,5,2297,3.5015243902439024,0.0,0.0
4656,1,656,[272 478 509 264 208],13,5,2302,3.503805175038052,0.0,0.0
4657,1,657,[272 478 509 264 208],13,5,2307,3.5060790273556233,0.0,0.0
4658,1,658,[507 231 243 331 230],13,0,2307,3.5007587253414263,0.0,0.0
4659,1,659,[272 478 509 264 208],13,5,2312,3.503030303030303,0.0,0.0
4660,1,660,[481 218 290 202 321],234,1,2313,3.4992435703479576,0.0,0.0
4661,1,661,[272 478 509 264 208],13,5,2318,3.501510574018127,0.0,0.0
4662,1,662,[272 478 509 264 208],13,5,2323,3.5037707390648567,0.0,0.0
4663,1,663,[227 254 230 367 390],279,2,2325,3.5015060240963853,0.0,0.0
4664,1,664,[216 243 218 206 378],650,2,2327,3.4992481203007517,0.0,0.0
4665,1,665,[272 478 509 264 208],13,5,2332,3.5015015015015014,0.0,0.0
4666,1,666,[301 268 230 331 202],145,4,2336,3.502248875562219,0.0,0.0
4667,1,667,[223 420 239 255 222],378,3,2339,3.501497005988024,20.0,20.0
4668,1,668,[272 478 509 264 208],13,5,2344,3.5037369207772797,0.0,0.0
4669,1,669,[272 478 509 264 208],13,5,2349,3.505970149253731,0.0,0.0
4670,1,670,[227 367 219 429 223],7,3,2352,3.50521609538003,20.0,0.0
4671,1,671,[481 208 392 291 215],308,3,2355,3.5044642857142856,0.0,0.0
4672,1,672,[272 478 509 264 208],13,5,2360,3.5066864784546805,0.0,0.0
4673,1,673,[272 478 509 264 208],13,5,2365,3.5089020771513355,0.0,0.0
4674,1,674,[272 478 509 264 208],13,5,2370,3.511111111111111,0.0,0.0
4675,1,675,[275 299 211 222 241],13,1,2371,3.507396449704142,0.0,60.0
4676,1,676,[272 478 509 264 208],13,5,2376,3.5096011816838995,0.0,0.0
4677,1,677,[272 478 509 264 208],13,5,2381,3.5117994100294987,0.0,0.0
4678,1,678,[239 223 211 201 321],13,3,2384,3.5110456553755522,20.0,20.0
4679,1,679,[201 485 239 218 227],13,2,2386,3.5088235294117647,0.0,0.0
4680,1,680,[272 478 509 264 208],13,5,2391,3.511013215859031,0.0,0.0
4681,1,681,[209 222 240 254 206],804,3,2394,3.5102639296187683,0.0,20.0
4682,1,682,[272 478 509 264 208],13,5,2399,3.512445095168375,0.0,0.0
4683,1,683,[272 478 509 264 208],13,5,2404,3.5146198830409356,0.0,0.0
4684,1,684,[272 478 509 264 208],13,5,2409,3.5167883211678834,0.0,0.0
4685,1,685,[392 212 259 222 300],537,0,2409,3.511661807580175,0.0,40.0
4686,1,686,[244 276 216 507 202],271,2,2411,3.509461426491994,0.0,20.0
4687,1,687,[452 429 219 241 413],13,1,2412,3.505813953488372,0.0,0.0
4688,1,688,[272 478 509 264 208],13,5,2417,3.5079825834542815,0.0,0.0
4689,1,689,[431 509 508 201 212],13,2,2419,3.5057971014492755,0.0,0.0
4690,1,690,[272 478 509 264 208],13,5,2424,3.507959479015919,0.0,0.0
4691,1,691,[299 219 301 507 222],13,0,2424,3.5028901734104045,0.0,20.0
4692,1,692,[202 284 209 254 231],749,4,2428,3.5036075036075034,0.0,0.0
4693,1,693,[290 420 222 243 276],13,3,2431,3.5028818443804033,0.0,40.0
4694,1,694,[378 583 291 259 367],308,2,2433,3.500719424460432,0.0,0.0
4695,1,695,[350 509 217 226 208],13,3,2436,3.5,0.0,0.0
4696,1,696,[272 478 509 264 208],13,5,2441,3.5021520803443327,0.0,0.0
4697,1,697,[272 478 509 264 208],13,5,2446,3.504297994269341,0.0,0.0
4698,1,698,[272 478 509 264 208],13,5,2451,3.5064377682403434,0.0,0.0
4699,1,699,[272 478 509 264 208],13,5,2456,3.5085714285714285,0.0,0.0
4700,1,700,[272 478 509 264 208],13,5,2461,3.5106990014265333,0.0,0.0
4701,1,701,[272 478 509 264 208],13,5,2466,3.5128205128205128,0.0,0.0
4702,1,702,[272 478 509 264 208],13,5,2471,3.514935988620199,0.0,0.0
4703,1,703,[264 202 201 507 326],13,2,2473,3.512784090909091,0.0,0.0
4704,1,704,[239 280 291 202 226],200,3,2476,3.5120567375886527,0.0,0.0
4705,1,705,[251 254 208 209 215],385,1,2477,3.508498583569405,20.0,0.0
4706,1,706,[272 478 509 264 208],13,5,2482,3.510608203677511,0.0,0.0
4707,1,707,[211 275 509 485 216],95,3,2485,3.5098870056497176,0.0,40.0
4708,1,708,[202 209 219 267 226],833,3,2488,3.5091678420310295,0.0,0.0
4709,1,709,[209 211 367 208 378],650,2,2490,3.507042253521127,0.0,20.0
4710,1,710,[272 478 509 264 208],13,5,2495,3.509142053445851,0.0,0.0
4711,1,711,[272 478 509 264 208],13,5,2500,3.5112359550561796,0.0,0.0
4712,1,712,[272 478 509 264 208],13,5,2505,3.5133239831697054,0.0,0.0
4713,1,713,[272 478 509 264 208],13,5,2510,3.515406162464986,0.0,0.0
4714,1,714,[272 478 509 264 208],13,5,2515,3.5174825174825175,0.0,0.0
4715,1,715,[272 478 509 264 208],13,5,2520,3.5195530726256985,0.0,0.0
4716,1,716,[223 291 429 276 367],308,4,2524,3.5202231520223153,20.0,20.0
4717,1,717,[272 478 509 264 208],13,5,2529,3.522284122562674,0.0,0.0
4718,1,718,[272 478 509 264 208],13,5,2534,3.5243393602225312,0.0,0.0
4719,1,719,[243 241 202 324 211],387,2,2536,3.522222222222222,0.0,20.0
4720,1,720,[431 280 429 378 231],749,5,2541,3.5242718446601944,0.0,0.0
4721,1,721,[429 244 283 231 209],334,2,2543,3.5221606648199444,0.0,0.0
4722,1,722,[226 241 507 316 216],13,2,2545,3.520055325034578,20.0,0.0
4723,1,723,[272 478 509 264 208],13,5,2550,3.522099447513812,0.0,0.0
4724,1,724,[272 478 509 264 208],13,5,2555,3.524137931034483,0.0,0.0
4725,1,725,[303 206 508 284 213],537,3,2558,3.5234159779614327,0.0,0.0
4726,1,726,[272 478 509 264 208],13,5,2563,3.5254470426409905,0.0,0.0
4727,1,727,[272 478 509 264 208],13,5,2568,3.5274725274725274,0.0,0.0
4728,1,728,[272 478 509 264 208],13,5,2573,3.5294924554183815,0.0,0.0
4729,1,729,[272 478 509 264 208],13,5,2578,3.5315068493150683,0.0,0.0
4730,1,730,[232 241 431 326 231],328,2,2580,3.5294117647058822,0.0,0.0
4731,1,731,[226 223 240 231 215],92,2,2582,3.5273224043715845,20.0,0.0
4732,1,732,[216 324 223 213 217],334,3,2585,3.5266030013642564,20.0,0.0
4733,1,733,[236 276 216 275 283],533,3,2588,3.525885558583106,0.0,40.0
4734,1,734,[272 478 509 264 208],13,5,2593,3.527891156462585,0.0,0.0
4735,1,735,[367 222 508 268 246],92,4,2597,3.5285326086956523,0.0,20.0
4736,1,736,[303 509 241 212 221],90,5,2602,3.5305291723202172,0.0,0.0
4737,1,737,[290 209 240 231 365],804,4,2606,3.5311653116531163,0.0,0.0
4738,1,738,[272 478 509 264 208],13,5,2611,3.5331529093369416,0.0,0.0
4739,1,739,[231 485 326 220 222],334,1,2612,3.5297297297297296,0.0,20.0
4740,1,740,[272 478 509 264 208],13,5,2617,3.5317139001349527,0.0,0.0
4741,1,741,[215 429 219 392 276],59,4,2621,3.532345013477089,0.0,20.0
4742,1,742,[201 394 367 216 336],13,0,2621,3.5275908479138627,0.0,0.0
4743,1,743,[272 478 509 264 208],13,5,2626,3.5295698924731185,0.0,0.0
4744,1,744,[272 478 509 264 208],13,5,2631,3.531543624161074,0.0,0.0
4745,1,745,[256 272 316 290 283],894,2,2633,3.5294906166219837,20.0,0.0
4746,1,746,[272 478 509 264 208],13,5,2638,3.531459170013387,0.0,0.0
4747,1,747,[272 478 509 264 208],13,5,2643,3.533422459893048,0.0,0.0
4748,1,748,[272 478 509 264 208],13,5,2648,3.5353805073431244,0.0,0.0
4749,1,749,[272 478 509 264 208],13,5,2653,3.537333333333333,0.0,0.0
4750,1,750,[272 478 509 264 208],13,5,2658,3.5392809587217045,0.0,0.0
4751,1,751,[481 213 583 429 367],308,5,2663,3.541223404255319,0.0,0.0
4752,1,752,[272 478 509 264 208],13,5,2668,3.543160690571049,0.0,0.0
4753,1,753,[300 217 232 261 272],13,1,2669,3.5397877984084882,0.0,20.0
4754,1,754,[300 283 509 275 209],537,4,2673,3.5403973509933775,0.0,40.0
4755,1,755,[272 478 509 264 208],13,5,2678,3.5423280423280423,0.0,0.0
4756,1,756,[272 478 509 264 208],13,5,2683,3.544253632760898,0.0,0.0
4757,1,757,[283 216 290 218 485],334,1,2684,3.54089709762533,0.0,0.0
4758,1,758,[272 478 509 264 208],13,5,2689,3.5428194993412383,0.0,0.0
4759,1,759,[272 478 509 264 208],13,5,2694,3.544736842105263,0.0,0.0
4760,1,760,[331 211 478 226 326],13,3,2697,3.5440210249671487,0.0,20.0
4761,1,761,[509 324 452 384 275],7,3,2700,3.543307086614173,0.0,20.0
4762,1,762,[227 275 208 211 259],7,3,2703,3.54259501965924,0.0,40.0
4763,1,763,[272 478 509 264 208],13,5,2708,3.5445026178010473,0.0,0.0
4764,1,764,[272 478 509 264 208],13,5,2713,3.5464052287581698,0.0,0.0
4765,1,765,[272 478 509 264 208],13,5,2718,3.548302872062663,0.0,0.0
4766,1,766,[272 478 509 264 208],13,5,2723,3.5501955671447196,0.0,0.0
4767,1,767,[272 478 509 264 208],13,5,2728,3.5520833333333335,0.0,0.0
4768,1,768,[211 215 208 220 240],59,3,2731,3.551365409622887,0.0,20.0
4769,1,769,[272 478 509 264 208],13,5,2736,3.553246753246753,0.0,0.0
4770,1,770,[272 478 509 264 208],13,5,2741,3.5551232166018156,0.0,0.0
4771,1,771,[272 478 509 264 208],13,5,2746,3.55699481865285,0.0,0.0
4772,1,772,[290 350 243 264 276],13,3,2749,3.55627425614489,0.0,20.0
4773,1,773,[300 331 283 303 298],894,3,2752,3.5555555555555554,0.0,20.0
4774,1,774,[280 264 300 202 316],13,4,2756,3.5561290322580645,20.0,20.0
4775,1,775,[215 226 378 216 211],804,5,2761,3.5579896907216493,0.0,20.0
4776,1,776,[227 300 420 321 241],311,2,2763,3.555984555984556,0.0,20.0
4777,1,777,[272 478 509 264 208],13,5,2768,3.557840616966581,0.0,0.0
4778,1,778,[227 324 283 216 231],334,2,2770,3.5558408215661106,0.0,0.0
4779,1,779,[272 478 509 264 208],13,5,2775,3.5576923076923075,0.0,0.0
4780,1,780,[272 478 509 264 208],13,5,2780,3.559539052496799,0.0,0.0
4781,1,781,[227 276 431 226 222],145,3,2783,3.5588235294117645,0.0,40.0
4782,1,782,[272 478 509 264 208],13,5,2788,3.5606641123882503,0.0,0.0
4783,1,783,[275 508 290 485 216],334,1,2789,3.5573979591836733,0.0,20.0
4784,1,784,[272 478 509 264 208],13,5,2794,3.559235668789809,0.0,0.0
4785,1,785,[367 508 336 420 216],13,1,2795,3.5559796437659035,0.0,0.0
4786,1,786,[272 478 509 264 208],13,5,2800,3.5578144853875475,0.0,0.0
4787,1,787,[272 478 509 264 208],13,5,2805,3.5596446700507616,0.0,0.0
4788,1,788,[378 284 291 202 208],234,2,2807,3.55766793409379,0.0,0.0
4789,1,789,[272 478 509 264 208],13,5,2812,3.559493670886076,0.0,0.0
4790,1,790,[272 478 509 264 208],13,5,2817,3.5613147914032868,0.0,0.0
4791,1,791,[272 478 509 264 208],13,5,2822,3.563131313131313,0.0,0.0
4792,1,792,[507 208 321 478 509],537,4,2826,3.5636822194199245,0.0,0.0
4793,1,793,[272 478 509 264 208],13,5,2831,3.565491183879093,0.0,0.0
4794,1,794,[272 478 509 264 208],13,5,2836,3.567295597484277,0.0,0.0
4795,1,795,[256 284 295 283 221],894,1,2837,3.564070351758794,0.0,0.0
4796,1,796,[230 219 216 239 272],650,3,2840,3.5633626097867,0.0,0.0
4797,1,797,[272 478 509 264 208],13,5,2845,3.5651629072681703,0.0,0.0
4798,1,798,[272 478 509 264 208],13,5,2850,3.566958698372966,0.0,0.0
4799,1,799,[272 478 509 264 208],13,5,2855,3.56875,0.0,0.0
4800,1,800,[268 299 241 239 264],13,3,2858,3.568039950062422,0.0,0.0
4801,1,801,[429 508 293 216 367],385,2,2860,3.5660847880299253,0.0,0.0
4802,1,802,[272 478 509 264 208],13,5,2865,3.567870485678705,0.0,0.0
4803,1,803,[272 478 509 264 208],13,5,2870,3.5696517412935322,0.0,0.0
4804,1,804,[272 478 509 264 208],13,5,2875,3.5714285714285716,0.0,0.0
4805,1,805,[272 478 509 264 208],13,5,2880,3.5732009925558312,0.0,0.0
4806,1,806,[272 478 509 264 208],13,5,2885,3.5749690210656753,0.0,0.0
4807,1,807,[272 478 509 264 208],13,5,2890,3.5767326732673266,0.0,0.0
4808,1,808,[272 478 509 264 208],13,5,2895,3.5784919653893694,0.0,0.0
4809,1,809,[232 261 331 350 243],13,0,2895,3.574074074074074,0.0,0.0
4810,1,810,[272 478 509 264 208],13,5,2900,3.5758323057953145,0.0,0.0
4811,1,811,[272 478 509 264 208],13,5,2905,3.5775862068965516,0.0,0.0
4812,1,812,[272 478 509 264 208],13,5,2910,3.5793357933579335,0.0,0.0
4813,1,813,[429 223 215 222 431],234,1,2911,3.576167076167076,20.0,20.0
4814,1,814,[300 227 213 315 431],311,5,2916,3.577914110429448,20.0,20.0
4815,1,815,[272 478 509 264 208],13,5,2921,3.579656862745098,0.0,0.0
4816,1,816,[272 478 509 264 208],13,5,2926,3.5813953488372094,0.0,0.0
4817,1,817,[284 202 344 293 508],833,4,2930,3.5819070904645476,0.0,0.0
4818,1,818,[272 478 509 264 208],13,5,2935,3.583638583638584,0.0,0.0
4819,1,819,[367 243 240 202 230],92,0,2935,3.5792682926829267,0.0,0.0
4820,1,820,[272 478 509 264 208],13,5,2940,3.580998781973203,0.0,0.0
4821,1,821,[272 478 509 264 208],13,5,2945,3.5827250608272507,0.0,0.0
4822,1,822,[272 478 509 264 208],13,5,2950,3.5844471445929527,0.0,0.0
4823,1,823,[272 478 509 264 208],13,5,2955,3.5861650485436893,0.0,0.0
4824,1,824,[293 303 275 283 429],334,4,2959,3.5866666666666664,0.0,20.0
4825,1,825,[272 478 509 264 208],13,5,2964,3.5883777239709445,0.0,0.0
4826,1,826,[272 478 509 264 208],13,5,2969,3.5900846432889963,0.0,0.0
4827,1,827,[272 478 509 264 208],13,5,2974,3.5917874396135265,0.0,0.0
4828,1,828,[272 478 509 264 208],13,5,2979,3.5934861278648973,0.0,0.0
4829,1,829,[272 478 509 264 208],13,5,2984,3.595180722891566,0.0,0.0
4830,1,830,[293 303 202 218 236],533,3,2987,3.594464500601685,0.0,0.0
4831,1,831,[272 478 509 264 208],13,5,2992,3.5961538461538463,0.0,0.0
4832,1,832,[507 293 272 297 367],6,2,2994,3.5942376950780313,20.0,0.0
4833,1,833,[272 478 509 264 208],13,5,2999,3.595923261390887,0.0,0.0
4834,1,834,[272 478 509 264 208],13,5,3004,3.5976047904191617,0.0,0.0
4835,1,835,[272 478 509 264 208],13,5,3009,3.599282296650718,0.0,0.0
4836,1,836,[272 478 509 264 208],13,5,3014,3.6009557945041815,0.0,0.0
4837,1,837,[272 478 509 264 208],13,5,3019,3.6026252983293556,0.0,0.0
4838,1,838,[272 478 509 264 208],13,5,3024,3.604290822407628,0.0,0.0
4839,1,839,[272 478 509 264 208],13,5,3029,3.605952380952381,0.0,0.0
4840,1,840,[272 478 509 264 208],13,5,3034,3.6076099881093935,0.0,0.0
4841,1,841,[272 478 509 264 208],13,5,3039,3.6092636579572446,0.0,0.0
4842,1,842,[272 478 509 264 208],13,5,3044,3.6109134045077105,0.0,0.0
4843,1,843,[226 219 209 230 243],92,2,3046,3.609004739336493,0.0,0.0
4844,1,844,[478 218 280 300 272],13,3,3049,3.608284023668639,0.0,20.0
4845,1,845,[219 299 232 231 300],13,0,3049,3.604018912529551,0.0,20.0
4846,1,846,[272 478 509 264 208],13,5,3054,3.605667060212515,0.0,0.0
4847,1,847,[272 478 509 264 208],13,5,3059,3.607311320754717,0.0,0.0
4848,1,848,[209 217 215 272 212],650,1,3060,3.604240282685512,0.0,0.0
4849,1,849,[202 227 217 431 231],158,3,3063,3.603529411764706,0.0,0.0
4850,1,850,[217 344 232 336 509],13,1,3064,3.600470035252644,0.0,0.0
4851,1,851,[301 300 202 485 272],537,1,3065,3.597417840375587,0.0,20.0
4852,1,852,[316 301 272 300 244],334,2,3067,3.5955451348182885,20.0,20.0
4853,1,853,[272 478 509 264 208],13,5,3072,3.5971896955503513,0.0,0.0
4854,1,854,[298 208 452 293 392],308,4,3076,3.5976608187134502,0.0,0.0
4855,1,855,[272 478 509 264 208],13,5,3081,3.5992990654205608,0.0,0.0
4856,1,856,[272 478 509 264 208],13,5,3086,3.6009334889148192,0.0,0.0
4857,1,857,[272 478 509 264 208],13,5,3091,3.6025641025641026,0.0,0.0
4858,1,858,[272 478 509 264 208],13,5,3096,3.6041909196740396,0.0,0.0
4859,1,859,[212 290 295 255 284],894,1,3097,3.6011627906976744,0.0,0.0
4860,1,860,[211 378 431 367 291],833,0,3097,3.596980255516841,0.0,20.0
4861,1,861,[272 478 509 264 208],13,5,3102,3.5986078886310904,0.0,0.0
4862,1,862,[272 478 509 264 208],13,5,3107,3.600231749710313,0.0,0.0
4863,1,863,[272 478 509 264 208],13,5,3112,3.6018518518518516,0.0,0.0
4864,1,864,[268 583 232 217 213],7,1,3113,3.598843930635838,0.0,0.0
4865,1,865,[272 478 509 264 208],13,5,3118,3.600461893764434,0.0,0.0
4866,1,866,[212 217 431 507 219],7,3,3121,3.599769319492503,0.0,0.0
4867,1,867,[299 221 268 213 283],894,2,3123,3.597926267281106,0.0,0.0
4868,1,868,[226 298 392 481 291],308,3,3126,3.5972382048331415,0.0,0.0
4869,1,869,[272 478 509 264 208],13,5,3131,3.598850574712644,0.0,0.0
4870,1,870,[272 478 509 264 208],13,5,3136,3.6004592422502872,0.0,0.0
4871,1,871,[211 452 231 276 350],13,2,3138,3.5986238532110093,0.0,40.0
4872,1,872,[276 227 291 215 508],533,3,3141,3.597938144329897,0.0,20.0
4873,1,873,[367 227 290 208 226],524,2,3143,3.5961098398169336,0.0,0.0
4874,1,874,[336 316 344 295 284],894,2,3145,3.5942857142857143,20.0,0.0
4875,1,875,[272 478 509 264 208],13,5,3150,3.595890410958904,0.0,0.0
4876,1,876,[272 478 509 264 208],13,5,3155,3.597491448118586,0.0,0.0
4877,1,877,[272 478 509 264 208],13,5,3160,3.5990888382687927,0.0,0.0
4878,1,878,[272 478 509 264 208],13,5,3165,3.6006825938566553,0.0,0.0
4879,1,879,[230 485 583 478 241],524,2,3167,3.598863636363636,0.0,0.0
4880,1,880,[272 478 509 264 208],13,5,3172,3.6004540295119183,0.0,0.0
4881,1,881,[215 208 429 378 316],234,4,3176,3.600907029478458,20.0,0.0
4882,1,882,[284 509 219 211 431],406,1,3177,3.5979614949037373,0.0,20.0
4883,1,883,[315 481 241 226 243],13,2,3179,3.5961538461538463,20.0,0.0
4884,1,884,[272 478 509 264 208],13,5,3184,3.5977401129943503,0.0,0.0
4885,1,885,[429 275 259 365 284],308,3,3187,3.5970654627539504,0.0,20.0
4886,1,886,[272 478 509 264 208],13,5,3192,3.5986471251409244,0.0,0.0
4887,1,887,[344 315 300 227 209],13,2,3194,3.5968468468468466,20.0,20.0
4888,1,888,[272 478 509 264 208],13,5,3199,3.5984251968503935,0.0,0.0
4889,1,889,[316 231 236 220 217],334,2,3201,3.596629213483146,20.0,0.0
4890,1,890,[272 478 509 264 208],13,5,3206,3.5982042648709314,0.0,0.0
4891,1,891,[336 239 232 243 222],13,1,3207,3.5952914798206277,0.0,20.0
4892,1,892,[272 478 509 264 208],13,5,3212,3.596864501679731,0.0,0.0
4893,1,893,[378 326 239 223 284],749,5,3217,3.598434004474273,20.0,0.0
4894,1,894,[321 367 507 485 240],59,3,3220,3.5977653631284916,0.0,0.0
4895,1,895,[315 221 243 201 206],537,1,3221,3.5948660714285716,20.0,0.0
4896,1,896,[272 478 509 264 208],13,5,3226,3.596432552954292,0.0,0.0
4897,1,897,[367 226 212 508 290],524,3,3229,3.5957683741648108,0.0,0.0
4898,1,898,[413 209 275 276 230],145,2,3231,3.5939933259176864,0.0,40.0
4899,1,899,[223 293 509 284 246],6,2,3233,3.5922222222222224,20.0,0.0
4900,1,900,[243 378 223 367 290],234,2,3235,3.5904550499445063,20.0,0.0
4901,1,901,[303 300 301 268 202],90,3,3238,3.58980044345898,0.0,20.0
4902,1,902,[272 478 509 264 208],13,5,3243,3.5913621262458473,0.0,0.0
4903,1,903,[268 378 507 208 202],537,3,3246,3.59070796460177,0.0,0.0
4904,1,904,[478 284 300 509 283],85,2,3248,3.588950276243094,0.0,20.0
4905,1,905,[272 478 509 264 208],13,5,3253,3.5905077262693155,0.0,0.0
4906,1,906,[272 478 509 264 208],13,5,3258,3.5920617420066154,0.0,0.0
4907,1,907,[231 298 321 208 293],308,3,3261,3.591409691629956,0.0,0.0
4908,1,908,[272 478 509 264 208],13,5,3266,3.592959295929593,0.0,0.0
4909,1,909,[272 478 509 264 208],13,5,3271,3.5945054945054946,0.0,0.0
4910,1,910,[272 478 509 264 208],13,5,3276,3.5960482985729967,0.0,0.0
4911,1,911,[272 478 509 264 208],13,5,3281,3.5975877192982457,0.0,0.0
4912,1,912,[227 246 243 206 219],387,2,3283,3.5958378970427165,0.0,0.0
4913,1,913,[226 284 259 485 301],524,1,3284,3.5929978118161925,0.0,0.0
4914,1,914,[272 478 509 264 208],13,5,3289,3.594535519125683,0.0,0.0
4915,1,915,[272 478 509 264 208],13,5,3294,3.596069868995633,0.0,0.0
4916,1,916,[378 276 215 216 478],537,2,3296,3.59432933478735,0.0,20.0
4917,1,917,[272 478 509 264 208],13,5,3301,3.5958605664488017,0.0,0.0
4918,1,918,[272 478 509 264 208],13,5,3306,3.5973884657236126,0.0,0.0
4919,1,919,[226 268 223 218 481],643,3,3309,3.5967391304347824,20.0,0.0
4920,1,920,[272 478 509 264 208],13,5,3314,3.598262757871878,0.0,0.0
4921,1,921,[215 378 290 219 509],95,4,3318,3.598698481561822,0.0,0.0
4922,1,922,[272 478 509 264 208],13,5,3323,3.600216684723727,0.0,0.0
4923,1,923,[209 508 227 208 226],339,3,3326,3.5995670995670994,0.0,0.0
4924,1,924,[321 219 413 344 212],13,1,3327,3.596756756756757,0.0,0.0
4925,1,925,[223 420 509 202 268],643,3,3330,3.5961123110151187,20.0,0.0
4926,1,926,[284 290 201 367 291],279,2,3332,3.594390507011866,0.0,0.0
4927,1,927,[272 478 509 264 208],13,5,3337,3.595905172413793,0.0,0.0
4928,1,928,[272 478 509 264 208],13,5,3342,3.597416576964478,0.0,0.0
4929,1,929,[272 478 509 264 208],13,5,3347,3.598924731182796,0.0,0.0
4930,1,930,[272 336 212 394 202],13,3,3350,3.59828141783029,0.0,0.0
4931,1,931,[254 216 378 509 208],184,4,3354,3.5987124463519313,0.0,0.0
4932,1,932,[272 478 509 264 208],13,5,3359,3.60021436227224,0.0,0.0
4933,1,933,[272 478 509 264 208],13,5,3364,3.601713062098501,0.0,0.0
4934,1,934,[241 243 231 321 209],387,1,3365,3.5989304812834226,0.0,0.0
4935,1,935,[272 478 509 264 208],13,5,3370,3.6004273504273505,0.0,0.0
4936,1,936,[272 478 509 264 208],13,5,3375,3.601921024546425,0.0,0.0
4937,1,937,[272 478 509 264 208],13,5,3380,3.603411513859275,0.0,0.0
4938,1,938,[227 211 208 215 478],506,5,3385,3.604898828541001,0.0,20.0
4939,1,939,[239 481 507 227 222],194,1,3386,3.6021276595744682,0.0,20.0
4940,1,940,[232 226 431 508 254],774,1,3387,3.5993623804463337,0.0,0.0
4941,1,941,[272 478 509 264 208],13,5,3392,3.6008492569002124,0.0,0.0
4942,1,942,[272 478 509 264 208],13,5,3397,3.6023329798515378,0.0,0.0
4943,1,943,[272 478 509 264 208],13,5,3402,3.6038135593220337,0.0,0.0
4944,1,944,[272 478 509 264 208],13,5,3407,3.605291005291005,0.0,0.0
4945,1,945,[272 478 509 264 208],13,5,3412,3.6067653276955602,0.0,0.0
4946,1,946,[250 301 231 222 254],279,1,3413,3.604012671594509,0.0,20.0
4947,1,947,[300 222 392 230 250],843,1,3414,3.6012658227848102,0.0,40.0
4948,1,948,[272 478 509 264 208],13,5,3419,3.6027397260273974,0.0,0.0
4949,1,949,[272 478 509 264 208],13,5,3424,3.6042105263157893,0.0,0.0
4950,1,950,[272 478 509 264 208],13,5,3429,3.6056782334384856,0.0,0.0
4951,1,951,[250 344 264 284 227],833,1,3430,3.6029411764705883,0.0,0.0
4952,1,952,[255 298 208 429 284],308,5,3435,3.6044071353620146,0.0,0.0
4953,1,953,[201 507 226 275 280],13,2,3437,3.60272536687631,0.0,20.0
4954,1,954,[297 244 209 272 223],334,3,3440,3.602094240837696,40.0,0.0
4955,1,955,[272 478 509 264 208],13,5,3445,3.6035564853556483,0.0,0.0
4956,1,956,[272 478 509 264 208],13,5,3450,3.605015673981191,0.0,0.0
4957,1,957,[272 478 509 264 208],13,5,3455,3.606471816283925,0.0,0.0
4958,1,958,[201 218 241 481 344],13,0,3455,3.602711157455683,0.0,0.0
4959,1,959,[275 420 208 431 365],311,4,3459,3.603125,0.0,20.0
4960,1,960,[420 384 208 452 316],13,3,3462,3.6024973985431843,20.0,0.0
4961,1,961,[272 478 509 264 208],13,5,3467,3.603950103950104,0.0,0.0
4962,1,962,[384 219 215 290 254],385,0,3467,3.600207684319834,0.0,0.0
4963,1,963,[272 478 509 264 208],13,5,3472,3.6016597510373445,0.0,0.0
4964,1,964,[272 478 509 264 208],13,5,3477,3.6031088082901555,0.0,0.0
4965,1,965,[272 478 509 264 208],13,5,3482,3.6045548654244306,0.0,0.0
4966,1,966,[272 478 509 264 208],13,5,3487,3.605997931747673,0.0,0.0
4967,1,967,[209 246 202 222 298],145,4,3491,3.606404958677686,0.0,20.0
4968,1,968,[208 293 211 283 230],533,3,3494,3.60577915376677,0.0,20.0
4969,1,969,[272 478 509 264 208],13,5,3499,3.607216494845361,0.0,0.0
4970,1,970,[272 478 509 264 208],13,5,3504,3.6086508753862,0.0,0.0
4971,1,971,[272 478 509 264 208],13,5,3509,3.610082304526749,0.0,0.0
4972,1,972,[272 478 509 264 208],13,5,3514,3.6115107913669067,0.0,0.0
4973,1,973,[272 478 509 264 208],13,5,3519,3.6129363449691994,0.0,0.0
4974,1,974,[300 272 239 276 509],13,4,3523,3.6133333333333333,0.0,40.0
4975,1,975,[276 275 301 246 261],6,1,3524,3.610655737704918,0.0,40.0
4976,1,976,[272 478 509 264 208],13,5,3529,3.6120777891504607,0.0,0.0
4977,1,977,[218 246 300 255 209],334,1,3530,3.609406952965235,0.0,20.0
4978,1,978,[261 208 431 243 212],13,2,3532,3.6077630234933604,0.0,0.0
4979,1,979,[272 478 509 264 208],13,5,3537,3.6091836734693876,0.0,0.0
4980,1,980,[413 209 202 254 290],804,4,3541,3.6095820591233436,0.0,0.0
4981,1,981,[218 215 201 211 321],308,3,3544,3.608961303462322,0.0,20.0
4982,1,982,[276 264 344 255 236],894,3,3547,3.6083418107833163,0.0,20.0
4983,1,983,[272 478 509 264 208],13,5,3552,3.6097560975609757,0.0,0.0
4984,1,984,[272 478 509 264 208],13,5,3557,3.6111675126903555,0.0,0.0
4985,1,985,[217 283 218 208 231],385,0,3557,3.607505070993915,0.0,0.0
4986,1,986,[272 478 509 264 208],13,5,3562,3.6089159067882473,0.0,0.0
4987,1,987,[272 478 509 264 208],13,5,3567,3.610323886639676,0.0,0.0
4988,1,988,[392 208 212 268 485],537,2,3569,3.608695652173913,0.0,0.0
4989,1,989,[272 478 509 264 208],13,5,3574,3.61010101010101,0.0,0.0
4990,1,990,[201 293 208 236 240],385,2,3576,3.608476286579213,0.0,0.0
4991,1,991,[272 478 509 264 208],13,5,3581,3.6098790322580645,0.0,0.0
4992,1,992,[297 293 230 316 485],334,3,3584,3.609264853977845,40.0,0.0
4993,1,993,[272 478 509 264 208],13,5,3589,3.6106639839034207,0.0,0.0
4994,1,994,[272 478 509 264 208],13,5,3594,3.6120603015075377,0.0,0.0
4995,1,995,[272 478 509 264 208],13,5,3599,3.6134538152610443,0.0,0.0
4996,1,996,[378 241 239 384 272],271,1,3600,3.6108324974924773,0.0,0.0
4997,1,997,[272 478 509 264 208],13,5,3605,3.6122244488977957,0.0,0.0
4998,1,998,[272 478 509 264 208],13,5,3610,3.6136136136136137,0.0,0.0
4999,1,999,[272 478 509 264 208],13,5,3615,3.615,0.0,0.0
5000,1,1000,[315 231 215 216 236],537,1,3616,3.612387612387612,20.0,0.0
5001,1,1001,[216 208 509 219 239],95,4,3620,3.6127744510978044,0.0,0.0
5002,1,1002,[272 478 509 264 208],13,5,3625,3.614157527417747,0.0,0.0
5003,1,1003,[291 216 239 202 284],749,5,3630,3.6155378486055776,0.0,0.0
5004,1,1004,[272 478 509 264 208],13,5,3635,3.616915422885572,0.0,0.0
5005,1,1005,[272 478 509 264 208],13,5,3640,3.618290258449304,0.0,0.0
5006,1,1006,[367 202 290 236 431],279,4,3644,3.618669314796425,0.0,0.0
5007,1,1007,[413 452 350 481 276],13,1,3645,3.6160714285714284,0.0,20.0
5008,1,1008,[272 478 509 264 208],13,5,3650,3.617443012884044,0.0,0.0
5009,1,1009,[485 276 300 420 222],378,4,3654,3.617821782178218,0.0,60.0
5010,1,1010,[331 217 315 300 209],145,2,3656,3.6162215628091,20.0,20.0
5011,1,1011,[272 478 509 264 208],13,5,3661,3.617588932806324,0.0,0.0
5012,1,1012,[272 478 509 264 208],13,5,3666,3.6189536031589338,0.0,0.0
5013,1,1013,[272 478 509 264 208],13,5,3671,3.6203155818540433,0.0,0.0
5014,1,1014,[239 485 243 331 230],13,1,3672,3.617733990147783,0.0,0.0
5015,1,1015,[272 478 509 264 208],13,5,3677,3.6190944881889764,0.0,0.0
5016,1,1016,[202 326 295 213 215],378,2,3679,3.617502458210423,0.0,0.0
5017,1,1017,[254 284 226 236 222],279,2,3681,3.6159135559921416,0.0,20.0
5018,1,1018,[367 507 276 264 209],13,2,3683,3.61432777232581,0.0,20.0
5019,1,1019,[254 213 485 231 378],308,1,3684,3.611764705882353,0.0,0.0
5020,1,1020,[272 478 509 264 208],13,5,3689,3.613124387855044,0.0,0.0
5021,1,1021,[272 478 509 264 208],13,5,3694,3.614481409001957,0.0,0.0
5022,1,1022,[272 478 509 264 208],13,5,3699,3.6158357771260996,0.0,0.0
5023,1,1023,[272 478 509 264 208],13,5,3704,3.6171875,0.0,0.0
5024,1,1024,[321 315 336 216 300],13,1,3705,3.6146341463414635,20.0,20.0
5025,1,1025,[212 378 226 227 230],311,4,3709,3.615009746588694,0.0,0.0
5026,1,1026,[272 478 509 264 208],13,5,3714,3.6163583252190845,0.0,0.0
5027,1,1027,[316 315 241 299 217],13,2,3716,3.614785992217899,40.0,0.0
5028,1,1028,[280 211 300 209 384],13,2,3718,3.6132167152575314,0.0,40.0
5029,1,1029,[272 478 509 264 208],13,5,3723,3.6145631067961164,0.0,0.0
5030,1,1030,[272 478 509 264 208],13,5,3728,3.615906886517944,0.0,0.0
5031,1,1031,[272 478 509 264 208],13,5,3733,3.617248062015504,0.0,0.0
5032,1,1032,[272 478 509 264 208],13,5,3738,3.6185866408518876,0.0,0.0
5033,1,1033,[272 478 509 264 208],13,5,3743,3.6199226305609282,0.0,0.0
5034,1,1034,[202 215 420 392 241],64,2,3745,3.6183574879227054,0.0,0.0
5035,1,1035,[209 230 218 508 227],387,3,3748,3.617760617760618,0.0,0.0
5036,1,1036,[208 226 239 283 216],883,3,3751,3.617164898746384,0.0,0.0
5037,1,1037,[272 478 509 264 208],13,5,3756,3.6184971098265897,0.0,0.0
5038,1,1038,[301 230 300 201 276],537,1,3757,3.6159769008662175,0.0,40.0
5039,1,1039,[284 264 272 326 303],894,2,3759,3.6144230769230767,0.0,0.0
5040,1,1040,[215 213 220 509 478],184,4,3763,3.6147934678194042,0.0,0.0
5041,1,1041,[217 275 250 485 216],184,4,3767,3.6151631477927064,0.0,20.0
5042,1,1042,[429 452 232 301 303],13,2,3769,3.613614573346117,0.0,0.0
5043,1,1043,[272 478 509 264 208],13,5,3774,3.6149425287356323,0.0,0.0
5044,1,1044,[509 295 241 298 213],378,3,3777,3.614354066985646,0.0,0.0
5045,1,1045,[208 230 509 336 485],13,2,3779,3.612810707456979,0.0,0.0
5046,1,1046,[272 478 509 264 208],13,5,3784,3.6141356255969437,0.0,0.0
5047,1,1047,[272 478 509 264 208],13,5,3789,3.6154580152671754,0.0,0.0
5048,1,1048,[272 478 509 264 208],13,5,3794,3.6167778836987607,0.0,0.0
5049,1,1049,[378 211 295 367 481],308,3,3797,3.6161904761904764,0.0,20.0
5050,1,1050,[272 478 509 264 208],13,5,3802,3.6175071360608944,0.0,0.0
5051,1,1051,[284 241 223 268 213],234,0,3802,3.6140684410646386,20.0,0.0
5052,1,1052,[284 367 300 230 216],378,2,3804,3.6125356125356127,0.0,20.0
5053,1,1053,[303 316 243 272 232],13,3,3807,3.611954459203036,20.0,0.0
5054,1,1054,[272 478 509 264 208],13,5,3812,3.613270142180095,0.0,0.0
5055,1,1055,[452 202 223 246 226],92,2,3814,3.6117424242424243,20.0,0.0
5056,1,1056,[272 478 509 264 208],13,5,3819,3.6130558183538315,0.0,0.0
5057,1,1057,[272 478 509 264 208],13,5,3824,3.614366729678639,0.0,0.0
5058,1,1058,[272 478 509 264 208],13,5,3829,3.615675165250236,0.0,0.0
5059,1,1059,[272 478 509 264 208],13,5,3834,3.616981132075472,0.0,0.0
5060,1,1060,[272 478 509 264 208],13,5,3839,3.6182846371347783,0.0,0.0
5061,1,1061,[272 478 509 264 208],13,5,3844,3.6195856873822976,0.0,0.0
5062,1,1062,[272 478 509 264 208],13,5,3849,3.620884289746002,0.0,0.0
5063,1,1063,[250 272 326 303 275],334,3,3852,3.6203007518796992,0.0,20.0
5064,1,1064,[272 478 509 264 208],13,5,3857,3.6215962441314553,0.0,0.0
5065,1,1065,[272 478 509 264 208],13,5,3862,3.622889305816135,0.0,0.0
5066,1,1066,[272 478 509 264 208],13,5,3867,3.624179943767573,0.0,0.0
5067,1,1067,[429 208 431 284 209],537,3,3870,3.6235955056179776,0.0,0.0
5068,1,1068,[272 478 509 264 208],13,5,3875,3.6248830682881197,0.0,0.0
5069,1,1069,[272 478 509 264 208],13,5,3880,3.6261682242990654,0.0,0.0
5070,1,1070,[272 478 509 264 208],13,5,3885,3.627450980392157,0.0,0.0
5071,1,1071,[272 478 509 264 208],13,5,3890,3.628731343283582,0.0,0.0
5072,1,1072,[272 478 509 264 208],13,5,3895,3.630009319664492,0.0,0.0
5073,1,1073,[272 478 509 264 208],13,5,3900,3.631284916201117,0.0,0.0
5074,1,1074,[208 217 216 264 420],13,3,3903,3.6306976744186046,0.0,0.0
5075,1,1075,[272 478 509 264 208],13,5,3908,3.6319702602230484,0.0,0.0
5076,1,1076,[272 478 509 264 208],13,5,3913,3.6332404828226554,0.0,0.0
5077,1,1077,[272 478 509 264 208],13,5,3918,3.6345083487940633,0.0,0.0
5078,1,1078,[272 478 509 264 208],13,5,3923,3.6357738646895275,0.0,0.0
5079,1,1079,[272 478 509 264 208],13,5,3928,3.637037037037037,0.0,0.0
5080,1,1080,[272 478 509 264 208],13,5,3933,3.6382978723404253,0.0,0.0
5081,1,1081,[301 509 390 227 284],279,2,3935,3.6367837338262476,0.0,0.0
5082,1,1082,[272 478 509 264 208],13,5,3940,3.6380424746075715,0.0,0.0
5083,1,1083,[284 227 293 478 222],749,4,3944,3.6383763837638377,0.0,20.0
5084,1,1084,[485 420 211 218 241],311,1,3945,3.6359447004608296,0.0,20.0
5085,1,1085,[218 208 231 226 246],92,3,3948,3.6353591160220993,0.0,0.0
5086,1,1086,[272 478 509 264 208],13,5,3953,3.636614535418583,0.0,0.0
5087,1,1087,[272 478 509 264 208],13,5,3958,3.6378676470588234,0.0,0.0
5088,1,1088,[272 478 509 264 208],13,5,3963,3.6391184573002753,0.0,0.0
5089,1,1089,[326 336 208 272 219],13,2,3965,3.6376146788990824,0.0,0.0
5090,1,1090,[272 478 509 264 208],13,5,3970,3.638863428047663,0.0,0.0
5091,1,1091,[232 226 365 509 429],7,4,3974,3.639194139194139,0.0,0.0
5092,1,1092,[241 321 213 208 239],308,3,3977,3.6386093321134494,0.0,0.0
5093,1,1093,[272 478 509 264 208],13,5,3982,3.639853747714808,0.0,0.0
5094,1,1094,[243 232 429 217 218],13,1,3983,3.6374429223744293,0.0,0.0
5095,1,1095,[272 478 509 264 208],13,5,3988,3.6386861313868613,0.0,0.0
5096,1,1096,[299 241 367 276 301],13,1,3989,3.636280765724704,0.0,20.0
5097,1,1097,[272 478 509 264 208],13,5,3994,3.6375227686703098,0.0,0.0
5098,1,1098,[324 367 230 218 452],833,1,3995,3.635122838944495,0.0,0.0
5099,1,1099,[280 413 303 315 350],13,3,3998,3.6345454545454547,20.0,0.0
5100,1,1100,[272 478 509 264 208],13,5,4003,3.6357856494096277,0.0,0.0
5101,1,1101,[272 478 509 264 208],13,5,4008,3.6370235934664246,0.0,0.0
5102,1,1102,[272 478 509 264 208],13,5,4013,3.6382592928377155,0.0,0.0
5103,1,1103,[272 478 509 264 208],13,5,4018,3.6394927536231885,0.0,0.0
5104,1,1104,[241 209 481 227 219],13,1,4019,3.63710407239819,0.0,0.0
5105,1,1105,[216 209 429 276 223],409,5,4024,3.638336347197107,20.0,20.0
5106,1,1106,[316 209 300 315 219],13,2,4026,3.6368563685636857,40.0,20.0
5107,1,1107,[299 367 280 336 201],13,1,4027,3.634476534296029,0.0,0.0
5108,1,1108,[272 478 509 264 208],13,5,4032,3.63570784490532,0.0,0.0
5109,1,1109,[272 478 509 264 208],13,5,4037,3.636936936936937,0.0,0.0
5110,1,1110,[272 478 509 264 208],13,5,4042,3.6381638163816383,0.0,0.0
5111,1,1111,[429 236 202 331 478],666,5,4047,3.639388489208633,0.0,0.0
5112,1,1112,[206 223 211 331 300],666,3,4050,3.638814016172507,20.0,40.0
5113,1,1113,[272 478 509 264 208],13,5,4055,3.640035906642729,0.0,0.0
5114,1,1114,[272 478 509 264 208],13,5,4060,3.6412556053811658,0.0,0.0
5115,1,1115,[217 264 218 219 321],13,1,4061,3.638888888888889,0.0,0.0
5116,1,1116,[272 478 509 264 208],13,5,4066,3.640107430617726,0.0,0.0
5117,1,1117,[275 485 226 315 300],537,2,4068,3.638640429338104,20.0,40.0
5118,1,1118,[452 301 276 300 481],13,1,4069,3.636282394995532,0.0,40.0
5119,1,1119,[272 478 509 264 208],13,5,4074,3.6375,0.0,0.0
5120,1,1120,[272 478 509 264 208],13,5,4079,3.63871543264942,0.0,0.0
5121,1,1121,[223 344 508 367 378],833,3,4082,3.6381461675579323,20.0,0.0
5122,1,1122,[202 241 264 239 300],102,1,4083,3.6357969723953696,0.0,20.0
5123,1,1123,[272 478 509 264 208],13,5,4088,3.6370106761565837,0.0,0.0
5124,1,1124,[272 478 509 264 208],13,5,4093,3.6382222222222222,0.0,0.0
5125,1,1125,[272 478 509 264 208],13,5,4098,3.6394316163410303,0.0,0.0
5126,1,1126,[272 478 509 264 208],13,5,4103,3.6406388642413487,0.0,0.0
5127,1,1127,[272 478 509 264 208],13,5,4108,3.641843971631206,0.0,0.0
5128,1,1128,[272 478 509 264 208],13,5,4113,3.6430469441984057,0.0,0.0
5129,1,1129,[290 211 367 344 301],13,2,4115,3.6415929203539825,0.0,20.0
5130,1,1130,[272 478 509 264 208],13,5,4120,3.642793987621574,0.0,0.0
5131,1,1131,[272 478 509 264 208],13,5,4125,3.643992932862191,0.0,0.0
5132,1,1132,[429 301 213 212 209],234,2,4127,3.642541924095322,0.0,0.0
5133,1,1133,[583 485 201 378 215],308,2,4129,3.6410934744268078,0.0,0.0
5134,1,1134,[216 293 508 223 367],207,2,4131,3.639647577092511,20.0,0.0
5135,1,1135,[272 478 509 264 208],13,5,4136,3.640845070422535,0.0,0.0
5136,1,1136,[272 478 509 264 208],13,5,4141,3.6420404573438874,0.0,0.0
5137,1,1137,[272 478 509 264 208],13,5,4146,3.6432337434094904,0.0,0.0
5138,1,1138,[272 478 509 264 208],13,5,4151,3.6444249341527657,0.0,0.0
5139,1,1139,[215 259 209 216 239],537,1,4152,3.642105263157895,0.0,0.0
5140,1,1140,[236 239 213 429 217],334,3,4155,3.6415425065731815,0.0,0.0
5141,1,1141,[272 478 509 264 208],13,5,4160,3.6427320490367774,0.0,0.0
5142,1,1142,[272 478 509 264 208],13,5,4165,3.6439195100612425,0.0,0.0
5143,1,1143,[272 478 509 264 208],13,5,4170,3.645104895104895,0.0,0.0
5144,1,1144,[275 202 276 429 259],537,2,4172,3.6436681222707423,0.0,40.0
5145,1,1145,[272 478 509 264 208],13,5,4177,3.6448516579406633,0.0,0.0
5146,1,1146,[272 478 509 264 208],13,5,4182,3.646033129904098,0.0,0.0
5147,1,1147,[272 478 509 264 208],13,5,4187,3.647212543554007,0.0,0.0
5148,1,1148,[227 218 481 350 272],13,2,4189,3.645778938207137,0.0,0.0
5149,1,1149,[298 284 507 255 583],308,4,4193,3.646086956521739,0.0,0.0
5150,1,1150,[272 478 509 264 208],13,5,4198,3.6472632493483927,0.0,0.0
5151,1,1151,[236 299 241 321 283],537,1,4199,3.6449652777777777,0.0,0.0
5152,1,1152,[420 223 208 218 241],308,5,4204,3.6461405030355594,20.0,0.0
5153,1,1153,[272 478 509 264 208],13,5,4209,3.647313691507799,0.0,0.0
5154,1,1154,[230 378 222 213 216],85,2,4211,3.6458874458874457,0.0,20.0
5155,1,1155,[272 478 509 264 208],13,5,4216,3.6470588235294117,0.0,0.0
5156,1,1156,[272 478 509 264 208],13,5,4221,3.648228176318064,0.0,0.0
5157,1,1157,[219 209 321 232 202],13,1,4222,3.64594127806563,0.0,0.0
5158,1,1158,[222 231 272 394 218],13,1,4223,3.643658326143227,0.0,20.0
5159,1,1159,[272 478 509 264 208],13,5,4228,3.6448275862068966,0.0,0.0
5160,1,1160,[272 478 509 264 208],13,5,4233,3.645994832041344,0.0,0.0
5161,1,1161,[222 223 227 244 268],334,3,4236,3.6454388984509465,20.0,20.0
5162,1,1162,[211 261 201 290 241],13,2,4238,3.64402407566638,0.0,20.0
5163,1,1163,[219 384 201 272 268],13,2,4240,3.642611683848797,0.0,0.0
5164,1,1164,[243 384 231 232 272],13,1,4241,3.640343347639485,0.0,0.0
5165,1,1165,[272 478 509 264 208],13,5,4246,3.641509433962264,0.0,0.0
5166,1,1166,[272 478 509 264 208],13,5,4251,3.6426735218508997,0.0,0.0
5167,1,1167,[201 394 239 429 275],13,2,4253,3.641267123287671,0.0,20.0
5168,1,1168,[297 485 509 259 208],6,3,4256,3.6407185628742513,20.0,0.0
5169,1,1169,[272 478 509 264 208],13,5,4261,3.641880341880342,0.0,0.0
5170,1,1170,[272 478 509 264 208],13,5,4266,3.643040136635354,0.0,0.0
5171,1,1171,[413 276 241 350 243],13,1,4267,3.6407849829351537,0.0,20.0
5172,1,1172,[208 231 275 230 227],13,2,4269,3.639386189258312,0.0,20.0
5173,1,1173,[220 321 284 392 367],378,0,4269,3.6362862010221466,0.0,0.0
5174,1,1174,[272 478 509 264 208],13,5,4274,3.637446808510638,0.0,0.0
5175,1,1175,[508 230 485 246 420],85,3,4277,3.636904761904762,0.0,0.0
5176,1,1176,[272 478 509 264 208],13,5,4282,3.6380628717077315,0.0,0.0
5177,1,1177,[301 284 221 478 276],6,2,4284,3.636672325976231,0.0,20.0
5178,1,1178,[272 478 509 264 208],13,5,4289,3.6378286683630194,0.0,0.0
5179,1,1179,[272 478 509 264 208],13,5,4294,3.6389830508474574,0.0,0.0
5180,1,1180,[226 219 254 507 259],308,0,4294,3.6359017781541065,0.0,0.0
5181,1,1181,[250 212 209 283 246],85,2,4296,3.6345177664974617,0.0,0.0
5182,1,1182,[272 478 509 264 208],13,5,4301,3.635672020287405,0.0,0.0
5183,1,1183,[272 478 509 264 208],13,5,4306,3.636824324324324,0.0,0.0
5184,1,1184,[206 272 201 230 392],537,1,4307,3.6345991561181434,0.0,0.0
5185,1,1185,[280 431 485 202 326],749,5,4312,3.6357504215851604,0.0,0.0
5186,1,1186,[272 478 509 264 208],13,5,4317,3.6368997472620053,0.0,0.0
5187,1,1187,[221 315 256 300 246],894,4,4321,3.637205387205387,20.0,20.0
5188,1,1188,[219 413 208 272 344],13,2,4323,3.63582842724979,0.0,0.0
5189,1,1189,[272 478 509 264 208],13,5,4328,3.6369747899159663,0.0,0.0
5190,1,1190,[272 478 509 264 208],13,5,4333,3.6381192275398826,0.0,0.0
5191,1,1191,[243 478 208 236 216],537,2,4335,3.636744966442953,0.0,0.0
5192,1,1192,[272 478 509 264 208],13,5,4340,3.6378876781223806,0.0,0.0
5193,1,1193,[230 478 201 508 350],13,1,4341,3.635678391959799,0.0,0.0
5194,1,1194,[272 478 509 264 208],13,5,4346,3.636820083682008,0.0,0.0
5195,1,1195,[272 478 509 264 208],13,5,4351,3.637959866220736,0.0,0.0
5196,1,1196,[509 239 481 219 284],406,0,4351,3.634920634920635,0.0,0.0
5197,1,1197,[216 215 219 509 241],95,4,4355,3.6352253756260433,0.0,0.0
5198,1,1198,[272 478 509 264 208],13,5,4360,3.6363636363636362,0.0,0.0
5199,1,1199,[272 478 509 264 208],13,5,4365,3.6375,0.0,0.0
5200,1,1200,[272 478 509 264 208],13,5,4370,3.6386344712739382,0.0,0.0
5201,1,1201,[429 215 316 315 350],13,4,4374,3.638935108153078,40.0,0.0
5202,1,1202,[202 478 276 231 211],13,4,4378,3.6392352452202825,0.0,40.0
5203,1,1203,[272 478 509 264 208],13,5,4383,3.6403654485049834,0.0,0.0
5204,1,1204,[272 478 509 264 208],13,5,4388,3.64149377593361,0.0,0.0
5205,1,1205,[217 280 230 209 344],13,1,4389,3.6393034825870645,0.0,0.0
5206,1,1206,[485 321 211 508 222],13,1,4390,3.6371168185584093,0.0,40.0
5207,1,1207,[321 284 508 223 213],378,3,4393,3.63658940397351,20.0,0.0
5208,1,1208,[272 478 509 264 208],13,5,4398,3.6377171215880892,0.0,0.0
5209,1,1209,[264 255 507 284 230],308,3,4401,3.637190082644628,0.0,0.0
5210,1,1210,[227 344 300 275 264],13,2,4403,3.6358381502890174,0.0,40.0
5211,1,1211,[367 217 394 303 326],13,1,4404,3.633663366336634,0.0,0.0
5212,1,1212,[230 268 384 209 394],13,1,4405,3.6314921681780707,0.0,0.0
5213,1,1213,[227 431 272 202 216],13,3,4408,3.6309719934102143,0.0,0.0
5214,1,1214,[272 478 509 208 264],13,5,4413,3.6320987654320986,0.0,0.0
5215,1,1215,[272 478 509 208 264],13,5,4418,3.633223684210526,0.0,0.0
5216,1,1216,[223 583 219 230 226],92,2,4420,3.6318816762530814,20.0,0.0
5217,1,1217,[272 478 509 208 264],13,5,4425,3.6330049261083746,0.0,0.0
5218,1,1218,[272 478 509 208 264],13,5,4430,3.634126333059885,0.0,0.0
5219,1,1219,[272 478 509 208 264],13,5,4435,3.6352459016393444,0.0,0.0
5220,1,1220,[272 478 509 208 264],13,5,4440,3.6363636363636362,0.0,0.0
5221,1,1221,[206 215 478 509 216],537,2,4442,3.635024549918167,0.0,0.0
5222,1,1222,[331 230 227 336 429],13,2,4444,3.633687653311529,0.0,0.0
5223,1,1223,[272 478 509 208 264],13,5,4449,3.6348039215686274,0.0,0.0
5224,1,1224,[272 478 509 208 264],13,5,4454,3.635918367346939,0.0,0.0
5225,1,1225,[230 300 291 241 211],85,1,4455,3.633768352365416,0.0,40.0
5226,1,1226,[272 478 509 208 264],13,5,4460,3.634881825590872,0.0,0.0
5227,1,1227,[241 429 300 275 230],694,4,4464,3.6351791530944624,0.0,40.0
5228,1,1228,[216 367 222 218 429],406,2,4466,3.6338486574450775,0.0,20.0
5229,1,1229,[209 231 298 201 378],308,3,4469,3.6333333333333333,0.0,0.0
5230,1,1230,[293 240 215 239 209],749,4,4473,3.633631194151097,0.0,0.0
5231,1,1231,[272 478 509 208 264],13,5,4478,3.63474025974026,0.0,0.0
5232,1,1232,[272 478 509 208 264],13,5,4483,3.635847526358475,0.0,0.0
5233,1,1233,[272 478 509 208 264],13,5,4488,3.6369529983792543,0.0,0.0
5234,1,1234,[272 478 509 208 264],13,5,4493,3.6380566801619434,0.0,0.0
5235,1,1235,[272 478 509 208 264],13,5,4498,3.6391585760517797,0.0,0.0
5236,1,1236,[301 326 221 303 208],334,3,4501,3.6386418755052548,0.0,0.0
5237,1,1237,[272 478 509 208 264],13,5,4506,3.639741518578352,0.0,0.0
5238,1,1238,[300 275 220 276 230],378,3,4509,3.639225181598063,0.0,60.0
5239,1,1239,[272 478 509 208 264],13,5,4514,3.640322580645161,0.0,0.0
5240,1,1240,[272 478 509 208 264],13,5,4519,3.6414182111200644,0.0,0.0
5241,1,1241,[272 478 509 208 264],13,5,4524,3.642512077294686,0.0,0.0
5242,1,1242,[218 301 324 326 303],334,2,4526,3.64119066773934,0.0,0.0
5243,1,1243,[272 478 509 208 264],13,5,4531,3.642282958199357,0.0,0.0
5244,1,1244,[331 264 250 509 297],894,4,4535,3.642570281124498,20.0,0.0
5245,1,1245,[272 478 509 208 264],13,5,4540,3.6436597110754416,0.0,0.0
5246,1,1246,[272 478 509 208 264],13,5,4545,3.644747393744988,0.0,0.0
5247,1,1247,[272 478 509 208 264],13,5,4550,3.6458333333333335,0.0,0.0
5248,1,1248,[326 223 276 213 344],894,4,4554,3.646116893514812,20.0,20.0
5249,1,1249,[272 478 509 208 264],13,5,4559,3.6472,0.0,0.0
5250,1,1250,[272 478 509 208 264],13,5,4564,3.6482813749000798,0.0,0.0
5251,1,1251,[272 478 509 208 264],13,5,4569,3.6493610223642174,0.0,0.0
5252,1,1252,[272 478 509 208 264],13,5,4574,3.650438946528332,0.0,0.0
5253,1,1253,[272 478 509 208 264],13,5,4579,3.6515151515151514,0.0,0.0
5254,1,1254,[272 478 509 208 264],13,5,4584,3.652589641434263,0.0,0.0
5255,1,1255,[222 300 254 344 272],548,2,4586,3.6512738853503186,0.0,40.0
5256,1,1256,[284 316 507 211 208],474,4,4590,3.6515513126491648,20.0,20.0
5257,1,1257,[215 507 223 280 201],13,3,4593,3.651033386327504,20.0,0.0
5258,1,1258,[272 478 509 208 264],13,5,4598,3.6521048451151708,0.0,0.0
5259,1,1259,[272 478 509 208 264],13,5,4603,3.653174603174603,0.0,0.0
5260,1,1260,[272 478 509 208 264],13,5,4608,3.654242664551943,0.0,0.0
5261,1,1261,[272 478 509 208 264],13,5,4613,3.655309033280507,0.0,0.0
5262,1,1262,[324 291 243 220 246],699,2,4615,3.6539984164687254,0.0,0.0
5263,1,1263,[272 478 509 208 264],13,5,4620,3.6550632911392404,0.0,0.0
5264,1,1264,[241 297 478 211 202],343,4,4624,3.655335968379447,20.0,20.0
5265,1,1265,[272 478 509 208 264],13,5,4629,3.656398104265403,0.0,0.0
5266,1,1266,[272 478 509 208 264],13,5,4634,3.657458563535912,0.0,0.0
5267,1,1267,[231 420 485 303 384],13,2,4636,3.6561514195583595,0.0,0.0
5268,1,1268,[232 208 429 452 508],774,0,4636,3.653270291568164,0.0,0.0
5269,1,1269,[272 478 509 264 208],13,5,4641,3.6543307086614174,0.0,0.0
5270,1,1270,[272 478 509 264 208],13,5,4646,3.6553894571203775,0.0,0.0
5271,1,1271,[272 478 509 264 208],13,5,4651,3.6564465408805034,0.0,0.0
5272,1,1272,[272 478 509 264 208],13,5,4656,3.657501963864886,0.0,0.0
5273,1,1273,[283 218 202 230 216],533,3,4659,3.6569858712715857,0.0,0.0
5274,1,1274,[272 478 509 264 208],13,5,4664,3.6580392156862747,0.0,0.0
5275,1,1275,[280 291 209 478 241],234,1,4665,3.6559561128526648,0.0,0.0
5276,1,1276,[272 478 509 264 208],13,5,4670,3.6570086139389195,0.0,0.0
5277,1,1277,[272 478 509 264 208],13,5,4675,3.6580594679186227,0.0,0.0
5278,1,1278,[295 211 583 284 291],308,3,4678,3.6575449569976546,0.0,20.0
5279,1,1279,[272 478 509 264 208],13,5,4683,3.65859375,0.0,0.0
5280,1,1280,[272 276 212 509 284],894,4,4687,3.6588602654176423,0.0,20.0
5281,1,1281,[272 478 509 264 208],13,5,4692,3.6599063962558502,0.0,0.0
5282,1,1282,[272 478 509 264 208],13,5,4697,3.660950896336711,0.0,0.0
5283,1,1283,[272 478 509 264 208],13,5,4702,3.661993769470405,0.0,0.0
5284,1,1284,[272 478 509 264 208],13,5,4707,3.663035019455253,0.0,0.0
5285,1,1285,[431 206 284 215 365],804,4,4711,3.6632970451010887,0.0,0.0
5286,1,1286,[272 478 509 264 208],13,5,4716,3.664335664335664,0.0,0.0
5287,1,1287,[272 478 509 264 208],13,5,4721,3.665372670807453,0.0,0.0
5288,1,1288,[272 478 509 264 208],13,5,4726,3.666408068269977,0.0,0.0
5289,1,1289,[283 300 367 290 209],234,2,4728,3.6651162790697676,0.0,20.0
5290,1,1290,[272 478 509 264 208],13,5,4733,3.6661502711076683,0.0,0.0
5291,1,1291,[201 208 420 268 367],13,3,4736,3.6656346749226008,0.0,0.0
5292,1,1292,[300 250 244 220 222],334,1,4737,3.663573085846868,0.0,40.0
5293,1,1293,[272 478 509 264 208],13,5,4742,3.6646058732612055,0.0,0.0
5294,1,1294,[272 478 509 264 208],13,5,4747,3.665637065637066,0.0,0.0
5295,1,1295,[272 478 509 264 208],13,5,4752,3.6666666666666665,0.0,0.0
5296,1,1296,[507 209 284 315 221],474,5,4757,3.6676946800308405,20.0,0.0
5297,1,1297,[272 478 509 264 208],13,5,4762,3.6687211093990757,0.0,0.0
5298,1,1298,[378 240 232 222 202],897,4,4766,3.6689761354888377,0.0,20.0
5299,1,1299,[272 230 209 316 452],13,2,4768,3.667692307692308,20.0,0.0
5300,1,1300,[272 478 509 264 208],13,5,4773,3.668716372021522,0.0,0.0
5301,1,1301,[272 478 509 264 208],13,5,4778,3.6697388632872503,0.0,0.0
5302,1,1302,[272 478 509 264 208],13,5,4783,3.6707597851112816,0.0,0.0
5303,1,1303,[216 209 367 301 507],13,0,4783,3.667944785276074,0.0,0.0
5304,1,1304,[316 217 452 211 300],13,2,4785,3.6666666666666665,20.0,40.0
5305,1,1305,[216 290 202 211 232],650,2,4787,3.6653905053598774,0.0,20.0
5306,1,1306,[215 208 239 246 231],387,0,4787,3.6625860749808723,0.0,0.0
5307,1,1307,[272 478 509 264 208],13,5,4792,3.6636085626911314,0.0,0.0
5308,1,1308,[212 261 227 452 219],13,2,4794,3.6623376623376624,0.0,0.0
5309,1,1309,[272 478 509 264 208],13,5,4799,3.663358778625954,0.0,0.0
5310,1,1310,[272 478 509 264 208],13,5,4804,3.664378337147216,0.0,0.0
5311,1,1311,[315 431 219 212 300],145,3,4807,3.6638719512195124,20.0,20.0
5312,1,1312,[321 276 226 378 230],537,1,4808,3.661843107387662,0.0,20.0
5313,1,1313,[344 239 367 303 321],13,2,4810,3.660578386605784,0.0,0.0
5314,1,1314,[272 478 509 264 208],13,5,4815,3.661596958174905,0.0,0.0
5315,1,1315,[239 507 202 216 452],13,2,4817,3.6603343465045595,0.0,0.0
5316,1,1316,[272 478 509 264 208],13,5,4822,3.6613515565679573,0.0,0.0
5317,1,1317,[272 478 509 264 208],13,5,4827,3.6623672230652504,0.0,0.0
5318,1,1318,[392 367 429 226 218],59,4,4831,3.66262319939348,0.0,0.0
5319,1,1319,[272 478 509 264 208],13,5,4836,3.6636363636363636,0.0,0.0
5320,1,1320,[272 478 509 264 208],13,5,4841,3.6646479939439818,0.0,0.0
5321,1,1321,[272 478 509 264 208],13,5,4846,3.6656580937972767,0.0,0.0
5322,1,1322,[272 478 509 264 208],13,5,4851,3.6666666666666665,0.0,0.0
5323,1,1323,[272 478 509 264 208],13,5,4856,3.6676737160120845,0.0,0.0
5324,1,1324,[272 478 509 264 208],13,5,4861,3.668679245283019,0.0,0.0
5325,1,1325,[275 241 264 243 231],13,1,4862,3.6666666666666665,0.0,20.0
5326,1,1326,[272 478 509 264 208],13,5,4867,3.66767143933685,0.0,0.0
5327,1,1327,[295 413 240 246 293],294,3,4870,3.6671686746987953,0.0,0.0
5328,1,1328,[272 478 509 264 208],13,5,4875,3.6681715575620766,0.0,0.0
5329,1,1329,[272 478 509 264 208],13,5,4880,3.669172932330827,0.0,0.0
5330,1,1330,[272 478 509 264 208],13,5,4885,3.6701728024042075,0.0,0.0
5331,1,1331,[272 478 509 264 208],13,5,4890,3.671171171171171,0.0,0.0
5332,1,1332,[209 326 344 420 509],13,2,4892,3.6699174793698424,0.0,0.0
5333,1,1333,[272 478 509 264 208],13,5,4897,3.6709145427286356,0.0,0.0
5334,1,1334,[507 212 378 268 202],7,2,4899,3.6696629213483147,0.0,0.0
5335,1,1335,[272 478 509 264 208],13,5,4904,3.6706586826347305,0.0,0.0
5336,1,1336,[336 300 208 217 478],13,2,4906,3.6694091249065073,0.0,20.0
5337,1,1337,[272 478 509 264 208],13,5,4911,3.6704035874439462,0.0,0.0
5338,1,1338,[272 478 509 264 208],13,5,4916,3.6713965646004483,0.0,0.0
5339,1,1339,[272 478 509 264 208],13,5,4921,3.6723880597014924,0.0,0.0
5340,1,1340,[272 478 509 264 208],13,5,4926,3.6733780760626398,0.0,0.0
5341,1,1341,[230 275 507 222 509],85,2,4928,3.6721311475409837,0.0,40.0
5342,1,1342,[299 231 215 452 239],13,2,4930,3.670886075949367,0.0,0.0
5343,1,1343,[217 240 431 227 250],648,2,4932,3.669642857142857,0.0,0.0
5344,1,1344,[272 478 509 264 208],13,5,4937,3.670631970260223,0.0,0.0
5345,1,1345,[272 478 509 264 208],13,5,4942,3.6716196136701336,0.0,0.0
5346,1,1346,[272 478 509 264 208],13,5,4947,3.6726057906458798,0.0,0.0
5347,1,1347,[272 478 509 264 208],13,5,4952,3.6735905044510386,0.0,0.0
5348,1,1348,[272 478 509 264 208],13,5,4957,3.674573758339511,0.0,0.0
5349,1,1349,[218 230 216 209 291],881,3,4960,3.674074074074074,0.0,0.0
5350,1,1350,[272 478 509 264 208],13,5,4965,3.675055514433753,0.0,0.0
5351,1,1351,[272 478 509 264 208],13,5,4970,3.67603550295858,0.0,0.0
5352,1,1352,[259 230 298 215 284],474,2,4972,3.6747967479674797,0.0,0.0
5353,1,1353,[452 420 211 507 431],13,2,4974,3.673559822747415,0.0,20.0
5354,1,1354,[216 275 243 221 206],537,1,4975,3.6715867158671585,0.0,20.0
5355,1,1355,[297 208 276 315 231],334,4,4979,3.671828908554572,40.0,20.0
5356,1,1356,[336 268 280 481 261],13,2,4981,3.6705969049373617,0.0,0.0
5357,1,1357,[272 478 509 264 208],13,5,4986,3.6715758468335786,0.0,0.0
5358,1,1358,[202 284 378 507 280],234,2,4988,3.670345842531273,0.0,0.0
5359,1,1359,[507 272 215 283 315],454,3,4991,3.6698529411764707,20.0,0.0
5360,1,1360,[378 250 223 291 227],749,4,4995,3.6700955180014696,20.0,0.0
5361,1,1361,[272 478 509 264 208],13,5,5000,3.671071953010279,0.0,0.0
5362,1,1362,[230 212 208 301 507],13,2,5002,3.6698459280997797,0.0,0.0
5363,1,1363,[222 209 216 226 223],194,1,5003,3.6678885630498534,20.0,20.0
5364,1,1364,[272 478 509 264 208],13,5,5008,3.6688644688644687,0.0,0.0
5365,1,1365,[272 478 509 264 208],13,5,5013,3.669838945827233,0.0,0.0
5366,1,1366,[272 478 509 264 208],13,5,5018,3.6708119970738844,0.0,0.0
5367,1,1367,[272 478 509 264 208],13,5,5023,3.671783625730994,0.0,0.0
5368,1,1368,[230 216 284 299 478],537,1,5024,3.6698319941563184,0.0,0.0
5369,1,1369,[226 255 284 297 367],533,2,5026,3.6686131386861316,20.0,0.0
5370,1,1370,[202 300 481 209 223],409,2,5028,3.6673960612691467,20.0,20.0
5371,1,1371,[201 508 209 211 261],13,1,5029,3.6654518950437316,0.0,20.0
5372,1,1372,[272 478 509 264 208],13,5,5034,3.666423889293518,0.0,0.0
5373,1,1373,[284 211 231 384 392],64,2,5036,3.6652110625909753,0.0,20.0
5374,1,1374,[272 478 509 264 208],13,5,5041,3.666181818181818,0.0,0.0
5375,1,1375,[272 478 509 264 208],13,5,5046,3.667151162790698,0.0,0.0
5376,1,1376,[272 478 509 264 208],13,5,5051,3.6681190994916486,0.0,0.0
5377,1,1377,[272 478 509 264 208],13,5,5056,3.669085631349782,0.0,0.0
5378,1,1378,[241 216 384 300 420],7,4,5060,3.6693255982596082,0.0,20.0
5379,1,1379,[272 478 509 264 208],13,5,5065,3.670289855072464,0.0,0.0
5380,1,1380,[272 478 509 264 208],13,5,5070,3.671252715423606,0.0,0.0
5381,1,1381,[272 478 509 264 208],13,5,5075,3.6722141823444283,0.0,0.0
5382,1,1382,[272 478 509 264 208],13,5,5080,3.673174258857556,0.0,0.0
5383,1,1383,[259 213 392 295 321],308,2,5082,3.671965317919075,0.0,0.0
5384,1,1384,[295 209 241 264 226],479,1,5083,3.6700361010830327,0.0,0.0
5385,1,1385,[208 392 259 226 283],308,2,5085,3.668831168831169,0.0,0.0
5386,1,1386,[272 478 509 264 208],13,5,5090,3.6697909156452777,0.0,0.0
5387,1,1387,[272 478 509 264 208],13,5,5095,3.6707492795389047,0.0,0.0
5388,1,1388,[272 478 509 264 208],13,5,5100,3.67170626349892,0.0,0.0
5389,1,1389,[303 324 321 221 246],486,3,5103,3.6712230215827337,0.0,0.0
5390,1,1390,[272 478 509 264 208],13,5,5108,3.672178289000719,0.0,0.0
5391,1,1391,[272 478 509 264 208],13,5,5113,3.673132183908046,0.0,0.0
5392,1,1392,[272 478 509 264 208],13,5,5118,3.6740847092605886,0.0,0.0
5393,1,1393,[272 478 509 264 208],13,5,5123,3.6750358680057387,0.0,0.0
5394,1,1394,[272 478 509 264 208],13,5,5128,3.6759856630824372,0.0,0.0
5395,1,1395,[272 478 509 264 208],13,5,5133,3.6769340974212033,0.0,0.0
5396,1,1396,[272 478 509 264 208],13,5,5138,3.677881173944166,0.0,0.0
5397,1,1397,[239 261 299 420 478],13,3,5141,3.6773962804005724,0.0,0.0
5398,1,1398,[202 241 275 216 276],82,3,5144,3.6769120800571837,0.0,40.0
5399,1,1399,[481 243 216 280 300],234,1,5145,3.675,0.0,20.0
5400,1,1400,[331 299 217 264 226],13,2,5147,3.673804425410421,0.0,0.0
5401,1,1401,[222 259 507 316 509],474,4,5151,3.674037089871612,20.0,20.0
5402,1,1402,[413 326 394 227 431],13,1,5152,3.6721311475409837,0.0,0.0
5403,1,1403,[283 255 223 254 481],308,3,5155,3.671652421652422,20.0,0.0
5404,1,1404,[216 316 259 272 420],940,5,5160,3.6725978647686834,20.0,0.0
5405,1,1405,[241 215 303 239 478],537,2,5162,3.671408250355619,0.0,0.0
5406,1,1406,[272 478 509 264 208],13,5,5167,3.672352523098792,0.0,0.0
5407,1,1407,[272 478 509 264 208],13,5,5172,3.6732954545454546,0.0,0.0
5408,1,1408,[272 478 509 264 208],13,5,5177,3.674237047551455,0.0,0.0
5409,1,1409,[272 478 509 264 208],13,5,5182,3.675177304964539,0.0,0.0
5410,1,1410,[429 300 215 275 299],13,2,5184,3.6739900779588943,0.0,40.0
5411,1,1411,[213 429 231 509 241],7,3,5187,3.673512747875354,0.0,0.0
5412,1,1412,[272 478 509 264 208],13,5,5192,3.6744515215852798,0.0,0.0
5413,1,1413,[272 478 509 264 208],13,5,5197,3.6753889674681752,0.0,0.0
5414,1,1414,[272 478 509 264 208],13,5,5202,3.6763250883392224,0.0,0.0
5415,1,1415,[216 212 231 275 298],85,1,5203,3.6744350282485874,0.0,20.0
5416,1,1416,[284 222 240 291 298],749,3,5206,3.673959068454481,0.0,20.0
5417,1,1417,[272 478 509 264 208],13,5,5211,3.6748942172073344,0.0,0.0
5418,1,1418,[232 212 481 241 264],7,3,5214,3.6744186046511627,0.0,0.0
5419,1,1419,[216 326 243 331 208],13,1,5215,3.6725352112676055,0.0,0.0
5420,1,1420,[272 478 509 264 208],13,5,5220,3.673469387755102,0.0,0.0
5421,1,1421,[272 478 509 264 208],13,5,5225,3.6744022503516174,0.0,0.0
5422,1,1422,[272 478 509 264 208],13,5,5230,3.6753338018271258,0.0,0.0
5423,1,1423,[201 509 507 219 254],308,2,5232,3.6741573033707864,0.0,0.0
5424,1,1424,[241 211 208 331 350],13,2,5234,3.672982456140351,0.0,20.0
5425,1,1425,[272 478 509 264 208],13,5,5239,3.6739130434782608,0.0,0.0
5426,1,1426,[276 413 478 202 216],13,3,5242,3.6734407848633497,0.0,20.0
5427,1,1427,[272 478 509 264 208],13,5,5247,3.6743697478991595,0.0,0.0
5428,1,1428,[272 478 509 264 208],13,5,5252,3.675297410776767,0.0,0.0
5429,1,1429,[272 478 509 264 208],13,5,5257,3.676223776223776,0.0,0.0
5430,1,1430,[272 478 509 264 208],13,5,5262,3.6771488469601676,0.0,0.0
5431,1,1431,[272 478 509 264 208],13,5,5267,3.678072625698324,0.0,0.0
5432,1,1432,[344 299 250 331 350],116,2,5269,3.6769016050244243,0.0,0.0
5433,1,1433,[272 478 509 264 208],13,5,5274,3.6778242677824267,0.0,0.0
5434,1,1434,[268 392 283 236 211],537,3,5277,3.6773519163763067,0.0,20.0
5435,1,1435,[272 478 509 264 208],13,5,5282,3.6782729805013927,0.0,0.0
5436,1,1436,[272 478 509 264 208],13,5,5287,3.67919276270007,0.0,0.0
5437,1,1437,[209 259 507 227 275],474,3,5290,3.678720445062587,0.0,20.0
5438,1,1438,[272 478 509 264 208],13,5,5295,3.679638637943016,0.0,0.0
5439,1,1439,[420 219 413 211 239],13,3,5298,3.6791666666666667,0.0,20.0
5440,1,1440,[272 478 509 264 208],13,5,5303,3.6800832755031228,0.0,0.0
5441,1,1441,[276 230 298 485 392],378,2,5305,3.6789181692094313,0.0,20.0
5442,1,1442,[431 392 202 321 231],311,4,5309,3.679140679140679,0.0,0.0
5443,1,1443,[272 478 509 264 208],13,5,5314,3.6800554016620497,0.0,0.0
5444,1,1444,[272 478 509 264 208],13,5,5319,3.680968858131488,0.0,0.0
5445,1,1445,[272 478 509 264 208],13,5,5324,3.681881051175657,0.0,0.0
5446,1,1446,[272 478 509 264 208],13,5,5329,3.68279198341396,0.0,0.0
5447,1,1447,[420 509 481 316 315],13,4,5333,3.6830110497237567,40.0,0.0
5448,1,1448,[290 344 216 315 420],13,3,5336,3.6825396825396823,20.0,0.0
5449,1,1449,[272 478 509 264 208],13,5,5341,3.683448275862069,0.0,0.0
5450,1,1450,[272 478 509 264 208],13,5,5346,3.684355616815989,0.0,0.0
5451,1,1451,[202 208 259 255 378],184,2,5348,3.683195592286501,0.0,0.0
5452,1,1452,[231 240 218 241 227],339,2,5350,3.6820371644872676,0.0,0.0
5453,1,1453,[272 478 509 264 208],13,5,5355,3.6829436038514443,0.0,0.0
5454,1,1454,[344 485 431 326 509],13,1,5356,3.681099656357388,0.0,0.0
5455,1,1455,[280 215 211 431 218],13,3,5359,3.680631868131868,0.0,20.0
5456,1,1456,[303 301 239 201 429],13,3,5362,3.680164722031572,0.0,0.0
5457,1,1457,[272 478 509 264 208],13,5,5367,3.6810699588477367,0.0,0.0
5458,1,1458,[272 478 509 264 208],13,5,5372,3.681973954763537,0.0,0.0
5459,1,1459,[272 478 509 264 208],13,5,5377,3.6828767123287673,0.0,0.0
5460,1,1460,[300 413 293 216 284],145,3,5380,3.682409308692676,0.0,20.0
5461,1,1461,[272 478 509 264 208],13,5,5385,3.6833105335157317,0.0,0.0
5462,1,1462,[272 478 509 264 208],13,5,5390,3.6842105263157894,0.0,0.0
5463,1,1463,[272 478 509 264 208],13,5,5395,3.685109289617486,0.0,0.0
5464,1,1464,[243 295 250 241 291],92,2,5397,3.6839590443686006,0.0,0.0
5465,1,1465,[272 478 509 264 208],13,5,5402,3.6848567530695773,0.0,0.0
5466,1,1466,[272 478 509 264 208],13,5,5407,3.685753237900477,0.0,0.0
5467,1,1467,[272 478 509 264 208],13,5,5412,3.6866485013623977,0.0,0.0
5468,1,1468,[272 478 509 264 208],13,5,5417,3.6875425459496256,0.0,0.0
5469,1,1469,[227 208 291 216 213],653,1,5418,3.6857142857142855,0.0,0.0
5470,1,1470,[272 478 509 264 208],13,5,5423,3.686607749830048,0.0,0.0
5471,1,1471,[272 478 509 264 208],13,5,5428,3.6875,0.0,0.0
5472,1,1472,[272 478 509 264 208],13,5,5433,3.6883910386965377,0.0,0.0
5473,1,1473,[272 478 509 264 208],13,5,5438,3.689280868385346,0.0,0.0
5474,1,1474,[303 509 241 213 276],90,5,5443,3.690169491525424,0.0,20.0
5475,1,1475,[272 478 509 264 208],13,5,5448,3.6910569105691056,0.0,0.0
5476,1,1476,[272 478 509 264 208],13,5,5453,3.691943127962085,0.0,0.0
5477,1,1477,[280 202 481 259 221],234,1,5454,3.6901217861975644,0.0,0.0
5478,1,1478,[272 478 509 264 208],13,5,5459,3.6910074374577415,0.0,0.0
5479,1,1479,[384 213 276 256 226],883,2,5461,3.6898648648648646,0.0,20.0
5480,1,1480,[216 243 212 508 261],13,1,5462,3.688048615800135,0.0,0.0
5481,1,1481,[272 478 509 264 208],13,5,5467,3.6889338731443995,0.0,0.0
5482,1,1482,[272 478 509 264 208],13,5,5472,3.6898179366149697,0.0,0.0
5483,1,1483,[272 478 509 264 208],13,5,5477,3.690700808625337,0.0,0.0
5484,1,1484,[272 478 509 264 208],13,5,5482,3.6915824915824915,0.0,0.0
5485,1,1485,[243 350 209 509 227],13,2,5484,3.690444145356662,0.0,0.0
5486,1,1486,[208 365 250 429 240],774,0,5484,3.6879623402824477,0.0,0.0
5487,1,1487,[272 478 509 264 208],13,5,5489,3.6888440860215055,0.0,0.0
5488,1,1488,[284 485 452 429 201],308,3,5492,3.6883814640698454,0.0,0.0
5489,1,1489,[211 272 216 232 394],13,2,5494,3.687248322147651,0.0,20.0
5490,1,1490,[268 216 272 220 259],90,4,5498,3.687458081824279,0.0,0.0
5491,1,1491,[298 251 255 264 336],486,1,5499,3.685656836461126,20.0,0.0
5492,1,1492,[272 478 509 264 208],13,5,5504,3.6865371734762222,0.0,0.0
5493,1,1493,[420 220 239 509 326],378,2,5506,3.6854082998661313,0.0,0.0
5494,1,1494,[272 478 509 264 208],13,5,5511,3.68628762541806,0.0,0.0
5495,1,1495,[272 478 509 264 208],13,5,5516,3.6871657754010694,0.0,0.0
5496,1,1496,[315 394 331 239 227],13,3,5519,3.6867067468269874,20.0,0.0
5497,1,1497,[507 243 261 272 216],13,1,5520,3.684913217623498,0.0,0.0
5498,1,1498,[231 226 275 213 509],537,3,5523,3.684456304202802,0.0,20.0
5499,1,1499,[272 478 509 264 208],13,5,5528,3.6853333333333333,0.0,0.0
5500,1,1500,[272 478 509 264 208],13,5,5533,3.6862091938707526,0.0,0.0
5501,1,1501,[272 478 509 264 208],13,5,5538,3.6870838881491346,0.0,0.0
5502,1,1502,[350 301 326 315 272],116,0,5538,3.684630738522954,20.0,0.0
5503,1,1503,[272 478 509 264 208],13,5,5543,3.685505319148936,0.0,0.0
5504,1,1504,[243 202 261 217 230],13,1,5544,3.683720930232558,0.0,0.0
5505,1,1505,[272 478 509 264 208],13,5,5549,3.684594953519256,0.0,0.0
5506,1,1506,[272 478 509 264 208],13,5,5554,3.685467816854678,0.0,0.0
5507,1,1507,[272 478 509 264 208],13,5,5559,3.6863395225464193,0.0,0.0
5508,1,1508,[272 478 509 264 208],13,5,5564,3.6872100728959576,0.0,0.0
5509,1,1509,[272 478 509 264 208],13,5,5569,3.6880794701986757,0.0,0.0
5510,1,1510,[272 478 509 264 208],13,5,5574,3.6889477167438782,0.0,0.0
5511,1,1511,[272 478 509 264 208],13,5,5579,3.689814814814815,0.0,0.0
5512,1,1512,[227 280 275 509 239],378,2,5581,3.6886979510905484,0.0,20.0
5513,1,1513,[243 485 316 507 272],13,2,5583,3.6875825627476884,20.0,0.0
5514,1,1514,[413 217 429 206 226],843,2,5585,3.6864686468646863,0.0,0.0
5515,1,1515,[431 232 212 394 216],13,1,5586,3.6846965699208445,0.0,0.0
5516,1,1516,[272 478 509 264 208],13,5,5591,3.6855636123928806,0.0,0.0
5517,1,1517,[508 297 283 315 220],334,3,5594,3.6851119894598154,40.0,0.0
5518,1,1518,[221 300 367 208 478],234,2,5596,3.684002633311389,0.0,20.0
5519,1,1519,[216 221 272 259 507],85,2,5598,3.682894736842105,0.0,0.0
5520,1,1520,[259 284 230 213 316],474,3,5601,3.6824457593688362,20.0,0.0
5521,1,1521,[275 215 202 507 208],271,4,5605,3.6826544021024965,0.0,20.0
5522,1,1522,[223 315 216 254 507],934,4,5609,3.6828627708470125,40.0,0.0
5523,1,1523,[272 478 509 264 208],13,5,5614,3.683727034120735,0.0,0.0
5524,1,1524,[202 350 261 216 326],13,1,5615,3.681967213114754,0.0,0.0
5525,1,1525,[293 216 209 481 211],308,4,5619,3.6821756225425952,0.0,20.0
5526,1,1526,[272 478 509 264 208],13,5,5624,3.6830386378519973,0.0,0.0
5527,1,1527,[272 478 509 264 208],13,5,5629,3.6839005235602094,0.0,0.0
5528,1,1528,[272 478 509 264 208],13,5,5634,3.684761281883584,0.0,0.0
5529,1,1529,[241 222 217 583 226],387,2,5636,3.683660130718954,0.0,20.0
5530,1,1530,[272 478 509 264 208],13,5,5641,3.6845199216198563,0.0,0.0
5531,1,1531,[478 301 201 213 299],537,2,5643,3.683420365535248,0.0,0.0
5532,1,1532,[272 478 509 264 208],13,5,5648,3.684279191128506,0.0,0.0
5533,1,1533,[284 222 331 231 350],328,1,5649,3.682529335071708,0.0,20.0
5534,1,1534,[227 218 290 216 378],650,1,5650,3.6807817589576546,0.0,0.0
5535,1,1535,[272 478 509 264 208],13,5,5655,3.681640625,0.0,0.0
5536,1,1536,[272 478 509 264 208],13,5,5660,3.682498373454782,0.0,0.0
5537,1,1537,[272 478 509 264 208],13,5,5665,3.6833550065019507,0.0,0.0
5538,1,1538,[390 324 295 275 297],116,1,5666,3.681611435997401,20.0,20.0
5539,1,1539,[272 478 509 264 208],13,5,5671,3.6824675324675327,0.0,0.0
5540,1,1540,[272 478 509 264 208],13,5,5676,3.683322517845555,0.0,0.0
5541,1,1541,[221 478 284 259 202],537,1,5677,3.681582360570687,0.0,0.0
5542,1,1542,[481 209 264 290 216],13,2,5679,3.68049254698639,0.0,0.0
5543,1,1543,[272 478 509 264 208],13,5,5684,3.6813471502590676,0.0,0.0
5544,1,1544,[243 301 452 280 216],13,1,5685,3.679611650485437,0.0,0.0
5545,1,1545,[315 431 378 303 213],537,4,5689,3.679818887451488,20.0,0.0
5546,1,1546,[272 478 509 264 208],13,5,5694,3.680672268907563,0.0,0.0
5547,1,1547,[272 478 509 264 208],13,5,5699,3.6815245478036176,0.0,0.0
5548,1,1548,[272 478 509 264 208],13,5,5704,3.682375726275016,0.0,0.0
5549,1,1549,[272 478 509 264 208],13,5,5709,3.683225806451613,0.0,0.0
5550,1,1550,[272 478 509 264 208],13,5,5714,3.6840747904577693,0.0,0.0
5551,1,1551,[276 241 217 300 216],13,1,5715,3.6823453608247423,0.0,40.0
5552,1,1552,[272 478 509 264 208],13,5,5720,3.683193818415969,0.0,0.0
5553,1,1553,[272 478 509 264 208],13,5,5725,3.684041184041184,0.0,0.0
5554,1,1554,[272 478 509 264 208],13,5,5730,3.684887459807074,0.0,0.0
5555,1,1555,[272 478 509 264 208],13,5,5735,3.68573264781491,0.0,0.0
5556,1,1556,[272 478 509 264 208],13,5,5740,3.6865767501605653,0.0,0.0
5557,1,1557,[284 202 508 275 211],537,3,5743,3.686136071887035,0.0,40.0
5558,1,1558,[272 478 509 264 208],13,5,5748,3.6869788325849906,0.0,0.0
5559,1,1559,[255 297 508 211 226],533,4,5752,3.687179487179487,20.0,20.0
5560,1,1560,[256 221 344 336 350],894,2,5754,3.68609865470852,0.0,0.0
5561,1,1561,[216 276 298 243 226],533,3,5757,3.6856594110115237,0.0,20.0
5562,1,1562,[209 219 509 201 223],308,4,5761,3.6858605246321177,20.0,0.0
5563,1,1563,[272 478 509 264 208],13,5,5766,3.686700767263427,0.0,0.0
5564,1,1564,[272 478 509 264 208],13,5,5771,3.6875399361022363,0.0,0.0
5565,1,1565,[272 478 509 264 208],13,5,5776,3.6883780332056193,0.0,0.0
5566,1,1566,[222 240 223 226 254],749,2,5778,3.6873005743458838,20.0,20.0
5567,1,1567,[211 275 208 215 378],271,5,5783,3.6881377551020407,0.0,40.0
5568,1,1568,[272 478 509 264 208],13,5,5788,3.6889738687061824,0.0,0.0
5569,1,1569,[272 478 509 264 208],13,5,5793,3.6898089171974524,0.0,0.0
5570,1,1570,[272 478 509 264 208],13,5,5798,3.690642902609803,0.0,0.0
5571,1,1571,[231 208 298 293 211],387,2,5800,3.6895674300254453,0.0,20.0
5572,1,1572,[272 478 509 264 208],13,5,5805,3.690400508582327,0.0,0.0
5573,1,1573,[299 275 293 222 315],145,4,5809,3.690597204574333,20.0,40.0
5574,1,1574,[284 202 227 378 223],833,2,5811,3.6895238095238096,20.0,0.0
5575,1,1575,[293 208 241 216 222],158,3,5814,3.6890862944162435,0.0,20.0
5576,1,1576,[272 478 509 264 208],13,5,5819,3.689917564996829,0.0,0.0
5577,1,1577,[272 478 509 264 208],13,5,5824,3.6907477820025347,0.0,0.0
5578,1,1578,[275 215 452 239 413],13,2,5826,3.689677010766308,0.0,20.0
5579,1,1579,[212 331 276 509 290],894,4,5830,3.689873417721519,0.0,20.0
5580,1,1580,[222 280 217 201 321],13,1,5831,3.6881720430107525,0.0,20.0
5581,1,1581,[284 344 315 223 241],328,4,5835,3.688369152970923,40.0,0.0
5582,1,1582,[272 478 509 264 208],13,5,5840,3.689197725837018,0.0,0.0
5583,1,1583,[264 241 367 232 326],13,1,5841,3.6875,0.0,0.0
5584,1,1584,[272 478 509 264 208],13,5,5846,3.688328075709779,0.0,0.0
5585,1,1585,[219 264 226 231 211],308,1,5847,3.6866330390920554,0.0,20.0
5586,1,1586,[272 478 509 264 208],13,5,5852,3.687460617517328,0.0,0.0
5587,1,1587,[272 478 509 264 208],13,5,5857,3.688287153652393,0.0,0.0
5588,1,1588,[272 211 431 378 209],537,4,5861,3.688483322844556,0.0,20.0
5589,1,1589,[272 478 509 264 208],13,5,5866,3.6893081761006288,0.0,0.0
5590,1,1590,[300 299 243 508 268],537,2,5868,3.6882463859208046,0.0,20.0
5591,1,1591,[300 378 223 509 507],7,5,5873,3.689070351758794,20.0,20.0
5592,1,1592,[508 293 344 429 227],833,3,5876,3.6886377903327054,0.0,0.0
5593,1,1593,[272 478 509 264 208],13,5,5881,3.689460476787955,0.0,0.0
5594,1,1594,[367 212 485 378 219],234,2,5883,3.6884012539184954,0.0,0.0
5595,1,1595,[272 478 509 264 208],13,5,5888,3.68922305764411,0.0,0.0
5596,1,1596,[255 420 276 481 275],308,5,5893,3.6900438321853475,0.0,40.0
5597,1,1597,[507 218 429 216 219],308,2,5895,3.6889862327909886,0.0,0.0
5598,1,1598,[272 478 509 264 208],13,5,5900,3.689806128830519,0.0,0.0
5599,1,1599,[272 478 509 264 208],13,5,5905,3.690625,0.0,0.0
5600,1,1600,[276 299 241 300 217],13,1,5906,3.68894440974391,0.0,40.0
5601,1,1601,[272 478 509 264 208],13,5,5911,3.6897627965043696,0.0,0.0
5602,1,1602,[272 478 509 264 208],13,5,5916,3.6905801621958827,0.0,0.0
5603,1,1603,[272 478 509 264 208],13,5,5921,3.6913965087281797,0.0,0.0
5604,1,1604,[272 478 509 264 208],13,5,5926,3.6922118380062305,0.0,0.0
5605,1,1605,[272 478 509 264 208],13,5,5931,3.6930261519302614,0.0,0.0
5606,1,1606,[272 478 509 264 208],13,5,5936,3.6938394523957685,0.0,0.0
5607,1,1607,[201 336 219 272 217],13,1,5937,3.6921641791044775,0.0,0.0
5608,1,1608,[272 478 509 264 208],13,5,5942,3.6929770043505283,0.0,0.0
5609,1,1609,[509 508 290 241 216],207,3,5945,3.6925465838509317,0.0,0.0
5610,1,1610,[272 478 509 264 208],13,5,5950,3.6933581626319056,0.0,0.0
5611,1,1611,[272 478 509 264 208],13,5,5955,3.694168734491315,0.0,0.0
5612,1,1612,[272 478 509 264 208],13,5,5960,3.694978301301922,0.0,0.0
5613,1,1613,[509 280 268 261 272],13,4,5964,3.6951672862453533,0.0,0.0
5614,1,1614,[272 478 509 264 208],13,5,5969,3.6959752321981423,0.0,0.0
5615,1,1615,[272 478 509 264 208],13,5,5974,3.6967821782178216,0.0,0.0
5616,1,1616,[272 478 509 264 208],13,5,5979,3.697588126159555,0.0,0.0
5617,1,1617,[336 218 209 331 478],13,1,5980,3.6959208899876392,0.0,0.0
5618,1,1618,[272 478 509 264 208],13,5,5985,3.6967263743051264,0.0,0.0
5619,1,1619,[221 206 215 509 259],537,1,5986,3.6950617283950615,0.0,0.0
5620,1,1620,[272 478 509 264 208],13,5,5991,3.6958667489204196,0.0,0.0
5621,1,1621,[272 478 509 264 208],13,5,5996,3.6966707768187423,0.0,0.0
5622,1,1622,[272 478 509 264 208],13,5,6001,3.6974738139248307,0.0,0.0
5623,1,1623,[272 478 509 264 208],13,5,6006,3.6982758620689653,0.0,0.0
5624,1,1624,[272 478 509 264 208],13,5,6011,3.699076923076923,0.0,0.0
5625,1,1625,[272 478 509 264 208],13,5,6016,3.6998769987699878,0.0,0.0
5626,1,1626,[211 259 452 216 321],308,1,6017,3.6982175783650892,0.0,20.0
5627,1,1627,[272 478 509 264 208],13,5,6022,3.699017199017199,0.0,0.0
5628,1,1628,[272 478 509 264 208],13,5,6027,3.699815837937385,0.0,0.0
5629,1,1629,[221 507 222 202 303],537,2,6029,3.6987730061349695,0.0,20.0
5630,1,1630,[272 478 509 264 208],13,5,6034,3.699570815450644,0.0,0.0
5631,1,1631,[272 478 509 264 208],13,5,6039,3.7003676470588234,0.0,0.0
5632,1,1632,[272 478 509 264 208],13,5,6044,3.7011635027556644,0.0,0.0
5633,1,1633,[255 272 297 250 239],334,2,6046,3.700122399020808,20.0,0.0
5634,1,1634,[272 478 509 264 208],13,5,6051,3.7009174311926607,0.0,0.0
5635,1,1635,[367 217 452 303 212],13,2,6053,3.699877750611247,0.0,0.0
5636,1,1636,[272 478 509 264 208],13,5,6058,3.700671960904093,0.0,0.0
5637,1,1637,[283 219 222 236 284],279,1,6059,3.699023199023199,0.0,20.0
5638,1,1638,[272 478 509 264 208],13,5,6064,3.699816961561928,0.0,0.0
5639,1,1639,[272 478 509 264 208],13,5,6069,3.700609756097561,0.0,0.0
5640,1,1640,[241 431 509 268 221],537,3,6072,3.7001828153564897,0.0,0.0
5641,1,1641,[201 293 298 217 222],387,3,6075,3.699756394640682,0.0,20.0
5642,1,1642,[208 201 268 241 365],7,3,6078,3.6993304930006086,0.0,0.0
5643,1,1643,[272 478 509 264 208],13,5,6083,3.7001216545012166,0.0,0.0
5644,1,1644,[211 219 452 226 215],774,1,6084,3.6984802431610944,0.0,20.0
5645,1,1645,[208 429 219 283 243],234,2,6086,3.697448359659781,0.0,0.0
5646,1,1646,[272 478 509 264 208],13,5,6091,3.6982392228293866,0.0,0.0
5647,1,1647,[326 316 299 275 244],894,3,6094,3.6978155339805827,20.0,20.0
5648,1,1648,[272 478 509 264 208],13,5,6099,3.6986052152819893,0.0,0.0
5649,1,1649,[272 478 509 264 208],13,5,6104,3.6993939393939392,0.0,0.0
5650,1,1650,[216 378 226 232 230],326,2,6106,3.698364627498486,0.0,0.0
5651,1,1651,[272 478 509 264 208],13,5,6111,3.6991525423728815,0.0,0.0
5652,1,1652,[272 478 509 264 208],13,5,6116,3.6999395039322445,0.0,0.0
5653,1,1653,[272 478 509 264 208],13,5,6121,3.700725513905683,0.0,0.0
5654,1,1654,[378 275 392 230 481],308,4,6125,3.700906344410876,0.0,20.0
5655,1,1655,[272 478 509 264 208],13,5,6130,3.7016908212560384,0.0,0.0
5656,1,1656,[291 316 283 202 367],234,2,6132,3.7006638503319254,20.0,0.0
5657,1,1657,[272 478 509 264 208],13,5,6137,3.701447527141134,0.0,0.0
5658,1,1658,[255 413 246 300 240],294,2,6139,3.70042194092827,0.0,20.0
5659,1,1659,[272 478 509 264 208],13,5,6144,3.7012048192771085,0.0,0.0
5660,1,1660,[272 478 509 264 208],13,5,6149,3.7019867549668874,0.0,0.0
5661,1,1661,[291 212 367 290 284],524,3,6152,3.7015643802647413,0.0,0.0
5662,1,1662,[276 227 216 209 275],474,4,6156,3.7017438364401682,0.0,40.0
5663,1,1663,[208 268 344 290 275],13,3,6159,3.7013221153846154,0.0,20.0
5664,1,1664,[272 478 509 264 208],13,5,6164,3.702102102102102,0.0,0.0
5665,1,1665,[212 202 290 226 215],650,0,6164,3.699879951980792,0.0,0.0
5666,1,1666,[215 367 222 509 241],194,0,6164,3.697660467906419,0.0,20.0
5667,1,1667,[272 478 509 264 208],13,5,6169,3.698441247002398,0.0,0.0
5668,1,1668,[367 268 344 485 201],13,1,6170,3.696824445775914,0.0,0.0
5669,1,1669,[336 290 280 481 241],13,2,6172,3.695808383233533,0.0,0.0
5670,1,1670,[272 478 509 264 208],13,5,6177,3.6965888689407542,0.0,0.0
5671,1,1671,[272 478 509 264 208],13,5,6182,3.6973684210526314,0.0,0.0
5672,1,1672,[272 478 509 264 208],13,5,6187,3.6981470412432755,0.0,0.0
5673,1,1673,[219 250 230 284 290],279,2,6189,3.697132616487455,0.0,0.0
5674,1,1674,[272 478 509 264 208],13,5,6194,3.697910447761194,0.0,0.0
5675,1,1675,[222 209 431 216 429],13,1,6195,3.6963007159904535,0.0,20.0
5676,1,1676,[272 478 509 264 208],13,5,6200,3.697078115682767,0.0,0.0
5677,1,1677,[272 478 509 264 208],13,5,6205,3.697854588796186,0.0,0.0
5678,1,1678,[272 478 509 264 208],13,5,6210,3.6986301369863015,0.0,0.0
5679,1,1679,[272 478 509 264 208],13,5,6215,3.699404761904762,0.0,0.0
5680,1,1680,[272 478 509 264 208],13,5,6220,3.700178465199286,0.0,0.0
5681,1,1681,[231 321 219 230 452],308,1,6221,3.698573127229489,0.0,0.0
5682,1,1682,[301 216 222 303 315],13,2,6223,3.6975638740344623,20.0,20.0
5683,1,1683,[272 478 509 264 208],13,5,6228,3.6983372921615203,0.0,0.0
5684,1,1684,[272 478 509 264 208],13,5,6233,3.6991097922848666,0.0,0.0
5685,1,1685,[213 246 216 478 284],85,3,6236,3.698695136417556,0.0,0.0
5686,1,1686,[272 478 509 264 208],13,5,6241,3.6994665085951395,0.0,0.0
5687,1,1687,[429 213 276 254 208],308,4,6245,3.699644549763033,0.0,20.0
5688,1,1688,[429 201 217 230 208],774,0,6245,3.6974541148608644,0.0,0.0
5689,1,1689,[316 220 283 250 315],931,3,6248,3.6970414201183432,40.0,0.0
5690,1,1690,[217 216 420 452 275],7,5,6253,3.697811945594323,0.0,20.0
5691,1,1691,[272 478 509 264 208],13,5,6258,3.698581560283688,0.0,0.0
5692,1,1692,[222 201 230 284 259],537,0,6258,3.696396928529238,0.0,20.0
5693,1,1693,[284 315 216 293 283],474,4,6262,3.6965761511216058,20.0,0.0
5694,1,1694,[272 478 509 264 208],13,5,6267,3.697345132743363,0.0,0.0
5695,1,1695,[272 478 509 264 208],13,5,6272,3.69811320754717,0.0,0.0
5696,1,1696,[272 478 509 264 208],13,5,6277,3.6988803771361227,0.0,0.0
5697,1,1697,[272 218 326 275 284],328,4,6281,3.699057714958775,0.0,20.0
5698,1,1698,[315 243 212 452 301],13,2,6283,3.698057680988817,20.0,0.0
5699,1,1699,[272 478 509 264 208],13,5,6288,3.6988235294117646,0.0,0.0
5700,1,1700,[212 216 485 316 208],13,3,6291,3.6984126984126986,20.0,0.0
5701,1,1701,[272 478 509 264 208],13,5,6296,3.6991774383078733,0.0,0.0
5702,1,1702,[272 478 509 264 208],13,5,6301,3.699941280093952,0.0,0.0
5703,1,1703,[226 507 420 231 215],7,4,6305,3.700117370892019,0.0,0.0
5704,1,1704,[254 275 378 223 255],308,3,6308,3.699706744868035,20.0,20.0
5705,1,1705,[226 272 291 213 216],537,2,6310,3.6987104337631886,0.0,0.0
5706,1,1706,[283 222 508 246 208],334,4,6314,3.6988869361452843,0.0,20.0
5707,1,1707,[211 208 240 508 251],385,1,6315,3.6973067915690865,20.0,20.0
5708,1,1708,[272 478 509 264 208],13,5,6320,3.698069046225863,0.0,0.0
5709,1,1709,[272 478 509 264 208],13,5,6325,3.698830409356725,0.0,0.0
5710,1,1710,[272 478 509 264 208],13,5,6330,3.699590882524839,0.0,0.0
5711,1,1711,[272 478 509 264 208],13,5,6335,3.7003504672897196,0.0,0.0
5712,1,1712,[272 478 509 264 208],13,5,6340,3.7011091652072388,0.0,0.0
5713,1,1713,[272 478 509 264 208],13,5,6345,3.7018669778296385,0.0,0.0
5714,1,1714,[272 478 509 264 208],13,5,6350,3.7026239067055395,0.0,0.0
5715,1,1715,[212 301 509 378 290],537,1,6351,3.7010489510489513,0.0,0.0
5716,1,1716,[272 478 509 264 208],13,5,6356,3.7018054746651137,0.0,0.0
5717,1,1717,[283 284 239 206 291],537,1,6357,3.7002328288707798,0.0,0.0
5718,1,1718,[215 219 243 367 420],13,2,6359,3.699243746364165,0.0,0.0
5719,1,1719,[301 217 508 303 316],334,2,6361,3.6982558139534882,20.0,0.0
5720,1,1720,[272 478 509 264 208],13,5,6366,3.6990122022080185,0.0,0.0
5721,1,1721,[272 478 509 264 208],13,5,6371,3.699767711962834,0.0,0.0
5722,1,1722,[272 478 509 264 208],13,5,6376,3.7005223447475335,0.0,0.0
5723,1,1723,[272 478 509 264 208],13,5,6381,3.7012761020881673,0.0,0.0
5724,1,1724,[429 284 509 452 209],406,1,6382,3.6997101449275362,0.0,0.0
5725,1,1725,[336 394 239 212 420],13,3,6385,3.6993047508690613,0.0,0.0
5726,1,1726,[272 478 509 264 208],13,5,6390,3.70005790387956,0.0,0.0
5727,1,1727,[272 478 509 264 208],13,5,6395,3.700810185185185,0.0,0.0
5728,1,1728,[272 478 509 264 208],13,5,6400,3.7015615962984385,0.0,0.0
5729,1,1729,[420 241 215 231 243],200,4,6404,3.701734104046243,0.0,0.0
5730,1,1730,[272 478 509 264 208],13,5,6409,3.7024841132293473,0.0,0.0
5731,1,1731,[267 452 298 344 219],833,3,6412,3.7020785219399537,0.0,0.0
5732,1,1732,[212 215 291 481 246],85,3,6415,3.701673398730525,0.0,0.0
5733,1,1733,[272 478 509 264 208],13,5,6420,3.7024221453287196,0.0,0.0
5734,1,1734,[284 231 268 298 250],85,2,6422,3.701440922190202,0.0,0.0
5735,1,1735,[272 478 509 264 208],13,5,6427,3.702188940092166,0.0,0.0
5736,1,1736,[272 478 509 264 208],13,5,6432,3.70293609671848,0.0,0.0
5737,1,1737,[272 478 509 264 208],13,5,6437,3.703682393555811,0.0,0.0
5738,1,1738,[272 478 509 264 208],13,5,6442,3.7044278320874064,0.0,0.0
5739,1,1739,[231 241 299 206 507],537,1,6443,3.702873563218391,0.0,0.0
5740,1,1740,[272 478 509 264 208],13,5,6448,3.703618609994256,0.0,0.0
5741,1,1741,[508 275 272 231 215],378,4,6452,3.703788748564868,0.0,20.0
5742,1,1742,[209 243 316 232 485],13,1,6453,3.70223752151463,20.0,0.0
5743,1,1743,[394 217 201 481 222],13,0,6453,3.7001146788990824,0.0,20.0
5744,1,1744,[420 276 365 230 452],308,3,6456,3.6997134670487104,0.0,20.0
5745,1,1745,[272 478 509 264 208],13,5,6461,3.700458190148912,0.0,0.0
5746,1,1746,[452 315 268 300 431],13,2,6463,3.6994848311390958,20.0,20.0
5747,1,1747,[316 301 290 230 507],13,2,6465,3.698512585812357,20.0,0.0
5748,1,1748,[226 218 300 293 284],533,2,6467,3.6975414522584336,0.0,20.0
5749,1,1749,[216 232 227 241 508],59,3,6470,3.697142857142857,0.0,0.0
5750,1,1750,[272 478 509 264 208],13,5,6475,3.697886921758995,0.0,0.0
5751,1,1751,[298 275 201 216 239],308,3,6478,3.6974885844748857,0.0,20.0
5752,1,1752,[272 478 509 264 208],13,5,6483,3.6982316029663433,0.0,0.0
5753,1,1753,[264 394 230 367 212],13,2,6485,3.6972633979475487,0.0,0.0
5754,1,1754,[509 275 293 209 420],308,5,6490,3.698005698005698,0.0,20.0
5755,1,1755,[272 478 509 264 208],13,5,6495,3.69874715261959,0.0,0.0
5756,1,1756,[213 291 221 208 315],537,3,6498,3.6983494593056347,20.0,0.0
5757,1,1757,[272 478 509 264 208],13,5,6503,3.6990898748577927,0.0,0.0
5758,1,1758,[230 508 223 246 255],334,3,6506,3.6986924388857307,20.0,0.0
5759,1,1759,[272 478 509 264 208],13,5,6511,3.699431818181818,0.0,0.0
5760,1,1760,[272 478 509 264 208],13,5,6516,3.700170357751278,0.0,0.0
5761,1,1761,[272 478 509 264 208],13,5,6521,3.7009080590238366,0.0,0.0
5762,1,1762,[272 478 509 264 208],13,5,6526,3.7016449234259783,0.0,0.0
5763,1,1763,[272 478 509 264 208],13,5,6531,3.7023809523809526,0.0,0.0
5764,1,1764,[272 478 509 264 208],13,5,6536,3.7031161473087817,0.0,0.0
5765,1,1765,[378 243 276 206 316],234,3,6539,3.702718006795017,20.0,20.0
5766,1,1766,[272 478 509 264 208],13,5,6544,3.703452178834182,0.0,0.0
5767,1,1767,[272 478 509 264 208],13,5,6549,3.704185520361991,0.0,0.0
5768,1,1768,[272 478 509 264 208],13,5,6554,3.7049180327868854,0.0,0.0
5769,1,1769,[272 478 509 264 208],13,5,6559,3.7056497175141243,0.0,0.0
5770,1,1770,[216 290 350 299 212],13,2,6561,3.704686617730096,0.0,0.0
5771,1,1771,[583 429 209 218 420],308,5,6566,3.705417607223476,0.0,0.0
5772,1,1772,[231 217 222 202 250],387,2,6568,3.7044557247602934,0.0,20.0
5773,1,1773,[272 478 509 264 208],13,5,6573,3.705186020293123,0.0,0.0
5774,1,1774,[272 478 509 264 208],13,5,6578,3.7059154929577467,0.0,0.0
5775,1,1775,[272 478 509 264 208],13,5,6583,3.706644144144144,0.0,0.0
5776,1,1776,[220 301 295 509 275],378,2,6585,3.7056837366347777,0.0,20.0
5777,1,1777,[431 222 216 275 509],474,4,6589,3.7058492688413947,0.0,40.0
5778,1,1778,[272 350 223 275 303],13,3,6592,3.7054525014052837,20.0,20.0
5779,1,1779,[211 413 202 215 300],13,3,6595,3.705056179775281,0.0,40.0
5780,1,1780,[272 478 509 264 208],13,5,6600,3.7057832678270635,0.0,0.0
5781,1,1781,[272 478 509 264 208],13,5,6605,3.706509539842873,0.0,0.0
5782,1,1782,[272 478 509 264 208],13,5,6610,3.7072349971957377,0.0,0.0
5783,1,1783,[272 478 509 264 208],13,5,6615,3.7079596412556053,0.0,0.0
5784,1,1784,[272 478 509 264 208],13,5,6620,3.708683473389356,0.0,0.0
5785,1,1785,[272 478 509 264 208],13,5,6625,3.709406494960806,0.0,0.0
5786,1,1786,[276 239 478 219 230],13,3,6628,3.7090095131505314,0.0,20.0
5787,1,1787,[201 208 243 227 232],897,4,6632,3.70917225950783,0.0,0.0
5788,1,1788,[272 478 509 264 208],13,5,6637,3.7098937954164337,0.0,0.0
5789,1,1789,[231 218 452 429 212],650,1,6638,3.7083798882681562,0.0,0.0
5790,1,1790,[272 478 509 264 208],13,5,6643,3.709101060859855,0.0,0.0
5791,1,1791,[272 478 509 264 208],13,5,6648,3.7098214285714284,0.0,0.0
5792,1,1792,[272 478 509 264 208],13,5,6653,3.7105409927495816,0.0,0.0
5793,1,1793,[478 211 485 283 206],234,1,6654,3.709030100334448,0.0,20.0
5794,1,1794,[272 478 509 264 208],13,5,6659,3.70974930362117,0.0,0.0
5795,1,1795,[216 208 217 209 316],13,2,6661,3.708797327394209,20.0,0.0
5796,1,1796,[272 478 509 264 208],13,5,6666,3.709515859766277,0.0,0.0
5797,1,1797,[315 276 507 301 303],537,4,6670,3.7096774193548385,20.0,20.0
5798,1,1798,[297 231 217 303 478],343,4,6674,3.709838799332963,20.0,0.0
5799,1,1799,[272 478 509 264 208],13,5,6679,3.7105555555555556,0.0,0.0
5800,1,1800,[272 478 509 264 208],13,5,6684,3.7112715158245417,0.0,0.0
5801,1,1801,[211 226 300 290 236],537,1,6685,3.70976692563818,0.0,40.0
5802,1,1802,[220 508 216 230 276],82,2,6687,3.708818635607321,0.0,20.0
5803,1,1803,[583 208 431 239 367],92,3,6690,3.7084257206208426,0.0,0.0
5804,1,1804,[232 350 413 261 452],13,0,6690,3.706371191135734,0.0,0.0
5805,1,1805,[272 478 509 264 208],13,5,6695,3.7070874861572536,0.0,0.0
5806,1,1806,[272 478 509 264 208],13,5,6700,3.707802988378528,0.0,0.0
5807,1,1807,[272 478 509 264 208],13,5,6705,3.708517699115044,0.0,0.0
5808,1,1808,[509 275 429 276 301],13,3,6708,3.7081260364842454,0.0,40.0
5809,1,1809,[272 478 509 264 208],13,5,6713,3.7088397790055248,0.0,0.0
5810,1,1810,[272 478 509 264 208],13,5,6718,3.7095527332965212,0.0,0.0
5811,1,1811,[272 478 509 264 208],13,5,6723,3.7102649006622515,0.0,0.0
5812,1,1812,[272 478 509 264 208],13,5,6728,3.7109762824048538,0.0,0.0
5813,1,1813,[272 478 509 264 208],13,5,6733,3.7116868798235942,0.0,0.0
5814,1,1814,[272 478 509 264 208],13,5,6738,3.712396694214876,0.0,0.0
5815,1,1815,[250 211 202 243 219],387,2,6740,3.711453744493392,0.0,20.0
5816,1,1816,[272 478 509 264 208],13,5,6745,3.7121629058888277,0.0,0.0
5817,1,1817,[272 478 509 264 208],13,5,6750,3.712871287128713,0.0,0.0
5818,1,1818,[216 213 272 509 283],479,4,6754,3.7130291368884003,0.0,0.0
5819,1,1819,[284 219 452 300 276],145,2,6756,3.7120879120879122,0.0,40.0
5820,1,1820,[272 478 509 264 208],13,5,6761,3.71279516749039,0.0,0.0
5821,1,1821,[272 478 509 264 208],13,5,6766,3.7135016465422614,0.0,0.0
5822,1,1822,[272 246 275 481 213],334,5,6771,3.714207350521119,0.0,20.0
5823,1,1823,[231 275 259 321 390],279,1,6772,3.712719298245614,0.0,20.0
5824,1,1824,[211 384 222 413 201],13,1,6773,3.711232876712329,0.0,40.0
5825,1,1825,[272 478 509 264 208],13,5,6778,3.711938663745893,0.0,0.0
5826,1,1826,[272 478 509 264 208],13,5,6783,3.7126436781609193,0.0,0.0
5827,1,1827,[291 211 209 230 244],474,4,6787,3.712800875273523,0.0,20.0
5828,1,1828,[272 478 509 264 208],13,5,6792,3.7135046473482776,0.0,0.0
5829,1,1829,[272 478 509 264 208],13,5,6797,3.714207650273224,0.0,0.0
5830,1,1830,[272 478 509 264 208],13,5,6802,3.7149098853085745,0.0,0.0
5831,1,1831,[272 478 509 264 208],13,5,6807,3.7156113537117905,0.0,0.0
5832,1,1832,[272 478 509 264 208],13,5,6812,3.7163120567375887,0.0,0.0
5833,1,1833,[272 478 509 264 208],13,5,6817,3.7170119956379497,0.0,0.0
5834,1,1834,[272 478 509 264 208],13,5,6822,3.7177111716621254,0.0,0.0
5835,1,1835,[272 478 509 264 208],13,5,6827,3.718409586056645,0.0,0.0
5836,1,1836,[272 478 509 264 208],13,5,6832,3.719107240065324,0.0,0.0
5837,1,1837,[241 295 239 201 208],308,3,6835,3.7187159956474427,0.0,0.0
5838,1,1838,[208 429 384 239 315],271,3,6838,3.718325176726482,20.0,0.0
5839,1,1839,[272 478 509 264 208],13,5,6843,3.7190217391304348,0.0,0.0
5840,1,1840,[272 478 509 264 208],13,5,6848,3.719717544812602,0.0,0.0
5841,1,1841,[272 478 509 264 208],13,5,6853,3.720412595005429,0.0,0.0
5842,1,1842,[507 431 212 268 478],13,3,6856,3.7200217037438956,0.0,0.0
5843,1,1843,[230 378 218 326 300],311,4,6860,3.720173535791757,0.0,20.0
5844,1,1844,[272 478 509 264 208],13,5,6865,3.720867208672087,0.0,0.0
5845,1,1845,[272 478 509 264 208],13,5,6870,3.7215601300108343,0.0,0.0
5846,1,1846,[268 275 255 236 324],486,2,6872,3.7206280454791556,0.0,20.0
5847,1,1847,[272 478 509 264 208],13,5,6877,3.721320346320346,0.0,0.0
5848,1,1848,[272 478 509 264 208],13,5,6882,3.722011898323418,0.0,0.0
5849,1,1849,[331 485 413 336 215],13,1,6883,3.7205405405405405,0.0,0.0
5850,1,1850,[272 478 509 264 208],13,5,6888,3.7212317666126418,0.0,0.0
5851,1,1851,[326 485 259 221 276],474,3,6891,3.720842332613391,0.0,20.0
5852,1,1852,[272 478 509 264 208],13,5,6896,3.7215326497571506,0.0,0.0
5853,1,1853,[431 350 227 218 485],13,1,6897,3.720064724919094,0.0,0.0
5854,1,1854,[272 478 509 264 208],13,5,6902,3.720754716981132,0.0,0.0
5855,1,1855,[290 275 231 239 316],13,3,6905,3.7203663793103448,20.0,20.0
5856,1,1856,[272 478 509 264 208],13,5,6910,3.721055465805062,0.0,0.0
5857,1,1857,[272 478 509 264 208],13,5,6915,3.7217438105489773,0.0,0.0
5858,1,1858,[303 206 301 230 276],537,2,6917,3.720817643894567,0.0,20.0
5859,1,1859,[231 293 275 290 297],334,2,6919,3.7198924731182794,20.0,20.0
5860,1,1860,[478 420 212 213 509],85,4,6923,3.7200429876410532,0.0,0.0
5861,1,1861,[255 365 213 583 241],308,4,6927,3.7201933404940926,0.0,0.0
5862,1,1862,[272 478 509 264 208],13,5,6932,3.7208803005904456,0.0,0.0
5863,1,1863,[272 478 509 264 208],13,5,6937,3.72156652360515,0.0,0.0
5864,1,1864,[202 275 315 280 326],13,3,6940,3.721179624664879,20.0,20.0
5865,1,1865,[272 478 509 264 208],13,5,6945,3.7218649517684885,0.0,0.0
5866,1,1866,[272 478 509 264 208],13,5,6950,3.7225495447241563,0.0,0.0
5867,1,1867,[272 478 509 264 208],13,5,6955,3.723233404710921,0.0,0.0
5868,1,1868,[239 300 303 264 223],13,4,6959,3.723381487426431,20.0,20.0
5869,1,1869,[240 223 295 226 230],749,2,6961,3.7224598930481285,20.0,0.0
5870,1,1870,[272 478 509 264 208],13,5,6966,3.7231427044361305,0.0,0.0
5871,1,1871,[272 478 509 264 208],13,5,6971,3.723824786324786,0.0,0.0
5872,1,1872,[272 478 509 264 208],13,5,6976,3.7245061398825414,0.0,0.0
5873,1,1873,[272 478 509 264 208],13,5,6981,3.725186766275347,0.0,0.0
5874,1,1874,[215 254 208 206 250],804,4,6985,3.7253333333333334,0.0,0.0
5875,1,1875,[272 478 509 264 208],13,5,6990,3.7260127931769724,0.0,0.0
5876,1,1876,[272 478 509 264 208],13,5,6995,3.7266915290356954,0.0,0.0
5877,1,1877,[272 478 509 264 208],13,5,7000,3.7273695420660276,0.0,0.0
5878,1,1878,[378 275 217 227 413],843,1,7001,3.7259180415114423,0.0,20.0
5879,1,1879,[303 315 324 297 298],116,0,7001,3.723936170212766,40.0,0.0
5880,1,1880,[272 478 509 264 208],13,5,7006,3.72461456671983,0.0,0.0
5881,1,1881,[272 478 509 264 208],13,5,7011,3.7252922422954304,0.0,0.0
5882,1,1882,[272 478 509 264 208],13,5,7016,3.725969198088157,0.0,0.0
5883,1,1883,[508 507 509 216 219],13,1,7017,3.7245222929936306,0.0,0.0
5884,1,1884,[209 284 392 315 431],537,3,7020,3.7241379310344827,20.0,0.0
5885,1,1885,[431 226 246 298 394],145,2,7022,3.7232237539766704,0.0,0.0
5886,1,1886,[272 478 509 264 208],13,5,7027,3.7239003709591945,0.0,0.0
5887,1,1887,[481 227 216 259 232],7,2,7029,3.7229872881355934,0.0,0.0
5888,1,1888,[272 478 509 264 208],13,5,7034,3.72366331392271,0.0,0.0
5889,1,1889,[254 239 208 259 365],308,1,7035,3.7222222222222223,0.0,0.0
5890,1,1890,[218 431 299 212 300],13,1,7036,3.7207826546800633,0.0,20.0
5891,1,1891,[209 241 284 221 507],537,2,7038,3.719873150105708,0.0,0.0
5892,1,1892,[507 290 201 211 219],59,4,7042,3.7200211304807183,0.0,20.0
5893,1,1893,[272 478 509 264 208],13,5,7047,3.7206969376979937,0.0,0.0
5894,1,1894,[284 211 508 218 201],447,3,7050,3.7203166226912927,0.0,20.0
5895,1,1895,[272 478 509 264 208],13,5,7055,3.720991561181435,0.0,0.0
5896,1,1896,[231 264 212 239 303],13,4,7059,3.7211386399578283,0.0,0.0
5897,1,1897,[272 478 509 264 208],13,5,7064,3.721812434141201,0.0,0.0
5898,1,1898,[241 509 268 219 201],13,2,7066,3.720905739863086,0.0,0.0
5899,1,1899,[326 209 485 378 365],749,4,7070,3.721052631578947,0.0,0.0
5900,1,1900,[241 275 212 324 232],7,2,7072,3.7201472908995266,0.0,20.0
5901,1,1901,[272 478 509 264 208],13,5,7077,3.720820189274448,0.0,0.0
5902,1,1902,[272 478 509 264 208],13,5,7082,3.721492380451918,0.0,0.0
5903,1,1903,[232 208 227 250 367],158,3,7085,3.721113445378151,0.0,0.0
5904,1,1904,[272 478 509 264 208],13,5,7090,3.7217847769028873,0.0,0.0
5905,1,1905,[284 244 508 280 295],894,1,7091,3.7203567681007343,0.0,0.0
5906,1,1906,[272 478 509 264 208],13,5,7096,3.7210277923439956,0.0,0.0
5907,1,1907,[272 478 509 264 208],13,5,7101,3.7216981132075473,0.0,0.0
5908,1,1908,[272 478 509 264 208],13,5,7106,3.7223677317967523,0.0,0.0
5909,1,1909,[272 478 509 264 208],13,5,7111,3.72303664921466,0.0,0.0
5910,1,1910,[272 478 509 264 208],13,5,7116,3.7237048665620094,0.0,0.0
5911,1,1911,[321 508 201 507 316],13,1,7117,3.7222803347280333,20.0,0.0
5912,1,1912,[272 478 509 264 208],13,5,7122,3.722948248823837,0.0,0.0
5913,1,1913,[272 478 509 264 208],13,5,7127,3.7236154649947752,0.0,0.0
5914,1,1914,[212 507 239 227 201],13,3,7130,3.7232375979112273,0.0,0.0
5915,1,1915,[276 331 413 326 344],13,1,7131,3.721816283924843,0.0,20.0
5916,1,1916,[272 478 509 264 208],13,5,7136,3.7224830464267082,0.0,0.0
5917,1,1917,[272 478 509 264 208],13,5,7141,3.7231491136600625,0.0,0.0
5918,1,1918,[272 478 509 264 208],13,5,7146,3.723814486711829,0.0,0.0
5919,1,1919,[420 507 295 481 218],308,3,7149,3.7234375,0.0,0.0
5920,1,1920,[219 276 243 209 272],13,2,7151,3.722540343571057,0.0,20.0
5921,1,1921,[272 478 509 264 208],13,5,7156,3.7232049947970864,0.0,0.0
5922,1,1922,[239 206 300 268 230],537,1,7157,3.721788871554862,0.0,20.0
5923,1,1923,[509 223 431 316 429],13,4,7161,3.721933471933472,40.0,0.0
5924,1,1924,[272 478 509 264 208],13,5,7166,3.7225974025974025,0.0,0.0
5925,1,1925,[223 216 219 215 344],13,2,7168,3.7217030114226377,20.0,0.0
5926,1,1926,[272 478 509 264 208],13,5,7173,3.7223663725998963,0.0,0.0
5927,1,1927,[485 509 284 201 293],308,4,7177,3.7225103734439835,0.0,0.0
5928,1,1928,[272 478 509 264 208],13,5,7182,3.723172628304821,0.0,0.0
5929,1,1929,[431 211 485 239 413],843,0,7182,3.7212435233160623,0.0,20.0
5930,1,1930,[272 478 509 264 208],13,5,7187,3.721905748316934,0.0,0.0
5931,1,1931,[241 300 283 226 209],479,2,7189,3.721014492753623,0.0,20.0
5932,1,1932,[217 219 268 231 223],7,2,7191,3.720124159337817,20.0,0.0
5933,1,1933,[217 220 508 272 230],378,2,7193,3.71923474663909,0.0,0.0
5934,1,1934,[272 478 509 264 208],13,5,7198,3.719896640826873,0.0,0.0
5935,1,1935,[272 478 509 264 208],13,5,7203,3.7205578512396693,0.0,0.0
5936,1,1936,[485 431 211 344 394],13,1,7204,3.719153329891585,0.0,20.0
5937,1,1937,[272 478 509 264 208],13,5,7209,3.719814241486068,0.0,0.0
5938,1,1938,[212 223 231 276 429],13,4,7213,3.7199587416193913,20.0,20.0
5939,1,1939,[283 239 301 217 293],334,1,7214,3.718556701030928,0.0,0.0
5940,1,1940,[272 478 509 264 208],13,5,7219,3.7192168985059246,0.0,0.0
5941,1,1941,[272 478 509 264 208],13,5,7224,3.7198764160659112,0.0,0.0
5942,1,1942,[315 431 290 201 216],13,2,7226,3.718991250643335,20.0,0.0
5943,1,1943,[272 478 509 264 208],13,5,7231,3.719650205761317,0.0,0.0
5944,1,1944,[272 478 509 264 208],13,5,7236,3.7203084832904882,0.0,0.0
5945,1,1945,[226 420 240 227 250],749,3,7239,3.719938335046249,0.0,0.0
5946,1,1946,[272 478 509 264 208],13,5,7244,3.7205957883923984,0.0,0.0
5947,1,1947,[272 478 509 264 208],13,5,7249,3.721252566735113,0.0,0.0
5948,1,1948,[272 478 509 264 208],13,5,7254,3.7219086711133915,0.0,0.0
5949,1,1949,[344 431 429 212 208],13,3,7257,3.7215384615384615,0.0,0.0
5950,1,1950,[272 478 509 264 208],13,5,7262,3.7221937467965147,0.0,0.0
5951,1,1951,[272 478 509 264 208],13,5,7267,3.7228483606557377,0.0,0.0
5952,1,1952,[452 246 216 215 201],92,2,7269,3.7219662058371736,0.0,0.0
5953,1,1953,[275 241 231 212 222],13,1,7270,3.72057318321392,0.0,40.0
5954,1,1954,[272 478 509 264 208],13,5,7275,3.721227621483376,0.0,0.0
5955,1,1955,[301 291 259 202 392],537,0,7275,3.7193251533742333,0.0,0.0
5956,1,1956,[272 478 509 264 208],13,5,7280,3.7199795605518653,0.0,0.0
5957,1,1957,[272 478 509 264 208],13,5,7285,3.7206332992849847,0.0,0.0
5958,1,1958,[272 478 509 264 208],13,5,7290,3.7212863705972437,0.0,0.0
5959,1,1959,[208 378 259 485 241],537,1,7291,3.7198979591836734,0.0,0.0
5960,1,1960,[431 275 261 202 212],13,2,7293,3.719020907700153,0.0,20.0
5961,1,1961,[264 223 259 232 227],7,2,7295,3.718144750254842,20.0,0.0
5962,1,1962,[272 478 509 264 208],13,5,7300,3.7187977585328578,0.0,0.0
5963,1,1963,[272 478 509 264 208],13,5,7305,3.7194501018329937,0.0,0.0
5964,1,1964,[272 478 509 264 208],13,5,7310,3.7201017811704835,0.0,0.0
5965,1,1965,[509 384 216 481 241],271,2,7312,3.7192268565615465,0.0,0.0
5966,1,1966,[316 215 222 275 230],328,2,7314,3.7183528215556687,20.0,40.0
5967,1,1967,[272 478 509 264 208],13,5,7319,3.7190040650406506,0.0,0.0
5968,1,1968,[272 478 509 264 208],13,5,7324,3.719654647028949,0.0,0.0
5969,1,1969,[227 298 378 211 291],474,4,7328,3.7197969543147207,0.0,20.0
5970,1,1970,[272 478 509 264 208],13,5,7333,3.7204464738711316,0.0,0.0
5971,1,1971,[272 478 509 264 208],13,5,7338,3.7210953346855984,0.0,0.0
5972,1,1972,[272 478 509 264 208],13,5,7343,3.7217435377597567,0.0,0.0
5973,1,1973,[276 236 240 413 230],145,2,7345,3.720871327254306,0.0,20.0
5974,1,1974,[283 367 507 259 485],454,3,7348,3.720506329113924,0.0,0.0
5975,1,1975,[272 478 509 264 208],13,5,7353,3.7211538461538463,0.0,0.0
5976,1,1976,[272 478 509 264 208],13,5,7358,3.721800708143652,0.0,0.0
5977,1,1977,[272 478 509 264 208],13,5,7363,3.722446916076845,0.0,0.0
5978,1,1978,[272 478 509 264 208],13,5,7368,3.7230924709449216,0.0,0.0
5979,1,1979,[284 227 275 413 283],279,2,7370,3.7222222222222223,0.0,20.0
5980,1,1980,[272 478 509 264 208],13,5,7375,3.722867238768299,0.0,0.0
5981,1,1981,[295 222 219 290 413],648,3,7378,3.722502522704339,0.0,20.0
5982,1,1982,[272 478 509 264 208],13,5,7383,3.723146747352496,0.0,0.0
5983,1,1983,[272 478 509 264 208],13,5,7388,3.723790322580645,0.0,0.0
5984,1,1984,[213 216 275 284 508],85,1,7389,3.722418136020151,0.0,20.0
5985,1,1985,[272 478 509 264 208],13,5,7394,3.7230614300100706,0.0,0.0
5986,1,1986,[272 478 509 264 208],13,5,7399,3.7237040764972322,0.0,0.0
5987,1,1987,[218 230 246 485 236],334,3,7402,3.7233400402414487,0.0,0.0
5988,1,1988,[241 213 283 226 201],479,3,7405,3.7229763700351937,0.0,0.0
5989,1,1989,[239 378 231 216 293],749,5,7410,3.7236180904522613,0.0,0.0
5990,1,1990,[272 478 509 264 208],13,5,7415,3.7242591662481166,0.0,0.0
5991,1,1991,[202 367 217 232 223],387,1,7416,3.7228915662650603,20.0,0.0
5992,1,1992,[202 212 239 215 507],194,1,7417,3.721525338685399,0.0,0.0
5993,1,1993,[226 384 223 215 316],13,4,7421,3.721664994984955,40.0,0.0
5994,1,1994,[272 478 509 264 208],13,5,7426,3.722305764411028,0.0,0.0
5995,1,1995,[241 300 230 215 284],537,0,7426,3.720440881763527,0.0,20.0
5996,1,1996,[259 221 227 218 301],524,2,7428,3.7195793690535806,0.0,0.0
5997,1,1997,[272 478 509 264 208],13,5,7433,3.72022022022022,0.0,0.0
5998,1,1998,[276 295 227 291 431],92,3,7436,3.7198599299649824,0.0,20.0
5999,1,1999,[272 478 509 264 208],13,5,7441,3.7205,0.0,0.0
6000,1,2000,[272 478 509 264 208],13,5,7446,3.7211394302848575,0.0,0.0
6001,1,2001,[232 226 243 212 215],13,3,7449,3.720779220779221,0.0,0.0
6002,1,2002,[272 478 509 264 208],13,5,7454,3.7214178731902146,0.0,0.0
6003,1,2003,[272 478 509 264 208],13,5,7459,3.722055888223553,0.0,0.0
6004,1,2004,[272 478 509 264 208],13,5,7464,3.7226932668329176,0.0,0.0
6005,1,2005,[243 261 485 231 481],13,0,7464,3.7208374875373877,0.0,0.0
6006,1,2006,[272 478 509 264 208],13,5,7469,3.7214748380667664,0.0,0.0
6007,1,2007,[272 478 509 264 208],13,5,7474,3.7221115537848606,0.0,0.0
6008,1,2008,[208 485 261 290 219],13,2,7476,3.721254355400697,0.0,0.0
6009,1,2009,[272 478 509 264 208],13,5,7481,3.7218905472636816,0.0,0.0
6010,1,2010,[272 478 509 264 208],13,5,7486,3.722526106414719,0.0,0.0
6011,1,2011,[209 280 211 212 478],234,1,7487,3.7211729622266403,0.0,20.0
6012,1,2012,[272 478 509 264 208],13,5,7492,3.7218082463984103,0.0,0.0
6013,1,2013,[272 478 509 264 208],13,5,7497,3.7224428997020853,0.0,0.0
6014,1,2014,[219 300 268 275 316],13,2,7499,3.721588089330025,20.0,40.0
6015,1,2015,[216 239 331 226 241],13,2,7501,3.720734126984127,0.0,0.0
6016,1,2016,[272 268 420 275 222],85,3,7504,3.7203767972235995,0.0,40.0
6017,1,2017,[211 261 290 299 276],13,3,7507,3.72001982160555,0.0,40.0
6018,1,2018,[272 478 509 264 208],13,5,7512,3.7206537890044578,0.0,0.0
6019,1,2019,[272 478 509 264 208],13,5,7517,3.7212871287128713,0.0,0.0
6020,1,2020,[226 202 259 222 243],804,4,7521,3.7214250371103414,0.0,20.0
6021,1,2021,[272 478 509 264 208],13,5,7526,3.722057368941642,0.0,0.0
6022,1,2022,[272 478 509 264 208],13,5,7531,3.722689075630252,0.0,0.0
6023,1,2023,[297 509 283 280 344],894,3,7534,3.722332015810277,20.0,0.0
6024,1,2024,[272 478 509 264 208],13,5,7539,3.722962962962963,0.0,0.0
6025,1,2025,[272 478 509 264 208],13,5,7544,3.723593287265548,0.0,0.0
6026,1,2026,[272 478 509 264 208],13,5,7549,3.7242229896398618,0.0,0.0
6027,1,2027,[227 290 231 246 221],334,2,7551,3.723372781065089,0.0,0.0
6028,1,2028,[272 478 509 264 208],13,5,7556,3.72400197141449,0.0,0.0
6029,1,2029,[206 300 236 367 213],234,2,7558,3.723152709359606,0.0,20.0
6030,1,2030,[300 223 264 226 208],13,4,7562,3.7232890201871,20.0,20.0
6031,1,2031,[232 208 211 215 227],387,2,7564,3.72244094488189,0.0,20.0
6032,1,2032,[429 291 211 226 230],653,1,7565,3.721101819970487,0.0,20.0
6033,1,2033,[431 222 291 300 299],537,1,7566,3.71976401179941,0.0,40.0
6034,1,2034,[509 507 583 223 481],308,4,7570,3.7199017199017197,20.0,0.0
6035,1,2035,[272 478 509 264 208],13,5,7575,3.720530451866405,0.0,0.0
6036,1,2036,[223 378 485 226 509],7,5,7580,3.7211585665193914,20.0,0.0
6037,1,2037,[272 478 509 264 208],13,5,7585,3.7217860647693817,0.0,0.0
6038,1,2038,[259 221 241 243 507],234,1,7586,3.720451201569397,0.0,0.0
6039,1,2039,[272 478 509 264 208],13,5,7591,3.721078431372549,0.0,0.0
6040,1,2040,[272 478 509 264 208],13,5,7596,3.721705046545811,0.0,0.0
6041,1,2041,[326 223 219 344 481],13,1,7597,3.7203721841332027,20.0,0.0
6042,1,2042,[275 219 485 452 431],13,0,7597,3.718551150269212,0.0,20.0
6043,1,2043,[272 478 509 264 208],13,5,7602,3.719178082191781,0.0,0.0
6044,1,2044,[272 478 509 264 208],13,5,7607,3.719804400977995,0.0,0.0
6045,1,2045,[429 221 244 485 392],271,2,7609,3.7189638318670575,0.0,0.0
6046,1,2046,[272 478 509 264 208],13,5,7614,3.719589643380557,0.0,0.0
6047,1,2047,[272 478 509 264 208],13,5,7619,3.72021484375,0.0,0.0
6048,1,2048,[326 290 276 485 508],13,2,7621,3.7193753050268423,0.0,20.0
6049,1,2049,[272 478 509 264 208],13,5,7626,3.72,0.0,0.0
6050,1,2050,[272 478 509 264 208],13,5,7631,3.720624085811799,0.0,0.0
6051,1,2051,[272 478 509 264 208],13,5,7636,3.7212475633528266,0.0,0.0
6052,1,2052,[272 478 509 264 208],13,5,7641,3.721870433511934,0.0,0.0
6053,1,2053,[243 268 280 241 301],234,0,7641,3.720058422590068,0.0,0.0
6054,1,2054,[212 378 230 291 283],474,3,7644,3.71970802919708,0.0,0.0
6055,1,2055,[272 478 509 264 208],13,5,7649,3.720330739299611,0.0,0.0
6056,1,2056,[246 221 216 236 297],334,4,7653,3.720466699076325,20.0,0.0
6057,1,2057,[272 478 509 264 208],13,5,7658,3.7210884353741496,0.0,0.0
6058,1,2058,[211 392 255 284 507],308,4,7662,3.721223895094706,0.0,20.0
6059,1,2059,[272 478 509 264 208],13,5,7667,3.721844660194175,0.0,0.0
6060,1,2060,[272 478 509 264 208],13,5,7672,3.7224648229015043,0.0,0.0
6061,1,2061,[227 431 219 212 230],7,1,7673,3.721144519883608,0.0,0.0
6062,1,2062,[272 478 509 264 208],13,5,7678,3.7217644207464855,0.0,0.0
6063,1,2063,[231 300 431 217 216],13,0,7678,3.7199612403100777,0.0,20.0
6064,1,2064,[272 478 509 264 208],13,5,7683,3.720581113801453,0.0,0.0
6065,1,2065,[272 478 509 264 208],13,5,7688,3.7212003872216846,0.0,0.0
6066,1,2066,[298 213 250 218 241],339,3,7691,3.7208514755684567,0.0,0.0
6067,1,2067,[272 478 509 264 208],13,5,7696,3.7214700193423598,0.0,0.0
6068,1,2068,[272 478 509 264 208],13,5,7701,3.72208796520058,0.0,0.0
6069,1,2069,[230 231 241 202 216],378,2,7703,3.721256038647343,0.0,0.0
6070,1,2070,[295 226 211 239 201],308,2,7705,3.7204249154997586,0.0,20.0
6071,1,2071,[272 478 509 264 208],13,5,7710,3.721042471042471,0.0,0.0
6072,1,2072,[272 478 509 264 208],13,5,7715,3.7216594307766524,0.0,0.0
6073,1,2073,[303 264 481 485 384],13,2,7717,3.7208293153326903,0.0,0.0
6074,1,2074,[241 223 217 212 219],7,3,7720,3.720481927710843,20.0,0.0
6075,1,2075,[478 321 300 485 284],537,1,7721,3.719171483622351,0.0,20.0
6076,1,2076,[254 283 275 219 239],279,1,7722,3.7178623013962446,0.0,20.0
6077,1,2077,[275 478 321 507 291],537,3,7725,3.717516843118383,0.0,20.0
6078,1,2078,[272 478 509 264 208],13,5,7730,3.718133718133718,0.0,0.0
6079,1,2079,[272 478 509 264 208],13,5,7735,3.71875,0.0,0.0
6080,1,2080,[272 478 509 264 208],13,5,7740,3.719365689572321,0.0,0.0
6081,1,2081,[272 478 509 264 208],13,5,7745,3.7199807877041304,0.0,0.0
6082,1,2082,[211 290 350 344 216],13,2,7747,3.7191550648103697,0.0,20.0
6083,1,2083,[272 478 509 264 208],13,5,7752,3.719769673704415,0.0,0.0
6084,1,2084,[272 478 509 264 208],13,5,7757,3.7203836930455636,0.0,0.0
6085,1,2085,[211 276 384 290 272],13,4,7761,3.720517737296261,0.0,40.0
6086,1,2086,[218 219 293 250 508],387,3,7764,3.7201724964063247,0.0,0.0
6087,1,2087,[208 413 209 431 508],13,1,7765,3.7188697318007664,0.0,0.0
6088,1,2088,[231 213 298 246 284],85,3,7768,3.7185256103398756,0.0,0.0
6089,1,2089,[216 221 478 208 508],85,2,7770,3.7177033492822966,0.0,0.0
6090,1,2090,[429 301 272 216 321],537,1,7771,3.7164036346245815,0.0,0.0
6091,1,2091,[201 508 239 222 240],92,3,7774,3.716061185468451,0.0,20.0
6092,1,2092,[272 478 509 264 208],13,5,7779,3.716674629718108,0.0,0.0
6093,1,2093,[272 478 509 264 208],13,5,7784,3.717287488061127,0.0,0.0
6094,1,2094,[272 478 509 264 208],13,5,7789,3.7178997613365157,0.0,0.0
6095,1,2095,[272 478 509 264 208],13,5,7794,3.7185114503816794,0.0,0.0
6096,1,2096,[284 246 209 431 508],92,4,7798,3.7186456843109204,0.0,0.0
6097,1,2097,[272 478 509 264 208],13,5,7803,3.719256434699714,0.0,0.0
6098,1,2098,[272 478 509 264 208],13,5,7808,3.7198666031443546,0.0,0.0
6099,1,2099,[301 508 392 215 276],378,3,7811,3.7195238095238095,0.0,20.0
6100,1,2100,[272 478 509 264 208],13,5,7816,3.7201332698714897,0.0,0.0
6101,1,2101,[264 509 241 485 272],479,2,7818,3.719314938154139,0.0,0.0
6102,1,2102,[209 297 250 303 324],334,3,7821,3.7189728958630526,20.0,0.0
6103,1,2103,[272 478 509 264 208],13,5,7826,3.71958174904943,0.0,0.0
6104,1,2104,[276 243 223 283 226],234,0,7826,3.7178147268408552,20.0,20.0
6105,1,2105,[299 290 507 316 350],13,2,7828,3.7169990503323835,20.0,0.0
6106,1,2106,[272 478 509 264 208],13,5,7833,3.7176079734219267,0.0,0.0
6107,1,2107,[276 268 478 303 290],13,5,7838,3.718216318785579,0.0,20.0
6108,1,2108,[272 478 509 264 208],13,5,7843,3.7188240872451397,0.0,0.0
6109,1,2109,[272 478 509 264 208],13,5,7848,3.7194312796208533,0.0,0.0
6110,1,2110,[272 478 509 264 208],13,5,7853,3.720037896731407,0.0,0.0
6111,1,2111,[272 478 509 264 208],13,5,7858,3.7206439393939394,0.0,0.0
6112,1,2112,[316 485 321 202 215],13,3,7861,3.7203028868906767,20.0,0.0
6113,1,2113,[272 478 509 264 208],13,5,7866,3.7209082308420056,0.0,0.0
6114,1,2114,[211 367 215 243 284],804,3,7869,3.720567375886525,0.0,20.0
6115,1,2115,[276 223 321 243 222],13,2,7871,3.7197542533081287,20.0,40.0
6116,1,2116,[272 478 509 264 208],13,5,7876,3.7203589985829004,0.0,0.0
6117,1,2117,[272 478 509 264 208],13,5,7881,3.7209631728045327,0.0,0.0
6118,1,2118,[420 378 217 431 290],295,5,7886,3.7215667767815006,0.0,0.0
6119,1,2119,[272 478 509 264 208],13,5,7891,3.7221698113207546,0.0,0.0
6120,1,2120,[272 478 509 264 208],13,5,7896,3.722772277227723,0.0,0.0
6121,1,2121,[290 283 276 315 297],334,4,7900,3.7229029217719134,40.0,20.0
6122,1,2122,[284 221 485 300 478],537,1,7901,3.721620348563354,0.0,20.0
6123,1,2123,[231 300 211 241 213],311,3,7904,3.721280602636535,0.0,40.0
6124,1,2124,[215 232 216 290 367],13,2,7906,3.720470588235294,0.0,0.0
6125,1,2125,[272 478 509 264 208],13,5,7911,3.7210724365004704,0.0,0.0
6126,1,2126,[272 478 509 264 208],13,5,7916,3.7216737188528444,0.0,0.0
6127,1,2127,[272 478 509 264 208],13,5,7921,3.7222744360902253,0.0,0.0
6128,1,2128,[316 284 298 213 221],144,2,7923,3.7214654767496476,20.0,0.0
6129,1,2129,[272 478 509 264 208],13,5,7928,3.7220657276995306,0.0,0.0
6130,1,2130,[478 300 239 303 276],537,3,7931,3.721726888784608,0.0,40.0
6131,1,2131,[272 478 509 264 208],13,5,7936,3.7223264540337713,0.0,0.0
6132,1,2132,[507 211 230 206 452],650,4,7940,3.722456633849039,0.0,20.0
6133,1,2133,[272 478 509 264 208],13,5,7945,3.723055295220244,0.0,0.0
6134,1,2134,[211 276 209 509 232],13,3,7948,3.7227166276346604,0.0,40.0
6135,1,2135,[272 478 509 264 208],13,5,7953,3.723314606741573,0.0,0.0
6136,1,2136,[227 254 413 250 213],804,4,7957,3.7234440804866638,0.0,0.0
6137,1,2137,[429 250 246 508 226],387,2,7959,3.7226379794200186,0.0,0.0
6138,1,2138,[365 230 219 243 208],804,3,7962,3.7223001402524543,0.0,0.0
6139,1,2139,[272 478 509 264 208],13,5,7967,3.722897196261682,0.0,0.0
6140,1,2140,[299 216 243 201 241],13,0,7967,3.7211583372255954,0.0,0.0
6141,1,2141,[272 478 509 264 208],13,5,7972,3.7217553688141924,0.0,0.0
6142,1,2142,[272 478 509 264 208],13,5,7977,3.7223518432104528,0.0,0.0
6143,1,2143,[268 241 239 280 290],13,4,7981,3.722481343283582,0.0,0.0
6144,1,2144,[478 259 236 231 509],537,2,7983,3.7216783216783216,0.0,0.0
6145,1,2145,[272 478 509 264 208],13,5,7988,3.722273998136067,0.0,0.0
6146,1,2146,[272 478 509 264 208],13,5,7993,3.7228691197019095,0.0,0.0
6147,1,2147,[272 478 509 264 208],13,5,7998,3.723463687150838,0.0,0.0
6148,1,2148,[256 298 213 275 509],894,3,8001,3.7231270358306188,0.0,20.0
6149,1,2149,[241 227 275 264 365],7,4,8005,3.7232558139534886,0.0,20.0
6150,1,2150,[215 239 209 508 231],537,2,8007,3.7224546722454672,0.0,0.0
6151,1,2151,[272 478 509 264 208],13,5,8012,3.7230483271375463,0.0,0.0
6152,1,2152,[272 478 509 264 208],13,5,8017,3.7236414305620067,0.0,0.0
6153,1,2153,[222 315 230 239 303],334,4,8021,3.723769730733519,20.0,20.0
6154,1,2154,[272 478 509 264 208],13,5,8026,3.7243619489559165,0.0,0.0
6155,1,2155,[272 478 509 264 208],13,5,8031,3.7249536178107605,0.0,0.0
6156,1,2156,[272 478 509 264 208],13,5,8036,3.725544738062123,0.0,0.0
6157,1,2157,[272 478 509 264 208],13,5,8041,3.72613531047266,0.0,0.0
6158,1,2158,[272 478 509 264 208],13,5,8046,3.726725335803613,0.0,0.0
6159,1,2159,[300 331 315 209 264],13,2,8048,3.725925925925926,20.0,20.0
6160,1,2160,[221 303 220 202 268],90,4,8052,3.7260527533549284,0.0,0.0
6161,1,2161,[283 219 367 208 485],385,2,8054,3.725254394079556,0.0,0.0
6162,1,2162,[219 378 212 206 429],804,2,8056,3.7244567730004623,0.0,0.0
6163,1,2163,[272 478 509 264 208],13,5,8061,3.7250462107208873,0.0,0.0
6164,1,2164,[272 478 509 264 208],13,5,8066,3.725635103926097,0.0,0.0
6165,1,2165,[272 478 509 264 208],13,5,8071,3.7262234533702676,0.0,0.0
6166,1,2166,[280 367 478 394 226],13,3,8074,3.7258883248730963,0.0,0.0
6167,1,2167,[272 478 509 264 208],13,5,8079,3.7264760147601477,0.0,0.0
6168,1,2168,[272 478 509 264 208],13,5,8084,3.72706316274781,0.0,0.0
6169,1,2169,[272 478 509 264 208],13,5,8089,3.7276497695852533,0.0,0.0
6170,1,2170,[324 367 227 222 239],387,3,8092,3.7273146015660985,0.0,20.0
6171,1,2171,[272 478 509 264 208],13,5,8097,3.727900552486188,0.0,0.0
6172,1,2172,[272 478 509 264 208],13,5,8102,3.728485964104924,0.0,0.0
6173,1,2173,[300 212 227 280 367],13,3,8105,3.7281508739650415,0.0,20.0
6174,1,2174,[272 478 509 264 208],13,5,8110,3.7287356321839082,0.0,0.0
6175,1,2175,[429 227 201 284 219],833,2,8112,3.7279411764705883,0.0,0.0
6176,1,2176,[272 478 509 264 208],13,5,8117,3.7285254937988057,0.0,0.0
6177,1,2177,[272 478 509 264 208],13,5,8122,3.72910927456382,0.0,0.0
6178,1,2178,[583 209 223 226 227],92,2,8124,3.728315741165672,20.0,0.0
6179,1,2179,[272 478 509 264 208],13,5,8129,3.7288990825688075,0.0,0.0
6180,1,2180,[272 478 509 264 208],13,5,8134,3.729481889041724,0.0,0.0
6181,1,2181,[272 478 509 264 208],13,5,8139,3.73006416131989,0.0,0.0
6182,1,2182,[272 478 509 264 208],13,5,8144,3.7306459001374255,0.0,0.0
6183,1,2183,[215 227 202 223 276],13,5,8149,3.7312271062271063,20.0,20.0
6184,1,2184,[485 212 429 452 367],650,1,8150,3.7299771167048057,0.0,0.0
6185,1,2185,[272 478 509 264 208],13,5,8155,3.7305580969807868,0.0,0.0
6186,1,2186,[202 216 509 230 215],537,1,8156,3.7293095564700502,0.0,0.0
6187,1,2187,[272 478 509 264 208],13,5,8161,3.729890310786106,0.0,0.0
6188,1,2188,[272 478 509 264 208],13,5,8166,3.730470534490635,0.0,0.0
6189,1,2189,[272 478 509 264 208],13,5,8171,3.7310502283105023,0.0,0.0
6190,1,2190,[272 478 509 264 208],13,5,8176,3.731629392971246,0.0,0.0
6191,1,2191,[272 478 509 264 208],13,5,8181,3.7322080291970803,0.0,0.0
6192,1,2192,[217 211 276 215 250],385,0,8181,3.7305061559507524,0.0,40.0
6193,1,2193,[272 478 509 264 208],13,5,8186,3.731084776663628,0.0,0.0
6194,1,2194,[264 201 230 241 509],308,4,8190,3.7312072892938497,0.0,0.0
6195,1,2195,[315 206 392 431 283],537,3,8193,3.730874316939891,20.0,0.0
6196,1,2196,[202 226 268 201 290],13,4,8197,3.7309968138370504,0.0,0.0
6197,1,2197,[272 478 509 264 208],13,5,8202,3.731574158325751,0.0,0.0
6198,1,2198,[429 201 508 283 324],527,2,8204,3.730786721236926,0.0,0.0
6199,1,2199,[272 478 509 264 208],13,5,8209,3.7313636363636364,0.0,0.0
6200,1,2200,[272 478 509 264 208],13,5,8214,3.731940027260336,0.0,0.0
6201,1,2201,[272 478 509 264 208],13,5,8219,3.732515894641235,0.0,0.0
6202,1,2202,[272 478 509 264 208],13,5,8224,3.7330912392192466,0.0,0.0
6203,1,2203,[272 478 509 264 208],13,5,8229,3.733666061705989,0.0,0.0
6204,1,2204,[219 208 209 227 365],804,3,8232,3.7333333333333334,0.0,0.0
6205,1,2205,[272 478 509 264 208],13,5,8237,3.7339075249320035,0.0,0.0
6206,1,2206,[272 478 509 264 208],13,5,8242,3.7344811961939284,0.0,0.0
6207,1,2207,[272 478 509 264 208],13,5,8247,3.735054347826087,0.0,0.0
6208,1,2208,[215 367 276 222 272],378,3,8250,3.734721593481213,0.0,40.0
6209,1,2209,[272 478 509 264 208],13,5,8255,3.735294117647059,0.0,0.0
6210,1,2210,[272 478 509 264 208],13,5,8260,3.7358661239258253,0.0,0.0
6211,1,2211,[272 478 509 264 208],13,5,8265,3.7364376130198913,0.0,0.0
6212,1,2212,[232 227 378 230 481],326,1,8266,3.735201084500678,0.0,0.0
6213,1,2213,[217 367 431 202 216],13,1,8267,3.733965672990063,0.0,0.0
6214,1,2214,[268 241 316 301 223],90,5,8272,3.7345372460496615,40.0,0.0
6215,1,2215,[272 478 509 264 208],13,5,8277,3.7351083032490973,0.0,0.0
6216,1,2216,[384 367 208 378 485],7,4,8281,3.7352277852954443,0.0,0.0
6217,1,2217,[272 478 509 264 208],13,5,8286,3.7357980162308384,0.0,0.0
6218,1,2218,[272 478 509 264 208],13,5,8291,3.736367733213159,0.0,0.0
6219,1,2219,[272 478 509 264 208],13,5,8296,3.736936936936937,0.0,0.0
6220,1,2220,[272 478 509 264 208],13,5,8301,3.7375056280954526,0.0,0.0
6221,1,2221,[272 478 509 264 208],13,5,8306,3.7380738073807382,0.0,0.0
6222,1,2222,[272 478 509 264 208],13,5,8311,3.738641475483581,0.0,0.0
6223,1,2223,[272 478 509 264 208],13,5,8316,3.7392086330935252,0.0,0.0
6224,1,2224,[272 478 509 264 208],13,5,8321,3.7397752808988765,0.0,0.0
6225,1,2225,[429 367 291 216 231],308,2,8323,3.738993710691824,0.0,0.0
6226,1,2226,[217 280 350 211 344],13,2,8325,3.738212842388864,0.0,20.0
6227,1,2227,[290 220 481 429 222],334,3,8328,3.7378815080789947,0.0,20.0
6228,1,2228,[272 478 509 264 208],13,5,8333,3.7384477344100495,0.0,0.0
6229,1,2229,[272 478 509 264 208],13,5,8338,3.739013452914798,0.0,0.0
6230,1,2230,[272 478 509 264 208],13,5,8343,3.7395786642761095,0.0,0.0
6231,1,2231,[272 478 509 264 208],13,5,8348,3.740143369175627,0.0,0.0
6232,1,2232,[429 276 481 211 264],308,4,8352,3.74025974025974,0.0,40.0
6233,1,2233,[272 478 509 264 208],13,5,8357,3.7408236347358996,0.0,0.0
6234,1,2234,[241 316 378 485 290],234,2,8359,3.7400447427293066,20.0,0.0
6235,1,2235,[211 212 259 290 201],452,0,8359,3.738372093023256,0.0,20.0
6236,1,2236,[429 272 508 236 276],334,4,8363,3.738489047831918,0.0,20.0
6237,1,2237,[299 301 290 261 303],13,2,8365,3.7377122430741734,0.0,0.0
6238,1,2238,[350 272 243 275 268],13,2,8367,3.7369361322018757,0.0,20.0
6239,1,2239,[272 478 509 264 208],13,5,8372,3.7375,0.0,0.0
6240,1,2240,[272 478 509 264 208],13,5,8377,3.738063364569389,0.0,0.0
6241,1,2241,[272 478 509 264 208],13,5,8382,3.7386262265834076,0.0,0.0
6242,1,2242,[272 478 509 264 208],13,5,8387,3.739188586714222,0.0,0.0
6243,1,2243,[241 509 211 315 290],537,3,8390,3.7388591800356505,20.0,20.0
6244,1,2244,[478 485 223 316 508],13,3,8393,3.738530066815145,40.0,0.0
6245,1,2245,[291 367 219 211 429],833,1,8394,3.7373107747105965,0.0,20.0
6246,1,2246,[272 478 509 264 208],13,5,8399,3.7378727191811305,0.0,0.0
6247,1,2247,[272 478 509 264 208],13,5,8404,3.7384341637010676,0.0,0.0
6248,1,2248,[272 478 509 264 208],13,5,8409,3.7389951089373055,0.0,0.0
6249,1,2249,[272 478 509 264 208],13,5,8414,3.7395555555555555,0.0,0.0
6250,1,2250,[350 509 222 384 321],13,1,8415,3.7383385162150153,0.0,20.0
6251,1,2251,[219 485 217 478 202],406,2,8417,3.7375666074600353,0.0,0.0
6252,1,2252,[272 478 509 264 208],13,5,8422,3.7381269418553043,0.0,0.0
6253,1,2253,[213 219 226 241 209],234,1,8423,3.7369121561668144,0.0,0.0
6254,1,2254,[272 478 509 264 208],13,5,8428,3.737472283813747,0.0,0.0
6255,1,2255,[272 478 509 264 208],13,5,8433,3.738031914893617,0.0,0.0
6256,1,2256,[272 478 509 264 208],13,5,8438,3.73859105006646,0.0,0.0
6257,1,2257,[272 478 509 264 208],13,5,8443,3.7391496899911427,0.0,0.0
6258,1,2258,[481 241 208 268 420],13,3,8446,3.738822487826472,0.0,0.0
6259,1,2259,[321 316 301 290 431],13,2,8448,3.7380530973451327,20.0,0.0
6260,1,2260,[298 478 275 216 227],474,3,8451,3.7377266696152147,0.0,20.0
6261,1,2261,[272 478 509 264 208],13,5,8456,3.7382847038019453,0.0,0.0
6262,1,2262,[272 478 509 264 208],13,5,8461,3.738842244807777,0.0,0.0
6263,1,2263,[272 478 509 264 208],13,5,8466,3.739399293286219,0.0,0.0
6264,1,2264,[485 321 300 241 218],311,2,8468,3.7386313465783663,0.0,20.0
6265,1,2265,[272 478 509 264 208],13,5,8473,3.73918799646955,0.0,0.0
6266,1,2266,[209 275 215 218 239],64,3,8476,3.7388619320688132,0.0,20.0
6267,1,2267,[272 478 509 264 208],13,5,8481,3.7394179894179893,0.0,0.0
6268,1,2268,[272 478 509 264 208],13,5,8486,3.739973556632878,0.0,0.0
6269,1,2269,[212 276 216 321 268],537,2,8488,3.73920704845815,0.0,20.0
6270,1,2270,[295 291 223 365 429],308,2,8490,3.738441215323646,20.0,0.0
6271,1,2271,[272 478 509 264 208],13,5,8495,3.7389964788732395,0.0,0.0
6272,1,2272,[272 478 509 264 208],13,5,8500,3.739551253849538,0.0,0.0
6273,1,2273,[272 478 509 264 208],13,5,8505,3.7401055408970976,0.0,0.0
6274,1,2274,[232 478 230 212 336],13,2,8507,3.7393406593406593,0.0,0.0
6275,1,2275,[272 478 509 264 208],13,5,8512,3.739894551845343,0.0,0.0
6276,1,2276,[272 478 509 264 208],13,5,8517,3.740447957839262,0.0,0.0
6277,1,2277,[209 227 264 211 298],833,2,8519,3.7396839332748026,0.0,20.0
6278,1,2278,[431 481 208 231 275],7,4,8523,3.7397981570864416,0.0,20.0
6279,1,2279,[350 201 264 429 420],13,3,8526,3.7394736842105263,0.0,0.0
6280,1,2280,[272 478 509 264 208],13,5,8531,3.740026304252521,0.0,0.0
6281,1,2281,[272 478 509 264 208],13,5,8536,3.740578439964943,0.0,0.0
6282,1,2282,[272 478 509 264 208],13,5,8541,3.7411300919842314,0.0,0.0
6283,1,2283,[202 240 367 216 284],92,0,8541,3.739492119089317,0.0,0.0
6284,1,2284,[272 478 509 264 208],13,5,8546,3.740043763676149,0.0,0.0
6285,1,2285,[209 481 243 226 219],234,2,8548,3.7392825896762907,0.0,0.0
6286,1,2286,[429 507 223 226 230],13,3,8551,3.738959335373852,20.0,0.0
6287,1,2287,[272 478 509 264 208],13,5,8556,3.7395104895104896,0.0,0.0
6288,1,2288,[223 384 230 509 481],7,3,8559,3.739187418086501,20.0,0.0
6289,1,2289,[392 206 209 508 236],537,2,8561,3.7384279475982534,0.0,0.0
6290,1,2290,[272 478 509 264 208],13,5,8566,3.7389786119598427,0.0,0.0
6291,1,2291,[272 478 509 264 208],13,5,8571,3.7395287958115184,0.0,0.0
6292,1,2292,[272 478 509 264 208],13,5,8576,3.740078499781945,0.0,0.0
6293,1,2293,[272 478 509 264 208],13,5,8581,3.740627724498692,0.0,0.0
6294,1,2294,[272 478 509 264 208],13,5,8586,3.7411764705882353,0.0,0.0
6295,1,2295,[222 268 280 429 507],13,3,8589,3.7408536585365852,0.0,20.0
6296,1,2296,[272 478 509 264 208],13,5,8594,3.7414018284719197,0.0,0.0
6297,1,2297,[272 478 509 264 208],13,5,8599,3.7419495213228893,0.0,0.0
6298,1,2298,[272 478 509 264 208],13,5,8604,3.742496737712049,0.0,0.0
6299,1,2299,[272 478 509 264 208],13,5,8609,3.7430434782608697,0.0,0.0
6300,1,2300,[272 478 509 264 208],13,5,8614,3.7435897435897436,0.0,0.0
6301,1,2301,[272 478 509 264 208],13,5,8619,3.7441355343179845,0.0,0.0
6302,1,2302,[303 202 508 284 478],537,3,8622,3.7438124185844552,0.0,0.0
6303,1,2303,[315 250 264 298 283],894,2,8624,3.7430555555555554,20.0,0.0
6304,1,2304,[509 227 431 268 300],13,3,8627,3.7427331887201736,0.0,20.0
6305,1,2305,[239 255 217 241 295],378,2,8629,3.7419774501300953,0.0,0.0
6306,1,2306,[209 223 219 485 216],234,1,8630,3.740788903337668,20.0,0.0
6307,1,2307,[272 478 509 264 208],13,5,8635,3.7413344887348354,0.0,0.0
6308,1,2308,[272 478 509 264 208],13,5,8640,3.7418796015591167,0.0,0.0
6309,1,2309,[272 478 509 264 208],13,5,8645,3.742424242424242,0.0,0.0
6310,1,2310,[452 508 231 431 326],13,0,8645,3.7408048463868457,0.0,0.0
6311,1,2311,[215 378 216 429 211],650,3,8648,3.7404844290657437,0.0,20.0
6312,1,2312,[272 478 509 264 208],13,5,8653,3.7410289667099006,0.0,0.0
6313,1,2313,[272 478 509 264 208],13,5,8658,3.741573033707865,0.0,0.0
6314,1,2314,[301 212 218 367 481],234,2,8660,3.7408207343412525,0.0,0.0
6315,1,2315,[272 478 509 264 208],13,5,8665,3.7413644214162347,0.0,0.0
6316,1,2316,[231 481 227 384 211],13,2,8667,3.740612861458783,0.0,20.0
6317,1,2317,[272 478 509 264 208],13,5,8672,3.741156169111303,0.0,0.0
6318,1,2318,[420 211 485 268 275],85,4,8676,3.741267787839586,0.0,40.0
6319,1,2319,[367 212 431 301 232],13,1,8677,3.7400862068965517,0.0,0.0
6320,1,2320,[272 478 509 264 208],13,5,8682,3.740629039207238,0.0,0.0
6321,1,2321,[218 239 378 216 420],650,1,8683,3.739448751076658,0.0,0.0
6322,1,2322,[272 478 509 264 208],13,5,8688,3.739991390443392,0.0,0.0
6323,1,2323,[272 478 509 264 208],13,5,8693,3.7405335628227196,0.0,0.0
6324,1,2324,[336 431 227 275 452],13,1,8694,3.7393548387096773,0.0,20.0
6325,1,2325,[236 301 316 291 241],234,1,8695,3.738177128116939,20.0,0.0
6326,1,2326,[272 478 509 264 208],13,5,8700,3.7387193811774817,0.0,0.0
6327,1,2327,[431 219 583 290 220],59,3,8703,3.73840206185567,0.0,0.0
6328,1,2328,[272 478 509 264 208],13,5,8708,3.7389437526835554,0.0,0.0
6329,1,2329,[272 478 509 264 208],13,5,8713,3.7394849785407724,0.0,0.0
6330,1,2330,[272 478 509 264 208],13,5,8718,3.74002574002574,0.0,0.0
6331,1,2331,[231 209 216 268 299],13,1,8719,3.73885077186964,0.0,0.0
6332,1,2332,[272 478 509 264 208],13,5,8724,3.7393913416202316,0.0,0.0
6333,1,2333,[272 478 509 264 208],13,5,8729,3.739931448157669,0.0,0.0
6334,1,2334,[283 227 241 221 209],158,3,8732,3.739614561027837,0.0,0.0
6335,1,2335,[272 478 509 264 208],13,5,8737,3.740154109589041,0.0,0.0
6336,1,2336,[272 478 509 264 208],13,5,8742,3.7406931964056485,0.0,0.0
6337,1,2337,[272 478 509 264 208],13,5,8747,3.7412318220701453,0.0,0.0
6338,1,2338,[223 209 236 507 429],666,3,8750,3.7409149209063703,20.0,0.0
6339,1,2339,[384 231 367 211 208],648,3,8753,3.7405982905982906,0.0,20.0
6340,1,2340,[272 478 509 264 208],13,5,8758,3.7411362665527554,0.0,0.0
6341,1,2341,[231 240 298 293 226],339,2,8760,3.740392826643894,0.0,0.0
6342,1,2342,[272 478 509 264 208],13,5,8765,3.740930431071276,0.0,0.0
6343,1,2343,[272 478 509 264 208],13,5,8770,3.741467576791809,0.0,0.0
6344,1,2344,[272 478 509 264 208],13,5,8775,3.742004264392324,0.0,0.0
6345,1,2345,[272 478 509 264 208],13,5,8780,3.742540494458653,0.0,0.0
6346,1,2346,[272 478 509 264 208],13,5,8785,3.7430762675756286,0.0,0.0
6347,1,2347,[272 478 509 264 208],13,5,8790,3.7436115843270867,0.0,0.0
6348,1,2348,[272 478 509 264 208],13,5,8795,3.7441464452958706,0.0,0.0
6349,1,2349,[272 478 509 264 208],13,5,8800,3.74468085106383,0.0,0.0
6350,1,2350,[431 367 272 275 350],13,1,8801,3.743513398553807,0.0,20.0
6351,1,2351,[272 478 509 264 208],13,5,8806,3.744047619047619,0.0,0.0
6352,1,2352,[206 452 232 217 202],650,1,8807,3.742881427964301,0.0,0.0
6353,1,2353,[239 231 413 300 226],13,2,8809,3.74214103653356,0.0,20.0
6354,1,2354,[272 478 509 264 208],13,5,8814,3.742675159235669,0.0,0.0
6355,1,2355,[431 215 241 291 230],328,2,8816,3.7419354838709675,0.0,0.0
6356,1,2356,[272 478 509 264 208],13,5,8821,3.742469240560034,0.0,0.0
6357,1,2357,[272 478 509 264 208],13,5,8826,3.7430025445292623,0.0,0.0
6358,1,2358,[272 478 509 264 208],13,5,8831,3.7435353963543876,0.0,0.0
6359,1,2359,[316 255 300 392 378],454,3,8834,3.743220338983051,20.0,20.0
6360,1,2360,[272 478 509 264 208],13,5,8839,3.743752647183397,0.0,0.0
6361,1,2361,[272 478 509 264 208],13,5,8844,3.7442845046570703,0.0,0.0
6362,1,2362,[272 478 509 264 208],13,5,8849,3.744815911976301,0.0,0.0
6363,1,2363,[272 478 509 264 208],13,5,8854,3.745346869712352,0.0,0.0
6364,1,2364,[284 212 221 215 230],85,1,8855,3.744186046511628,0.0,0.0
6365,1,2365,[284 240 227 420 378],749,4,8859,3.7442941673710903,0.0,0.0
6366,1,2366,[290 485 216 301 231],334,0,8859,3.7427122940430926,0.0,0.0
6367,1,2367,[259 321 209 509 232],194,0,8859,3.7411317567567566,0.0,0.0
6368,1,2368,[272 478 509 264 208],13,5,8864,3.74166314900802,0.0,0.0
6369,1,2369,[272 478 509 264 208],13,5,8869,3.7421940928270043,0.0,0.0
6370,1,2370,[300 378 219 301 243],234,1,8870,3.7410375369042597,0.0,20.0
6371,1,2371,[202 509 384 216 315],13,3,8873,3.740725126475548,20.0,0.0
6372,1,2372,[272 478 509 264 208],13,5,8878,3.7412557943531395,0.0,0.0
6373,1,2373,[272 478 509 264 208],13,5,8883,3.74178601516428,0.0,0.0
6374,1,2374,[272 478 509 264 208],13,5,8888,3.7423157894736843,0.0,0.0
6375,1,2375,[223 254 295 241 226],308,2,8890,3.741582491582492,20.0,0.0
6376,1,2376,[272 478 509 264 208],13,5,8895,3.7421119057635677,0.0,0.0
6377,1,2377,[272 478 509 264 208],13,5,8900,3.742640874684609,0.0,0.0
6378,1,2378,[272 478 509 264 208],13,5,8905,3.7431693989071038,0.0,0.0
6379,1,2379,[272 478 509 264 208],13,5,8910,3.7436974789915967,0.0,0.0
6380,1,2380,[509 268 230 336 212],13,3,8913,3.743385132297354,0.0,0.0
6381,1,2381,[272 478 509 264 208],13,5,8918,3.7439126784214944,0.0,0.0
6382,1,2382,[259 481 218 216 507],194,2,8920,3.7431808644565674,0.0,0.0
6383,1,2383,[315 275 239 208 211],13,4,8924,3.7432885906040267,20.0,40.0
6384,1,2384,[295 236 336 315 244],894,3,8927,3.7429769392033543,20.0,0.0
6385,1,2385,[272 478 509 264 208],13,5,8932,3.743503772003353,0.0,0.0
6386,1,2386,[243 241 221 202 222],234,0,8932,3.7419354838709675,0.0,20.0
6387,1,2387,[272 478 509 264 208],13,5,8937,3.742462311557789,0.0,0.0
6388,1,2388,[272 478 509 264 208],13,5,8942,3.7429886982000835,0.0,0.0
6389,1,2389,[508 280 215 298 301],378,2,8944,3.7422594142259413,0.0,0.0
6390,1,2390,[211 300 221 218 478],234,0,8944,3.740694270179841,0.0,40.0
6391,1,2391,[272 478 509 264 208],13,5,8949,3.7412207357859533,0.0,0.0
6392,1,2392,[272 478 509 264 208],13,5,8954,3.74174676138738,0.0,0.0
6393,1,2393,[326 344 272 230 321],197,3,8957,3.741436925647452,0.0,0.0
6394,1,2394,[272 478 509 264 208],13,5,8962,3.7419624217118996,0.0,0.0
6395,1,2395,[298 276 291 293 331],548,4,8966,3.7420701168614356,0.0,20.0
6396,1,2396,[272 478 509 264 208],13,5,8971,3.7425949103045473,0.0,0.0
6397,1,2397,[272 478 509 264 208],13,5,8976,3.743119266055046,0.0,0.0
6398,1,2398,[272 478 509 264 208],13,5,8981,3.743643184660275,0.0,0.0
6399,1,2399,[272 478 509 264 208],13,5,8986,3.7441666666666666,0.0,0.0
6400,1,2400,[272 478 509 264 208],13,5,8991,3.7446897126197416,0.0,0.0
6401,1,2401,[272 478 509 264 208],13,5,8996,3.7452123230641132,0.0,0.0
6402,1,2402,[272 478 509 264 208],13,5,9001,3.7457344985434875,0.0,0.0
6403,1,2403,[259 481 222 280 290],234,1,9002,3.74459234608985,0.0,20.0
6404,1,2404,[293 350 509 324 255],894,2,9004,3.743866943866944,0.0,0.0
6405,1,2405,[272 478 509 264 208],13,5,9009,3.7443890274314215,0.0,0.0
6406,1,2406,[216 239 202 365 275],378,2,9011,3.7436643124221023,0.0,20.0
6407,1,2407,[272 478 509 264 208],13,5,9016,3.744186046511628,0.0,0.0
6408,1,2408,[272 478 509 264 208],13,5,9021,3.7447073474470733,0.0,0.0
6409,1,2409,[272 478 509 264 208],13,5,9026,3.745228215767635,0.0,0.0
6410,1,2410,[508 378 241 298 211],85,3,9029,3.744919120696806,0.0,20.0
6411,1,2411,[216 394 336 202 367],13,1,9030,3.743781094527363,0.0,0.0
6412,1,2412,[272 478 509 264 208],13,5,9035,3.7443016991297142,0.0,0.0
6413,1,2413,[315 478 227 222 230],474,4,9039,3.744407622203811,20.0,20.0
6414,1,2414,[272 478 509 264 208],13,5,9044,3.744927536231884,0.0,0.0
6415,1,2415,[223 303 217 215 241],13,3,9047,3.7446192052980134,20.0,0.0
6416,1,2416,[272 478 509 264 208],13,5,9052,3.745138601572197,0.0,0.0
6417,1,2417,[213 478 239 236 243],537,2,9054,3.7444168734491314,0.0,0.0
6418,1,2418,[272 478 509 264 208],13,5,9059,3.7449359239355107,0.0,0.0
6419,1,2419,[272 478 509 264 208],13,5,9064,3.7454545454545456,0.0,0.0
6420,1,2420,[272 478 509 264 208],13,5,9069,3.745972738537794,0.0,0.0
6421,1,2421,[272 478 509 264 208],13,5,9074,3.746490503715937,0.0,0.0
6422,1,2422,[264 326 507 413 384],195,1,9075,3.7453569954601735,0.0,0.0
6423,1,2423,[272 478 509 208 264],13,5,9080,3.745874587458746,0.0,0.0
6424,1,2424,[213 223 243 211 431],234,0,9080,3.7443298969072165,20.0,20.0
6425,1,2425,[239 217 240 226 222],815,2,9082,3.74361088211047,0.0,20.0
6426,1,2426,[272 478 509 208 264],13,5,9087,3.7441285537700866,0.0,0.0
6427,1,2427,[208 236 216 201 431],537,2,9089,3.7434102141680397,0.0,0.0
6428,1,2428,[272 478 509 208 264],13,5,9094,3.7439275421984357,0.0,0.0
6429,1,2429,[272 478 509 208 264],13,5,9099,3.7444444444444445,0.0,0.0
6430,1,2430,[239 218 429 241 276],200,4,9103,3.74454956807898,0.0,20.0
6431,1,2431,[413 239 241 367 429],13,2,9105,3.7438322368421053,0.0,0.0
6432,1,2432,[230 232 202 222 241],295,4,9109,3.7439375256884504,0.0,20.0
6433,1,2433,[216 429 284 211 298],749,5,9114,3.744453574363188,0.0,20.0
6434,1,2434,[231 208 384 321 344],13,1,9115,3.7433264887063653,0.0,0.0
6435,1,2435,[272 478 509 208 264],13,5,9120,3.7438423645320196,0.0,0.0
6436,1,2436,[272 478 509 208 264],13,5,9125,3.7443578169881,0.0,0.0
6437,1,2437,[221 316 485 208 300],334,3,9128,3.7440525020508613,20.0,20.0
6438,1,2438,[272 478 509 208 264],13,5,9133,3.744567445674457,0.0,0.0
6439,1,2439,[239 284 230 321 283],378,1,9134,3.7434426229508198,0.0,0.0
6440,1,2440,[264 485 211 291 378],308,1,9135,3.7423187218353133,0.0,20.0
6441,1,2441,[275 230 485 291 212],537,1,9136,3.741195741195741,0.0,20.0
6442,1,2442,[272 478 509 208 264],13,5,9141,3.741711011051985,0.0,0.0
6443,1,2443,[272 478 509 208 264],13,5,9146,3.742225859247136,0.0,0.0
6444,1,2444,[272 478 509 208 264],13,5,9151,3.7427402862985684,0.0,0.0
6445,1,2445,[272 478 509 208 264],13,5,9156,3.743254292722813,0.0,0.0
6446,1,2446,[272 478 509 208 264],13,5,9161,3.7437678790355537,0.0,0.0
6447,1,2447,[394 211 299 452 223],13,2,9163,3.7430555555555554,20.0,20.0
6448,1,2448,[272 478 509 208 264],13,5,9168,3.7435688035933032,0.0,0.0
6449,1,2449,[276 268 326 221 300],334,3,9171,3.743265306122449,0.0,40.0
6450,1,2450,[272 478 509 208 264],13,5,9176,3.7437780497756017,0.0,0.0
6451,1,2451,[215 250 365 206 212],804,3,9179,3.74347471451876,0.0,0.0
6452,1,2452,[301 241 243 284 259],234,0,9179,3.741948634325316,0.0,0.0
6453,1,2453,[219 300 290 212 280],234,0,9179,3.7404237978810104,0.0,20.0
6454,1,2454,[243 202 336 507 280],13,2,9181,3.739714867617108,0.0,0.0
6455,1,2455,[272 478 509 208 264],13,5,9186,3.740228013029316,0.0,0.0
6456,1,2456,[291 365 218 264 223],308,2,9188,3.7395197395197397,20.0,0.0
6457,1,2457,[254 293 211 367 227],774,1,9189,3.7384052074857608,0.0,20.0
6458,1,2458,[272 478 509 208 264],13,5,9194,3.738918259455063,0.0,0.0
6459,1,2459,[272 478 509 208 264],13,5,9199,3.739430894308943,0.0,0.0
6460,1,2460,[331 508 230 316 227],13,2,9201,3.7387240958959773,20.0,0.0
6461,1,2461,[367 246 321 243 231],387,0,9201,3.7372055239642568,0.0,0.0
6462,1,2462,[272 478 509 208 264],13,5,9206,3.7377182298010556,0.0,0.0
6463,1,2463,[272 478 509 208 264],13,5,9211,3.7382305194805197,0.0,0.0
6464,1,2464,[272 478 509 208 264],13,5,9216,3.7387423935091277,0.0,0.0
6465,1,2465,[272 478 509 208 264],13,5,9221,3.7392538523925385,0.0,0.0
6466,1,2466,[272 478 509 208 264],13,5,9226,3.73976489663559,0.0,0.0
6467,1,2467,[507 485 241 246 211],85,4,9230,3.739870340356564,0.0,20.0
6468,1,2468,[202 583 507 259 295],308,2,9232,3.739165654110976,0.0,0.0
6469,1,2469,[429 507 291 254 239],308,1,9233,3.7380566801619435,0.0,0.0
6470,1,2470,[452 431 367 201 217],833,1,9234,3.736948603804128,0.0,0.0
6471,1,2471,[272 478 509 208 264],13,5,9239,3.7374595469255665,0.0,0.0
6472,1,2472,[272 478 509 208 264],13,5,9244,3.7379700768297615,0.0,0.0
6473,1,2473,[272 478 509 208 264],13,5,9249,3.738480194017785,0.0,0.0
6474,1,2474,[272 478 509 208 264],13,5,9254,3.738989898989899,0.0,0.0
6475,1,2475,[221 481 378 243 291],234,2,9256,3.738287560581583,0.0,0.0
6476,1,2476,[272 478 509 208 264],13,5,9261,3.7387969317723053,0.0,0.0
6477,1,2477,[321 212 481 431 218],13,1,9262,3.7376916868442294,0.0,0.0
6478,1,2478,[272 478 509 208 264],13,5,9267,3.7382008874546186,0.0,0.0
6479,1,2479,[215 284 243 241 303],537,1,9268,3.7370967741935486,0.0,0.0
6480,1,2480,[272 478 509 208 264],13,5,9273,3.7376058041112454,0.0,0.0
6481,1,2481,[276 230 226 321 315],13,3,9276,3.7373086220789684,20.0,20.0
6482,1,2482,[272 478 509 208 264],13,5,9281,3.737817156665324,0.0,0.0
6483,1,2483,[284 215 485 241 209],59,3,9284,3.737520128824477,0.0,0.0
6484,1,2484,[283 213 293 485 392],308,3,9287,3.7372233400402415,0.0,0.0
6485,1,2485,[272 478 509 208 264],13,5,9292,3.737731295253419,0.0,0.0
6486,1,2486,[272 478 509 208 264],13,5,9297,3.738238841978287,0.0,0.0
6487,1,2487,[299 221 300 324 255],486,3,9300,3.737942122186495,0.0,20.0
6488,1,2488,[293 259 284 275 481],474,3,9303,3.7376456408196064,0.0,20.0
6489,1,2489,[239 315 202 215 280],13,5,9308,3.7381526104417673,20.0,0.0
6490,1,2490,[272 478 509 208 264],13,5,9313,3.7386591730228824,0.0,0.0
6491,1,2491,[272 478 509 208 264],13,5,9318,3.7391653290529696,0.0,0.0
6492,1,2492,[272 478 509 208 264],13,5,9323,3.7396710790212597,0.0,0.0
6493,1,2493,[226 301 227 350 261],13,2,9325,3.73897353648757,0.0,0.0
6494,1,2494,[272 478 509 208 264],13,5,9330,3.7394789579158316,0.0,0.0
6495,1,2495,[272 478 509 208 264],13,5,9335,3.7399839743589745,0.0,0.0
6496,1,2496,[272 478 509 208 264],13,5,9340,3.7404885863035644,0.0,0.0
6497,1,2497,[272 478 509 208 264],13,5,9345,3.7409927942353884,0.0,0.0
6498,1,2498,[507 232 290 272 202],13,3,9348,3.7406962785114044,0.0,0.0
6499,1,2499,[367 208 216 290 215],13,3,9351,3.7404,0.0,0.0
6500,1,2500,[201 321 202 394 239],13,2,9353,3.739704118352659,0.0,0.0
6501,1,2501,[272 478 509 208 264],13,5,9358,3.7402078337330136,0.0,0.0
6502,1,2502,[215 208 283 378 481],271,4,9362,3.7403116260487415,0.0,0.0
6503,1,2503,[509 275 230 227 218],474,3,9365,3.7400159744408947,0.0,20.0
6504,1,2504,[272 478 509 208 264],13,5,9370,3.740518962075848,0.0,0.0
6505,1,2505,[272 478 509 208 264],13,5,9375,3.741021548284118,0.0,0.0
6506,1,2506,[272 478 509 208 264],13,5,9380,3.741523733546071,0.0,0.0
6507,1,2507,[297 202 255 208 293],533,3,9383,3.741228070175439,20.0,0.0
6508,1,2508,[272 478 509 208 264],13,5,9388,3.741729772817856,0.0,0.0
6509,1,2509,[272 478 509 208 264],13,5,9393,3.742231075697211,0.0,0.0
6510,1,2510,[272 478 509 208 264],13,5,9398,3.742731979291119,0.0,0.0
6511,1,2511,[230 219 222 293 216],145,5,9403,3.743232484076433,0.0,20.0
6512,1,2512,[202 208 231 299 315],537,2,9405,3.7425387982491047,20.0,0.0
6513,1,2513,[431 316 293 246 216],145,5,9410,3.7430389817024663,20.0,0.0
6514,1,2514,[272 478 509 208 264],13,5,9415,3.743538767395626,0.0,0.0
6515,1,2515,[272 478 509 208 264],13,5,9420,3.7440381558028615,0.0,0.0
6516,1,2516,[272 478 509 208 264],13,5,9425,3.7445371473976956,0.0,0.0
6517,1,2517,[211 284 267 226 217],833,0,9425,3.743050039714059,0.0,20.0
6518,1,2518,[283 293 240 221 250],385,2,9427,3.7423580786026203,0.0,0.0
6519,1,2519,[298 280 223 315 344],894,3,9430,3.742063492063492,40.0,0.0
6520,1,2520,[272 478 509 208 264],13,5,9435,3.742562475208251,0.0,0.0
6521,1,2521,[272 478 509 208 264],13,5,9440,3.7430610626486915,0.0,0.0
6522,1,2522,[431 272 326 209 321],13,1,9441,3.741973840665874,0.0,0.0
6523,1,2523,[276 255 202 367 208],643,4,9445,3.742076069730586,0.0,20.0
6524,1,2524,[272 478 509 208 264],13,5,9450,3.742574257425743,0.0,0.0
6525,1,2525,[272 478 509 208 264],13,5,9455,3.7430720506730006,0.0,0.0
6526,1,2526,[272 478 509 208 264],13,5,9460,3.743569449940641,0.0,0.0
6527,1,2527,[272 478 509 208 264],13,5,9465,3.7440664556962027,0.0,0.0
6528,1,2528,[209 217 211 478 231],339,3,9468,3.7437722419928825,0.0,20.0
6529,1,2529,[272 478 509 208 264],13,5,9473,3.7442687747035572,0.0,0.0
6530,1,2530,[378 431 291 420 232],749,5,9478,3.7447649150533384,0.0,0.0
6531,1,2531,[272 478 509 208 264],13,5,9483,3.745260663507109,0.0,0.0
6532,1,2532,[272 478 509 208 264],13,5,9488,3.745756020529017,0.0,0.0
6533,1,2533,[218 507 212 413 508],13,1,9489,3.744672454617206,0.0,0.0
6534,1,2534,[272 478 509 208 264],13,5,9494,3.7451676528599607,0.0,0.0
6535,1,2535,[216 293 264 231 276],308,2,9496,3.7444794952681386,0.0,20.0
6536,1,2536,[272 478 509 208 264],13,5,9501,3.7449743791880175,0.0,0.0
6537,1,2537,[272 478 509 208 264],13,5,9506,3.7454688731284476,0.0,0.0
6538,1,2538,[272 478 509 208 264],13,5,9511,3.745962977550217,0.0,0.0
6539,1,2539,[272 478 509 208 264],13,5,9516,3.746456692913386,0.0,0.0
6540,1,2540,[226 276 384 485 202],13,3,9519,3.7461629279811097,0.0,20.0
6541,1,2541,[276 275 297 212 283],894,4,9523,3.746262785208497,20.0,40.0
6542,1,2542,[272 478 509 208 264],13,5,9528,3.746755800235942,0.0,0.0
6543,1,2543,[431 217 232 272 321],13,1,9529,3.745676100628931,0.0,0.0
6544,1,2544,[272 478 509 208 264],13,5,9534,3.746168958742633,0.0,0.0
6545,1,2545,[272 478 509 208 264],13,5,9539,3.746661429693637,0.0,0.0
6546,1,2546,[367 431 485 276 230],194,1,9540,3.745583038869258,0.0,20.0
6547,1,2547,[226 222 202 321 219],387,1,9541,3.7445054945054945,0.0,20.0
6548,1,2548,[272 478 509 208 264],13,5,9546,3.7449980384464494,0.0,0.0
6549,1,2549,[272 478 509 208 264],13,5,9551,3.7454901960784315,0.0,0.0
6550,1,2550,[272 478 509 208 264],13,5,9556,3.7459819678557427,0.0,0.0
6551,1,2551,[300 303 223 213 326],334,3,9559,3.7456896551724137,20.0,20.0
6552,1,2552,[272 478 509 208 264],13,5,9564,3.746180963572268,0.0,0.0
6553,1,2553,[272 478 509 208 264],13,5,9569,3.7466718872357085,0.0,0.0
6554,1,2554,[344 315 508 255 223],894,3,9572,3.7463796477495106,40.0,0.0
6555,1,2555,[272 478 509 208 264],13,5,9577,3.746870109546166,0.0,0.0
6556,1,2556,[239 276 481 431 215],406,1,9578,3.745795854517012,0.0,20.0
6557,1,2557,[272 478 509 208 264],13,5,9583,3.7462861610633307,0.0,0.0
6558,1,2558,[272 478 509 208 264],13,5,9588,3.746776084407972,0.0,0.0
6559,1,2559,[272 478 509 208 264],13,5,9593,3.747265625,0.0,0.0
6560,1,2560,[215 508 243 299 268],537,2,9595,3.746583365872706,0.0,0.0
6561,1,2561,[261 350 478 230 215],13,2,9597,3.7459016393442623,0.0,0.0
6562,1,2562,[201 223 290 336 275],13,2,9599,3.74522044479126,20.0,20.0
6563,1,2563,[367 295 429 215 227],648,2,9601,3.7445397815912638,0.0,0.0
6564,1,2564,[299 268 336 201 215],13,2,9603,3.743859649122807,0.0,0.0
6565,1,2565,[394 336 316 231 452],13,1,9604,3.7427903351519873,20.0,0.0
6566,1,2566,[272 478 509 208 264],13,5,9609,3.7432800934943513,0.0,0.0
6567,1,2567,[272 478 509 208 264],13,5,9614,3.7437694704049846,0.0,0.0
6568,1,2568,[272 478 509 208 264],13,5,9619,3.744258466329311,0.0,0.0
6569,1,2569,[223 485 230 231 509],308,3,9622,3.7439688715953308,20.0,0.0
6570,1,2570,[272 478 509 208 264],13,5,9627,3.7444574095682612,0.0,0.0
6571,1,2571,[272 478 509 208 264],13,5,9632,3.744945567651633,0.0,0.0
6572,1,2572,[272 478 509 208 264],13,5,9637,3.7454333462883795,0.0,0.0
6573,1,2573,[272 478 509 208 264],13,5,9642,3.745920745920746,0.0,0.0
6574,1,2574,[331 239 384 452 321],13,1,9643,3.744854368932039,0.0,0.0
6575,1,2575,[272 478 509 208 264],13,5,9648,3.7453416149068324,0.0,0.0
6576,1,2576,[509 478 213 507 367],6,4,9652,3.7454404346138923,0.0,0.0
6577,1,2577,[213 208 291 478 378],234,2,9654,3.7447633824670286,0.0,0.0
6578,1,2578,[272 478 509 208 264],13,5,9659,3.7452500969367972,0.0,0.0
6579,1,2579,[226 202 236 485 316],234,1,9660,3.744186046511628,20.0,0.0
6580,1,2580,[272 478 509 208 264],13,5,9665,3.7446726075164665,0.0,0.0
6581,1,2581,[272 478 509 208 264],13,5,9670,3.745158791634392,0.0,0.0
6582,1,2582,[272 478 509 208 264],13,5,9675,3.745644599303136,0.0,0.0
6583,1,2583,[272 478 509 208 264],13,5,9680,3.7461300309597525,0.0,0.0
6584,1,2584,[272 478 509 208 264],13,5,9685,3.746615087040619,0.0,0.0
6585,1,2585,[429 300 215 239 264],13,4,9689,3.7467130703789637,0.0,20.0
6586,1,2586,[272 478 509 208 264],13,5,9694,3.7471975260919983,0.0,0.0
6587,1,2587,[272 478 509 208 264],13,5,9699,3.747681607418856,0.0,0.0
6588,1,2588,[223 283 217 280 420],378,3,9702,3.7473928157589804,20.0,0.0
6589,1,2589,[315 232 264 316 275],13,3,9705,3.747104247104247,40.0,20.0
6590,1,2590,[283 316 507 232 246],85,2,9707,3.746429949826322,20.0,0.0
6591,1,2591,[272 478 509 208 264],13,5,9712,3.746913580246914,0.0,0.0
6592,1,2592,[272 478 509 208 264],13,5,9717,3.7473968376397995,0.0,0.0
6593,1,2593,[209 211 201 202 226],479,4,9721,3.7474942174248267,0.0,20.0
6594,1,2594,[202 300 291 230 295],533,4,9725,3.7475915221579963,0.0,20.0
6595,1,2595,[226 316 509 208 202],650,1,9726,3.74653312788906,20.0,0.0
6596,1,2596,[217 216 301 218 420],13,1,9727,3.74547554871005,0.0,0.0
6597,1,2597,[272 243 478 331 290],13,3,9730,3.745188606620477,0.0,0.0
6598,1,2598,[420 485 303 350 413],13,2,9732,3.7445171219699884,0.0,0.0
6599,1,2599,[272 478 509 208 264],13,5,9737,3.745,0.0,0.0
6600,1,2600,[272 478 509 208 264],13,5,9742,3.7454825067281816,0.0,0.0
6601,1,2601,[272 478 509 208 264],13,5,9747,3.7459646425826287,0.0,0.0
6602,1,2602,[378 219 478 301 217],650,1,9748,3.7449097195543604,0.0,0.0
6603,1,2603,[481 485 221 378 298],85,4,9752,3.7450076804915513,0.0,0.0
6604,1,2604,[211 298 509 452 507],308,3,9755,3.7447216890595008,0.0,20.0
6605,1,2605,[215 378 276 223 221],184,5,9760,3.7452033768227166,20.0,20.0
6606,1,2606,[272 478 509 208 264],13,5,9765,3.7456846950517835,0.0,0.0
6607,1,2607,[344 222 301 275 350],328,2,9767,3.745015337423313,0.0,40.0
6608,1,2608,[272 478 509 208 264],13,5,9772,3.7454963587581447,0.0,0.0
6609,1,2609,[215 209 202 431 394],13,2,9774,3.7448275862068967,0.0,0.0
6610,1,2610,[227 367 290 221 298],158,2,9776,3.744159325928763,0.0,0.0
6611,1,2611,[478 272 212 227 209],650,2,9778,3.743491577335375,0.0,0.0
6612,1,2612,[481 509 507 413 367],13,1,9779,3.742441637964026,0.0,0.0
6613,1,2613,[221 268 315 321 485],537,2,9781,3.7417750573833204,20.0,0.0
6614,1,2614,[272 478 509 208 264],13,5,9786,3.7422562141491396,0.0,0.0
6615,1,2615,[272 478 509 208 264],13,5,9791,3.742737003058104,0.0,0.0
6616,1,2616,[272 344 222 303 216],13,2,9793,3.742071073748567,0.0,20.0
6617,1,2617,[222 243 481 290 367],234,2,9795,3.741405653170359,0.0,20.0
6618,1,2618,[272 478 509 208 264],13,5,9800,3.7418862161130204,0.0,0.0
6619,1,2619,[272 478 509 208 264],13,5,9805,3.7423664122137406,0.0,0.0
6620,1,2620,[272 478 509 208 264],13,5,9810,3.7428462418924076,0.0,0.0
6621,1,2621,[272 478 509 208 264],13,5,9815,3.7433257055682687,0.0,0.0
6622,1,2622,[244 230 485 316 507],474,4,9819,3.743423560808235,20.0,0.0
6623,1,2623,[275 429 215 221 378],537,1,9820,3.7423780487804876,0.0,20.0
6624,1,2624,[392 283 223 295 301],378,2,9822,3.7417142857142855,20.0,0.0
6625,1,2625,[272 478 509 208 264],13,5,9827,3.742193450114242,0.0,0.0
6626,1,2626,[272 478 509 208 264],13,5,9832,3.742672249714503,0.0,0.0
6627,1,2627,[272 478 509 208 264],13,5,9837,3.743150684931507,0.0,0.0
6628,1,2628,[272 478 509 208 264],13,5,9842,3.7436287561810575,0.0,0.0
6629,1,2629,[452 264 219 301 280],13,2,9844,3.7429657794676805,0.0,0.0
6630,1,2630,[272 478 509 208 264],13,5,9849,3.743443557582668,0.0,0.0
6631,1,2631,[272 478 509 208 264],13,5,9854,3.7439209726443767,0.0,0.0
6632,1,2632,[272 478 509 208 264],13,5,9859,3.744398025066464,0.0,0.0
6633,1,2633,[272 478 509 208 264],13,5,9864,3.744874715261959,0.0,0.0
6634,1,2634,[272 478 509 208 264],13,5,9869,3.7453510436432635,0.0,0.0
6635,1,2635,[272 478 509 208 264],13,5,9874,3.745827010622155,0.0,0.0
6636,1,2636,[272 478 509 208 264],13,5,9879,3.7463026166097837,0.0,0.0
6637,1,2637,[272 478 509 208 264],13,5,9884,3.746777862016679,0.0,0.0
6638,1,2638,[300 215 201 211 365],7,4,9888,3.746873815839333,0.0,40.0
6639,1,2639,[367 223 300 202 212],234,1,9889,3.745833333333333,20.0,20.0
6640,1,2640,[218 219 299 264 243],13,1,9890,3.744793638773192,0.0,0.0
6641,1,2641,[272 478 509 208 264],13,5,9895,3.7452687358062073,0.0,0.0
6642,1,2642,[272 478 509 208 264],13,5,9900,3.745743473325766,0.0,0.0
6643,1,2643,[272 478 509 208 264],13,5,9905,3.746217851739788,0.0,0.0
6644,1,2644,[272 478 509 208 264],13,5,9910,3.7466918714555764,0.0,0.0
6645,1,2645,[272 478 509 208 264],13,5,9915,3.747165532879819,0.0,0.0
6646,1,2646,[298 236 301 284 268],145,3,9918,3.746883264072535,0.0,0.0
6647,1,2647,[272 478 509 208 264],13,5,9923,3.747356495468278,0.0,0.0
6648,1,2648,[272 478 509 208 264],13,5,9928,3.7478293695734237,0.0,0.0
6649,1,2649,[284 221 216 202 272],537,1,9929,3.7467924528301886,0.0,0.0
6650,1,2650,[275 429 216 211 420],7,5,9934,3.7472651829498305,0.0,40.0
6651,1,2651,[272 478 509 208 264],13,5,9939,3.747737556561086,0.0,0.0
6652,1,2652,[507 299 350 326 212],13,1,9940,3.746701846965699,0.0,0.0
6653,1,2653,[507 478 206 213 215],406,2,9942,3.746043707611153,0.0,0.0
6654,1,2654,[272 478 509 208 264],13,5,9947,3.7465160075329567,0.0,0.0
6655,1,2655,[227 211 290 508 232],13,3,9950,3.746234939759036,0.0,20.0
6656,1,2656,[272 478 509 208 264],13,5,9955,3.746706812194204,0.0,0.0
6657,1,2657,[509 230 243 211 222],13,2,9957,3.7460496613995486,0.0,40.0
6658,1,2658,[272 478 509 208 264],13,5,9962,3.7465212485896955,0.0,0.0
6659,1,2659,[239 280 420 215 298],749,5,9967,3.7469924812030073,0.0,0.0
6660,1,2660,[272 478 509 208 264],13,5,9972,3.7474633596392333,0.0,0.0
6661,1,2661,[272 478 509 208 264],13,5,9977,3.7479338842975207,0.0,0.0
6662,1,2662,[283 208 390 384 429],279,3,9980,3.7476530229064964,0.0,0.0
6663,1,2663,[272 478 509 208 264],13,5,9985,3.748123123123123,0.0,0.0
6664,1,2664,[367 301 239 227 290],13,3,9988,3.747842401500938,0.0,0.0
6665,1,2665,[272 478 509 208 264],13,5,9993,3.748312078019505,0.0,0.0
6666,1,2666,[232 324 208 420 300],7,3,9996,3.748031496062992,0.0,20.0
6667,1,2667,[272 478 509 208 264],13,5,10001,3.748500749625187,0.0,0.0
6668,1,2668,[280 507 367 227 350],13,2,10003,3.7478456350693143,0.0,0.0
6669,1,2669,[272 478 509 208 264],13,5,10008,3.748314606741573,0.0,0.0
6670,1,2670,[272 478 509 208 264],13,5,10013,3.7487832272557093,0.0,0.0
6671,1,2671,[272 478 509 208 264],13,5,10018,3.749251497005988,0.0,0.0
6672,1,2672,[272 478 509 208 264],13,5,10023,3.749719416386083,0.0,0.0
6673,1,2673,[272 478 509 208 264],13,5,10028,3.75018698578908,0.0,0.0
6674,1,2674,[316 212 218 216 429],13,3,10031,3.749906542056075,20.0,0.0
6675,1,2675,[272 481 350 268 344],13,2,10033,3.749252615844544,0.0,0.0
6676,1,2676,[226 509 300 211 303],13,4,10037,3.749346283152783,0.0,40.0
6677,1,2677,[209 284 239 211 429],749,5,10042,3.749813293502614,0.0,20.0
6678,1,2678,[226 219 429 291 211],279,3,10045,3.7495334079880553,0.0,20.0
6679,1,2679,[246 218 298 394 431],145,2,10047,3.7488805970149253,0.0,0.0
6680,1,2680,[272 478 509 208 264],13,5,10052,3.7493472584856398,0.0,0.0
6681,1,2681,[272 478 509 208 264],13,5,10057,3.749813571961223,0.0,0.0
6682,1,2682,[272 478 509 208 264],13,5,10062,3.7502795378307865,0.0,0.0
6683,1,2683,[230 452 241 254 240],774,1,10063,3.7492548435171384,0.0,0.0
6684,1,2684,[316 264 246 299 336],894,2,10065,3.7486033519553073,20.0,0.0
6685,1,2685,[241 208 239 583 227],387,2,10067,3.74795234549516,0.0,0.0
6686,1,2686,[275 276 217 208 211],343,4,10071,3.7480461481205807,0.0,60.0
6687,1,2687,[202 216 241 272 220],378,3,10074,3.747767857142857,0.0,0.0
6688,1,2688,[303 239 222 202 315],13,4,10078,3.7478616586091484,20.0,20.0
6689,1,2689,[230 365 241 231 201],308,3,10081,3.7475836431226766,0.0,0.0
6690,1,2690,[272 478 509 208 264],13,5,10086,3.7480490523968784,0.0,0.0
6691,1,2691,[272 478 509 208 264],13,5,10091,3.74851411589896,0.0,0.0
6692,1,2692,[272 478 509 208 264],13,5,10096,3.748978834014111,0.0,0.0
6693,1,2693,[272 478 509 208 264],13,5,10101,3.749443207126949,0.0,0.0
6694,1,2694,[272 478 509 208 264],13,5,10106,3.7499072356215213,0.0,0.0
6695,1,2695,[272 478 509 208 264],13,5,10111,3.7503709198813056,0.0,0.0
6696,1,2696,[321 365 218 300 272],378,2,10113,3.7497219132369297,0.0,20.0
6697,1,2697,[509 478 201 384 485],13,2,10115,3.7490733876945885,0.0,0.0
6698,1,2698,[272 478 509 208 264],13,5,10120,3.749536865505743,0.0,0.0
6699,1,2699,[275 218 259 276 268],145,1,10121,3.7485185185185186,0.0,40.0
6700,1,2700,[208 226 316 241 272],102,1,10122,3.7475009255831173,20.0,0.0
6701,1,2701,[272 478 509 208 264],13,5,10127,3.747964470762398,0.0,0.0
6702,1,2702,[331 212 223 231 300],13,2,10129,3.7473177950425454,20.0,20.0
6703,1,2703,[272 478 509 208 264],13,5,10134,3.7477810650887573,0.0,0.0
6704,1,2704,[429 261 222 478 384],13,2,10136,3.7471349353049908,0.0,20.0
6705,1,2705,[222 293 246 206 239],387,3,10139,3.746858832224686,0.0,20.0
6706,1,2706,[223 213 231 255 326],334,2,10141,3.746213520502401,20.0,0.0
6707,1,2707,[272 478 509 208 264],13,5,10146,3.7466765140324965,0.0,0.0
6708,1,2708,[216 300 212 509 291],85,1,10147,3.7456626061277225,0.0,20.0
6709,1,2709,[420 243 485 211 331],13,2,10149,3.7450184501845016,0.0,20.0
6710,1,2710,[293 255 326 226 283],548,4,10153,3.745112504610845,0.0,0.0
6711,1,2711,[272 478 509 208 264],13,5,10158,3.745575221238938,0.0,0.0
6712,1,2712,[272 478 509 208 264],13,5,10163,3.7460375967563584,0.0,0.0
6713,1,2713,[290 219 367 344 232],13,1,10164,3.7450257921886516,0.0,0.0
6714,1,2714,[331 303 221 293 275],894,5,10169,3.74548802946593,0.0,20.0
6715,1,2715,[303 293 301 298 250],486,2,10171,3.7448453608247423,0.0,0.0
6716,1,2716,[272 478 509 208 264],13,5,10176,3.745307324254693,0.0,0.0
6717,1,2717,[272 478 509 208 264],13,5,10181,3.745768947755703,0.0,0.0
6718,1,2718,[272 478 509 208 264],13,5,10186,3.7462302317028318,0.0,0.0
6719,1,2719,[509 295 300 254 321],378,2,10188,3.7455882352941177,0.0,20.0
6720,1,2720,[272 478 509 208 264],13,5,10193,3.7460492466005144,0.0,0.0
6721,1,2721,[272 478 509 208 264],13,5,10198,3.746509919177076,0.0,0.0
6722,1,2722,[272 478 509 208 264],13,5,10203,3.7469702533969884,0.0,0.0
6723,1,2723,[226 202 485 231 215],378,2,10205,3.7463289280469896,0.0,0.0
6724,1,2724,[272 478 509 208 264],13,5,10210,3.746788990825688,0.0,0.0
6725,1,2725,[272 478 509 208 264],13,5,10215,3.747248716067498,0.0,0.0
6726,1,2726,[272 478 509 208 264],13,5,10220,3.7477081041437477,0.0,0.0
6727,1,2727,[272 478 509 208 264],13,5,10225,3.74816715542522,0.0,0.0
6728,1,2728,[272 478 509 208 264],13,5,10230,3.7486258702821544,0.0,0.0
6729,1,2729,[392 276 284 290 208],59,2,10232,3.747985347985348,0.0,20.0
6730,1,2730,[276 202 217 431 300],13,2,10234,3.747345294763823,0.0,40.0
6731,1,2731,[254 227 452 230 201],774,1,10235,3.7463396778916547,0.0,0.0
6732,1,2732,[272 478 509 208 264],13,5,10240,3.7467983900475668,0.0,0.0
6733,1,2733,[227 216 209 300 208],334,1,10241,3.7457937088514996,0.0,20.0
6734,1,2734,[272 478 509 208 264],13,5,10246,3.746252285191956,0.0,0.0
6735,1,2735,[272 478 509 208 264],13,5,10251,3.7467105263157894,0.0,0.0
6736,1,2736,[264 583 365 230 254],308,2,10253,3.74607234198027,0.0,0.0
6737,1,2737,[272 478 509 208 264],13,5,10258,3.746530314097882,0.0,0.0
6738,1,2738,[275 509 226 413 481],13,2,10260,3.7458926615553123,0.0,20.0
6739,1,2739,[259 226 211 213 202],537,2,10262,3.745255474452555,0.0,20.0
6740,1,2740,[272 478 509 208 264],13,5,10267,3.745713243341846,0.0,0.0
6741,1,2741,[272 478 509 208 264],13,5,10272,3.74617067833698,0.0,0.0
6742,1,2742,[478 509 230 239 222],488,2,10274,3.7455340867663143,0.0,20.0
6743,1,2743,[272 478 509 208 264],13,5,10279,3.745991253644315,0.0,0.0
6744,1,2744,[299 509 452 420 275],13,2,10281,3.745355191256831,0.0,20.0
6745,1,2745,[420 295 255 392 298],308,4,10285,3.7454479242534595,0.0,0.0
6746,1,2746,[485 298 219 284 215],308,2,10287,3.744812522752093,0.0,0.0
6747,1,2747,[212 241 315 222 291],537,1,10288,3.7438136826783115,20.0,20.0
6748,1,2748,[272 478 509 208 264],13,5,10293,3.7442706438704985,0.0,0.0
6749,1,2749,[299 222 283 315 291],537,2,10295,3.7436363636363637,20.0,20.0
6750,1,2750,[315 268 201 230 209],537,3,10298,3.7433660487095604,20.0,0.0
6751,1,2751,[272 478 509 208 264],13,5,10303,3.7438226744186047,0.0,0.0
6752,1,2752,[211 230 202 507 217],7,3,10306,3.743552488194697,0.0,20.0
6753,1,2753,[272 478 509 208 264],13,5,10311,3.74400871459695,0.0,0.0
6754,1,2754,[272 478 509 208 264],13,5,10316,3.744464609800363,0.0,0.0
6755,1,2755,[272 478 509 208 264],13,5,10321,3.744920174165457,0.0,0.0
6756,1,2756,[272 478 509 208 264],13,5,10326,3.745375408052231,0.0,0.0
6757,1,2757,[272 478 509 208 264],13,5,10331,3.7458303118201597,0.0,0.0
6758,1,2758,[272 478 509 208 264],13,5,10336,3.7462848858281985,0.0,0.0
6759,1,2759,[508 211 485 331 507],13,1,10337,3.7452898550724636,0.0,20.0
6760,1,2760,[485 219 202 452 216],308,1,10338,3.7442955450923576,0.0,0.0
6761,1,2761,[272 478 509 208 264],13,5,10343,3.74475018102824,0.0,0.0
6762,1,2762,[321 431 246 583 232],387,1,10344,3.743756786102063,0.0,0.0
6763,1,2763,[272 478 509 208 264],13,5,10349,3.7442112879884224,0.0,0.0
6764,1,2764,[209 213 509 481 259],90,4,10353,3.7443037974683544,0.0,0.0
6765,1,2765,[485 222 290 509 275],13,2,10355,3.7436731742588574,0.0,40.0
6766,1,2766,[272 478 509 208 264],13,5,10360,3.7441272135887242,0.0,0.0
6767,1,2767,[272 478 509 208 264],13,5,10365,3.7445809248554913,0.0,0.0
6768,1,2768,[272 478 509 208 264],13,5,10370,3.7450343084145903,0.0,0.0
6769,1,2769,[331 222 431 291 218],548,5,10375,3.7454873646209386,0.0,20.0
6770,1,2770,[272 478 509 208 264],13,5,10380,3.7459400938289424,0.0,0.0
6771,1,2771,[272 478 509 208 264],13,5,10385,3.7463924963924966,0.0,0.0
6772,1,2772,[272 295 336 297 331],894,3,10388,3.746123332131266,20.0,0.0
6773,1,2773,[272 478 509 208 264],13,5,10393,3.7465753424657535,0.0,0.0
6774,1,2774,[272 478 509 208 264],13,5,10398,3.747027027027027,0.0,0.0
6775,1,2775,[217 295 367 223 231],92,1,10399,3.746037463976945,20.0,0.0
6776,1,2776,[272 478 509 208 264],13,5,10404,3.746489016924739,0.0,0.0
6777,1,2777,[201 283 298 367 321],308,3,10407,3.74622030237581,0.0,0.0
6778,1,2778,[218 241 321 509 420],311,1,10408,3.7452320978769342,0.0,0.0
6779,1,2779,[272 478 509 208 264],13,5,10413,3.74568345323741,0.0,0.0
6780,1,2780,[272 478 509 208 264],13,5,10418,3.7461344839985617,0.0,0.0
6781,1,2781,[272 478 509 208 264],13,5,10423,3.746585190510424,0.0,0.0
6782,1,2782,[272 478 509 208 264],13,5,10428,3.7470355731225298,0.0,0.0
6783,1,2783,[272 478 509 208 264],13,5,10433,3.747485632183908,0.0,0.0
6784,1,2784,[272 478 509 208 264],13,5,10438,3.747935368043088,0.0,0.0
6785,1,2785,[276 297 208 508 236],343,5,10443,3.7483847810480975,20.0,20.0
6786,1,2786,[208 230 276 316 378],474,3,10446,3.7481162540365984,20.0,20.0
6787,1,2787,[219 217 485 431 420],406,2,10448,3.7474892395982784,0.0,0.0
6788,1,2788,[272 478 509 208 264],13,5,10453,3.747938329150233,0.0,0.0
6789,1,2789,[259 321 216 297 508],6,1,10454,3.746953405017921,20.0,0.0
6790,1,2790,[272 478 509 208 264],13,5,10459,3.7474023647438193,0.0,0.0
6791,1,2791,[315 211 507 212 226],650,2,10461,3.746776504297994,20.0,20.0
6792,1,2792,[280 301 275 321 481],13,1,10462,3.7457930540637308,0.0,20.0
6793,1,2793,[209 264 367 420 507],13,2,10464,3.7451682176091623,0.0,0.0
6794,1,2794,[299 212 481 316 336],13,2,10466,3.7445438282647583,20.0,0.0
6795,1,2795,[272 478 509 208 264],13,5,10471,3.7449928469241773,0.0,0.0
6796,1,2796,[272 478 509 208 264],13,5,10476,3.7454415445119773,0.0,0.0
6797,1,2797,[272 478 509 208 264],13,5,10481,3.745889921372409,0.0,0.0
6798,1,2798,[452 259 231 481 365],308,1,10482,3.744908896034298,0.0,0.0
6799,1,2799,[201 219 241 509 384],7,2,10484,3.744285714285714,0.0,0.0
6800,1,2800,[300 250 231 208 216],85,1,10485,3.7433059621563727,0.0,20.0
6801,1,2801,[367 481 259 293 231],308,3,10488,3.7430406852248392,0.0,0.0
6802,1,2802,[272 478 509 208 264],13,5,10493,3.743489118801284,0.0,0.0
6803,1,2803,[272 478 509 208 264],13,5,10498,3.7439372325249645,0.0,0.0
6804,1,2804,[222 378 227 231 239],311,4,10502,3.744028520499109,0.0,20.0
6805,1,2805,[222 206 208 219 378],843,0,10502,3.742694226657163,0.0,20.0
6806,1,2806,[272 478 509 208 264],13,5,10507,3.743142144638404,0.0,0.0
6807,1,2807,[272 478 509 208 264],13,5,10512,3.7435897435897436,0.0,0.0
6808,1,2808,[280 303 293 315 336],894,3,10515,3.7433250266998934,20.0,0.0
6809,1,2809,[272 478 509 208 264],13,5,10520,3.7437722419928825,0.0,0.0
6810,1,2810,[213 218 241 239 321],308,3,10523,3.743507648523657,0.0,0.0
6811,1,2811,[431 326 300 336 331],13,0,10523,3.742176386913229,0.0,20.0
6812,1,2812,[272 478 509 208 264],13,5,10528,3.7426235335940277,0.0,0.0
6813,1,2813,[272 478 509 208 264],13,5,10533,3.7430703624733477,0.0,0.0
6814,1,2814,[272 478 509 208 264],13,5,10538,3.7435168738898756,0.0,0.0
6815,1,2815,[272 478 509 208 264],13,5,10543,3.7439630681818183,0.0,0.0
6816,1,2816,[378 226 218 478 208],650,2,10545,3.7433439829605963,0.0,0.0
6817,1,2817,[481 232 509 202 201],7,2,10547,3.742725337118524,0.0,0.0
6818,1,2818,[226 215 324 481 431],7,4,10551,3.7428166016317843,0.0,0.0
6819,1,2819,[272 478 509 208 264],13,5,10556,3.743262411347518,0.0,0.0
6820,1,2820,[272 478 509 208 264],13,5,10561,3.7437079049982276,0.0,0.0
6821,1,2821,[272 478 509 208 264],13,5,10566,3.7441530829199148,0.0,0.0
6822,1,2822,[485 223 216 344 208],13,2,10568,3.7435352461919944,20.0,0.0
6823,1,2823,[272 478 509 208 264],13,5,10573,3.7439801699716715,0.0,0.0
6824,1,2824,[378 216 223 508 241],184,4,10577,3.744070796460177,20.0,0.0
6825,1,2825,[272 478 509 208 264],13,5,10582,3.7445152158527955,0.0,0.0
6826,1,2826,[226 259 218 222 420],881,2,10584,3.7438981252210826,0.0,20.0
6827,1,2827,[291 478 280 507 211],234,1,10585,3.742927864214993,0.0,20.0
6828,1,2828,[264 384 231 321 431],13,1,10586,3.741958289148109,0.0,0.0
6829,1,2829,[300 226 429 215 507],7,5,10591,3.7424028268551237,0.0,20.0
6830,1,2830,[272 478 509 208 264],13,5,10596,3.7428470505121867,0.0,0.0
6831,1,2831,[350 300 272 390 299],116,1,10597,3.7418785310734464,0.0,20.0
6832,1,2832,[429 241 250 293 240],774,1,10598,3.7409106953759266,0.0,0.0
6833,1,2833,[272 478 509 208 264],13,5,10603,3.7413549752999296,0.0,0.0
6834,1,2834,[223 509 226 413 321],13,3,10606,3.741093474426808,20.0,0.0
6835,1,2835,[275 478 315 236 290],537,3,10609,3.7408321579689705,20.0,20.0
6836,1,2836,[259 365 254 243 213],804,3,10612,3.7405710257314064,0.0,0.0
6837,1,2837,[217 331 276 268 326],13,2,10614,3.7399577167019027,0.0,20.0
6838,1,2838,[485 507 291 508 232],85,2,10616,3.7393448397323,0.0,0.0
6839,1,2839,[272 478 509 208 264],13,5,10621,3.7397887323943664,0.0,0.0
6840,1,2840,[272 478 509 208 264],13,5,10626,3.7402323125659978,0.0,0.0
6841,1,2841,[272 478 509 208 264],13,5,10631,3.7406755805770584,0.0,0.0
6842,1,2842,[272 478 509 208 264],13,5,10636,3.741118536756947,0.0,0.0
6843,1,2843,[272 478 509 208 264],13,5,10641,3.7415611814345993,0.0,0.0
6844,1,2844,[275 220 211 250 413],648,3,10644,3.741300527240773,0.0,40.0
6845,1,2845,[272 478 509 208 264],13,5,10649,3.741742796907941,0.0,0.0
6846,1,2846,[272 478 509 208 264],13,5,10654,3.742184755883386,0.0,0.0
6847,1,2847,[272 478 509 208 264],13,5,10659,3.742626404494382,0.0,0.0
6848,1,2848,[272 478 509 208 264],13,5,10664,3.7430677430677433,0.0,0.0
6849,1,2849,[272 478 509 208 264],13,5,10669,3.7435087719298243,0.0,0.0
6850,1,2850,[303 272 290 431 215],537,3,10672,3.743247983163802,0.0,0.0
6851,1,2851,[272 478 509 208 264],13,5,10677,3.743688639551192,0.0,0.0
6852,1,2852,[272 478 509 208 264],13,5,10682,3.7441289870311953,0.0,0.0
6853,1,2853,[272 478 509 208 264],13,5,10687,3.7445690259285214,0.0,0.0
6854,1,2854,[429 344 209 201 208],13,2,10689,3.7439579684763573,0.0,0.0
6855,1,2855,[276 219 326 508 211],13,2,10691,3.7433473389355743,0.0,40.0
6856,1,2856,[272 478 509 208 264],13,5,10696,3.743787189359468,0.0,0.0
6857,1,2857,[315 243 431 275 509],13,2,10698,3.743177046885934,20.0,20.0
6858,1,2858,[272 478 509 208 264],13,5,10703,3.7436166491780343,0.0,0.0
6859,1,2859,[272 478 509 208 264],13,5,10708,3.744055944055944,0.0,0.0
6860,1,2860,[272 478 509 208 264],13,5,10713,3.7444949318420133,0.0,0.0
6861,1,2861,[478 227 420 316 211],650,2,10715,3.743885394828791,20.0,20.0
6862,1,2862,[243 239 295 230 206],387,1,10716,3.742926999650716,0.0,0.0
6863,1,2863,[272 478 509 208 264],13,5,10721,3.7433659217877095,0.0,0.0
6864,1,2864,[272 478 509 208 264],13,5,10726,3.743804537521815,0.0,0.0
6865,1,2865,[272 478 509 208 264],13,5,10731,3.744242847173761,0.0,0.0
6866,1,2866,[219 280 367 420 241],13,2,10733,3.743634461109173,0.0,0.0
6867,1,2867,[226 481 485 231 268],7,3,10736,3.7433751743375177,0.0,0.0
6868,1,2868,[350 212 478 243 217],13,2,10738,3.742767514813524,0.0,0.0
6869,1,2869,[219 218 209 202 301],650,0,10738,3.7414634146341466,0.0,0.0
6870,1,2870,[272 478 509 208 264],13,5,10743,3.741901776384535,0.0,0.0
6871,1,2871,[272 478 509 208 264],13,5,10748,3.7423398328690807,0.0,0.0
6872,1,2872,[300 315 378 429 509],537,2,10750,3.7417333797424295,20.0,20.0
6873,1,2873,[272 478 509 208 264],13,5,10755,3.742171189979123,0.0,0.0
6874,1,2874,[326 268 301 208 221],334,3,10758,3.741913043478261,0.0,0.0
6875,1,2875,[303 236 429 507 222],537,2,10760,3.741307371349096,0.0,20.0
6876,1,2876,[272 478 509 208 264],13,5,10765,3.7417448731317346,0.0,0.0
6877,1,2877,[264 272 326 255 280],894,1,10766,3.7407922168172343,0.0,0.0
6878,1,2878,[509 255 420 298 300],378,4,10770,3.7408822507815214,0.0,20.0
6879,1,2879,[429 227 230 212 420],7,2,10772,3.7402777777777776,0.0,0.0
6880,1,2880,[272 478 509 208 264],13,5,10777,3.7407150295036447,0.0,0.0
6881,1,2881,[420 216 413 219 264],13,2,10779,3.7401110340041637,0.0,0.0
6882,1,2882,[259 283 213 507 378],308,1,10780,3.739160596600763,0.0,0.0
6883,1,2883,[202 344 280 218 301],13,2,10782,3.7385575589459084,0.0,0.0
6884,1,2884,[291 219 367 240 220],92,2,10784,3.7379549393414213,0.0,0.0
6885,1,2885,[272 478 509 208 264],13,5,10789,3.7383922383922386,0.0,0.0
6886,1,2886,[272 478 509 208 264],13,5,10794,3.7388292344994802,0.0,0.0
6887,1,2887,[268 316 216 230 298],145,4,10798,3.738919667590028,20.0,0.0
6888,1,2888,[201 268 326 336 243],13,1,10799,3.7379716164762895,0.0,0.0
6889,1,2889,[272 478 509 208 264],13,5,10804,3.73840830449827,0.0,0.0
6890,1,2890,[230 231 226 300 208],506,3,10807,3.738152888273954,0.0,20.0
6891,1,2891,[272 478 509 208 264],13,5,10812,3.7385892116182573,0.0,0.0
6892,1,2892,[272 478 509 208 264],13,5,10817,3.7390252333218115,0.0,0.0
6893,1,2893,[272 478 509 208 264],13,5,10822,3.739460953697305,0.0,0.0
6894,1,2894,[272 478 509 208 264],13,5,10827,3.739896373056995,0.0,0.0
6895,1,2895,[272 478 509 208 264],13,5,10832,3.7403314917127073,0.0,0.0
6896,1,2896,[227 231 299 272 218],13,2,10834,3.7397307559544357,0.0,0.0
6897,1,2897,[206 217 211 250 431],833,1,10835,3.738785369220152,0.0,20.0
6898,1,2898,[222 301 227 478 226],13,3,10838,3.7385305277681957,0.0,20.0
6899,1,2899,[272 478 509 208 264],13,5,10843,3.7389655172413794,0.0,0.0
6900,1,2900,[272 478 509 208 264],13,5,10848,3.7394002068252328,0.0,0.0
6901,1,2901,[324 206 239 243 215],387,2,10850,3.7388008270158513,0.0,0.0
6902,1,2902,[276 250 299 227 222],145,4,10854,3.7388908026179815,0.0,40.0
6903,1,2903,[272 478 509 208 264],13,5,10859,3.7393250688705235,0.0,0.0
6904,1,2904,[264 202 298 226 429],833,2,10861,3.738726333907057,0.0,0.0
6905,1,2905,[272 478 509 208 264],13,5,10866,3.7391603578802477,0.0,0.0
6906,1,2906,[272 478 509 208 264],13,5,10871,3.739594083247334,0.0,0.0
6907,1,2907,[272 478 509 208 264],13,5,10876,3.7400275103163687,0.0,0.0
6908,1,2908,[429 216 276 299 291],537,1,10877,3.7390855964248884,0.0,20.0
6909,1,2909,[272 478 509 208 264],13,5,10882,3.7395189003436426,0.0,0.0
6910,1,2910,[367 209 293 211 283],385,2,10884,3.7389213328753006,0.0,20.0
6911,1,2911,[272 478 509 208 264],13,5,10889,3.7393543956043955,0.0,0.0
6912,1,2912,[241 231 420 452 230],308,3,10892,3.7391005835907998,0.0,0.0
6913,1,2913,[272 478 509 208 264],13,5,10897,3.7395332875772134,0.0,0.0
6914,1,2914,[272 478 509 208 264],13,5,10902,3.739965694682676,0.0,0.0
6915,1,2915,[243 303 331 215 315],13,3,10905,3.7397119341563787,20.0,0.0
6916,1,2916,[392 218 284 509 219],308,4,10909,3.7398011655810763,0.0,0.0
6917,1,2917,[272 478 509 208 264],13,5,10914,3.740233036326251,0.0,0.0
6918,1,2918,[272 478 509 208 264],13,5,10919,3.7406646111682083,0.0,0.0
6919,1,2919,[272 478 509 208 264],13,5,10924,3.741095890410959,0.0,0.0
6920,1,2920,[378 299 315 507 209],537,3,10927,3.740842177336529,20.0,0.0
6921,1,2921,[300 268 275 301 429],537,2,10929,3.740246406570842,0.0,40.0
6922,1,2922,[272 478 509 208 264],13,5,10934,3.7406773862470066,0.0,0.0
6923,1,2923,[272 478 509 208 264],13,5,10939,3.741108071135431,0.0,0.0
6924,1,2924,[384 336 217 485 367],13,0,10939,3.7398290598290598,0.0,0.0
6925,1,2925,[272 478 509 208 264],13,5,10944,3.74025974025974,0.0,0.0
6926,1,2926,[255 290 244 264 221],894,2,10946,3.7396651861974717,0.0,0.0
6927,1,2927,[272 478 509 208 264],13,5,10951,3.7400956284153004,0.0,0.0
6928,1,2928,[241 485 481 508 227],326,1,10952,3.7391601229088427,0.0,0.0
6929,1,2929,[272 478 509 208 264],13,5,10957,3.739590443686007,0.0,0.0
6930,1,2930,[272 478 509 208 264],13,5,10962,3.7400204708290685,0.0,0.0
6931,1,2931,[299 272 223 384 264],13,3,10965,3.739768076398363,20.0,0.0
6932,1,2932,[272 478 509 208 264],13,5,10970,3.740197749744289,0.0,0.0
6933,1,2933,[219 295 215 213 241],308,2,10972,3.739604635310157,0.0,0.0
6934,1,2934,[275 239 321 508 299],537,2,10974,3.7390119250425893,0.0,20.0
6935,1,2935,[272 478 509 208 264],13,5,10979,3.739441416893733,0.0,0.0
6936,1,2936,[272 478 509 208 264],13,5,10984,3.7398706162751107,0.0,0.0
6937,1,2937,[272 478 509 208 264],13,5,10989,3.740299523485364,0.0,0.0
6938,1,2938,[272 478 509 208 264],13,5,10994,3.7407281388227287,0.0,0.0
6939,1,2939,[272 478 509 208 264],13,5,10999,3.741156462585034,0.0,0.0
6940,1,2940,[413 316 331 240 219],145,3,11002,3.740904454267256,20.0,0.0
6941,1,2941,[272 478 509 208 264],13,5,11007,3.7413324269204624,0.0,0.0
6942,1,2942,[272 478 509 208 264],13,5,11012,3.741760108732586,0.0,0.0
6943,1,2943,[272 478 509 208 264],13,5,11017,3.7421875,0.0,0.0
6944,1,2944,[272 478 509 208 264],13,5,11022,3.742614601018676,0.0,0.0
6945,1,2945,[211 321 344 420 276],13,3,11025,3.7423625254582484,0.0,40.0
6946,1,2946,[272 478 509 208 264],13,5,11030,3.7427892772310827,0.0,0.0
6947,1,2947,[222 301 431 420 232],13,1,11031,3.7418588873812753,0.0,20.0
6948,1,2948,[217 243 211 300 215],13,2,11033,3.7412682265174637,0.0,40.0
6949,1,2949,[272 478 509 208 264],13,5,11038,3.741694915254237,0.0,0.0
6950,1,2950,[272 478 509 208 264],13,5,11043,3.7421213148085393,0.0,0.0
6951,1,2951,[303 300 272 221 315],537,3,11046,3.741869918699187,20.0,20.0
6952,1,2952,[272 478 509 208 264],13,5,11051,3.742295970199797,0.0,0.0
6953,1,2953,[243 230 202 508 236],533,4,11055,3.742383209207854,0.0,0.0
6954,1,2954,[291 216 243 211 201],537,1,11056,3.741455160744501,0.0,20.0
6955,1,2955,[259 301 213 481 478],6,3,11059,3.7412043301759135,0.0,0.0
6956,1,2956,[284 217 300 226 508],378,2,11061,3.7406154886709504,0.0,20.0
6957,1,2957,[223 211 485 301 222],13,2,11063,3.740027045300879,20.0,40.0
6958,1,2958,[272 478 509 208 264],13,5,11068,3.7404528556944916,0.0,0.0
6959,1,2959,[213 284 378 222 209],537,2,11070,3.739864864864865,0.0,20.0
6960,1,2960,[272 478 509 208 264],13,5,11075,3.740290442418102,0.0,0.0
6961,1,2961,[272 478 509 208 264],13,5,11080,3.7407157326130993,0.0,0.0
6962,1,2962,[272 478 509 208 264],13,5,11085,3.741140735740803,0.0,0.0
6963,1,2963,[212 276 420 206 452],406,2,11087,3.74055330634278,0.0,20.0
6964,1,2964,[275 326 213 255 324],894,2,11089,3.739966273187184,0.0,20.0
6965,1,2965,[413 202 220 240 212],82,2,11091,3.73937963587323,0.0,0.0
6966,1,2966,[272 478 509 208 264],13,5,11096,3.739804516346478,0.0,0.0
6967,1,2967,[272 478 509 208 264],13,5,11101,3.7402291105121295,0.0,0.0
6968,1,2968,[272 478 509 208 264],13,5,11106,3.7406534186594813,0.0,0.0
6969,1,2969,[201 231 208 413 209],13,1,11107,3.73973063973064,0.0,0.0
6970,1,2970,[231 208 272 226 215],537,2,11109,3.7391450690003367,0.0,0.0
6971,1,2971,[272 478 509 208 264],13,5,11114,3.7395693135935395,0.0,0.0
6972,1,2972,[215 429 367 507 394],13,2,11116,3.7389841910528085,0.0,0.0
6973,1,2973,[272 478 509 208 264],13,5,11121,3.7394082044384667,0.0,0.0
6974,1,2974,[290 316 216 226 211],650,2,11123,3.7388235294117647,20.0,20.0
6975,1,2975,[272 478 509 208 264],13,5,11128,3.739247311827957,0.0,0.0
6976,1,2976,[272 478 509 208 264],13,5,11133,3.7396708095398052,0.0,0.0
6977,1,2977,[321 276 367 217 299],13,1,11134,3.7387508394895903,0.0,20.0
6978,1,2978,[255 298 226 303 230],533,4,11138,3.738838536421618,0.0,0.0
6979,1,2979,[272 478 509 208 264],13,5,11143,3.739261744966443,0.0,0.0
6980,1,2980,[298 250 215 222 219],387,2,11145,3.738678295873868,0.0,20.0
6981,1,2981,[272 478 509 208 264],13,5,11150,3.739101274312542,0.0,0.0
6982,1,2982,[272 478 509 208 264],13,5,11155,3.739523969158565,0.0,0.0
6983,1,2983,[272 478 509 208 264],13,5,11160,3.739946380697051,0.0,0.0
6984,1,2984,[243 315 208 230 202],210,3,11163,3.7396984924623116,20.0,0.0
6985,1,2985,[272 478 509 208 264],13,5,11168,3.7401205626255862,0.0,0.0
6986,1,2986,[272 478 509 208 264],13,5,11173,3.740542350184131,0.0,0.0
6987,1,2987,[241 272 384 211 300],13,2,11175,3.7399598393574296,0.0,40.0
6988,1,2988,[220 254 241 231 275],378,2,11177,3.739377718300435,0.0,20.0
6989,1,2989,[215 230 315 218 202],650,1,11178,3.7384615384615385,20.0,0.0
6990,1,2990,[509 315 507 452 223],650,1,11179,3.7375459712470747,40.0,0.0
6991,1,2991,[272 478 509 208 264],13,5,11184,3.7379679144385025,0.0,0.0
6992,1,2992,[272 478 509 208 264],13,5,11189,3.7383895756765786,0.0,0.0
6993,1,2993,[272 478 509 208 264],13,5,11194,3.738810955243821,0.0,0.0
6994,1,2994,[272 478 509 208 264],13,5,11199,3.7392320534223704,0.0,0.0
6995,1,2995,[272 478 509 208 264],13,5,11204,3.739652870493992,0.0,0.0
6996,1,2996,[226 290 300 378 508],653,1,11205,3.7387387387387387,0.0,20.0
6997,1,2997,[272 478 509 208 264],13,5,11210,3.7391594396264174,0.0,0.0
6998,1,2998,[272 478 509 208 264],13,5,11215,3.739579859953318,0.0,0.0
6999,1,2999,[272 478 509 208 264],13,5,11220,3.74,0.0,0.0
7000,1,3000,[212 303 243 481 219],13,2,11222,3.73942019326891,0.0,0.0
7001,1,3001,[212 284 250 268 272],85,2,11224,3.738840772818121,0.0,0.0
7002,1,3002,[378 236 243 218 478],234,1,11225,3.737928737928738,0.0,0.0
7003,1,3003,[213 300 508 227 250],334,1,11226,3.737017310252996,0.0,20.0
7004,1,3004,[272 478 509 208 264],13,5,11231,3.7374376039933446,0.0,0.0
7005,1,3005,[272 478 509 208 264],13,5,11236,3.7378576180971392,0.0,0.0
7006,1,3006,[216 481 261 321 201],13,0,11236,3.736614566012637,0.0,0.0
7007,1,3007,[272 478 509 208 264],13,5,11241,3.737034574468085,0.0,0.0
7008,1,3008,[211 218 478 217 452],13,2,11243,3.7364572947823196,0.0,20.0
7009,1,3009,[365 254 239 215 222],749,2,11245,3.7358803986710964,0.0,20.0
7010,1,3010,[367 227 303 275 216],13,2,11247,3.735303885752242,0.0,20.0
7011,1,3011,[272 478 509 208 264],13,5,11252,3.735723771580345,0.0,0.0
7012,1,3012,[413 218 299 209 315],13,1,11253,3.7348157982077663,20.0,0.0
7013,1,3013,[275 485 254 241 216],378,4,11257,3.7349037823490376,0.0,20.0
7014,1,3014,[272 478 509 208 264],13,5,11262,3.735323383084577,0.0,0.0
7015,1,3015,[283 298 331 431 284],548,3,11265,3.735079575596817,0.0,0.0
7016,1,3016,[272 478 509 208 264],13,5,11270,3.7354988399071924,0.0,0.0
7017,1,3017,[272 478 509 208 264],13,5,11275,3.7359178263750827,0.0,0.0
7018,1,3018,[272 478 509 208 264],13,5,11280,3.736336535276582,0.0,0.0
7019,1,3019,[211 218 223 384 239],690,2,11282,3.7357615894039733,20.0,20.0
7020,1,3020,[272 478 509 208 264],13,5,11287,3.7361800728235686,0.0,0.0
7021,1,3021,[241 202 321 211 246],387,1,11288,3.7352746525479814,0.0,20.0
7022,1,3022,[208 413 222 240 211],774,0,11288,3.7340390340721137,0.0,40.0
7023,1,3023,[272 478 509 208 264],13,5,11293,3.734457671957672,0.0,0.0
7024,1,3024,[272 478 509 208 264],13,5,11298,3.7348760330578514,0.0,0.0
7025,1,3025,[272 478 509 208 264],13,5,11303,3.735294117647059,0.0,0.0
7026,1,3026,[218 303 215 367 243],13,2,11305,3.734720845721837,0.0,0.0
7027,1,3027,[272 478 509 208 264],13,5,11310,3.7351387054161163,0.0,0.0
7028,1,3028,[272 478 509 208 264],13,5,11315,3.7355562892043577,0.0,0.0
7029,1,3029,[272 478 509 208 264],13,5,11320,3.735973597359736,0.0,0.0
7030,1,3030,[272 478 509 208 264],13,5,11325,3.7363906301550642,0.0,0.0
7031,1,3031,[272 478 509 208 264],13,5,11330,3.7368073878627968,0.0,0.0
7032,1,3032,[326 478 336 201 212],13,2,11332,3.7362347510715463,0.0,0.0
7033,1,3033,[300 208 209 217 223],13,2,11334,3.7356624917600527,20.0,20.0
7034,1,3034,[272 478 509 208 264],13,5,11339,3.7360790774299835,0.0,0.0
7035,1,3035,[211 507 216 392 303],537,3,11342,3.735836627140975,0.0,20.0
7036,1,3036,[272 478 509 208 264],13,5,11347,3.736252881132697,0.0,0.0
7037,1,3037,[367 218 583 485 201],308,4,11351,3.7363396971691905,0.0,0.0
7038,1,3038,[272 478 509 208 264],13,5,11356,3.736755511681474,0.0,0.0
7039,1,3039,[272 478 509 208 264],13,5,11361,3.737171052631579,0.0,0.0
7040,1,3040,[478 485 209 507 208],85,5,11366,3.7375863202893784,0.0,0.0
7041,1,3041,[272 478 509 208 264],13,5,11371,3.738001314924392,0.0,0.0
7042,1,3042,[272 478 509 208 264],13,5,11376,3.7384160368057837,0.0,0.0
7043,1,3043,[240 230 227 212 208],59,3,11379,3.738173455978975,0.0,0.0
7044,1,3044,[276 222 218 223 240],92,4,11383,3.7382594417077177,20.0,40.0
7045,1,3045,[485 291 221 208 232],85,2,11385,3.73768877216021,0.0,0.0
7046,1,3046,[291 255 509 216 259],474,4,11389,3.737774860518543,0.0,0.0
7047,1,3047,[272 478 509 208 264],13,5,11394,3.7381889763779528,0.0,0.0
7048,1,3048,[272 478 509 208 264],13,5,11399,3.738602820596917,0.0,0.0
7049,1,3049,[316 215 350 226 429],13,4,11403,3.738688524590164,20.0,0.0
7050,1,3050,[272 478 509 208 264],13,5,11408,3.7391019337921994,0.0,0.0
7051,1,3051,[272 478 509 208 264],13,5,11413,3.7395150720838792,0.0,0.0
7052,1,3052,[272 478 509 208 264],13,5,11418,3.7399279397314116,0.0,0.0
7053,1,3053,[272 478 509 208 264],13,5,11423,3.740340537000655,0.0,0.0
7054,1,3054,[272 478 509 208 264],13,5,11428,3.7407528641571193,0.0,0.0
7055,1,3055,[272 478 509 208 264],13,5,11433,3.741164921465969,0.0,0.0
7056,1,3056,[272 478 509 208 264],13,5,11438,3.7415767091920182,0.0,0.0
7057,1,3057,[321 208 218 222 223],234,1,11439,3.7406801831262264,20.0,20.0
7058,1,3058,[509 226 208 485 367],650,1,11440,3.7397842432167376,0.0,0.0
7059,1,3059,[284 268 222 508 275],85,1,11441,3.738888888888889,0.0,40.0
7060,1,3060,[429 211 227 243 212],650,2,11443,3.7383208101927474,0.0,20.0
7061,1,3061,[272 478 509 208 264],13,5,11448,3.7387328543435663,0.0,0.0
7062,1,3062,[272 478 509 208 264],13,5,11453,3.7391446294482535,0.0,0.0
7063,1,3063,[509 478 212 222 268],664,3,11456,3.7389033942558747,0.0,20.0
7064,1,3064,[272 478 509 208 264],13,5,11461,3.7393148450244698,0.0,0.0
7065,1,3065,[298 217 239 290 202],158,3,11464,3.7390737116764514,0.0,0.0
7066,1,3066,[208 212 272 241 268],537,3,11467,3.7388327355722204,0.0,0.0
7067,1,3067,[272 478 509 208 264],13,5,11472,3.7392438070404173,0.0,0.0
7068,1,3068,[272 478 509 208 264],13,5,11477,3.7396546106223525,0.0,0.0
7069,1,3069,[272 478 509 208 264],13,5,11482,3.7400651465798047,0.0,0.0
7070,1,3070,[272 478 509 208 264],13,5,11487,3.7404754151742106,0.0,0.0
7071,1,3071,[272 478 509 208 264],13,5,11492,3.7408854166666665,0.0,0.0
7072,1,3072,[378 452 315 209 212],650,0,11492,3.7396680767979174,20.0,0.0
7073,1,3073,[272 478 509 208 264],13,5,11497,3.740078074170462,0.0,0.0
7074,1,3074,[272 478 509 208 264],13,5,11502,3.740487804878049,0.0,0.0
7075,1,3075,[272 478 509 208 264],13,5,11507,3.740897269180754,0.0,0.0
7076,1,3076,[272 478 509 208 264],13,5,11512,3.7413064673383167,0.0,0.0
7077,1,3077,[226 202 211 429 431],653,1,11513,3.740415854450942,0.0,20.0
7078,1,3078,[201 378 222 241 303],537,1,11514,3.7395258200714516,0.0,20.0
7079,1,3079,[272 478 509 208 264],13,5,11519,3.739935064935065,0.0,0.0
7080,1,3080,[272 478 509 208 264],13,5,11524,3.7403440441415126,0.0,0.0
7081,1,3081,[272 478 509 208 264],13,5,11529,3.7407527579493833,0.0,0.0
7082,1,3082,[272 478 509 208 264],13,5,11534,3.7411612066169315,0.0,0.0
7083,1,3083,[272 478 509 208 264],13,5,11539,3.7415693904020753,0.0,0.0
7084,1,3084,[300 239 220 218 290],334,0,11539,3.740356564019449,0.0,20.0
7085,1,3085,[507 226 429 216 321],234,2,11541,3.7397926117952043,0.0,0.0
7086,1,3086,[272 478 509 208 264],13,5,11546,3.7402008422416584,0.0,0.0
7087,1,3087,[300 217 280 215 384],13,2,11548,3.739637305699482,0.0,20.0
7088,1,3088,[478 301 276 300 315],537,3,11551,3.739397863386209,20.0,40.0
7089,1,3089,[272 478 509 208 264],13,5,11556,3.7398058252427187,0.0,0.0
7090,1,3090,[298 226 243 236 276],533,3,11559,3.7395664833387254,0.0,20.0
7091,1,3091,[272 478 509 208 264],13,5,11564,3.739974126778784,0.0,0.0
7092,1,3092,[272 478 509 208 264],13,5,11569,3.740381506627869,0.0,0.0
7093,1,3093,[272 478 509 208 264],13,5,11574,3.7407886231415644,0.0,0.0
7094,1,3094,[420 241 485 316 452],13,2,11576,3.740226171243942,20.0,0.0
7095,1,3095,[213 255 321 241 202],308,4,11580,3.74031007751938,0.0,0.0
7096,1,3096,[478 212 221 290 301],537,1,11581,3.73942525024217,0.0,0.0
7097,1,3097,[272 478 509 208 264],13,5,11586,3.7398321497740477,0.0,0.0
7098,1,3098,[272 478 509 208 264],13,5,11591,3.740238786705389,0.0,0.0
7099,1,3099,[272 478 509 208 264],13,5,11596,3.7406451612903227,0.0,0.0
7100,1,3100,[303 213 336 293 295],894,3,11599,3.740406320541761,0.0,0.0
7101,1,3101,[268 201 583 367 222],387,3,11602,3.740167633784655,0.0,20.0
7102,1,3102,[272 478 509 208 264],13,5,11607,3.7405736384144377,0.0,0.0
7103,1,3103,[222 215 227 291 295],533,4,11611,3.7406572164948453,0.0,20.0
7104,1,3104,[202 226 201 392 378],537,0,11611,3.739452495974235,0.0,0.0
7105,1,3105,[326 227 344 272 223],13,3,11614,3.739214423696072,20.0,0.0
7106,1,3106,[264 300 394 290 507],13,2,11616,3.738654650788542,0.0,20.0
7107,1,3107,[250 293 219 217 201],385,1,11617,3.7377734877734876,0.0,0.0
7108,1,3108,[272 478 509 208 264],13,5,11622,3.7381794789321323,0.0,0.0
7109,1,3109,[272 478 509 208 264],13,5,11627,3.7385852090032152,0.0,0.0
7110,1,3110,[264 212 211 275 452],7,4,11631,3.7386692381870783,0.0,40.0
7111,1,3111,[413 209 254 208 227],279,4,11635,3.7387532133676094,0.0,0.0
7112,1,3112,[230 316 232 481 478],85,2,11637,3.7381946675232895,20.0,0.0
7113,1,3113,[259 291 211 392 221],537,1,11638,3.7373153500321132,0.0,20.0
7114,1,3114,[230 211 227 331 284],328,2,11640,3.736757624398074,0.0,20.0
7115,1,3115,[239 268 378 212 213],537,2,11642,3.7362002567394095,0.0,0.0
7116,1,3116,[241 291 223 250 227],92,3,11645,3.735964068014116,20.0,0.0
7117,1,3117,[220 485 283 254 241],184,2,11647,3.7354073123797304,0.0,0.0
7118,1,3118,[219 212 220 583 208],59,4,11651,3.735492144918243,0.0,0.0
7119,1,3119,[272 478 509 208 264],13,5,11656,3.735897435897436,0.0,0.0
7120,1,3120,[272 478 509 208 264],13,5,11661,3.7363024671579623,0.0,0.0
7121,1,3121,[485 241 272 222 213],537,2,11663,3.735746316463805,0.0,20.0
7122,1,3122,[272 478 509 208 264],13,5,11668,3.7361511367275058,0.0,0.0
7123,1,3123,[272 478 509 208 264],13,5,11673,3.7365556978233037,0.0,0.0
7124,1,3124,[227 209 201 301 280],13,2,11675,3.736,0.0,0.0
7125,1,3125,[272 478 509 208 264],13,5,11680,3.7364043506078053,0.0,0.0
7126,1,3126,[272 478 509 208 264],13,5,11685,3.7368084425967383,0.0,0.0
7127,1,3127,[208 272 243 429 378],650,3,11688,3.7365728900255752,0.0,0.0
7128,1,3128,[272 478 509 208 264],13,5,11693,3.736976669862576,0.0,0.0
7129,1,3129,[272 478 509 208 264],13,5,11698,3.737380191693291,0.0,0.0
7130,1,3130,[272 478 509 208 264],13,5,11703,3.7377834557649314,0.0,0.0
7131,1,3131,[272 478 509 208 264],13,5,11708,3.7381864623243932,0.0,0.0
7132,1,3132,[272 478 509 208 264],13,5,11713,3.7385892116182573,0.0,0.0
7133,1,3133,[272 478 509 208 264],13,5,11718,3.738991703892789,0.0,0.0
7134,1,3134,[272 478 509 208 264],13,5,11723,3.7393939393939393,0.0,0.0
7135,1,3135,[272 478 509 208 264],13,5,11728,3.739795918367347,0.0,0.0
7136,1,3136,[272 478 509 208 264],13,5,11733,3.740197641058336,0.0,0.0
7137,1,3137,[272 478 509 208 264],13,5,11738,3.7405991077119185,0.0,0.0
7138,1,3138,[215 227 315 230 509],311,4,11742,3.7406817457789105,20.0,0.0
7139,1,3139,[272 478 509 208 264],13,5,11747,3.7410828025477705,0.0,0.0
7140,1,3140,[272 478 509 208 264],13,5,11752,3.7414836039477875,0.0,0.0
7141,1,3141,[272 478 509 208 264],13,5,11757,3.741884150222788,0.0,0.0
7142,1,3142,[275 384 215 211 216],271,4,11761,3.741966274260261,0.0,40.0
7143,1,3143,[272 478 509 208 264],13,5,11766,3.7423664122137406,0.0,0.0
7144,1,3144,[272 478 509 208 264],13,5,11771,3.7427662957074723,0.0,0.0
7145,1,3145,[272 478 509 208 264],13,5,11776,3.743165924984107,0.0,0.0
7146,1,3146,[272 478 509 208 264],13,5,11781,3.7435653002859866,0.0,0.0
7147,1,3147,[272 478 509 208 264],13,5,11786,3.743964421855146,0.0,0.0
7148,1,3148,[221 291 231 478 431],537,2,11788,3.7434106065417594,0.0,0.0
7149,1,3149,[303 429 231 290 223],334,3,11791,3.7431746031746034,20.0,0.0
7150,1,3150,[261 384 316 481 452],13,1,11792,3.7423040304665185,20.0,0.0
7151,1,3151,[272 478 509 208 264],13,5,11797,3.7427030456852792,0.0,0.0
7152,1,3152,[272 478 509 208 264],13,5,11802,3.7431018078020935,0.0,0.0
7153,1,3153,[272 478 509 208 264],13,5,11807,3.7435003170577046,0.0,0.0
7154,1,3154,[392 227 431 326 300],64,1,11808,3.7426307448494454,0.0,20.0
7155,1,3155,[272 478 509 208 264],13,5,11813,3.7430291508238276,0.0,0.0
7156,1,3156,[272 478 509 208 264],13,5,11818,3.743427304402914,0.0,0.0
7157,1,3157,[239 485 218 202 213],308,3,11821,3.7431918936035466,0.0,0.0
7158,1,3158,[209 230 326 212 321],664,2,11823,3.742640075973409,0.0,0.0
7159,1,3159,[508 217 209 215 230],13,1,11824,3.741772151898734,0.0,0.0
7160,1,3160,[272 478 509 208 264],13,5,11829,3.7421701993040175,0.0,0.0
7161,1,3161,[272 478 509 208 264],13,5,11834,3.7425679949399115,0.0,0.0
7162,1,3162,[429 299 275 303 509],13,3,11837,3.7423332279481505,0.0,20.0
7163,1,3163,[272 478 509 208 264],13,5,11842,3.742730720606827,0.0,0.0
7164,1,3164,[272 478 509 208 264],13,5,11847,3.743127962085308,0.0,0.0
7165,1,3165,[272 478 509 208 264],13,5,11852,3.7435249526216046,0.0,0.0
7166,1,3166,[303 272 231 239 220],334,2,11854,3.7429744237448688,0.0,0.0
7167,1,3167,[272 478 509 208 264],13,5,11859,3.743371212121212,0.0,0.0
7168,1,3168,[336 298 219 431 429],833,2,11861,3.7428210792047967,0.0,0.0
7169,1,3169,[272 478 509 208 264],13,5,11866,3.743217665615142,0.0,0.0
7170,1,3170,[507 222 223 239 481],194,2,11868,3.742667928098392,20.0,20.0
7171,1,3171,[272 478 509 208 264],13,5,11873,3.743064312736444,0.0,0.0
7172,1,3172,[272 478 509 208 264],13,5,11878,3.7434604475260005,0.0,0.0
7173,1,3173,[295 202 420 232 231],749,4,11882,3.74354127284184,0.0,0.0
7174,1,3174,[272 478 509 208 264],13,5,11887,3.743937007874016,0.0,0.0
7175,1,3175,[272 478 509 208 264],13,5,11892,3.7443324937027707,0.0,0.0
7176,1,3176,[272 478 509 208 264],13,5,11897,3.7447277305634246,0.0,0.0
7177,1,3177,[219 485 227 216 241],59,3,11900,3.7444933920704844,0.0,0.0
7178,1,3178,[202 259 300 223 429],234,1,11901,3.7436300723497955,20.0,20.0
7179,1,3179,[336 350 230 321 275],13,0,11901,3.7424528301886792,0.0,20.0
7180,1,3180,[272 478 509 208 264],13,5,11906,3.7428481609556745,0.0,0.0
7181,1,3181,[272 478 509 208 264],13,5,11911,3.7432432432432434,0.0,0.0
7182,1,3182,[300 219 202 298 301],145,3,11914,3.743009739239711,0.0,20.0
7183,1,3183,[336 315 215 226 344],13,3,11917,3.7427763819095476,20.0,0.0
7184,1,3184,[272 478 509 208 264],13,5,11922,3.743171114599686,0.0,0.0
7185,1,3185,[508 231 485 230 431],537,2,11924,3.7426239799121155,0.0,0.0
7186,1,3186,[239 264 452 478 261],13,3,11927,3.7423909632883587,0.0,0.0
7187,1,3187,[303 284 239 231 301],537,1,11928,3.741530740276035,0.0,0.0
7188,1,3188,[272 478 509 208 264],13,5,11933,3.7419253684540608,0.0,0.0
7189,1,3189,[321 239 208 202 303],537,2,11935,3.7413793103448274,0.0,0.0
7190,1,3190,[272 478 509 208 264],13,5,11940,3.7417737386399246,0.0,0.0
7191,1,3191,[220 213 275 218 478],184,3,11943,3.7415413533834587,0.0,20.0
7192,1,3192,[272 478 509 208 264],13,5,11948,3.7419354838709675,0.0,0.0
7193,1,3193,[272 478 509 208 264],13,5,11953,3.742329367564183,0.0,0.0
7194,1,3194,[276 300 303 268 208],537,4,11957,3.7424100156494524,0.0,40.0
7195,1,3195,[272 478 509 208 264],13,5,11962,3.7428035043804755,0.0,0.0
7196,1,3196,[272 478 509 208 264],13,5,11967,3.743196746950266,0.0,0.0
7197,1,3197,[272 478 509 208 264],13,5,11972,3.7435897435897436,0.0,0.0
7198,1,3198,[272 478 509 208 264],13,5,11977,3.7439824945295404,0.0,0.0
7199,1,3199,[231 303 220 230 315],334,3,11980,3.74375,20.0,0.0
7200,1,3200,[272 478 509 208 264],13,5,11985,3.7441424554826614,0.0,0.0
7201,1,3201,[272 478 509 208 264],13,5,11990,3.7445346658338536,0.0,0.0
7202,1,3202,[218 321 275 300 239],378,2,11992,3.743990009366219,0.0,40.0
7203,1,3203,[259 264 217 326 331],802,3,11995,3.743757802746567,0.0,0.0
7204,1,3204,[485 331 243 226 300],13,1,11996,3.742901716068643,0.0,20.0
7205,1,3205,[295 215 208 226 206],387,1,11997,3.7420461634435433,0.0,0.0
7206,1,3206,[429 367 239 222 272],650,3,12000,3.7418147801683816,0.0,20.0
7207,1,3207,[272 478 509 208 264],13,5,12005,3.742206982543641,0.0,0.0
7208,1,3208,[209 276 221 367 243],234,2,12007,3.741664069803677,0.0,20.0
7209,1,3209,[507 215 509 452 240],406,2,12009,3.7411214953271026,0.0,0.0
7210,1,3210,[272 478 509 208 264],13,5,12014,3.7415135471815635,0.0,0.0
7211,1,3211,[220 217 508 209 241],92,2,12016,3.7409713574097134,0.0,0.0
7212,1,3212,[272 478 509 208 264],13,5,12021,3.7413632119514473,0.0,0.0
7213,1,3213,[272 478 509 208 264],13,5,12026,3.7417548226509023,0.0,0.0
7214,1,3214,[231 283 378 221 218],184,3,12029,3.741524105754277,0.0,0.0
7215,1,3215,[272 478 509 208 264],13,5,12034,3.741915422885572,0.0,0.0
7216,1,3216,[429 227 240 232 230],897,4,12038,3.741995648119366,0.0,0.0
7217,1,3217,[293 295 246 331 264],294,4,12042,3.742075823492853,0.0,0.0
7218,1,3218,[485 202 223 226 230],13,3,12045,3.7418452935694315,20.0,0.0
7219,1,3219,[226 336 231 232 239],13,2,12047,3.741304347826087,0.0,0.0
7220,1,3220,[275 223 280 239 367],378,2,12049,3.7407637379695746,20.0,20.0
7221,1,3221,[280 290 276 300 299],13,3,12052,3.740533829919305,0.0,40.0
7222,1,3222,[272 478 509 208 264],13,5,12057,3.740924604405833,0.0,0.0
7223,1,3223,[452 219 217 211 508],406,3,12060,3.740694789081886,0.0,20.0
7224,1,3224,[280 507 429 509 241],13,3,12063,3.74046511627907,0.0,0.0
7225,1,3225,[272 478 509 208 264],13,5,12068,3.74085554866708,0.0,0.0
7226,1,3226,[272 478 509 208 264],13,5,12073,3.741245739076542,0.0,0.0
7227,1,3227,[272 478 509 208 264],13,5,12078,3.741635687732342,0.0,0.0
7228,1,3228,[331 268 324 272 508],74,3,12081,3.7414060080520284,0.0,0.0
7229,1,3229,[272 478 509 208 264],13,5,12086,3.741795665634675,0.0,0.0
7230,1,3230,[272 478 509 208 264],13,5,12091,3.742185082017951,0.0,0.0
7231,1,3231,[264 215 223 429 276],308,3,12094,3.7419554455445545,20.0,20.0
7232,1,3232,[272 478 509 208 264],13,5,12099,3.74234457160532,0.0,0.0
7233,1,3233,[272 478 509 208 264],13,5,12104,3.7427334570191713,0.0,0.0
7234,1,3234,[272 478 509 208 264],13,5,12109,3.7431221020092735,0.0,0.0
7235,1,3235,[272 478 509 208 264],13,5,12114,3.7435105067985166,0.0,0.0
7236,1,3236,[272 478 509 208 264],13,5,12119,3.743898671609515,0.0,0.0
7237,1,3237,[272 478 509 208 264],13,5,12124,3.7442865966646077,0.0,0.0
7238,1,3238,[217 211 227 367 429],650,2,12126,3.7437480703920962,0.0,20.0
7239,1,3239,[272 478 509 208 264],13,5,12131,3.744135802469136,0.0,0.0
7240,1,3240,[241 251 212 384 239],883,3,12134,3.7439062017895712,20.0,0.0
7241,1,3241,[272 478 509 208 264],13,5,12139,3.744293645897594,0.0,0.0
7242,1,3242,[272 478 509 208 264],13,5,12144,3.74468085106383,0.0,0.0
7243,1,3243,[272 478 509 208 264],13,5,12149,3.745067817509248,0.0,0.0
7244,1,3244,[507 211 272 215 230],766,2,12151,3.7445300462249613,0.0,20.0
7245,1,3245,[508 215 217 239 201],387,2,12153,3.743992606284658,0.0,0.0
7246,1,3246,[272 478 509 208 264],13,5,12158,3.7443794271635356,0.0,0.0
7247,1,3247,[420 384 303 243 239],13,3,12161,3.7441502463054186,0.0,0.0
7248,1,3248,[222 232 226 431 216],650,2,12163,3.7436134195136965,0.0,20.0
7249,1,3249,[272 478 509 208 264],13,5,12168,3.744,0.0,0.0
7250,1,3250,[272 478 509 208 264],13,5,12173,3.7443863426637956,0.0,0.0
7251,1,3251,[241 485 219 216 268],7,3,12176,3.7441574415744157,0.0,0.0
7252,1,3252,[478 326 209 509 230],13,2,12178,3.7436212726713802,0.0,0.0
7253,1,3253,[241 206 431 226 315],537,2,12180,3.743085433312846,20.0,0.0
7254,1,3254,[303 222 367 394 215],13,2,12182,3.7425499231950843,0.0,20.0
7255,1,3255,[215 324 230 241 431],479,2,12184,3.742014742014742,0.0,0.0
7256,1,3256,[272 478 509 208 264],13,5,12189,3.7424009824992326,0.0,0.0
7257,1,3257,[280 300 232 291 485],749,5,12194,3.7427869858809086,0.0,20.0
7258,1,3258,[272 478 509 208 264],13,5,12199,3.74317275237803,0.0,0.0
7259,1,3259,[272 478 509 208 264],13,5,12204,3.743558282208589,0.0,0.0
7260,1,3260,[293 508 378 283 276],533,2,12206,3.743023612388838,0.0,20.0
7261,1,3261,[272 478 509 208 264],13,5,12211,3.743408951563458,0.0,0.0
7262,1,3262,[222 220 275 321 284],378,1,12212,3.7425681887833284,0.0,40.0
7263,1,3263,[272 478 509 208 264],13,5,12217,3.742953431372549,0.0,0.0
7264,1,3264,[272 478 509 208 264],13,5,12222,3.7433384379785606,0.0,0.0
7265,1,3265,[272 478 509 208 264],13,5,12227,3.743723208818126,0.0,0.0
7266,1,3266,[272 478 509 208 264],13,5,12232,3.744107744107744,0.0,0.0
7267,1,3267,[272 478 509 208 264],13,5,12237,3.7444920440636476,0.0,0.0
7268,1,3268,[272 478 509 208 264],13,5,12242,3.744876108901805,0.0,0.0
7269,1,3269,[272 478 509 208 264],13,5,12247,3.7452599388379206,0.0,0.0
7270,1,3270,[231 300 217 272 344],13,1,12248,3.7444206664628554,0.0,20.0
7271,1,3271,[272 478 509 208 264],13,5,12253,3.744804400977995,0.0,0.0
7272,1,3272,[272 478 509 208 264],13,5,12258,3.7451879010082494,0.0,0.0
7273,1,3273,[350 413 485 299 264],13,1,12259,3.744349419670128,0.0,0.0
7274,1,3274,[272 478 509 208 264],13,5,12264,3.744732824427481,0.0,0.0
7275,1,3275,[272 478 509 208 264],13,5,12269,3.745115995115995,0.0,0.0
7276,1,3276,[392 275 259 211 216],537,2,12271,3.7445834604821484,0.0,40.0
7277,1,3277,[261 212 301 232 230],13,1,12272,3.743746186699207,0.0,0.0
7278,1,3278,[272 478 509 208 264],13,5,12277,3.744129307715767,0.0,0.0
7279,1,3279,[321 276 298 272 246],6,1,12278,3.743292682926829,0.0,20.0
7280,1,3280,[217 331 215 218 303],13,2,12280,3.7427613532459616,0.0,0.0
7281,1,3281,[272 478 509 208 264],13,5,12285,3.743144424131627,0.0,0.0
7282,1,3282,[384 394 316 290 485],13,2,12287,3.742613463295766,20.0,0.0
7283,1,3283,[272 478 509 208 264],13,5,12292,3.74299634591961,0.0,0.0
7284,1,3284,[272 478 509 208 264],13,5,12297,3.74337899543379,0.0,0.0
7285,1,3285,[272 478 509 208 264],13,5,12302,3.743761412051126,0.0,0.0
7286,1,3286,[272 478 509 208 264],13,5,12307,3.74414359598418,0.0,0.0
7287,1,3287,[303 344 243 509 272],13,3,12310,3.743917274939173,0.0,0.0
7288,1,3288,[509 218 394 209 300],13,1,12311,3.7430830039525693,0.0,20.0
7289,1,3289,[272 478 509 208 264],13,5,12316,3.743465045592705,0.0,0.0
7290,1,3290,[272 478 509 208 264],13,5,12321,3.7438468550592523,0.0,0.0
7291,1,3291,[272 478 509 208 264],13,5,12326,3.744228432563791,0.0,0.0
7292,1,3292,[272 478 509 208 264],13,5,12331,3.7446097783176433,0.0,0.0
7293,1,3293,[272 478 509 208 264],13,5,12336,3.744990892531876,0.0,0.0
7294,1,3294,[478 508 240 485 276],339,5,12341,3.745371775417299,0.0,20.0
7295,1,3295,[272 478 509 208 264],13,5,12346,3.745752427184466,0.0,0.0
7296,1,3296,[276 201 219 202 227],13,3,12349,3.745526235972096,0.0,20.0
7297,1,3297,[350 316 481 222 315],13,2,12351,3.7449969678593087,40.0,20.0
7298,1,3298,[272 478 509 208 264],13,5,12356,3.745377387086996,0.0,0.0
7299,1,3299,[272 478 509 208 264],13,5,12361,3.7457575757575756,0.0,0.0
7300,1,3300,[272 478 509 208 264],13,5,12366,3.7461375340805816,0.0,0.0
7301,1,3301,[272 478 509 208 264],13,5,12371,3.746517262265294,0.0,0.0
7302,1,3302,[272 478 509 208 264],13,5,12376,3.746896760520739,0.0,0.0
7303,1,3303,[283 326 222 221 293],334,3,12379,3.746670702179177,0.0,20.0
7304,1,3304,[283 255 301 275 290],334,2,12381,3.746142208774584,0.0,20.0
7305,1,3305,[272 478 509 208 264],13,5,12386,3.746521476104053,0.0,0.0
7306,1,3306,[272 478 509 208 264],13,5,12391,3.7469005140610827,0.0,0.0
7307,1,3307,[321 316 315 215 431],13,3,12394,3.746674727932285,40.0,0.0
7308,1,3308,[272 478 509 208 264],13,5,12399,3.7470534904805075,0.0,0.0
7309,1,3309,[272 478 509 208 264],13,5,12404,3.7474320241691843,0.0,0.0
7310,1,3310,[272 478 509 208 264],13,5,12409,3.747810329205678,0.0,0.0
7311,1,3311,[272 478 509 208 264],13,5,12414,3.7481884057971016,0.0,0.0
7312,1,3312,[272 478 509 208 264],13,5,12419,3.748566254150317,0.0,0.0
7313,1,3313,[223 216 222 241 232],13,1,12420,3.747736873868437,20.0,20.0
7314,1,3314,[291 215 239 202 222],200,3,12423,3.7475113122171946,0.0,20.0
7315,1,3315,[208 298 217 209 336],833,2,12425,3.7469843184559712,0.0,0.0
7316,1,3316,[272 478 509 208 264],13,5,12430,3.7473620741634006,0.0,0.0
7317,1,3317,[202 367 222 212 215],13,3,12433,3.7471368294153105,0.0,20.0
7318,1,3318,[291 284 331 264 255],666,2,12435,3.746610424826755,0.0,0.0
7319,1,3319,[255 241 272 218 367],378,3,12438,3.746385542168675,0.0,0.0
7320,1,3320,[272 478 509 208 264],13,5,12443,3.7467630231857876,0.0,0.0
7321,1,3321,[272 478 509 208 264],13,5,12448,3.7471402769416016,0.0,0.0
7322,1,3322,[384 217 267 336 227],833,0,12448,3.7460126391814623,0.0,0.0
7323,1,3323,[272 478 509 208 264],13,5,12453,3.746389891696751,0.0,0.0
7324,1,3324,[272 478 509 208 264],13,5,12458,3.746766917293233,0.0,0.0
7325,1,3325,[299 378 202 485 291],537,0,12458,3.745640408899579,0.0,0.0
7326,1,3326,[272 478 509 208 264],13,5,12463,3.7460174331229337,0.0,0.0
7327,1,3327,[272 478 509 208 264],13,5,12468,3.746394230769231,0.0,0.0
7328,1,3328,[261 420 222 211 212],13,3,12471,3.7461700210273357,0.0,40.0
7329,1,3329,[259 226 275 239 209],537,2,12473,3.7456456456456455,0.0,20.0
7330,1,3330,[211 485 230 227 365],7,3,12476,3.7454217952566795,0.0,20.0
7331,1,3331,[272 478 509 208 264],13,5,12481,3.745798319327731,0.0,0.0
7332,1,3332,[272 478 509 208 264],13,5,12486,3.746174617461746,0.0,0.0
7333,1,3333,[272 478 509 208 264],13,5,12491,3.7465506898620275,0.0,0.0
7334,1,3334,[272 478 509 208 264],13,5,12496,3.746926536731634,0.0,0.0
7335,1,3335,[290 276 315 268 244],334,3,12499,3.746702637889688,20.0,20.0
7336,1,3336,[429 243 261 452 507],13,1,12500,3.7458795325142344,0.0,0.0
7337,1,3337,[272 478 509 208 264],13,5,12505,3.7462552426602755,0.0,0.0
7338,1,3338,[219 208 367 429 283],308,3,12508,3.746031746031746,0.0,0.0
7339,1,3339,[272 478 509 208 264],13,5,12513,3.7464071856287426,0.0,0.0
7340,1,3340,[272 478 509 208 264],13,5,12518,3.7467824004788985,0.0,0.0
7341,1,3341,[213 220 508 227 316],334,2,12520,3.746259724715739,20.0,0.0
7342,1,3342,[227 291 280 276 226],200,4,12524,3.74633562668262,0.0,20.0
7343,1,3343,[272 478 509 208 264],13,5,12529,3.7467105263157894,0.0,0.0
7344,1,3344,[300 236 208 215 222],234,1,12530,3.7458893871449925,0.0,40.0
7345,1,3345,[272 478 509 208 264],13,5,12535,3.746264196054991,0.0,0.0
7346,1,3346,[293 216 301 261 478],6,2,12537,3.7457424559306842,0.0,0.0
7347,1,3347,[509 280 226 478 264],13,5,12542,3.7461170848267624,0.0,0.0
7348,1,3348,[272 478 509 208 264],13,5,12547,3.746491489997014,0.0,0.0
7349,1,3349,[272 478 509 208 264],13,5,12552,3.746865671641791,0.0,0.0
7350,1,3350,[301 284 206 209 236],666,4,12556,3.7469412115786334,0.0,0.0
7351,1,3351,[431 336 280 326 485],13,1,12557,3.7461217183770885,0.0,0.0
7352,1,3352,[413 290 206 213 219],804,2,12559,3.7456009543692215,0.0,0.0
7353,1,3353,[209 218 244 283 293],474,4,12563,3.745676803816339,0.0,0.0
7354,1,3354,[255 227 301 283 218],334,1,12564,3.7448584202682564,0.0,0.0
7355,1,3355,[216 321 212 284 220],59,3,12567,3.744636471990465,0.0,0.0
7356,1,3356,[290 291 272 215 485],537,1,12568,3.7438188859100388,0.0,0.0
7357,1,3357,[272 478 509 208 264],13,5,12573,3.744192972007147,0.0,0.0
7358,1,3358,[227 384 209 420 303],13,3,12576,3.743971420065496,0.0,0.0
7359,1,3359,[272 478 509 208 264],13,5,12581,3.7443452380952382,0.0,0.0
7360,1,3360,[272 478 509 208 264],13,5,12586,3.7447188336804524,0.0,0.0
7361,1,3361,[272 478 509 208 264],13,5,12591,3.7450922070196313,0.0,0.0
7362,1,3362,[272 478 509 208 264],13,5,12596,3.745465358311032,0.0,0.0
7363,1,3363,[272 478 509 208 264],13,5,12601,3.7458382877526755,0.0,0.0
7364,1,3364,[275 452 232 261 276],13,1,12602,3.7450222882615156,0.0,40.0
7365,1,3365,[268 300 236 485 211],537,2,12604,3.744503862150921,0.0,40.0
7366,1,3366,[272 478 509 208 264],13,5,12609,3.744876744876745,0.0,0.0
7367,1,3367,[272 478 509 208 264],13,5,12614,3.745249406175772,0.0,0.0
7368,1,3368,[208 272 283 222 236],334,5,12619,3.7456218462451765,0.0,20.0
7369,1,3369,[272 478 509 208 264],13,5,12624,3.745994065281899,0.0,0.0
7370,1,3370,[272 478 509 208 264],13,5,12629,3.746366063482646,0.0,0.0
7371,1,3371,[507 209 226 508 283],537,4,12633,3.74644128113879,0.0,0.0
7372,1,3372,[291 255 485 230 293],474,4,12637,3.7465164541950786,0.0,0.0
7373,1,3373,[272 478 509 208 264],13,5,12642,3.7468879668049793,0.0,0.0
7374,1,3374,[272 478 509 208 264],13,5,12647,3.747259259259259,0.0,0.0
7375,1,3375,[222 216 230 485 232],194,0,12647,3.746149289099526,0.0,20.0
7376,1,3376,[326 261 508 276 384],13,1,12648,3.745336097127628,0.0,20.0
7377,1,3377,[272 478 509 208 264],13,5,12653,3.745707519242155,0.0,0.0
7378,1,3378,[394 301 316 201 509],13,2,12655,3.7451908848771827,20.0,0.0
7379,1,3379,[213 227 226 215 212],7,2,12657,3.7446745562130177,0.0,0.0
7380,1,3380,[301 298 211 208 264],102,1,12658,3.743862762496303,0.0,20.0
7381,1,3381,[272 478 509 208 264],13,5,12663,3.744234180958013,0.0,0.0
7382,1,3382,[275 223 344 283 213],894,4,12667,3.7443097842151936,20.0,20.0
7383,1,3383,[508 240 276 298 378],533,3,12670,3.7440898345153664,0.0,20.0
7384,1,3384,[202 226 485 365 264],308,1,12671,3.7432791728212704,0.0,0.0
7385,1,3385,[217 326 215 365 254],378,1,12672,3.7424689899586534,0.0,0.0
7386,1,3386,[272 478 509 208 264],13,5,12677,3.7428402716268083,0.0,0.0
7387,1,3387,[272 478 509 208 264],13,5,12682,3.743211334120425,0.0,0.0
7388,1,3388,[272 478 509 208 264],13,5,12687,3.7435821776335203,0.0,0.0
7389,1,3389,[284 321 298 392 276],308,4,12691,3.7436578171091446,0.0,20.0
7390,1,3390,[241 223 243 481 431],234,1,12692,3.7428487171925684,20.0,0.0
7391,1,3391,[239 315 301 508 478],537,3,12695,3.7426297169811322,20.0,0.0
7392,1,3392,[213 243 431 206 478],537,3,12698,3.742410845859122,0.0,0.0
7393,1,3393,[241 507 452 231 216],7,4,12702,3.742486741308191,0.0,0.0
7394,1,3394,[272 478 509 208 264],13,5,12707,3.742857142857143,0.0,0.0
7395,1,3395,[239 208 298 209 218],387,1,12708,3.7420494699646643,0.0,0.0
7396,1,3396,[272 478 509 208 264],13,5,12713,3.74241978216073,0.0,0.0
7397,1,3397,[241 303 226 268 216],537,2,12715,3.741907004120071,0.0,0.0
7398,1,3398,[272 478 509 208 264],13,5,12720,3.7422771403353927,0.0,0.0
7399,1,3399,[268 264 216 208 218],13,3,12723,3.742058823529412,0.0,0.0
7400,1,3400,[272 478 509 208 264],13,5,12728,3.742428697441929,0.0,0.0
7401,1,3401,[272 478 509 208 264],13,5,12733,3.742798353909465,0.0,0.0
7402,1,3402,[231 315 212 336 331],13,2,12735,3.7422862180429033,20.0,0.0
7403,1,3403,[452 218 275 315 284],145,2,12737,3.741774383078731,20.0,20.0
7404,1,3404,[275 384 223 303 239],13,3,12740,3.7415565345080766,20.0,20.0
7405,1,3405,[344 420 268 217 232],13,2,12742,3.741045214327657,0.0,0.0
7406,1,3406,[272 478 509 208 264],13,5,12747,3.741414734370414,0.0,0.0
7407,1,3407,[272 478 509 208 264],13,5,12752,3.7417840375586855,0.0,0.0
7408,1,3408,[272 478 509 208 264],13,5,12757,3.742153124083309,0.0,0.0
7409,1,3409,[272 478 509 208 264],13,5,12762,3.7425219941348975,0.0,0.0
7410,1,3410,[272 478 509 208 264],13,5,12767,3.7428906479038404,0.0,0.0
7411,1,3411,[272 478 509 208 264],13,5,12772,3.7432590855803047,0.0,0.0
7412,1,3412,[507 283 378 315 231],537,3,12775,3.7430413126281863,20.0,0.0
7413,1,3413,[272 478 509 208 264],13,5,12780,3.743409490333919,0.0,0.0
7414,1,3414,[217 452 209 241 231],92,1,12781,3.742606149341142,0.0,0.0
7415,1,3415,[272 478 509 208 264],13,5,12786,3.7429742388758784,0.0,0.0
7416,1,3416,[272 478 509 208 264],13,5,12791,3.743342112964589,0.0,0.0
7417,1,3417,[291 276 202 241 429],234,1,12792,3.7425394967817436,0.0,20.0
7418,1,3418,[272 478 509 208 264],13,5,12797,3.7429072828312373,0.0,0.0
7419,1,3419,[272 478 509 208 264],13,5,12802,3.7432748538011698,0.0,0.0
7420,1,3420,[211 259 212 232 283],85,1,12803,3.7424729611224787,0.0,20.0
7421,1,3421,[241 509 429 452 211],13,3,12806,3.7422559906487436,0.0,20.0
7422,1,3422,[272 478 509 208 264],13,5,12811,3.7426234297399943,0.0,0.0
7423,1,3423,[218 209 284 429 226],234,2,12813,3.7421144859813085,0.0,0.0
7424,1,3424,[321 209 211 367 239],194,1,12814,3.7413138686131386,0.0,20.0
7425,1,3425,[272 478 509 208 264],13,5,12819,3.7416812609457093,0.0,0.0
7426,1,3426,[272 478 509 208 264],13,5,12824,3.7420484388678146,0.0,0.0
7427,1,3427,[478 211 208 283 276],343,5,12829,3.7424154025670946,0.0,40.0
7428,1,3428,[272 478 509 208 264],13,5,12834,3.742782152230971,0.0,0.0
7429,1,3429,[336 226 211 208 264],833,0,12834,3.7416909620991254,0.0,20.0
7430,1,3430,[431 485 208 507 217],650,2,12836,3.741183328475663,0.0,0.0
7431,1,3431,[272 478 509 208 264],13,5,12841,3.7415501165501164,0.0,0.0
7432,1,3432,[272 478 509 208 264],13,5,12846,3.741916690940868,0.0,0.0
7433,1,3433,[508 218 429 300 367],13,1,12847,3.741118229470006,0.0,20.0
7434,1,3434,[478 223 344 303 211],13,4,12851,3.7411935953420667,20.0,20.0
7435,1,3435,[272 478 509 208 264],13,5,12856,3.741559953434226,0.0,0.0
7436,1,3436,[326 367 336 261 420],13,1,12857,3.7407622926971196,0.0,0.0
7437,1,3437,[272 478 509 208 264],13,5,12862,3.741128563118092,0.0,0.0
7438,1,3438,[272 478 509 208 264],13,5,12867,3.7414946205292234,0.0,0.0
7439,1,3439,[272 478 509 208 264],13,5,12872,3.7418604651162792,0.0,0.0
7440,1,3440,[218 201 344 230 431],13,0,12872,3.7407730310956118,0.0,0.0
7441,1,3441,[244 283 429 239 275],334,3,12875,3.740557815223707,0.0,20.0
7442,1,3442,[239 202 209 300 316],13,3,12878,3.7403427243682836,20.0,20.0
7443,1,3443,[583 429 509 216 208],7,4,12882,3.740418118466899,0.0,0.0
7444,1,3444,[272 478 509 208 264],13,5,12887,3.7407837445573295,0.0,0.0
7445,1,3445,[272 478 509 208 264],13,5,12892,3.7411491584445735,0.0,0.0
7446,1,3446,[272 478 509 208 264],13,5,12897,3.741514360313316,0.0,0.0
7447,1,3447,[272 478 509 208 264],13,5,12902,3.741879350348028,0.0,0.0
7448,1,3448,[272 478 509 208 264],13,5,12907,3.742244128732966,0.0,0.0
7449,1,3449,[216 268 413 241 290],13,2,12909,3.7417391304347825,0.0,0.0
7450,1,3450,[272 478 509 208 264],13,5,12914,3.742103738046943,0.0,0.0
7451,1,3451,[272 478 509 208 264],13,5,12919,3.742468134414832,0.0,0.0
7452,1,3452,[272 478 509 208 264],13,5,12924,3.742832319721981,0.0,0.0
7453,1,3453,[272 478 509 208 264],13,5,12929,3.743196294151708,0.0,0.0
7454,1,3454,[226 206 231 284 213],804,3,12932,3.7429811866859626,0.0,0.0
7455,1,3455,[251 231 208 283 429],385,1,12933,3.7421875,20.0,0.0
7456,1,3456,[208 254 223 284 291],308,3,12936,3.7419728087937516,20.0,0.0
7457,1,3457,[208 226 481 378 201],7,4,12940,3.7420474262579524,0.0,0.0
7458,1,3458,[272 478 509 208 264],13,5,12945,3.7424111014744144,0.0,0.0
7459,1,3459,[218 223 481 290 291],234,1,12946,3.7416184971098265,20.0,0.0
7460,1,3460,[272 283 326 255 256],894,1,12947,3.7408263507656745,0.0,0.0
7461,1,3461,[272 478 509 208 264],13,5,12952,3.7411900635470827,0.0,0.0
7462,1,3462,[272 478 509 208 264],13,5,12957,3.7415535662720183,0.0,0.0
7463,1,3463,[236 413 316 331 275],145,1,12958,3.7407621247113165,20.0,20.0
7464,1,3464,[272 478 509 208 264],13,5,12963,3.741125541125541,0.0,0.0
7465,1,3465,[272 478 509 208 264],13,5,12968,3.7414887478361223,0.0,0.0
7466,1,3466,[452 212 326 209 216],13,1,12969,3.7406980098067493,0.0,0.0
7467,1,3467,[230 259 254 226 212],804,4,12973,3.7407727797001153,0.0,0.0
7468,1,3468,[218 431 509 227 215],194,2,12975,3.7402709714615163,0.0,0.0
7469,1,3469,[272 478 509 208 264],13,5,12980,3.7406340057636887,0.0,0.0
7470,1,3470,[272 478 509 208 264],13,5,12985,3.7409968308844714,0.0,0.0
7471,1,3471,[272 478 509 208 264],13,5,12990,3.741359447004608,0.0,0.0
7472,1,3472,[272 478 509 208 264],13,5,12995,3.7417218543046356,0.0,0.0
7473,1,3473,[272 478 509 208 264],13,5,13000,3.742084052964882,0.0,0.0
7474,1,3474,[272 478 509 208 264],13,5,13005,3.742446043165468,0.0,0.0
7475,1,3475,[209 232 246 211 298],387,2,13007,3.741944764096663,0.0,20.0
7476,1,3476,[392 481 429 284 507],271,1,13008,3.741156169111303,0.0,0.0
7477,1,3477,[509 202 431 219 485],406,0,13008,3.7400805060379527,0.0,0.0
7478,1,3478,[226 211 202 300 208],313,4,13012,3.740155217016384,0.0,40.0
7479,1,3479,[350 508 300 272 222],13,1,13013,3.739367816091954,0.0,40.0
7480,1,3480,[272 478 509 208 264],13,5,13018,3.7397299626544096,0.0,0.0
7481,1,3481,[272 478 509 208 264],13,5,13023,3.7400919012062035,0.0,0.0
7482,1,3482,[272 478 509 208 264],13,5,13028,3.7404536319265,0.0,0.0
7483,1,3483,[272 478 509 208 264],13,5,13033,3.7408151549942597,0.0,0.0
7484,1,3484,[272 478 509 208 264],13,5,13038,3.7411764705882353,0.0,0.0
7485,1,3485,[272 478 509 208 264],13,5,13043,3.7415375788869767,0.0,0.0
7486,1,3486,[241 429 216 218 259],234,1,13044,3.740751362202466,0.0,0.0
7487,1,3487,[272 478 509 208 264],13,5,13049,3.741112385321101,0.0,0.0
7488,1,3488,[344 315 227 420 507],13,3,13052,3.7408999713384925,20.0,0.0
7489,1,3489,[230 298 324 217 291],833,1,13053,3.740114613180516,0.0,0.0
7490,1,3490,[272 478 509 208 264],13,5,13058,3.740475508450301,0.0,0.0
7491,1,3491,[272 478 509 208 264],13,5,13063,3.740836197021764,0.0,0.0
7492,1,3492,[378 324 241 227 583],7,2,13065,3.740337818494131,0.0,0.0
7493,1,3493,[272 478 509 208 264],13,5,13070,3.7406983400114484,0.0,0.0
7494,1,3494,[272 478 509 208 264],13,5,13075,3.7410586552217455,0.0,0.0
7495,1,3495,[215 243 326 202 276],13,3,13078,3.740846681922197,0.0,20.0
7496,1,3496,[301 219 268 222 303],13,2,13080,3.7403488704603944,0.0,20.0
7497,1,3497,[222 321 478 283 268],234,0,13080,3.739279588336192,0.0,20.0
7498,1,3498,[275 392 300 365 367],378,2,13082,3.738782509288368,0.0,40.0
7499,1,3499,[301 201 218 231 230],13,0,13082,3.7377142857142855,0.0,0.0
7500,1,3500,[272 478 509 208 264],13,5,13087,3.738074835761211,0.0,0.0
7501,1,3501,[272 478 509 208 264],13,5,13092,3.7384351798972015,0.0,0.0
7502,1,3502,[254 264 276 209 211],308,3,13095,3.7382243791036256,0.0,40.0
7503,1,3503,[293 239 216 211 378],749,5,13100,3.7385844748858448,0.0,20.0
7504,1,3504,[272 478 509 208 264],13,5,13105,3.738944365192582,0.0,0.0
7505,1,3505,[211 201 275 221 243],537,2,13107,3.7384483742156305,0.0,40.0
7506,1,3506,[283 217 230 315 429],334,4,13111,3.7385229540918163,20.0,0.0
7507,1,3507,[272 478 509 208 264],13,5,13116,3.7388825541619157,0.0,0.0
7508,1,3508,[272 478 509 208 264],13,5,13121,3.739241949273297,0.0,0.0
7509,1,3509,[268 290 508 392 230],537,2,13123,3.7387464387464386,0.0,0.0
7510,1,3510,[206 209 219 264 336],833,3,13126,3.7385360296211907,0.0,0.0
7511,1,3511,[431 452 232 331 508],13,0,13126,3.7374715261959,0.0,0.0
7512,1,3512,[219 239 350 231 420],13,2,13128,3.7369769427839454,0.0,0.0
7513,1,3513,[272 478 509 208 264],13,5,13133,3.7373363688104724,0.0,0.0
7514,1,3514,[208 209 481 246 215],643,4,13137,3.737411095305832,0.0,0.0
7515,1,3515,[272 478 509 208 264],13,5,13142,3.7377701934015928,0.0,0.0
7516,1,3516,[218 293 481 298 283],308,4,13146,3.7378447540517485,0.0,0.0
7517,1,3517,[280 336 243 452 272],13,2,13148,3.7373507674815234,0.0,0.0
7518,1,3518,[272 478 509 208 264],13,5,13153,3.737709576584257,0.0,0.0
7519,1,3519,[226 218 485 326 202],13,2,13155,3.737215909090909,0.0,0.0
7520,1,3520,[272 478 509 208 264],13,5,13160,3.737574552683897,0.0,0.0
7521,1,3521,[272 478 509 208 264],13,5,13165,3.737932992617831,0.0,0.0
7522,1,3522,[202 367 336 324 264],833,1,13166,3.7371558330967924,0.0,0.0
7523,1,3523,[272 478 509 208 264],13,5,13171,3.7375141884222476,0.0,0.0
7524,1,3524,[429 219 321 367 208],13,2,13173,3.737021276595745,0.0,0.0
7525,1,3525,[272 478 509 208 264],13,5,13178,3.737379466817924,0.0,0.0
7526,1,3526,[272 478 509 208 264],13,5,13183,3.73773745392685,0.0,0.0
7527,1,3527,[275 209 350 485 508],13,0,13183,3.7366780045351473,0.0,20.0
7528,1,3528,[272 478 509 208 264],13,5,13188,3.7370359875318786,0.0,0.0
7529,1,3529,[507 241 291 230 509],537,2,13190,3.736543909348442,0.0,0.0
7530,1,3530,[272 478 509 208 264],13,5,13195,3.7369017275559333,0.0,0.0
7531,1,3531,[291 429 212 222 239],537,0,13195,3.7358437146092864,0.0,20.0
7532,1,3532,[227 218 212 301 290],524,2,13197,3.7353523917350695,0.0,0.0
7533,1,3533,[272 478 509 208 264],13,5,13202,3.735710243350311,0.0,0.0
7534,1,3534,[301 300 215 230 326],328,2,13204,3.735219236209335,0.0,20.0
7535,1,3535,[431 202 211 208 213],194,2,13206,3.7347285067873304,0.0,20.0
7536,1,3536,[429 315 201 212 202],537,1,13207,3.733955329375177,20.0,0.0
7537,1,3537,[213 429 202 481 431],892,4,13211,3.7340305257207462,0.0,0.0
7538,1,3538,[429 230 583 201 295],387,2,13213,3.733540548177451,0.0,0.0
7539,1,3539,[272 478 509 208 264],13,5,13218,3.733898305084746,0.0,0.0
7540,1,3540,[272 478 509 208 264],13,5,13223,3.7342558599265745,0.0,0.0
7541,1,3541,[272 478 509 208 264],13,5,13228,3.7346132128740823,0.0,0.0
7542,1,3542,[272 478 509 208 264],13,5,13233,3.734970364098222,0.0,0.0
7543,1,3543,[272 478 509 208 264],13,5,13238,3.735327313769752,0.0,0.0
7544,1,3544,[272 478 509 208 264],13,5,13243,3.735684062059238,0.0,0.0
7545,1,3545,[272 478 509 208 264],13,5,13248,3.736040609137056,0.0,0.0
7546,1,3546,[272 478 509 208 264],13,5,13253,3.7363969551733858,0.0,0.0
7547,1,3547,[336 226 231 211 431],13,2,13255,3.7359075535512964,0.0,20.0
7548,1,3548,[272 478 509 208 264],13,5,13260,3.7362637362637363,0.0,0.0
7549,1,3549,[272 478 509 208 264],13,5,13265,3.7366197183098593,0.0,0.0
7550,1,3550,[272 478 509 208 264],13,5,13270,3.7369754998591946,0.0,0.0
7551,1,3551,[272 264 303 202 508],13,4,13274,3.7370495495495497,0.0,0.0
7552,1,3552,[230 344 275 241 232],328,3,13277,3.736842105263158,0.0,20.0
7553,1,3553,[272 478 509 208 264],13,5,13282,3.7371975239167137,0.0,0.0
7554,1,3554,[272 478 509 208 264],13,5,13287,3.7375527426160335,0.0,0.0
7555,1,3555,[508 290 481 413 367],13,1,13288,3.7367829021372327,0.0,0.0
7556,1,3556,[272 478 509 208 264],13,5,13293,3.737138037672196,0.0,0.0
7557,1,3557,[255 208 241 216 217],184,2,13295,3.7366498032602586,0.0,0.0
7558,1,3558,[272 478 509 208 264],13,5,13300,3.737004776622647,0.0,0.0
7559,1,3559,[219 275 276 299 239],13,2,13302,3.736516853932584,0.0,40.0
7560,1,3560,[284 508 275 222 211],533,4,13306,3.736590845268183,0.0,60.0
7561,1,3561,[226 236 429 301 509],537,1,13307,3.735822571588995,0.0,0.0
7562,1,3562,[367 211 507 284 212],59,4,13311,3.735896716250351,0.0,20.0
7563,1,3563,[272 478 509 208 264],13,5,13316,3.73625140291807,0.0,0.0
7564,1,3564,[324 254 298 293 301],294,4,13320,3.7363253856942498,0.0,0.0
7565,1,3565,[272 478 509 208 264],13,5,13325,3.7366797532249016,0.0,0.0
7566,1,3566,[226 290 276 508 303],13,4,13329,3.736753574432296,0.0,20.0
7567,1,3567,[275 276 508 212 283],82,2,13331,3.7362668161434978,0.0,40.0
7568,1,3568,[202 291 240 226 429],833,2,13333,3.735780330624825,0.0,0.0
7569,1,3569,[272 478 509 208 264],13,5,13338,3.7361344537815127,0.0,0.0
7570,1,3570,[272 478 509 208 264],13,5,13343,3.736488378605433,0.0,0.0
7571,1,3571,[272 478 509 208 264],13,5,13348,3.736842105263158,0.0,0.0
7572,1,3572,[272 478 509 208 264],13,5,13353,3.7371956339210746,0.0,0.0
7573,1,3573,[272 478 509 208 264],13,5,13358,3.7375489647453835,0.0,0.0
7574,1,3574,[272 478 509 208 264],13,5,13363,3.737902097902098,0.0,0.0
7575,1,3575,[272 478 509 208 264],13,5,13368,3.738255033557047,0.0,0.0
7576,1,3576,[290 202 227 223 231],447,2,13370,3.7377690802348336,20.0,0.0
7577,1,3577,[272 478 509 208 264],13,5,13375,3.738121855785355,0.0,0.0
7578,1,3578,[272 478 509 208 264],13,5,13380,3.738474434199497,0.0,0.0
7579,1,3579,[272 478 509 208 264],13,5,13385,3.738826815642458,0.0,0.0
7580,1,3580,[208 300 420 264 219],7,4,13389,3.7388997486735547,0.0,20.0
7581,1,3581,[272 478 509 208 264],13,5,13394,3.739251814628699,0.0,0.0
7582,1,3582,[272 478 509 208 264],13,5,13399,3.739603684063634,0.0,0.0
7583,1,3583,[272 478 509 208 264],13,5,13404,3.739955357142857,0.0,0.0
7584,1,3584,[219 239 243 218 209],650,0,13404,3.7389121338912132,0.0,0.0
7585,1,3585,[272 478 509 208 264],13,5,13409,3.7392638036809815,0.0,0.0
7586,1,3586,[272 478 509 208 264],13,5,13414,3.739615277390577,0.0,0.0
7587,1,3587,[272 478 509 208 264],13,5,13419,3.7399665551839463,0.0,0.0
7588,1,3588,[272 478 509 208 264],13,5,13424,3.740317637224854,0.0,0.0
7589,1,3589,[298 509 254 280 231],378,1,13425,3.7395543175487465,0.0,0.0
7590,1,3590,[202 211 227 508 481],13,3,13428,3.7393483709273183,0.0,20.0
7591,1,3591,[272 478 509 208 264],13,5,13433,3.7396993318485525,0.0,0.0
7592,1,3592,[272 478 509 208 264],13,5,13438,3.7400500974116335,0.0,0.0
7593,1,3593,[220 222 231 367 452],92,1,13439,3.739287701725097,0.0,20.0
7594,1,3594,[227 284 201 240 378],833,2,13441,3.738803894297636,0.0,0.0
7595,1,3595,[212 222 226 507 331],13,2,13443,3.738320355951057,0.0,20.0
7596,1,3596,[272 478 509 208 264],13,5,13448,3.7386711148179037,0.0,0.0
7597,1,3597,[272 478 509 208 264],13,5,13453,3.7390216787103947,0.0,0.0
7598,1,3598,[215 211 213 275 232],7,3,13456,3.738816337871631,0.0,40.0
7599,1,3599,[481 220 209 216 300],90,4,13460,3.738888888888889,0.0,20.0
7600,1,3600,[272 478 509 208 264],13,5,13465,3.7392391002499306,0.0,0.0
7601,1,3601,[272 478 509 208 264],13,5,13470,3.7395891171571347,0.0,0.0
7602,1,3602,[272 478 509 208 264],13,5,13475,3.739938939772412,0.0,0.0
7603,1,3603,[272 478 509 208 264],13,5,13480,3.740288568257492,0.0,0.0
7604,1,3604,[211 208 222 485 276],311,3,13483,3.7400832177531207,0.0,60.0
7605,1,3605,[272 478 509 208 264],13,5,13488,3.7404326123128118,0.0,0.0
7606,1,3606,[321 220 254 420 326],378,1,13489,3.739672858331023,0.0,0.0
7607,1,3607,[209 321 241 283 485],308,2,13491,3.739190687361419,0.0,0.0
7608,1,3608,[264 272 209 230 507],13,2,13493,3.738708783596564,0.0,0.0
7609,1,3609,[272 478 509 208 264],13,5,13498,3.7390581717451523,0.0,0.0
7610,1,3610,[272 478 509 208 264],13,5,13503,3.739407366380504,0.0,0.0
7611,1,3611,[216 509 485 231 284],308,2,13505,3.738925802879291,0.0,0.0
7612,1,3612,[291 365 431 378 295],749,3,13508,3.738721284251315,0.0,0.0
7613,1,3613,[272 478 509 208 264],13,5,13513,3.7390702822357498,0.0,0.0
7614,1,3614,[321 208 211 290 429],279,5,13518,3.7394190871369295,0.0,20.0
7615,1,3615,[272 478 509 208 264],13,5,13523,3.739767699115044,0.0,0.0
7616,1,3616,[272 478 509 208 264],13,5,13528,3.740116118330108,0.0,0.0
7617,1,3617,[272 478 509 208 264],13,5,13533,3.740464344941957,0.0,0.0
7618,1,3618,[293 326 315 246 275],894,4,13537,3.7405360596849957,20.0,20.0
7619,1,3619,[272 478 509 208 264],13,5,13542,3.7408839779005523,0.0,0.0
7620,1,3620,[300 202 367 223 284],447,3,13545,3.7406793703396852,20.0,20.0
7621,1,3621,[208 209 336 268 227],13,3,13548,3.740474875759249,0.0,0.0
7622,1,3622,[230 231 276 222 223],374,4,13552,3.7405465084184377,20.0,40.0
7623,1,3623,[272 478 509 208 264],13,5,13557,3.740894039735099,0.0,0.0
7624,1,3624,[213 240 413 211 378],804,4,13561,3.740965517241379,0.0,20.0
7625,1,3625,[202 227 291 429 241],200,4,13565,3.7410369553226697,0.0,0.0
7626,1,3626,[272 478 509 208 264],13,5,13570,3.741384063964709,0.0,0.0
7627,1,3627,[272 478 509 208 264],13,5,13575,3.741730981256891,0.0,0.0
7628,1,3628,[272 478 509 208 264],13,5,13580,3.7420777073573985,0.0,0.0
7629,1,3629,[212 275 280 344 315],13,3,13583,3.7418732782369144,20.0,20.0
7630,1,3630,[272 478 509 208 264],13,5,13588,3.7422197741668963,0.0,0.0
7631,1,3631,[272 478 509 208 264],13,5,13593,3.742566079295154,0.0,0.0
7632,1,3632,[272 478 509 208 264],13,5,13598,3.742912193779246,0.0,0.0
7633,1,3633,[272 478 509 208 264],13,5,13603,3.7432581177765547,0.0,0.0
7634,1,3634,[485 367 259 216 300],7,4,13607,3.743328748280605,0.0,20.0
7635,1,3635,[291 378 508 259 241],85,1,13608,3.742574257425743,0.0,0.0
7636,1,3636,[508 509 301 202 276],13,3,13611,3.742370085235084,0.0,20.0
7637,1,3637,[221 222 216 226 239],158,0,13611,3.7413413963716327,0.0,20.0
7638,1,3638,[272 478 509 208 264],13,5,13616,3.7416872767243747,0.0,0.0
7639,1,3639,[272 478 509 208 264],13,5,13621,3.742032967032967,0.0,0.0
7640,1,3640,[272 478 509 208 264],13,5,13626,3.742378467453996,0.0,0.0
7641,1,3641,[272 478 509 208 264],13,5,13631,3.742723778143877,0.0,0.0
7642,1,3642,[298 272 509 202 209],479,4,13635,3.742794400219599,0.0,0.0
7643,1,3643,[272 478 509 208 264],13,5,13640,3.743139407244786,0.0,0.0
7644,1,3644,[218 420 223 215 209],643,3,13643,3.7429355281207135,20.0,0.0
7645,1,3645,[485 215 254 236 218],385,1,13644,3.742183214481624,0.0,0.0
7646,1,3646,[272 478 509 208 264],13,5,13649,3.742528105292021,0.0,0.0
7647,1,3647,[272 478 509 208 264],13,5,13654,3.7428728070175437,0.0,0.0
7648,1,3648,[272 478 509 208 264],13,5,13659,3.7432173198136476,0.0,0.0
7649,1,3649,[209 301 290 230 226],13,2,13661,3.742739726027397,0.0,0.0
7650,1,3650,[481 241 272 290 239],13,3,13664,3.7425362914270064,0.0,0.0
7651,1,3651,[272 478 509 208 264],13,5,13669,3.742880613362541,0.0,0.0
7652,1,3652,[272 478 509 208 264],13,5,13674,3.743224746783466,0.0,0.0
7653,1,3653,[272 478 509 208 264],13,5,13679,3.743568691844554,0.0,0.0
7654,1,3654,[272 478 509 208 264],13,5,13684,3.7439124487004105,0.0,0.0
7655,1,3655,[230 250 508 217 239],92,3,13687,3.7437089715536107,0.0,0.0
7656,1,3656,[272 478 509 208 264],13,5,13692,3.7440525020508613,0.0,0.0
7657,1,3657,[272 478 509 208 264],13,5,13697,3.744395844723893,0.0,0.0
7658,1,3658,[272 478 509 208 264],13,5,13702,3.7447389997267013,0.0,0.0
7659,1,3659,[367 226 321 246 232],387,0,13702,3.7437158469945353,0.0,0.0
7660,1,3660,[232 378 240 280 429],749,4,13706,3.7437858508604207,0.0,0.0
7661,1,3661,[478 413 315 290 216],13,3,13709,3.7435827416712177,20.0,0.0
7662,1,3662,[272 478 509 208 264],13,5,13714,3.743925743925744,0.0,0.0
7663,1,3663,[241 232 209 217 218],64,1,13715,3.7431768558951966,0.0,0.0
7664,1,3664,[227 208 478 301 315],650,2,13717,3.7427012278308323,20.0,0.0
7665,1,3665,[272 478 509 208 264],13,5,13722,3.7430441898527005,0.0,0.0
7666,1,3666,[272 478 509 208 264],13,5,13727,3.74338696482138,0.0,0.0
7667,1,3667,[507 208 452 367 215],648,1,13728,3.742639040348964,0.0,0.0
7668,1,3668,[272 478 509 208 264],13,5,13733,3.7429817388934317,0.0,0.0
7669,1,3669,[272 478 509 208 264],13,5,13738,3.743324250681199,0.0,0.0
7670,1,3670,[264 239 211 227 394],13,4,13742,3.7433941705257423,0.0,20.0
7671,1,3671,[219 215 452 259 211],308,1,13743,3.7426470588235294,0.0,20.0
7672,1,3672,[272 478 509 208 264],13,5,13748,3.742989381976586,0.0,0.0
7673,1,3673,[272 478 509 208 264],13,5,13753,3.7433315187806206,0.0,0.0
7674,1,3674,[208 216 202 420 509],406,1,13754,3.7425850340136053,0.0,0.0
7675,1,3675,[243 299 222 211 478],488,2,13756,3.7421109902067466,0.0,40.0
7676,1,3676,[272 478 509 208 264],13,5,13761,3.742453086755507,0.0,0.0
7677,1,3677,[272 478 509 208 264],13,5,13766,3.742794997281131,0.0,0.0
7678,1,3678,[272 478 509 208 264],13,5,13771,3.7431367219353087,0.0,0.0
7679,1,3679,[217 485 202 209 243],650,0,13771,3.7421195652173913,0.0,0.0
7680,1,3680,[243 367 261 478 216],13,1,13772,3.741374626460201,0.0,0.0
7681,1,3681,[276 431 301 507 241],537,3,13775,3.7411732753938076,0.0,20.0
7682,1,3682,[272 478 509 208 264],13,5,13780,3.741515069237035,0.0,0.0
7683,1,3683,[272 478 509 208 264],13,5,13785,3.74185667752443,0.0,0.0
7684,1,3684,[218 241 268 272 226],13,3,13788,3.7416553595658075,0.0,0.0
7685,1,3685,[272 478 509 208 264],13,5,13793,3.7419967444384157,0.0,0.0
7686,1,3686,[272 478 509 208 264],13,5,13798,3.7423379441280176,0.0,0.0
7687,1,3687,[272 478 509 208 264],13,5,13803,3.7426789587852496,0.0,0.0
7688,1,3688,[431 219 507 478 223],650,2,13805,3.742206560043372,20.0,0.0
7689,1,3689,[272 478 509 208 264],13,5,13810,3.7425474254742546,0.0,0.0
7690,1,3690,[272 478 509 208 264],13,5,13815,3.7428881062042807,0.0,0.0
7691,1,3691,[272 478 509 208 264],13,5,13820,3.743228602383532,0.0,0.0
7692,1,3692,[272 478 509 208 264],13,5,13825,3.743568914161928,0.0,0.0
7693,1,3693,[272 478 509 208 264],13,5,13830,3.743909041689226,0.0,0.0
7694,1,3694,[452 394 217 300 315],13,1,13831,3.743166441136671,20.0,20.0
7695,1,3695,[272 478 509 208 264],13,5,13836,3.7435064935064934,0.0,0.0
7696,1,3696,[250 485 507 216 211],385,1,13837,3.7427644035704626,0.0,20.0
7697,1,3697,[272 478 509 208 264],13,5,13842,3.7431043807463493,0.0,0.0
7698,1,3698,[216 284 298 211 231],749,5,13847,3.7434441741011084,0.0,20.0
7699,1,3699,[272 478 509 208 264],13,5,13852,3.7437837837837837,0.0,0.0
7700,1,3700,[226 291 239 478 206],537,1,13853,3.7430424209673063,0.0,0.0
7701,1,3701,[272 478 509 208 264],13,5,13858,3.743381955699622,0.0,0.0
7702,1,3702,[212 219 508 316 367],13,2,13860,3.742911153119093,20.0,0.0
7703,1,3703,[272 478 509 208 264],13,5,13865,3.7432505399568035,0.0,0.0
7704,1,3704,[272 478 509 208 264],13,5,13870,3.7435897435897436,0.0,0.0
7705,1,3705,[272 478 509 208 264],13,5,13875,3.743928764166217,0.0,0.0
7706,1,3706,[230 508 227 201 321],13,1,13876,3.74318856217966,0.0,0.0
7707,1,3707,[272 478 509 208 264],13,5,13881,3.7435275080906147,0.0,0.0
7708,1,3708,[272 507 261 452 223],13,2,13883,3.743057427878134,20.0,0.0
7709,1,3709,[331 303 201 290 316],13,3,13886,3.742857142857143,20.0,0.0
7710,1,3710,[272 478 509 208 264],13,5,13891,3.743195904068984,0.0,0.0
7711,1,3711,[272 478 509 208 264],13,5,13896,3.7435344827586206,0.0,0.0
7712,1,3712,[246 276 284 222 301],63,2,13898,3.743064907083221,0.0,40.0
7713,1,3713,[272 478 509 208 264],13,5,13903,3.743403338718363,0.0,0.0
7714,1,3714,[272 478 509 208 264],13,5,13908,3.743741588156124,0.0,0.0
7715,1,3715,[276 315 507 367 201],13,2,13910,3.7432723358449946,20.0,20.0
7716,1,3716,[202 431 420 326 392],64,2,13912,3.742803336023675,0.0,0.0
7717,1,3717,[272 478 509 208 264],13,5,13917,3.7431414739107045,0.0,0.0
7718,1,3718,[208 218 226 301 485],234,1,13918,3.7424038720086044,0.0,0.0
7719,1,3719,[272 478 509 208 264],13,5,13923,3.742741935483871,0.0,0.0
7720,1,3720,[299 211 209 239 344],13,2,13925,3.7422735823703306,0.0,20.0
7721,1,3721,[232 378 231 223 215],7,3,13928,3.7420741536808166,20.0,0.0
7722,1,3722,[211 221 303 241 367],90,5,13933,3.7424120333064734,0.0,20.0
7723,1,3723,[316 336 321 509 227],13,3,13936,3.742212674543502,20.0,0.0
7724,1,3724,[213 508 316 290 300],334,2,13938,3.741744966442953,20.0,20.0
7725,1,3725,[272 478 509 208 264],13,5,13943,3.7420826623725176,0.0,0.0
7726,1,3726,[230 321 280 227 216],13,2,13945,3.7416152401395224,0.0,0.0
7727,1,3727,[316 394 478 209 211],13,3,13948,3.7414163090128754,20.0,20.0
7728,1,3728,[272 478 509 208 264],13,5,13953,3.741753821399839,0.0,0.0
7729,1,3729,[272 478 509 208 264],13,5,13958,3.7420911528150134,0.0,0.0
7730,1,3730,[485 367 321 392 213],308,3,13961,3.741892254087376,0.0,0.0
7731,1,3731,[272 478 509 208 264],13,5,13966,3.742229367631297,0.0,0.0
7732,1,3732,[272 478 509 208 264],13,5,13971,3.74256630056255,0.0,0.0
7733,1,3733,[208 216 212 413 367],804,3,13974,3.7423674343867166,0.0,0.0
7734,1,3734,[272 478 509 208 264],13,5,13979,3.7427041499330658,0.0,0.0
7735,1,3735,[243 218 259 481 216],234,1,13980,3.7419700214132763,0.0,0.0
7736,1,3736,[295 300 326 250 254],548,4,13984,3.742039068771742,0.0,20.0
7737,1,3737,[272 478 509 208 264],13,5,13989,3.7423756019261636,0.0,0.0
7738,1,3738,[220 284 208 509 206],406,0,13989,3.741374699117411,0.0,0.0
7739,1,3739,[272 478 509 208 264],13,5,13994,3.741711229946524,0.0,0.0
7740,1,3740,[272 478 509 208 264],13,5,13999,3.7420475808607323,0.0,0.0
7741,1,3741,[431 315 299 321 261],13,1,14000,3.7413148049171565,20.0,0.0
7742,1,3742,[202 429 481 268 232],7,2,14002,3.740849585893668,0.0,0.0
7743,1,3743,[272 478 509 208 264],13,5,14007,3.7411858974358974,0.0,0.0
7744,1,3744,[272 478 509 208 264],13,5,14012,3.7415220293724967,0.0,0.0
7745,1,3745,[508 212 223 485 211],13,3,14015,3.7413240790176188,20.0,20.0
7746,1,3746,[272 478 509 208 264],13,5,14020,3.7416599946623967,0.0,0.0
7747,1,3747,[202 208 215 211 367],90,2,14022,3.7411953041622197,0.0,20.0
7748,1,3748,[283 216 202 241 254],184,2,14024,3.7407308615630837,0.0,0.0
7749,1,3749,[216 508 259 255 326],474,2,14026,3.740266666666667,0.0,0.0
7750,1,3750,[208 378 392 211 452],308,3,14029,3.7400693148493733,0.0,20.0
7751,1,3751,[481 276 212 303 507],90,5,14034,3.740405117270789,0.0,20.0
7752,1,3752,[507 321 431 280 367],234,2,14036,3.73994138022915,0.0,0.0
7753,1,3753,[272 478 509 208 264],13,5,14041,3.7402770378263184,0.0,0.0
7754,1,3754,[303 232 290 384 211],13,3,14044,3.7400798934753663,0.0,20.0
7755,1,3755,[217 250 226 290 413],648,2,14046,3.7396166134185305,0.0,0.0
7756,1,3756,[485 226 231 218 365],308,1,14047,3.738887410167687,0.0,0.0
7757,1,3757,[218 240 241 290 226],59,3,14050,3.7386907929749866,0.0,0.0
7758,1,3758,[219 350 429 275 420],13,2,14052,3.7382282521947325,0.0,20.0
7759,1,3759,[239 211 230 202 232],653,1,14053,3.7375,0.0,20.0
7760,1,3760,[272 478 509 208 264],13,5,14058,3.737835681999468,0.0,0.0
7761,1,3761,[367 384 508 208 226],833,1,14059,3.7371079213184477,0.0,0.0
7762,1,3762,[223 244 280 212 300],894,4,14063,3.7371777836832316,20.0,20.0
7763,1,3763,[272 478 509 208 264],13,5,14068,3.7375132837407015,0.0,0.0
7764,1,3764,[217 508 227 507 231],13,1,14069,3.7367861885790172,0.0,0.0
7765,1,3765,[272 478 509 208 264],13,5,14074,3.7371216144450345,0.0,0.0
7766,1,3766,[264 209 283 452 219],308,1,14075,3.736395009291213,0.0,0.0
7767,1,3767,[431 219 275 301 226],13,1,14076,3.7356687898089174,0.0,20.0
7768,1,3768,[272 478 509 208 264],13,5,14081,3.7360042451578668,0.0,0.0
7769,1,3769,[272 478 509 208 264],13,5,14086,3.736339522546419,0.0,0.0
7770,1,3770,[300 303 255 243 239],533,2,14088,3.73587907716786,0.0,20.0
7771,1,3771,[272 478 509 208 264],13,5,14093,3.7362142099681868,0.0,0.0
7772,1,3772,[272 478 509 208 264],13,5,14098,3.7365491651205938,0.0,0.0
7773,1,3773,[272 478 509 208 264],13,5,14103,3.736883942766296,0.0,0.0
7774,1,3774,[300 227 202 264 384],7,2,14105,3.7364238410596027,0.0,20.0
7775,1,3775,[429 239 208 509 413],279,4,14109,3.7364936440677967,0.0,0.0
7776,1,3776,[272 478 509 208 264],13,5,14114,3.7368281705056923,0.0,0.0
7777,1,3777,[215 219 384 231 254],648,2,14116,3.73636844891477,0.0,0.0
7778,1,3778,[217 218 290 300 231],334,0,14116,3.735379730087325,0.0,20.0
7779,1,3779,[254 211 367 202 378],308,3,14119,3.7351851851851854,0.0,20.0
7780,1,3780,[272 478 509 208 264],13,5,14124,3.735519703782068,0.0,0.0
7781,1,3781,[392 202 231 216 303],537,1,14125,3.7347964040190376,0.0,0.0
7782,1,3782,[219 290 243 241 218],59,3,14128,3.7346021675918584,0.0,0.0
7783,1,3783,[303 239 316 413 276],13,4,14132,3.7346723044397465,20.0,20.0
7784,1,3784,[215 226 509 315 208],537,3,14135,3.7344782034346102,20.0,0.0
7785,1,3785,[272 478 509 208 264],13,5,14140,3.734812466983624,0.0,0.0
7786,1,3786,[272 478 509 208 264],13,5,14145,3.735146554000528,0.0,0.0
7787,1,3787,[290 509 208 378 508],537,3,14148,3.7349524815205912,0.0,0.0
7788,1,3788,[250 259 251 301 222],63,3,14151,3.7347585114806017,20.0,20.0
7789,1,3789,[272 478 509 208 264],13,5,14156,3.7350923482849603,0.0,0.0
7790,1,3790,[272 478 509 208 264],13,5,14161,3.7354260089686098,0.0,0.0
7791,1,3791,[272 478 509 208 264],13,5,14166,3.7357594936708862,0.0,0.0
7792,1,3792,[583 244 241 216 431],158,3,14169,3.735565515423148,0.0,0.0
7793,1,3793,[272 478 509 208 264],13,5,14174,3.735898787559304,0.0,0.0
7794,1,3794,[272 478 509 208 264],13,5,14179,3.736231884057971,0.0,0.0
7795,1,3795,[508 218 254 231 201],774,0,14179,3.7352476290832457,0.0,0.0
7796,1,3796,[272 478 509 208 264],13,5,14184,3.7355807216223336,0.0,0.0
7797,1,3797,[276 394 227 290 212],13,4,14188,3.7356503422854135,0.0,20.0
7798,1,3798,[272 478 509 208 264],13,5,14193,3.7359831534614374,0.0,0.0
7799,1,3799,[303 485 300 231 272],13,2,14195,3.735526315789474,0.0,20.0
7800,1,3800,[272 226 367 232 227],650,1,14196,3.734806629834254,0.0,0.0
7801,1,3801,[509 298 254 275 202],378,2,14198,3.7343503419253024,0.0,20.0
7802,1,3802,[275 326 295 316 284],894,2,14200,3.733894293978438,20.0,20.0
7803,1,3803,[223 485 293 209 298],308,4,14204,3.7339642481598316,20.0,0.0
7804,1,3804,[226 378 239 315 303],537,2,14206,3.733508541392904,20.0,0.0
7805,1,3805,[201 261 272 367 276],13,2,14208,3.7330530740935366,0.0,20.0
7806,1,3806,[272 478 509 208 264],13,5,14213,3.733385868137641,0.0,0.0
7807,1,3807,[272 478 509 208 264],13,5,14218,3.733718487394958,0.0,0.0
7808,1,3808,[272 478 509 208 264],13,5,14223,3.7340509320031505,0.0,0.0
7809,1,3809,[272 478 509 208 264],13,5,14228,3.7343832020997376,0.0,0.0
7810,1,3810,[272 478 509 208 264],13,5,14233,3.734715297822094,0.0,0.0
7811,1,3811,[223 507 215 239 478],13,4,14237,3.734784889821616,20.0,0.0
7812,1,3812,[272 478 509 208 264],13,5,14242,3.73511670600577,0.0,0.0
7813,1,3813,[272 478 509 208 264],13,5,14247,3.7354483481908756,0.0,0.0
7814,1,3814,[272 478 509 208 264],13,5,14252,3.7357798165137615,0.0,0.0
7815,1,3815,[272 478 509 208 264],13,5,14257,3.736111111111111,0.0,0.0
7816,1,3816,[202 222 300 208 326],749,4,14261,3.7361802462667018,0.0,40.0
7817,1,3817,[232 209 230 508 226],59,4,14265,3.7362493452069145,0.0,0.0
7818,1,3818,[299 326 222 429 243],13,1,14266,3.7355328620057606,0.0,20.0
7819,1,3819,[272 478 509 208 264],13,5,14271,3.73586387434555,0.0,0.0
7820,1,3820,[272 478 509 208 264],13,5,14276,3.736194713425805,0.0,0.0
7821,1,3821,[315 231 272 202 481],13,3,14279,3.7360020931449505,20.0,0.0
7822,1,3822,[481 321 413 485 478],13,1,14280,3.7352864242741304,0.0,0.0
7823,1,3823,[272 478 509 208 264],13,5,14285,3.7356171548117154,0.0,0.0
7824,1,3824,[431 284 291 298 295],548,4,14289,3.735686274509804,0.0,0.0
7825,1,3825,[272 478 509 208 264],13,5,14294,3.7360167276529013,0.0,0.0
7826,1,3826,[272 478 509 208 264],13,5,14299,3.73634700810034,0.0,0.0
7827,1,3827,[300 485 215 222 201],537,0,14299,3.7353709508881923,0.0,40.0
7828,1,3828,[481 583 230 284 208],308,5,14304,3.7357012274745363,0.0,0.0
7829,1,3829,[272 478 509 208 264],13,5,14309,3.7360313315926894,0.0,0.0
7830,1,3830,[290 452 326 299 202],13,2,14311,3.735578178021404,0.0,0.0
7831,1,3831,[290 226 326 316 485],13,3,14314,3.7353862212943634,20.0,0.0
7832,1,3832,[272 478 509 208 264],13,5,14319,3.7357161492303677,0.0,0.0
7833,1,3833,[272 478 509 208 264],13,5,14324,3.7360459050599895,0.0,0.0
7834,1,3834,[272 478 509 208 264],13,5,14329,3.736375488917862,0.0,0.0
7835,1,3835,[217 321 508 227 431],13,1,14330,3.735662148070907,0.0,0.0
7836,1,3836,[276 217 208 367 283],343,4,14334,3.7357310398749024,0.0,20.0
7837,1,3837,[255 336 290 324 212],894,1,14335,3.735018238665972,0.0,0.0
7838,1,3838,[212 275 452 222 478],406,1,14336,3.7343058088043763,0.0,40.0
7839,1,3839,[509 344 227 331 485],13,2,14338,3.7338541666666667,0.0,0.0
7840,1,3840,[272 478 509 208 264],13,5,14343,3.7341838063004427,0.0,0.0
7841,1,3841,[272 478 509 208 264],13,5,14348,3.734513274336283,0.0,0.0
7842,1,3842,[272 478 509 208 264],13,5,14353,3.7348425709081448,0.0,0.0
7843,1,3843,[201 509 508 239 485],13,2,14355,3.7343912591050987,0.0,0.0
7844,1,3844,[275 227 326 272 226],328,3,14358,3.7342002600780235,0.0,20.0
7845,1,3845,[272 478 509 208 264],13,5,14363,3.734529381175247,0.0,0.0
7846,1,3846,[350 478 300 321 452],13,1,14364,3.733818559916818,0.0,20.0
7847,1,3847,[508 222 244 276 324],486,3,14367,3.733627858627859,0.0,40.0
7848,1,3848,[212 507 301 215 202],234,1,14368,3.7329176409457,0.0,0.0
7849,1,3849,[272 478 509 208 264],13,5,14373,3.7332467532467533,0.0,0.0
7850,1,3850,[272 478 509 208 264],13,5,14378,3.733575694624773,0.0,0.0
7851,1,3851,[300 378 283 215 230],533,4,14382,3.7336448598130842,0.0,20.0
7852,1,3852,[485 243 222 209 208],537,2,14384,3.7331949130547626,0.0,20.0
7853,1,3853,[272 478 509 208 264],13,5,14389,3.733523611831863,0.0,0.0
7854,1,3854,[231 223 232 507 420],7,3,14392,3.7333333333333334,20.0,0.0
7855,1,3855,[272 478 509 208 264],13,5,14397,3.733661825726141,0.0,0.0
7856,1,3856,[230 202 394 216 276],13,2,14399,3.733212341197822,0.0,20.0
7857,1,3857,[272 478 509 208 264],13,5,14404,3.7335406946604457,0.0,0.0
7858,1,3858,[272 478 509 208 264],13,5,14409,3.7338688779476548,0.0,0.0
7859,1,3859,[202 315 208 331 344],13,3,14412,3.733678756476684,20.0,0.0
7860,1,3860,[272 478 509 208 264],13,5,14417,3.734006734006734,0.0,0.0
7861,1,3861,[481 429 336 301 230],13,1,14418,3.733298808907302,0.0,0.0
7862,1,3862,[272 478 509 208 264],13,5,14423,3.733626714988351,0.0,0.0
7863,1,3863,[236 250 272 316 221],334,4,14427,3.733695652173913,20.0,0.0
7864,1,3864,[272 478 509 208 264],13,5,14432,3.7340232858990943,0.0,0.0
7865,1,3865,[236 213 223 211 222],666,3,14435,3.7338334195550957,20.0,40.0
7866,1,3866,[239 232 290 485 202],897,2,14437,3.7333850530126713,0.0,0.0
7867,1,3867,[211 508 384 243 230],13,1,14438,3.732678386763185,0.0,20.0
7868,1,3868,[299 284 239 259 221],537,0,14438,3.731713621090721,0.0,0.0
7869,1,3869,[219 209 264 478 239],13,3,14441,3.7315245478036174,0.0,0.0
7870,1,3870,[509 331 303 209 315],13,3,14444,3.731335572203565,20.0,0.0
7871,1,3871,[272 478 509 208 264],13,5,14449,3.731663223140496,0.0,0.0
7872,1,3872,[272 478 509 208 264],13,5,14454,3.731990704879938,0.0,0.0
7873,1,3873,[272 478 509 208 264],13,5,14459,3.7323180175529167,0.0,0.0
7874,1,3874,[272 478 509 208 264],13,5,14464,3.7326451612903226,0.0,0.0
7875,1,3875,[272 478 509 208 264],13,5,14469,3.73297213622291,0.0,0.0
7876,1,3876,[272 478 509 208 264],13,5,14474,3.7332989424813,0.0,0.0
7877,1,3877,[209 250 413 206 290],804,3,14477,3.73310985043837,0.0,0.0
7878,1,3878,[508 230 215 216 272],378,4,14481,3.7331786542923435,0.0,0.0
7879,1,3879,[243 201 241 218 268],92,2,14483,3.7327319587628867,0.0,0.0
7880,1,3880,[272 478 509 208 264],13,5,14488,3.7330584900798764,0.0,0.0
7881,1,3881,[297 508 298 202 230],533,5,14493,3.7333848531684697,20.0,0.0
7882,1,3882,[272 478 509 208 264],13,5,14498,3.73371104815864,0.0,0.0
7883,1,3883,[272 478 509 208 264],13,5,14503,3.7340370751802268,0.0,0.0
7884,1,3884,[223 268 276 201 232],13,3,14506,3.733848133848134,20.0,20.0
7885,1,3885,[378 392 212 299 321],537,0,14506,3.732887287699434,0.0,0.0
7886,1,3886,[272 478 509 208 264],13,5,14511,3.733213275019295,0.0,0.0
7887,1,3887,[212 478 221 290 300],537,1,14512,3.7325102880658436,0.0,20.0
7888,1,3888,[272 478 509 208 264],13,5,14517,3.732836204679866,0.0,0.0
7889,1,3889,[295 378 211 280 485],749,4,14521,3.732904884318766,0.0,20.0
7890,1,3890,[272 478 509 208 264],13,5,14526,3.733230531996916,0.0,0.0
7891,1,3891,[272 478 509 208 264],13,5,14531,3.7335560123329907,0.0,0.0
7892,1,3892,[241 264 211 300 226],13,3,14534,3.7333675828409967,0.0,40.0
7893,1,3893,[272 478 509 208 264],13,5,14539,3.7336928608115048,0.0,0.0
7894,1,3894,[272 478 509 208 264],13,5,14544,3.734017971758665,0.0,0.0
7895,1,3895,[272 478 509 208 264],13,5,14549,3.734342915811088,0.0,0.0
7896,1,3896,[272 478 509 208 264],13,5,14554,3.734667693097254,0.0,0.0
7897,1,3897,[272 478 509 208 264],13,5,14559,3.7349923037455106,0.0,0.0
7898,1,3898,[431 216 272 218 300],328,3,14562,3.7348037958450884,0.0,20.0
7899,1,3899,[272 478 509 208 264],13,5,14567,3.735128205128205,0.0,0.0
7900,1,3900,[384 227 272 241 481],13,2,14569,3.7346834145091004,0.0,0.0
7901,1,3901,[272 478 509 208 264],13,5,14574,3.735007688364941,0.0,0.0
7902,1,3902,[272 478 509 208 264],13,5,14579,3.735331796054317,0.0,0.0
7903,1,3903,[239 255 508 218 216],378,3,14582,3.7351434426229506,0.0,0.0
7904,1,3904,[209 212 485 481 290],524,3,14585,3.734955185659411,0.0,0.0
7905,1,3905,[272 478 509 208 264],13,5,14590,3.735279057859703,0.0,0.0
7906,1,3906,[272 478 509 208 264],13,5,14595,3.7356027642692604,0.0,0.0
7907,1,3907,[478 219 290 243 321],13,2,14597,3.7351586489252813,0.0,0.0
7908,1,3908,[231 509 230 201 264],308,3,14600,3.7349705807111793,0.0,0.0
7909,1,3909,[272 478 509 208 264],13,5,14605,3.735294117647059,0.0,0.0
7910,1,3910,[241 378 215 202 208],7,4,14609,3.735361800051138,0.0,0.0
7911,1,3911,[219 202 201 413 431],279,4,14613,3.7354294478527605,0.0,0.0
7912,1,3912,[272 478 509 208 264],13,5,14618,3.7357526194735495,0.0,0.0
7913,1,3913,[272 478 509 208 264],13,5,14623,3.736075625958099,0.0,0.0
7914,1,3914,[272 478 509 208 264],13,5,14628,3.73639846743295,0.0,0.0
7915,1,3915,[272 478 509 208 264],13,5,14633,3.7367211440245147,0.0,0.0
7916,1,3916,[272 478 509 208 264],13,5,14638,3.737043655859076,0.0,0.0
7917,1,3917,[272 478 509 208 264],13,5,14643,3.737366003062787,0.0,0.0
7918,1,3918,[272 478 509 208 264],13,5,14648,3.737688185761674,0.0,0.0
7919,1,3919,[299 219 452 227 272],13,2,14650,3.7372448979591835,0.0,0.0
7920,1,3920,[272 478 509 208 264],13,5,14655,3.737566947207345,0.0,0.0
7921,1,3921,[221 211 239 321 290],524,2,14657,3.7371239163691996,0.0,20.0
7922,1,3922,[272 478 509 208 264],13,5,14662,3.737445832271221,0.0,0.0
7923,1,3923,[213 208 431 284 300],537,3,14665,3.7372579001019366,0.0,20.0
7924,1,3924,[272 478 509 208 264],13,5,14670,3.737579617834395,0.0,0.0
7925,1,3925,[272 478 509 208 264],13,5,14675,3.737901171676006,0.0,0.0
7926,1,3926,[276 202 420 280 264],13,5,14680,3.7382225617519733,0.0,20.0
7927,1,3927,[272 478 509 208 264],13,5,14685,3.7385437881873727,0.0,0.0
7928,1,3928,[272 478 509 208 264],13,5,14690,3.738864851107152,0.0,0.0
7929,1,3929,[212 481 227 226 583],524,3,14693,3.738676844783715,0.0,0.0
7930,1,3930,[272 478 509 208 264],13,5,14698,3.7389977105062324,0.0,0.0
7931,1,3931,[272 478 509 208 264],13,5,14703,3.7393184130213633,0.0,0.0
7932,1,3932,[272 478 509 208 264],13,5,14708,3.7396389524535976,0.0,0.0
7933,1,3933,[272 478 509 208 264],13,5,14713,3.7399593289273003,0.0,0.0
7934,1,3934,[216 507 508 303 241],537,3,14716,3.7397712833545107,0.0,0.0
7935,1,3935,[219 226 227 246 284],92,2,14718,3.739329268292683,0.0,0.0
7936,1,3936,[272 478 509 208 264],13,5,14723,3.7396494792989587,0.0,0.0
7937,1,3937,[209 367 507 295 481],308,3,14726,3.739461655662773,0.0,0.0
7938,1,3938,[394 485 507 384 299],13,0,14726,3.7385123127697386,0.0,0.0
7939,1,3939,[321 239 215 222 303],13,3,14729,3.7383248730964467,0.0,20.0
7940,1,3940,[272 478 509 208 264],13,5,14734,3.738645013955849,0.0,0.0
7941,1,3941,[272 478 509 208 264],13,5,14739,3.7389649923896497,0.0,0.0
7942,1,3942,[272 478 509 208 264],13,5,14744,3.7392848085214303,0.0,0.0
7943,1,3943,[272 478 509 208 264],13,5,14749,3.739604462474645,0.0,0.0
7944,1,3944,[452 218 299 227 508],13,1,14750,3.738910012674271,0.0,0.0
7945,1,3945,[272 478 509 208 264],13,5,14755,3.739229599594526,0.0,0.0
7946,1,3946,[276 239 219 420 201],13,3,14758,3.7390423106156576,0.0,20.0
7947,1,3947,[367 211 217 209 429],64,4,14762,3.7391084093211755,0.0,20.0
7948,1,3948,[272 478 509 208 264],13,5,14767,3.739427703216004,0.0,0.0
7949,1,3949,[230 276 298 240 299],145,3,14770,3.739240506329114,0.0,20.0
7950,1,3950,[272 478 509 208 264],13,5,14775,3.7395596051632496,0.0,0.0
7951,1,3951,[316 431 218 250 219],145,4,14779,3.7396255060728745,20.0,0.0
7952,1,3952,[272 478 509 208 264],13,5,14784,3.7399443460662787,0.0,0.0
7953,1,3953,[272 478 509 208 264],13,5,14789,3.740263024785028,0.0,0.0
7954,1,3954,[272 478 509 208 264],13,5,14794,3.7405815423514537,0.0,0.0
7955,1,3955,[272 478 509 208 264],13,5,14799,3.7408998988877653,0.0,0.0
7956,1,3956,[272 478 509 208 264],13,5,14804,3.7412180945160474,0.0,0.0
7957,1,3957,[272 478 509 208 264],13,5,14809,3.741536129358262,0.0,0.0
7958,1,3958,[272 478 509 208 264],13,5,14814,3.7418540035362464,0.0,0.0
7959,1,3959,[316 217 321 201 222],13,1,14815,3.7411616161616164,20.0,20.0
7960,1,3960,[272 478 509 208 264],13,5,14820,3.741479424387781,0.0,0.0
7961,1,3961,[272 478 509 208 264],13,5,14825,3.741797072185765,0.0,0.0
7962,1,3962,[272 478 509 208 264],13,5,14830,3.7421145596770122,0.0,0.0
7963,1,3963,[272 478 509 208 264],13,5,14835,3.7424318869828457,0.0,0.0
7964,1,3964,[272 478 509 208 264],13,5,14840,3.742749054224464,0.0,0.0
7965,1,3965,[227 239 478 367 508],326,0,14840,3.741805345436208,0.0,0.0
7966,1,3966,[261 209 216 298 221],6,3,14843,3.741618351399042,0.0,0.0
7967,1,3967,[272 478 509 208 264],13,5,14848,3.7419354838709675,0.0,0.0
7968,1,3968,[272 478 509 208 264],13,5,14853,3.742252456538171,0.0,0.0
7969,1,3969,[272 478 509 208 264],13,5,14858,3.7425692695214106,0.0,0.0
7970,1,3970,[272 478 509 208 264],13,5,14863,3.7428859229413245,0.0,0.0
7971,1,3971,[272 478 509 208 264],13,5,14868,3.743202416918429,0.0,0.0
7972,1,3972,[284 219 507 215 509],194,1,14869,3.742511955700982,0.0,0.0
7973,1,3973,[272 478 509 208 264],13,5,14874,3.742828384499245,0.0,0.0
7974,1,3974,[215 216 213 218 239],804,4,14878,3.7428930817610064,0.0,0.0
7975,1,3975,[272 478 509 208 264],13,5,14883,3.7432092555331993,0.0,0.0
7976,1,3976,[431 216 223 243 316],650,1,14884,3.7425194870505405,40.0,0.0
7977,1,3977,[509 219 290 413 394],13,2,14886,3.742081447963801,0.0,0.0
7978,1,3978,[272 478 509 208 264],13,5,14891,3.742397587333501,0.0,0.0
7979,1,3979,[272 478 509 208 264],13,5,14896,3.742713567839196,0.0,0.0
7980,1,3980,[272 508 295 255 290],894,1,14897,3.7420246169304194,0.0,0.0
7981,1,3981,[367 211 240 431 384],279,4,14901,3.742089402310397,0.0,20.0
7982,1,3982,[272 478 509 208 264],13,5,14906,3.742405222194326,0.0,0.0
7983,1,3983,[272 478 509 208 264],13,5,14911,3.7427208835341363,0.0,0.0
7984,1,3984,[272 478 509 208 264],13,5,14916,3.7430363864491842,0.0,0.0
7985,1,3985,[316 275 219 261 272],13,2,14918,3.742599096838936,20.0,20.0
7986,1,3986,[232 429 431 275 218],13,1,14919,3.741911211437171,0.0,20.0
7987,1,3987,[209 315 300 232 367],13,1,14920,3.741223671013039,20.0,20.0
7988,1,3988,[431 478 509 272 275],537,5,14925,3.7415392328904487,0.0,20.0
7989,1,3989,[241 301 275 216 230],85,1,14926,3.7408521303258144,0.0,20.0
7990,1,3990,[272 478 509 208 264],13,5,14931,3.7411676271611123,0.0,0.0
7991,1,3991,[215 212 218 211 485],59,4,14935,3.7412324649298596,0.0,20.0
7992,1,3992,[272 478 509 208 264],13,5,14940,3.741547708489857,0.0,0.0
7993,1,3993,[272 478 509 208 264],13,5,14945,3.7418627941912868,0.0,0.0
7994,1,3994,[272 478 509 208 264],13,5,14950,3.742177722152691,0.0,0.0
7995,1,3995,[226 201 217 350 219],13,1,14951,3.7414914914914914,0.0,0.0
7996,1,3996,[336 201 216 429 413],13,1,14952,3.7408056042031523,0.0,0.0
7997,1,3997,[272 478 509 208 264],13,5,14957,3.74112056028014,0.0,0.0
7998,1,3998,[272 478 509 208 264],13,5,14962,3.74143535883971,0.0,0.0
7999,1,3999,[264 272 223 299 239],13,4,14966,3.7415,20.0,0.0
8000,2,0,[215 202 481 208 213],90,2,2,2.0,0.0,0.0
8001,2,1,[321 420 326 227 298],378,1,3,1.5,0.0,0.0
8002,2,2,[259 293 507 583 230],308,3,6,2.0,0.0,0.0
8003,2,3,[420 481 213 583 230],7,2,8,2.0,0.0,0.0
8004,2,4,[420 481 293 213 583],308,5,13,2.6,0.0,0.0
8005,2,5,[420 481 293 213 583],308,5,18,3.0,0.0,0.0
8006,2,6,[508 384 215 429 283],385,1,19,2.7142857142857144,0.0,0.0
8007,2,7,[231 485 275 283 250],334,2,21,2.625,0.0,20.0
8008,2,8,[219 431 209 367 452],650,0,21,2.3333333333333335,0.0,0.0
8009,2,9,[301 321 429 431 276],13,2,23,2.3,0.0,20.0
8010,2,10,[420 481 293 429 276],308,5,28,2.5454545454545454,0.0,20.0
8011,2,11,[219 420 303 326 212],13,3,31,2.5833333333333335,0.0,0.0
8012,2,12,[226 298 384 217 231],648,2,33,2.5384615384615383,0.0,0.0
8013,2,13,[239 221 299 275 213],537,2,35,2.5,0.0,20.0
8014,2,14,[378 420 452 216 241],7,5,40,2.6666666666666665,0.0,0.0
8015,2,15,[216 212 481 303 241],90,5,45,2.8125,0.0,0.0
8016,2,16,[276 293 212 303 284],144,3,48,2.823529411764706,0.0,20.0
8017,2,17,[216 212 481 303 241],13,2,50,2.7777777777777777,0.0,0.0
8018,2,18,[485 230 215 344 272],13,2,52,2.736842105263158,0.0,0.0
8019,2,19,[212 219 431 221 316],234,1,53,2.65,20.0,0.0
8020,2,20,[236 283 315 226 230],537,2,55,2.619047619047619,20.0,0.0
8021,2,21,[316 303 272 315 429],334,5,60,2.727272727272727,40.0,0.0
8022,2,22,[420 485 301 223 384],13,2,62,2.6956521739130435,20.0,0.0
8023,2,23,[223 420 316 429 378],650,1,63,2.625,40.0,0.0
8024,2,24,[275 429 303 315 272],537,4,67,2.68,20.0,20.0
8025,2,25,[275 303 315 272 293],894,5,72,2.769230769230769,20.0,20.0
8026,2,26,[275 303 315 272 293],334,4,76,2.814814814814815,20.0,20.0
8027,2,27,[478 208 481 300 276],90,3,79,2.8214285714285716,0.0,40.0
8028,2,28,[478 303 272 315 275],537,5,84,2.896551724137931,20.0,20.0
8029,2,29,[478 303 272 315 275],13,4,88,2.933333333333333,20.0,20.0
8030,2,30,[201 485 280 316 243],13,2,90,2.903225806451613,20.0,0.0
8031,2,31,[478 315 280 303 272],13,5,95,2.96875,20.0,0.0
8032,2,32,[478 315 280 303 272],13,5,100,3.0303030303030303,20.0,0.0
8033,2,33,[478 315 280 303 272],13,5,105,3.088235294117647,20.0,0.0
8034,2,34,[478 315 280 303 272],13,5,110,3.142857142857143,20.0,0.0
8035,2,35,[211 583 259 223 420],308,4,114,3.1666666666666665,20.0,20.0
8036,2,36,[478 272 280 315 211],13,5,119,3.2162162162162162,20.0,20.0
8037,2,37,[478 272 280 315 211],13,5,124,3.263157894736842,20.0,20.0
8038,2,38,[230 232 211 222 300],749,3,127,3.2564102564102564,0.0,60.0
8039,2,39,[211 367 221 316 509],90,5,132,3.3,20.0,20.0
8040,2,40,[507 508 478 236 485],537,3,135,3.292682926829268,0.0,0.0
8041,2,41,[303 272 315 280 211],13,5,140,3.3333333333333335,20.0,20.0
8042,2,42,[303 272 315 280 211],13,5,145,3.372093023255814,20.0,20.0
8043,2,43,[303 272 315 280 211],13,5,150,3.409090909090909,20.0,20.0
8044,2,44,[303 272 315 280 211],13,5,155,3.4444444444444446,20.0,20.0
8045,2,45,[481 392 255 420 219],308,4,159,3.4565217391304346,0.0,0.0
8046,2,46,[212 452 223 232 239],650,0,159,3.382978723404255,20.0,0.0
8047,2,47,[394 275 259 230 293],145,2,161,3.3541666666666665,0.0,20.0
8048,2,48,[336 321 367 219 316],13,1,162,3.306122448979592,20.0,0.0
8049,2,49,[226 227 284 211 321],279,4,166,3.32,0.0,20.0
8050,2,50,[215 211 290 261 209],13,3,169,3.3137254901960786,0.0,20.0
8051,2,51,[230 216 378 508 202],326,2,171,3.2884615384615383,0.0,0.0
8052,2,52,[303 280 272 290 255],894,2,173,3.2641509433962264,0.0,0.0
8053,2,53,[202 213 481 507 268],234,2,175,3.240740740740741,0.0,0.0
8054,2,54,[303 272 315 509 211],537,5,180,3.272727272727273,20.0,20.0
8055,2,55,[303 272 315 509 211],537,5,185,3.3035714285714284,20.0,20.0
8056,2,56,[303 272 315 509 211],13,5,190,3.3333333333333335,20.0,20.0
8057,2,57,[272 275 216 367 213],378,4,194,3.3448275862068964,0.0,20.0
8058,2,58,[284 283 250 255 291],548,3,197,3.3389830508474576,0.0,0.0
8059,2,59,[478 272 303 315 392],537,4,201,3.35,20.0,0.0
8060,2,60,[478 272 303 315 211],13,5,206,3.377049180327869,20.0,20.0
8061,2,61,[226 201 208 222 243],537,1,207,3.338709677419355,0.0,20.0
8062,2,62,[315 212 230 241 232],311,2,209,3.3174603174603177,20.0,0.0
8063,2,63,[478 211 272 303 315],13,5,214,3.34375,20.0,20.0
8064,2,64,[509 326 261 243 316],13,2,216,3.3230769230769233,20.0,0.0
8065,2,65,[478 211 272 303 315],13,5,221,3.3484848484848486,20.0,20.0
8066,2,66,[478 211 272 303 315],537,5,226,3.373134328358209,20.0,20.0
8067,2,67,[478 211 272 303 315],13,5,231,3.3970588235294117,20.0,20.0
8068,2,68,[478 211 272 303 315],13,5,236,3.420289855072464,20.0,20.0
8069,2,69,[223 316 478 212 378],650,1,237,3.3857142857142857,40.0,0.0
8070,2,70,[478 315 291 211 509],474,5,242,3.408450704225352,20.0,20.0
8071,2,71,[478 315 291 211 509],537,4,246,3.4166666666666665,20.0,20.0
8072,2,72,[478 315 211 509 303],13,5,251,3.4383561643835616,20.0,20.0
8073,2,73,[478 315 211 509 303],13,5,256,3.4594594594594597,20.0,20.0
8074,2,74,[478 315 211 509 303],537,5,261,3.48,20.0,20.0
8075,2,75,[478 315 211 509 303],537,5,266,3.5,20.0,20.0
8076,2,76,[209 431 481 268 217],13,1,267,3.4675324675324677,0.0,0.0
8077,2,77,[283 216 223 276 209],308,3,270,3.4615384615384617,20.0,20.0
8078,2,78,[478 272 303 315 211],537,5,275,3.481012658227848,20.0,20.0
8079,2,79,[478 272 303 315 211],537,5,280,3.5,20.0,20.0
8080,2,80,[478 272 303 315 211],13,5,285,3.5185185185185186,20.0,20.0
8081,2,81,[276 315 250 264 213],894,4,289,3.524390243902439,20.0,20.0
8082,2,82,[478 509 272 303 315],13,5,294,3.5421686746987953,20.0,0.0
8083,2,83,[478 509 272 303 315],13,5,299,3.5595238095238093,20.0,0.0
8084,2,84,[478 509 272 303 315],537,5,304,3.5764705882352943,20.0,0.0
8085,2,85,[478 509 272 303 315],13,5,309,3.5930232558139537,20.0,0.0
8086,2,86,[478 509 272 303 315],13,5,314,3.6091954022988504,20.0,0.0
8087,2,87,[299 275 413 429 231],13,1,315,3.5795454545454546,0.0,20.0
8088,2,88,[478 509 272 303 315],13,5,320,3.595505617977528,20.0,0.0
8089,2,89,[299 239 384 367 478],13,2,322,3.577777777777778,0.0,0.0
8090,2,90,[212 507 218 264 326],13,2,324,3.5604395604395602,0.0,0.0
8091,2,91,[509 211 272 478 303],90,5,329,3.5760869565217392,0.0,20.0
8092,2,92,[509 211 272 478 303],13,5,334,3.5913978494623655,0.0,20.0
8093,2,93,[509 211 272 478 303],90,5,339,3.606382978723404,0.0,20.0
8094,2,94,[509 211 272 478 303],537,5,344,3.6210526315789475,0.0,20.0
8095,2,95,[509 211 272 478 303],537,5,349,3.6354166666666665,0.0,20.0
8096,2,96,[509 211 272 478 303],90,5,354,3.649484536082474,0.0,20.0
8097,2,97,[509 211 272 478 303],90,5,359,3.663265306122449,0.0,20.0
8098,2,98,[215 230 284 218 508],92,3,362,3.6565656565656566,0.0,0.0
8099,2,99,[208 211 350 212 485],13,3,365,3.65,0.0,20.0
8100,2,100,[211 272 303 315 509],13,5,370,3.6633663366336635,20.0,20.0
8101,2,101,[239 217 508 208 261],13,2,372,3.6470588235294117,0.0,0.0
8102,2,102,[509 211 272 478 303],6,4,376,3.650485436893204,0.0,20.0
8103,2,103,[509 211 272 478 315],537,5,381,3.6634615384615383,20.0,20.0
8104,2,104,[509 211 272 478 315],13,5,386,3.676190476190476,20.0,20.0
8105,2,105,[509 211 272 478 315],537,5,391,3.688679245283019,20.0,20.0
8106,2,106,[392 301 250 209 259],119,4,395,3.691588785046729,0.0,0.0
8107,2,107,[272 478 315 211 509],650,3,398,3.685185185185185,20.0,20.0
8108,2,108,[272 478 211 303 315],537,5,403,3.697247706422018,20.0,20.0
8109,2,109,[272 478 211 303 315],13,5,408,3.709090909090909,20.0,20.0
8110,2,110,[246 299 264 291 298],294,2,410,3.6936936936936937,0.0,0.0
8111,2,111,[246 272 478 211 303],6,3,413,3.6875,0.0,20.0
8112,2,112,[272 478 211 315 509],537,5,418,3.6991150442477876,20.0,20.0
8113,2,113,[272 478 211 315 509],537,5,423,3.710526315789474,20.0,20.0
8114,2,114,[272 478 211 315 509],650,3,426,3.7043478260869565,20.0,20.0
8115,2,115,[272 478 211 303 315],537,5,431,3.7155172413793105,20.0,20.0
8116,2,116,[272 478 211 303 315],13,5,436,3.7264957264957266,20.0,20.0
8117,2,117,[272 478 211 303 315],13,5,441,3.73728813559322,20.0,20.0
8118,2,118,[283 478 481 236 300],234,1,442,3.7142857142857144,0.0,20.0
8119,2,119,[272 211 478 303 315],13,5,447,3.725,20.0,20.0
8120,2,120,[272 211 478 303 315],537,5,452,3.7355371900826446,20.0,20.0
8121,2,121,[272 211 478 303 315],13,5,457,3.7459016393442623,20.0,20.0
8122,2,122,[272 211 478 303 315],13,5,462,3.7560975609756095,20.0,20.0
8123,2,123,[268 227 331 431 217],145,3,465,3.75,0.0,0.0
8124,2,124,[272 211 478 303 315],13,5,470,3.76,20.0,20.0
8125,2,125,[272 211 478 303 315],13,5,475,3.7698412698412698,20.0,20.0
8126,2,126,[241 384 230 315 509],13,2,477,3.7559055118110236,20.0,0.0
8127,2,127,[272 211 478 315 303],537,5,482,3.765625,20.0,20.0
8128,2,128,[326 431 213 485 208],474,3,485,3.75968992248062,0.0,0.0
8129,2,129,[272 211 478 315 303],13,5,490,3.769230769230769,20.0,20.0
8130,2,130,[280 350 223 331 316],894,3,493,3.763358778625954,40.0,0.0
8131,2,131,[485 326 227 222 231],13,1,494,3.742424242424242,0.0,20.0
8132,2,132,[227 384 222 231 264],102,1,495,3.7218045112781954,0.0,20.0
8133,2,133,[272 211 478 315 303],13,5,500,3.7313432835820897,20.0,20.0
8134,2,134,[272 211 478 315 303],13,5,505,3.740740740740741,20.0,20.0
8135,2,135,[509 272 212 226 232],13,4,509,3.7426470588235294,0.0,0.0
8136,2,136,[272 211 478 315 303],13,5,514,3.7518248175182483,20.0,20.0
8137,2,137,[272 211 478 315 303],537,5,519,3.760869565217391,20.0,20.0
8138,2,138,[272 211 478 315 303],537,5,524,3.7697841726618706,20.0,20.0
8139,2,139,[272 211 478 315 303],13,5,529,3.7785714285714285,20.0,20.0
8140,2,140,[298 221 236 303 208],533,4,533,3.780141843971631,0.0,0.0
8141,2,141,[276 508 394 344 211],13,2,535,3.767605633802817,0.0,40.0
8142,2,142,[211 272 478 315 303],13,5,540,3.7762237762237763,20.0,20.0
8143,2,143,[301 208 211 222 219],279,3,543,3.7708333333333335,0.0,40.0
8144,2,144,[272 211 478 315 303],13,5,548,3.779310344827586,20.0,20.0
8145,2,145,[272 211 478 315 303],537,5,553,3.787671232876712,20.0,20.0
8146,2,146,[272 211 478 315 303],537,5,558,3.795918367346939,20.0,20.0
8147,2,147,[272 211 478 315 303],13,5,563,3.804054054054054,20.0,20.0
8148,2,148,[272 211 478 315 303],13,5,568,3.8120805369127515,20.0,20.0
8149,2,149,[272 211 478 315 303],13,5,573,3.82,20.0,20.0
8150,2,150,[272 211 478 315 303],537,5,578,3.827814569536424,20.0,20.0
8151,2,151,[297 303 209 259 284],6,1,579,3.8092105263157894,20.0,0.0
8152,2,152,[378 301 208 259 268],537,2,581,3.7973856209150325,0.0,0.0
8153,2,153,[272 211 478 315 303],537,5,586,3.8051948051948052,20.0,20.0
8154,2,154,[272 211 478 315 303],13,5,591,3.8129032258064517,20.0,20.0
8155,2,155,[301 275 509 291 232],85,2,593,3.801282051282051,0.0,20.0
8156,2,156,[272 211 478 315 303],537,5,598,3.8089171974522293,20.0,20.0
8157,2,157,[291 293 209 215 276],308,3,601,3.8037974683544302,0.0,20.0
8158,2,158,[300 284 222 303 293],533,3,604,3.79874213836478,0.0,40.0
8159,2,159,[290 280 219 268 259],234,0,604,3.775,0.0,0.0
8160,2,160,[272 211 478 315 303],13,5,609,3.782608695652174,20.0,20.0
8161,2,161,[272 211 478 315 303],13,5,614,3.7901234567901234,20.0,20.0
8162,2,162,[272 211 478 315 303],537,5,619,3.7975460122699385,20.0,20.0
8163,2,163,[272 211 478 315 303],13,5,624,3.8048780487804876,20.0,20.0
8164,2,164,[272 211 478 315 303],537,5,629,3.812121212121212,20.0,20.0
8165,2,165,[272 211 478 315 303],13,5,634,3.819277108433735,20.0,20.0
8166,2,166,[241 331 316 218 326],328,5,639,3.8263473053892216,20.0,0.0
8167,2,167,[272 211 478 315 303],13,5,644,3.8333333333333335,20.0,20.0
8168,2,168,[431 212 321 201 394],13,1,645,3.8165680473372783,0.0,0.0
8169,2,169,[350 315 223 413 290],13,3,648,3.8117647058823527,40.0,0.0
8170,2,170,[272 211 478 315 303],537,5,653,3.818713450292398,20.0,20.0
8171,2,171,[272 211 478 315 303],13,5,658,3.8255813953488373,20.0,20.0
8172,2,172,[272 211 478 315 303],13,5,663,3.832369942196532,20.0,20.0
8173,2,173,[272 211 478 315 303],13,5,668,3.839080459770115,20.0,20.0
8174,2,174,[226 239 230 244 283],158,2,670,3.8285714285714287,0.0,0.0
8175,2,175,[218 367 219 254 298],648,1,671,3.8125,0.0,0.0
8176,2,176,[202 365 276 392 293],308,4,675,3.8135593220338984,0.0,20.0
8177,2,177,[202 218 316 367 378],650,0,675,3.792134831460674,20.0,0.0
8178,2,178,[209 219 241 583 216],308,3,678,3.787709497206704,0.0,0.0
8179,2,179,[218 508 250 268 216],334,1,679,3.772222222222222,0.0,0.0
8180,2,180,[219 509 239 213 230],194,0,679,3.751381215469613,0.0,0.0
8181,2,181,[211 221 284 507 291],234,1,680,3.7362637362637363,0.0,20.0
8182,2,182,[230 213 507 291 301],85,3,683,3.73224043715847,0.0,0.0
8183,2,183,[321 290 431 301 216],279,4,687,3.733695652173913,0.0,0.0
8184,2,184,[219 240 509 275 321],279,2,689,3.7243243243243245,0.0,20.0
8185,2,185,[276 259 211 232 485],194,1,690,3.7096774193548385,0.0,40.0
8186,2,186,[508 241 206 429 478],537,2,692,3.700534759358289,0.0,0.0
8187,2,187,[324 220 223 429 244],334,3,695,3.6968085106382977,20.0,0.0
8188,2,188,[275 284 239 272 485],537,2,697,3.687830687830688,0.0,20.0
8189,2,189,[394 216 227 452 226],145,2,699,3.6789473684210527,0.0,0.0
8190,2,190,[321 583 231 239 367],308,2,701,3.670157068062827,0.0,0.0
8191,2,191,[208 344 201 431 420],13,2,703,3.6614583333333335,0.0,0.0
8192,2,192,[213 300 254 301 227],378,2,705,3.6528497409326426,0.0,20.0
8193,2,193,[202 227 216 452 230],7,2,707,3.6443298969072164,0.0,0.0
8194,2,194,[216 227 478 219 429],326,1,708,3.6307692307692307,0.0,0.0
8195,2,195,[236 321 485 316 215],234,1,709,3.61734693877551,20.0,0.0
8196,2,196,[243 206 429 392 241],537,0,709,3.598984771573604,0.0,0.0
8197,2,197,[429 215 211 216 202],59,5,714,3.606060606060606,0.0,20.0
8198,2,198,[241 280 276 221 283],234,0,714,3.5879396984924625,0.0,20.0
8199,2,199,[241 202 272 211 255],479,3,717,3.585,0.0,20.0
8200,2,200,[217 215 431 299 226],13,2,719,3.5771144278606966,0.0,0.0
8201,2,201,[508 297 298 221 236],894,3,722,3.5742574257425743,20.0,0.0
8202,2,202,[208 275 216 508 220],184,4,726,3.5763546798029555,0.0,20.0
8203,2,203,[367 275 485 212 431],7,4,730,3.5784313725490198,0.0,20.0
8204,2,204,[202 303 478 239 509],537,3,733,3.575609756097561,0.0,0.0
8205,2,205,[261 213 268 209 507],6,3,736,3.5728155339805827,0.0,0.0
8206,2,206,[206 222 236 283 268],234,1,737,3.5603864734299515,0.0,20.0
8207,2,207,[226 283 321 293 259],308,1,738,3.548076923076923,0.0,0.0
8208,2,208,[227 211 478 202 272],13,5,743,3.555023923444976,0.0,20.0
8209,2,209,[509 218 452 264 481],13,2,745,3.5476190476190474,0.0,0.0
8210,2,210,[255 276 481 507 223],308,4,749,3.5497630331753554,20.0,20.0
8211,2,211,[326 276 239 452 223],13,3,752,3.547169811320755,20.0,20.0
8212,2,212,[201 276 392 211 212],59,4,756,3.5492957746478875,0.0,40.0
8213,2,213,[215 211 255 231 216],643,3,759,3.546728971962617,0.0,20.0
8214,2,214,[230 429 209 202 226],308,4,763,3.5488372093023255,0.0,0.0
8215,2,215,[413 367 241 275 350],13,0,763,3.5324074074074074,0.0,20.0
8216,2,216,[222 231 367 202 241],506,2,765,3.525345622119816,0.0,20.0
8217,2,217,[240 215 216 231 226],648,2,767,3.518348623853211,0.0,0.0
8218,2,218,[331 344 261 280 208],13,2,769,3.5114155251141552,0.0,0.0
8219,2,219,[485 384 275 216 222],13,0,769,3.4954545454545456,0.0,40.0
8220,2,220,[250 239 226 222 300],506,2,771,3.48868778280543,0.0,40.0
8221,2,221,[284 222 429 293 223],666,1,772,3.4774774774774775,20.0,20.0
8222,2,222,[429 202 201 275 481],13,2,774,3.4708520179372195,0.0,20.0
8223,2,223,[485 239 243 241 201],13,1,775,3.4598214285714284,0.0,0.0
8224,2,224,[212 276 208 250 218],184,4,779,3.462222222222222,0.0,20.0
8225,2,225,[231 202 507 211 218],648,2,781,3.4557522123893807,0.0,20.0
8226,2,226,[250 239 215 231 295],506,2,783,3.449339207048458,0.0,0.0
8227,2,227,[378 283 485 208 218],184,4,787,3.4517543859649122,0.0,0.0
8228,2,228,[392 321 431 420 230],311,3,790,3.449781659388646,0.0,0.0
8229,2,229,[212 272 478 378 485],650,2,792,3.4434782608695653,0.0,0.0
8230,2,230,[268 209 316 259 215],234,2,794,3.4372294372294374,20.0,0.0
8231,2,231,[215 283 243 218 291],234,0,794,3.4224137931034484,0.0,0.0
8232,2,232,[212 215 413 216 350],13,2,796,3.4163090128755367,0.0,0.0
8233,2,233,[485 232 216 208 321],311,2,798,3.41025641025641,0.0,0.0
8234,2,234,[280 239 413 202 509],13,4,802,3.4127659574468083,0.0,0.0
8235,2,235,[275 236 211 284 202],279,3,805,3.4110169491525424,0.0,40.0
8236,2,236,[268 478 431 259 243],537,3,808,3.409282700421941,0.0,0.0
8237,2,237,[219 239 413 290 344],13,2,810,3.403361344537815,0.0,0.0
8238,2,238,[211 284 218 209 208],59,4,814,3.405857740585774,0.0,20.0
8239,2,239,[201 291 367 275 254],279,1,815,3.3958333333333335,0.0,20.0
8240,2,240,[301 215 300 298 202],378,2,817,3.3900414937759336,0.0,20.0
8241,2,241,[223 301 508 478 413],13,2,819,3.384297520661157,20.0,0.0
8242,2,242,[452 215 217 222 431],774,1,820,3.374485596707819,0.0,20.0
8243,2,243,[231 208 481 217 202],7,3,823,3.372950819672131,0.0,0.0
8244,2,244,[485 209 222 284 507],85,3,826,3.3714285714285714,0.0,20.0
8245,2,245,[222 227 321 239 261],13,2,828,3.3658536585365852,0.0,20.0
8246,2,246,[350 221 315 324 344],116,2,830,3.360323886639676,20.0,0.0
8247,2,247,[508 243 201 222 211],125,1,831,3.350806451612903,0.0,40.0
8248,2,248,[508 202 336 431 223],833,3,834,3.3493975903614457,20.0,0.0
8249,2,249,[300 232 201 478 212],13,2,836,3.344,0.0,20.0
8250,2,250,[261 219 227 212 413],13,2,838,3.3386454183266934,0.0,0.0
8251,2,251,[218 202 230 241 367],59,5,843,3.3452380952380953,0.0,0.0
8252,2,252,[300 254 284 485 293],749,4,847,3.347826086956522,0.0,20.0
8253,2,253,[384 350 218 217 272],13,1,848,3.338582677165354,0.0,0.0
8254,2,254,[211 297 509 276 213],6,3,851,3.3372549019607844,20.0,40.0
8255,2,255,[219 227 276 202 507],59,4,855,3.33984375,0.0,20.0
8256,2,256,[255 227 268 326 231],334,1,856,3.330739299610895,0.0,0.0
8257,2,257,[299 243 301 206 230],537,0,856,3.317829457364341,0.0,0.0
8258,2,258,[216 241 508 507 344],13,0,856,3.305019305019305,0.0,0.0
8259,2,259,[202 301 221 223 268],90,4,860,3.3076923076923075,20.0,0.0
8260,2,260,[227 202 212 413 509],13,4,864,3.310344827586207,0.0,0.0
8261,2,261,[300 290 321 268 301],13,2,866,3.3053435114503817,0.0,20.0
8262,2,262,[301 350 326 231 336],13,0,866,3.2927756653992395,0.0,0.0
8263,2,263,[201 230 280 315 300],13,2,868,3.287878787878788,20.0,20.0
8264,2,264,[283 507 478 300 201],537,3,871,3.2867924528301886,0.0,20.0
8265,2,265,[284 291 212 209 321],537,1,872,3.2781954887218046,0.0,0.0
8266,2,266,[215 236 218 321 226],234,0,872,3.2659176029962547,0.0,0.0
8267,2,267,[431 365 384 275 485],7,4,876,3.2686567164179103,0.0,20.0
8268,2,268,[219 429 227 241 222],387,2,878,3.2639405204460967,0.0,20.0
8269,2,269,[250 213 303 212 223],894,5,883,3.27037037037037,20.0,0.0
8270,2,270,[202 230 254 291 390],279,2,885,3.265682656826568,0.0,0.0
8271,2,271,[215 481 275 211 202],7,4,889,3.2683823529411766,0.0,40.0
8272,2,272,[297 300 316 230 293],334,3,892,3.2673992673992673,40.0,20.0
8273,2,273,[507 211 431 241 316],13,2,894,3.2627737226277373,20.0,20.0
8274,2,274,[212 280 508 256 250],894,2,896,3.2581818181818183,0.0,0.0
8275,2,275,[222 241 231 218 202],387,1,897,3.25,0.0,20.0
8276,2,276,[209 217 244 208 272],334,2,899,3.2454873646209386,0.0,0.0
8277,2,277,[276 429 284 231 299],537,1,900,3.237410071942446,0.0,20.0
8278,2,278,[298 429 250 378 222],749,3,903,3.236559139784946,0.0,20.0
8279,2,279,[298 221 324 244 297],894,3,906,3.2357142857142858,20.0,0.0
8280,2,280,[219 241 215 208 226],92,3,909,3.2348754448398576,0.0,0.0
8281,2,281,[218 367 284 300 212],234,1,910,3.226950354609929,0.0,20.0
8282,2,282,[217 211 272 478 261],13,3,913,3.2261484098939928,0.0,20.0
8283,2,283,[220 365 230 276 283],378,2,915,3.221830985915493,0.0,20.0
8284,2,284,[227 226 239 209 291],92,3,918,3.221052631578947,0.0,0.0
8285,2,285,[223 202 261 208 481],6,3,921,3.2202797202797204,20.0,0.0
8286,2,286,[241 213 250 216 481],85,2,923,3.21602787456446,0.0,0.0
8287,2,287,[212 413 507 452 429],13,2,925,3.2118055555555554,0.0,0.0
8288,2,288,[485 208 276 268 244],334,3,928,3.2110726643598615,0.0,20.0
8289,2,289,[250 202 222 219 324],387,3,931,3.2103448275862068,0.0,20.0
8290,2,290,[452 219 394 230 298],145,2,933,3.2061855670103094,0.0,0.0
8291,2,291,[300 326 216 367 227],378,2,935,3.202054794520548,0.0,20.0
8292,2,292,[290 367 272 223 211],653,1,936,3.1945392491467577,20.0,20.0
8293,2,293,[202 276 284 213 259],537,2,938,3.1904761904761907,0.0,20.0
8294,2,294,[367 255 259 202 226],308,3,941,3.1898305084745764,0.0,0.0
8295,2,295,[216 227 222 243 230],650,3,944,3.189189189189189,0.0,20.0
8296,2,296,[321 239 241 301 261],13,1,945,3.1818181818181817,0.0,0.0
8297,2,297,[219 215 378 508 240],385,1,946,3.174496644295302,0.0,0.0
8298,2,298,[222 324 241 208 429],343,4,950,3.177257525083612,0.0,20.0
8299,2,299,[241 272 301 231 420],85,3,953,3.1766666666666667,0.0,0.0
8300,2,300,[259 240 283 284 367],279,1,954,3.169435215946844,0.0,0.0
8301,2,301,[231 283 223 217 508],378,3,957,3.1688741721854305,20.0,0.0
8302,2,302,[259 230 478 300 485],488,1,958,3.1617161716171616,0.0,20.0
8303,2,303,[291 223 485 226 268],234,0,958,3.151315789473684,20.0,0.0
8304,2,304,[211 213 226 321 215],537,2,960,3.1475409836065573,0.0,20.0
8305,2,305,[206 236 478 211 291],666,4,964,3.150326797385621,0.0,20.0
8306,2,306,[268 299 429 217 508],13,2,966,3.1465798045602607,0.0,0.0
8307,2,307,[268 507 315 275 331],13,2,968,3.142857142857143,20.0,20.0
8308,2,308,[303 243 239 326 212],13,3,971,3.1423948220064726,0.0,0.0
8309,2,309,[222 239 218 202 378],804,5,976,3.1483870967741936,0.0,20.0
8310,2,310,[509 219 226 222 283],279,1,977,3.1414790996784565,0.0,20.0
8311,2,311,[230 220 202 218 295],378,0,977,3.1314102564102564,0.0,0.0
8312,2,312,[284 392 509 259 202],537,1,978,3.1246006389776357,0.0,0.0
8313,2,313,[272 211 478 303 315],13,5,983,3.1305732484076434,20.0,20.0
8314,2,314,[272 211 478 303 315],13,5,988,3.1365079365079365,20.0,20.0
8315,2,315,[272 211 478 303 315],537,5,993,3.142405063291139,20.0,20.0
8316,2,316,[272 211 478 303 315],537,5,998,3.1482649842271293,20.0,20.0
8317,2,317,[280 268 226 209 275],13,3,1001,3.147798742138365,0.0,20.0
8318,2,318,[272 211 478 303 315],13,5,1006,3.153605015673981,20.0,20.0
8319,2,319,[272 211 478 303 315],537,5,1011,3.159375,20.0,20.0
8320,2,320,[272 211 478 303 315],537,5,1016,3.1651090342679127,20.0,20.0
8321,2,321,[272 211 478 303 315],537,5,1021,3.170807453416149,20.0,20.0
8322,2,322,[272 211 478 303 315],537,5,1026,3.176470588235294,20.0,20.0
8323,2,323,[272 211 478 303 315],537,5,1031,3.182098765432099,20.0,20.0
8324,2,324,[222 275 227 239 244],334,2,1033,3.1784615384615384,0.0,40.0
8325,2,325,[272 211 478 303 315],537,5,1038,3.184049079754601,20.0,20.0
8326,2,326,[272 211 478 303 315],537,5,1043,3.1896024464831805,20.0,20.0
8327,2,327,[206 268 272 222 209],537,3,1046,3.1890243902439024,0.0,20.0
8328,2,328,[272 211 478 303 315],537,5,1051,3.1945288753799392,20.0,20.0
8329,2,329,[429 290 284 276 212],59,3,1054,3.193939393939394,0.0,20.0
8330,2,330,[255 315 316 264 303],894,3,1057,3.193353474320242,40.0,0.0
8331,2,331,[272 211 478 303 315],13,5,1062,3.1987951807228914,20.0,20.0
8332,2,332,[272 211 478 303 315],13,5,1067,3.204204204204204,20.0,20.0
8333,2,333,[275 350 201 290 507],13,1,1068,3.197604790419162,0.0,20.0
8334,2,334,[272 211 478 303 315],537,5,1073,3.2029850746268655,20.0,20.0
8335,2,335,[272 211 478 303 315],13,5,1078,3.2083333333333335,20.0,20.0
8336,2,336,[272 211 478 303 315],537,5,1083,3.2136498516320473,20.0,20.0
8337,2,337,[272 211 478 303 315],13,5,1088,3.2189349112426036,20.0,20.0
8338,2,338,[272 211 478 303 315],13,5,1093,3.224188790560472,20.0,20.0
8339,2,339,[378 218 275 276 215],554,4,1097,3.226470588235294,0.0,40.0
8340,2,340,[272 211 478 303 315],537,5,1102,3.231671554252199,20.0,20.0
8341,2,341,[272 211 478 303 315],537,5,1107,3.236842105263158,20.0,20.0
8342,2,342,[275 485 239 509 452],308,2,1109,3.2332361516034984,0.0,20.0
8343,2,343,[272 211 478 303 315],13,5,1114,3.238372093023256,20.0,20.0
8344,2,344,[394 384 280 227 429],13,3,1117,3.2376811594202897,0.0,0.0
8345,2,345,[321 392 275 255 280],378,2,1119,3.2341040462427744,0.0,20.0
8346,2,346,[272 211 478 303 315],13,5,1124,3.239193083573487,20.0,20.0
8347,2,347,[272 211 478 303 315],537,5,1129,3.2442528735632186,20.0,20.0
8348,2,348,[272 211 478 303 315],13,5,1134,3.2492836676217767,20.0,20.0
8349,2,349,[272 211 478 303 315],537,5,1139,3.2542857142857144,20.0,20.0
8350,2,350,[272 211 478 303 315],537,5,1144,3.259259259259259,20.0,20.0
8351,2,351,[481 485 259 507 241],234,2,1146,3.2556818181818183,0.0,0.0
8352,2,352,[272 211 478 303 315],537,5,1151,3.2606232294617565,20.0,20.0
8353,2,353,[272 211 478 303 315],537,5,1156,3.2655367231638417,20.0,20.0
8354,2,354,[272 211 478 303 315],537,5,1161,3.2704225352112677,20.0,20.0
8355,2,355,[291 209 211 283 326],474,3,1164,3.269662921348315,0.0,20.0
8356,2,356,[272 211 478 303 315],537,5,1169,3.2745098039215685,20.0,20.0
8357,2,357,[231 420 298 280 232],749,5,1174,3.2793296089385473,0.0,0.0
8358,2,358,[276 212 413 367 241],82,3,1177,3.278551532033426,0.0,20.0
8359,2,359,[222 481 509 211 429],13,3,1180,3.2777777777777777,0.0,40.0
8360,2,360,[272 211 478 303 315],13,5,1185,3.2825484764542936,20.0,20.0
8361,2,361,[272 211 478 303 315],537,5,1190,3.287292817679558,20.0,20.0
8362,2,362,[272 211 478 303 315],13,5,1195,3.2920110192837466,20.0,20.0
8363,2,363,[272 211 478 303 315],13,5,1200,3.2967032967032965,20.0,20.0
8364,2,364,[272 211 478 303 315],13,5,1205,3.3013698630136985,20.0,20.0
8365,2,365,[272 211 478 303 315],13,5,1210,3.3060109289617485,20.0,20.0
8366,2,366,[272 211 478 303 315],537,5,1215,3.310626702997275,20.0,20.0
8367,2,367,[272 211 478 303 315],13,5,1220,3.3152173913043477,20.0,20.0
8368,2,368,[211 202 378 508 230],533,5,1225,3.3197831978319785,0.0,20.0
8369,2,369,[367 227 230 215 272],13,3,1228,3.3189189189189188,0.0,0.0
8370,2,370,[272 211 478 303 315],13,5,1233,3.3234501347708894,20.0,20.0
8371,2,371,[272 211 478 303 315],537,5,1238,3.327956989247312,20.0,20.0
8372,2,372,[202 232 275 223 217],13,2,1240,3.324396782841823,20.0,20.0
8373,2,373,[272 211 478 303 315],13,5,1245,3.328877005347594,20.0,20.0
8374,2,374,[272 211 478 303 315],13,5,1250,3.3333333333333335,20.0,20.0
8375,2,375,[272 211 478 303 315],13,5,1255,3.3377659574468086,20.0,20.0
8376,2,376,[272 211 478 303 315],13,5,1260,3.3421750663129974,20.0,20.0
8377,2,377,[509 275 220 276 215],184,4,1264,3.3439153439153437,0.0,40.0
8378,2,378,[429 206 213 275 216],406,1,1265,3.337730870712401,0.0,20.0
8379,2,379,[272 211 478 303 315],537,5,1270,3.3421052631578947,20.0,20.0
8380,2,380,[272 211 478 303 315],13,5,1275,3.3464566929133857,20.0,20.0
8381,2,381,[272 211 478 303 315],13,5,1280,3.350785340314136,20.0,20.0
8382,2,382,[272 211 478 303 315],537,5,1285,3.3550913838120104,20.0,20.0
8383,2,383,[272 211 478 303 315],13,5,1290,3.359375,20.0,20.0
8384,2,384,[272 211 478 303 315],13,5,1295,3.3636363636363638,20.0,20.0
8385,2,385,[272 211 478 303 315],13,5,1300,3.3678756476683938,20.0,20.0
8386,2,386,[272 211 478 303 315],537,5,1305,3.372093023255814,20.0,20.0
8387,2,387,[272 211 478 303 315],13,5,1310,3.3762886597938144,20.0,20.0
8388,2,388,[272 211 478 303 315],13,5,1315,3.380462724935733,20.0,20.0
8389,2,389,[272 211 478 303 315],13,5,1320,3.3846153846153846,20.0,20.0
8390,2,390,[220 232 218 212 508],59,3,1323,3.3836317135549874,0.0,0.0
8391,2,391,[272 211 478 303 315],537,5,1328,3.3877551020408165,20.0,20.0
8392,2,392,[272 211 478 303 315],537,5,1333,3.391857506361323,20.0,20.0
8393,2,393,[272 211 478 303 315],537,5,1338,3.3959390862944163,20.0,20.0
8394,2,394,[272 211 478 303 315],537,5,1343,3.4,20.0,20.0
8395,2,395,[239 452 431 509 222],650,1,1344,3.393939393939394,0.0,20.0
8396,2,396,[272 211 478 303 315],13,5,1349,3.397984886649874,20.0,20.0
8397,2,397,[272 211 478 303 315],537,5,1354,3.4020100502512562,20.0,20.0
8398,2,398,[223 293 268 280 344],894,3,1357,3.401002506265664,20.0,0.0
8399,2,399,[272 211 478 303 315],13,5,1362,3.405,20.0,20.0
8400,2,400,[272 211 478 303 315],537,5,1367,3.4089775561097255,20.0,20.0
8401,2,401,[272 211 478 303 315],13,5,1372,3.4129353233830844,20.0,20.0
8402,2,402,[272 211 478 303 315],13,5,1377,3.4168734491315136,20.0,20.0
8403,2,403,[280 321 367 276 241],234,1,1378,3.410891089108911,0.0,20.0
8404,2,404,[268 230 350 452 429],13,2,1380,3.4074074074074074,0.0,0.0
8405,2,405,[367 276 230 291 209],92,3,1383,3.4064039408866993,0.0,20.0
8406,2,406,[272 211 478 303 315],537,5,1388,3.4103194103194103,20.0,20.0
8407,2,407,[231 478 429 367 201],13,2,1390,3.406862745098039,0.0,0.0
8408,2,408,[272 211 478 303 315],537,5,1395,3.410757946210269,20.0,20.0
8409,2,409,[272 211 478 303 315],537,5,1400,3.4146341463414633,20.0,20.0
8410,2,410,[272 211 478 303 315],537,5,1405,3.4184914841849148,20.0,20.0
8411,2,411,[326 264 212 268 246],894,2,1407,3.4150485436893203,0.0,0.0
8412,2,412,[272 211 478 303 315],537,5,1412,3.4188861985472156,20.0,20.0
8413,2,413,[236 303 209 485 255],334,2,1414,3.4154589371980677,0.0,0.0
8414,2,414,[478 211 324 583 429],343,5,1419,3.419277108433735,0.0,20.0
8415,2,415,[272 211 478 303 315],537,5,1424,3.423076923076923,20.0,20.0
8416,2,416,[272 211 478 303 315],537,5,1429,3.4268585131894485,20.0,20.0
8417,2,417,[272 211 478 303 315],13,5,1434,3.430622009569378,20.0,20.0
8418,2,418,[272 211 478 303 315],537,5,1439,3.4343675417661097,20.0,20.0
8419,2,419,[272 211 478 303 315],537,5,1444,3.4380952380952383,20.0,20.0
8420,2,420,[272 211 478 303 315],537,5,1449,3.441805225653207,20.0,20.0
8421,2,421,[272 211 478 303 315],537,5,1454,3.4454976303317535,20.0,20.0
8422,2,422,[272 211 478 303 315],537,5,1459,3.4491725768321513,20.0,20.0
8423,2,423,[272 211 478 303 315],13,5,1464,3.452830188679245,20.0,20.0
8424,2,424,[272 211 478 303 315],13,5,1469,3.456470588235294,20.0,20.0
8425,2,425,[272 211 478 303 315],537,5,1474,3.460093896713615,20.0,20.0
8426,2,426,[272 211 478 303 315],537,5,1479,3.4637002341920375,20.0,20.0
8427,2,427,[272 211 478 303 315],537,5,1484,3.467289719626168,20.0,20.0
8428,2,428,[291 431 316 213 259],234,1,1485,3.4615384615384617,20.0,0.0
8429,2,429,[272 211 478 303 315],537,5,1490,3.4651162790697674,20.0,20.0
8430,2,430,[283 259 478 215 268],234,0,1490,3.45707656612529,0.0,0.0
8431,2,431,[216 326 212 429 226],13,3,1493,3.4560185185185186,0.0,0.0
8432,2,432,[272 211 303 315 478],537,5,1498,3.459584295612009,20.0,20.0
8433,2,433,[272 211 303 315 478],537,5,1503,3.4631336405529956,20.0,20.0
8434,2,434,[272 211 303 315 478],13,5,1508,3.466666666666667,20.0,20.0
8435,2,435,[272 211 303 315 478],537,5,1513,3.470183486238532,20.0,20.0
8436,2,436,[272 211 303 315 478],537,5,1518,3.473684210526316,20.0,20.0
8437,2,437,[452 211 219 276 227],13,3,1521,3.4726027397260273,0.0,40.0
8438,2,438,[272 211 303 315 478],537,5,1526,3.4760820045558085,20.0,20.0
8439,2,439,[272 211 303 315 478],537,5,1531,3.4795454545454545,20.0,20.0
8440,2,440,[272 211 303 315 478],537,5,1536,3.4829931972789114,20.0,20.0
8441,2,441,[392 508 485 321 280],378,2,1538,3.479638009049774,0.0,0.0
8442,2,442,[272 211 303 315 478],537,5,1543,3.4830699774266365,20.0,20.0
8443,2,443,[272 211 303 315 478],13,5,1548,3.4864864864864864,20.0,20.0
8444,2,444,[243 290 378 208 232],650,1,1549,3.4808988764044946,0.0,0.0
8445,2,445,[272 211 303 315 478],537,5,1554,3.484304932735426,20.0,20.0
8446,2,446,[331 202 316 219 431],145,4,1558,3.4854586129753913,20.0,0.0
8447,2,447,[272 211 303 315 478],537,5,1563,3.4888392857142856,20.0,20.0
8448,2,448,[264 223 350 367 301],13,2,1565,3.485523385300668,20.0,0.0
8449,2,449,[272 211 303 315 478],537,5,1570,3.488888888888889,20.0,20.0
8450,2,450,[201 216 226 268 316],13,3,1573,3.4878048780487805,20.0,0.0
8451,2,451,[272 211 303 315 478],537,5,1578,3.4911504424778763,20.0,20.0
8452,2,452,[272 211 303 315 478],537,5,1583,3.4944812362030904,20.0,20.0
8453,2,453,[216 211 481 230 221],474,4,1587,3.495594713656388,0.0,20.0
8454,2,454,[272 211 303 315 478],13,5,1592,3.498901098901099,20.0,20.0
8455,2,455,[272 211 303 315 478],13,5,1597,3.5021929824561404,20.0,20.0
8456,2,456,[272 211 303 315 478],13,5,1602,3.5054704595185995,20.0,20.0
8457,2,457,[272 211 303 315 478],537,5,1607,3.5087336244541483,20.0,20.0
8458,2,458,[272 211 303 315 478],537,5,1612,3.5119825708061003,20.0,20.0
8459,2,459,[272 211 303 315 478],537,5,1617,3.515217391304348,20.0,20.0
8460,2,460,[272 211 303 315 478],537,5,1622,3.5184381778741867,20.0,20.0
8461,2,461,[272 211 303 315 478],537,5,1627,3.5216450216450217,20.0,20.0
8462,2,462,[272 211 303 315 478],537,5,1632,3.524838012958963,20.0,20.0
8463,2,463,[272 211 303 315 478],13,5,1637,3.5280172413793105,20.0,20.0
8464,2,464,[272 211 303 315 478],13,5,1642,3.531182795698925,20.0,20.0
8465,2,465,[208 481 326 301 378],318,5,1647,3.5343347639484977,0.0,0.0
8466,2,466,[272 211 303 315 478],537,5,1652,3.537473233404711,20.0,20.0
8467,2,467,[272 211 303 315 478],13,5,1657,3.5405982905982905,20.0,20.0
8468,2,468,[222 298 324 276 413],294,4,1661,3.541577825159915,0.0,40.0
8469,2,469,[272 211 303 315 478],13,5,1666,3.5446808510638297,20.0,20.0
8470,2,470,[272 211 303 315 478],537,5,1671,3.5477707006369426,20.0,20.0
8471,2,471,[272 211 303 315 478],13,5,1676,3.5508474576271185,20.0,20.0
8472,2,472,[261 394 226 350 303],13,2,1678,3.5475687103594082,0.0,0.0
8473,2,473,[272 211 303 315 478],537,5,1683,3.550632911392405,20.0,20.0
8474,2,474,[272 211 303 315 478],537,5,1688,3.553684210526316,20.0,20.0
8475,2,475,[272 211 303 315 478],537,5,1693,3.55672268907563,20.0,20.0
8476,2,476,[272 211 303 315 478],13,5,1698,3.559748427672956,20.0,20.0
8477,2,477,[272 211 303 315 478],537,5,1703,3.562761506276151,20.0,20.0
8478,2,478,[272 211 303 315 478],13,5,1708,3.5657620041753653,20.0,20.0
8479,2,479,[336 211 326 509 299],13,2,1710,3.5625,0.0,20.0
8480,2,480,[272 211 303 315 478],537,5,1715,3.5654885654885655,20.0,20.0
8481,2,481,[272 211 303 315 478],537,5,1720,3.5684647302904566,20.0,20.0
8482,2,482,[452 350 268 276 232],13,2,1722,3.5652173913043477,0.0,20.0
8483,2,483,[272 211 303 315 478],537,5,1727,3.5681818181818183,20.0,20.0
8484,2,484,[272 211 303 315 478],13,5,1732,3.571134020618557,20.0,20.0
8485,2,485,[272 211 303 315 478],13,5,1737,3.574074074074074,20.0,20.0
8486,2,486,[272 211 303 315 478],13,5,1742,3.57700205338809,20.0,20.0
8487,2,487,[272 211 303 315 478],537,5,1747,3.5799180327868854,20.0,20.0
8488,2,488,[272 211 303 315 478],537,5,1752,3.5828220858895707,20.0,20.0
8489,2,489,[420 215 216 208 275],882,5,1757,3.585714285714286,0.0,20.0
8490,2,490,[272 211 303 315 478],537,5,1762,3.5885947046843176,20.0,20.0
8491,2,491,[272 211 303 315 478],537,5,1767,3.591463414634146,20.0,20.0
8492,2,492,[429 321 367 202 452],308,3,1770,3.59026369168357,0.0,0.0
8493,2,493,[272 211 303 315 478],537,5,1775,3.5931174089068825,20.0,20.0
8494,2,494,[231 367 420 301 272],650,1,1776,3.587878787878788,0.0,0.0
8495,2,495,[272 211 303 315 478],537,5,1781,3.590725806451613,20.0,20.0
8496,2,496,[272 211 303 315 478],13,5,1786,3.5935613682092553,20.0,20.0
8497,2,497,[272 211 303 315 478],13,5,1791,3.5963855421686746,20.0,20.0
8498,2,498,[272 211 303 315 478],537,5,1796,3.599198396793587,20.0,20.0
8499,2,499,[202 365 222 300 219],774,2,1798,3.596,0.0,40.0
8500,2,500,[272 211 303 315 478],13,5,1803,3.5988023952095807,20.0,20.0
8501,2,501,[272 211 303 315 478],13,5,1808,3.601593625498008,20.0,20.0
8502,2,502,[272 211 303 315 478],13,5,1813,3.6043737574552686,20.0,20.0
8503,2,503,[272 211 303 315 478],13,5,1818,3.607142857142857,20.0,20.0
8504,2,504,[272 211 303 315 478],537,5,1823,3.60990099009901,20.0,20.0
8505,2,505,[272 211 303 315 478],13,5,1828,3.6126482213438735,20.0,20.0
8506,2,506,[336 507 215 326 209],13,1,1829,3.6074950690335306,0.0,0.0
8507,2,507,[272 211 303 315 478],537,5,1834,3.6102362204724407,20.0,20.0
8508,2,508,[272 211 303 315 478],13,5,1839,3.612966601178782,20.0,20.0
8509,2,509,[272 211 303 315 478],537,5,1844,3.615686274509804,20.0,20.0
8510,2,510,[272 211 303 315 478],13,5,1849,3.6183953033268104,20.0,20.0
8511,2,511,[268 478 290 301 429],537,2,1851,3.615234375,0.0,0.0
8512,2,512,[272 211 303 315 478],537,5,1856,3.617933723196881,20.0,20.0
8513,2,513,[212 367 230 300 507],13,1,1857,3.61284046692607,0.0,20.0
8514,2,514,[272 211 303 315 478],537,5,1862,3.615533980582524,20.0,20.0
8515,2,515,[478 209 219 367 226],194,0,1862,3.608527131782946,0.0,0.0
8516,2,516,[272 211 303 315 478],13,5,1867,3.611218568665377,20.0,20.0
8517,2,517,[272 211 303 315 478],13,5,1872,3.613899613899614,20.0,20.0
8518,2,518,[272 211 303 315 478],13,5,1877,3.6165703275529864,20.0,20.0
8519,2,519,[223 243 209 295 241],92,2,1879,3.6134615384615385,20.0,0.0
8520,2,520,[272 211 303 315 478],537,5,1884,3.616122840690979,20.0,20.0
8521,2,521,[230 344 272 316 215],13,3,1887,3.6149425287356323,20.0,0.0
8522,2,522,[272 211 303 315 478],13,5,1892,3.617590822179732,20.0,20.0
8523,2,523,[316 221 272 215 259],85,2,1894,3.614503816793893,20.0,0.0
8524,2,524,[272 211 303 315 478],537,5,1899,3.617142857142857,20.0,20.0
8525,2,525,[208 217 299 231 243],13,1,1900,3.612167300380228,0.0,0.0
8526,2,526,[272 211 303 315 478],13,5,1905,3.6148007590132827,20.0,20.0
8527,2,527,[230 284 583 290 226],59,3,1908,3.6136363636363638,0.0,0.0
8528,2,528,[272 211 303 315 478],13,5,1913,3.616257088846881,20.0,20.0
8529,2,529,[272 211 303 315 478],537,5,1918,3.6188679245283017,20.0,20.0
8530,2,530,[272 211 303 315 478],13,5,1923,3.621468926553672,20.0,20.0
8531,2,531,[209 219 216 290 429],13,2,1925,3.6184210526315788,0.0,0.0
8532,2,532,[272 211 303 315 478],537,5,1930,3.621013133208255,20.0,20.0
8533,2,533,[272 211 303 315 478],537,5,1935,3.6235955056179776,20.0,20.0
8534,2,534,[272 211 303 315 478],13,5,1940,3.6261682242990654,20.0,20.0
8535,2,535,[272 211 303 315 478],13,5,1945,3.628731343283582,20.0,20.0
8536,2,536,[212 300 481 259 231],7,2,1947,3.625698324022346,0.0,20.0
8537,2,537,[209 227 276 226 213],311,4,1951,3.62639405204461,0.0,20.0
8538,2,538,[272 211 303 315 478],13,5,1956,3.6289424860853434,20.0,20.0
8539,2,539,[272 211 303 315 478],13,5,1961,3.6314814814814813,20.0,20.0
8540,2,540,[272 211 303 315 478],537,5,1966,3.6340110905730127,20.0,20.0
8541,2,541,[300 303 301 276 290],537,2,1968,3.6309963099630997,0.0,40.0
8542,2,542,[272 211 303 315 478],13,5,1973,3.6335174953959486,20.0,20.0
8543,2,543,[202 378 213 218 221],234,1,1974,3.6286764705882355,0.0,0.0
8544,2,544,[221 283 239 301 276],334,3,1977,3.6275229357798167,0.0,20.0
8545,2,545,[392 276 485 243 231],537,1,1978,3.6227106227106227,0.0,20.0
8546,2,546,[275 208 215 478 280],13,4,1982,3.623400365630713,0.0,20.0
8547,2,547,[272 211 303 315 478],537,5,1987,3.625912408759124,20.0,20.0
8548,2,548,[272 211 303 315 478],13,5,1992,3.628415300546448,20.0,20.0
8549,2,549,[272 211 303 315 478],13,5,1997,3.630909090909091,20.0,20.0
8550,2,550,[272 211 303 315 478],13,5,2002,3.633393829401089,20.0,20.0
8551,2,551,[431 216 243 336 344],13,0,2002,3.6268115942028984,0.0,0.0
8552,2,552,[344 290 223 218 272],13,3,2005,3.6256781193490055,20.0,0.0
8553,2,553,[272 211 303 315 478],537,5,2010,3.628158844765343,20.0,20.0
8554,2,554,[272 211 303 315 478],537,5,2015,3.630630630630631,20.0,20.0
8555,2,555,[290 212 378 216 284],804,4,2019,3.631294964028777,0.0,0.0
8556,2,556,[272 211 303 315 478],13,5,2024,3.6337522441651706,20.0,20.0
8557,2,557,[272 211 303 315 478],537,5,2029,3.6362007168458783,20.0,20.0
8558,2,558,[272 211 303 315 478],13,5,2034,3.638640429338104,20.0,20.0
8559,2,559,[272 211 303 315 478],13,5,2039,3.6410714285714287,20.0,20.0
8560,2,560,[272 211 303 315 478],13,5,2044,3.64349376114082,20.0,20.0
8561,2,561,[272 211 303 315 478],13,5,2049,3.6459074733096086,20.0,20.0
8562,2,562,[221 298 290 276 326],894,2,2051,3.6429840142095915,0.0,20.0
8563,2,563,[261 241 485 219 336],13,0,2051,3.6365248226950353,0.0,0.0
8564,2,564,[297 276 291 221 226],533,2,2053,3.633628318584071,20.0,20.0
8565,2,565,[272 211 303 315 478],537,5,2058,3.636042402826855,20.0,20.0
8566,2,566,[481 232 213 300 259],85,2,2060,3.6331569664903,0.0,20.0
8567,2,567,[272 211 303 315 478],537,5,2065,3.63556338028169,20.0,20.0
8568,2,568,[217 378 208 222 431],843,1,2066,3.630931458699473,0.0,20.0
8569,2,569,[272 211 303 315 478],537,5,2071,3.6333333333333333,20.0,20.0
8570,2,570,[272 211 303 315 478],537,5,2076,3.635726795096322,20.0,20.0
8571,2,571,[272 211 303 315 478],537,5,2081,3.638111888111888,20.0,20.0
8572,2,572,[272 211 303 315 478],537,5,2086,3.6404886561954624,20.0,20.0
8573,2,573,[272 211 303 315 478],537,5,2091,3.642857142857143,20.0,20.0
8574,2,574,[232 227 230 508 217],774,1,2092,3.6382608695652174,0.0,0.0
8575,2,575,[272 211 303 315 478],537,5,2097,3.640625,20.0,20.0
8576,2,576,[272 211 303 315 478],537,5,2102,3.6429809358752165,20.0,20.0
8577,2,577,[272 211 303 315 478],537,5,2107,3.6453287197231834,20.0,20.0
8578,2,578,[272 211 303 315 478],13,5,2112,3.6476683937823835,20.0,20.0
8579,2,579,[509 230 420 485 315],13,3,2115,3.646551724137931,20.0,0.0
8580,2,580,[272 211 303 315 478],537,5,2120,3.648881239242685,20.0,20.0
8581,2,581,[218 316 300 222 211],328,4,2124,3.649484536082474,20.0,60.0
8582,2,582,[272 211 303 315 478],13,5,2129,3.6518010291595195,20.0,20.0
8583,2,583,[485 509 230 226 213],311,3,2132,3.6506849315068495,0.0,0.0
8584,2,584,[272 211 303 315 478],537,5,2137,3.652991452991453,20.0,20.0
8585,2,585,[272 211 303 315 478],13,5,2142,3.6552901023890785,20.0,20.0
8586,2,586,[365 241 231 211 367],774,1,2143,3.6507666098807494,0.0,20.0
8587,2,587,[255 509 392 295 241],308,4,2147,3.651360544217687,0.0,0.0
8588,2,588,[272 303 315 211 478],13,5,2152,3.6536502546689302,20.0,20.0
8589,2,589,[272 303 315 211 478],537,5,2157,3.6559322033898307,20.0,20.0
8590,2,590,[272 303 315 211 478],537,5,2162,3.6582064297800336,20.0,20.0
8591,2,591,[272 303 315 211 478],537,5,2167,3.660472972972973,20.0,20.0
8592,2,592,[272 303 315 211 478],537,5,2172,3.6627318718381114,20.0,20.0
8593,2,593,[384 212 239 226 217],13,3,2175,3.6616161616161618,0.0,0.0
8594,2,594,[272 303 315 211 478],13,5,2180,3.6638655462184873,20.0,20.0
8595,2,595,[272 303 315 211 478],13,5,2185,3.6661073825503356,20.0,20.0
8596,2,596,[202 300 241 291 236],537,0,2185,3.659966499162479,0.0,20.0
8597,2,597,[507 223 222 315 239],650,2,2187,3.657190635451505,40.0,20.0
8598,2,598,[272 303 211 315 478],537,5,2192,3.659432387312187,20.0,20.0
8599,2,599,[272 303 211 315 478],13,5,2197,3.6616666666666666,20.0,20.0
8600,2,600,[272 303 211 315 478],537,5,2202,3.6638935108153077,20.0,20.0
8601,2,601,[272 303 211 315 478],13,5,2207,3.666112956810631,20.0,20.0
8602,2,602,[206 303 290 230 283],537,2,2209,3.6633499170812605,0.0,0.0
8603,2,603,[272 303 211 315 478],537,5,2214,3.665562913907285,20.0,20.0
8604,2,604,[272 303 211 315 478],13,5,2219,3.667768595041322,20.0,20.0
8605,2,605,[272 303 211 315 478],537,5,2224,3.66996699669967,20.0,20.0
8606,2,606,[272 303 211 315 478],537,5,2229,3.672158154859967,20.0,20.0
8607,2,607,[272 303 211 315 478],13,5,2234,3.674342105263158,20.0,20.0
8608,2,608,[272 303 211 315 478],537,5,2239,3.676518883415435,20.0,20.0
8609,2,609,[367 507 240 298 295],648,1,2240,3.6721311475409837,0.0,0.0
8610,2,610,[272 303 211 315 478],537,5,2245,3.6743044189852703,20.0,20.0
8611,2,611,[272 303 211 315 478],13,5,2250,3.676470588235294,20.0,20.0
8612,2,612,[420 231 208 218 326],13,2,2252,3.67373572593801,0.0,0.0
8613,2,613,[218 244 481 316 284],474,5,2257,3.675895765472313,20.0,0.0
8614,2,614,[272 303 211 315 478],13,5,2262,3.678048780487805,20.0,20.0
8615,2,615,[223 230 452 226 378],308,2,2264,3.675324675324675,20.0,0.0
8616,2,616,[272 303 211 315 478],537,5,2269,3.6774716369529985,20.0,20.0
8617,2,617,[272 303 211 315 478],13,5,2274,3.679611650485437,20.0,20.0
8618,2,618,[272 303 211 315 478],537,5,2279,3.6817447495961226,20.0,20.0
8619,2,619,[272 303 211 315 478],13,5,2284,3.6838709677419357,20.0,20.0
8620,2,620,[272 303 211 315 478],537,5,2289,3.685990338164251,20.0,20.0
8621,2,621,[272 303 211 315 478],537,5,2294,3.688102893890675,20.0,20.0
8622,2,622,[272 303 211 315 478],537,5,2299,3.6902086677367576,20.0,20.0
8623,2,623,[243 507 394 202 219],13,1,2300,3.6858974358974357,0.0,0.0
8624,2,624,[272 303 211 315 478],13,5,2305,3.688,20.0,20.0
8625,2,625,[326 295 230 220 255],378,1,2306,3.68370607028754,0.0,0.0
8626,2,626,[293 211 420 298 291],308,4,2310,3.6842105263157894,0.0,20.0
8627,2,627,[272 303 211 315 478],13,5,2315,3.6863057324840764,20.0,20.0
8628,2,628,[272 303 211 315 478],13,5,2320,3.6883942766295705,20.0,20.0
8629,2,629,[272 303 211 315 478],13,5,2325,3.6904761904761907,20.0,20.0
8630,2,630,[239 478 431 202 413],13,3,2328,3.6893819334389857,0.0,0.0
8631,2,631,[275 431 226 316 300],145,2,2330,3.6867088607594938,20.0,40.0
8632,2,632,[272 303 211 315 478],537,5,2335,3.688783570300158,20.0,20.0
8633,2,633,[272 303 211 315 478],13,5,2340,3.690851735015773,20.0,20.0
8634,2,634,[272 303 211 315 478],13,5,2345,3.6929133858267718,20.0,20.0
8635,2,635,[213 272 275 268 241],537,4,2349,3.693396226415094,0.0,20.0
8636,2,636,[272 303 211 315 478],13,5,2354,3.695447409733124,20.0,20.0
8637,2,637,[272 303 211 315 478],537,5,2359,3.697492163009404,20.0,20.0
8638,2,638,[272 303 211 315 478],13,5,2364,3.699530516431925,20.0,20.0
8639,2,639,[264 226 222 201 300],13,2,2366,3.696875,0.0,40.0
8640,2,640,[215 485 226 230 264],7,4,2370,3.6973478939157567,0.0,0.0
8641,2,641,[211 215 291 236 255],533,3,2373,3.696261682242991,0.0,20.0
8642,2,642,[272 303 211 315 478],537,5,2378,3.698289269051322,20.0,20.0
8643,2,643,[272 303 211 315 478],13,5,2383,3.700310559006211,20.0,20.0
8644,2,644,[222 413 216 209 223],13,1,2384,3.696124031007752,20.0,20.0
8645,2,645,[272 303 211 315 478],537,5,2389,3.698142414860681,20.0,20.0
8646,2,646,[272 303 211 315 478],537,5,2394,3.7001545595054095,20.0,20.0
8647,2,647,[272 303 211 315 478],13,5,2399,3.7021604938271606,20.0,20.0
8648,2,648,[272 303 211 315 478],13,5,2404,3.704160246533128,20.0,20.0
8649,2,649,[272 303 211 315 478],537,5,2409,3.706153846153846,20.0,20.0
8650,2,650,[481 507 583 284 239],308,3,2412,3.705069124423963,0.0,0.0
8651,2,651,[324 315 336 272 299],894,2,2414,3.7024539877300615,20.0,0.0
8652,2,652,[272 303 211 315 478],537,5,2419,3.7044410413476263,20.0,20.0
8653,2,653,[223 508 202 226 239],92,3,2422,3.7033639143730888,20.0,0.0
8654,2,654,[215 350 230 300 284],328,1,2423,3.699236641221374,0.0,20.0
8655,2,655,[272 303 211 315 478],13,5,2428,3.701219512195122,20.0,20.0
8656,2,656,[272 303 211 315 478],13,5,2433,3.7031963470319633,20.0,20.0
8657,2,657,[272 303 211 315 478],537,5,2438,3.7051671732522795,20.0,20.0
8658,2,658,[272 303 211 315 478],13,5,2443,3.7071320182094083,20.0,20.0
8659,2,659,[272 303 211 315 478],13,5,2448,3.709090909090909,20.0,20.0
8660,2,660,[272 303 211 315 478],13,5,2453,3.7110438729198183,20.0,20.0
8661,2,661,[272 303 211 315 478],537,5,2458,3.712990936555891,20.0,20.0
8662,2,662,[283 255 226 216 291],308,1,2459,3.708898944193062,0.0,0.0
8663,2,663,[272 303 211 315 478],13,5,2464,3.710843373493976,20.0,20.0
8664,2,664,[272 303 211 315 478],537,5,2469,3.712781954887218,20.0,20.0
8665,2,665,[272 303 211 315 478],537,5,2474,3.714714714714715,20.0,20.0
8666,2,666,[272 303 211 315 478],537,5,2479,3.71664167916042,20.0,20.0
8667,2,667,[272 303 211 315 478],13,5,2484,3.718562874251497,20.0,20.0
8668,2,668,[272 303 211 315 478],537,5,2489,3.720478325859492,20.0,20.0
8669,2,669,[211 218 350 215 231],328,2,2491,3.717910447761194,0.0,20.0
8670,2,670,[290 508 222 509 429],653,1,2492,3.7138599105812222,0.0,20.0
8671,2,671,[272 303 211 315 478],13,5,2497,3.7157738095238093,20.0,20.0
8672,2,672,[283 293 378 208 295],533,3,2500,3.7147102526002973,0.0,0.0
8673,2,673,[300 212 221 218 241],234,0,2500,3.7091988130563798,0.0,20.0
8674,2,674,[272 303 211 315 478],13,5,2505,3.7111111111111112,20.0,20.0
8675,2,675,[272 303 211 315 478],537,5,2510,3.71301775147929,20.0,20.0
8676,2,676,[507 299 222 221 276],537,2,2512,3.7104874446085674,0.0,40.0
8677,2,677,[272 303 211 315 478],537,5,2517,3.7123893805309733,20.0,20.0
8678,2,678,[272 303 211 315 478],13,5,2522,3.7142857142857144,20.0,20.0
8679,2,679,[272 303 211 315 478],537,5,2527,3.7161764705882354,20.0,20.0
8680,2,680,[290 230 254 429 202],804,5,2532,3.7180616740088106,0.0,0.0
8681,2,681,[272 303 211 315 478],13,5,2537,3.719941348973607,20.0,20.0
8682,2,682,[478 378 215 508 208],184,5,2542,3.721815519765739,0.0,0.0
8683,2,683,[272 303 211 315 478],13,5,2547,3.723684210526316,20.0,20.0
8684,2,684,[272 303 211 315 478],13,5,2552,3.7255474452554744,20.0,20.0
8685,2,685,[272 303 211 315 478],13,5,2557,3.727405247813411,20.0,20.0
8686,2,686,[272 303 211 315 478],537,5,2562,3.7292576419213974,20.0,20.0
8687,2,687,[272 303 211 315 478],13,5,2567,3.7311046511627906,20.0,20.0
8688,2,688,[268 212 201 280 208],13,4,2571,3.7314949201741654,0.0,0.0
8689,2,689,[272 303 211 315 478],537,5,2576,3.7333333333333334,20.0,20.0
8690,2,690,[303 241 331 276 212],13,3,2579,3.732272069464544,0.0,20.0
8691,2,691,[272 303 211 315 478],13,5,2584,3.7341040462427744,20.0,20.0
8692,2,692,[272 303 211 315 478],537,5,2589,3.735930735930736,20.0,20.0
8693,2,693,[272 303 211 315 478],537,5,2594,3.7377521613832854,20.0,20.0
8694,2,694,[272 303 211 315 478],537,5,2599,3.739568345323741,20.0,20.0
8695,2,695,[272 303 211 315 478],537,5,2604,3.7413793103448274,20.0,20.0
8696,2,696,[272 303 211 315 478],13,5,2609,3.7431850789096126,20.0,20.0
8697,2,697,[272 303 211 315 478],537,5,2614,3.7449856733524354,20.0,20.0
8698,2,698,[272 303 211 315 478],13,5,2619,3.7467811158798283,20.0,20.0
8699,2,699,[272 303 211 315 478],13,5,2624,3.7485714285714287,20.0,20.0
8700,2,700,[272 303 211 315 478],13,5,2629,3.7503566333808847,20.0,20.0
8701,2,701,[272 303 211 315 478],537,5,2634,3.752136752136752,20.0,20.0
8702,2,702,[272 303 211 315 478],537,5,2639,3.7539118065433854,20.0,20.0
8703,2,703,[272 303 211 315 478],537,5,2644,3.7556818181818183,20.0,20.0
8704,2,704,[272 303 211 315 478],537,5,2649,3.7574468085106383,20.0,20.0
8705,2,705,[272 303 211 315 478],537,5,2654,3.7592067988668556,20.0,20.0
8706,2,706,[216 202 303 507 213],6,3,2657,3.758132956152758,0.0,0.0
8707,2,707,[272 211 303 315 478],13,5,2662,3.7598870056497176,20.0,20.0
8708,2,708,[272 211 303 315 478],537,5,2667,3.76163610719323,20.0,20.0
8709,2,709,[272 211 303 315 478],537,5,2672,3.7633802816901407,20.0,20.0
8710,2,710,[324 226 223 215 213],7,3,2675,3.7623066104078764,20.0,0.0
8711,2,711,[211 241 227 478 350],13,3,2678,3.7612359550561796,0.0,20.0
8712,2,712,[272 211 303 315 478],537,5,2683,3.7629733520336606,20.0,20.0
8713,2,713,[290 331 283 509 275],894,3,2686,3.761904761904762,0.0,20.0
8714,2,714,[272 211 303 315 478],13,5,2691,3.7636363636363637,20.0,20.0
8715,2,715,[272 211 303 315 478],537,5,2696,3.7653631284916202,20.0,20.0
8716,2,716,[272 211 303 315 478],537,5,2701,3.767085076708508,20.0,20.0
8717,2,717,[272 211 303 315 478],537,5,2706,3.768802228412256,20.0,20.0
8718,2,718,[272 211 303 315 478],537,5,2711,3.7705146036161334,20.0,20.0
8719,2,719,[255 201 215 264 429],308,3,2714,3.7694444444444444,0.0,0.0
8720,2,720,[272 211 303 315 478],537,5,2719,3.7711511789181693,20.0,20.0
8721,2,721,[272 211 303 315 478],13,5,2724,3.772853185595568,20.0,20.0
8722,2,722,[272 211 303 315 478],13,5,2729,3.7745504840940525,20.0,20.0
8723,2,723,[272 211 303 315 478],13,5,2734,3.776243093922652,20.0,20.0
8724,2,724,[272 211 303 315 478],537,5,2739,3.7779310344827586,20.0,20.0
8725,2,725,[272 211 303 315 478],13,5,2744,3.7796143250688705,20.0,20.0
8726,2,726,[272 211 303 315 478],13,5,2749,3.781292984869326,20.0,20.0
8727,2,727,[272 211 303 315 478],13,5,2754,3.782967032967033,20.0,20.0
8728,2,728,[275 201 264 509 261],13,2,2756,3.7805212620027433,0.0,20.0
8729,2,729,[272 211 303 315 478],13,5,2761,3.782191780821918,20.0,20.0
8730,2,730,[272 211 303 315 478],537,5,2766,3.783857729138167,20.0,20.0
8731,2,731,[272 211 303 315 478],537,5,2771,3.7855191256830603,20.0,20.0
8732,2,732,[272 211 303 315 478],13,5,2776,3.787175989085948,20.0,20.0
8733,2,733,[272 211 303 315 478],13,5,2781,3.7888283378746594,20.0,20.0
8734,2,734,[303 326 223 246 218],334,3,2784,3.7877551020408164,20.0,0.0
8735,2,735,[272 211 303 315 478],537,5,2789,3.7894021739130435,20.0,20.0
8736,2,736,[272 211 303 315 478],537,5,2794,3.791044776119403,20.0,20.0
8737,2,737,[272 211 303 315 478],13,5,2799,3.792682926829268,20.0,20.0
8738,2,738,[283 215 275 208 284],271,4,2803,3.7929634641407306,0.0,20.0
8739,2,739,[272 211 303 315 478],13,5,2808,3.7945945945945945,20.0,20.0
8740,2,740,[272 211 303 315 478],537,5,2813,3.796221322537112,20.0,20.0
8741,2,741,[507 509 218 230 209],650,2,2815,3.793800539083558,0.0,0.0
8742,2,742,[272 211 303 315 478],13,5,2820,3.7954239569313595,20.0,20.0
8743,2,743,[230 293 222 429 290],653,0,2820,3.7903225806451615,0.0,20.0
8744,2,744,[272 211 303 315 478],537,5,2825,3.791946308724832,20.0,20.0
8745,2,745,[272 211 303 315 478],537,5,2830,3.7935656836461127,20.0,20.0
8746,2,746,[216 321 201 326 202],409,1,2831,3.789825970548862,0.0,0.0
8747,2,747,[272 211 303 315 478],537,5,2836,3.7914438502673797,20.0,20.0
8748,2,748,[272 211 303 315 478],13,5,2841,3.79305740987984,20.0,20.0
8749,2,749,[272 211 303 315 478],13,5,2846,3.7946666666666666,20.0,20.0
8750,2,750,[272 211 303 315 478],537,5,2851,3.796271637816245,20.0,20.0
8751,2,751,[272 211 303 315 478],537,5,2856,3.797872340425532,20.0,20.0
8752,2,752,[394 507 431 316 300],13,1,2857,3.7941567065073043,20.0,20.0
8753,2,753,[272 211 303 315 478],13,5,2862,3.7957559681697615,20.0,20.0
8754,2,754,[272 211 303 315 478],537,5,2867,3.7973509933774836,20.0,20.0
8755,2,755,[264 215 509 300 290],13,4,2871,3.7976190476190474,0.0,20.0
8756,2,756,[272 211 303 315 478],537,5,2876,3.799207397622193,20.0,20.0
8757,2,757,[201 230 276 222 431],13,1,2877,3.795514511873351,0.0,40.0
8758,2,758,[272 211 303 315 478],13,5,2882,3.7971014492753623,20.0,20.0
8759,2,759,[272 211 303 315 478],537,5,2887,3.7986842105263157,20.0,20.0
8760,2,760,[227 243 220 240 216],92,0,2887,3.7936925098554535,0.0,0.0
8761,2,761,[367 478 222 202 227],506,4,2891,3.793963254593176,0.0,20.0
8762,2,762,[272 211 303 315 478],13,5,2896,3.7955439056356486,20.0,20.0
8763,2,763,[344 485 299 223 272],13,2,2898,3.7931937172774868,20.0,0.0
8764,2,764,[215 272 481 217 431],13,2,2900,3.7908496732026142,0.0,0.0
8765,2,765,[272 211 303 315 478],537,5,2905,3.7924281984334205,20.0,20.0
8766,2,766,[272 211 303 315 478],13,5,2910,3.7940026075619295,20.0,20.0
8767,2,767,[272 211 303 315 478],537,5,2915,3.7955729166666665,20.0,20.0
8768,2,768,[272 211 303 315 478],13,5,2920,3.7971391417425226,20.0,20.0
8769,2,769,[272 211 303 315 478],537,5,2925,3.7987012987012987,20.0,20.0
8770,2,770,[272 211 303 315 478],13,5,2930,3.8002594033722437,20.0,20.0
8771,2,771,[272 211 303 315 478],13,5,2935,3.801813471502591,20.0,20.0
8772,2,772,[272 211 303 315 478],13,5,2940,3.8033635187580854,20.0,20.0
8773,2,773,[272 211 303 315 478],13,5,2945,3.804909560723514,20.0,20.0
8774,2,774,[272 431 208 222 429],650,4,2949,3.8051612903225807,0.0,20.0
8775,2,775,[272 211 303 315 478],537,5,2954,3.806701030927835,20.0,20.0
8776,2,776,[272 211 303 315 478],13,5,2959,3.808236808236808,20.0,20.0
8777,2,777,[226 222 478 202 420],749,4,2963,3.808483290488432,0.0,20.0
8778,2,778,[216 276 227 240 223],92,2,2965,3.8061617458279846,20.0,20.0
8779,2,779,[272 211 303 315 478],13,5,2970,3.8076923076923075,20.0,20.0
8780,2,780,[272 211 303 315 478],537,5,2975,3.8092189500640203,20.0,20.0
8781,2,781,[303 227 230 299 218],13,2,2977,3.8069053708439897,0.0,0.0
8782,2,782,[272 211 303 315 478],537,5,2982,3.8084291187739465,20.0,20.0
8783,2,783,[331 291 232 301 218],328,3,2985,3.8073979591836733,0.0,0.0
8784,2,784,[272 211 303 315 478],13,5,2990,3.8089171974522293,20.0,20.0
8785,2,785,[275 316 208 268 276],334,5,2995,3.8104325699745547,20.0,40.0
8786,2,786,[272 211 303 315 478],13,5,3000,3.8119440914866582,20.0,20.0
8787,2,787,[272 211 303 315 478],537,5,3005,3.813451776649746,20.0,20.0
8788,2,788,[272 211 303 315 478],13,5,3010,3.814955640050697,20.0,20.0
8789,2,789,[272 211 303 315 478],13,5,3015,3.8164556962025316,20.0,20.0
8790,2,790,[272 211 303 315 478],13,5,3020,3.81795195954488,20.0,20.0
8791,2,791,[272 211 303 315 478],537,5,3025,3.8194444444444446,20.0,20.0
8792,2,792,[272 211 303 315 478],13,5,3030,3.82093316519546,20.0,20.0
8793,2,793,[236 221 303 250 275],894,5,3035,3.822418136020151,0.0,20.0
8794,2,794,[212 213 231 284 507],537,2,3037,3.820125786163522,0.0,0.0
8795,2,795,[378 241 227 431 208],95,2,3039,3.8178391959798996,0.0,0.0
8796,2,796,[272 211 303 315 478],13,5,3044,3.8193224592220827,20.0,20.0
8797,2,797,[272 211 303 315 478],13,5,3049,3.8208020050125313,20.0,20.0
8798,2,798,[201 206 215 236 208],537,1,3050,3.8172715894868587,0.0,0.0
8799,2,799,[298 208 291 384 201],833,2,3052,3.815,0.0,0.0
8800,2,800,[272 211 303 315 478],537,5,3057,3.816479400749064,20.0,20.0
8801,2,801,[201 232 321 481 290],13,1,3058,3.8129675810473818,0.0,0.0
8802,2,802,[272 211 303 315 478],537,5,3063,3.8144458281444584,20.0,20.0
8803,2,803,[268 239 367 284 218],92,3,3066,3.8134328358208953,0.0,0.0
8804,2,804,[202 509 392 275 241],378,3,3069,3.8124223602484473,0.0,20.0
8805,2,805,[272 211 303 315 478],537,5,3074,3.8138957816377173,20.0,20.0
8806,2,806,[280 344 299 261 384],13,1,3075,3.8104089219330857,0.0,0.0
8807,2,807,[272 211 303 315 478],13,5,3080,3.8118811881188117,20.0,20.0
8808,2,808,[272 211 303 315 478],13,5,3085,3.8133498145859086,20.0,20.0
8809,2,809,[272 211 303 315 478],13,5,3090,3.814814814814815,20.0,20.0
8810,2,810,[213 219 583 208 509],7,2,3092,3.812577065351418,0.0,0.0
8811,2,811,[272 211 303 315 478],537,5,3097,3.814039408866995,20.0,20.0
8812,2,812,[272 211 303 315 478],13,5,3102,3.8154981549815496,20.0,20.0
8813,2,813,[213 272 268 300 236],537,3,3105,3.8144963144963144,0.0,20.0
8814,2,814,[246 208 230 255 220],334,3,3108,3.8134969325153376,0.0,0.0
8815,2,815,[272 211 303 315 478],537,5,3113,3.814950980392157,20.0,20.0
8816,2,816,[272 211 303 315 478],13,5,3118,3.8164014687882495,20.0,20.0
8817,2,817,[275 509 485 209 202],537,3,3121,3.815403422982885,0.0,20.0
8818,2,818,[284 201 254 239 321],279,3,3124,3.8144078144078146,0.0,0.0
8819,2,819,[301 478 221 231 485],537,1,3125,3.8109756097560976,0.0,0.0
8820,2,820,[272 211 303 315 478],13,5,3130,3.8124238733252134,20.0,20.0
8821,2,821,[272 211 303 315 478],537,5,3135,3.8138686131386863,20.0,20.0
8822,2,822,[272 211 303 315 478],537,5,3140,3.8153098420413123,20.0,20.0
8823,2,823,[222 201 215 290 336],13,2,3142,3.813106796116505,0.0,20.0
8824,2,824,[272 211 303 315 478],13,5,3147,3.8145454545454545,20.0,20.0
8825,2,825,[272 211 303 315 478],13,5,3152,3.8159806295399514,20.0,20.0
8826,2,826,[272 211 303 315 478],537,5,3157,3.8174123337363968,20.0,20.0
8827,2,827,[215 485 298 264 255],479,0,3157,3.8128019323671496,0.0,0.0
8828,2,828,[272 211 303 315 478],13,5,3162,3.814234016887817,20.0,20.0
8829,2,829,[272 211 303 315 478],13,5,3167,3.81566265060241,20.0,20.0
8830,2,830,[272 211 303 315 478],13,5,3172,3.8170878459687123,20.0,20.0
8831,2,831,[272 211 303 315 478],537,5,3177,3.8185096153846154,20.0,20.0
8832,2,832,[272 211 303 315 478],13,5,3182,3.8199279711884753,20.0,20.0
8833,2,833,[272 211 303 315 478],13,5,3187,3.821342925659472,20.0,20.0
8834,2,834,[272 211 303 315 478],537,5,3192,3.8227544910179643,20.0,20.0
8835,2,835,[272 211 303 315 478],537,5,3197,3.824162679425837,20.0,20.0
8836,2,836,[272 211 303 315 478],13,5,3202,3.825567502986858,20.0,20.0
8837,2,837,[293 209 219 298 508],833,5,3207,3.8269689737470167,0.0,0.0
8838,2,838,[272 211 303 315 478],537,5,3212,3.828367103694875,20.0,20.0
8839,2,839,[272 211 303 315 478],13,5,3217,3.829761904761905,20.0,20.0
8840,2,840,[272 211 303 315 478],537,5,3222,3.83115338882283,20.0,20.0
8841,2,841,[272 211 303 315 478],13,5,3227,3.832541567695962,20.0,20.0
8842,2,842,[272 211 303 315 478],13,5,3232,3.833926453143535,20.0,20.0
8843,2,843,[268 202 321 283 507],537,3,3235,3.8329383886255926,0.0,0.0
8844,2,844,[272 211 303 315 478],537,5,3240,3.834319526627219,20.0,20.0
8845,2,845,[226 256 283 275 208],883,4,3244,3.83451536643026,0.0,20.0
8846,2,846,[219 201 212 211 240],59,4,3248,3.834710743801653,0.0,20.0
8847,2,847,[272 211 303 315 478],13,5,3253,3.8360849056603774,20.0,20.0
8848,2,848,[272 211 303 315 478],13,5,3258,3.8374558303886928,20.0,20.0
8849,2,849,[272 211 303 315 478],537,5,3263,3.8388235294117647,20.0,20.0
8850,2,850,[272 211 303 315 478],13,5,3268,3.8401880141010576,20.0,20.0
8851,2,851,[272 211 303 315 478],13,5,3273,3.841549295774648,20.0,20.0
8852,2,852,[272 211 303 315 478],13,5,3278,3.842907385697538,20.0,20.0
8853,2,853,[272 211 303 315 478],13,5,3283,3.8442622950819674,20.0,20.0
8854,2,854,[272 211 303 315 478],537,5,3288,3.8456140350877193,20.0,20.0
8855,2,855,[230 478 241 431 276],200,5,3293,3.84696261682243,0.0,20.0
8856,2,856,[272 211 303 315 478],13,5,3298,3.84830805134189,20.0,20.0
8857,2,857,[291 208 254 284 231],899,1,3299,3.844988344988345,0.0,0.0
8858,2,858,[272 211 303 315 478],537,5,3304,3.8463329452852153,20.0,20.0
8859,2,859,[208 259 429 478 485],524,1,3305,3.8430232558139537,0.0,0.0
8860,2,860,[272 211 303 315 478],13,5,3310,3.8443670150987224,20.0,20.0
8861,2,861,[272 211 303 315 478],13,5,3315,3.8457076566125292,20.0,20.0
8862,2,862,[272 211 303 315 478],13,5,3320,3.847045191193511,20.0,20.0
8863,2,863,[272 211 303 315 478],13,5,3325,3.8483796296296298,20.0,20.0
8864,2,864,[272 211 303 315 478],537,5,3330,3.8497109826589595,20.0,20.0
8865,2,865,[316 246 216 250 293],145,5,3335,3.851039260969977,20.0,0.0
8866,2,866,[227 316 230 239 303],13,4,3339,3.85121107266436,20.0,0.0
8867,2,867,[272 211 303 315 478],537,5,3344,3.8525345622119818,20.0,20.0
8868,2,868,[583 201 321 367 223],387,3,3347,3.851553509781358,20.0,0.0
8869,2,869,[272 211 303 315 478],537,5,3352,3.852873563218391,20.0,20.0
8870,2,870,[272 211 303 315 478],537,5,3357,3.854190585533869,20.0,20.0
8871,2,871,[272 211 303 315 478],537,5,3362,3.8555045871559632,20.0,20.0
8872,2,872,[272 211 303 315 478],13,5,3367,3.856815578465063,20.0,20.0
8873,2,873,[272 211 303 315 478],537,5,3372,3.85812356979405,20.0,20.0
8874,2,874,[272 211 303 315 478],13,5,3377,3.8594285714285714,20.0,20.0
8875,2,875,[272 211 303 315 478],537,5,3382,3.8607305936073057,20.0,20.0
8876,2,876,[272 211 303 315 478],537,5,3387,3.862029646522235,20.0,20.0
8877,2,877,[272 230 261 218 215],13,2,3389,3.859908883826879,0.0,0.0
8878,2,878,[272 211 303 315 478],537,5,3394,3.861205915813424,20.0,20.0
8879,2,879,[272 211 303 315 478],13,5,3399,3.8625,20.0,20.0
8880,2,880,[219 264 365 227 215],7,3,3402,3.8615209988649264,0.0,0.0
8881,2,881,[211 275 420 321 326],311,1,3403,3.8582766439909295,0.0,40.0
8882,2,882,[365 211 230 250 202],804,5,3408,3.8595696489241225,0.0,20.0
8883,2,883,[202 219 208 206 212],650,2,3410,3.8574660633484164,0.0,0.0
8884,2,884,[272 303 315 211 478],13,5,3415,3.8587570621468927,20.0,20.0
8885,2,885,[272 303 315 211 478],13,5,3420,3.860045146726862,20.0,20.0
8886,2,886,[272 303 315 211 478],13,5,3425,3.8613303269447576,20.0,20.0
8887,2,887,[272 303 315 211 478],13,5,3430,3.8626126126126126,20.0,20.0
8888,2,888,[272 303 315 211 478],537,5,3435,3.8638920134983126,20.0,20.0
8889,2,889,[201 216 208 298 283],308,3,3438,3.8629213483146065,0.0,0.0
8890,2,890,[272 303 315 211 478],13,5,3443,3.8641975308641974,20.0,20.0
8891,2,891,[272 303 315 211 478],537,5,3448,3.8654708520179373,20.0,20.0
8892,2,892,[272 303 315 211 478],537,5,3453,3.8667413213885777,20.0,20.0
8893,2,893,[272 303 315 211 478],537,5,3458,3.868008948545861,20.0,20.0
8894,2,894,[272 303 315 211 478],537,5,3463,3.86927374301676,20.0,20.0
8895,2,895,[264 272 481 300 326],13,2,3465,3.8671875,0.0,20.0
8896,2,896,[223 215 420 295 226],308,2,3467,3.8651059085841695,20.0,0.0
8897,2,897,[272 303 315 211 478],13,5,3472,3.866369710467706,20.0,20.0
8898,2,898,[272 303 315 211 478],537,5,3477,3.867630700778643,20.0,20.0
8899,2,899,[272 303 315 211 478],537,5,3482,3.868888888888889,20.0,20.0
8900,2,900,[213 297 221 223 316],894,5,3487,3.8701442841287457,60.0,0.0
8901,2,901,[272 303 315 211 478],537,5,3492,3.87139689578714,20.0,20.0
8902,2,902,[272 303 315 211 478],537,5,3497,3.8726467331118495,20.0,20.0
8903,2,903,[272 303 315 211 478],537,5,3502,3.8738938053097347,20.0,20.0
8904,2,904,[272 303 315 211 478],537,5,3507,3.875138121546961,20.0,20.0
8905,2,905,[272 303 315 211 478],537,5,3512,3.876379690949227,20.0,20.0
8906,2,906,[230 272 212 239 222],215,1,3513,3.8732083792723264,0.0,20.0
8907,2,907,[272 303 315 211 478],537,5,3518,3.8744493392070485,20.0,20.0
8908,2,908,[272 303 315 211 478],13,5,3523,3.8756875687568755,20.0,20.0
8909,2,909,[276 223 429 202 420],13,5,3528,3.876923076923077,20.0,20.0
8910,2,910,[272 303 315 211 478],537,5,3533,3.8781558726673984,20.0,20.0
8911,2,911,[272 303 315 211 478],537,5,3538,3.879385964912281,20.0,20.0
8912,2,912,[272 303 315 211 478],537,5,3543,3.8806133625410735,20.0,20.0
8913,2,913,[303 268 272 291 276],537,4,3547,3.8807439824945296,0.0,20.0
8914,2,914,[272 303 315 211 478],537,5,3552,3.8819672131147542,20.0,20.0
8915,2,915,[272 303 315 211 478],13,5,3557,3.8831877729257642,20.0,20.0
8916,2,916,[326 201 276 485 336],13,1,3558,3.880043620501636,0.0,20.0
8917,2,917,[272 303 315 211 478],13,5,3563,3.8812636165577343,20.0,20.0
8918,2,918,[208 275 276 378 478],233,5,3568,3.882480957562568,0.0,40.0
8919,2,919,[272 303 315 211 478],13,5,3573,3.883695652173913,20.0,20.0
8920,2,920,[384 217 290 209 429],385,2,3575,3.8816503800217155,0.0,0.0
8921,2,921,[272 303 315 211 478],537,5,3580,3.882863340563991,20.0,20.0
8922,2,922,[272 303 315 211 478],13,5,3585,3.884073672806067,20.0,20.0
8923,2,923,[272 303 315 211 478],537,5,3590,3.8852813852813854,20.0,20.0
8924,2,924,[272 303 315 211 478],537,5,3595,3.8864864864864863,20.0,20.0
8925,2,925,[272 303 315 211 478],537,5,3600,3.8876889848812093,20.0,20.0
8926,2,926,[215 208 206 291 231],804,4,3604,3.887810140237325,0.0,0.0
8927,2,927,[272 303 315 211 478],537,5,3609,3.8890086206896552,20.0,20.0
8928,2,928,[336 217 485 239 344],13,1,3610,3.8858988159311085,0.0,0.0
8929,2,929,[272 303 315 211 478],13,5,3615,3.8870967741935485,20.0,20.0
8930,2,930,[272 303 315 211 478],13,5,3620,3.888292158968851,20.0,20.0
8931,2,931,[202 478 243 301 211],650,2,3622,3.8862660944206007,0.0,20.0
8932,2,932,[272 303 315 211 478],13,5,3627,3.887459807073955,20.0,20.0
8933,2,933,[295 299 315 246 255],116,1,3628,3.8843683083511777,20.0,0.0
8934,2,934,[272 303 211 315 478],537,5,3633,3.8855614973262034,20.0,20.0
8935,2,935,[272 303 211 315 478],13,5,3638,3.8867521367521367,20.0,20.0
8936,2,936,[272 303 211 315 478],537,5,3643,3.887940234791889,20.0,20.0
8937,2,937,[272 303 211 315 478],537,5,3648,3.8891257995735606,20.0,20.0
8938,2,938,[429 230 239 218 250],387,1,3649,3.88604898828541,0.0,0.0
8939,2,939,[384 485 239 275 264],13,2,3651,3.8840425531914895,0.0,20.0
8940,2,940,[239 251 212 275 276],883,4,3655,3.8841657810839534,20.0,40.0
8941,2,941,[392 219 507 276 215],308,2,3657,3.8821656050955413,0.0,20.0
8942,2,942,[326 481 384 272 230],13,1,3658,3.8791092258748674,0.0,0.0
8943,2,943,[508 315 429 413 367],13,2,3660,3.8771186440677967,20.0,0.0
8944,2,944,[218 413 239 485 315],13,2,3662,3.875132275132275,20.0,0.0
8945,2,945,[217 452 272 231 223],650,1,3663,3.872093023255814,20.0,0.0
8946,2,946,[211 367 275 316 212],883,5,3668,3.873284054910243,20.0,40.0
8947,2,947,[231 218 213 227 241],311,4,3672,3.8734177215189876,0.0,0.0
8948,2,948,[240 367 452 231 202],92,0,3672,3.869336143308746,0.0,0.0
8949,2,949,[218 420 350 413 303],13,2,3674,3.867368421052632,0.0,0.0
8950,2,950,[315 240 236 452 202],145,3,3677,3.8664563617245005,20.0,0.0
8951,2,951,[255 276 250 336 280],894,2,3679,3.8644957983193278,0.0,20.0
8952,2,952,[208 276 217 215 508],406,3,3682,3.863588667366212,0.0,20.0
8953,2,953,[301 201 208 392 215],537,1,3683,3.860587002096436,0.0,0.0
8954,2,954,[378 321 291 239 216],537,0,3683,3.856544502617801,0.0,0.0
8955,2,955,[232 208 218 429 216],59,4,3687,3.8566945606694563,0.0,0.0
8956,2,956,[291 218 303 283 508],533,2,3689,3.8547544409613375,0.0,0.0
8957,2,957,[316 367 290 211 284],207,2,3691,3.8528183716075155,20.0,20.0
8958,2,958,[219 367 431 231 240],648,2,3693,3.8508863399374347,0.0,0.0
8959,2,959,[219 202 452 367 420],13,2,3695,3.8489583333333335,0.0,0.0
8960,2,960,[222 367 303 211 208],87,4,3699,3.849115504682622,0.0,40.0
8961,2,961,[431 315 211 508 413],13,2,3701,3.8471933471933473,20.0,20.0
8962,2,962,[209 324 227 208 367],506,3,3704,3.8463136033229492,0.0,0.0
8963,2,963,[431 315 508 211 231],537,4,3708,3.8464730290456433,20.0,20.0
8964,2,964,[259 275 583 208 218],308,4,3712,3.8466321243523316,0.0,20.0
8965,2,965,[216 509 208 220 217],184,3,3715,3.8457556935817805,0.0,0.0
8966,2,966,[223 264 367 420 259],308,3,3718,3.8448810754912097,20.0,0.0
8967,2,967,[243 216 232 478 303],13,2,3720,3.84297520661157,0.0,0.0
8968,2,968,[268 236 507 300 202],537,2,3722,3.8410732714138285,0.0,20.0
8969,2,969,[284 481 241 367 212],524,4,3726,3.841237113402062,0.0,0.0
8970,2,970,[255 201 223 264 429],308,4,3730,3.8414006179196702,20.0,0.0
8971,2,971,[222 226 367 232 239],311,2,3732,3.8395061728395063,0.0,20.0
8972,2,972,[202 239 431 231 208],311,4,3736,3.83967112024666,0.0,0.0
8973,2,973,[507 420 231 218 259],308,2,3738,3.837782340862423,0.0,0.0
8974,2,974,[321 246 226 219 223],387,1,3739,3.8348717948717947,20.0,0.0
8975,2,975,[291 223 226 429 478],234,1,3740,3.831967213114754,20.0,0.0
8976,2,976,[221 268 299 509 315],894,3,3743,3.8311156601842375,20.0,0.0
8977,2,977,[202 284 209 303 485],537,2,3745,3.829243353783231,0.0,0.0
8978,2,978,[230 431 316 222 215],474,4,3749,3.829417773237998,20.0,20.0
8979,2,979,[326 316 230 481 290],334,3,3752,3.8285714285714287,20.0,0.0
8980,2,980,[250 295 420 202 208],749,3,3755,3.8277268093781855,0.0,0.0
8981,2,981,[300 217 331 218 299],13,0,3755,3.8238289205702647,0.0,20.0
8982,2,982,[255 509 301 231 321],378,2,3757,3.821973550356053,0.0,0.0
8983,2,983,[481 209 509 275 221],90,5,3762,3.823170731707317,0.0,20.0
8984,2,984,[219 250 291 231 217],648,2,3764,3.821319796954315,0.0,0.0
8985,2,985,[211 241 384 272 326],13,2,3766,3.81947261663286,0.0,20.0
8986,2,986,[315 222 218 276 413],13,2,3768,3.817629179331307,20.0,40.0
8987,2,987,[276 236 316 367 283],234,2,3770,3.8157894736842106,20.0,20.0
8988,2,988,[392 276 367 275 218],308,5,3775,3.8169868554095046,0.0,40.0
8989,2,989,[231 209 283 240 509],279,2,3777,3.815151515151515,0.0,0.0
8990,2,990,[241 226 280 218 336],13,2,3779,3.8133198789101916,0.0,0.0
8991,2,991,[350 316 201 384 218],13,1,3780,3.810483870967742,20.0,0.0
8992,2,992,[283 507 276 259 221],537,3,3783,3.809667673716012,0.0,20.0
8993,2,993,[481 217 243 201 507],13,0,3783,3.805835010060362,0.0,0.0
8994,2,994,[216 297 251 215 508],144,5,3788,3.8070351758793968,40.0,0.0
8995,2,995,[243 220 367 215 219],92,2,3790,3.8052208835341363,0.0,0.0
8996,2,996,[264 209 202 331 290],13,3,3793,3.8044132397191577,0.0,0.0
8997,2,997,[209 284 478 231 290],537,2,3795,3.802605210420842,0.0,0.0
8998,2,998,[293 350 221 297 326],894,3,3798,3.8018018018018016,20.0,0.0
8999,2,999,[211 316 299 264 272],13,4,3802,3.802,20.0,20.0
9000,2,1000,[378 290 209 216 508],537,2,3804,3.8001998001998003,0.0,0.0
9001,2,1001,[331 250 315 350 336],894,3,3807,3.7994011976047903,20.0,0.0
9002,2,1002,[208 378 231 290 315],537,2,3809,3.7976071784646064,20.0,0.0
9003,2,1003,[232 219 321 227 303],13,2,3811,3.795816733067729,0.0,0.0
9004,2,1004,[367 232 272 384 223],13,2,3813,3.7940298507462686,20.0,0.0
9005,2,1005,[290 331 241 275 217],13,1,3814,3.7912524850894633,0.0,20.0
9006,2,1006,[275 509 218 413 243],13,1,3815,3.788480635551142,0.0,20.0
9007,2,1007,[213 202 216 220 255],378,3,3818,3.7876984126984126,0.0,0.0
9008,2,1008,[239 293 429 226 209],308,3,3821,3.786917740336967,0.0,0.0
9009,2,1009,[275 227 321 284 301],524,1,3822,3.784158415841584,0.0,20.0
9010,2,1010,[429 367 209 230 452],833,1,3823,3.781404549950544,0.0,0.0
9011,2,1011,[239 431 241 212 299],537,1,3824,3.7786561264822134,0.0,0.0
9012,2,1012,[485 315 212 300 283],537,2,3826,3.7769002961500493,20.0,20.0
9013,2,1013,[218 219 284 293 283],308,3,3829,3.7761341222879685,0.0,0.0
9014,2,1014,[222 244 315 478 216],474,5,3834,3.7773399014778324,20.0,20.0
9015,2,1015,[300 211 217 232 231],64,1,3835,3.7746062992125986,0.0,40.0
9016,2,1016,[212 215 509 290 211],537,2,3837,3.7728613569321534,0.0,20.0
9017,2,1017,[508 301 507 239 284],537,2,3839,3.7711198428290764,0.0,0.0
9018,2,1018,[272 243 275 215 303],537,3,3842,3.77036310107949,0.0,20.0
9019,2,1019,[208 268 217 300 264],13,3,3845,3.769607843137255,0.0,20.0
9020,2,1020,[276 275 478 250 508],343,5,3850,3.7708129285014693,0.0,40.0
9021,2,1021,[301 350 316 232 215],13,2,3852,3.7690802348336594,20.0,0.0
9022,2,1022,[211 300 290 231 378],537,1,3853,3.766373411534702,0.0,40.0
9023,2,1023,[241 226 509 216 276],13,3,3856,3.765625,0.0,20.0
9024,2,1024,[218 215 283 507 211],234,1,3857,3.7629268292682925,0.0,20.0
9025,2,1025,[331 264 413 315 209],13,2,3859,3.7612085769980506,20.0,0.0
9026,2,1026,[215 226 378 508 275],537,2,3861,3.759493670886076,0.0,20.0
9027,2,1027,[293 275 208 216 246],334,3,3864,3.7587548638132295,0.0,20.0
9028,2,1028,[211 226 230 367 298],738,1,3865,3.7560738581146746,0.0,20.0
9029,2,1029,[268 226 215 211 290],537,2,3867,3.754368932038835,0.0,20.0
9030,2,1030,[301 290 275 413 222],279,3,3870,3.7536372453928224,0.0,40.0
9031,2,1031,[276 211 255 293 201],308,5,3875,3.75484496124031,0.0,40.0
9032,2,1032,[367 280 420 201 276],13,3,3878,3.7541142303969024,0.0,20.0
9033,2,1033,[276 230 315 299 321],13,2,3880,3.7524177949709863,20.0,20.0
9034,2,1034,[222 208 508 209 301],13,1,3881,3.74975845410628,0.0,20.0
9035,2,1035,[226 303 272 452 478],13,4,3885,3.75,0.0,0.0
9036,2,1036,[216 300 268 321 221],234,0,3885,3.746383799421408,0.0,20.0
9037,2,1037,[300 392 218 315 431],311,5,3890,3.7475915221579963,20.0,20.0
9038,2,1038,[485 227 230 367 290],13,2,3892,3.7459095283926853,0.0,0.0
9039,2,1039,[290 208 227 298 241],158,3,3895,3.7451923076923075,0.0,0.0
9040,2,1040,[299 290 431 223 218],13,2,3897,3.7435158501440924,20.0,0.0
9041,2,1041,[227 212 301 303 208],13,4,3901,3.7437619961612283,0.0,0.0
9042,2,1042,[324 213 216 232 365],7,2,3903,3.7420901246404603,0.0,0.0
9043,2,1043,[227 220 208 202 219],92,2,3905,3.7404214559386975,0.0,0.0
9044,2,1044,[226 299 321 272 209],13,2,3907,3.738755980861244,0.0,0.0
9045,2,1045,[384 316 413 300 208],13,2,3909,3.737093690248566,20.0,20.0
9046,2,1046,[239 246 208 431 222],92,5,3914,3.738299904489016,0.0,20.0
9047,2,1047,[202 478 215 268 315],13,5,3919,3.739503816793893,20.0,0.0
9048,2,1048,[301 259 230 268 283],537,2,3921,3.737845567206864,0.0,0.0
9049,2,1049,[243 413 431 250 367],804,3,3924,3.737142857142857,0.0,0.0
9050,2,1050,[209 367 239 420 216],406,2,3926,3.735490009514748,0.0,0.0
9051,2,1051,[213 283 218 255 223],334,3,3929,3.7347908745247147,20.0,0.0
9052,2,1052,[246 324 315 276 275],894,4,3933,3.735042735042735,20.0,40.0
9053,2,1053,[384 290 420 344 367],13,2,3935,3.7333965844402277,0.0,0.0
9054,2,1054,[202 211 321 226 241],308,3,3938,3.732701421800948,0.0,20.0
9055,2,1055,[243 481 344 290 272],13,2,3940,3.731060606060606,0.0,0.0
9056,2,1056,[221 283 326 481 211],474,3,3943,3.730368968779565,0.0,20.0
9057,2,1057,[264 231 259 241 268],7,2,3945,3.728733459357278,0.0,0.0
9058,2,1058,[331 209 226 384 272],13,2,3947,3.7271010387157695,0.0,0.0
9059,2,1059,[431 316 283 290 291],234,1,3948,3.7245283018867923,20.0,0.0
9060,2,1060,[215 209 378 420 232],85,4,3952,3.7247879359095193,0.0,0.0
9061,2,1061,[485 268 275 241 239],537,2,3954,3.7231638418079096,0.0,20.0
9062,2,1062,[222 208 276 485 244],334,3,3957,3.722483537158984,0.0,40.0
9063,2,1063,[219 261 315 429 276],13,3,3960,3.7218045112781954,20.0,20.0
9064,2,1064,[283 217 509 275 250],184,4,3964,3.7220657276995306,0.0,20.0
9065,2,1065,[230 211 431 250 206],833,1,3965,3.7195121951219514,0.0,20.0
9066,2,1066,[507 367 222 218 215],234,2,3967,3.717900656044986,0.0,20.0
9067,2,1067,[276 509 213 218 230],308,5,3972,3.7191011235955056,0.0,20.0
9068,2,1068,[231 202 508 481 367],643,3,3975,3.7184284377923293,0.0,0.0
9069,2,1069,[223 365 259 215 239],308,1,3976,3.71588785046729,20.0,0.0
9070,2,1070,[284 431 246 240 230],92,2,3978,3.7142857142857144,0.0,0.0
9071,2,1071,[300 208 452 268 290],13,3,3981,3.7136194029850746,0.0,20.0
9072,2,1072,[250 284 216 223 280],749,4,3985,3.7138863000931965,20.0,0.0
9073,2,1073,[378 275 297 283 276],533,3,3988,3.713221601489758,20.0,40.0
9074,2,1074,[240 429 211 231 300],749,4,3992,3.7134883720930234,0.0,40.0
9075,2,1075,[315 367 478 211 378],650,2,3994,3.7118959107806693,20.0,20.0
9076,2,1076,[230 201 212 280 211],13,3,3997,3.711234911792015,0.0,20.0
9077,2,1077,[481 215 213 321 226],308,2,3999,3.7096474953617813,0.0,0.0
9078,2,1078,[431 315 268 215 276],537,4,4003,3.7099165894346617,20.0,20.0
9079,2,1079,[481 301 315 223 300],328,3,4006,3.7092592592592593,40.0,20.0
9080,2,1080,[481 232 209 268 508],85,3,4009,3.7086031452358927,0.0,0.0
9081,2,1081,[222 227 378 429 208],897,4,4013,3.7088724584103514,0.0,20.0
9082,2,1082,[217 211 275 315 321],13,2,4015,3.7072945521698983,20.0,40.0
9083,2,1083,[303 508 206 213 283],537,4,4019,3.7075645756457565,0.0,0.0
9084,2,1084,[241 226 202 316 431],102,1,4020,3.705069124423963,20.0,0.0
9085,2,1085,[216 293 213 208 209],308,4,4024,3.705340699815838,0.0,0.0
9086,2,1086,[367 321 268 231 250],387,1,4025,3.702851885924563,0.0,0.0
9087,2,1087,[485 227 367 583 212],59,3,4028,3.702205882352941,0.0,0.0
9088,2,1088,[276 326 336 236 331],894,3,4031,3.7015610651974287,0.0,20.0
9089,2,1089,[250 222 202 211 367],883,3,4034,3.7009174311926607,0.0,40.0
9090,2,1090,[211 413 315 336 202],13,3,4037,3.700274977085243,20.0,20.0
9091,2,1091,[226 284 243 236 216],533,3,4040,3.6996336996337,0.0,0.0
9092,2,1092,[293 283 509 295 284],894,2,4042,3.69807868252516,0.0,0.0
9093,2,1093,[222 243 315 300 290],537,1,4043,3.6956124314442413,20.0,40.0
9094,2,1094,[367 583 217 303 211],343,4,4047,3.695890410958904,0.0,20.0
9095,2,1095,[227 236 303 508 246],334,3,4050,3.6952554744525545,0.0,0.0
9096,2,1096,[236 230 509 213 241],537,2,4052,3.6937101185050136,0.0,0.0
9097,2,1097,[485 221 508 272 202],6,3,4055,3.693078324225865,0.0,0.0
9098,2,1098,[508 303 211 392 241],537,3,4058,3.692447679708826,0.0,20.0
9099,2,1099,[220 217 216 485 280],378,2,4060,3.690909090909091,0.0,0.0
9100,2,1100,[254 209 213 583 219],308,3,4063,3.690281562216167,0.0,0.0
9101,2,1101,[384 222 212 394 216],13,1,4064,3.6878402903811254,0.0,20.0
9102,2,1102,[218 481 321 293 283],308,3,4067,3.687216681776972,0.0,0.0
9103,2,1103,[230 202 239 272 509],650,2,4069,3.6856884057971016,0.0,0.0
9104,2,1104,[209 452 219 331 367],13,0,4069,3.6823529411764704,0.0,0.0
9105,2,1105,[227 293 367 295 431],387,2,4071,3.680831826401447,0.0,0.0
9106,2,1106,[216 239 223 213 283],334,3,4074,3.6802168021680215,20.0,0.0
9107,2,1107,[429 413 367 290 384],279,4,4078,3.6805054151624548,0.0,0.0
9108,2,1108,[316 215 218 431 227],13,3,4081,3.679891794409378,20.0,0.0
9109,2,1109,[230 429 216 250 206],843,2,4083,3.6783783783783783,0.0,0.0
9110,2,1110,[208 221 508 201 268],537,3,4086,3.677767776777678,0.0,0.0
9111,2,1111,[239 219 231 378 223],308,1,4087,3.675359712230216,20.0,0.0
9112,2,1112,[230 293 211 226 283],308,3,4090,3.674752920035939,0.0,20.0
9113,2,1113,[226 300 222 230 202],533,5,4095,3.6759425493716336,0.0,40.0
9114,2,1114,[232 367 215 485 213],311,2,4097,3.674439461883408,0.0,0.0
9115,2,1115,[276 243 232 429 290],59,2,4099,3.6729390681003586,0.0,20.0
9116,2,1116,[350 315 321 268 232],13,2,4101,3.6714413607878247,20.0,0.0
9117,2,1117,[208 222 378 431 452],650,2,4103,3.6699463327370303,0.0,20.0
9118,2,1118,[280 215 212 290 299],13,4,4107,3.670241286863271,0.0,0.0
9119,2,1119,[212 211 509 206 315],650,2,4109,3.66875,20.0,20.0
9120,2,1120,[209 259 211 293 202],6,2,4111,3.6672613737734165,0.0,20.0
9121,2,1121,[429 367 226 268 243],387,0,4111,3.663992869875223,0.0,0.0
9122,2,1122,[211 216 272 301 223],6,4,4115,3.664292074799644,20.0,20.0
9123,2,1123,[219 226 222 295 209],92,3,4118,3.6637010676156585,0.0,20.0
9124,2,1124,[226 219 232 431 216],7,3,4121,3.663111111111111,0.0,0.0
9125,2,1125,[303 226 413 231 367],13,2,4123,3.661634103019538,0.0,0.0
9126,2,1126,[431 222 316 219 239],102,0,4123,3.658385093167702,20.0,20.0
9127,2,1127,[344 215 300 212 275],13,2,4125,3.6569148936170213,0.0,40.0
9128,2,1128,[452 508 202 429 264],833,2,4127,3.6554472984942428,0.0,0.0
9129,2,1129,[284 293 209 378 208],749,5,4132,3.656637168141593,0.0,0.0
9130,2,1130,[378 290 291 212 321],537,0,4132,3.6534040671971706,0.0,0.0
9131,2,1131,[226 227 239 230 384],13,3,4135,3.652826855123675,0.0,0.0
9132,2,1132,[227 264 231 215 268],7,2,4137,3.651368049426302,0.0,0.0
9133,2,1133,[218 268 211 280 272],13,4,4141,3.6516754850088184,0.0,20.0
9134,2,1134,[230 321 316 344 226],197,4,4145,3.6519823788546257,20.0,0.0
9135,2,1135,[231 247 239 226 230],374,3,4148,3.6514084507042255,0.0,0.0
9136,2,1136,[231 508 485 209 240],385,3,4151,3.6508355321020227,0.0,0.0
9137,2,1137,[507 220 300 244 216],271,1,4152,3.648506151142355,0.0,20.0
9138,2,1138,[222 336 217 509 413],13,1,4153,3.646180860403863,0.0,20.0
9139,2,1139,[259 507 485 213 276],6,3,4156,3.645614035087719,0.0,20.0
9140,2,1140,[431 367 230 300 291],653,3,4159,3.645048203330412,0.0,20.0
9141,2,1141,[221 429 275 213 478],524,2,4161,3.6436077057793343,0.0,20.0
9142,2,1142,[255 390 324 221 268],116,3,4164,3.643044619422572,0.0,0.0
9143,2,1143,[429 208 211 290 202],59,4,4168,3.6433566433566433,0.0,20.0
9144,2,1144,[344 301 230 326 272],13,1,4169,3.641048034934498,0.0,0.0
9145,2,1145,[481 259 219 284 208],234,2,4171,3.6396160558464223,0.0,0.0
9146,2,1146,[303 261 215 478 243],13,3,4174,3.6390584132519614,0.0,0.0
9147,2,1147,[211 299 284 291 509],537,2,4176,3.637630662020906,0.0,20.0
9148,2,1148,[208 211 508 264 316],13,4,4180,3.6379460400348127,20.0,20.0
9149,2,1149,[300 452 276 243 226],13,2,4182,3.6365217391304347,0.0,40.0
9150,2,1150,[216 429 284 452 255],308,3,4185,3.6359687228496957,0.0,0.0
9151,2,1151,[219 301 452 232 508],13,0,4185,3.6328125,0.0,0.0
9152,2,1152,[392 213 243 429 268],537,2,4187,3.6313963573287076,0.0,0.0
9153,2,1153,[384 452 508 209 215],13,1,4188,3.6291161178509532,0.0,0.0
9154,2,1154,[331 232 326 215 321],13,1,4189,3.6268398268398268,0.0,0.0
9155,2,1155,[244 216 293 508 315],474,4,4193,3.6271626297577853,20.0,0.0
9156,2,1156,[259 212 232 481 241],85,1,4194,3.6248919619706137,0.0,0.0
9157,2,1157,[321 230 290 232 509],13,2,4196,3.623488773747841,0.0,0.0
9158,2,1158,[394 212 218 222 261],13,1,4197,3.6212251941328732,0.0,20.0
9159,2,1159,[481 485 230 215 259],308,2,4199,3.6198275862068967,0.0,0.0
9160,2,1160,[232 227 231 431 429],650,1,4200,3.6175710594315245,0.0,0.0
9161,2,1161,[324 255 275 331 244],894,3,4203,3.617039586919105,0.0,20.0
9162,2,1162,[378 206 230 284 226],537,0,4203,3.6139294926913155,0.0,0.0
9163,2,1163,[283 264 236 293 276],894,3,4206,3.61340206185567,0.0,20.0
9164,2,1164,[295 290 413 431 216],648,3,4209,3.612875536480687,0.0,0.0
9165,2,1165,[212 367 250 202 243],92,2,4211,3.611492281303602,0.0,0.0
9166,2,1166,[284 367 239 241 321],378,1,4212,3.609254498714653,0.0,0.0
9167,2,1167,[276 420 365 367 220],378,2,4214,3.607876712328767,0.0,20.0
9168,2,1168,[300 283 227 280 226],378,2,4216,3.6065012831479897,0.0,20.0
9169,2,1169,[212 250 218 241 508],339,4,4220,3.606837606837607,0.0,0.0
9170,2,1170,[268 284 367 241 508],92,2,4222,3.605465414175918,0.0,0.0
9171,2,1171,[295 218 429 507 222],648,3,4225,3.604948805460751,0.0,20.0
9172,2,1172,[293 303 230 316 255],334,3,4228,3.604433077578858,20.0,0.0
9173,2,1173,[295 290 275 227 507],648,2,4230,3.603066439522998,0.0,20.0
9174,2,1174,[378 429 264 367 208],833,0,4230,3.6,0.0,0.0
9175,2,1175,[301 316 211 509 215],85,4,4234,3.6003401360544216,20.0,20.0
9176,2,1176,[316 413 216 298 212],145,2,4236,3.598980458793543,20.0,0.0
9177,2,1177,[507 220 276 226 321],59,4,4240,3.5993208828522922,0.0,20.0
9178,2,1178,[213 284 202 208 283],308,4,4244,3.5996607294317218,0.0,0.0
9179,2,1179,[264 326 303 300 301],13,2,4246,3.5983050847457627,0.0,20.0
9180,2,1180,[227 222 276 431 241],92,3,4249,3.5977984758679087,0.0,40.0
9181,2,1181,[231 202 485 230 321],537,0,4249,3.5947546531302876,0.0,0.0
9182,2,1182,[413 241 232 331 350],13,0,4249,3.591715976331361,0.0,0.0
9183,2,1183,[231 509 215 211 221],85,3,4252,3.5912162162162162,0.0,20.0
9184,2,1184,[275 276 478 218 250],184,4,4256,3.5915611814345993,0.0,40.0
9185,2,1185,[226 255 211 241 201],308,4,4260,3.5919055649241147,0.0,20.0
9186,2,1186,[208 213 212 259 509],184,4,4264,3.5922493681550125,0.0,0.0
9187,2,1187,[226 431 378 209 367],833,1,4265,3.59006734006734,0.0,0.0
9188,2,1188,[216 378 431 206 223],234,2,4267,3.588730025231287,20.0,0.0
9189,2,1189,[211 250 216 420 481],85,3,4270,3.588235294117647,0.0,20.0
9190,2,1190,[211 413 222 212 509],13,3,4273,3.5877413937867337,0.0,40.0
9191,2,1191,[291 509 239 321 259],308,1,4274,3.585570469798658,0.0,0.0
9192,2,1192,[293 326 478 291 244],474,4,4278,3.5859178541492036,0.0,0.0
9193,2,1193,[390 216 250 321 230],279,2,4280,3.5845896147403686,0.0,0.0
9194,2,1194,[239 507 218 231 485],308,1,4281,3.5824267782426777,0.0,0.0
9195,2,1195,[221 226 367 243 284],533,1,4282,3.580267558528428,0.0,0.0
9196,2,1196,[283 507 213 316 244],474,4,4286,3.5806182121971597,20.0,0.0
9197,2,1197,[219 211 215 431 216],346,2,4288,3.5792988313856426,0.0,20.0
9198,2,1198,[508 211 209 583 232],59,4,4292,3.579649708090075,0.0,20.0
9199,2,1199,[293 208 202 226 201],833,3,4295,3.5791666666666666,0.0,0.0
9200,2,1200,[365 239 231 275 420],308,2,4297,3.5778517901748543,0.0,20.0
9201,2,1201,[350 326 227 276 413],13,2,4299,3.576539101497504,0.0,20.0
9202,2,1202,[264 336 303 367 212],13,3,4302,3.576059850374065,0.0,0.0
9203,2,1203,[232 241 268 300 213],7,2,4304,3.574750830564784,0.0,20.0
9204,2,1204,[291 243 276 240 293],533,0,4304,3.5717842323651454,0.0,20.0
9205,2,1205,[303 378 213 478 429],537,3,4307,3.5713101160862353,0.0,0.0
9206,2,1206,[231 226 222 227 275],279,2,4309,3.5700082850041426,0.0,40.0
9207,2,1207,[222 223 291 295 215],92,4,4313,3.5703642384105962,20.0,20.0
9208,2,1208,[230 222 250 223 241],455,2,4315,3.5690653432588917,20.0,20.0
9209,2,1209,[220 508 365 202 326],378,1,4316,3.5669421487603308,0.0,0.0
9210,2,1210,[300 211 223 284 268],234,0,4316,3.563996696944674,20.0,40.0
9211,2,1211,[202 250 209 324 431],479,4,4320,3.5643564356435644,0.0,0.0
9212,2,1212,[481 211 218 429 378],308,4,4324,3.5647155812036275,0.0,20.0
9213,2,1213,[276 509 216 259 211],308,3,4327,3.5642504118616145,0.0,40.0
9214,2,1214,[215 223 413 243 268],13,3,4330,3.5637860082304527,20.0,0.0
9215,2,1215,[509 283 321 420 392],378,3,4333,3.5633223684210527,0.0,0.0
9216,2,1216,[321 394 336 331 219],13,0,4333,3.5603944124897287,0.0,0.0
9217,2,1217,[452 250 246 331 227],145,3,4336,3.5599343185550083,0.0,0.0
9218,2,1218,[367 212 223 216 215],90,4,4340,3.5602953240360953,20.0,0.0
9219,2,1219,[299 276 202 272 264],13,4,4344,3.560655737704918,0.0,20.0
9220,2,1220,[321 284 481 211 316],234,2,4346,3.5593775593775594,20.0,20.0
9221,2,1221,[298 299 452 413 259],145,1,4347,3.5572831423895255,0.0,0.0
9222,2,1222,[275 301 220 218 300],334,1,4348,3.555192150449714,0.0,40.0
9223,2,1223,[236 240 250 276 315],145,3,4351,3.554738562091503,20.0,20.0
9224,2,1224,[241 378 259 508 276],537,2,4353,3.553469387755102,0.0,20.0
9225,2,1225,[239 303 212 301 290],537,1,4354,3.5513866231647633,0.0,0.0
9226,2,1226,[219 215 384 226 316],13,3,4357,3.5509372453137735,20.0,0.0
9227,2,1227,[226 218 431 211 222],102,0,4357,3.548045602605863,0.0,40.0
9228,2,1228,[227 295 326 232 365],749,3,4360,3.54759967453214,0.0,0.0
9229,2,1229,[221 276 481 255 508],474,4,4364,3.5479674796747966,0.0,20.0
9230,2,1230,[300 241 272 218 220],378,3,4367,3.5475223395613322,0.0,20.0
9231,2,1231,[301 384 303 241 344],13,1,4368,3.5454545454545454,0.0,0.0
9232,2,1232,[226 241 209 290 250],158,4,4372,3.5458231954582318,0.0,0.0
9233,2,1233,[291 508 429 208 212],537,2,4374,3.5445705024311183,0.0,0.0
9234,2,1234,[231 367 201 239 215],13,2,4376,3.5433198380566804,0.0,0.0
9235,2,1235,[239 256 209 316 227],883,2,4378,3.542071197411003,20.0,0.0
9236,2,1236,[316 303 222 243 261],13,2,4380,3.5408245755860954,20.0,20.0
9237,2,1237,[276 420 291 452 365],308,2,4382,3.5395799676898223,0.0,20.0
9238,2,1238,[215 217 431 300 301],13,1,4383,3.5375302663438255,0.0,20.0
9239,2,1239,[300 420 509 212 272],13,4,4387,3.537903225806452,0.0,20.0
9240,2,1240,[276 331 301 315 300],13,2,4389,3.5366639806607574,20.0,40.0
9241,2,1241,[209 218 413 431 239],804,4,4393,3.537037037037037,0.0,0.0
9242,2,1242,[431 429 485 231 280],749,5,4398,3.5382139983909897,0.0,0.0
9243,2,1243,[232 227 508 217 250],774,1,4399,3.5361736334405145,0.0,0.0
9244,2,1244,[213 420 365 485 276],378,4,4403,3.5365461847389557,0.0,20.0
9245,2,1245,[222 291 301 232 420],85,2,4405,3.5353130016051364,0.0,20.0
9246,2,1246,[299 209 429 481 211],13,2,4407,3.534081796311147,0.0,20.0
9247,2,1247,[284 509 213 255 367],378,3,4410,3.5336538461538463,0.0,0.0
9248,2,1248,[367 481 259 429 290],524,2,4412,3.532425940752602,0.0,0.0
9249,2,1249,[429 208 215 226 392],59,4,4416,3.5328,0.0,0.0
9250,2,1250,[367 223 259 230 213],7,2,4418,3.5315747402078337,20.0,0.0
9251,2,1251,[223 394 201 509 300],13,2,4420,3.5303514376996805,20.0,20.0
9252,2,1252,[315 275 429 431 276],13,3,4423,3.5299281723862728,20.0,40.0
9253,2,1253,[211 218 239 315 290],650,1,4424,3.5279106858054226,20.0,20.0
9254,2,1254,[206 507 211 316 301],650,3,4427,3.5274900398406372,20.0,20.0
9255,2,1255,[300 275 219 226 431],145,2,4429,3.5262738853503186,0.0,40.0
9256,2,1256,[420 239 481 212 485],406,1,4430,3.5242641209228323,0.0,0.0
9257,2,1257,[485 231 413 261 367],13,0,4430,3.521462639109698,0.0,0.0
9258,2,1258,[367 212 230 227 202],804,3,4433,3.5210484511517075,0.0,0.0
9259,2,1259,[291 201 222 431 202],92,3,4436,3.5206349206349206,0.0,20.0
9260,2,1260,[264 394 226 507 227],13,3,4439,3.520222045995242,0.0,0.0
9261,2,1261,[507 276 272 420 384],13,3,4442,3.519809825673534,0.0,20.0
9262,2,1262,[367 209 208 481 508],643,5,4447,3.5209817893903406,0.0,0.0
9263,2,1263,[227 276 212 239 241],92,3,4450,3.5205696202531644,0.0,20.0
9264,2,1264,[232 230 344 208 367],13,1,4451,3.5185770750988143,0.0,0.0
9265,2,1265,[378 211 230 275 216],537,2,4453,3.5173775671406005,0.0,40.0
9266,2,1266,[272 508 227 213 276],334,3,4456,3.516969218626677,0.0,20.0
9267,2,1267,[232 239 222 478 227],749,4,4460,3.5173501577287065,0.0,20.0
9268,2,1268,[243 211 259 283 208],537,3,4463,3.5169424743892828,0.0,20.0
9269,2,1269,[239 208 420 276 485],311,2,4465,3.515748031496063,0.0,20.0
9270,2,1270,[213 429 509 367 272],653,2,4467,3.5145554681353266,0.0,0.0
9271,2,1271,[293 226 367 208 365],774,0,4467,3.5117924528301887,0.0,0.0
9272,2,1272,[280 212 226 202 218],13,4,4471,3.512175962293794,0.0,0.0
9273,2,1273,[208 276 367 201 215],385,2,4473,3.510989010989011,0.0,20.0
9274,2,1274,[321 297 507 213 301],6,2,4475,3.5098039215686274,20.0,0.0
9275,2,1275,[344 283 221 316 509],894,4,4479,3.510188087774295,20.0,0.0
9276,2,1276,[452 239 367 241 268],92,2,4481,3.509005481597494,0.0,0.0
9277,2,1277,[284 291 215 326 300],328,3,4484,3.508607198748044,0.0,20.0
9278,2,1278,[211 226 259 275 390],279,2,4486,3.5074276778733386,0.0,40.0
9279,2,1279,[365 392 219 202 452],308,2,4488,3.50625,0.0,0.0
9280,2,1280,[250 226 219 208 227],648,4,4492,3.5066354410616705,0.0,0.0
9281,2,1281,[295 216 392 259 226],308,1,4493,3.504680187207488,0.0,0.0
9282,2,1282,[222 290 219 275 226],648,4,4497,3.505066250974279,0.0,40.0
9283,2,1283,[255 250 508 315 316],26,0,4497,3.5023364485981308,40.0,0.0
9284,2,1284,[300 420 232 429 301],13,2,4499,3.5011673151750973,0.0,20.0
9285,2,1285,[300 485 246 208 222],334,3,4502,3.5007776049766717,0.0,40.0
9286,2,1286,[264 280 255 222 220],486,0,4502,3.498057498057498,0.0,20.0
9287,2,1287,[508 212 230 429 215],59,5,4507,3.499223602484472,0.0,0.0
9288,2,1288,[222 300 290 219 226],653,1,4508,3.4972847168347556,0.0,40.0
9289,2,1289,[264 429 209 431 218],13,2,4510,3.496124031007752,0.0,0.0
9290,2,1290,[508 202 431 284 392],537,2,4512,3.4949651432997677,0.0,0.0
9291,2,1291,[261 481 485 336 201],13,0,4512,3.4922600619195046,0.0,0.0
9292,2,1292,[223 209 336 431 218],13,1,4513,3.4903325599381283,20.0,0.0
9293,2,1293,[209 481 239 268 293],334,2,4515,3.489180834621329,0.0,0.0
9294,2,1294,[216 431 254 378 365],804,5,4520,3.4903474903474905,0.0,0.0
9295,2,1295,[291 267 230 298 211],833,1,4521,3.488425925925926,0.0,20.0
9296,2,1296,[478 301 316 206 221],234,2,4523,3.4872783346183502,20.0,0.0
9297,2,1297,[350 283 268 272 315],894,2,4525,3.4861325115562405,20.0,0.0
9298,2,1298,[507 209 420 208 202],13,3,4528,3.4857582755966128,0.0,0.0
9299,2,1299,[261 232 202 507 420],13,2,4530,3.4846153846153847,0.0,0.0
9300,2,1300,[326 239 509 241 222],378,2,4532,3.4834742505764797,0.0,20.0
9301,2,1301,[293 241 485 227 216],339,3,4535,3.4831029185867894,0.0,0.0
9302,2,1302,[201 230 226 215 367],59,5,4540,3.484267075978511,0.0,0.0
9303,2,1303,[219 429 378 240 344],833,3,4543,3.4838957055214723,0.0,0.0
9304,2,1304,[206 212 507 315 509],650,2,4545,3.4827586206896552,20.0,0.0
9305,2,1305,[508 212 216 259 276],474,3,4548,3.482388973966309,0.0,20.0
9306,2,1306,[301 208 478 211 272],90,4,4552,3.482785003825555,0.0,20.0
9307,2,1307,[239 215 230 222 321],311,3,4555,3.482415902140673,0.0,20.0
9308,2,1308,[255 367 254 202 275],378,2,4557,3.481283422459893,0.0,20.0
9309,2,1309,[250 293 209 326 303],392,3,4560,3.480916030534351,0.0,0.0
9310,2,1310,[509 221 392 290 485],537,1,4561,3.479023646071701,0.0,0.0
9311,2,1311,[378 240 217 251 283],385,1,4562,3.4771341463414633,20.0,0.0
9312,2,1312,[272 303 478 315 211],13,5,4567,3.478293983244478,20.0,20.0
9313,2,1313,[272 303 478 315 211],537,5,4572,3.4794520547945207,20.0,20.0
9314,2,1314,[272 303 478 315 211],537,5,4577,3.4806083650190116,20.0,20.0
9315,2,1315,[272 303 478 315 211],537,5,4582,3.4817629179331306,20.0,20.0
9316,2,1316,[272 303 478 315 211],13,5,4587,3.4829157175398633,20.0,20.0
9317,2,1317,[299 268 243 232 208],13,2,4589,3.4817905918057663,0.0,0.0
9318,2,1318,[316 276 291 509 378],474,5,4594,3.4829416224412433,20.0,20.0
9319,2,1319,[429 239 290 384 509],13,4,4598,3.4833333333333334,0.0,0.0
9320,2,1320,[272 303 478 315 211],13,5,4603,3.4844814534443604,20.0,20.0
9321,2,1321,[272 303 478 315 211],13,5,4608,3.485627836611195,20.0,20.0
9322,2,1322,[272 303 478 315 211],537,5,4613,3.486772486772487,20.0,20.0
9323,2,1323,[272 303 478 315 211],537,5,4618,3.487915407854985,20.0,20.0
9324,2,1324,[272 303 478 315 211],13,5,4623,3.489056603773585,20.0,20.0
9325,2,1325,[384 275 232 321 272],13,1,4624,3.4871794871794872,0.0,20.0
9326,2,1326,[272 303 478 315 211],537,5,4629,3.4883195177091184,20.0,20.0
9327,2,1327,[272 303 478 315 211],13,5,4634,3.4894578313253013,20.0,20.0
9328,2,1328,[272 303 478 315 211],13,5,4639,3.490594431903687,20.0,20.0
9329,2,1329,[272 303 478 315 211],537,5,4644,3.4917293233082707,20.0,20.0
9330,2,1330,[390 284 202 301 283],279,2,4646,3.4906085649887304,0.0,0.0
9331,2,1331,[206 223 226 222 478],234,1,4647,3.4887387387387387,20.0,20.0
9332,2,1332,[392 215 420 239 413],843,0,4647,3.486121530382596,0.0,0.0
9333,2,1333,[240 211 300 209 241],64,2,4649,3.4850074962518742,0.0,40.0
9334,2,1334,[222 276 221 268 250],486,2,4651,3.4838951310861423,0.0,40.0
9335,2,1335,[284 211 293 259 583],308,4,4655,3.4842814371257487,0.0,20.0
9336,2,1336,[272 303 478 315 211],537,5,4660,3.4854151084517575,20.0,20.0
9337,2,1337,[213 321 202 295 301],378,1,4661,3.48355754857997,0.0,0.0
9338,2,1338,[272 303 478 315 211],13,5,4666,3.484690067214339,20.0,20.0
9339,2,1339,[272 303 478 315 211],537,5,4671,3.485820895522388,20.0,20.0
9340,2,1340,[272 303 478 315 211],537,5,4676,3.4869500372856077,20.0,20.0
9341,2,1341,[272 303 478 315 211],537,5,4681,3.4880774962742174,20.0,20.0
9342,2,1342,[272 303 478 315 211],13,5,4686,3.4892032762472076,20.0,20.0
9343,2,1343,[202 316 507 331 223],13,3,4689,3.4888392857142856,40.0,0.0
9344,2,1344,[272 303 478 315 211],537,5,4694,3.4899628252788104,20.0,20.0
9345,2,1345,[275 268 478 431 219],13,2,4696,3.488855869242199,0.0,20.0
9346,2,1346,[272 303 478 315 211],537,5,4701,3.489977728285078,20.0,20.0
9347,2,1347,[272 303 478 315 211],537,5,4706,3.4910979228486645,20.0,20.0
9348,2,1348,[272 303 478 315 211],537,5,4711,3.492216456634544,20.0,20.0
9349,2,1349,[478 222 236 321 481],234,1,4712,3.4903703703703703,0.0,20.0
9350,2,1350,[272 303 315 478 211],13,5,4717,3.491487786824574,20.0,20.0
9351,2,1351,[392 284 507 298 241],308,4,4721,3.491863905325444,0.0,0.0
9352,2,1352,[272 303 315 478 211],537,5,4726,3.492978566149298,20.0,20.0
9353,2,1353,[272 303 222 378 212],537,2,4728,3.4918759231905465,0.0,20.0
9354,2,1354,[272 303 315 478 211],13,5,4733,3.492988929889299,20.0,20.0
9355,2,1355,[272 303 315 478 211],537,5,4738,3.494100294985251,20.0,20.0
9356,2,1356,[221 300 216 283 315],537,2,4740,3.4929992630803244,20.0,20.0
9357,2,1357,[485 223 230 481 384],13,1,4741,3.491163475699558,20.0,0.0
9358,2,1358,[272 303 315 478 211],537,5,4746,3.492273730684327,20.0,20.0
9359,2,1359,[272 303 315 478 211],537,5,4751,3.4933823529411763,20.0,20.0
9360,2,1360,[272 303 315 478 211],13,5,4756,3.494489346069067,20.0,20.0
9361,2,1361,[272 303 315 478 211],13,5,4761,3.495594713656388,20.0,20.0
9362,2,1362,[284 280 290 478 202],234,0,4761,3.4930300807043286,0.0,0.0
9363,2,1363,[272 303 315 211 478],13,5,4766,3.494134897360704,20.0,20.0
9364,2,1364,[272 303 315 211 478],537,5,4771,3.4952380952380953,20.0,20.0
9365,2,1365,[272 303 315 211 478],13,5,4776,3.4963396778916547,20.0,20.0
9366,2,1366,[272 303 315 211 478],537,5,4781,3.49743964886613,20.0,20.0
9367,2,1367,[331 222 293 291 299],164,5,4786,3.4985380116959064,0.0,20.0
9368,2,1368,[213 478 321 272 276],537,4,4790,3.4989043097151207,0.0,20.0
9369,2,1369,[223 255 236 303 250],894,4,4794,3.499270072992701,20.0,0.0
9370,2,1370,[272 303 315 211 478],537,5,4799,3.50036469730124,20.0,20.0
9371,2,1371,[272 303 315 211 478],13,5,4804,3.501457725947522,20.0,20.0
9372,2,1372,[272 303 315 211 478],537,5,4809,3.5025491624180627,20.0,20.0
9373,2,1373,[272 303 315 211 478],537,5,4814,3.5036390101892287,20.0,20.0
9374,2,1374,[272 303 315 211 478],13,5,4819,3.5047272727272727,20.0,20.0
9375,2,1375,[272 303 315 211 478],13,5,4824,3.505813953488372,20.0,20.0
9376,2,1376,[272 303 315 211 478],13,5,4829,3.5068990559186637,20.0,20.0
9377,2,1377,[272 303 315 211 478],13,5,4834,3.5079825834542815,20.0,20.0
9378,2,1378,[272 303 315 211 478],537,5,4839,3.5090645395213924,20.0,20.0
9379,2,1379,[508 215 217 321 378],184,4,4843,3.5094202898550724,0.0,0.0
9380,2,1380,[272 303 315 211 478],13,5,4848,3.510499637943519,20.0,20.0
9381,2,1381,[291 324 219 384 264],833,1,4849,3.508683068017366,0.0,0.0
9382,2,1382,[413 212 431 326 226],13,2,4851,3.507592190889371,0.0,0.0
9383,2,1383,[272 303 315 211 478],537,5,4856,3.508670520231214,20.0,20.0
9384,2,1384,[211 485 420 239 283],308,2,4858,3.507581227436823,0.0,20.0
9385,2,1385,[272 303 315 211 478],13,5,4863,3.5086580086580086,20.0,20.0
9386,2,1386,[272 303 315 211 478],537,5,4868,3.5097332372025956,20.0,20.0
9387,2,1387,[272 303 315 211 478],13,5,4873,3.510806916426513,20.0,20.0
9388,2,1388,[272 303 315 211 478],537,5,4878,3.511879049676026,20.0,20.0
9389,2,1389,[272 303 315 211 478],537,5,4883,3.51294964028777,20.0,20.0
9390,2,1390,[272 303 315 211 478],537,5,4888,3.514018691588785,20.0,20.0
9391,2,1391,[272 303 315 211 478],537,5,4893,3.5150862068965516,20.0,20.0
9392,2,1392,[272 303 315 211 478],13,5,4898,3.5161521895190235,20.0,20.0
9393,2,1393,[321 283 220 241 326],378,2,4900,3.51506456241033,0.0,0.0
9394,2,1394,[239 202 284 275 378],533,3,4903,3.514695340501792,0.0,20.0
9395,2,1395,[378 259 392 213 283],537,2,4905,3.5136103151862463,0.0,0.0
9396,2,1396,[272 303 315 211 478],537,5,4910,3.514674302075877,20.0,20.0
9397,2,1397,[240 291 216 223 246],92,3,4913,3.5143061516452074,20.0,0.0
9398,2,1398,[272 303 315 211 478],13,5,4918,3.5153681200857756,20.0,20.0
9399,2,1399,[272 303 315 211 478],13,5,4923,3.5164285714285715,20.0,20.0
9400,2,1400,[272 303 315 211 478],13,5,4928,3.5174875089221986,20.0,20.0
9401,2,1401,[272 303 315 211 478],537,5,4933,3.5185449358059913,20.0,20.0
9402,2,1402,[272 303 315 211 478],537,5,4938,3.51960085531005,20.0,20.0
9403,2,1403,[272 303 315 211 478],13,5,4943,3.5206552706552707,20.0,20.0
9404,2,1404,[272 303 315 211 478],537,5,4948,3.521708185053381,20.0,20.0
9405,2,1405,[272 303 315 211 478],537,5,4953,3.5227596017069702,20.0,20.0
9406,2,1406,[321 481 367 241 485],524,3,4956,3.5223880597014925,0.0,0.0
9407,2,1407,[272 303 315 211 478],537,5,4961,3.5234375,20.0,20.0
9408,2,1408,[272 303 315 211 478],13,5,4966,3.524485450674237,20.0,20.0
9409,2,1409,[298 276 509 255 213],894,3,4969,3.524113475177305,0.0,20.0
9410,2,1410,[272 303 315 211 478],13,5,4974,3.5251594613749115,20.0,20.0
9411,2,1411,[272 303 315 211 478],537,5,4979,3.526203966005666,20.0,20.0
9412,2,1412,[272 303 315 211 478],13,5,4984,3.527246992215145,20.0,20.0
9413,2,1413,[272 303 315 211 478],537,5,4989,3.5282885431400284,20.0,20.0
9414,2,1414,[272 303 315 211 478],13,5,4994,3.5293286219081272,20.0,20.0
9415,2,1415,[272 303 315 211 478],537,5,4999,3.5303672316384183,20.0,20.0
9416,2,1416,[272 303 315 211 478],13,5,5004,3.5314043754410727,20.0,20.0
9417,2,1417,[231 583 209 221 208],158,2,5006,3.530324400564175,0.0,0.0
9418,2,1418,[315 508 481 219 217],13,1,5007,3.528541226215645,20.0,0.0
9419,2,1419,[272 303 315 211 478],13,5,5012,3.5295774647887326,20.0,20.0
9420,2,1420,[202 350 290 231 367],13,2,5014,3.5285010555946514,0.0,0.0
9421,2,1421,[272 303 315 211 478],537,5,5019,3.529535864978903,20.0,20.0
9422,2,1422,[272 303 315 211 478],13,5,5024,3.5305692199578353,20.0,20.0
9423,2,1423,[350 303 431 211 239],13,3,5027,3.530196629213483,0.0,20.0
9424,2,1424,[272 303 315 211 478],537,5,5032,3.5312280701754384,20.0,20.0
9425,2,1425,[378 275 478 221 508],184,5,5037,3.532258064516129,0.0,20.0
9426,2,1426,[298 227 230 275 367],378,1,5038,3.5304835318850736,0.0,20.0
9427,2,1427,[301 202 367 230 321],13,1,5039,3.5287114845938374,0.0,0.0
9428,2,1428,[272 303 315 211 478],537,5,5044,3.529741077676697,20.0,20.0
9429,2,1429,[365 215 367 429 211],7,5,5049,3.5307692307692307,0.0,20.0
9430,2,1430,[272 303 315 211 478],13,5,5054,3.5317959468902864,20.0,20.0
9431,2,1431,[272 303 315 211 478],537,5,5059,3.5328212290502794,20.0,20.0
9432,2,1432,[272 303 315 211 478],537,5,5064,3.533845080251221,20.0,20.0
9433,2,1433,[272 303 315 211 478],13,5,5069,3.5348675034867503,20.0,20.0
9434,2,1434,[272 303 315 211 478],13,5,5074,3.53588850174216,20.0,20.0
9435,2,1435,[365 485 326 208 239],749,4,5078,3.5362116991643453,0.0,0.0
9436,2,1436,[276 213 508 284 324],894,2,5080,3.535142658315936,0.0,20.0
9437,2,1437,[272 303 315 211 478],537,5,5085,3.536161335187761,20.0,20.0
9438,2,1438,[272 303 315 211 478],537,5,5090,3.537178596247394,20.0,20.0
9439,2,1439,[213 230 215 216 209],537,2,5092,3.536111111111111,0.0,0.0
9440,2,1440,[272 303 315 211 478],13,5,5097,3.537126995142262,20.0,20.0
9441,2,1441,[413 232 509 508 452],13,1,5098,3.535367545076283,0.0,0.0
9442,2,1442,[272 303 315 211 478],537,5,5103,3.5363825363825363,20.0,20.0
9443,2,1443,[509 413 315 478 384],13,3,5106,3.53601108033241,20.0,0.0
9444,2,1444,[293 256 209 211 429],385,3,5109,3.5356401384083047,0.0,20.0
9445,2,1445,[272 303 315 478 211],13,5,5114,3.536652835408022,20.0,20.0
9446,2,1446,[272 303 315 478 211],13,5,5119,3.5376641326883207,20.0,20.0
9447,2,1447,[272 303 315 478 211],537,5,5124,3.5386740331491713,20.0,20.0
9448,2,1448,[272 303 315 478 211],537,5,5129,3.5396825396825395,20.0,20.0
9449,2,1449,[264 284 280 297 251],486,2,5131,3.5386206896551724,40.0,0.0
9450,2,1450,[272 303 315 478 211],13,5,5136,3.5396278428669885,20.0,20.0
9451,2,1451,[272 303 315 478 211],537,5,5141,3.540633608815427,20.0,20.0
9452,2,1452,[272 303 315 478 211],13,5,5146,3.5416379903647623,20.0,20.0
9453,2,1453,[509 226 209 268 485],537,3,5149,3.5412654745529575,0.0,0.0
9454,2,1454,[272 303 315 478 211],13,5,5154,3.5422680412371133,20.0,20.0
9455,2,1455,[272 303 315 478 211],13,5,5159,3.543269230769231,20.0,20.0
9456,2,1456,[272 303 315 478 211],13,5,5164,3.5442690459849007,20.0,20.0
9457,2,1457,[272 303 315 478 211],537,5,5169,3.545267489711934,20.0,20.0
9458,2,1458,[284 478 221 420 232],85,2,5171,3.5442083618917066,0.0,0.0
9459,2,1459,[283 321 209 303 478],537,4,5175,3.5445205479452055,0.0,0.0
9460,2,1460,[272 303 315 478 211],537,5,5180,3.5455167693360714,20.0,20.0
9461,2,1461,[272 303 315 478 211],13,5,5185,3.546511627906977,20.0,20.0
9462,2,1462,[272 303 315 478 211],537,5,5190,3.547505126452495,20.0,20.0
9463,2,1463,[232 227 208 276 365],311,4,5194,3.547814207650273,0.0,20.0
9464,2,1464,[272 303 315 478 211],13,5,5199,3.5488054607508532,20.0,20.0
9465,2,1465,[272 303 315 478 211],537,5,5204,3.549795361527967,20.0,20.0
9466,2,1466,[290 230 429 202 226],279,5,5209,3.550783912747103,0.0,0.0
9467,2,1467,[213 485 236 276 241],537,2,5211,3.5497275204359675,0.0,20.0
9468,2,1468,[290 303 216 227 300],13,3,5214,3.549353301565691,0.0,20.0
9469,2,1469,[239 485 222 232 367],13,1,5215,3.5476190476190474,0.0,20.0
9470,2,1470,[272 303 315 478 211],537,5,5220,3.548606390210741,20.0,20.0
9471,2,1471,[429 295 208 211 217],387,1,5221,3.546875,0.0,20.0
9472,2,1472,[326 227 255 365 239],378,1,5222,3.5451459606245757,0.0,0.0
9473,2,1473,[272 303 315 478 211],13,5,5227,3.546132971506106,20.0,20.0
9474,2,1474,[272 303 315 478 211],13,5,5232,3.5471186440677966,20.0,20.0
9475,2,1475,[272 303 315 478 211],13,5,5237,3.5481029810298104,20.0,20.0
9476,2,1476,[272 303 315 478 211],13,5,5242,3.5490859851049423,20.0,20.0
9477,2,1477,[272 303 315 478 211],13,5,5247,3.5500676589986466,20.0,20.0
9478,2,1478,[272 303 315 478 211],13,5,5252,3.55104800540906,20.0,20.0
9479,2,1479,[272 303 315 478 211],13,5,5257,3.552027027027027,20.0,20.0
9480,2,1480,[272 303 315 478 211],13,5,5262,3.553004726536124,20.0,20.0
9481,2,1481,[272 303 315 478 211],537,5,5267,3.5539811066126856,20.0,20.0
9482,2,1482,[272 303 315 478 211],13,5,5272,3.554956169925826,20.0,20.0
9483,2,1483,[272 303 315 478 211],13,5,5277,3.5559299191374665,20.0,20.0
9484,2,1484,[272 303 315 478 211],13,5,5282,3.556902356902357,20.0,20.0
9485,2,1485,[378 222 208 507 221],85,3,5285,3.5565275908479137,0.0,20.0
9486,2,1486,[276 268 283 290 315],894,2,5287,3.555480833893746,20.0,20.0
9487,2,1487,[272 303 315 478 211],537,5,5292,3.556451612903226,20.0,20.0
9488,2,1488,[215 276 378 230 284],554,3,5295,3.5560779046339825,0.0,20.0
9489,2,1489,[272 303 315 478 211],537,5,5300,3.557046979865772,20.0,20.0
9490,2,1490,[272 303 315 478 211],537,5,5305,3.5580147551978536,20.0,20.0
9491,2,1491,[272 303 315 478 211],13,5,5310,3.558981233243968,20.0,20.0
9492,2,1492,[272 303 315 478 211],13,5,5315,3.5599464166108508,20.0,20.0
9493,2,1493,[272 303 315 478 211],13,5,5320,3.5609103078982596,20.0,20.0
9494,2,1494,[413 208 231 202 315],13,3,5323,3.560535117056856,20.0,0.0
9495,2,1495,[272 303 315 478 211],13,5,5328,3.5614973262032086,20.0,20.0
9496,2,1496,[272 303 315 478 211],537,5,5333,3.5624582498329995,20.0,20.0
9497,2,1497,[272 303 315 478 211],537,5,5338,3.5634178905206944,20.0,20.0
9498,2,1498,[272 303 315 478 211],13,5,5343,3.5643762508338894,20.0,20.0
9499,2,1499,[272 303 315 478 211],13,5,5348,3.5653333333333332,20.0,20.0
9500,2,1500,[272 303 315 478 211],537,5,5353,3.5662891405729513,20.0,20.0
9501,2,1501,[272 303 315 478 211],537,5,5358,3.567243675099867,20.0,20.0
9502,2,1502,[299 507 394 239 219],13,1,5359,3.565535595475715,0.0,0.0
9503,2,1503,[272 303 315 478 211],537,5,5364,3.5664893617021276,20.0,20.0
9504,2,1504,[272 303 315 478 211],537,5,5369,3.567441860465116,20.0,20.0
9505,2,1505,[303 290 268 316 222],334,4,5373,3.5677290836653386,20.0,20.0
9506,2,1506,[272 303 315 478 211],537,5,5378,3.568679495686795,20.0,20.0
9507,2,1507,[272 303 315 478 211],537,5,5383,3.569628647214854,20.0,20.0
9508,2,1508,[236 202 208 291 431],537,2,5385,3.5685884691848906,0.0,0.0
9509,2,1509,[272 303 315 478 211],13,5,5390,3.5695364238410594,20.0,20.0
9510,2,1510,[272 303 315 478 211],537,5,5395,3.5704831237591,20.0,20.0
9511,2,1511,[222 211 507 213 268],537,4,5399,3.570767195767196,0.0,40.0
9512,2,1512,[272 303 315 478 211],537,5,5404,3.5717118307997358,20.0,20.0
9513,2,1513,[298 259 316 275 244],474,2,5406,3.570673712021136,20.0,20.0
9514,2,1514,[254 231 298 365 239],749,3,5409,3.5702970297029704,0.0,0.0
9515,2,1515,[272 303 315 478 211],537,5,5414,3.571240105540897,20.0,20.0
9516,2,1516,[272 303 315 478 211],13,5,5419,3.5721819380355964,20.0,20.0
9517,2,1517,[290 315 367 384 218],13,2,5421,3.5711462450592886,20.0,0.0
9518,2,1518,[485 324 452 509 213],7,3,5424,3.5707702435813036,0.0,0.0
9519,2,1519,[272 303 315 478 211],13,5,5429,3.5717105263157896,20.0,20.0
9520,2,1520,[272 303 315 478 211],537,5,5434,3.572649572649573,20.0,20.0
9521,2,1521,[331 336 264 326 344],894,2,5436,3.57161629434954,0.0,0.0
9522,2,1522,[272 303 315 478 211],13,5,5441,3.572554169402495,20.0,20.0
9523,2,1523,[272 303 315 478 211],13,5,5446,3.573490813648294,20.0,20.0
9524,2,1524,[272 303 315 478 211],13,5,5451,3.5744262295081968,20.0,20.0
9525,2,1525,[272 303 315 478 211],537,5,5456,3.5753604193971165,20.0,20.0
9526,2,1526,[272 303 315 478 211],13,5,5461,3.576293385723641,20.0,20.0
9527,2,1527,[272 303 315 478 211],13,5,5466,3.5772251308900525,20.0,20.0
9528,2,1528,[272 303 315 478 211],537,5,5471,3.578155657292348,20.0,20.0
9529,2,1529,[209 301 246 216 211],85,4,5475,3.5784313725490198,0.0,20.0
9530,2,1530,[303 216 481 275 290],334,3,5478,3.5780535597648595,0.0,20.0
9531,2,1531,[272 303 315 478 211],13,5,5483,3.578981723237598,20.0,20.0
9532,2,1532,[272 303 315 478 211],13,5,5488,3.5799086757990866,20.0,20.0
9533,2,1533,[272 303 315 478 211],13,5,5493,3.580834419817471,20.0,20.0
9534,2,1534,[315 298 295 293 297],894,3,5496,3.580456026058632,40.0,0.0
9535,2,1535,[300 429 420 336 275],13,2,5498,3.5794270833333335,0.0,40.0
9536,2,1536,[211 378 216 298 240],749,4,5502,3.579700715679896,0.0,20.0
9537,2,1537,[272 303 315 478 211],537,5,5507,3.580624187256177,20.0,20.0
9538,2,1538,[301 344 384 231 315],13,1,5508,3.5789473684210527,20.0,0.0
9539,2,1539,[272 303 315 478 211],537,5,5513,3.57987012987013,20.0,20.0
9540,2,1540,[272 303 315 478 211],13,5,5518,3.580791693705386,20.0,20.0
9541,2,1541,[272 303 315 478 211],13,5,5523,3.5817120622568095,20.0,20.0
9542,2,1542,[223 239 255 202 264],308,3,5526,3.5813350615683732,20.0,0.0
9543,2,1543,[219 509 215 431 299],13,2,5528,3.5803108808290154,0.0,0.0
9544,2,1544,[272 303 315 478 211],537,5,5533,3.581229773462783,20.0,20.0
9545,2,1545,[272 303 315 478 211],13,5,5538,3.5821474773609316,20.0,20.0
9546,2,1546,[272 303 315 478 211],13,5,5543,3.583063994828701,20.0,20.0
9547,2,1547,[272 303 315 478 211],537,5,5548,3.5839793281653747,20.0,20.0
9548,2,1548,[272 303 315 478 211],537,5,5553,3.5848934796642995,20.0,20.0
9549,2,1549,[272 303 315 478 211],13,5,5558,3.5858064516129033,20.0,20.0
9550,2,1550,[272 303 315 478 211],537,5,5563,3.5867182462927145,20.0,20.0
9551,2,1551,[272 303 315 478 211],537,5,5568,3.5876288659793816,20.0,20.0
9552,2,1552,[272 303 315 478 211],537,5,5573,3.5885383129426915,20.0,20.0
9553,2,1553,[272 303 315 478 211],537,5,5578,3.5894465894465895,20.0,20.0
9554,2,1554,[272 303 315 478 211],13,5,5583,3.590353697749196,20.0,20.0
9555,2,1555,[222 243 316 291 268],234,1,5584,3.588688946015424,20.0,20.0
9556,2,1556,[272 303 315 478 211],537,5,5589,3.5895953757225434,20.0,20.0
9557,2,1557,[276 392 259 209 227],881,3,5592,3.589216944801027,0.0,20.0
9558,2,1558,[272 303 315 478 211],13,5,5597,3.59012187299551,20.0,20.0
9559,2,1559,[272 303 315 478 211],13,5,5602,3.591025641025641,20.0,20.0
9560,2,1560,[272 303 315 478 211],13,5,5607,3.591928251121076,20.0,20.0
9561,2,1561,[218 367 485 509 315],650,0,5607,3.589628681177977,20.0,0.0
9562,2,1562,[236 301 230 392 201],537,0,5607,3.587332053742802,0.0,0.0
9563,2,1563,[272 303 315 478 211],537,5,5612,3.588235294117647,20.0,20.0
9564,2,1564,[212 275 226 272 231],537,2,5614,3.587220447284345,0.0,20.0
9565,2,1565,[272 303 315 478 211],13,5,5619,3.5881226053639845,20.0,20.0
9566,2,1566,[272 303 315 478 211],13,5,5624,3.5890236119974475,20.0,20.0
9567,2,1567,[272 303 315 478 211],13,5,5629,3.589923469387755,20.0,20.0
9568,2,1568,[232 216 431 420 215],95,4,5633,3.590184831102613,0.0,0.0
9569,2,1569,[272 303 315 478 211],537,5,5638,3.5910828025477706,20.0,20.0
9570,2,1570,[485 413 299 276 344],13,1,5639,3.5894334818586886,0.0,20.0
9571,2,1571,[272 303 315 478 211],13,5,5644,3.590330788804071,20.0,20.0
9572,2,1572,[272 303 315 478 211],537,5,5649,3.5912269548633184,20.0,20.0
9573,2,1573,[272 303 315 478 211],13,5,5654,3.5921219822109274,20.0,20.0
9574,2,1574,[272 303 315 478 211],537,5,5659,3.593015873015873,20.0,20.0
9575,2,1575,[272 303 315 478 211],537,5,5664,3.5939086294416245,20.0,20.0
9576,2,1576,[211 208 209 259 429],804,4,5668,3.594166138237159,0.0,20.0
9577,2,1577,[272 303 315 478 211],13,5,5673,3.5950570342205324,20.0,20.0
9578,2,1578,[276 413 212 222 283],82,2,5675,3.5940468651044966,0.0,40.0
9579,2,1579,[220 216 222 275 250],334,2,5677,3.5930379746835444,0.0,40.0
9580,2,1580,[275 301 208 241 321],13,1,5678,3.5913978494623655,0.0,20.0
9581,2,1581,[216 212 211 275 276],452,1,5679,3.5897597977243993,0.0,60.0
9582,2,1582,[272 303 315 478 211],537,5,5684,3.590650663297536,20.0,20.0
9583,2,1583,[272 303 315 478 211],537,5,5689,3.591540404040404,20.0,20.0
9584,2,1584,[272 303 315 478 211],537,5,5694,3.592429022082019,20.0,20.0
9585,2,1585,[227 485 239 219 230],13,2,5696,3.591424968474149,0.0,0.0
9586,2,1586,[272 303 315 478 211],537,5,5701,3.592312539382483,20.0,20.0
9587,2,1587,[303 217 226 202 507],13,3,5704,3.5919395465994963,0.0,0.0
9588,2,1588,[236 218 478 209 321],234,1,5705,3.590308370044053,0.0,0.0
9589,2,1589,[208 231 232 300 509],7,3,5708,3.589937106918239,0.0,20.0
9590,2,1590,[217 324 236 208 250],334,3,5711,3.589566310496543,0.0,0.0
9591,2,1591,[272 303 315 478 211],537,5,5716,3.590452261306533,20.0,20.0
9592,2,1592,[272 303 315 478 211],537,5,5721,3.591337099811676,20.0,20.0
9593,2,1593,[272 303 315 478 211],537,5,5726,3.592220828105395,20.0,20.0
9594,2,1594,[272 303 315 478 211],537,5,5731,3.593103448275862,20.0,20.0
9595,2,1595,[272 303 315 478 211],537,5,5736,3.593984962406015,20.0,20.0
9596,2,1596,[272 303 315 478 211],537,5,5741,3.5948653725735755,20.0,20.0
9597,2,1597,[420 218 215 240 276],406,3,5744,3.5944931163954945,0.0,20.0
9598,2,1598,[272 303 315 478 211],13,5,5749,3.5953721075672296,20.0,20.0
9599,2,1599,[272 303 315 478 211],537,5,5754,3.59625,20.0,20.0
9600,2,1600,[272 303 315 478 211],13,5,5759,3.5971267957526547,20.0,20.0
9601,2,1601,[202 509 284 583 254],308,4,5763,3.597378277153558,0.0,0.0
9602,2,1602,[272 303 315 478 211],13,5,5768,3.5982532751091703,20.0,20.0
9603,2,1603,[272 303 315 478 211],13,5,5773,3.599127182044888,20.0,20.0
9604,2,1604,[272 303 315 478 211],537,5,5778,3.6,20.0,20.0
9605,2,1605,[272 303 315 478 211],13,5,5783,3.6008717310087173,20.0,20.0
9606,2,1606,[272 303 315 478 211],537,5,5788,3.601742377100187,20.0,20.0
9607,2,1607,[272 303 315 478 211],13,5,5793,3.6026119402985075,20.0,20.0
9608,2,1608,[272 303 315 478 211],537,5,5798,3.6034804226227473,20.0,20.0
9609,2,1609,[272 303 315 478 211],13,5,5803,3.6043478260869564,20.0,20.0
9610,2,1610,[272 303 315 478 211],537,5,5808,3.6052141527001864,20.0,20.0
9611,2,1611,[272 303 315 478 211],537,5,5813,3.6060794044665014,20.0,20.0
9612,2,1612,[215 220 295 219 254],648,2,5815,3.605083694978301,0.0,0.0
9613,2,1613,[272 303 315 478 211],537,5,5820,3.6059479553903344,20.0,20.0
9614,2,1614,[215 226 241 212 290],524,2,5822,3.604953560371517,0.0,0.0
9615,2,1615,[272 303 315 478 211],537,5,5827,3.6058168316831685,20.0,20.0
9616,2,1616,[272 303 315 478 211],537,5,5832,3.6066790352504636,20.0,20.0
9617,2,1617,[300 208 299 209 216],13,1,5833,3.6050679851668725,0.0,20.0
9618,2,1618,[272 303 315 478 211],537,5,5838,3.605929586164299,20.0,20.0
9619,2,1619,[272 303 315 478 211],13,5,5843,3.6067901234567903,20.0,20.0
9620,2,1620,[272 303 315 478 211],537,5,5848,3.607649599012955,20.0,20.0
9621,2,1621,[230 431 222 429 211],653,1,5849,3.6060419235511714,0.0,40.0
9622,2,1622,[300 230 241 485 298],378,3,5852,3.6056685150955023,0.0,20.0
9623,2,1623,[259 239 431 222 290],279,3,5855,3.605295566502463,0.0,20.0
9624,2,1624,[272 303 315 478 211],13,5,5860,3.606153846153846,20.0,20.0
9625,2,1625,[272 303 315 478 211],537,5,5865,3.607011070110701,20.0,20.0
9626,2,1626,[272 303 315 478 211],537,5,5870,3.6078672403196066,20.0,20.0
9627,2,1627,[272 303 315 478 211],13,5,5875,3.6087223587223587,20.0,20.0
9628,2,1628,[272 303 315 478 211],537,5,5880,3.6095764272559854,20.0,20.0
9629,2,1629,[272 303 315 478 211],13,5,5885,3.6104294478527605,20.0,20.0
9630,2,1630,[378 241 583 259 254],308,2,5887,3.609442060085837,0.0,0.0
9631,2,1631,[272 303 315 478 211],537,5,5892,3.610294117647059,20.0,20.0
9632,2,1632,[272 303 315 478 211],537,5,5897,3.6111451316595224,20.0,20.0
9633,2,1633,[272 303 315 478 211],13,5,5902,3.611995104039168,20.0,20.0
9634,2,1634,[272 303 315 478 211],13,5,5907,3.612844036697248,20.0,20.0
9635,2,1635,[272 303 315 478 211],13,5,5912,3.6136919315403424,20.0,20.0
9636,2,1636,[272 303 315 478 211],537,5,5917,3.6145387904703727,20.0,20.0
9637,2,1637,[272 303 315 478 211],13,5,5922,3.6153846153846154,20.0,20.0
9638,2,1638,[272 303 315 478 211],537,5,5927,3.616229408175717,20.0,20.0
9639,2,1639,[272 303 315 478 211],13,5,5932,3.6170731707317074,20.0,20.0
9640,2,1640,[272 303 315 478 211],537,5,5937,3.6179159049360146,20.0,20.0
9641,2,1641,[272 303 315 478 211],13,5,5942,3.6187576126674785,20.0,20.0
9642,2,1642,[272 303 315 478 211],537,5,5947,3.6195982958003654,20.0,20.0
9643,2,1643,[236 303 223 208 241],343,4,5951,3.619829683698297,20.0,0.0
9644,2,1644,[272 303 315 478 211],537,5,5956,3.6206686930091188,20.0,20.0
9645,2,1645,[272 303 315 478 211],13,5,5961,3.6215066828675577,20.0,20.0
9646,2,1646,[276 219 301 264 275],13,2,5963,3.620522161505768,0.0,40.0
9647,2,1647,[272 303 315 478 211],13,5,5968,3.621359223300971,20.0,20.0
9648,2,1648,[429 217 215 202 239],406,2,5970,3.6203759854457247,0.0,0.0
9649,2,1649,[272 303 315 478 211],13,5,5975,3.621212121212121,20.0,20.0
9650,2,1650,[431 384 217 420 226],7,4,5979,3.6214415505754087,0.0,0.0
9651,2,1651,[272 303 315 478 211],537,5,5984,3.62227602905569,20.0,20.0
9652,2,1652,[272 303 315 478 211],537,5,5989,3.6231094978826377,20.0,20.0
9653,2,1653,[272 303 315 478 211],537,5,5994,3.6239419588875452,20.0,20.0
9654,2,1654,[272 303 315 478 211],537,5,5999,3.624773413897281,20.0,20.0
9655,2,1655,[272 303 315 478 211],13,5,6004,3.6256038647342996,20.0,20.0
9656,2,1656,[272 303 315 478 211],13,5,6009,3.6264333132166566,20.0,20.0
9657,2,1657,[213 283 321 429 378],234,2,6011,3.6254523522316044,0.0,0.0
9658,2,1658,[272 303 315 478 211],537,5,6016,3.626280892103677,20.0,20.0
9659,2,1659,[300 219 452 231 215],13,1,6017,3.624698795180723,0.0,20.0
9660,2,1660,[272 303 315 478 211],13,5,6022,3.625526791089705,20.0,20.0
9661,2,1661,[295 283 392 365 509],378,2,6024,3.624548736462094,0.0,0.0
9662,2,1662,[272 303 315 478 211],537,5,6029,3.6253758268190017,20.0,20.0
9663,2,1663,[231 215 367 239 392],378,1,6030,3.623798076923077,0.0,0.0
9664,2,1664,[326 230 392 212 227],64,1,6031,3.6222222222222222,0.0,0.0
9665,2,1665,[272 303 315 478 211],537,5,6036,3.623049219687875,20.0,20.0
9666,2,1666,[272 303 315 478 211],13,5,6041,3.623875224955009,20.0,20.0
9667,2,1667,[272 303 315 478 211],13,5,6046,3.6247002398081536,20.0,20.0
9668,2,1668,[272 303 315 478 211],13,5,6051,3.6255242660275613,20.0,20.0
9669,2,1669,[272 303 315 478 211],537,5,6056,3.6263473053892215,20.0,20.0
9670,2,1670,[272 303 315 478 211],13,5,6061,3.6271693596648715,20.0,20.0
9671,2,1671,[272 303 315 478 211],13,5,6066,3.6279904306220097,20.0,20.0
9672,2,1672,[255 215 259 283 231],308,1,6067,3.6264196054991036,0.0,0.0
9673,2,1673,[231 384 413 481 280],13,1,6068,3.6248506571087216,0.0,0.0
9674,2,1674,[272 303 315 478 211],537,5,6073,3.625671641791045,20.0,20.0
9675,2,1675,[272 303 315 478 211],13,5,6078,3.626491646778043,20.0,20.0
9676,2,1676,[272 303 315 478 211],13,5,6083,3.6273106738223015,20.0,20.0
9677,2,1677,[272 303 315 478 211],537,5,6088,3.6281287246722287,20.0,20.0
9678,2,1678,[219 272 261 202 326],13,2,6090,3.627159023228112,0.0,0.0
9679,2,1679,[272 303 315 478 211],537,5,6095,3.6279761904761907,20.0,20.0
9680,2,1680,[272 303 315 478 211],537,5,6100,3.6287923854848305,20.0,20.0
9681,2,1681,[272 303 315 478 211],537,5,6105,3.6296076099881094,20.0,20.0
9682,2,1682,[272 303 315 478 211],537,5,6110,3.6304218657159835,20.0,20.0
9683,2,1683,[272 303 315 478 211],537,5,6115,3.6312351543942993,20.0,20.0
9684,2,1684,[272 303 315 478 211],13,5,6120,3.6320474777448073,20.0,20.0
9685,2,1685,[509 452 202 507 315],650,1,6121,3.630486358244365,20.0,0.0
9686,2,1686,[223 208 219 295 431],92,4,6125,3.6307053941908713,20.0,0.0
9687,2,1687,[478 276 208 209 222],406,2,6127,3.629739336492891,0.0,40.0
9688,2,1688,[272 303 315 478 211],537,5,6132,3.630550621669627,20.0,20.0
9689,2,1689,[223 240 243 201 284],92,1,6133,3.6289940828402365,20.0,0.0
9690,2,1690,[272 303 315 478 211],13,5,6138,3.6298048492016557,20.0,20.0
9691,2,1691,[272 303 315 478 211],537,5,6143,3.630614657210402,20.0,20.0
9692,2,1692,[272 303 315 478 211],537,5,6148,3.631423508564678,20.0,20.0
9693,2,1693,[272 303 315 478 211],537,5,6153,3.6322314049586777,20.0,20.0
9694,2,1694,[272 303 315 478 211],13,5,6158,3.633038348082596,20.0,20.0
9695,2,1695,[429 213 222 284 507],537,2,6160,3.6320754716981134,0.0,20.0
9696,2,1696,[272 303 315 478 211],13,5,6165,3.6328815556865055,20.0,20.0
9697,2,1697,[272 303 315 478 211],13,5,6170,3.6336866902237928,20.0,20.0
9698,2,1698,[508 291 231 226 268],537,2,6172,3.6327251324308416,0.0,0.0
9699,2,1699,[272 303 315 478 211],13,5,6177,3.6335294117647057,20.0,20.0
9700,2,1700,[272 303 315 478 211],13,5,6182,3.6343327454438565,20.0,20.0
9701,2,1701,[298 208 275 420 316],85,3,6185,3.633960047003525,20.0,20.0
9702,2,1702,[272 303 315 478 211],13,5,6190,3.634762184380505,20.0,20.0
9703,2,1703,[272 303 315 478 211],537,5,6195,3.63556338028169,20.0,20.0
9704,2,1704,[272 303 315 478 211],537,5,6200,3.6363636363636362,20.0,20.0
9705,2,1705,[272 303 315 478 211],537,5,6205,3.6371629542790154,20.0,20.0
9706,2,1706,[272 303 315 478 211],537,5,6210,3.637961335676626,20.0,20.0
9707,2,1707,[272 303 315 478 211],13,5,6215,3.638758782201405,20.0,20.0
9708,2,1708,[272 303 315 478 211],13,5,6220,3.639555295494441,20.0,20.0
9709,2,1709,[272 303 315 478 211],537,5,6225,3.6403508771929824,20.0,20.0
9710,2,1710,[280 268 485 303 300],13,3,6228,3.6399766218585623,0.0,20.0
9711,2,1711,[272 303 315 478 211],13,5,6233,3.640771028037383,20.0,20.0
9712,2,1712,[272 303 315 478 211],13,5,6238,3.6415645067133684,20.0,20.0
9713,2,1713,[272 303 315 478 211],13,5,6243,3.6423570595099184,20.0,20.0
9714,2,1714,[272 303 315 478 211],537,5,6248,3.6431486880466473,20.0,20.0
9715,2,1715,[272 303 315 478 211],13,5,6253,3.643939393939394,20.0,20.0
9716,2,1716,[392 452 507 211 208],308,3,6256,3.6435643564356437,0.0,20.0
9717,2,1717,[272 303 315 478 211],537,5,6261,3.6443538998835856,20.0,20.0
9718,2,1718,[272 303 315 478 211],13,5,6266,3.6451425247236764,20.0,20.0
9719,2,1719,[272 303 315 478 211],537,5,6271,3.6459302325581397,20.0,20.0
9720,2,1720,[272 303 315 478 211],537,5,6276,3.6467170249854735,20.0,20.0
9721,2,1721,[272 303 315 478 211],537,5,6281,3.6475029036004645,20.0,20.0
9722,2,1722,[241 301 299 275 218],328,3,6284,3.6471271038885664,0.0,20.0
9723,2,1723,[272 303 315 478 211],13,5,6289,3.647911832946636,20.0,20.0
9724,2,1724,[272 303 315 478 211],537,5,6294,3.648695652173913,20.0,20.0
9725,2,1725,[429 326 301 209 239],13,2,6296,3.6477404403244496,0.0,0.0
9726,2,1726,[272 303 315 478 211],537,5,6301,3.6485234510712217,20.0,20.0
9727,2,1727,[300 275 209 250 255],119,3,6304,3.6481481481481484,0.0,40.0
9728,2,1728,[272 303 315 478 211],13,5,6309,3.64893001735107,20.0,20.0
9729,2,1729,[222 217 219 367 429],387,1,6310,3.647398843930636,0.0,20.0
9730,2,1730,[272 303 315 478 211],13,5,6315,3.6481802426343153,20.0,20.0
9731,2,1731,[243 213 300 284 215],537,1,6316,3.6466512702078524,0.0,20.0
9732,2,1732,[272 303 315 478 211],13,5,6321,3.6474321984997116,20.0,20.0
9733,2,1733,[272 303 315 478 211],537,5,6326,3.648212226066897,20.0,20.0
9734,2,1734,[202 315 272 219 232],13,3,6329,3.6478386167146972,20.0,0.0
9735,2,1735,[272 303 315 478 211],13,5,6334,3.6486175115207375,20.0,20.0
9736,2,1736,[218 378 201 429 231],385,2,6336,3.6476683937823835,0.0,0.0
9737,2,1737,[508 213 231 284 481],85,2,6338,3.6467203682393556,0.0,0.0
9738,2,1738,[222 244 485 508 217],334,1,6339,3.645198389879241,0.0,20.0
9739,2,1739,[272 303 315 478 211],13,5,6344,3.645977011494253,20.0,20.0
9740,2,1740,[272 303 315 478 211],13,5,6349,3.646754738655945,20.0,20.0
9741,2,1741,[272 303 315 478 211],13,5,6354,3.647531572904707,20.0,20.0
9742,2,1742,[507 211 202 213 215],406,2,6356,3.646586345381526,0.0,20.0
9743,2,1743,[431 303 316 315 326],13,3,6359,3.646215596330275,40.0,0.0
9744,2,1744,[216 217 202 280 275],13,2,6361,3.645272206303725,0.0,20.0
9745,2,1745,[272 303 315 478 211],537,5,6366,3.6460481099656357,20.0,20.0
9746,2,1746,[230 276 344 301 243],13,1,6367,3.6445334859759586,0.0,20.0
9747,2,1747,[272 303 315 478 211],13,5,6372,3.645308924485126,20.0,20.0
9748,2,1748,[272 303 315 478 211],13,5,6377,3.6460834762721555,20.0,20.0
9749,2,1749,[272 303 315 478 211],13,5,6382,3.646857142857143,20.0,20.0
9750,2,1750,[216 429 256 384 240],385,3,6385,3.646487721302113,0.0,0.0
9751,2,1751,[272 303 315 478 211],13,5,6390,3.6472602739726026,20.0,20.0
9752,2,1752,[272 303 315 478 211],537,5,6395,3.648031945236737,20.0,20.0
9753,2,1753,[272 303 315 478 211],537,5,6400,3.6488027366020526,20.0,20.0
9754,2,1754,[272 303 315 478 211],13,5,6405,3.6495726495726495,20.0,20.0
9755,2,1755,[212 217 367 321 202],13,2,6407,3.6486332574031892,0.0,0.0
9756,2,1756,[272 303 315 478 211],537,5,6412,3.649402390438247,20.0,20.0
9757,2,1757,[272 303 315 478 211],537,5,6417,3.650170648464164,20.0,20.0
9758,2,1758,[272 303 315 478 211],13,5,6422,3.65093803297328,20.0,20.0
9759,2,1759,[272 303 315 478 211],537,5,6427,3.6517045454545456,20.0,20.0
9760,2,1760,[272 303 315 478 211],13,5,6432,3.6524701873935266,20.0,20.0
9761,2,1761,[272 303 315 478 211],537,5,6437,3.653234960272418,20.0,20.0
9762,2,1762,[272 303 315 478 211],13,5,6442,3.6539988655700513,20.0,20.0
9763,2,1763,[272 303 315 478 211],13,5,6447,3.6547619047619047,20.0,20.0
9764,2,1764,[272 303 315 478 211],537,5,6452,3.6555240793201134,20.0,20.0
9765,2,1765,[272 303 315 478 211],537,5,6457,3.6562853907134767,20.0,20.0
9766,2,1766,[509 284 241 315 478],537,3,6460,3.6559139784946235,20.0,0.0
9767,2,1767,[272 303 315 478 211],13,5,6465,3.6566742081447963,20.0,20.0
9768,2,1768,[272 508 275 231 316],85,1,6466,3.6551724137931036,20.0,20.0
9769,2,1769,[272 303 315 478 211],13,5,6471,3.6559322033898307,20.0,20.0
9770,2,1770,[272 303 315 478 211],13,5,6476,3.6566911349520046,20.0,20.0
9771,2,1771,[272 303 315 478 211],537,5,6481,3.6574492099322797,20.0,20.0
9772,2,1772,[272 303 315 478 211],13,5,6486,3.6582064297800336,20.0,20.0
9773,2,1773,[272 303 315 478 211],537,5,6491,3.6589627959413753,20.0,20.0
9774,2,1774,[272 303 315 478 211],13,5,6496,3.659718309859155,20.0,20.0
9775,2,1775,[272 303 315 478 211],13,5,6501,3.660472972972973,20.0,20.0
9776,2,1776,[275 303 241 202 280],13,3,6504,3.6601012943162634,0.0,20.0
9777,2,1777,[507 259 208 268 221],90,3,6507,3.659730033745782,0.0,0.0
9778,2,1778,[272 303 315 478 211],537,5,6512,3.6604834176503656,20.0,20.0
9779,2,1779,[272 303 315 478 211],537,5,6517,3.66123595505618,20.0,20.0
9780,2,1780,[272 303 315 478 211],13,5,6522,3.661987647389107,20.0,20.0
9781,2,1781,[303 264 367 300 206],409,2,6524,3.6610549943883277,0.0,20.0
9782,2,1782,[272 303 315 478 211],13,5,6529,3.6618059450364555,20.0,20.0
9783,2,1783,[272 303 315 478 211],13,5,6534,3.662556053811659,20.0,20.0
9784,2,1784,[272 303 315 478 211],13,5,6539,3.6633053221288514,20.0,20.0
9785,2,1785,[272 303 315 478 211],537,5,6544,3.664053751399776,20.0,20.0
9786,2,1786,[223 431 208 259 485],194,2,6546,3.663122551762731,20.0,0.0
9787,2,1787,[272 303 315 478 211],537,5,6551,3.663870246085011,20.0,20.0
9788,2,1788,[272 303 315 478 211],537,5,6556,3.664617104527669,20.0,20.0
9789,2,1789,[272 303 315 478 211],13,5,6561,3.66536312849162,20.0,20.0
9790,2,1790,[272 303 315 478 211],537,5,6566,3.666108319374651,20.0,20.0
9791,2,1791,[227 420 508 230 367],378,2,6568,3.6651785714285716,0.0,0.0
9792,2,1792,[223 226 478 429 202],749,5,6573,3.6659230340211937,20.0,0.0
9793,2,1793,[315 241 326 275 350],328,4,6577,3.6661092530657746,20.0,20.0
9794,2,1794,[272 303 315 478 211],13,5,6582,3.6668523676880223,20.0,20.0
9795,2,1795,[272 303 315 478 211],537,5,6587,3.667594654788419,20.0,20.0
9796,2,1796,[272 303 315 478 211],13,5,6592,3.6683361157484695,20.0,20.0
9797,2,1797,[272 303 315 478 211],537,5,6597,3.669076751946607,20.0,20.0
9798,2,1798,[272 303 315 478 211],537,5,6602,3.669816564758199,20.0,20.0
9799,2,1799,[272 303 315 478 211],537,5,6607,3.6705555555555556,20.0,20.0
9800,2,1800,[290 481 280 243 241],234,1,6608,3.6690727373681287,0.0,0.0
9801,2,1801,[272 303 315 478 211],13,5,6613,3.669811320754717,20.0,20.0
9802,2,1802,[272 303 315 478 211],537,5,6618,3.670549084858569,20.0,20.0
9803,2,1803,[226 209 241 222 201],13,1,6619,3.6690687361419068,0.0,20.0
9804,2,1804,[272 303 315 478 211],537,5,6624,3.6698060941828254,20.0,20.0
9805,2,1805,[272 303 315 478 211],13,5,6629,3.6705426356589146,20.0,20.0
9806,2,1806,[226 230 211 219 344],833,2,6631,3.66961815163254,0.0,20.0
9807,2,1807,[272 303 315 478 211],537,5,6636,3.670353982300885,20.0,20.0
9808,2,1808,[272 303 315 478 211],537,5,6641,3.6710889994472082,20.0,20.0
9809,2,1809,[272 303 315 478 211],13,5,6646,3.6718232044198893,20.0,20.0
9810,2,1810,[272 303 315 478 211],537,5,6651,3.672556598564329,20.0,20.0
9811,2,1811,[485 202 215 298 241],378,3,6654,3.672185430463576,0.0,0.0
9812,2,1812,[301 336 481 239 420],13,2,6656,3.6712630998345284,0.0,0.0
9813,2,1813,[272 303 315 478 211],537,5,6661,3.6719955898566705,20.0,20.0
9814,2,1814,[272 303 315 478 211],13,5,6666,3.672727272727273,20.0,20.0
9815,2,1815,[272 303 315 478 211],13,5,6671,3.673458149779736,20.0,20.0
9816,2,1816,[272 303 315 478 211],537,5,6676,3.674188222344524,20.0,20.0
9817,2,1817,[272 303 315 478 211],13,5,6681,3.674917491749175,20.0,20.0
9818,2,1818,[272 303 315 478 211],537,5,6686,3.675645959318307,20.0,20.0
9819,2,1819,[272 303 315 478 211],13,5,6691,3.676373626373626,20.0,20.0
9820,2,1820,[272 303 315 478 211],537,5,6696,3.6771004942339376,20.0,20.0
9821,2,1821,[272 303 315 478 211],537,5,6701,3.677826564215148,20.0,20.0
9822,2,1822,[272 303 315 478 211],537,5,6706,3.67855183763028,20.0,20.0
9823,2,1823,[272 303 315 478 211],537,5,6711,3.679276315789474,20.0,20.0
9824,2,1824,[272 303 315 478 211],537,5,6716,3.68,20.0,20.0
9825,2,1825,[272 303 315 478 211],13,5,6721,3.680722891566265,20.0,20.0
9826,2,1826,[209 478 218 222 213],234,1,6722,3.679255610290093,0.0,20.0
9827,2,1827,[367 221 236 219 485],385,3,6725,3.678884026258206,0.0,0.0
9828,2,1828,[231 298 222 508 217],387,2,6727,3.6779661016949152,0.0,20.0
9829,2,1829,[272 303 315 478 211],537,5,6732,3.678688524590164,20.0,20.0
9830,2,1830,[272 303 315 478 211],13,5,6737,3.679410158383397,20.0,20.0
9831,2,1831,[243 219 264 211 481],13,2,6739,3.6784934497816595,0.0,20.0
9832,2,1832,[272 303 315 478 211],537,5,6744,3.679214402618658,20.0,20.0
9833,2,1833,[272 303 315 478 211],537,5,6749,3.6799345692475462,20.0,20.0
9834,2,1834,[202 206 213 378 222],234,2,6751,3.6790190735694823,0.0,20.0
9835,2,1835,[231 485 230 215 202],537,0,6751,3.6770152505446623,0.0,0.0
9836,2,1836,[429 202 507 241 230],7,3,6754,3.6766467065868262,0.0,0.0
9837,2,1837,[272 303 315 478 211],13,5,6759,3.677366702937976,20.0,20.0
9838,2,1838,[211 226 222 241 215],788,3,6762,3.6769983686786296,0.0,40.0
9839,2,1839,[272 303 315 478 211],13,5,6767,3.677717391304348,20.0,20.0
9840,2,1840,[272 303 315 478 211],537,5,6772,3.6784356328082564,20.0,20.0
9841,2,1841,[272 303 315 478 211],537,5,6777,3.679153094462541,20.0,20.0
9842,2,1842,[272 303 315 478 211],537,5,6782,3.679869777536625,20.0,20.0
9843,2,1843,[272 303 315 478 211],537,5,6787,3.68058568329718,20.0,20.0
9844,2,1844,[272 303 315 478 211],537,5,6792,3.68130081300813,20.0,20.0
9845,2,1845,[272 303 315 478 211],537,5,6797,3.6820151679306607,20.0,20.0
9846,2,1846,[272 303 315 478 211],13,5,6802,3.682728749323227,20.0,20.0
9847,2,1847,[208 431 227 291 240],749,4,6806,3.682900432900433,0.0,0.0
9848,2,1848,[239 485 216 222 583],524,2,6808,3.6819902650081127,0.0,20.0
9849,2,1849,[272 303 315 478 211],13,5,6813,3.6827027027027026,20.0,20.0
9850,2,1850,[272 303 315 478 211],13,5,6818,3.683414370610481,20.0,20.0
9851,2,1851,[272 303 315 478 211],537,5,6823,3.6841252699784017,20.0,20.0
9852,2,1852,[291 232 231 208 378],85,2,6825,3.6832164058283863,0.0,0.0
9853,2,1853,[272 303 315 478 211],537,5,6830,3.6839266450916934,20.0,20.0
9854,2,1854,[272 303 315 478 211],13,5,6835,3.684636118598383,20.0,20.0
9855,2,1855,[226 321 485 239 295],378,1,6836,3.6831896551724137,0.0,0.0
9856,2,1856,[336 367 452 429 268],13,2,6838,3.6822832525578892,0.0,0.0
9857,2,1857,[219 227 384 218 220],648,2,6840,3.681377825618945,0.0,0.0
9858,2,1858,[272 303 315 478 211],13,5,6845,3.6820871436256053,20.0,20.0
9859,2,1859,[272 303 315 478 211],537,5,6850,3.682795698924731,20.0,20.0
9860,2,1860,[272 303 315 478 211],537,5,6855,3.6835034927458357,20.0,20.0
9861,2,1861,[272 303 315 478 211],13,5,6860,3.6842105263157894,20.0,20.0
9862,2,1862,[272 303 315 478 211],13,5,6865,3.6849168008588298,20.0,20.0
9863,2,1863,[272 303 315 478 211],537,5,6870,3.6856223175965663,20.0,20.0
9864,2,1864,[254 283 250 378 259],184,3,6873,3.685254691689008,0.0,0.0
9865,2,1865,[272 303 315 478 211],13,5,6878,3.6859592711682745,20.0,20.0
9866,2,1866,[272 303 315 478 211],13,5,6883,3.6866630958757365,20.0,20.0
9867,2,1867,[272 303 315 478 211],537,5,6888,3.6873661670235545,20.0,20.0
9868,2,1868,[272 303 315 478 211],537,5,6893,3.6880684858212947,20.0,20.0
9869,2,1869,[272 303 315 478 211],13,5,6898,3.688770053475936,20.0,20.0
9870,2,1870,[272 303 315 478 211],13,5,6903,3.689470871191876,20.0,20.0
9871,2,1871,[272 303 315 478 211],537,5,6908,3.6901709401709404,20.0,20.0
9872,2,1872,[378 420 202 293 481],308,4,6912,3.6903363587827016,0.0,0.0
9873,2,1873,[272 303 315 478 211],13,5,6917,3.6910352187833513,20.0,20.0
9874,2,1874,[485 221 291 213 420],85,3,6920,3.6906666666666665,0.0,0.0
9875,2,1875,[272 303 315 478 211],537,5,6925,3.69136460554371,20.0,20.0
9876,2,1876,[272 303 315 478 211],537,5,6930,3.692061800745871,20.0,20.0
9877,2,1877,[272 303 315 478 211],537,5,6935,3.692758253461129,20.0,20.0
9878,2,1878,[208 221 481 378 216],271,3,6938,3.692389568919638,0.0,0.0
9879,2,1879,[272 303 315 478 211],13,5,6943,3.693085106382979,20.0,20.0
9880,2,1880,[272 303 315 478 211],13,5,6948,3.6937799043062203,20.0,20.0
9881,2,1881,[272 303 315 478 211],13,5,6953,3.694473963868225,20.0,20.0
9882,2,1882,[239 290 230 231 250],334,1,6954,3.6930430164630907,0.0,0.0
9883,2,1883,[272 303 315 478 211],13,5,6959,3.6937367303609343,20.0,20.0
9884,2,1884,[276 367 509 213 202],308,5,6964,3.6944297082228115,0.0,20.0
9885,2,1885,[272 303 315 478 211],13,5,6969,3.6951219512195124,20.0,20.0
9886,2,1886,[331 268 413 481 431],13,1,6970,3.6936936936936937,0.0,0.0
9887,2,1887,[299 394 303 485 223],13,2,6972,3.6927966101694913,20.0,0.0
9888,2,1888,[272 303 315 478 211],537,5,6977,3.69348861831657,20.0,20.0
9889,2,1889,[272 303 315 478 211],537,5,6982,3.6941798941798942,20.0,20.0
9890,2,1890,[321 431 481 201 275],13,0,6982,3.6922263352723426,0.0,20.0
9891,2,1891,[272 303 315 478 211],13,5,6987,3.6929175475687104,20.0,20.0
9892,2,1892,[431 230 267 211 219],833,1,6988,3.6914949815108296,0.0,20.0
9893,2,1893,[209 297 367 213 301],6,2,6990,3.690601900739176,20.0,0.0
9894,2,1894,[272 303 315 478 211],13,5,6995,3.691292875989446,20.0,20.0
9895,2,1895,[272 303 315 478 211],537,5,7000,3.691983122362869,20.0,20.0
9896,2,1896,[272 303 315 478 211],13,5,7005,3.6926726410121242,20.0,20.0
9897,2,1897,[209 321 208 508 301],13,1,7006,3.691253951527924,0.0,0.0
9898,2,1898,[272 303 315 478 211],13,5,7011,3.691943127962085,20.0,20.0
9899,2,1899,[272 303 315 478 211],537,5,7016,3.6926315789473683,20.0,20.0
9900,2,1900,[230 276 217 215 365],378,2,7018,3.6917411888479745,0.0,20.0
9901,2,1901,[272 303 315 478 211],13,5,7023,3.692429022082019,20.0,20.0
9902,2,1902,[420 254 509 223 275],378,4,7027,3.6925906463478717,20.0,20.0
9903,2,1903,[272 303 315 478 211],537,5,7032,3.69327731092437,20.0,20.0
9904,2,1904,[272 303 315 478 211],13,5,7037,3.693963254593176,20.0,20.0
9905,2,1905,[272 303 315 478 211],13,5,7042,3.694648478488982,20.0,20.0
9906,2,1906,[272 303 315 478 211],13,5,7047,3.6953329837441005,20.0,20.0
9907,2,1907,[272 303 315 478 211],13,5,7052,3.6960167714884697,20.0,20.0
9908,2,1908,[272 303 315 478 211],537,5,7057,3.6966998428496596,20.0,20.0
9909,2,1909,[272 303 315 478 211],13,5,7062,3.6973821989528797,20.0,20.0
9910,2,1910,[384 241 431 209 300],13,0,7062,3.695447409733124,0.0,20.0
9911,2,1911,[272 303 315 478 211],13,5,7067,3.696129707112971,20.0,20.0
9912,2,1912,[272 303 315 478 211],537,5,7072,3.6968112911657083,20.0,20.0
9913,2,1913,[272 303 315 478 211],13,5,7077,3.697492163009404,20.0,20.0
9914,2,1914,[217 300 240 215 431],64,2,7079,3.696605744125326,0.0,20.0
9915,2,1915,[272 303 315 478 211],13,5,7084,3.6972860125260962,20.0,20.0
9916,2,1916,[272 303 315 478 211],13,5,7089,3.6979655712050077,20.0,20.0
9917,2,1917,[268 213 275 212 291],85,2,7091,3.697080291970803,0.0,20.0
9918,2,1918,[272 303 315 478 211],537,5,7096,3.6977592496091716,20.0,20.0
9919,2,1919,[272 303 315 478 211],13,5,7101,3.6984375,20.0,20.0
9920,2,1920,[272 303 315 478 211],537,5,7106,3.6991150442477876,20.0,20.0
9921,2,1921,[272 303 315 478 211],13,5,7111,3.6997918834547345,20.0,20.0
9922,2,1922,[272 303 315 478 211],537,5,7116,3.700468018720749,20.0,20.0
9923,2,1923,[219 217 508 384 215],13,1,7117,3.699064449064449,0.0,0.0
9924,2,1924,[272 303 315 478 211],13,5,7122,3.6997402597402598,20.0,20.0
9925,2,1925,[259 272 392 300 478],537,2,7124,3.698857736240914,0.0,20.0
9926,2,1926,[272 303 315 478 211],537,5,7129,3.699532952776336,20.0,20.0
9927,2,1927,[272 303 315 478 211],537,5,7134,3.7002074688796682,20.0,20.0
9928,2,1928,[272 303 315 478 211],13,5,7139,3.7008812856402282,20.0,20.0
9929,2,1929,[272 303 315 478 211],537,5,7144,3.7015544041450776,20.0,20.0
9930,2,1930,[316 452 223 431 299],13,2,7146,3.7006732263076128,40.0,0.0
9931,2,1931,[272 303 315 478 211],537,5,7151,3.701345755693582,20.0,20.0
9932,2,1932,[272 303 315 478 211],13,5,7156,3.702017589239524,20.0,20.0
9933,2,1933,[272 303 315 478 211],13,5,7161,3.702688728024819,20.0,20.0
9934,2,1934,[367 231 201 268 280],13,2,7163,3.7018087855297157,0.0,0.0
9935,2,1935,[272 303 315 478 211],537,5,7168,3.7024793388429753,20.0,20.0
9936,2,1936,[222 209 230 218 284],64,4,7172,3.7026329375322664,0.0,20.0
9937,2,1937,[509 264 226 298 215],479,1,7173,3.7012383900928794,0.0,0.0
9938,2,1938,[272 303 315 478 211],13,5,7178,3.701908200103146,20.0,20.0
9939,2,1939,[244 303 298 212 344],894,4,7182,3.7020618556701033,0.0,0.0
9940,2,1940,[481 209 300 301 508],334,1,7183,3.7006697578567747,0.0,20.0
9941,2,1941,[367 219 223 243 276],234,1,7184,3.699279093717817,20.0,20.0
9942,2,1942,[272 303 315 478 211],13,5,7189,3.6999485331960886,20.0,20.0
9943,2,1943,[276 240 201 223 218],92,3,7192,3.6995884773662553,20.0,20.0
9944,2,1944,[272 303 315 478 211],13,5,7197,3.70025706940874,20.0,20.0
9945,2,1945,[367 295 217 230 300],378,1,7198,3.6988694758478933,0.0,20.0
9946,2,1946,[272 303 315 478 211],13,5,7203,3.699537750385208,20.0,20.0
9947,2,1947,[272 303 315 478 211],13,5,7208,3.700205338809035,20.0,20.0
9948,2,1948,[508 420 481 211 509],643,4,7212,3.7003591585428426,0.0,20.0
9949,2,1949,[272 303 315 478 211],13,5,7217,3.701025641025641,20.0,20.0
9950,2,1950,[217 202 211 206 246],387,2,7219,3.700153767298821,0.0,20.0
9951,2,1951,[231 226 331 384 336],13,1,7220,3.6987704918032787,0.0,0.0
9952,2,1952,[272 303 315 478 211],537,5,7225,3.699436763952893,20.0,20.0
9953,2,1953,[211 202 218 215 300],311,4,7229,3.6995905834186287,0.0,40.0
9954,2,1954,[272 303 315 478 211],13,5,7234,3.7002557544757035,20.0,20.0
9955,2,1955,[218 315 394 202 222],13,2,7236,3.6993865030674846,20.0,20.0
9956,2,1956,[208 321 378 275 215],184,5,7241,3.7000510986203374,0.0,20.0
9957,2,1957,[272 303 315 478 211],537,5,7246,3.700715015321757,20.0,20.0
9958,2,1958,[272 303 315 478 211],537,5,7251,3.7013782542113325,20.0,20.0
9959,2,1959,[272 303 315 478 211],13,5,7256,3.7020408163265306,20.0,20.0
9960,2,1960,[272 303 315 478 211],13,5,7261,3.7027027027027026,20.0,20.0
9961,2,1961,[272 303 315 478 211],13,5,7266,3.7033639143730888,20.0,20.0
9962,2,1962,[509 485 301 211 326],318,5,7271,3.7040244523688233,0.0,20.0
9963,2,1963,[485 321 300 215 316],13,2,7273,3.7031568228105907,20.0,20.0
9964,2,1964,[272 303 315 478 211],537,5,7278,3.7038167938931297,20.0,20.0
9965,2,1965,[272 303 315 478 211],537,5,7283,3.704476093591048,20.0,20.0
9966,2,1966,[272 303 315 478 211],13,5,7288,3.7051347229283174,20.0,20.0
9967,2,1967,[298 222 291 326 223],749,4,7292,3.7052845528455283,20.0,20.0
9968,2,1968,[272 303 315 478 211],537,5,7297,3.7059421025901473,20.0,20.0
9969,2,1969,[272 303 315 478 211],537,5,7302,3.7065989847715737,20.0,20.0
9970,2,1970,[208 211 384 227 420],7,3,7305,3.706240487062405,0.0,20.0
9971,2,1971,[272 303 315 478 211],13,5,7310,3.706896551724138,20.0,20.0
9972,2,1972,[272 303 315 478 211],537,5,7315,3.7075519513431323,20.0,20.0
9973,2,1973,[272 303 315 478 211],537,5,7320,3.708206686930091,20.0,20.0
9974,2,1974,[272 303 315 478 211],13,5,7325,3.7088607594936707,20.0,20.0
9975,2,1975,[272 303 315 478 211],537,5,7330,3.7095141700404857,20.0,20.0
9976,2,1976,[272 303 315 478 211],537,5,7335,3.710166919575114,20.0,20.0
9977,2,1977,[272 303 315 478 211],537,5,7340,3.710819009100101,20.0,20.0
9978,2,1978,[227 431 275 390 367],279,2,7342,3.709954522486104,0.0,20.0
9979,2,1979,[272 303 315 478 211],13,5,7347,3.7106060606060605,20.0,20.0
9980,2,1980,[272 303 315 478 211],13,5,7352,3.71125694093892,20.0,20.0
9981,2,1981,[272 303 315 478 211],13,5,7357,3.7119071644803228,20.0,20.0
9982,2,1982,[272 303 315 478 211],537,5,7362,3.712556732223903,20.0,20.0
9983,2,1983,[272 303 315 478 211],13,5,7367,3.7132056451612905,20.0,20.0
9984,2,1984,[230 324 217 227 268],387,2,7369,3.7123425692695213,0.0,0.0
9985,2,1985,[367 215 209 212 300],13,2,7371,3.711480362537764,0.0,20.0
9986,2,1986,[272 303 315 478 211],537,5,7376,3.712128837443382,20.0,20.0
9987,2,1987,[272 303 315 478 211],537,5,7381,3.7127766599597587,20.0,20.0
9988,2,1988,[272 303 315 478 211],13,5,7386,3.71342383107089,20.0,20.0
9989,2,1989,[272 303 315 478 211],537,5,7391,3.714070351758794,20.0,20.0
9990,2,1990,[239 256 283 251 275],883,4,7395,3.7142139628327473,20.0,20.0
9991,2,1991,[202 222 321 290 350],13,2,7397,3.7133534136546187,0.0,20.0
9992,2,1992,[326 244 222 301 508],334,1,7398,3.711991971901656,0.0,20.0
9993,2,1993,[272 303 315 478 211],13,5,7403,3.7126379137412235,20.0,20.0
9994,2,1994,[217 230 384 413 218],648,2,7405,3.711779448621554,0.0,0.0
9995,2,1995,[272 303 315 478 211],13,5,7410,3.712424849699399,20.0,20.0
9996,2,1996,[272 303 315 478 211],13,5,7415,3.71306960440661,20.0,20.0
9997,2,1997,[272 303 315 478 211],537,5,7420,3.7137137137137137,20.0,20.0
9998,2,1998,[272 303 315 478 211],13,5,7425,3.7143571785892946,20.0,20.0
9999,2,1999,[284 336 264 220 321],486,0,7425,3.7125,0.0,0.0
10000,2,2000,[272 303 315 478 211],537,5,7430,3.713143428285857,20.0,20.0
10001,2,2001,[272 303 315 478 211],13,5,7435,3.713786213786214,20.0,20.0
10002,2,2002,[272 303 315 478 211],13,5,7440,3.714428357463804,20.0,20.0
10003,2,2003,[295 231 272 222 284],378,1,7441,3.713073852295409,0.0,20.0
10004,2,2004,[272 303 315 478 211],13,5,7446,3.713715710723192,20.0,20.0
10005,2,2005,[272 303 315 478 211],13,5,7451,3.714356929212363,20.0,20.0
10006,2,2006,[272 303 315 478 211],537,5,7456,3.714997508719482,20.0,20.0
10007,2,2007,[272 303 315 478 211],537,5,7461,3.7156374501992033,20.0,20.0
10008,2,2008,[272 303 315 478 211],13,5,7466,3.7162767546042805,20.0,20.0
10009,2,2009,[272 303 315 478 211],537,5,7471,3.716915422885572,20.0,20.0
10010,2,2010,[272 303 315 478 211],13,5,7476,3.717553455992044,20.0,20.0
10011,2,2011,[272 303 315 478 211],13,5,7481,3.7181908548707754,20.0,20.0
10012,2,2012,[272 303 315 478 211],537,5,7486,3.7188276204669646,20.0,20.0
10013,2,2013,[272 303 315 478 211],537,5,7491,3.7194637537239323,20.0,20.0
10014,2,2014,[272 303 315 478 211],13,5,7496,3.7200992555831265,20.0,20.0
10015,2,2015,[250 230 213 268 227],334,3,7499,3.7197420634920637,0.0,0.0
10016,2,2016,[201 215 478 326 211],13,3,7502,3.719385225582548,0.0,20.0
10017,2,2017,[272 303 315 478 211],537,5,7507,3.72001982160555,20.0,20.0
10018,2,2018,[272 303 315 478 211],13,5,7512,3.7206537890044578,20.0,20.0
10019,2,2019,[202 268 217 240 216],92,1,7513,3.7193069306930693,0.0,0.0
10020,2,2020,[272 303 315 478 211],537,5,7518,3.719940623453736,20.0,20.0
10021,2,2021,[272 303 315 478 211],537,5,7523,3.7205736894164194,20.0,20.0
10022,2,2022,[272 303 315 478 211],537,5,7528,3.7212061295106276,20.0,20.0
10023,2,2023,[300 452 367 219 264],13,1,7529,3.7198616600790513,0.0,20.0
10024,2,2024,[315 201 239 232 223],13,3,7532,3.7195061728395062,40.0,0.0
10025,2,2025,[272 303 315 478 211],537,5,7537,3.7201382033563672,20.0,20.0
10026,2,2026,[272 303 315 478 211],537,5,7542,3.72076961026147,20.0,20.0
10027,2,2027,[481 227 212 217 231],7,2,7544,3.719921104536489,0.0,0.0
10028,2,2028,[272 303 315 478 211],537,5,7549,3.720551996057171,20.0,20.0
10029,2,2029,[331 232 222 272 315],328,3,7552,3.7201970443349754,20.0,20.0
10030,2,2030,[272 303 315 478 211],537,5,7557,3.7208271787296896,20.0,20.0
10031,2,2031,[431 209 216 212 316],650,1,7558,3.719488188976378,20.0,0.0
10032,2,2032,[272 303 315 478 211],13,5,7563,3.720118052139695,20.0,20.0
10033,2,2033,[272 303 315 478 211],13,5,7568,3.720747295968535,20.0,20.0
10034,2,2034,[272 303 315 478 211],13,5,7573,3.7213759213759214,20.0,20.0
10035,2,2035,[272 303 315 478 211],537,5,7578,3.7220039292730847,20.0,20.0
10036,2,2036,[272 303 315 478 211],537,5,7583,3.722631320569465,20.0,20.0
10037,2,2037,[509 216 508 367 350],13,1,7584,3.721295387634936,0.0,0.0
10038,2,2038,[272 303 315 478 211],537,5,7589,3.721922511034821,20.0,20.0
10039,2,2039,[272 303 315 478 211],13,5,7594,3.7225490196078432,20.0,20.0
10040,2,2040,[231 230 268 326 429],334,3,7597,3.7221950024497796,0.0,0.0
10041,2,2041,[272 303 315 478 211],537,5,7602,3.722820763956905,20.0,20.0
10042,2,2042,[367 321 275 326 303],13,1,7603,3.72148800783162,0.0,20.0
10043,2,2043,[272 303 315 478 211],537,5,7608,3.7221135029354206,20.0,20.0
10044,2,2044,[272 303 315 478 211],13,5,7613,3.7227383863080683,20.0,20.0
10045,2,2045,[350 223 344 275 394],13,1,7614,3.721407624633431,20.0,20.0
10046,2,2046,[272 303 315 478 211],537,5,7619,3.722032242305813,20.0,20.0
10047,2,2047,[272 303 315 478 211],13,5,7624,3.72265625,20.0,20.0
10048,2,2048,[272 303 315 478 211],13,5,7629,3.723279648609078,20.0,20.0
10049,2,2049,[272 303 315 478 211],537,5,7634,3.7239024390243904,20.0,20.0
10050,2,2050,[431 261 222 239 280],13,2,7636,3.7230619210141396,0.0,20.0
10051,2,2051,[272 303 315 478 211],13,5,7641,3.723684210526316,20.0,20.0
10052,2,2052,[272 303 315 478 211],13,5,7646,3.7243058938139306,20.0,20.0
10053,2,2053,[272 303 315 478 211],537,5,7651,3.724926971762415,20.0,20.0
10054,2,2054,[344 299 452 222 268],13,1,7652,3.72360097323601,0.0,20.0
10055,2,2055,[272 303 315 478 211],13,5,7657,3.7242217898832686,20.0,20.0
10056,2,2056,[272 303 315 478 211],13,5,7662,3.724842002916869,20.0,20.0
10057,2,2057,[272 303 315 478 211],13,5,7667,3.7254616132167153,20.0,20.0
10058,2,2058,[275 394 202 246 222],145,3,7670,3.725109276347742,0.0,40.0
10059,2,2059,[213 230 268 246 223],334,5,7675,3.7257281553398056,20.0,0.0
10060,2,2060,[272 303 315 478 211],13,5,7680,3.7263464337700145,20.0,20.0
10061,2,2061,[216 209 223 276 297],6,3,7683,3.7259941804073713,40.0,20.0
10062,2,2062,[272 303 315 478 211],537,5,7688,3.7266117304895783,20.0,20.0
10063,2,2063,[272 303 315 478 211],13,5,7693,3.7272286821705425,20.0,20.0
10064,2,2064,[272 303 315 478 211],537,5,7698,3.7278450363196125,20.0,20.0
10065,2,2065,[272 303 315 478 211],13,5,7703,3.728460793804453,20.0,20.0
10066,2,2066,[272 303 315 478 211],13,5,7708,3.7290759554910498,20.0,20.0
10067,2,2067,[272 303 315 478 211],13,5,7713,3.729690522243714,20.0,20.0
10068,2,2068,[272 303 315 478 211],13,5,7718,3.7303044949250848,20.0,20.0
10069,2,2069,[215 507 485 202 301],13,2,7720,3.7294685990338166,0.0,0.0
10070,2,2070,[272 303 315 478 211],537,5,7725,3.730082085948817,20.0,20.0
10071,2,2071,[508 223 218 231 481],643,3,7728,3.72972972972973,20.0,0.0
10072,2,2072,[223 331 275 219 336],13,1,7729,3.7284129281234923,20.0,20.0
10073,2,2073,[272 303 315 478 211],537,5,7734,3.7290260366441657,20.0,20.0
10074,2,2074,[272 303 315 478 211],537,5,7739,3.7296385542168675,20.0,20.0
10075,2,2075,[272 303 315 478 211],13,5,7744,3.7302504816955686,20.0,20.0
10076,2,2076,[272 303 315 478 211],13,5,7749,3.730861819932595,20.0,20.0
10077,2,2077,[222 201 212 508 321],537,1,7750,3.7295476419634266,0.0,20.0
10078,2,2078,[283 201 367 485 481],308,3,7753,3.729196729196729,0.0,0.0
10079,2,2079,[272 303 315 478 211],537,5,7758,3.729807692307692,20.0,20.0
10080,2,2080,[241 295 259 275 209],308,3,7761,3.7294569918308507,0.0,20.0
10081,2,2081,[272 303 315 478 211],13,5,7766,3.730067243035543,20.0,20.0
10082,2,2082,[272 303 315 478 211],13,5,7771,3.730676908305329,20.0,20.0
10083,2,2083,[272 303 315 478 211],13,5,7776,3.7312859884836853,20.0,20.0
10084,2,2084,[272 303 315 478 211],537,5,7781,3.73189448441247,20.0,20.0
10085,2,2085,[272 303 315 478 211],537,5,7786,3.732502396931927,20.0,20.0
10086,2,2086,[272 303 315 478 211],13,5,7791,3.73310972688069,20.0,20.0
10087,2,2087,[272 303 315 478 211],13,5,7796,3.7337164750957856,20.0,20.0
10088,2,2088,[272 303 315 478 211],13,5,7801,3.7343226424126374,20.0,20.0
10089,2,2089,[272 303 315 478 211],537,5,7806,3.734928229665072,20.0,20.0
10090,2,2090,[272 303 315 478 211],537,5,7811,3.735533237685318,20.0,20.0
10091,2,2091,[316 367 481 222 216],234,3,7814,3.7351816443594648,20.0,20.0
10092,2,2092,[272 303 315 478 211],537,5,7819,3.7357859531772575,20.0,20.0
10093,2,2093,[272 303 315 478 211],13,5,7824,3.7363896848137537,20.0,20.0
10094,2,2094,[272 303 315 478 211],13,5,7829,3.7369928400954655,20.0,20.0
10095,2,2095,[272 303 315 478 211],537,5,7834,3.7375954198473282,20.0,20.0
10096,2,2096,[272 303 315 478 211],13,5,7839,3.7381974248927037,20.0,20.0
10097,2,2097,[272 303 315 478 211],13,5,7844,3.7387988560533842,20.0,20.0
10098,2,2098,[272 303 315 478 211],537,5,7849,3.739399714149595,20.0,20.0
10099,2,2099,[230 420 300 378 583],7,3,7852,3.739047619047619,0.0,20.0
10100,2,2100,[272 303 315 478 211],537,5,7857,3.7396477867682054,20.0,20.0
10101,2,2101,[241 485 413 299 507],13,0,7857,3.737868696479543,0.0,0.0
10102,2,2102,[272 303 315 478 211],13,5,7862,3.7384688540180693,20.0,20.0
10103,2,2103,[272 303 315 478 211],537,5,7867,3.7390684410646386,20.0,20.0
10104,2,2104,[272 303 315 478 211],537,5,7872,3.739667458432304,20.0,20.0
10105,2,2105,[272 303 315 478 211],537,5,7877,3.7402659069325734,20.0,20.0
10106,2,2106,[272 303 315 478 211],537,5,7882,3.740863787375415,20.0,20.0
10107,2,2107,[272 303 315 478 211],537,5,7887,3.74146110056926,20.0,20.0
10108,2,2108,[272 303 315 478 211],13,5,7892,3.7420578473210053,20.0,20.0
10109,2,2109,[272 303 315 478 211],13,5,7897,3.742654028436019,20.0,20.0
10110,2,2110,[272 303 315 478 211],13,5,7902,3.743249644718143,20.0,20.0
10111,2,2111,[272 303 315 478 211],13,5,7907,3.743844696969697,20.0,20.0
10112,2,2112,[272 303 315 478 211],537,5,7912,3.744439185991481,20.0,20.0
10113,2,2113,[429 212 216 481 226],234,2,7914,3.7436140018921478,0.0,0.0
10114,2,2114,[272 303 315 478 211],537,5,7919,3.744208037825059,20.0,20.0
10115,2,2115,[272 303 315 478 211],537,5,7924,3.7448015122873346,20.0,20.0
10116,2,2116,[272 303 315 478 211],537,5,7929,3.745394426074634,20.0,20.0
10117,2,2117,[272 303 315 478 211],13,5,7934,3.745986779981114,20.0,20.0
10118,2,2118,[272 303 315 478 211],13,5,7939,3.746578574799434,20.0,20.0
10119,2,2119,[280 429 290 213 485],234,1,7940,3.7452830188679247,0.0,0.0
10120,2,2120,[272 303 315 478 211],13,5,7945,3.745874587458746,20.0,20.0
10121,2,2121,[394 250 212 300 236],145,1,7946,3.7445805843543827,0.0,20.0
10122,2,2122,[272 303 315 478 211],13,5,7951,3.7451719265190766,20.0,20.0
10123,2,2123,[272 303 315 478 211],537,5,7956,3.7457627118644066,20.0,20.0
10124,2,2124,[216 272 276 243 231],537,2,7958,3.744941176470588,0.0,20.0
10125,2,2125,[272 303 315 478 211],13,5,7963,3.7455315145813737,20.0,20.0
10126,2,2126,[272 303 315 478 211],537,5,7968,3.7461212976022567,20.0,20.0
10127,2,2127,[272 303 315 478 211],537,5,7973,3.7467105263157894,20.0,20.0
10128,2,2128,[272 303 315 478 211],537,5,7978,3.7472992015030533,20.0,20.0
10129,2,2129,[222 272 293 226 219],653,1,7979,3.7460093896713613,0.0,20.0
10130,2,2130,[272 303 315 478 211],13,5,7984,3.7465978413890193,20.0,20.0
10131,2,2131,[272 303 315 478 211],537,5,7989,3.74718574108818,20.0,20.0
10132,2,2132,[272 303 315 478 211],537,5,7994,3.7477730895452415,20.0,20.0
10133,2,2133,[272 303 315 478 211],537,5,7999,3.748359887535145,20.0,20.0
10134,2,2134,[478 202 298 378 231],749,5,8004,3.748946135831382,0.0,0.0
10135,2,2135,[272 303 315 478 211],537,5,8009,3.7495318352059925,20.0,20.0
10136,2,2136,[272 303 315 478 211],537,5,8014,3.7501169864295743,20.0,20.0
10137,2,2137,[272 303 315 478 211],13,5,8019,3.7507015902712815,20.0,20.0
10138,2,2138,[272 303 315 478 211],537,5,8024,3.751285647498831,20.0,20.0
10139,2,2139,[283 255 300 268 508],334,2,8026,3.750467289719626,0.0,20.0
10140,2,2140,[272 303 315 478 211],13,5,8031,3.751050910789351,20.0,20.0
10141,2,2141,[272 303 315 478 211],13,5,8036,3.7516339869281046,20.0,20.0
10142,2,2142,[272 303 315 478 211],537,5,8041,3.75221651889874,20.0,20.0
10143,2,2143,[272 303 315 478 211],13,5,8046,3.7527985074626864,20.0,20.0
10144,2,2144,[272 303 315 478 211],13,5,8051,3.7533799533799534,20.0,20.0
10145,2,2145,[431 230 384 218 429],833,1,8052,3.7520969245107176,0.0,0.0
10146,2,2146,[211 240 298 485 232],749,4,8056,3.752212389380531,0.0,20.0
10147,2,2147,[272 303 315 478 211],537,5,8061,3.7527932960893855,20.0,20.0
10148,2,2148,[272 303 315 478 211],13,5,8066,3.7533736621684506,20.0,20.0
10149,2,2149,[272 303 315 478 211],13,5,8071,3.753953488372093,20.0,20.0
10150,2,2150,[272 303 315 478 211],537,5,8076,3.7545327754532773,20.0,20.0
10151,2,2151,[272 303 315 478 211],537,5,8081,3.755111524163569,20.0,20.0
10152,2,2152,[218 291 201 227 324],833,2,8083,3.754296330701347,0.0,0.0
10153,2,2153,[272 303 315 478 211],537,5,8088,3.754874651810585,20.0,20.0
10154,2,2154,[431 280 331 481 227],13,2,8090,3.754060324825986,0.0,0.0
10155,2,2155,[272 303 315 478 211],13,5,8095,3.754638218923933,20.0,20.0
10156,2,2156,[272 303 315 478 211],13,5,8100,3.755215577190542,20.0,20.0
10157,2,2157,[272 303 315 478 211],13,5,8105,3.7557924003707135,20.0,20.0
10158,2,2158,[272 303 315 478 211],537,5,8110,3.756368689207967,20.0,20.0
10159,2,2159,[272 303 315 478 211],537,5,8115,3.7569444444444446,20.0,20.0
10160,2,2160,[272 303 315 478 211],537,5,8120,3.757519666820916,20.0,20.0
10161,2,2161,[216 211 331 232 507],13,1,8121,3.7562442183163736,0.0,20.0
10162,2,2162,[223 481 202 215 276],643,3,8124,3.7558945908460473,20.0,20.0
10163,2,2163,[272 303 315 478 211],13,5,8129,3.7564695009242146,20.0,20.0
10164,2,2164,[255 295 300 367 222],533,3,8132,3.7561200923787528,0.0,40.0
10165,2,2165,[272 303 315 478 211],537,5,8137,3.756694367497692,20.0,20.0
10166,2,2166,[272 303 315 478 211],13,5,8142,3.757268112598062,20.0,20.0
10167,2,2167,[272 303 315 478 211],537,5,8147,3.757841328413284,20.0,20.0
10168,2,2168,[272 303 315 478 211],537,5,8152,3.7584140156754264,20.0,20.0
10169,2,2169,[259 507 284 223 219],234,1,8153,3.757142857142857,20.0,0.0
10170,2,2170,[272 303 315 478 211],537,5,8158,3.7577153385536617,20.0,20.0
10171,2,2171,[272 303 315 478 211],537,5,8163,3.7582872928176796,20.0,20.0
10172,2,2172,[223 326 299 275 226],328,3,8166,3.7579383341003223,20.0,20.0
10173,2,2173,[272 303 315 478 211],13,5,8171,3.7585096596136154,20.0,20.0
10174,2,2174,[272 303 315 478 211],537,5,8176,3.759080459770115,20.0,20.0
10175,2,2175,[272 303 315 478 211],537,5,8181,3.7596507352941178,20.0,20.0
10176,2,2176,[272 303 315 478 211],537,5,8186,3.76022048690859,20.0,20.0
10177,2,2177,[213 300 268 315 321],574,3,8189,3.7598714416896235,20.0,20.0
10178,2,2178,[272 303 315 478 211],537,5,8194,3.76044056906838,20.0,20.0
10179,2,2179,[272 303 315 478 211],537,5,8199,3.7610091743119267,20.0,20.0
10180,2,2180,[272 303 315 478 211],537,5,8204,3.7615772581384688,20.0,20.0
10181,2,2181,[272 303 315 478 211],537,5,8209,3.7621448212648945,20.0,20.0
10182,2,2182,[272 303 315 478 211],537,5,8214,3.76271186440678,20.0,20.0
10183,2,2183,[272 303 315 478 211],537,5,8219,3.7632783882783882,20.0,20.0
10184,2,2184,[272 303 315 478 211],13,5,8224,3.7638443935926773,20.0,20.0
10185,2,2185,[272 303 315 478 211],13,5,8229,3.764409881061299,20.0,20.0
10186,2,2186,[272 303 315 478 211],537,5,8234,3.7649748513946046,20.0,20.0
10187,2,2187,[272 303 315 478 211],13,5,8239,3.7655393053016453,20.0,20.0
10188,2,2188,[272 303 315 478 211],537,5,8244,3.766103243490178,20.0,20.0
10189,2,2189,[272 303 315 478 211],537,5,8249,3.7666666666666666,20.0,20.0
10190,2,2190,[272 303 315 478 211],13,5,8254,3.767229575536285,20.0,20.0
10191,2,2191,[272 303 315 478 211],537,5,8259,3.7677919708029197,20.0,20.0
10192,2,2192,[272 303 315 478 211],13,5,8264,3.7683538531691747,20.0,20.0
10193,2,2193,[272 303 315 478 211],13,5,8269,3.768915223336372,20.0,20.0
10194,2,2194,[222 485 232 227 223],650,1,8270,3.7676537585421412,20.0,20.0
10195,2,2195,[272 303 315 478 211],13,5,8275,3.7682149362477233,20.0,20.0
10196,2,2196,[272 303 315 478 211],13,5,8280,3.7687756030951296,20.0,20.0
10197,2,2197,[272 303 315 478 211],537,5,8285,3.7693357597816197,20.0,20.0
10198,2,2198,[272 303 315 478 211],13,5,8290,3.769895407003183,20.0,20.0
10199,2,2199,[284 583 275 283 226],158,3,8293,3.7695454545454545,0.0,20.0
10200,2,2200,[272 303 315 478 211],537,5,8298,3.770104497955475,20.0,20.0
10201,2,2201,[216 243 230 219 290],13,1,8299,3.768846503178928,0.0,0.0
10202,2,2202,[272 303 315 478 211],13,5,8304,3.7694053563322742,20.0,20.0
10203,2,2203,[272 303 315 478 211],537,5,8309,3.769963702359347,20.0,20.0
10204,2,2204,[272 303 315 478 211],13,5,8314,3.7705215419501132,20.0,20.0
10205,2,2205,[272 303 315 478 211],537,5,8319,3.771078875793291,20.0,20.0
10206,2,2206,[272 303 315 478 211],537,5,8324,3.771635704576348,20.0,20.0
10207,2,2207,[272 303 315 478 211],13,5,8329,3.7721920289855073,20.0,20.0
10208,2,2208,[321 261 239 301 272],13,2,8331,3.7713897691263014,0.0,0.0
10209,2,2209,[272 303 315 478 211],13,5,8336,3.771945701357466,20.0,20.0
10210,2,2210,[272 303 315 478 211],537,5,8341,3.772501130710086,20.0,20.0
10211,2,2211,[272 303 315 478 211],13,5,8346,3.7730560578661843,20.0,20.0
10212,2,2212,[272 303 315 478 211],537,5,8351,3.7736104835065523,20.0,20.0
10213,2,2213,[293 298 507 227 276],474,4,8355,3.7737127371273713,0.0,20.0
10214,2,2214,[250 303 485 208 272],334,3,8358,3.7733634311512416,0.0,0.0
10215,2,2215,[272 303 315 478 211],13,5,8363,3.773916967509025,20.0,20.0
10216,2,2216,[272 303 315 478 211],537,5,8368,3.7744700045106,20.0,20.0
10217,2,2217,[272 303 315 478 211],537,5,8373,3.7750225428313797,20.0,20.0
10218,2,2218,[272 303 315 478 211],13,5,8378,3.775574583145561,20.0,20.0
10219,2,2219,[275 236 291 431 239],279,3,8381,3.7752252252252254,0.0,20.0
10220,2,2220,[272 303 315 478 211],13,5,8386,3.775776677172445,20.0,20.0
10221,2,2221,[272 303 315 478 211],13,5,8391,3.776327632763276,20.0,20.0
10222,2,2222,[272 303 315 478 211],537,5,8396,3.7768780926675665,20.0,20.0
10223,2,2223,[272 303 315 478 211],13,5,8401,3.7774280575539567,20.0,20.0
10224,2,2224,[272 303 315 478 211],13,5,8406,3.7779775280898877,20.0,20.0
10225,2,2225,[272 303 315 478 211],13,5,8411,3.7785265049415995,20.0,20.0
10226,2,2226,[275 429 283 209 291],308,3,8414,3.778176919622811,0.0,20.0
10227,2,2227,[272 303 315 478 211],13,5,8419,3.778725314183124,20.0,20.0
10228,2,2228,[272 303 315 478 211],537,5,8424,3.779273216689098,20.0,20.0
10229,2,2229,[272 303 315 478 211],537,5,8429,3.7798206278026907,20.0,20.0
10230,2,2230,[272 303 315 478 211],537,5,8434,3.7803675481846706,20.0,20.0
10231,2,2231,[272 303 315 478 211],537,5,8439,3.7809139784946235,20.0,20.0
10232,2,2232,[272 303 315 478 211],537,5,8444,3.781459919390954,20.0,20.0
10233,2,2233,[209 219 212 301 268],145,4,8448,3.781557743957028,0.0,0.0
10234,2,2234,[272 303 315 478 211],13,5,8453,3.782102908277405,20.0,20.0
10235,2,2235,[272 303 315 478 211],537,5,8458,3.782647584973166,20.0,20.0
10236,2,2236,[272 303 315 478 211],13,5,8463,3.7831917746982566,20.0,20.0
10237,2,2237,[272 303 315 478 211],13,5,8468,3.7837354781054513,20.0,20.0
10238,2,2238,[272 303 315 478 211],537,5,8473,3.78427869584636,20.0,20.0
10239,2,2239,[272 303 315 478 211],537,5,8478,3.7848214285714286,20.0,20.0
10240,2,2240,[272 303 315 478 211],13,5,8483,3.785363676929942,20.0,20.0
10241,2,2241,[272 303 315 478 211],537,5,8488,3.785905441570027,20.0,20.0
10242,2,2242,[316 280 226 429 507],234,3,8491,3.7855550601872494,20.0,0.0
10243,2,2243,[272 303 315 478 211],13,5,8496,3.786096256684492,20.0,20.0
10244,2,2244,[268 452 208 324 507],7,3,8499,3.7857461024498886,0.0,0.0
10245,2,2245,[272 303 315 478 211],13,5,8504,3.786286731967943,20.0,20.0
10246,2,2246,[301 221 220 213 255],334,2,8506,3.785491766800178,0.0,0.0
10247,2,2247,[272 303 315 478 211],13,5,8511,3.786032028469751,20.0,20.0
10248,2,2248,[478 212 429 301 215],650,2,8513,3.7852378835037794,0.0,0.0
10249,2,2249,[272 303 315 478 211],13,5,8518,3.7857777777777777,20.0,20.0
10250,2,2250,[272 303 315 478 211],13,5,8523,3.7863171923589514,20.0,20.0
10251,2,2251,[272 303 315 478 211],537,5,8528,3.786856127886323,20.0,20.0
10252,2,2252,[272 303 315 478 211],13,5,8533,3.787394584997781,20.0,20.0
10253,2,2253,[272 303 315 478 211],537,5,8538,3.78793256433008,20.0,20.0
10254,2,2254,[216 223 509 478 206],650,3,8541,3.7875831485587583,20.0,0.0
10255,2,2255,[284 290 392 241 201],537,0,8541,3.785904255319149,0.0,0.0
10256,2,2256,[232 226 336 344 507],13,1,8542,3.7846699158174566,0.0,0.0
10257,2,2257,[272 303 315 478 211],13,5,8547,3.7852081488042515,20.0,20.0
10258,2,2258,[272 303 315 478 211],537,5,8552,3.7857459052678175,20.0,20.0
10259,2,2259,[290 378 301 284 283],537,1,8553,3.784513274336283,0.0,0.0
10260,2,2260,[272 303 315 478 211],13,5,8558,3.7850508624502432,20.0,20.0
10261,2,2261,[272 303 315 478 211],13,5,8563,3.7855879752431476,20.0,20.0
10262,2,2262,[272 303 315 478 211],537,5,8568,3.786124613345117,20.0,20.0
10263,2,2263,[272 303 315 478 211],13,5,8573,3.786660777385159,20.0,20.0
10264,2,2264,[300 316 230 209 216],334,2,8575,3.7858719646799117,20.0,20.0
10265,2,2265,[272 303 315 478 211],537,5,8580,3.7864077669902914,20.0,20.0
10266,2,2266,[272 303 315 478 211],13,5,8585,3.7869430966034408,20.0,20.0
10267,2,2267,[236 293 216 300 255],533,3,8588,3.7865961199294533,0.0,20.0
10268,2,2268,[272 303 315 478 211],13,5,8593,3.7871308946672544,20.0,20.0
10269,2,2269,[272 303 315 478 211],537,5,8598,3.7876651982378853,20.0,20.0
10270,2,2270,[272 218 226 300 276],548,3,8601,3.787318361955086,0.0,40.0
10271,2,2271,[272 303 315 478 211],537,5,8606,3.7878521126760565,20.0,20.0
10272,2,2272,[275 321 232 509 367],311,1,8607,3.7866256049274085,0.0,20.0
10273,2,2273,[212 276 230 208 216],311,4,8611,3.7867194371152153,0.0,20.0
10274,2,2274,[272 303 315 478 211],13,5,8616,3.7872527472527473,20.0,20.0
10275,2,2275,[272 303 315 478 211],13,5,8621,3.7877855887521967,20.0,20.0
10276,2,2276,[272 303 315 478 211],13,5,8626,3.7883179622310057,20.0,20.0
10277,2,2277,[272 303 315 478 211],13,5,8631,3.7888498683055314,20.0,20.0
10278,2,2278,[431 202 300 290 232],13,2,8633,3.7880649407634928,0.0,20.0
10279,2,2279,[256 315 272 316 244],894,4,8637,3.788157894736842,40.0,0.0
10280,2,2280,[291 485 208 431 202],234,1,8638,3.786935554581324,0.0,0.0
10281,2,2281,[243 217 222 300 478],13,1,8639,3.7857142857142856,0.0,40.0
10282,2,2282,[367 384 275 413 301],279,3,8642,3.785370127025843,0.0,20.0
10283,2,2283,[272 303 315 478 211],13,5,8647,3.7859019264448337,20.0,20.0
10284,2,2284,[272 303 315 478 211],537,5,8652,3.7864332603938733,20.0,20.0
10285,2,2285,[272 303 315 478 211],537,5,8657,3.7869641294838146,20.0,20.0
10286,2,2286,[272 303 315 478 211],13,5,8662,3.7874945343244426,20.0,20.0
10287,2,2287,[231 240 509 283 431],279,2,8664,3.7867132867132867,0.0,0.0
10288,2,2288,[272 303 315 478 211],537,5,8669,3.787243337702053,20.0,20.0
10289,2,2289,[272 303 315 478 211],13,5,8674,3.7877729257641923,20.0,20.0
10290,2,2290,[272 303 315 478 211],13,5,8679,3.7883020515058927,20.0,20.0
10291,2,2291,[272 303 315 478 211],13,5,8684,3.7888307155322862,20.0,20.0
10292,2,2292,[272 303 315 478 211],13,5,8689,3.7893589184474488,20.0,20.0
10293,2,2293,[272 303 315 478 211],537,5,8694,3.789886660854403,20.0,20.0
10294,2,2294,[272 303 315 478 211],537,5,8699,3.79041394335512,20.0,20.0
10295,2,2295,[272 303 315 478 211],537,5,8704,3.7909407665505226,20.0,20.0
10296,2,2296,[272 303 315 478 211],537,5,8709,3.7914671310404877,20.0,20.0
10297,2,2297,[222 219 259 413 291],279,1,8710,3.7902523933855528,0.0,20.0
10298,2,2298,[272 303 315 478 211],537,5,8715,3.7907785993910394,20.0,20.0
10299,2,2299,[226 217 275 227 243],13,2,8717,3.79,0.0,20.0
10300,2,2300,[272 303 315 478 211],537,5,8722,3.7905258583224684,20.0,20.0
10301,2,2301,[272 303 315 478 211],13,5,8727,3.7910512597741093,20.0,20.0
10302,2,2302,[431 485 215 378 420],295,5,8732,3.791576204950065,0.0,0.0
10303,2,2303,[272 303 315 478 211],13,5,8737,3.7921006944444446,20.0,20.0
10304,2,2304,[272 303 315 478 211],13,5,8742,3.7926247288503254,20.0,20.0
10305,2,2305,[254 509 209 255 291],308,3,8745,3.7922810060711187,0.0,0.0
10306,2,2306,[272 303 315 478 211],13,5,8750,3.7928045080190724,20.0,20.0
10307,2,2307,[272 303 315 478 211],537,5,8755,3.7933275563258233,20.0,20.0
10308,2,2308,[272 303 315 478 211],13,5,8760,3.793850151580771,20.0,20.0
10309,2,2309,[231 246 222 221 301],85,2,8762,3.793073593073593,0.0,20.0
10310,2,2310,[272 303 315 478 211],13,5,8767,3.7935958459541324,20.0,20.0
10311,2,2311,[215 239 485 216 208],650,2,8769,3.792820069204152,0.0,0.0
10312,2,2312,[272 303 315 478 211],13,5,8774,3.793341980112408,20.0,20.0
10313,2,2313,[272 303 315 478 211],13,5,8779,3.7938634399308557,20.0,20.0
10314,2,2314,[275 509 213 276 481],308,5,8784,3.7943844492440606,0.0,40.0
10315,2,2315,[272 303 315 478 211],537,5,8789,3.7949050086355784,20.0,20.0
10316,2,2316,[212 222 509 303 239],13,4,8793,3.7949935261113508,0.0,20.0
10317,2,2317,[272 303 315 478 211],537,5,8798,3.795513373597929,20.0,20.0
10318,2,2318,[272 303 315 478 211],537,5,8803,3.7960327727468735,20.0,20.0
10319,2,2319,[218 321 239 420 216],311,2,8805,3.7952586206896552,0.0,0.0
10320,2,2320,[272 303 315 478 211],13,5,8810,3.795777682033606,20.0,20.0
10321,2,2321,[272 303 315 478 211],537,5,8815,3.7962962962962963,20.0,20.0
10322,2,2322,[272 303 315 478 211],537,5,8820,3.7968144640551014,20.0,20.0
10323,2,2323,[272 303 315 478 211],13,5,8825,3.7973321858864026,20.0,20.0
10324,2,2324,[215 241 507 290 264],13,3,8828,3.796989247311828,0.0,0.0
10325,2,2325,[272 303 315 478 211],537,5,8833,3.7975064488392087,20.0,20.0
10326,2,2326,[272 303 315 478 211],537,5,8838,3.798023205844435,20.0,20.0
10327,2,2327,[272 303 315 478 211],537,5,8843,3.7985395189003435,20.0,20.0
10328,2,2328,[272 303 315 478 211],537,5,8848,3.799055388578789,20.0,20.0
10329,2,2329,[272 303 315 478 211],13,5,8853,3.7995708154506436,20.0,20.0
10330,2,2330,[272 303 315 478 211],537,5,8858,3.8000858000858,20.0,20.0
10331,2,2331,[226 227 223 202 241],194,1,8859,3.7988850771869638,20.0,0.0
10332,2,2332,[272 303 315 478 211],13,5,8864,3.799399914273468,20.0,20.0
10333,2,2333,[272 303 315 478 211],537,5,8869,3.7999143101970865,20.0,20.0
10334,2,2334,[239 244 208 231 508],334,1,8870,3.798715203426124,0.0,0.0
10335,2,2335,[272 303 315 478 211],13,5,8875,3.7992294520547945,20.0,20.0
10336,2,2336,[272 303 315 478 211],13,5,8880,3.7997432605905006,20.0,20.0
10337,2,2337,[272 303 315 478 211],13,5,8885,3.8002566295979467,20.0,20.0
10338,2,2338,[239 478 350 201 208],13,3,8888,3.7999144933732363,0.0,0.0
10339,2,2339,[272 303 315 478 211],537,5,8893,3.8004273504273502,20.0,20.0
10340,2,2340,[272 303 315 478 211],13,5,8898,3.8009397693293465,20.0,20.0
10341,2,2341,[272 303 315 478 211],13,5,8903,3.8014517506404784,20.0,20.0
10342,2,2342,[299 336 243 227 478],13,2,8905,3.8006828851899273,0.0,0.0
10343,2,2343,[272 303 315 478 211],13,5,8910,3.801194539249147,20.0,20.0
10344,2,2344,[272 303 315 478 211],537,5,8915,3.8017057569296377,20.0,20.0
10345,2,2345,[272 303 315 478 211],537,5,8920,3.8022165387894287,20.0,20.0
10346,2,2346,[272 303 315 478 211],537,5,8925,3.8027268853855984,20.0,20.0
10347,2,2347,[272 303 315 478 211],13,5,8930,3.803236797274276,20.0,20.0
10348,2,2348,[217 202 227 300 209],64,2,8932,3.802469135802469,0.0,20.0
10349,2,2349,[272 303 315 478 211],537,5,8937,3.802978723404255,20.0,20.0
10350,2,2350,[272 303 315 478 211],13,5,8942,3.8034878774989367,20.0,20.0
10351,2,2351,[272 303 315 478 211],537,5,8947,3.803996598639456,20.0,20.0
10352,2,2352,[272 303 315 478 211],13,5,8952,3.8045048873778153,20.0,20.0
10353,2,2353,[272 303 315 478 211],537,5,8957,3.8050127442650807,20.0,20.0
10354,2,2354,[272 303 315 478 211],537,5,8962,3.80552016985138,20.0,20.0
10355,2,2355,[272 303 315 478 211],13,5,8967,3.8060271646859083,20.0,20.0
10356,2,2356,[272 303 315 478 211],13,5,8972,3.806533729316928,20.0,20.0
10357,2,2357,[272 303 315 478 211],13,5,8977,3.807039864291773,20.0,20.0
10358,2,2358,[272 303 315 478 211],13,5,8982,3.807545570156846,20.0,20.0
10359,2,2359,[272 303 315 478 211],537,5,8987,3.808050847457627,20.0,20.0
10360,2,2360,[272 303 315 478 211],537,5,8992,3.80855569673867,20.0,20.0
10361,2,2361,[272 303 315 478 211],537,5,8997,3.809060118543607,20.0,20.0
10362,2,2362,[272 303 315 478 211],537,5,9002,3.80956411341515,20.0,20.0
10363,2,2363,[298 219 202 431 452],145,3,9005,3.8092216582064298,0.0,0.0
10364,2,2364,[272 303 315 478 211],13,5,9010,3.809725158562368,20.0,20.0
10365,2,2365,[272 303 315 478 211],537,5,9015,3.8102282333051565,20.0,20.0
10366,2,2366,[272 303 315 478 211],537,5,9020,3.810730882974229,20.0,20.0
10367,2,2367,[272 303 315 478 211],537,5,9025,3.811233108108108,20.0,20.0
10368,2,2368,[202 201 507 275 222],13,1,9026,3.8100464330941324,0.0,40.0
10369,2,2369,[272 303 315 478 211],537,5,9031,3.810548523206751,20.0,20.0
10370,2,2370,[272 303 315 478 211],13,5,9036,3.811050189793336,20.0,20.0
10371,2,2371,[272 303 315 478 211],13,5,9041,3.811551433389545,20.0,20.0
10372,2,2372,[272 303 315 478 211],13,5,9046,3.8120522545301307,20.0,20.0
10373,2,2373,[272 303 315 478 211],537,5,9051,3.812552653748947,20.0,20.0
10374,2,2374,[272 303 315 478 211],13,5,9056,3.8130526315789472,20.0,20.0
10375,2,2375,[272 303 315 478 211],13,5,9061,3.8135521885521886,20.0,20.0
10376,2,2376,[272 303 315 478 211],537,5,9066,3.8140513251998316,20.0,20.0
10377,2,2377,[272 303 315 478 211],13,5,9071,3.8145500420521445,20.0,20.0
10378,2,2378,[272 303 315 478 211],537,5,9076,3.8150483396385035,20.0,20.0
10379,2,2379,[272 303 315 478 211],13,5,9081,3.815546218487395,20.0,20.0
10380,2,2380,[367 232 231 326 392],64,1,9082,3.8143637127257457,0.0,0.0
10381,2,2381,[272 303 315 478 211],537,5,9087,3.8148614609571787,20.0,20.0
10382,2,2382,[507 246 268 275 481],85,4,9091,3.8149391523289973,0.0,20.0
10383,2,2383,[272 303 315 478 211],13,5,9096,3.815436241610738,20.0,20.0
10384,2,2384,[230 226 215 344 299],13,2,9098,3.8146750524109017,0.0,0.0
10385,2,2385,[272 303 315 478 211],13,5,9103,3.8151718357082984,20.0,20.0
10386,2,2386,[272 303 315 478 211],13,5,9108,3.815668202764977,20.0,20.0
10387,2,2387,[272 303 315 478 211],13,5,9113,3.8161641541038525,20.0,20.0
10388,2,2388,[291 420 509 478 283],85,3,9116,3.815822519882796,0.0,0.0
10389,2,2389,[272 303 315 478 211],13,5,9121,3.816317991631799,20.0,20.0
10390,2,2390,[272 303 315 478 211],13,5,9126,3.8168130489335006,20.0,20.0
10391,2,2391,[272 303 315 478 211],537,5,9131,3.8173076923076925,20.0,20.0
10392,2,2392,[272 303 315 478 211],537,5,9136,3.817801922273297,20.0,20.0
10393,2,2393,[272 303 315 478 211],537,5,9141,3.818295739348371,20.0,20.0
10394,2,2394,[272 303 315 478 211],13,5,9146,3.8187891440501045,20.0,20.0
10395,2,2395,[272 303 315 478 211],13,5,9151,3.8192821368948247,20.0,20.0
10396,2,2396,[241 216 431 211 485],311,2,9153,3.818523153942428,0.0,20.0
10397,2,2397,[272 303 315 478 211],537,5,9158,3.8190158465387825,20.0,20.0
10398,2,2398,[272 303 315 478 211],537,5,9163,3.8195081283868277,20.0,20.0
10399,2,2399,[272 303 315 478 211],13,5,9168,3.82,20.0,20.0
10400,2,2400,[272 303 315 478 211],537,5,9173,3.820491461890879,20.0,20.0
10401,2,2401,[299 208 316 216 239],13,3,9176,3.82014987510408,20.0,0.0
10402,2,2402,[272 303 315 478 211],13,5,9181,3.8206408655846857,20.0,20.0
10403,2,2403,[272 303 315 478 211],13,5,9186,3.8211314475873546,20.0,20.0
10404,2,2404,[216 202 213 219 268],234,0,9186,3.8195426195426196,0.0,0.0
10405,2,2405,[272 303 315 478 211],13,5,9191,3.8200332502078136,20.0,20.0
10406,2,2406,[276 254 226 316 209],119,2,9193,3.819277108433735,20.0,20.0
10407,2,2407,[272 303 315 478 211],13,5,9198,3.8197674418604652,20.0,20.0
10408,2,2408,[272 303 315 478 211],537,5,9203,3.8202573682025736,20.0,20.0
10409,2,2409,[272 303 315 478 211],13,5,9208,3.820746887966805,20.0,20.0
10410,2,2410,[219 316 509 350 485],13,2,9210,3.819991704686852,20.0,0.0
10411,2,2411,[272 303 315 478 211],13,5,9215,3.820480928689884,20.0,20.0
10412,2,2412,[272 303 315 478 211],537,5,9220,3.8209697472026525,20.0,20.0
10413,2,2413,[268 485 508 301 241],85,3,9223,3.82062966031483,0.0,0.0
10414,2,2414,[272 303 315 478 211],537,5,9228,3.8211180124223603,20.0,20.0
10415,2,2415,[272 303 315 478 211],13,5,9233,3.821605960264901,20.0,20.0
10416,2,2416,[213 283 221 378 201],537,2,9235,3.820852296235002,0.0,0.0
10417,2,2417,[255 290 300 236 216],334,1,9236,3.8196856906534324,0.0,20.0
10418,2,2418,[212 209 226 507 301],13,2,9238,3.8189334435717237,0.0,0.0
10419,2,2419,[272 303 315 478 211],537,5,9243,3.819421487603306,20.0,20.0
10420,2,2420,[232 429 508 209 336],13,1,9244,3.818256918628666,0.0,0.0
10421,2,2421,[272 303 315 478 211],537,5,9249,3.8187448389760528,20.0,20.0
10422,2,2422,[272 303 315 478 211],537,5,9254,3.8192323565827486,20.0,20.0
10423,2,2423,[272 303 315 478 211],537,5,9259,3.8197194719471947,20.0,20.0
10424,2,2424,[272 303 315 478 211],537,5,9264,3.8202061855670104,20.0,20.0
10425,2,2425,[272 303 315 478 211],13,5,9269,3.8206924979389942,20.0,20.0
10426,2,2426,[272 303 315 478 211],13,5,9274,3.8211784095591264,20.0,20.0
10427,2,2427,[272 303 315 478 211],537,5,9279,3.8216639209225702,20.0,20.0
10428,2,2428,[283 378 216 301 300],537,1,9280,3.820502264306299,0.0,20.0
10429,2,2429,[272 303 315 478 211],13,5,9285,3.8209876543209877,20.0,20.0
10430,2,2430,[272 303 315 478 211],537,5,9290,3.8214726450020566,20.0,20.0
10431,2,2431,[272 303 315 478 211],13,5,9295,3.8219572368421053,20.0,20.0
10432,2,2432,[290 243 276 223 219],13,3,9298,3.8216193999177968,20.0,20.0
10433,2,2433,[217 241 365 268 208],7,4,9302,3.8216926869350862,0.0,0.0
10434,2,2434,[272 303 315 478 211],13,5,9307,3.82217659137577,20.0,20.0
10435,2,2435,[272 303 315 478 211],537,5,9312,3.8226600985221677,20.0,20.0
10436,2,2436,[272 303 315 478 211],537,5,9317,3.823143208863357,20.0,20.0
10437,2,2437,[272 303 315 478 211],537,5,9322,3.823625922887613,20.0,20.0
10438,2,2438,[272 303 315 478 211],13,5,9327,3.8241082410824108,20.0,20.0
10439,2,2439,[272 303 315 478 211],13,5,9332,3.824590163934426,20.0,20.0
10440,2,2440,[272 303 315 478 211],537,5,9337,3.825071691929537,20.0,20.0
10441,2,2441,[272 303 315 478 211],537,5,9342,3.8255528255528257,20.0,20.0
10442,2,2442,[272 303 315 478 211],537,5,9347,3.8260335652885797,20.0,20.0
10443,2,2443,[272 303 315 478 211],537,5,9352,3.8265139116202946,20.0,20.0
10444,2,2444,[272 303 315 478 211],13,5,9357,3.826993865030675,20.0,20.0
10445,2,2445,[272 303 315 478 211],537,5,9362,3.827473426001635,20.0,20.0
10446,2,2446,[303 283 300 507 236],537,3,9365,3.827135267674704,0.0,20.0
10447,2,2447,[315 303 244 284 276],894,4,9369,3.827205882352941,20.0,20.0
10448,2,2448,[272 303 315 478 211],537,5,9374,3.8276847692935894,20.0,20.0
10449,2,2449,[272 303 315 478 211],537,5,9379,3.8281632653061224,20.0,20.0
10450,2,2450,[241 209 250 261 201],479,3,9382,3.827825377396981,0.0,0.0
10451,2,2451,[272 303 315 478 211],13,5,9387,3.8283034257748776,20.0,20.0
10452,2,2452,[272 303 315 478 211],537,5,9392,3.8287810843864656,20.0,20.0
10453,2,2453,[272 303 315 478 211],13,5,9397,3.8292583537082314,20.0,20.0
10454,2,2454,[275 420 485 239 230],308,3,9400,3.8289205702647657,0.0,20.0
10455,2,2455,[272 303 315 478 211],13,5,9405,3.829397394136808,20.0,20.0
10456,2,2456,[272 303 315 478 211],13,5,9410,3.8298738298738297,20.0,20.0
10457,2,2457,[272 303 315 478 211],537,5,9415,3.8303498779495526,20.0,20.0
10458,2,2458,[272 303 315 478 211],13,5,9420,3.8308255388369257,20.0,20.0
10459,2,2459,[272 303 315 478 211],13,5,9425,3.8313008130081303,20.0,20.0
10460,2,2460,[272 303 315 478 211],13,5,9430,3.8317757009345796,20.0,20.0
10461,2,2461,[272 303 315 478 211],537,5,9435,3.832250203086921,20.0,20.0
10462,2,2462,[272 303 315 478 211],13,5,9440,3.8327243199350387,20.0,20.0
10463,2,2463,[272 303 315 478 211],13,5,9445,3.833198051948052,20.0,20.0
10464,2,2464,[216 275 367 316 452],13,1,9446,3.832048681541582,20.0,20.0
10465,2,2465,[208 284 236 321 316],234,2,9448,3.8313057583130576,20.0,0.0
10466,2,2466,[272 303 315 478 211],13,5,9453,3.831779489258208,20.0,20.0
10467,2,2467,[272 303 315 478 211],13,5,9458,3.8322528363047,20.0,20.0
10468,2,2468,[223 216 259 209 264],308,2,9460,3.8315107330903198,20.0,0.0
10469,2,2469,[272 303 315 478 211],537,5,9465,3.831983805668016,20.0,20.0
10470,2,2470,[272 303 315 478 211],537,5,9470,3.8324564953460136,20.0,20.0
10471,2,2471,[365 202 413 232 231],774,1,9471,3.8313106796116503,0.0,0.0
10472,2,2472,[232 481 268 230 299],13,1,9472,3.830165790537808,0.0,0.0
10473,2,2473,[243 301 508 431 201],537,2,9474,3.8294260307194827,0.0,0.0
10474,2,2474,[272 303 315 478 211],537,5,9479,3.82989898989899,20.0,20.0
10475,2,2475,[272 303 315 478 211],537,5,9484,3.8303715670436187,20.0,20.0
10476,2,2476,[272 303 315 478 211],537,5,9489,3.830843762616068,20.0,20.0
10477,2,2477,[378 431 392 226 239],200,4,9493,3.83091202582728,0.0,0.0
10478,2,2478,[272 303 315 478 211],537,5,9498,3.8313836224283984,20.0,20.0
10479,2,2479,[272 303 315 478 211],13,5,9503,3.8318548387096776,20.0,20.0
10480,2,2480,[272 303 315 478 211],13,5,9508,3.8323256751309955,20.0,20.0
10481,2,2481,[243 239 413 209 230],13,1,9509,3.831184528605963,0.0,0.0
10482,2,2482,[272 303 315 478 211],13,5,9514,3.8316552557390255,20.0,20.0
10483,2,2483,[272 303 315 478 211],13,5,9519,3.832125603864734,20.0,20.0
10484,2,2484,[331 508 236 301 250],486,2,9521,3.8313883299798794,0.0,0.0
10485,2,2485,[272 303 315 478 211],13,5,9526,3.831858407079646,20.0,20.0
10486,2,2486,[272 303 315 478 211],13,5,9531,3.8323281061519903,20.0,20.0
10487,2,2487,[272 303 315 478 211],537,5,9536,3.832797427652733,20.0,20.0
10488,2,2488,[272 303 315 478 211],13,5,9541,3.8332663720369626,20.0,20.0
10489,2,2489,[272 303 315 478 211],13,5,9546,3.833734939759036,20.0,20.0
10490,2,2490,[272 303 315 478 211],537,5,9551,3.8342031312725813,20.0,20.0
10491,2,2491,[367 431 344 429 211],13,2,9553,3.8334670947030496,0.0,20.0
10492,2,2492,[272 303 315 478 211],537,5,9558,3.8339350180505414,20.0,20.0
10493,2,2493,[272 303 315 478 211],537,5,9563,3.834402566158781,20.0,20.0
10494,2,2494,[272 303 315 478 211],13,5,9568,3.834869739478958,20.0,20.0
10495,2,2495,[202 215 211 452 201],13,3,9571,3.8345352564102564,0.0,20.0
10496,2,2496,[272 303 315 478 211],13,5,9576,3.8350020024028835,20.0,20.0
10497,2,2497,[272 303 315 478 211],537,5,9581,3.8354683746997598,20.0,20.0
10498,2,2498,[272 303 315 478 211],537,5,9586,3.8359343737494997,20.0,20.0
10499,2,2499,[202 240 367 218 298],833,4,9590,3.836,0.0,0.0
10500,2,2500,[413 222 215 431 290],648,2,9592,3.835265893642543,0.0,20.0
10501,2,2501,[255 295 244 290 223],894,2,9594,3.8345323741007196,20.0,0.0
10502,2,2502,[291 452 378 284 209],308,2,9596,3.8337994406711946,0.0,0.0
10503,2,2503,[243 222 202 250 240],804,4,9600,3.8338658146964857,0.0,20.0
10504,2,2504,[272 303 315 478 211],13,5,9605,3.834331337325349,20.0,20.0
10505,2,2505,[478 509 321 212 211],13,4,9609,3.8343974461292896,0.0,20.0
10506,2,2506,[272 303 315 478 211],537,5,9614,3.834862385321101,20.0,20.0
10507,2,2507,[227 413 230 219 201],774,2,9616,3.8341307814992027,0.0,0.0
10508,2,2508,[272 303 315 478 211],537,5,9621,3.8345954563571145,20.0,20.0
10509,2,2509,[272 303 315 478 211],13,5,9626,3.835059760956175,20.0,20.0
10510,2,2510,[272 315 239 321 394],13,3,9629,3.834727200318598,20.0,0.0
10511,2,2511,[272 303 315 478 211],13,5,9634,3.835191082802548,20.0,20.0
10512,2,2512,[216 212 508 241 268],92,3,9637,3.834858734580183,0.0,0.0
10513,2,2513,[272 303 315 478 211],537,5,9642,3.835322195704057,20.0,20.0
10514,2,2514,[272 303 315 478 211],13,5,9647,3.835785288270378,20.0,20.0
10515,2,2515,[272 303 315 478 211],13,5,9652,3.836248012718601,20.0,20.0
10516,2,2516,[272 303 315 478 211],537,5,9657,3.836710369487485,20.0,20.0
10517,2,2517,[272 303 315 478 211],537,5,9662,3.8371723590150912,20.0,20.0
10518,2,2518,[272 303 315 478 211],13,5,9667,3.8376339817387852,20.0,20.0
10519,2,2519,[272 303 315 478 211],537,5,9672,3.8380952380952382,20.0,20.0
10520,2,2520,[272 303 315 478 211],537,5,9677,3.8385561285204286,20.0,20.0
10521,2,2521,[259 221 230 232 212],85,0,9677,3.837034099920698,0.0,0.0
10522,2,2522,[272 303 315 478 211],13,5,9682,3.837495045580658,20.0,20.0
10523,2,2523,[272 303 315 478 211],13,5,9687,3.8379556259904914,20.0,20.0
10524,2,2524,[272 303 315 478 211],537,5,9692,3.8384158415841583,20.0,20.0
10525,2,2525,[230 231 429 508 244],334,2,9694,3.8376880443388757,0.0,0.0
10526,2,2526,[272 303 315 478 211],13,5,9699,3.838148001582905,20.0,20.0
10527,2,2527,[272 303 315 478 211],537,5,9704,3.838607594936709,20.0,20.0
10528,2,2528,[272 303 315 478 211],13,5,9709,3.8390668248319493,20.0,20.0
10529,2,2529,[215 365 509 298 293],308,3,9712,3.8387351778656127,0.0,0.0
10530,2,2530,[272 303 315 478 211],13,5,9717,3.8391939944685896,20.0,20.0
10531,2,2531,[272 303 315 478 211],537,5,9722,3.839652448657188,20.0,20.0
10532,2,2532,[290 222 429 209 213],524,2,9724,3.838926174496644,0.0,20.0
10533,2,2533,[272 303 315 478 211],537,5,9729,3.839384372533544,20.0,20.0
10534,2,2534,[272 303 315 478 211],537,5,9734,3.8398422090729785,20.0,20.0
10535,2,2535,[211 231 315 272 206],650,3,9737,3.8395110410094637,20.0,20.0
10536,2,2536,[290 485 272 481 324],334,3,9740,3.839180134016555,0.0,0.0
10537,2,2537,[272 303 478 315 211],13,5,9745,3.839637509850276,20.0,20.0
10538,2,2538,[272 303 478 315 211],13,5,9750,3.8400945254037024,20.0,20.0
10539,2,2539,[272 303 478 315 211],537,5,9755,3.840551181102362,20.0,20.0
10540,2,2540,[272 303 478 315 211],13,5,9760,3.8410074773711136,20.0,20.0
10541,2,2541,[272 303 478 315 211],537,5,9765,3.841463414634146,20.0,20.0
10542,2,2542,[222 315 481 216 211],474,5,9770,3.8419189933149824,20.0,40.0
10543,2,2543,[272 303 478 315 211],13,5,9775,3.842374213836478,20.0,20.0
10544,2,2544,[272 303 478 315 211],13,5,9780,3.8428290766208253,20.0,20.0
10545,2,2545,[272 303 478 315 211],537,5,9785,3.843283582089552,20.0,20.0
10546,2,2546,[295 254 211 213 298],308,3,9788,3.8429524931291716,0.0,20.0
10547,2,2547,[272 303 478 315 211],537,5,9793,3.8434065934065935,20.0,20.0
10548,2,2548,[272 303 478 315 211],537,5,9798,3.843860337387211,20.0,20.0
10549,2,2549,[213 241 321 208 264],308,3,9801,3.843529411764706,0.0,0.0
10550,2,2550,[272 303 478 315 211],537,5,9806,3.843982751862015,20.0,20.0
10551,2,2551,[272 303 478 315 211],537,5,9811,3.844435736677116,20.0,20.0
10552,2,2552,[431 299 481 226 268],13,2,9813,3.8437132784958874,0.0,0.0
10553,2,2553,[272 303 478 315 211],13,5,9818,3.8441660140955363,20.0,20.0
10554,2,2554,[272 303 478 315 211],13,5,9823,3.8446183953033266,20.0,20.0
10555,2,2555,[272 303 478 315 211],13,5,9828,3.8450704225352115,20.0,20.0
10556,2,2556,[272 303 478 315 211],13,5,9833,3.845522096206492,20.0,20.0
10557,2,2557,[272 303 478 315 211],13,5,9838,3.845973416731822,20.0,20.0
10558,2,2558,[231 299 226 227 219],13,2,9840,3.8452520515826496,0.0,0.0
10559,2,2559,[222 208 276 213 293],334,4,9844,3.8453125,0.0,40.0
10560,2,2560,[272 303 478 315 211],13,5,9849,3.8457633736821553,20.0,20.0
10561,2,2561,[217 220 276 481 485],334,2,9851,3.8450429352068696,0.0,20.0
10562,2,2562,[272 303 478 315 211],537,5,9856,3.8454935622317596,20.0,20.0
10563,2,2563,[272 303 478 315 211],537,5,9861,3.8459438377535102,20.0,20.0
10564,2,2564,[272 303 478 315 211],537,5,9866,3.846393762183236,20.0,20.0
10565,2,2565,[272 303 478 315 211],13,5,9871,3.846843335931411,20.0,20.0
10566,2,2566,[272 303 478 315 211],13,5,9876,3.8472925594078693,20.0,20.0
10567,2,2567,[272 303 478 315 211],537,5,9881,3.847741433021807,20.0,20.0
10568,2,2568,[272 303 478 315 211],13,5,9886,3.848189957181783,20.0,20.0
10569,2,2569,[218 509 202 301 276],184,2,9888,3.8474708171206227,0.0,20.0
10570,2,2570,[272 303 478 315 211],13,5,9893,3.8479190976273823,20.0,20.0
10571,2,2571,[272 303 478 315 211],13,5,9898,3.848367029548989,20.0,20.0
10572,2,2572,[239 241 508 208 216],524,4,9902,3.848425961912165,0.0,0.0
10573,2,2573,[272 303 478 315 211],13,5,9907,3.848873348873349,20.0,20.0
10574,2,2574,[272 303 478 315 211],13,5,9912,3.8493203883495144,20.0,20.0
10575,2,2575,[272 303 478 315 211],537,5,9917,3.8497670807453415,20.0,20.0
10576,2,2576,[223 478 241 213 211],194,2,9919,3.8490492821109816,20.0,20.0
10577,2,2577,[272 303 315 478 211],537,5,9924,3.8494957331264548,20.0,20.0
10578,2,2578,[272 303 315 478 211],537,5,9929,3.849941837921675,20.0,20.0
10579,2,2579,[272 303 315 478 211],537,5,9934,3.8503875968992247,20.0,20.0
10580,2,2580,[272 303 315 478 211],13,5,9939,3.8508330104610615,20.0,20.0
10581,2,2581,[272 303 315 478 211],537,5,9944,3.8512780790085204,20.0,20.0
10582,2,2582,[272 303 315 478 211],537,5,9949,3.851722802942315,20.0,20.0
10583,2,2583,[272 303 315 478 211],537,5,9954,3.8521671826625385,20.0,20.0
10584,2,2584,[272 303 315 478 211],13,5,9959,3.8526112185686654,20.0,20.0
10585,2,2585,[291 295 431 201 240],92,2,9961,3.8518948182521267,0.0,0.0
10586,2,2586,[272 303 315 478 211],13,5,9966,3.8523386161577116,20.0,20.0
10587,2,2587,[272 303 315 478 211],13,5,9971,3.8527820710973724,20.0,20.0
10588,2,2588,[272 303 315 478 211],537,5,9976,3.8532251834685205,20.0,20.0
10589,2,2589,[272 303 315 478 211],13,5,9981,3.8536679536679537,20.0,20.0
10590,2,2590,[272 303 315 478 211],13,5,9986,3.8541103820918563,20.0,20.0
10591,2,2591,[272 303 315 478 211],537,5,9991,3.8545524691358026,20.0,20.0
10592,2,2592,[272 303 315 478 211],13,5,9996,3.854994215194755,20.0,20.0
10593,2,2593,[272 303 315 478 211],537,5,10001,3.8554356206630684,20.0,20.0
10594,2,2594,[272 303 315 478 211],13,5,10006,3.8558766859344895,20.0,20.0
10595,2,2595,[297 236 216 221 239],533,3,10009,3.855546995377504,20.0,0.0
10596,2,2596,[272 303 315 478 211],13,5,10014,3.855987678090104,20.0,20.0
10597,2,2597,[272 303 315 478 211],537,5,10019,3.8564280215550424,20.0,20.0
10598,2,2598,[239 276 217 218 219],13,2,10021,3.8557137360523277,0.0,20.0
10599,2,2599,[272 303 315 478 211],537,5,10026,3.856153846153846,20.0,20.0
10600,2,2600,[272 303 315 478 211],13,5,10031,3.8565936178392928,20.0,20.0
10601,2,2601,[272 303 315 478 211],537,5,10036,3.857033051498847,20.0,20.0
10602,2,2602,[275 315 250 212 256],883,3,10039,3.8567038033038803,20.0,20.0
10603,2,2603,[272 303 478 315 211],13,5,10044,3.857142857142857,20.0,20.0
10604,2,2604,[365 216 254 230 226],308,1,10045,3.856046065259117,0.0,0.0
10605,2,2605,[272 303 478 315 211],537,5,10050,3.856485034535687,20.0,20.0
10606,2,2606,[272 303 478 315 211],13,5,10055,3.8569236670502494,20.0,20.0
10607,2,2607,[230 219 209 217 298],387,1,10056,3.855828220858896,0.0,0.0
10608,2,2608,[272 303 478 315 211],13,5,10061,3.8562667688769645,20.0,20.0
10609,2,2609,[272 303 478 315 211],13,5,10066,3.856704980842912,20.0,20.0
10610,2,2610,[272 303 478 315 211],537,5,10071,3.857142857142857,20.0,20.0
10611,2,2611,[272 303 478 315 211],537,5,10076,3.8575803981623276,20.0,20.0
10612,2,2612,[215 259 316 291 212],234,1,10077,3.8564867967853043,20.0,0.0
10613,2,2613,[272 303 478 315 211],537,5,10082,3.8569242540168323,20.0,20.0
10614,2,2614,[209 243 216 226 230],881,2,10084,3.8562141491395794,0.0,0.0
10615,2,2615,[272 303 478 315 211],13,5,10089,3.856651376146789,20.0,20.0
10616,2,2616,[272 303 478 315 211],537,5,10094,3.857088269010317,20.0,20.0
10617,2,2617,[272 303 478 315 211],13,5,10099,3.857524828113063,20.0,20.0
10618,2,2618,[272 303 478 315 211],537,5,10104,3.8579610538373426,20.0,20.0
10619,2,2619,[272 303 478 315 211],537,5,10109,3.8583969465648855,20.0,20.0
10620,2,2620,[272 303 478 315 211],13,5,10114,3.858832506676841,20.0,20.0
10621,2,2621,[272 303 478 315 211],537,5,10119,3.8592677345537756,20.0,20.0
10622,2,2622,[316 315 297 256 255],894,3,10122,3.8589401448722835,60.0,0.0
10623,2,2623,[272 303 315 478 211],537,5,10127,3.859375,20.0,20.0
10624,2,2624,[272 303 315 478 211],537,5,10132,3.859809523809524,20.0,20.0
10625,2,2625,[232 290 264 301 261],13,2,10134,3.859101294744859,0.0,0.0
10626,2,2626,[272 303 315 478 211],537,5,10139,3.859535591929958,20.0,20.0
10627,2,2627,[272 303 315 478 211],13,5,10144,3.8599695585996954,20.0,20.0
10628,2,2628,[222 226 230 250 208],387,2,10146,3.8592620768352988,0.0,20.0
10629,2,2629,[272 303 315 478 211],13,5,10151,3.8596958174904943,20.0,20.0
10630,2,2630,[272 303 315 478 211],537,5,10156,3.860129228430255,20.0,20.0
10631,2,2631,[284 315 392 275 220],271,2,10158,3.8594224924012157,20.0,20.0
10632,2,2632,[215 268 367 420 365],7,4,10162,3.8594758830231677,0.0,0.0
10633,2,2633,[272 303 315 478 211],13,5,10167,3.859908883826879,20.0,20.0
10634,2,2634,[326 331 219 230 336],13,0,10167,3.8584440227703984,0.0,0.0
10635,2,2635,[272 303 315 478 211],537,5,10172,3.858877086494689,20.0,20.0
10636,2,2636,[272 303 315 478 211],13,5,10177,3.8593098217671598,20.0,20.0
10637,2,2637,[202 431 239 208 209],749,5,10182,3.8597422289613346,0.0,0.0
10638,2,2638,[272 303 315 478 211],13,5,10187,3.8601743084501705,20.0,20.0
10639,2,2639,[272 303 315 478 211],13,5,10192,3.860606060606061,20.0,20.0
10640,2,2640,[272 303 315 478 211],13,5,10197,3.861037485800833,20.0,20.0
10641,2,2641,[272 303 315 478 211],13,5,10202,3.861468584405753,20.0,20.0
10642,2,2642,[250 230 232 231 254],749,2,10204,3.8607642830117292,0.0,0.0
10643,2,2643,[303 384 264 226 316],13,4,10208,3.8608169440242057,20.0,0.0
10644,2,2644,[272 303 315 478 211],537,5,10213,3.8612476370510396,20.0,20.0
10645,2,2645,[272 303 315 478 211],537,5,10218,3.8616780045351473,20.0,20.0
10646,2,2646,[256 212 276 222 315],883,3,10221,3.861352474499433,20.0,40.0
10647,2,2647,[272 303 478 315 211],13,5,10226,3.86178247734139,20.0,20.0
10648,2,2648,[272 303 478 315 211],13,5,10231,3.862212155530389,20.0,20.0
10649,2,2649,[272 303 478 315 211],13,5,10236,3.862641509433962,20.0,20.0
10650,2,2650,[272 303 478 315 211],13,5,10241,3.863070539419087,20.0,20.0
10651,2,2651,[272 303 478 315 211],537,5,10246,3.863499245852187,20.0,20.0
10652,2,2652,[272 303 478 315 211],537,5,10251,3.863927629099133,20.0,20.0
10653,2,2653,[221 315 226 299 301],537,1,10252,3.86284853051997,20.0,0.0
10654,2,2654,[298 280 326 300 240],749,4,10256,3.862900188323917,0.0,20.0
10655,2,2655,[507 280 485 413 216],13,1,10257,3.8618222891566263,0.0,0.0
10656,2,2656,[478 215 429 283 367],234,2,10259,3.8611215656755737,0.0,0.0
10657,2,2657,[485 209 509 261 215],479,2,10261,3.860421369450715,0.0,0.0
10658,2,2658,[272 303 315 478 211],537,5,10266,3.860849943587815,20.0,20.0
10659,2,2659,[272 303 315 478 211],537,5,10271,3.8612781954887216,20.0,20.0
10660,2,2660,[272 303 315 478 211],13,5,10276,3.861706125516723,20.0,20.0
10661,2,2661,[272 303 315 478 211],13,5,10281,3.8621337340345603,20.0,20.0
10662,2,2662,[272 303 315 478 211],13,5,10286,3.862561021404431,20.0,20.0
10663,2,2663,[272 303 315 478 211],537,5,10291,3.862987987987988,20.0,20.0
10664,2,2664,[272 303 315 478 211],13,5,10296,3.8634146341463413,20.0,20.0
10665,2,2665,[202 218 241 429 209],308,5,10301,3.86384096024006,0.0,0.0
10666,2,2666,[272 303 315 478 211],13,5,10306,3.8642669666291716,20.0,20.0
10667,2,2667,[272 303 315 478 211],13,5,10311,3.8646926536731634,20.0,20.0
10668,2,2668,[222 211 202 243 259],804,4,10315,3.864743349569127,0.0,40.0
10669,2,2669,[283 344 350 508 256],894,1,10316,3.863670411985019,0.0,0.0
10670,2,2670,[202 241 344 209 299],13,1,10317,3.8625982777985772,0.0,0.0
10671,2,2671,[272 303 315 478 211],537,5,10322,3.8630239520958085,20.0,20.0
10672,2,2672,[478 218 276 244 298],474,4,10326,3.8630751964085297,0.0,20.0
10673,2,2673,[331 508 223 201 485],13,1,10327,3.862004487658938,20.0,0.0
10674,2,2674,[208 206 508 275 509],406,1,10328,3.8609345794392524,0.0,20.0
10675,2,2675,[272 303 315 478 211],13,5,10333,3.86136023916293,20.0,20.0
10676,2,2676,[344 276 290 211 215],13,4,10337,3.8614120283899886,0.0,40.0
10677,2,2677,[272 303 315 478 211],13,5,10342,3.861837191934279,20.0,20.0
10678,2,2678,[272 303 315 478 211],537,5,10347,3.8622620380739083,20.0,20.0
10679,2,2679,[223 209 230 583 219],387,3,10350,3.861940298507463,20.0,0.0
10680,2,2680,[303 509 236 300 221],537,2,10352,3.8612458038045507,0.0,20.0
10681,2,2681,[272 303 315 478 211],537,5,10357,3.861670395227442,20.0,20.0
10682,2,2682,[272 303 315 478 211],537,5,10362,3.8620946701453596,20.0,20.0
10683,2,2683,[509 217 226 212 394],13,3,10365,3.8617734724292103,0.0,0.0
10684,2,2684,[272 303 315 478 211],537,5,10370,3.8621973929236497,20.0,20.0
10685,2,2685,[272 303 315 478 211],537,5,10375,3.862620997766195,20.0,20.0
10686,2,2686,[275 222 264 315 300],13,2,10377,3.8619278005210274,20.0,60.0
10687,2,2687,[300 219 331 276 209],13,1,10378,3.8608630952380953,0.0,40.0
10688,2,2688,[243 299 218 321 208],13,1,10379,3.8597991818519897,0.0,0.0
10689,2,2689,[272 303 315 478 211],537,5,10384,3.8602230483271374,20.0,20.0
10690,2,2690,[218 481 478 216 209],524,3,10387,3.859903381642512,0.0,0.0
10691,2,2691,[272 303 315 478 211],13,5,10392,3.860326894502229,20.0,20.0
10692,2,2692,[236 336 246 220 284],486,0,10392,3.858893427404382,0.0,0.0
10693,2,2693,[227 413 211 326 316],13,3,10395,3.8585746102449887,20.0,20.0
10694,2,2694,[272 303 315 478 211],13,5,10400,3.8589981447124306,20.0,20.0
10695,2,2695,[272 303 315 478 211],537,5,10405,3.859421364985163,20.0,20.0
10696,2,2696,[213 478 299 231 268],537,3,10408,3.8591027067111607,0.0,0.0
10697,2,2697,[272 303 315 478 211],537,5,10413,3.8595255744996293,20.0,20.0
10698,2,2698,[272 303 315 478 211],13,5,10418,3.8599481289366433,20.0,20.0
10699,2,2699,[272 303 315 478 211],537,5,10423,3.8603703703703705,20.0,20.0
10700,2,2700,[272 303 315 478 211],13,5,10428,3.8607922991484633,20.0,20.0
10701,2,2701,[272 303 315 478 211],13,5,10433,3.8612139156180607,20.0,20.0
10702,2,2702,[272 303 315 478 211],13,5,10438,3.861635220125786,20.0,20.0
10703,2,2703,[272 303 315 478 211],537,5,10443,3.8620562130177514,20.0,20.0
10704,2,2704,[272 303 315 478 211],537,5,10448,3.8624768946395562,20.0,20.0
10705,2,2705,[272 303 315 478 211],537,5,10453,3.8628972653362896,20.0,20.0
10706,2,2706,[272 303 315 478 211],537,5,10458,3.8633173254525306,20.0,20.0
10707,2,2707,[272 303 315 478 211],537,5,10463,3.863737075332349,20.0,20.0
10708,2,2708,[272 303 315 478 211],537,5,10468,3.864156515319306,20.0,20.0
10709,2,2709,[272 303 315 478 211],13,5,10473,3.8645756457564575,20.0,20.0
10710,2,2710,[272 303 315 478 211],13,5,10478,3.864994466986352,20.0,20.0
10711,2,2711,[272 303 315 478 211],13,5,10483,3.8654129793510323,20.0,20.0
10712,2,2712,[272 303 315 478 211],537,5,10488,3.8658311831920384,20.0,20.0
10713,2,2713,[272 303 315 478 211],13,5,10493,3.866249078850405,20.0,20.0
10714,2,2714,[272 303 315 478 211],13,5,10498,3.8666666666666667,20.0,20.0
10715,2,2715,[272 303 315 478 211],13,5,10503,3.8670839469808542,20.0,20.0
10716,2,2716,[231 481 276 367 219],13,1,10504,3.8660287081339715,0.0,20.0
10717,2,2717,[272 303 315 478 211],13,5,10509,3.8664459161147904,20.0,20.0
10718,2,2718,[272 303 315 478 211],13,5,10514,3.8668628172122106,20.0,20.0
10719,2,2719,[272 303 315 478 211],537,5,10519,3.867279411764706,20.0,20.0
10720,2,2720,[227 239 485 429 284],398,2,10521,3.866593164277839,0.0,0.0
10721,2,2721,[272 303 315 478 211],13,5,10526,3.867009551800147,20.0,20.0
10722,2,2722,[223 508 298 367 206],447,3,10529,3.866691149467499,20.0,0.0
10723,2,2723,[272 303 315 478 211],537,5,10534,3.867107195301028,20.0,20.0
10724,2,2724,[272 303 315 478 211],537,5,10539,3.8675229357798164,20.0,20.0
10725,2,2725,[272 303 315 478 211],13,5,10544,3.867938371239912,20.0,20.0
10726,2,2726,[272 303 315 478 211],13,5,10549,3.8683535020168685,20.0,20.0
10727,2,2727,[218 413 485 315 508],13,1,10550,3.8673020527859236,20.0,0.0
10728,2,2728,[272 303 315 478 211],537,5,10555,3.8677171124954195,20.0,20.0
10729,2,2729,[272 303 315 478 211],537,5,10560,3.868131868131868,20.0,20.0
10730,2,2730,[272 303 315 478 211],537,5,10565,3.868546320029293,20.0,20.0
10731,2,2731,[272 303 315 478 211],537,5,10570,3.8689604685212298,20.0,20.0
10732,2,2732,[272 303 315 478 211],13,5,10575,3.8693743139407246,20.0,20.0
10733,2,2733,[240 384 230 239 232],64,1,10576,3.868324798829554,0.0,0.0
10734,2,2734,[272 303 315 478 211],537,5,10581,3.8687385740402194,20.0,20.0
10735,2,2735,[272 303 315 478 211],13,5,10586,3.8691520467836256,20.0,20.0
10736,2,2736,[272 303 315 478 211],13,5,10591,3.869565217391304,20.0,20.0
10737,2,2737,[268 303 276 220 315],334,4,10595,3.8696128560993426,20.0,20.0
10738,2,2738,[272 303 315 478 211],13,5,10600,3.8700255567725446,20.0,20.0
10739,2,2739,[272 303 315 478 211],537,5,10605,3.8704379562043796,20.0,20.0
10740,2,2740,[272 303 315 478 211],13,5,10610,3.8708500547245532,20.0,20.0
10741,2,2741,[272 303 315 478 211],537,5,10615,3.87126185266229,20.0,20.0
10742,2,2742,[230 583 268 232 452],7,1,10616,3.870215092963908,0.0,0.0
10743,2,2743,[297 208 300 293 283],334,3,10619,3.8698979591836733,20.0,20.0
10744,2,2744,[239 230 211 218 226],506,3,10622,3.8695810564663025,0.0,20.0
10745,2,2745,[272 303 315 478 211],537,5,10627,3.8699927166788055,20.0,20.0
10746,2,2746,[272 303 315 478 211],13,5,10632,3.8704040771751003,20.0,20.0
10747,2,2747,[239 326 212 272 261],13,3,10635,3.8700873362445414,0.0,0.0
10748,2,2748,[272 303 315 478 211],13,5,10640,3.870498363041106,20.0,20.0
10749,2,2749,[201 268 420 272 239],13,4,10644,3.8705454545454545,0.0,0.0
10750,2,2750,[272 303 315 478 211],537,5,10649,3.870956015994184,20.0,20.0
10751,2,2751,[272 303 315 478 211],537,5,10654,3.8713662790697674,20.0,20.0
10752,2,2752,[272 303 315 478 211],537,5,10659,3.871776244097348,20.0,20.0
10753,2,2753,[272 303 315 478 211],13,5,10664,3.8721859114015977,20.0,20.0
10754,2,2754,[272 303 315 478 211],13,5,10669,3.8725952813067153,20.0,20.0
10755,2,2755,[216 326 231 275 301],334,1,10670,3.8715529753265603,0.0,20.0
10756,2,2756,[227 206 250 240 202],738,3,10673,3.8712368516503446,0.0,0.0
10757,2,2757,[272 303 315 478 211],537,5,10678,3.871646120377085,20.0,20.0
10758,2,2758,[272 303 315 478 211],13,5,10683,3.8720550924247914,20.0,20.0
10759,2,2759,[272 303 315 478 211],537,5,10688,3.872463768115942,20.0,20.0
10760,2,2760,[272 303 315 478 211],13,5,10693,3.8728721477725463,20.0,20.0
10761,2,2761,[272 303 315 478 211],13,5,10698,3.873280231716148,20.0,20.0
10762,2,2762,[202 239 431 420 222],64,3,10701,3.8729641693811074,0.0,20.0
10763,2,2763,[272 303 315 478 211],13,5,10706,3.8733719247467437,20.0,20.0
10764,2,2764,[272 303 315 478 211],537,5,10711,3.8737793851717903,20.0,20.0
10765,2,2765,[272 303 315 478 211],13,5,10716,3.874186550976139,20.0,20.0
10766,2,2766,[272 303 315 478 211],13,5,10721,3.8745934224792196,20.0,20.0
10767,2,2767,[272 303 315 478 211],13,5,10726,3.875,20.0,20.0
10768,2,2768,[272 303 315 478 211],537,5,10731,3.875406283856988,20.0,20.0
10769,2,2769,[272 303 315 478 211],13,5,10736,3.875812274368231,20.0,20.0
10770,2,2770,[272 303 315 478 211],13,5,10741,3.8762179718513172,20.0,20.0
10771,2,2771,[221 250 300 220 301],486,3,10744,3.8759018759018757,0.0,20.0
10772,2,2772,[272 303 315 478 211],13,5,10749,3.8763072484673637,20.0,20.0
10773,2,2773,[272 303 315 478 211],537,5,10754,3.8767123287671232,20.0,20.0
10774,2,2774,[272 303 315 478 211],537,5,10759,3.877117117117117,20.0,20.0
10775,2,2775,[272 303 315 478 211],537,5,10764,3.877521613832853,20.0,20.0
10776,2,2776,[272 303 315 478 211],13,5,10769,3.877925819229384,20.0,20.0
10777,2,2777,[272 303 315 478 211],13,5,10774,3.8783297336213103,20.0,20.0
10778,2,2778,[272 303 315 478 211],13,5,10779,3.878733357322778,20.0,20.0
10779,2,2779,[272 303 315 478 211],537,5,10784,3.8791366906474822,20.0,20.0
10780,2,2780,[299 208 272 344 219],13,2,10786,3.8784609852571017,0.0,0.0
10781,2,2781,[507 378 230 227 239],326,1,10787,3.8774263120057513,0.0,0.0
10782,2,2782,[230 231 420 223 272],650,2,10789,3.8767517067912323,20.0,0.0
10783,2,2783,[485 299 344 218 211],13,1,10790,3.8757183908045976,0.0,20.0
10784,2,2784,[272 303 315 478 211],537,5,10795,3.8761220825852782,20.0,20.0
10785,2,2785,[272 303 315 478 211],13,5,10800,3.8765254845656854,20.0,20.0
10786,2,2786,[276 284 301 431 268],537,3,10803,3.876210979547901,0.0,20.0
10787,2,2787,[272 303 315 478 211],537,5,10808,3.8766140602582495,20.0,20.0
10788,2,2788,[300 268 218 297 239],334,2,10810,3.87594119756185,20.0,20.0
10789,2,2789,[272 303 315 478 211],537,5,10815,3.8763440860215055,20.0,20.0
10790,2,2790,[211 222 321 284 384],279,3,10818,3.87603009673952,0.0,40.0
10791,2,2791,[272 303 315 478 211],537,5,10823,3.876432664756447,20.0,20.0
10792,2,2792,[272 303 315 478 211],537,5,10828,3.8768349445041173,20.0,20.0
10793,2,2793,[272 303 315 478 211],13,5,10833,3.8772369362920545,20.0,20.0
10794,2,2794,[259 283 202 298 420],308,3,10836,3.876923076923077,0.0,0.0
10795,2,2795,[272 303 315 478 211],13,5,10841,3.877324749642346,20.0,20.0
10796,2,2796,[272 303 315 478 211],537,5,10846,3.877726135144798,20.0,20.0
10797,2,2797,[272 303 315 478 211],13,5,10851,3.8781272337383847,20.0,20.0
10798,2,2798,[272 303 315 478 211],13,5,10856,3.878528045730618,20.0,20.0
10799,2,2799,[272 303 315 478 211],537,5,10861,3.8789285714285713,20.0,20.0
10800,2,2800,[272 303 315 478 211],537,5,10866,3.879328811138879,20.0,20.0
10801,2,2801,[227 298 293 508 291],533,3,10869,3.879014989293362,0.0,0.0
10802,2,2802,[272 303 315 478 211],537,5,10874,3.8794149125936497,20.0,20.0
10803,2,2803,[272 303 315 478 211],13,5,10879,3.87981455064194,20.0,20.0
10804,2,2804,[272 303 315 478 211],537,5,10884,3.8802139037433157,20.0,20.0
10805,2,2805,[211 212 221 275 507],90,5,10889,3.880612972202423,0.0,40.0
10806,2,2806,[291 202 226 227 378],892,4,10893,3.8806555040969006,0.0,0.0
10807,2,2807,[202 268 213 227 378],7,1,10894,3.8796296296296298,0.0,0.0
10808,2,2808,[452 240 276 259 300],145,1,10895,3.878604485582058,0.0,40.0
10809,2,2809,[272 303 315 478 211],537,5,10900,3.8790035587188614,20.0,20.0
10810,2,2810,[272 303 315 478 211],13,5,10905,3.87940234791889,20.0,20.0
10811,2,2811,[413 280 212 209 326],13,2,10907,3.8787339971550496,0.0,0.0
10812,2,2812,[209 268 321 431 272],13,2,10909,3.878066121578386,0.0,0.0
10813,2,2813,[272 303 315 478 211],13,5,10914,3.878464818763326,20.0,20.0
10814,2,2814,[272 303 315 478 211],537,5,10919,3.8788632326820602,20.0,20.0
10815,2,2815,[272 303 315 478 211],13,5,10924,3.8792613636363638,20.0,20.0
10816,2,2816,[272 303 315 478 211],537,5,10929,3.8796592119275823,20.0,20.0
10817,2,2817,[272 303 315 478 211],13,5,10934,3.8800567778566357,20.0,20.0
10818,2,2818,[272 303 315 478 211],537,5,10939,3.8804540617240155,20.0,20.0
10819,2,2819,[272 303 315 478 211],13,5,10944,3.880851063829787,20.0,20.0
10820,2,2820,[272 303 315 478 211],537,5,10949,3.881247784473591,20.0,20.0
10821,2,2821,[272 303 315 478 211],13,5,10954,3.881644223954642,20.0,20.0
10822,2,2822,[272 303 315 478 211],537,5,10959,3.882040382571732,20.0,20.0
10823,2,2823,[583 216 284 202 264],308,3,10962,3.881728045325779,0.0,0.0
10824,2,2824,[303 290 268 392 259],537,2,10964,3.881061946902655,0.0,0.0
10825,2,2825,[272 303 315 478 211],537,5,10969,3.881457891012031,20.0,20.0
10826,2,2826,[272 303 315 478 211],13,5,10974,3.881853555005306,20.0,20.0
10827,2,2827,[272 303 315 478 211],13,5,10979,3.8822489391796324,20.0,20.0
10828,2,2828,[272 303 315 478 211],13,5,10984,3.8826440438317427,20.0,20.0
10829,2,2829,[272 303 315 478 211],13,5,10989,3.8830388692579505,20.0,20.0
10830,2,2830,[321 293 215 276 255],308,3,10992,3.882726951607206,0.0,20.0
10831,2,2831,[301 222 209 378 321],234,2,10994,3.8820621468926553,0.0,20.0
10832,2,2832,[272 303 315 478 211],13,5,10999,3.882456759618779,20.0,20.0
10833,2,2833,[276 293 222 227 291],474,5,11004,3.882851093860268,0.0,40.0
10834,2,2834,[272 303 315 478 211],537,5,11009,3.883245149911817,20.0,20.0
10835,2,2835,[272 303 315 478 211],537,5,11014,3.883638928067701,20.0,20.0
10836,2,2836,[301 241 220 485 215],378,3,11017,3.88332745858301,0.0,0.0
10837,2,2837,[272 303 315 478 211],537,5,11022,3.883720930232558,20.0,20.0
10838,2,2838,[272 303 315 478 211],13,5,11027,3.8841141246917927,20.0,20.0
10839,2,2839,[272 303 315 478 211],13,5,11032,3.8845070422535213,20.0,20.0
10840,2,2840,[272 303 315 478 211],537,5,11037,3.8848996832101372,20.0,20.0
10841,2,2841,[272 303 315 478 211],537,5,11042,3.8852920478536244,20.0,20.0
10842,2,2842,[452 295 215 226 420],308,1,11043,3.884277172001407,0.0,0.0
10843,2,2843,[272 303 315 478 211],537,5,11048,3.8846694796061882,20.0,20.0
10844,2,2844,[272 303 315 478 211],537,5,11053,3.88506151142355,20.0,20.0
10845,2,2845,[272 303 315 478 211],537,5,11058,3.8854532677442024,20.0,20.0
10846,2,2846,[507 290 272 201 211],13,3,11061,3.8851422550052686,0.0,20.0
10847,2,2847,[272 303 315 478 211],13,5,11066,3.8855337078651684,20.0,20.0
10848,2,2848,[268 212 246 485 221],85,3,11069,3.8852228852228854,0.0,0.0
10849,2,2849,[272 303 315 478 211],13,5,11074,3.8856140350877193,20.0,20.0
10850,2,2850,[272 303 315 478 211],13,5,11079,3.8860049105576993,20.0,20.0
10851,2,2851,[272 303 315 478 211],537,5,11084,3.886395511921459,20.0,20.0
10852,2,2852,[508 226 202 243 321],59,4,11088,3.8864353312302837,0.0,0.0
10853,2,2853,[272 303 315 478 211],13,5,11093,3.8868255080588647,20.0,20.0
10854,2,2854,[272 326 336 246 299],894,2,11095,3.8861646234676006,0.0,0.0
10855,2,2855,[452 218 300 481 239],13,1,11096,3.88515406162465,0.0,20.0
10856,2,2856,[272 303 315 478 211],537,5,11101,3.8855442772138606,20.0,20.0
10857,2,2857,[272 303 315 478 211],13,5,11106,3.8859342197340796,20.0,20.0
10858,2,2858,[275 259 211 291 213],537,3,11109,3.885624344176285,0.0,40.0
10859,2,2859,[259 209 226 478 283],537,3,11112,3.885314685314685,0.0,0.0
10860,2,2860,[230 221 209 244 218],334,2,11114,3.88465571478504,0.0,0.0
10861,2,2861,[272 303 315 478 211],13,5,11119,3.8850454227812716,20.0,20.0
10862,2,2862,[272 303 315 478 211],537,5,11124,3.885434858539993,20.0,20.0
10863,2,2863,[272 303 315 478 211],13,5,11129,3.8858240223463687,20.0,20.0
10864,2,2864,[272 303 315 478 211],13,5,11134,3.886212914485166,20.0,20.0
10865,2,2865,[272 303 315 478 211],537,5,11139,3.8866015352407537,20.0,20.0
10866,2,2866,[336 201 202 507 384],13,1,11140,3.8855946982908964,0.0,0.0
10867,2,2867,[272 303 315 478 211],13,5,11145,3.8859832635983262,20.0,20.0
10868,2,2868,[272 303 315 478 211],537,5,11150,3.8863715580341585,20.0,20.0
10869,2,2869,[211 509 221 291 481],474,5,11155,3.8867595818815333,0.0,20.0
10870,2,2870,[272 303 315 478 211],13,5,11160,3.8871473354231973,20.0,20.0
10871,2,2871,[272 303 315 478 211],13,5,11165,3.887534818941504,20.0,20.0
10872,2,2872,[272 303 315 478 211],13,5,11170,3.887922032718413,20.0,20.0
10873,2,2873,[272 303 315 478 211],13,5,11175,3.8883089770354906,20.0,20.0
10874,2,2874,[272 303 315 478 211],537,5,11180,3.888695652173913,20.0,20.0
10875,2,2875,[272 303 315 478 211],537,5,11185,3.8890820584144645,20.0,20.0
10876,2,2876,[272 303 315 478 211],537,5,11190,3.889468196037539,20.0,20.0
10877,2,2877,[272 303 315 478 211],13,5,11195,3.8898540653231413,20.0,20.0
10878,2,2878,[272 303 315 478 211],13,5,11200,3.890239666550886,20.0,20.0
10879,2,2879,[272 303 315 478 211],13,5,11205,3.890625,20.0,20.0
10880,2,2880,[508 218 230 243 344],13,0,11205,3.8892745574453316,0.0,0.0
10881,2,2881,[507 367 284 259 509],194,1,11206,3.8882720333102014,0.0,0.0
10882,2,2882,[227 250 255 303 221],334,2,11208,3.8876170655567117,0.0,0.0
10883,2,2883,[321 509 316 208 230],13,3,11211,3.8873092926490984,20.0,0.0
10884,2,2884,[227 250 231 219 230],279,2,11213,3.8866551126516464,0.0,0.0
10885,2,2885,[272 303 315 478 211],13,5,11218,3.8870408870408872,20.0,20.0
10886,2,2886,[272 303 315 478 211],537,5,11223,3.8874263941808107,20.0,20.0
10887,2,2887,[261 300 241 223 394],13,1,11224,3.886426592797784,20.0,20.0
10888,2,2888,[272 303 315 478 211],13,5,11229,3.8868120456905504,20.0,20.0
10889,2,2889,[272 303 315 478 211],537,5,11234,3.88719723183391,20.0,20.0
10890,2,2890,[272 303 315 478 211],13,5,11239,3.88758215150467,20.0,20.0
10891,2,2891,[272 303 315 478 211],537,5,11244,3.887966804979253,20.0,20.0
10892,2,2892,[222 215 509 284 326],64,3,11247,3.887659868648462,0.0,20.0
10893,2,2893,[272 303 315 478 211],537,5,11252,3.8880442294402213,20.0,20.0
10894,2,2894,[272 303 315 478 211],537,5,11257,3.8884283246977547,20.0,20.0
10895,2,2895,[264 429 384 250 201],833,1,11258,3.8874309392265194,0.0,0.0
10896,2,2896,[429 507 209 264 301],13,2,11260,3.8867794269934417,0.0,0.0
10897,2,2897,[272 303 315 478 211],537,5,11265,3.8871635610766044,20.0,20.0
10898,2,2898,[276 264 259 254 452],308,1,11266,3.8861676440151776,0.0,20.0
10899,2,2899,[272 303 315 478 211],537,5,11271,3.886551724137931,20.0,20.0
10900,2,2900,[212 299 211 241 303],537,2,11273,3.885901413305757,0.0,20.0
10901,2,2901,[272 303 315 478 211],13,5,11278,3.8862853204686423,20.0,20.0
10902,2,2902,[272 303 315 478 211],13,5,11283,3.886668963141578,20.0,20.0
10903,2,2903,[272 303 315 478 211],537,5,11288,3.887052341597796,20.0,20.0
10904,2,2904,[272 303 315 478 211],537,5,11293,3.887435456110155,20.0,20.0
10905,2,2905,[272 303 315 478 211],537,5,11298,3.8878183069511354,20.0,20.0
10906,2,2906,[272 303 315 478 211],13,5,11303,3.888200894392845,20.0,20.0
10907,2,2907,[272 303 315 478 211],13,5,11308,3.8885832187070153,20.0,20.0
10908,2,2908,[272 303 315 478 211],13,5,11313,3.888965280165005,20.0,20.0
10909,2,2909,[420 452 301 275 215],13,2,11315,3.888316151202749,0.0,20.0
10910,2,2910,[272 303 315 478 211],537,5,11320,3.8886980419099966,20.0,20.0
10911,2,2911,[272 303 315 478 211],13,5,11325,3.88907967032967,20.0,20.0
10912,2,2912,[272 303 315 478 211],537,5,11330,3.8894610367318916,20.0,20.0
10913,2,2913,[272 303 315 478 211],13,5,11335,3.8898421413864104,20.0,20.0
10914,2,2914,[272 303 315 478 211],13,5,11340,3.890222984562607,20.0,20.0
10915,2,2915,[272 303 315 478 211],13,5,11345,3.8906035665294922,20.0,20.0
10916,2,2916,[216 212 202 226 297],934,4,11349,3.890641069592047,20.0,0.0
10917,2,2917,[272 303 315 478 211],13,5,11354,3.8910212474297463,20.0,20.0
10918,2,2918,[272 303 315 478 211],13,5,11359,3.89140116478246,20.0,20.0
10919,2,2919,[222 321 481 280 485],13,1,11360,3.8904109589041096,0.0,20.0
10920,2,2920,[293 303 295 321 251],486,2,11362,3.8897637795275593,20.0,0.0
10921,2,2921,[272 303 315 478 211],537,5,11367,3.8901437371663246,20.0,20.0
10922,2,2922,[272 303 315 478 211],537,5,11372,3.8905234348272324,20.0,20.0
10923,2,2923,[272 303 315 478 211],13,5,11377,3.890902872777018,20.0,20.0
10924,2,2924,[272 303 315 478 211],13,5,11382,3.8912820512820514,20.0,20.0
10925,2,2925,[272 303 315 478 211],537,5,11387,3.891660970608339,20.0,20.0
10926,2,2926,[272 303 315 478 211],13,5,11392,3.892039631021524,20.0,20.0
10927,2,2927,[478 303 215 208 299],13,4,11396,3.8920765027322406,0.0,0.0
10928,2,2928,[223 298 284 216 295],308,3,11399,3.8917719358142713,20.0,0.0
10929,2,2929,[272 303 315 478 211],537,5,11404,3.8921501706484642,20.0,20.0
10930,2,2930,[243 208 230 315 222],650,3,11407,3.8918457864210168,20.0,20.0
10931,2,2931,[272 303 315 478 211],13,5,11412,3.892223738062756,20.0,20.0
10932,2,2932,[272 303 315 478 211],13,5,11417,3.892601431980907,20.0,20.0
10933,2,2933,[272 303 315 478 211],537,5,11422,3.892978868438991,20.0,20.0
10934,2,2934,[272 303 315 478 211],13,5,11427,3.8933560477001703,20.0,20.0
10935,2,2935,[272 303 315 478 211],13,5,11432,3.893732970027248,20.0,20.0
10936,2,2936,[272 303 315 478 211],537,5,11437,3.8941096356826694,20.0,20.0
10937,2,2937,[272 303 315 478 211],537,5,11442,3.894486044928523,20.0,20.0
10938,2,2938,[272 303 315 478 211],537,5,11447,3.8948621980265394,20.0,20.0
10939,2,2939,[429 230 390 208 283],279,3,11450,3.8945578231292517,0.0,0.0
10940,2,2940,[272 303 315 478 211],13,5,11455,3.894933696021761,20.0,20.0
10941,2,2941,[316 241 231 367 336],13,1,11456,3.893949694085656,20.0,0.0
10942,2,2942,[272 303 315 478 211],537,5,11461,3.894325518178729,20.0,20.0
10943,2,2943,[272 303 315 478 211],537,5,11466,3.894701086956522,20.0,20.0
10944,2,2944,[272 303 315 478 211],13,5,11471,3.895076400679117,20.0,20.0
10945,2,2945,[219 231 226 321 239],279,3,11474,3.894772572980312,0.0,0.0
10946,2,2946,[246 268 272 213 300],894,4,11478,3.894808279606379,0.0,20.0
10947,2,2947,[275 298 321 223 261],6,2,11480,3.8941655359565805,20.0,20.0
10948,2,2948,[272 303 315 478 211],537,5,11485,3.894540522210919,20.0,20.0
10949,2,2949,[272 303 315 478 211],537,5,11490,3.8949152542372882,20.0,20.0
10950,2,2950,[272 303 315 478 211],13,5,11495,3.8952897322941378,20.0,20.0
10951,2,2951,[202 223 485 231 211],650,1,11496,3.894308943089431,20.0,20.0
10952,2,2952,[272 303 315 478 211],13,5,11501,3.8946833728411785,20.0,20.0
10953,2,2953,[272 303 315 478 211],537,5,11506,3.895057549085985,20.0,20.0
10954,2,2954,[212 206 507 429 222],537,1,11507,3.894077834179357,0.0,20.0
10955,2,2955,[280 215 212 251 316],144,4,11511,3.8941136671177268,40.0,0.0
10956,2,2956,[272 303 315 478 211],537,5,11516,3.894487656408522,20.0,20.0
10957,2,2957,[272 303 315 478 211],13,5,11521,3.894861392832995,20.0,20.0
10958,2,2958,[272 303 315 478 211],537,5,11526,3.895234876647516,20.0,20.0
10959,2,2959,[272 303 315 478 211],13,5,11531,3.895608108108108,20.0,20.0
10960,2,2960,[272 303 315 478 211],537,5,11536,3.895981087470449,20.0,20.0
10961,2,2961,[272 303 315 478 211],13,5,11541,3.8963538149898715,20.0,20.0
10962,2,2962,[508 300 221 275 255],334,2,11543,3.8957138035774554,0.0,40.0
10963,2,2963,[272 303 315 478 211],537,5,11548,3.8960863697705803,20.0,20.0
10964,2,2964,[272 303 315 478 211],537,5,11553,3.8964586846543003,20.0,20.0
10965,2,2965,[212 232 275 227 300],64,1,11554,3.8954821308159135,0.0,40.0
10966,2,2966,[272 303 315 478 211],537,5,11559,3.895854398382204,20.0,20.0
10967,2,2967,[272 303 315 478 211],13,5,11564,3.8962264150943398,20.0,20.0
10968,2,2968,[272 303 315 478 211],13,5,11569,3.896598181205793,20.0,20.0
10969,2,2969,[272 303 315 478 211],13,5,11574,3.896969696969697,20.0,20.0
10970,2,2970,[272 303 315 478 211],537,5,11579,3.897340962638842,20.0,20.0
10971,2,2971,[268 431 240 222 300],145,4,11583,3.8973755047106327,0.0,40.0
10972,2,2972,[272 303 315 478 211],13,5,11588,3.8977463841237805,20.0,20.0
10973,2,2973,[276 239 290 231 230],13,3,11591,3.8974445191661062,0.0,20.0
10974,2,2974,[272 303 315 478 211],13,5,11596,3.8978151260504204,20.0,20.0
10975,2,2975,[272 303 315 478 211],537,5,11601,3.8981854838709675,20.0,20.0
10976,2,2976,[213 429 290 291 321],524,2,11603,3.8975478669801813,0.0,0.0
10977,2,2977,[272 303 315 478 211],13,5,11608,3.897918065815984,20.0,20.0
10978,2,2978,[272 303 315 478 211],13,5,11613,3.8982880161127897,20.0,20.0
10979,2,2979,[272 303 315 478 211],537,5,11618,3.8986577181208055,20.0,20.0
10980,2,2980,[272 303 315 478 211],13,5,11623,3.8990271720899026,20.0,20.0
10981,2,2981,[208 384 394 413 202],13,2,11625,3.898390342052314,0.0,0.0
10982,2,2982,[272 303 315 478 211],537,5,11630,3.898759637948374,20.0,20.0
10983,2,2983,[272 303 315 478 211],537,5,11635,3.8991286863270775,20.0,20.0
10984,2,2984,[509 276 211 326 216],13,3,11638,3.898827470686767,0.0,40.0
10985,2,2985,[272 303 315 478 211],13,5,11643,3.8991962491627596,20.0,20.0
10986,2,2986,[303 246 283 324 239],334,4,11647,3.8992299966521595,0.0,0.0
10987,2,2987,[272 303 315 478 211],537,5,11652,3.8995983935742973,20.0,20.0
10988,2,2988,[272 303 315 478 211],13,5,11657,3.899966543994647,20.0,20.0
10989,2,2989,[272 303 315 478 211],13,5,11662,3.9003344481605353,20.0,20.0
10990,2,2990,[272 303 315 478 211],13,5,11667,3.900702106318957,20.0,20.0
10991,2,2991,[272 303 315 478 211],13,5,11672,3.9010695187165774,20.0,20.0
10992,2,2992,[272 303 315 478 211],13,5,11677,3.901436685599733,20.0,20.0
10993,2,2993,[272 303 315 478 211],537,5,11682,3.9018036072144286,20.0,20.0
10994,2,2994,[272 303 315 478 211],537,5,11687,3.902170283806344,20.0,20.0
10995,2,2995,[272 303 315 478 211],13,5,11692,3.902536715620828,20.0,20.0
10996,2,2996,[272 303 315 478 211],537,5,11697,3.9029029029029028,20.0,20.0
10997,2,2997,[272 303 315 478 211],13,5,11702,3.903268845897265,20.0,20.0
10998,2,2998,[272 303 315 478 211],13,5,11707,3.9036345448482828,20.0,20.0
10999,2,2999,[272 303 315 478 211],13,5,11712,3.904,20.0,20.0
11000,2,3000,[384 227 431 211 315],13,3,11715,3.903698767077641,20.0,20.0
11001,2,3001,[272 303 315 478 211],537,5,11720,3.904063957361759,20.0,20.0
11002,2,3002,[272 303 315 478 211],537,5,11725,3.9044289044289044,20.0,20.0
11003,2,3003,[272 303 315 478 211],537,5,11730,3.9047936085219708,20.0,20.0
11004,2,3004,[272 303 315 478 211],13,5,11735,3.9051580698835275,20.0,20.0
11005,2,3005,[243 230 239 384 420],13,2,11737,3.9045242847638058,0.0,0.0
11006,2,3006,[272 303 315 478 211],537,5,11742,3.904888593282341,20.0,20.0
11007,2,3007,[272 303 315 478 211],537,5,11747,3.905252659574468,20.0,20.0
11008,2,3008,[272 303 315 478 211],13,5,11752,3.9056164838816883,20.0,20.0
11009,2,3009,[272 303 315 478 211],13,5,11757,3.9059800664451827,20.0,20.0
11010,2,3010,[272 303 315 478 211],537,5,11762,3.906343407505812,20.0,20.0
11011,2,3011,[272 303 315 478 211],537,5,11767,3.9067065073041167,20.0,20.0
11012,2,3012,[280 326 241 336 232],13,1,11768,3.905741785595752,0.0,0.0
11013,2,3013,[272 303 315 478 211],13,5,11773,3.9061048440610486,20.0,20.0
11014,2,3014,[272 303 315 478 211],13,5,11778,3.906467661691542,20.0,20.0
11015,2,3015,[272 303 315 478 211],537,5,11783,3.9068302387267906,20.0,20.0
11016,2,3016,[208 276 300 212 299],537,2,11785,3.906198210142526,0.0,40.0
11017,2,3017,[276 202 481 378 321],308,3,11788,3.905897945659377,0.0,20.0
11018,2,3018,[272 303 315 478 211],537,5,11793,3.9062603511096388,20.0,20.0
11019,2,3019,[272 303 315 478 211],13,5,11798,3.9066225165562916,20.0,20.0
11020,2,3020,[272 303 315 478 211],13,5,11803,3.9069844422376696,20.0,20.0
11021,2,3021,[272 303 315 478 211],13,5,11808,3.9073461283917936,20.0,20.0
11022,2,3022,[508 321 316 300 212],13,2,11810,3.906715183592458,20.0,20.0
11023,2,3023,[272 303 315 478 211],13,5,11815,3.9070767195767195,20.0,20.0
11024,2,3024,[272 303 315 478 211],13,5,11820,3.9074380165289258,20.0,20.0
11025,2,3025,[272 303 315 478 211],537,5,11825,3.907799074686054,20.0,20.0
11026,2,3026,[243 350 264 217 227],13,2,11827,3.907168814007268,0.0,0.0
11027,2,3027,[272 303 315 478 211],13,5,11832,3.907529722589168,20.0,20.0
11028,2,3028,[272 303 315 478 211],537,5,11837,3.9078903928689335,20.0,20.0
11029,2,3029,[508 208 231 230 209],537,3,11840,3.907590759075908,0.0,0.0
11030,2,3030,[272 303 315 478 211],537,5,11845,3.907951171230617,20.0,20.0
11031,2,3031,[272 303 315 478 211],13,5,11850,3.908311345646438,20.0,20.0
11032,2,3032,[301 507 413 478 232],13,1,11851,3.907352456313881,0.0,0.0
11033,2,3033,[272 303 315 478 211],537,5,11856,3.90771259063942,20.0,20.0
11034,2,3034,[272 303 315 478 211],537,5,11861,3.9080724876441515,20.0,20.0
11035,2,3035,[272 303 315 478 211],537,5,11866,3.9084321475625825,20.0,20.0
11036,2,3036,[272 303 315 478 211],537,5,11871,3.9087915706289103,20.0,20.0
11037,2,3037,[230 239 485 429 300],334,2,11873,3.9081632653061225,0.0,20.0
11038,2,3038,[431 240 215 284 226],59,3,11876,3.907864429088516,0.0,0.0
11039,2,3039,[272 303 315 478 211],537,5,11881,3.9082236842105265,20.0,20.0
11040,2,3040,[222 216 452 240 220],406,1,11882,3.907267346267675,0.0,20.0
11041,2,3041,[431 230 326 276 321],311,3,11885,3.9069690992767914,0.0,20.0
11042,2,3042,[272 303 315 478 211],537,5,11890,3.90732829444627,20.0,20.0
11043,2,3043,[227 301 208 485 217],650,1,11891,3.9063731931668855,0.0,0.0
11044,2,3044,[272 303 315 478 211],13,5,11896,3.9067323481116585,20.0,20.0
11045,2,3045,[272 303 315 478 211],537,5,11901,3.9070912672357188,20.0,20.0
11046,2,3046,[272 303 315 478 211],13,5,11906,3.9074499507712503,20.0,20.0
11047,2,3047,[272 303 315 478 211],13,5,11911,3.9078083989501313,20.0,20.0
11048,2,3048,[272 303 315 478 211],537,5,11916,3.9081666120039356,20.0,20.0
11049,2,3049,[272 303 315 478 211],13,5,11921,3.9085245901639345,20.0,20.0
11050,2,3050,[272 303 315 478 211],13,5,11926,3.908882333661095,20.0,20.0
11051,2,3051,[272 303 315 478 211],13,5,11931,3.9092398427260813,20.0,20.0
11052,2,3052,[272 303 315 478 211],537,5,11936,3.9095971175892563,20.0,20.0
11053,2,3053,[272 303 315 478 211],537,5,11941,3.909954158480681,20.0,20.0
11054,2,3054,[272 303 315 478 211],13,5,11946,3.9103109656301145,20.0,20.0
11055,2,3055,[239 201 290 315 215],13,4,11950,3.9103403141361257,20.0,0.0
11056,2,3056,[272 303 315 478 211],13,5,11955,3.9106967615309127,20.0,20.0
11057,2,3057,[272 303 315 478 211],537,5,11960,3.9110529758011774,20.0,20.0
11058,2,3058,[344 300 227 384 211],13,2,11962,3.9104282445243546,0.0,40.0
11059,2,3059,[303 508 336 331 212],894,3,11965,3.9101307189542482,0.0,0.0
11060,2,3060,[272 303 315 478 211],537,5,11970,3.910486769029729,20.0,20.0
11061,2,3061,[272 303 315 478 211],537,5,11975,3.910842586544742,20.0,20.0
11062,2,3062,[272 303 315 478 211],13,5,11980,3.911198171727065,20.0,20.0
11063,2,3063,[344 215 227 336 275],13,2,11982,3.910574412532637,0.0,20.0
11064,2,3064,[208 298 283 232 293],158,3,11985,3.9102773246329527,0.0,0.0
11065,2,3065,[272 303 315 478 211],537,5,11990,3.9106327462491848,20.0,20.0
11066,2,3066,[272 303 315 478 211],537,5,11995,3.910987936093903,20.0,20.0
11067,2,3067,[272 303 315 478 211],537,5,12000,3.911342894393742,20.0,20.0
11068,2,3068,[241 413 452 215 300],774,1,12001,3.910394265232975,0.0,20.0
11069,2,3069,[272 303 315 478 211],537,5,12006,3.9107491856677523,20.0,20.0
11070,2,3070,[272 303 315 478 211],537,5,12011,3.911103874959297,20.0,20.0
11071,2,3071,[272 303 315 478 211],537,5,12016,3.9114583333333335,20.0,20.0
11072,2,3072,[261 326 243 275 336],13,0,12016,3.9101854864952816,0.0,20.0
11073,2,3073,[272 303 315 478 211],13,5,12021,3.9105400130123615,20.0,20.0
11074,2,3074,[272 303 315 478 211],13,5,12026,3.9108943089430896,20.0,20.0
11075,2,3075,[272 303 315 478 211],537,5,12031,3.9112483745123536,20.0,20.0
11076,2,3076,[241 239 276 259 508],537,2,12033,3.910627234319142,0.0,20.0
11077,2,3077,[240 217 250 241 208],774,1,12034,3.9096816114359974,0.0,0.0
11078,2,3078,[413 212 216 241 219],13,1,12035,3.9087366027931147,0.0,0.0
11079,2,3079,[272 303 315 478 211],13,5,12040,3.909090909090909,20.0,20.0
11080,2,3080,[272 303 315 478 211],537,5,12045,3.9094449853943525,20.0,20.0
11081,2,3081,[272 303 315 478 211],13,5,12050,3.90979883192732,20.0,20.0
11082,2,3082,[272 303 315 478 211],537,5,12055,3.910152448913396,20.0,20.0
11083,2,3083,[344 230 485 239 272],13,2,12057,3.909533073929961,0.0,0.0
11084,2,3084,[272 303 315 478 211],537,5,12062,3.9098865478119933,20.0,20.0
11085,2,3085,[272 303 315 478 211],13,5,12067,3.910239792611795,20.0,20.0
11086,2,3086,[272 303 315 478 211],13,5,12072,3.9105928085519923,20.0,20.0
11087,2,3087,[272 303 315 478 211],537,5,12077,3.910945595854922,20.0,20.0
11088,2,3088,[272 303 315 478 211],537,5,12082,3.911298154742635,20.0,20.0
11089,2,3089,[431 222 291 413 220],648,2,12084,3.9106796116504854,0.0,20.0
11090,2,3090,[272 303 315 478 211],13,5,12089,3.911032028469751,20.0,20.0
11091,2,3091,[392 300 231 211 240],64,1,12090,3.9100905562742563,0.0,40.0
11092,2,3092,[272 303 315 478 211],13,5,12095,3.9104429356611705,20.0,20.0
11093,2,3093,[272 303 315 478 211],13,5,12100,3.9107950872656754,20.0,20.0
11094,2,3094,[272 303 315 478 211],537,5,12105,3.9111470113085622,20.0,20.0
11095,2,3095,[272 303 315 478 211],537,5,12110,3.911498708010336,20.0,20.0
11096,2,3096,[272 303 315 478 211],13,5,12115,3.911850177591217,20.0,20.0
11097,2,3097,[272 303 315 478 211],13,5,12120,3.912201420271143,20.0,20.0
11098,2,3098,[272 303 315 478 211],537,5,12125,3.9125524362697646,20.0,20.0
11099,2,3099,[272 303 315 478 211],13,5,12130,3.912903225806452,20.0,20.0
11100,2,3100,[236 264 293 284 508],486,1,12131,3.9119638826185104,0.0,0.0
11101,2,3101,[223 508 268 236 213],334,4,12135,3.911992263056093,20.0,0.0
11102,2,3102,[272 303 315 478 211],537,5,12140,3.912342893973574,20.0,20.0
11103,2,3103,[272 303 315 478 211],537,5,12145,3.912693298969072,20.0,20.0
11104,2,3104,[272 303 315 478 211],13,5,12150,3.9130434782608696,20.0,20.0
11105,2,3105,[276 216 275 392 420],308,4,12154,3.913071474565357,0.0,40.0
11106,2,3106,[431 226 201 291 202],92,2,12156,3.9124557450917283,0.0,0.0
11107,2,3107,[272 303 315 478 211],13,5,12161,3.912805662805663,20.0,20.0
11108,2,3108,[315 208 431 226 509],650,1,12162,3.9118687680926345,20.0,0.0
11109,2,3109,[378 367 243 284 206],234,3,12165,3.9115755627009645,0.0,0.0
11110,2,3110,[272 303 478 315 211],537,5,12170,3.911925425908068,20.0,20.0
11111,2,3111,[272 303 478 315 211],537,5,12175,3.912275064267352,20.0,20.0
11112,2,3112,[272 303 478 315 211],13,5,12180,3.912624477995503,20.0,20.0
11113,2,3113,[272 303 478 315 211],13,5,12185,3.9129736673089273,20.0,20.0
11114,2,3114,[208 481 301 268 509],6,3,12188,3.9126805778491174,0.0,0.0
11115,2,3115,[272 303 478 315 211],537,5,12193,3.9130295250320923,20.0,20.0
11116,2,3116,[384 275 485 259 217],7,3,12196,3.912736605710619,0.0,20.0
11117,2,3117,[272 303 478 315 211],537,5,12201,3.913085311096857,20.0,20.0
11118,2,3118,[272 303 478 315 211],13,5,12206,3.913433792882334,20.0,20.0
11119,2,3119,[507 326 211 275 509],13,2,12208,3.9128205128205127,0.0,40.0
11120,2,3120,[272 303 478 315 211],537,5,12213,3.913168856135854,20.0,20.0
11121,2,3121,[272 303 478 315 211],13,5,12218,3.9135169762972453,20.0,20.0
11122,2,3122,[272 303 478 315 211],537,5,12223,3.913864873519052,20.0,20.0
11123,2,3123,[272 303 478 315 211],537,5,12228,3.914212548015365,20.0,20.0
11124,2,3124,[272 303 478 315 211],13,5,12233,3.91456,20.0,20.0
11125,2,3125,[315 290 232 218 209],13,2,12235,3.913947536788228,20.0,0.0
11126,2,3126,[272 303 478 315 211],537,5,12240,3.914294851295171,20.0,20.0
11127,2,3127,[272 303 478 315 211],13,5,12245,3.9146419437340154,20.0,20.0
11128,2,3128,[272 303 478 315 211],537,5,12250,3.9149888143176734,20.0,20.0
11129,2,3129,[272 303 478 315 211],537,5,12255,3.915335463258786,20.0,20.0
11130,2,3130,[216 230 215 201 226],13,2,12257,3.9147237304375597,0.0,0.0
11131,2,3131,[321 295 507 231 298],308,1,12258,3.913793103448276,0.0,0.0
11132,2,3132,[272 303 478 315 211],13,5,12263,3.914139802106607,20.0,20.0
11133,2,3133,[272 303 478 315 211],537,5,12268,3.9144862795149966,20.0,20.0
11134,2,3134,[300 230 478 303 211],537,3,12271,3.9141945773524722,0.0,40.0
11135,2,3135,[392 208 299 275 206],537,2,12273,3.9135841836734695,0.0,20.0
11136,2,3136,[272 303 478 315 211],13,5,12278,3.913930506853682,20.0,20.0
11137,2,3137,[211 392 507 485 367],308,3,12281,3.9136392606755894,0.0,20.0
11138,2,3138,[272 303 478 315 211],13,5,12286,3.9139853456514815,20.0,20.0
11139,2,3139,[272 303 478 315 211],537,5,12291,3.914331210191083,20.0,20.0
11140,2,3140,[272 303 478 315 211],13,5,12296,3.914676854504935,20.0,20.0
11141,2,3141,[272 303 478 315 211],537,5,12301,3.9150222788033098,20.0,20.0
11142,2,3142,[272 303 478 315 211],537,5,12306,3.915367483296214,20.0,20.0
11143,2,3143,[272 303 478 315 211],13,5,12311,3.915712468193384,20.0,20.0
11144,2,3144,[226 243 213 365 212],804,2,12313,3.9151033386327505,0.0,0.0
11145,2,3145,[222 301 221 236 378],234,1,12314,3.9141767323585506,0.0,20.0
11146,2,3146,[230 301 208 250 508],85,2,12316,3.913568477915475,0.0,0.0
11147,2,3147,[272 303 478 315 211],537,5,12321,3.913913595933926,20.0,20.0
11148,2,3148,[272 303 478 315 211],13,5,12326,3.9142584947602415,20.0,20.0
11149,2,3149,[272 303 478 315 211],13,5,12331,3.9146031746031746,20.0,20.0
11150,2,3150,[272 303 478 315 211],537,5,12336,3.9149476356712154,20.0,20.0
11151,2,3151,[272 303 478 315 211],537,5,12341,3.9152918781725887,20.0,20.0
11152,2,3152,[272 303 478 315 211],537,5,12346,3.9156359023152554,20.0,20.0
11153,2,3153,[272 303 478 315 211],537,5,12351,3.915979708306912,20.0,20.0
11154,2,3154,[272 303 478 315 211],13,5,12356,3.916323296354992,20.0,20.0
11155,2,3155,[272 303 478 315 211],537,5,12361,3.9166666666666665,20.0,20.0
11156,2,3156,[272 303 478 315 211],537,5,12366,3.9170098194488436,20.0,20.0
11157,2,3157,[272 303 478 315 211],13,5,12371,3.91735275490817,20.0,20.0
11158,2,3158,[299 239 206 212 284],537,0,12371,3.916112693890472,0.0,0.0
11159,2,3159,[211 291 215 378 230],882,5,12376,3.9164556962025316,0.0,20.0
11160,2,3160,[326 331 478 216 215],13,2,12378,3.91584941474217,0.0,0.0
11161,2,3161,[272 303 478 315 211],13,5,12383,3.9161922833649587,20.0,20.0
11162,2,3162,[272 303 478 315 211],537,5,12388,3.9165349351881127,20.0,20.0
11163,2,3163,[272 303 478 315 211],13,5,12393,3.9168773704171933,20.0,20.0
11164,2,3164,[290 509 291 206 201],537,1,12394,3.915955766192733,0.0,0.0
11165,2,3165,[272 303 478 315 211],537,5,12399,3.9162981680353757,20.0,20.0
11166,2,3166,[272 303 478 315 211],537,5,12404,3.9166403536469847,20.0,20.0
11167,2,3167,[272 303 478 315 211],13,5,12409,3.916982323232323,20.0,20.0
11168,2,3168,[272 303 478 315 211],13,5,12414,3.917324076995898,20.0,20.0
11169,2,3169,[272 303 478 315 211],537,5,12419,3.917665615141956,20.0,20.0
11170,2,3170,[293 212 276 297 508],144,4,12423,3.9176915799432357,20.0,20.0
11171,2,3171,[485 208 218 315 227],334,2,12425,3.9170870113493064,20.0,0.0
11172,2,3172,[222 300 226 239 209],13,2,12427,3.916482823826032,0.0,40.0
11173,2,3173,[272 303 478 315 211],13,5,12432,3.9168241965973536,20.0,20.0
11174,2,3174,[272 303 478 315 211],13,5,12437,3.9171653543307086,20.0,20.0
11175,2,3175,[272 303 478 315 211],537,5,12442,3.917506297229219,20.0,20.0
11176,2,3176,[272 303 478 315 211],13,5,12447,3.917847025495751,20.0,20.0
11177,2,3177,[272 303 478 315 211],13,5,12452,3.918187539332914,20.0,20.0
11178,2,3178,[272 303 478 315 211],13,5,12457,3.918527838943064,20.0,20.0
11179,2,3179,[272 303 478 315 211],537,5,12462,3.918867924528302,20.0,20.0
11180,2,3180,[272 303 478 315 211],13,5,12467,3.9192077962904746,20.0,20.0
11181,2,3181,[272 303 478 315 211],13,5,12472,3.9195474544311755,20.0,20.0
11182,2,3182,[272 303 478 315 211],537,5,12477,3.9198868991517437,20.0,20.0
11183,2,3183,[272 303 478 315 211],537,5,12482,3.9202261306532664,20.0,20.0
11184,2,3184,[272 303 478 315 211],13,5,12487,3.9205651491365776,20.0,20.0
11185,2,3185,[272 303 478 315 211],537,5,12492,3.92090395480226,20.0,20.0
11186,2,3186,[272 303 478 315 211],13,5,12497,3.9212425478506434,20.0,20.0
11187,2,3187,[272 303 478 315 211],537,5,12502,3.9215809284818066,20.0,20.0
11188,2,3188,[272 303 478 315 211],13,5,12507,3.9219190968955786,20.0,20.0
11189,2,3189,[227 390 290 208 284],279,3,12510,3.9216300940438873,0.0,0.0
11190,2,3190,[272 303 478 315 211],537,5,12515,3.921968035098715,20.0,20.0
11191,2,3191,[272 222 201 394 202],13,2,12517,3.9213659147869673,0.0,20.0
11192,2,3192,[272 303 478 315 211],537,5,12522,3.9217037269025994,20.0,20.0
11193,2,3193,[208 431 212 478 206],650,3,12525,3.921415153412649,0.0,0.0
11194,2,3194,[299 508 230 303 202],537,2,12527,3.920813771517997,0.0,0.0
11195,2,3195,[272 303 478 315 211],537,5,12532,3.921151439299124,20.0,20.0
11196,2,3196,[413 226 478 208 300],13,3,12535,3.920863309352518,0.0,20.0
11197,2,3197,[272 303 478 315 211],537,5,12540,3.921200750469043,20.0,20.0
11198,2,3198,[272 303 478 315 211],537,5,12545,3.921537980618943,20.0,20.0
11199,2,3199,[272 303 478 315 211],13,5,12550,3.921875,20.0,20.0
11200,2,3200,[272 303 478 315 211],13,5,12555,3.922211808809747,20.0,20.0
11201,2,3201,[272 303 478 315 211],13,5,12560,3.9225484072454715,20.0,20.0
11202,2,3202,[508 272 378 321 222],537,2,12562,3.921948173587262,0.0,20.0
11203,2,3203,[272 303 478 315 211],13,5,12567,3.9222846441947565,20.0,20.0
11204,2,3204,[272 303 478 315 211],13,5,12572,3.9226209048361933,20.0,20.0
11205,2,3205,[216 215 300 208 378],85,3,12575,3.922333125389894,0.0,20.0
11206,2,3206,[272 303 478 315 211],537,5,12580,3.9226691612098534,20.0,20.0
11207,2,3207,[272 303 478 315 211],13,5,12585,3.923004987531172,20.0,20.0
11208,2,3208,[507 303 452 336 226],13,2,12587,3.922405733873481,0.0,0.0
11209,2,3209,[272 303 478 315 211],13,5,12592,3.9227414330218067,20.0,20.0
11210,2,3210,[272 303 478 315 211],537,5,12597,3.923076923076923,20.0,20.0
11211,2,3211,[272 303 478 315 211],537,5,12602,3.923412204234122,20.0,20.0
11212,2,3212,[272 303 478 315 211],13,5,12607,3.923747276688453,20.0,20.0
11213,2,3213,[272 303 478 315 211],537,5,12612,3.9240821406347233,20.0,20.0
11214,2,3214,[272 303 478 315 211],537,5,12617,3.9244167962674963,20.0,20.0
11215,2,3215,[272 303 478 315 211],13,5,12622,3.9247512437810945,20.0,20.0
11216,2,3216,[272 303 478 315 211],13,5,12627,3.925085483369599,20.0,20.0
11217,2,3217,[272 303 478 315 211],13,5,12632,3.925419515226849,20.0,20.0
11218,2,3218,[272 303 478 315 211],13,5,12637,3.925753339546443,20.0,20.0
11219,2,3219,[231 220 218 211 429],648,2,12639,3.9251552795031057,0.0,20.0
11220,2,3220,[272 303 478 315 211],13,5,12644,3.9254889785780813,20.0,20.0
11221,2,3221,[378 226 239 431 243],650,0,12644,3.924270639354438,0.0,0.0
11222,2,3222,[272 303 478 315 211],537,5,12649,3.9246044058330747,20.0,20.0
11223,2,3223,[272 303 478 315 211],13,5,12654,3.924937965260546,20.0,20.0
11224,2,3224,[272 303 478 315 211],537,5,12659,3.9252713178294574,20.0,20.0
11225,2,3225,[272 303 478 315 211],537,5,12664,3.925604463732176,20.0,20.0
11226,2,3226,[429 507 378 290 291],537,1,12665,3.924697861791137,0.0,0.0
11227,2,3227,[272 303 478 315 211],537,5,12670,3.9250309789343247,20.0,20.0
11228,2,3228,[272 303 478 315 211],537,5,12675,3.9253638897491485,20.0,20.0
11229,2,3229,[213 201 209 321 236],537,2,12677,3.9247678018575853,0.0,0.0
11230,2,3230,[272 303 478 315 211],537,5,12682,3.925100588053234,20.0,20.0
11231,2,3231,[272 303 478 315 211],13,5,12687,3.9254331683168315,20.0,20.0
11232,2,3232,[272 303 478 315 211],13,5,12692,3.9257655428394678,20.0,20.0
11233,2,3233,[481 231 295 215 209],308,2,12694,3.925170068027211,0.0,0.0
11234,2,3234,[301 275 221 268 481],6,3,12697,3.924884080370943,0.0,20.0
11235,2,3235,[272 303 478 315 211],13,5,12702,3.9252163164400495,20.0,20.0
11236,2,3236,[213 209 283 485 255],479,3,12705,3.9249304911955516,0.0,0.0
11237,2,3237,[261 303 481 209 321],13,1,12706,3.92402717726992,0.0,0.0
11238,2,3238,[272 303 478 315 211],537,5,12711,3.92435937017598,20.0,20.0
11239,2,3239,[272 303 478 315 211],537,5,12716,3.9246913580246914,20.0,20.0
11240,2,3240,[272 303 478 315 211],13,5,12721,3.9250231410058625,20.0,20.0
11241,2,3241,[272 303 478 315 211],537,5,12726,3.9253547193090683,20.0,20.0
11242,2,3242,[272 303 478 315 211],537,5,12731,3.925686093123651,20.0,20.0
11243,2,3243,[272 303 478 315 211],13,5,12736,3.9260172626387178,20.0,20.0
11244,2,3244,[218 303 344 201 202],13,2,12738,3.925423728813559,0.0,0.0
11245,2,3245,[215 218 222 241 344],328,3,12741,3.925138632162662,0.0,20.0
11246,2,3246,[272 303 478 315 211],13,5,12746,3.925469664305513,20.0,20.0
11247,2,3247,[272 303 478 315 211],13,5,12751,3.9258004926108376,20.0,20.0
11248,2,3248,[272 303 478 315 211],13,5,12756,3.926131117266851,20.0,20.0
11249,2,3249,[272 303 478 315 211],537,5,12761,3.9264615384615387,20.0,20.0
11250,2,3250,[209 236 321 208 275],537,3,12764,3.926176561058136,0.0,20.0
11251,2,3251,[272 303 478 315 211],537,5,12769,3.926506765067651,20.0,20.0
11252,2,3252,[239 217 276 250 293],455,3,12772,3.9262219489701815,0.0,20.0
11253,2,3253,[272 303 478 315 211],537,5,12777,3.9265519360786723,20.0,20.0
11254,2,3254,[272 303 478 315 211],13,5,12782,3.9268817204301074,20.0,20.0
11255,2,3255,[272 303 478 315 211],537,5,12787,3.927211302211302,20.0,20.0
11256,2,3256,[232 384 350 431 275],13,0,12787,3.9260055265581824,0.0,20.0
11257,2,3257,[272 303 478 315 211],13,5,12792,3.9263351749539597,20.0,20.0
11258,2,3258,[429 219 232 485 316],13,2,12794,3.9257440932801475,20.0,0.0
11259,2,3259,[321 226 218 202 212],194,1,12795,3.9248466257668713,0.0,0.0
11260,2,3260,[272 303 478 315 211],13,5,12800,3.925176326280282,20.0,20.0
11261,2,3261,[272 303 478 315 211],537,5,12805,3.9255058246474555,20.0,20.0
11262,2,3262,[232 485 336 315 215],13,2,12807,3.9249157217284707,20.0,0.0
11263,2,3263,[272 303 478 315 211],537,5,12812,3.9252450980392157,20.0,20.0
11264,2,3264,[272 303 478 315 211],13,5,12817,3.925574272588055,20.0,20.0
11265,2,3265,[272 303 478 315 211],13,5,12822,3.9259032455603182,20.0,20.0
11266,2,3266,[272 303 478 315 211],537,5,12827,3.9262320171411083,20.0,20.0
11267,2,3267,[272 303 478 315 211],537,5,12832,3.9265605875153,20.0,20.0
11268,2,3268,[272 303 478 315 211],537,5,12837,3.926888956867544,20.0,20.0
11269,2,3269,[216 241 378 227 268],7,3,12840,3.926605504587156,0.0,0.0
11270,2,3270,[272 303 478 315 211],537,5,12845,3.9269336594313664,20.0,20.0
11271,2,3271,[272 303 478 315 211],537,5,12850,3.9272616136919316,20.0,20.0
11272,2,3272,[272 303 478 315 211],13,5,12855,3.927589367552704,20.0,20.0
11273,2,3273,[272 303 478 315 211],13,5,12860,3.927916921197312,20.0,20.0
11274,2,3274,[272 303 478 315 211],13,5,12865,3.92824427480916,20.0,20.0
11275,2,3275,[272 303 478 315 211],13,5,12870,3.9285714285714284,20.0,20.0
11276,2,3276,[276 283 226 315 384],883,2,12872,3.9279829111992677,20.0,20.0
11277,2,3277,[272 303 478 211 315],537,5,12877,3.9283099450884684,20.0,20.0
11278,2,3278,[272 303 478 211 315],13,5,12882,3.928636779505947,20.0,20.0
11279,2,3279,[217 485 227 272 324],334,2,12884,3.928048780487805,0.0,0.0
11280,2,3280,[272 303 478 211 315],537,5,12889,3.9283754952758305,20.0,20.0
11281,2,3281,[272 303 478 211 315],537,5,12894,3.9287020109689212,20.0,20.0
11282,2,3282,[272 303 478 211 315],537,5,12899,3.92902832774901,20.0,20.0
11283,2,3283,[272 303 478 211 315],13,5,12904,3.9293544457978076,20.0,20.0
11284,2,3284,[272 303 478 211 315],13,5,12909,3.9296803652968038,20.0,20.0
11285,2,3285,[326 272 226 295 222],548,4,12913,3.9297017650639074,0.0,20.0
11286,2,3286,[272 303 478 211 315],13,5,12918,3.9300273805902037,20.0,20.0
11287,2,3287,[272 303 478 211 315],537,5,12923,3.9303527980535278,20.0,20.0
11288,2,3288,[272 303 478 211 315],537,5,12928,3.9306780176345395,20.0,20.0
11289,2,3289,[272 303 478 211 315],13,5,12933,3.9310030395136777,20.0,20.0
11290,2,3290,[272 303 478 211 315],13,5,12938,3.931327863871164,20.0,20.0
11291,2,3291,[485 509 231 420 326],378,3,12941,3.931044957472661,0.0,0.0
11292,2,3292,[272 303 478 211 315],537,5,12946,3.93136957181901,20.0,20.0
11293,2,3293,[272 303 478 211 315],537,5,12951,3.931693989071038,20.0,20.0
11294,2,3294,[365 208 367 481 284],308,4,12955,3.9317147192716235,0.0,0.0
11295,2,3295,[272 303 478 211 315],13,5,12960,3.9320388349514563,20.0,20.0
11296,2,3296,[272 303 478 211 315],537,5,12965,3.932362754018805,20.0,20.0
11297,2,3297,[272 303 478 211 315],537,5,12970,3.9326864766525165,20.0,20.0
11298,2,3298,[272 303 478 211 315],13,5,12975,3.9330100030312214,20.0,20.0
11299,2,3299,[272 303 478 211 315],13,5,12980,3.933333333333333,20.0,20.0
11300,2,3300,[272 303 478 211 315],13,5,12985,3.9336564677370496,20.0,20.0
11301,2,3301,[226 223 293 508 216],653,0,12985,3.9324651726226527,20.0,0.0
11302,2,3302,[272 303 478 211 315],13,5,12990,3.932788374205268,20.0,20.0
11303,2,3303,[272 303 478 211 315],537,5,12995,3.9331113801452786,20.0,20.0
11304,2,3304,[272 303 478 211 315],13,5,13000,3.933434190620272,20.0,20.0
11305,2,3305,[213 508 239 216 429],653,1,13001,3.9325468844525107,0.0,0.0
11306,2,3306,[272 303 478 211 315],13,5,13006,3.9328696703961294,20.0,20.0
11307,2,3307,[272 303 478 211 315],537,5,13011,3.933192261185006,20.0,20.0
11308,2,3308,[272 303 478 211 315],537,5,13016,3.9335146569960715,20.0,20.0
11309,2,3309,[272 303 478 211 315],537,5,13021,3.933836858006042,20.0,20.0
11310,2,3310,[272 303 478 211 315],13,5,13026,3.9341588643914225,20.0,20.0
11311,2,3311,[272 303 478 211 315],13,5,13031,3.9344806763285023,20.0,20.0
11312,2,3312,[272 303 478 211 315],13,5,13036,3.9348022939933593,20.0,20.0
11313,2,3313,[272 303 478 211 315],537,5,13041,3.9351237175618587,20.0,20.0
11314,2,3314,[272 303 478 211 315],537,5,13046,3.935444947209653,20.0,20.0
11315,2,3315,[272 303 478 211 315],537,5,13051,3.935765983112183,20.0,20.0
11316,2,3316,[272 303 478 211 315],13,5,13056,3.936086825444679,20.0,20.0
11317,2,3317,[272 303 478 211 315],13,5,13061,3.936407474382158,20.0,20.0
11318,2,3318,[272 303 478 211 315],13,5,13066,3.9367279300994276,20.0,20.0
11319,2,3319,[272 303 478 211 315],13,5,13071,3.9370481927710843,20.0,20.0
11320,2,3320,[272 303 478 211 315],13,5,13076,3.9373682625715145,20.0,20.0
11321,2,3321,[272 303 478 211 315],537,5,13081,3.937688139674895,20.0,20.0
11322,2,3322,[272 303 478 211 315],13,5,13086,3.938007824255191,20.0,20.0
11323,2,3323,[272 303 478 211 315],13,5,13091,3.9383273164861614,20.0,20.0
11324,2,3324,[272 303 478 211 315],13,5,13096,3.9386466165413534,20.0,20.0
11325,2,3325,[272 303 478 211 315],537,5,13101,3.938965724594107,20.0,20.0
11326,2,3326,[478 394 326 507 303],13,2,13103,3.9383829275623685,0.0,0.0
11327,2,3327,[272 303 478 211 315],13,5,13108,3.938701923076923,20.0,20.0
11328,2,3328,[272 303 478 211 315],537,5,13113,3.9390207269450284,20.0,20.0
11329,2,3329,[272 303 478 211 315],13,5,13118,3.939339339339339,20.0,20.0
11330,2,3330,[272 303 478 211 315],13,5,13123,3.9396577604323024,20.0,20.0
11331,2,3331,[272 303 478 211 315],13,5,13128,3.9399759903961584,20.0,20.0
11332,2,3332,[272 303 478 211 315],537,5,13133,3.9402940294029403,20.0,20.0
11333,2,3333,[272 303 478 211 315],537,5,13138,3.940611877624475,20.0,20.0
11334,2,3334,[240 384 367 236 259],279,3,13141,3.940329835082459,0.0,0.0
11335,2,3335,[272 303 478 211 315],537,5,13146,3.9406474820143886,20.0,20.0
11336,2,3336,[272 303 478 211 315],537,5,13151,3.940964938567576,20.0,20.0
11337,2,3337,[272 303 478 211 315],13,5,13156,3.9412822049131218,20.0,20.0
11338,2,3338,[272 303 478 211 315],537,5,13161,3.9415992812219227,20.0,20.0
11339,2,3339,[272 303 478 211 315],537,5,13166,3.9419161676646706,20.0,20.0
11340,2,3340,[272 303 478 211 315],537,5,13171,3.942232864411853,20.0,20.0
11341,2,3341,[272 303 478 211 315],537,5,13176,3.9425493716337523,20.0,20.0
11342,2,3342,[272 303 478 211 315],537,5,13181,3.9428656895004486,20.0,20.0
11343,2,3343,[272 303 478 211 315],13,5,13186,3.9431818181818183,20.0,20.0
11344,2,3344,[272 303 478 211 315],537,5,13191,3.9434977578475334,20.0,20.0
11345,2,3345,[272 303 478 211 315],537,5,13196,3.9438135086670654,20.0,20.0
11346,2,3346,[272 303 478 211 315],13,5,13201,3.94412907080968,20.0,20.0
11347,2,3347,[272 303 478 211 315],537,5,13206,3.9444444444444446,20.0,20.0
11348,2,3348,[230 276 241 485 290],13,2,13208,3.9438638399522246,0.0,20.0
11349,2,3349,[272 303 478 211 315],537,5,13213,3.944179104477612,20.0,20.0
11350,2,3350,[272 303 478 211 315],537,5,13218,3.9444941808415397,20.0,20.0
11351,2,3351,[272 303 478 211 315],537,5,13223,3.9448090692124107,20.0,20.0
11352,2,3352,[272 303 478 211 315],13,5,13228,3.945123769758425,20.0,20.0
11353,2,3353,[272 303 478 211 315],537,5,13233,3.945438282647585,20.0,20.0
11354,2,3354,[272 303 478 211 315],13,5,13238,3.94575260804769,20.0,20.0
11355,2,3355,[272 303 478 211 315],13,5,13243,3.946066746126341,20.0,20.0
11356,2,3356,[272 303 478 211 315],537,5,13248,3.9463806970509383,20.0,20.0
11357,2,3357,[272 303 478 211 315],537,5,13253,3.9466944609886836,20.0,20.0
11358,2,3358,[218 211 276 384 201],13,2,13255,3.9461149151533195,0.0,40.0
11359,2,3359,[272 303 478 211 315],13,5,13260,3.9464285714285716,20.0,20.0
11360,2,3360,[272 303 478 211 315],13,5,13265,3.9467420410592085,20.0,20.0
11361,2,3361,[272 303 478 211 315],537,5,13270,3.9470553242117785,20.0,20.0
11362,2,3362,[272 303 478 211 315],13,5,13275,3.9473684210526314,20.0,20.0
11363,2,3363,[272 303 478 211 315],537,5,13280,3.947681331747919,20.0,20.0
11364,2,3364,[272 303 478 211 315],537,5,13285,3.947994056463596,20.0,20.0
11365,2,3365,[222 241 508 284 215],92,3,13288,3.947712418300654,0.0,20.0
11366,2,3366,[272 303 478 211 315],537,5,13293,3.948024948024948,20.0,20.0
11367,2,3367,[272 303 478 211 315],537,5,13298,3.9483372921615203,20.0,20.0
11368,2,3368,[431 429 226 295 211],749,4,13302,3.948352626892253,0.0,20.0
11369,2,3369,[272 303 478 211 315],537,5,13307,3.9486646884272996,20.0,20.0
11370,2,3370,[272 303 478 211 315],537,5,13312,3.9489765648175617,20.0,20.0
11371,2,3371,[272 303 478 211 315],13,5,13317,3.949288256227758,20.0,20.0
11372,2,3372,[272 303 478 211 315],13,5,13322,3.9495997628224133,20.0,20.0
11373,2,3373,[272 303 478 211 315],13,5,13327,3.9499110847658567,20.0,20.0
11374,2,3374,[429 219 240 211 384],279,4,13331,3.949925925925926,0.0,20.0
11375,2,3375,[272 303 478 211 315],537,5,13336,3.9502369668246446,20.0,20.0
11376,2,3376,[509 211 344 272 202],13,4,13340,3.9502517026946995,0.0,20.0
11377,2,3377,[272 303 478 211 315],13,5,13345,3.9505624629958556,20.0,20.0
11378,2,3378,[291 508 222 215 367],524,3,13348,3.9502811482687186,0.0,20.0
11379,2,3379,[272 303 478 211 315],13,5,13353,3.9505917159763313,20.0,20.0
11380,2,3380,[272 303 478 211 315],13,5,13358,3.9509020999704227,20.0,20.0
11381,2,3381,[272 303 478 211 315],537,5,13363,3.9512123004139563,20.0,20.0
11382,2,3382,[272 303 478 211 315],537,5,13368,3.9515223174697014,20.0,20.0
11383,2,3383,[272 303 478 211 315],13,5,13373,3.9518321513002364,20.0,20.0
11384,2,3384,[272 303 478 211 315],537,5,13378,3.952141802067947,20.0,20.0
11385,2,3385,[272 303 478 211 315],13,5,13383,3.9524512699350267,20.0,20.0
11386,2,3386,[272 303 478 211 315],537,5,13388,3.952760555063478,20.0,20.0
11387,2,3387,[272 303 478 211 315],537,5,13393,3.9530696576151123,20.0,20.0
11388,2,3388,[272 303 478 211 315],537,5,13398,3.953378577751549,20.0,20.0
11389,2,3389,[508 230 485 284 213],85,2,13400,3.9528023598820057,0.0,0.0
11390,2,3390,[241 216 218 264 201],13,1,13401,3.9519315836036566,0.0,0.0
11391,2,3391,[508 221 231 259 226],537,1,13402,3.951061320754717,0.0,0.0
11392,2,3392,[211 509 478 212 221],90,5,13407,3.951370468611848,0.0,20.0
11393,2,3393,[213 259 478 284 222],537,2,13409,3.9507955215085446,0.0,20.0
11394,2,3394,[272 303 478 211 315],537,5,13414,3.9511045655375554,20.0,20.0
11395,2,3395,[272 303 478 211 315],537,5,13419,3.9514134275618376,20.0,20.0
11396,2,3396,[300 213 212 227 216],311,4,13423,3.951427730350309,0.0,20.0
11397,2,3397,[272 303 478 211 315],537,5,13428,3.951736315479694,20.0,20.0
11398,2,3398,[485 212 201 208 222],13,2,13430,3.9511621065019122,0.0,20.0
11399,2,3399,[211 478 222 223 208],488,4,13434,3.9511764705882353,20.0,40.0
11400,2,3400,[272 303 478 211 315],537,5,13439,3.9514848573948838,20.0,20.0
11401,2,3401,[272 303 478 211 315],537,5,13444,3.951793062904174,20.0,20.0
11402,2,3402,[272 303 478 211 315],537,5,13449,3.952101087275933,20.0,20.0
11403,2,3403,[272 303 478 211 315],537,5,13454,3.9524089306698,20.0,20.0
11404,2,3404,[272 303 478 211 315],537,5,13459,3.9527165932452277,20.0,20.0
11405,2,3405,[272 303 478 211 315],537,5,13464,3.95302407516148,20.0,20.0
11406,2,3406,[272 303 478 211 315],537,5,13469,3.9533313765776343,20.0,20.0
11407,2,3407,[272 303 478 211 315],537,5,13474,3.953638497652582,20.0,20.0
11408,2,3408,[241 264 275 202 243],13,2,13476,3.9530654150777353,0.0,20.0
11409,2,3409,[272 303 478 211 315],537,5,13481,3.9533724340175955,20.0,20.0
11410,2,3410,[272 303 478 211 315],13,5,13486,3.953679272940487,20.0,20.0
11411,2,3411,[272 303 478 211 315],537,5,13491,3.9539859320046893,20.0,20.0
11412,2,3412,[272 303 478 211 315],13,5,13496,3.954292411368298,20.0,20.0
11413,2,3413,[272 303 478 211 315],537,5,13501,3.9545987111892207,20.0,20.0
11414,2,3414,[272 303 478 211 315],537,5,13506,3.954904831625183,20.0,20.0
11415,2,3415,[272 303 478 211 315],537,5,13511,3.955210772833724,20.0,20.0
11416,2,3416,[272 303 478 211 315],537,5,13516,3.955516534972198,20.0,20.0
11417,2,3417,[272 303 478 211 315],13,5,13521,3.9558221181977764,20.0,20.0
11418,2,3418,[272 303 478 211 315],537,5,13526,3.9561275226674466,20.0,20.0
11419,2,3419,[509 261 290 243 367],13,2,13528,3.9555555555555557,0.0,0.0
11420,2,3420,[216 485 275 202 321],311,3,13531,3.9552762350190003,0.0,20.0
11421,2,3421,[272 303 478 211 315],537,5,13536,3.955581531268264,20.0,20.0
11422,2,3422,[272 303 478 211 315],13,5,13541,3.9558866491381828,20.0,20.0
11423,2,3423,[272 303 478 211 315],537,5,13546,3.9561915887850465,20.0,20.0
11424,2,3424,[230 507 431 226 413],13,1,13547,3.9553284671532847,0.0,0.0
11425,2,3425,[272 303 478 211 315],537,5,13552,3.9556333917104496,20.0,20.0
11426,2,3426,[272 303 478 211 315],537,5,13557,3.955938138313394,20.0,20.0
11427,2,3427,[315 255 221 509 378],474,5,13562,3.956242707117853,20.0,0.0
11428,2,3428,[272 303 478 211 315],537,5,13567,3.9565470982793816,20.0,20.0
11429,2,3429,[272 303 478 211 315],537,5,13572,3.956851311953353,20.0,20.0
11430,2,3430,[299 301 429 275 230],537,1,13573,3.9559895074322355,0.0,20.0
11431,2,3431,[431 478 485 226 331],13,2,13575,3.9554195804195804,0.0,0.0
11432,2,3432,[272 303 478 211 315],537,5,13580,3.955723856685115,20.0,20.0
11433,2,3433,[272 303 478 211 315],13,5,13585,3.95602795573675,20.0,20.0
11434,2,3434,[272 303 478 211 315],13,5,13590,3.9563318777292578,20.0,20.0
11435,2,3435,[321 201 300 212 208],537,1,13591,3.9554714784633296,0.0,20.0
11436,2,3436,[299 276 384 507 215],13,2,13593,3.9549025312772765,0.0,20.0
11437,2,3437,[272 303 478 211 315],13,5,13598,3.9552065154159397,20.0,20.0
11438,2,3438,[202 301 220 215 212],90,3,13601,3.9549287583599884,0.0,0.0
11439,2,3439,[272 303 478 211 315],537,5,13606,3.9552325581395347,20.0,20.0
11440,2,3440,[272 303 478 211 315],537,5,13611,3.955536181342633,20.0,20.0
11441,2,3441,[222 216 275 509 230],13,1,13612,3.9546775130737943,0.0,40.0
11442,2,3442,[239 223 583 216 509],308,3,13615,3.954400232355504,20.0,0.0
11443,2,3443,[272 303 478 211 315],13,5,13620,3.9547038327526134,20.0,20.0
11444,2,3444,[272 303 478 211 315],13,5,13625,3.9550072568940493,20.0,20.0
11445,2,3445,[507 222 290 429 478],13,3,13628,3.954730121880441,0.0,20.0
11446,2,3446,[222 378 230 202 217],295,5,13633,3.9550333623440674,0.0,20.0
11447,2,3447,[221 202 216 243 241],234,0,13633,3.9538863109048723,0.0,0.0
11448,2,3448,[272 303 478 211 315],537,5,13638,3.954189620179762,20.0,20.0
11449,2,3449,[272 303 478 211 315],537,5,13643,3.9544927536231884,20.0,20.0
11450,2,3450,[272 303 478 211 315],13,5,13648,3.9547957113880035,20.0,20.0
11451,2,3451,[272 303 478 211 315],13,5,13653,3.955098493626883,20.0,20.0
11452,2,3452,[272 303 478 211 315],13,5,13658,3.9554011004923253,20.0,20.0
11453,2,3453,[290 236 226 243 301],537,0,13658,3.9542559351476547,0.0,0.0
11454,2,3454,[259 216 208 316 293],474,3,13661,3.9539797395079597,20.0,0.0
11455,2,3455,[508 216 275 201 268],13,1,13662,3.953125,0.0,20.0
11456,2,3456,[272 303 478 211 315],537,5,13667,3.953427827596182,20.0,20.0
11457,2,3457,[272 303 478 211 315],13,5,13672,3.9537304800462696,20.0,20.0
11458,2,3458,[272 303 478 211 315],13,5,13677,3.9540329575021684,20.0,20.0
11459,2,3459,[272 303 478 211 315],537,5,13682,3.9543352601156068,20.0,20.0
11460,2,3460,[272 303 478 211 315],537,5,13687,3.9546373880381394,20.0,20.0
11461,2,3461,[213 431 429 420 212],406,2,13689,3.9540727902946275,0.0,0.0
11462,2,3462,[272 303 478 211 315],537,5,13694,3.954374819520647,20.0,20.0
11463,2,3463,[272 303 478 211 315],537,5,13699,3.954676674364896,20.0,20.0
11464,2,3464,[336 264 303 232 485],13,2,13701,3.954112554112554,0.0,0.0
11465,2,3465,[254 230 452 219 293],774,1,13702,3.953260242354299,0.0,0.0
11466,2,3466,[478 509 243 485 230],537,2,13704,3.9526968560715314,0.0,0.0
11467,2,3467,[272 303 478 211 315],537,5,13709,3.9529988465974624,20.0,20.0
11468,2,3468,[272 303 478 211 315],537,5,13714,3.9533006630152783,20.0,20.0
11469,2,3469,[272 303 478 211 315],13,5,13719,3.9536023054755045,20.0,20.0
11470,2,3470,[272 303 478 211 315],13,5,13724,3.9539037741284933,20.0,20.0
11471,2,3471,[272 303 478 211 315],13,5,13729,3.954205069124424,20.0,20.0
11472,2,3472,[272 303 478 211 315],13,5,13734,3.9545061906133028,20.0,20.0
11473,2,3473,[272 303 478 211 315],537,5,13739,3.9548071387449624,20.0,20.0
11474,2,3474,[485 201 300 206 243],537,0,13739,3.9536690647482016,0.0,20.0
11475,2,3475,[272 303 478 211 315],13,5,13744,3.953970080552359,20.0,20.0
11476,2,3476,[272 303 478 211 315],537,5,13749,3.9542709232096636,20.0,20.0
11477,2,3477,[507 284 208 300 384],271,1,13750,3.953421506612996,0.0,20.0
11478,2,3478,[264 290 268 230 272],13,4,13754,3.9534348950847944,0.0,0.0
11479,2,3479,[290 209 208 206 275],537,3,13757,3.9531609195402297,0.0,20.0
11480,2,3480,[222 239 223 326 208],334,3,13760,3.9528871014076414,20.0,20.0
11481,2,3481,[272 303 478 211 315],13,5,13765,3.953187823090178,20.0,20.0
11482,2,3482,[215 239 431 280 291],200,3,13768,3.952914154464542,0.0,0.0
11483,2,3483,[272 303 478 211 315],537,5,13773,3.9532146957520093,20.0,20.0
11484,2,3484,[272 303 478 211 315],13,5,13778,3.9535150645624104,20.0,20.0
11485,2,3485,[272 303 478 211 315],13,5,13783,3.9538152610441766,20.0,20.0
11486,2,3486,[215 212 507 230 255],474,4,13787,3.9538285058789793,0.0,0.0
11487,2,3487,[272 303 478 211 315],13,5,13792,3.9541284403669725,20.0,20.0
11488,2,3488,[272 303 478 211 315],537,5,13797,3.9544282029234736,20.0,20.0
11489,2,3489,[272 303 478 211 315],537,5,13802,3.954727793696275,20.0,20.0
11490,2,3490,[350 431 321 509 507],13,1,13803,3.9538814093382983,0.0,0.0
11491,2,3491,[272 303 478 211 315],537,5,13808,3.9541809851088203,20.0,20.0
11492,2,3492,[272 303 478 211 315],537,5,13813,3.954480389350129,20.0,20.0
11493,2,3493,[272 303 478 211 315],13,5,13818,3.954779622209502,20.0,20.0
11494,2,3494,[272 303 478 211 315],537,5,13823,3.955078683834049,20.0,20.0
11495,2,3495,[272 303 478 211 315],13,5,13828,3.9553775743707096,20.0,20.0
11496,2,3496,[272 303 478 211 315],537,5,13833,3.9556762939662566,20.0,20.0
11497,2,3497,[413 394 485 384 226],13,1,13834,3.9548313321898227,0.0,0.0
11498,2,3498,[272 303 478 211 315],537,5,13839,3.9551300371534723,20.0,20.0
11499,2,3499,[272 303 478 211 315],537,5,13844,3.9554285714285715,20.0,20.0
11500,2,3500,[218 209 255 283 431],474,4,13848,3.955441302485004,0.0,0.0
11501,2,3501,[272 303 478 211 315],537,5,13853,3.955739577384352,20.0,20.0
11502,2,3502,[272 303 478 211 315],537,5,13858,3.9560376819868686,20.0,20.0
11503,2,3503,[272 303 478 211 315],13,5,13863,3.956335616438356,20.0,20.0
11504,2,3504,[272 303 478 211 315],537,5,13868,3.9566333808844507,20.0,20.0
11505,2,3505,[272 509 220 275 485],378,4,13872,3.956645750142613,0.0,20.0
11506,2,3506,[272 303 478 211 315],537,5,13877,3.956943256344454,20.0,20.0
11507,2,3507,[272 303 478 211 315],13,5,13882,3.957240592930445,20.0,20.0
11508,2,3508,[485 232 209 219 227],650,0,13882,3.956112852664577,0.0,0.0
11509,2,3509,[272 303 478 211 315],537,5,13887,3.9564102564102566,20.0,20.0
11510,2,3510,[272 303 478 211 315],13,5,13892,3.956707490743378,20.0,20.0
11511,2,3511,[272 303 478 211 315],537,5,13897,3.957004555808656,20.0,20.0
11512,2,3512,[272 303 478 211 315],13,5,13902,3.9573014517506406,20.0,20.0
11513,2,3513,[583 284 239 201 429],308,4,13906,3.9573136027319293,0.0,0.0
11514,2,3514,[272 303 478 211 315],13,5,13911,3.957610241820768,20.0,20.0
11515,2,3515,[272 303 478 211 315],13,5,13916,3.9579067121729237,20.0,20.0
11516,2,3516,[259 272 223 218 485],90,4,13920,3.957918680693773,20.0,0.0
11517,2,3517,[272 303 478 211 315],13,5,13925,3.958214894826606,20.0,20.0
11518,2,3518,[272 303 478 211 315],13,5,13930,3.9585109406081274,20.0,20.0
11519,2,3519,[272 303 478 211 315],13,5,13935,3.9588068181818183,20.0,20.0
11520,2,3520,[272 303 478 211 315],537,5,13940,3.959102527690997,20.0,20.0
11521,2,3521,[272 303 478 211 315],537,5,13945,3.959398069278819,20.0,20.0
11522,2,3522,[243 202 478 215 367],234,1,13946,3.9585580471189328,0.0,0.0
11523,2,3523,[272 303 211 478 315],537,5,13951,3.9588535754824066,20.0,20.0
11524,2,3524,[272 303 211 478 315],13,5,13956,3.959148936170213,20.0,20.0
11525,2,3525,[272 303 211 478 315],13,5,13961,3.959444129325014,20.0,20.0
11526,2,3526,[212 295 326 221 293],894,3,13964,3.9591721009356395,0.0,0.0
11527,2,3527,[272 303 211 478 315],537,5,13969,3.959467120181406,20.0,20.0
11528,2,3528,[272 303 211 478 315],13,5,13974,3.9597619722300936,20.0,20.0
11529,2,3529,[272 303 211 478 315],537,5,13979,3.960056657223796,20.0,20.0
11530,2,3530,[272 303 211 478 315],13,5,13984,3.9603511753044462,20.0,20.0
11531,2,3531,[272 303 211 478 315],13,5,13989,3.9606455266138165,20.0,20.0
11532,2,3532,[272 303 211 478 315],537,5,13994,3.960939711293518,20.0,20.0
11533,2,3533,[272 303 211 478 315],13,5,13999,3.9612337294850026,20.0,20.0
11534,2,3534,[272 303 211 478 315],13,5,14004,3.9615275813295616,20.0,20.0
11535,2,3535,[226 283 431 298 284],548,3,14007,3.961255656108597,0.0,0.0
11536,2,3536,[272 303 211 478 315],13,5,14012,3.9615493355951372,20.0,20.0
11537,2,3537,[272 303 211 478 315],13,5,14017,3.9618428490672697,20.0,20.0
11538,2,3538,[272 303 211 478 315],537,5,14022,3.9621361966657247,20.0,20.0
11539,2,3539,[272 303 211 478 315],537,5,14027,3.9624293785310734,20.0,20.0
11540,2,3540,[272 303 211 478 315],13,5,14032,3.962722394803728,20.0,20.0
11541,2,3541,[324 508 275 246 297],894,3,14035,3.9624505928853755,20.0,20.0
11542,2,3542,[272 303 211 478 315],13,5,14040,3.9627434377646065,20.0,20.0
11543,2,3543,[272 303 211 478 315],13,5,14045,3.9630361173814896,20.0,20.0
11544,2,3544,[272 303 211 478 315],537,5,14050,3.9633286318758816,20.0,20.0
11545,2,3545,[259 226 250 219 202],279,2,14052,3.9627749576988154,0.0,0.0
11546,2,3546,[272 303 211 478 315],13,5,14057,3.963067380885255,20.0,20.0
11547,2,3547,[272 303 211 478 315],13,5,14062,3.9633596392333708,20.0,20.0
11548,2,3548,[272 303 211 478 315],537,5,14067,3.9636517328825023,20.0,20.0
11549,2,3549,[272 303 211 478 315],13,5,14072,3.963943661971831,20.0,20.0
11550,2,3550,[272 303 211 478 315],13,5,14077,3.964235426640383,20.0,20.0
11551,2,3551,[272 303 211 478 315],13,5,14082,3.964527027027027,20.0,20.0
11552,2,3552,[272 303 211 478 315],537,5,14087,3.9648184632704755,20.0,20.0
11553,2,3553,[272 303 211 478 315],537,5,14092,3.9651097355092855,20.0,20.0
11554,2,3554,[272 303 211 478 315],13,5,14097,3.9654008438818567,20.0,20.0
11555,2,3555,[202 301 230 413 303],13,2,14099,3.9648481439820022,0.0,0.0
11556,2,3556,[272 303 211 478 315],13,5,14104,3.9651391622153502,20.0,20.0
11557,2,3557,[222 219 209 431 254],804,3,14107,3.96486790331647,0.0,20.0
11558,2,3558,[284 227 223 384 336],833,1,14108,3.9640348412475412,20.0,0.0
11559,2,3559,[272 303 211 478 315],13,5,14113,3.964325842696629,20.0,20.0
11560,2,3560,[272 303 211 478 315],13,5,14118,3.9646166807076666,20.0,20.0
11561,2,3561,[272 303 211 478 315],537,5,14123,3.9649073554183043,20.0,20.0
11562,2,3562,[243 215 331 217 507],13,1,14124,3.9640752175133316,0.0,0.0
11563,2,3563,[272 303 211 478 315],537,5,14129,3.9643658810325477,20.0,20.0
11564,2,3564,[272 303 211 478 315],13,5,14134,3.964656381486676,20.0,20.0
11565,2,3565,[350 212 290 394 239],13,3,14137,3.964385866517106,0.0,0.0
11566,2,3566,[222 378 215 300 216],892,5,14142,3.964676198486123,0.0,40.0
11567,2,3567,[272 303 211 478 315],537,5,14147,3.9649663677130045,20.0,20.0
11568,2,3568,[272 303 211 478 315],537,5,14152,3.9652563743345475,20.0,20.0
11569,2,3569,[384 420 303 331 268],13,3,14155,3.9649859943977592,0.0,0.0
11570,2,3570,[272 303 211 478 315],537,5,14160,3.965275833099972,20.0,20.0
11571,2,3571,[481 321 275 583 201],308,4,14164,3.9652855543113104,0.0,20.0
11572,2,3572,[231 429 283 321 290],279,3,14167,3.96501539322698,0.0,0.0
11573,2,3573,[272 303 211 478 315],537,5,14172,3.965304980414102,20.0,20.0
11574,2,3574,[272 303 211 478 315],537,5,14177,3.9655944055944055,20.0,20.0
11575,2,3575,[272 303 211 478 315],13,5,14182,3.9658836689038033,20.0,20.0
11576,2,3576,[272 303 211 478 315],13,5,14187,3.966172770478054,20.0,20.0
11577,2,3577,[291 267 226 223 217],833,1,14188,3.9653437674678593,20.0,0.0
11578,2,3578,[452 217 243 216 272],650,2,14190,3.9647946353730092,0.0,0.0
11579,2,3579,[272 303 211 478 315],537,5,14195,3.9650837988826817,20.0,20.0
11580,2,3580,[272 303 211 478 315],537,5,14200,3.965372800893605,20.0,20.0
11581,2,3581,[272 303 211 478 315],13,5,14205,3.9656616415410384,20.0,20.0
11582,2,3582,[272 303 211 478 315],13,5,14210,3.9659503209600895,20.0,20.0
11583,2,3583,[223 280 298 275 218],378,2,14212,3.9654017857142856,20.0,20.0
11584,2,3584,[272 303 211 478 315],13,5,14217,3.9656903765690377,20.0,20.0
11585,2,3585,[272 303 211 478 315],13,5,14222,3.965978806469604,20.0,20.0
11586,2,3586,[272 303 211 478 315],13,5,14227,3.9662670755505993,20.0,20.0
11587,2,3587,[272 303 211 478 315],537,5,14232,3.9665551839464883,20.0,20.0
11588,2,3588,[272 303 211 478 315],537,5,14237,3.9668431317915855,20.0,20.0
11589,2,3589,[485 243 321 230 241],59,3,14240,3.966573816155989,0.0,0.0
11590,2,3590,[272 303 211 478 315],537,5,14245,3.9668615984405458,20.0,20.0
11591,2,3591,[272 303 211 478 315],537,5,14250,3.967149220489978,20.0,20.0
11592,2,3592,[272 303 211 478 315],537,5,14255,3.9674366824380742,20.0,20.0
11593,2,3593,[291 216 431 222 429],537,1,14256,3.96661101836394,0.0,20.0
11594,2,3594,[272 303 211 478 315],537,5,14261,3.9668984700973575,20.0,20.0
11595,2,3595,[272 303 211 478 315],537,5,14266,3.967185761957731,20.0,20.0
11596,2,3596,[272 303 211 478 315],537,5,14271,3.9674728940783988,20.0,20.0
11597,2,3597,[272 303 211 478 315],13,5,14276,3.9677598665925515,20.0,20.0
11598,2,3598,[272 303 211 478 315],13,5,14281,3.9680466796332317,20.0,20.0
11599,2,3599,[272 303 211 478 315],537,5,14286,3.9683333333333333,20.0,20.0
11600,2,3600,[246 213 298 202 297],6,1,14287,3.967509025270758,20.0,0.0
11601,2,3601,[211 283 259 299 275],537,3,14290,3.9672404219877846,0.0,40.0
11602,2,3602,[272 303 211 478 315],537,5,14295,3.967527060782681,20.0,20.0
11603,2,3603,[272 303 211 478 315],13,5,14300,3.967813540510544,20.0,20.0
11604,2,3604,[272 303 211 478 315],13,5,14305,3.968099861303745,20.0,20.0
11605,2,3605,[272 303 211 478 315],537,5,14310,3.968386023294509,20.0,20.0
11606,2,3606,[272 303 211 478 315],537,5,14315,3.9686720266149154,20.0,20.0
11607,2,3607,[272 303 211 478 315],537,5,14320,3.9689578713968956,20.0,20.0
11608,2,3608,[481 208 420 255 378],308,4,14324,3.968966472707121,0.0,0.0
11609,2,3609,[272 303 211 478 315],537,5,14329,3.969252077562327,20.0,20.0
11610,2,3610,[272 303 211 478 315],537,5,14334,3.969537524231515,20.0,20.0
11611,2,3611,[326 394 509 215 485],13,2,14336,3.9689922480620154,0.0,0.0
11612,2,3612,[272 303 211 478 315],13,5,14341,3.969277608635483,20.0,20.0
11613,2,3613,[272 303 211 478 315],13,5,14346,3.96956281128943,20.0,20.0
11614,2,3614,[272 303 211 478 315],13,5,14351,3.96984785615491,20.0,20.0
11615,2,3615,[272 303 211 478 315],13,5,14356,3.9701327433628317,20.0,20.0
11616,2,3616,[272 303 211 478 315],13,5,14361,3.970417473043959,20.0,20.0
11617,2,3617,[236 230 227 202 259],145,3,14364,3.970149253731343,0.0,0.0
11618,2,3618,[226 216 239 211 420],934,4,14368,3.9701575020723956,0.0,20.0
11619,2,3619,[272 303 211 478 315],537,5,14373,3.9704419889502764,20.0,20.0
11620,2,3620,[272 303 211 478 315],537,5,14378,3.9707263186964927,20.0,20.0
11621,2,3621,[272 303 211 478 315],13,5,14383,3.971010491441193,20.0,20.0
11622,2,3622,[241 384 222 218 209],13,0,14383,3.9699144355506486,0.0,20.0
11623,2,3623,[272 303 211 478 315],537,5,14388,3.9701986754966887,20.0,20.0
11624,2,3624,[272 303 211 478 315],13,5,14393,3.9704827586206894,20.0,20.0
11625,2,3625,[272 303 211 478 315],537,5,14398,3.9707666850523995,20.0,20.0
11626,2,3626,[222 212 209 226 220],92,3,14401,3.970499035015164,0.0,20.0
11627,2,3627,[272 303 211 478 315],537,5,14406,3.970782800441014,20.0,20.0
11628,2,3628,[272 303 211 478 315],13,5,14411,3.9710664094791954,20.0,20.0
11629,2,3629,[272 303 211 478 315],537,5,14416,3.971349862258953,20.0,20.0
11630,2,3630,[272 303 211 478 315],13,5,14421,3.971633158909391,20.0,20.0
11631,2,3631,[326 226 275 231 431],328,2,14423,3.971090308370044,0.0,20.0
11632,2,3632,[272 303 211 478 315],537,5,14428,3.9713735205064684,20.0,20.0
11633,2,3633,[272 303 211 478 315],13,5,14433,3.9716565767749037,20.0,20.0
11634,2,3634,[272 303 211 478 315],13,5,14438,3.971939477303989,20.0,20.0
11635,2,3635,[222 276 231 283 275],537,3,14441,3.9716721672167217,0.0,60.0
11636,2,3636,[300 324 244 321 250],486,2,14443,3.971130052240858,0.0,20.0
11637,2,3637,[272 303 211 478 315],537,5,14448,3.971412864211105,20.0,20.0
11638,2,3638,[272 303 211 478 315],537,5,14453,3.971695520747458,20.0,20.0
11639,2,3639,[272 303 211 478 315],13,5,14458,3.971978021978022,20.0,20.0
11640,2,3640,[481 241 367 208 202],326,1,14459,3.9711617687448504,0.0,0.0
11641,2,3641,[272 303 211 478 315],537,5,14464,3.971444261394838,20.0,20.0
11642,2,3642,[272 303 211 478 315],537,5,14469,3.9717265989569035,20.0,20.0
11643,2,3643,[272 303 211 478 315],537,5,14474,3.972008781558727,20.0,20.0
11644,2,3644,[272 303 211 478 315],537,5,14479,3.972290809327846,20.0,20.0
11645,2,3645,[272 303 211 478 315],537,5,14484,3.9725726823916623,20.0,20.0
11646,2,3646,[208 272 222 485 243],650,3,14487,3.9723060049355636,0.0,20.0
11647,2,3647,[272 303 211 478 315],13,5,14492,3.9725877192982457,20.0,20.0
11648,2,3648,[272 303 211 478 315],13,5,14497,3.9728692792545903,20.0,20.0
11649,2,3649,[272 303 211 478 315],537,5,14502,3.973150684931507,20.0,20.0
11650,2,3650,[272 303 211 478 315],537,5,14507,3.9734319364557655,20.0,20.0
11651,2,3651,[272 303 211 478 315],13,5,14512,3.973713033953998,20.0,20.0
11652,2,3652,[272 303 211 478 315],537,5,14517,3.9739939775526962,20.0,20.0
11653,2,3653,[272 303 211 478 315],13,5,14522,3.9742747673782155,20.0,20.0
11654,2,3654,[272 303 211 478 315],537,5,14527,3.9745554035567716,20.0,20.0
11655,2,3655,[272 303 211 478 315],537,5,14532,3.974835886214442,20.0,20.0
11656,2,3656,[272 303 211 478 315],13,5,14537,3.975116215477167,20.0,20.0
11657,2,3657,[272 303 211 478 315],13,5,14542,3.975396391470749,20.0,20.0
11658,2,3658,[216 485 223 276 280],234,0,14542,3.9743099207433725,20.0,20.0
11659,2,3659,[315 321 217 507 431],13,1,14543,3.973497267759563,20.0,0.0
11660,2,3660,[272 303 211 478 315],537,5,14548,3.9737776563780387,20.0,20.0
11661,2,3661,[272 303 211 478 315],13,5,14553,3.9740578918623704,20.0,20.0
11662,2,3662,[272 303 211 478 315],537,5,14558,3.9743379743379745,20.0,20.0
11663,2,3663,[272 303 211 478 315],13,5,14563,3.974617903930131,20.0,20.0
11664,2,3664,[272 303 211 478 315],13,5,14568,3.9748976807639838,20.0,20.0
11665,2,3665,[272 303 211 478 315],13,5,14573,3.975177304964539,20.0,20.0
11666,2,3666,[241 452 276 299 209],13,1,14574,3.9743659667302973,0.0,20.0
11667,2,3667,[272 303 211 478 315],13,5,14579,3.9746455834242096,20.0,20.0
11668,2,3668,[272 303 211 478 315],537,5,14584,3.97492504769692,20.0,20.0
11669,2,3669,[272 303 211 478 315],537,5,14589,3.9752043596730244,20.0,20.0
11670,2,3670,[272 303 211 478 315],537,5,14594,3.9754835194769815,20.0,20.0
11671,2,3671,[272 303 211 478 315],13,5,14599,3.9757625272331154,20.0,20.0
11672,2,3672,[367 211 209 284 227],524,3,14602,3.975496869044378,0.0,20.0
11673,2,3673,[272 303 211 478 315],13,5,14607,3.975775721284703,20.0,20.0
11674,2,3674,[272 303 211 478 315],537,5,14612,3.9760544217687075,20.0,20.0
11675,2,3675,[272 303 211 478 315],13,5,14617,3.9763329706202395,20.0,20.0
11676,2,3676,[272 303 211 478 315],13,5,14622,3.9766113679630135,20.0,20.0
11677,2,3677,[227 259 485 367 219],7,2,14624,3.976073953235454,0.0,0.0
11678,2,3678,[272 303 211 478 315],537,5,14629,3.9763522696384888,20.0,20.0
11679,2,3679,[272 303 211 478 315],537,5,14634,3.9766304347826087,20.0,20.0
11680,2,3680,[429 232 227 211 206],387,3,14637,3.9763651181744093,0.0,20.0
11681,2,3681,[272 303 211 478 315],537,5,14642,3.9766431287343833,20.0,20.0
11682,2,3682,[241 485 275 215 216],90,4,14646,3.9766494705403206,0.0,20.0
11683,2,3683,[272 303 211 478 315],13,5,14651,3.976927252985885,20.0,20.0
11684,2,3684,[392 218 378 209 239],843,0,14651,3.9758480325644503,0.0,0.0
11685,2,3685,[272 303 211 478 315],13,5,14656,3.9761258817145957,20.0,20.0
11686,2,3686,[230 231 321 344 280],13,1,14657,3.975318687279631,0.0,0.0
11687,2,3687,[211 365 452 216 264],7,5,14662,3.975596529284165,0.0,20.0
11688,2,3688,[272 303 211 478 315],537,5,14667,3.9758742206560043,20.0,20.0
11689,2,3689,[272 303 211 478 315],13,5,14672,3.976151761517615,20.0,20.0
11690,2,3690,[272 303 211 478 315],537,5,14677,3.97642915199133,20.0,20.0
11691,2,3691,[272 303 211 478 315],13,5,14682,3.97670639219935,20.0,20.0
11692,2,3692,[272 303 211 478 315],13,5,14687,3.9769834822637424,20.0,20.0
11693,2,3693,[272 303 211 478 315],537,5,14692,3.977260422306443,20.0,20.0
11694,2,3694,[272 303 211 478 315],13,5,14697,3.977537212449256,20.0,20.0
11695,2,3695,[367 226 221 230 429],524,2,14699,3.9770021645021645,0.0,0.0
11696,2,3696,[297 316 236 276 485],334,4,14703,3.9770083851771707,40.0,20.0
11697,2,3697,[272 303 211 478 315],13,5,14708,3.977285018929151,20.0,20.0
11698,2,3698,[272 303 211 478 315],537,5,14713,3.9775615031089484,20.0,20.0
11699,2,3699,[272 303 211 478 315],13,5,14718,3.977837837837838,20.0,20.0
11700,2,3700,[272 303 211 478 315],537,5,14723,3.978114023236963,20.0,20.0
11701,2,3701,[272 303 211 478 315],537,5,14728,3.9783900594273365,20.0,20.0
11702,2,3702,[272 303 211 478 315],13,5,14733,3.9786659465298406,20.0,20.0
11703,2,3703,[219 378 485 216 231],650,1,14734,3.9778617710583153,0.0,0.0
11704,2,3704,[272 303 211 478 315],537,5,14739,3.9781376518218625,20.0,20.0
11705,2,3705,[272 303 211 478 315],13,5,14744,3.9784133837021045,20.0,20.0
11706,2,3706,[272 303 211 478 315],537,5,14749,3.9786889668195307,20.0,20.0
11707,2,3707,[226 298 201 291 276],308,3,14752,3.9784250269687162,0.0,20.0
11708,2,3708,[272 303 211 478 315],13,5,14757,3.978700458344567,20.0,20.0
11709,2,3709,[272 303 211 478 315],13,5,14762,3.9789757412398923,20.0,20.0
11710,2,3710,[272 303 211 478 315],537,5,14767,3.979250875774724,20.0,20.0
11711,2,3711,[272 303 211 478 315],537,5,14772,3.9795258620689653,20.0,20.0
11712,2,3712,[272 303 211 478 315],13,5,14777,3.9798007002423916,20.0,20.0
11713,2,3713,[272 303 211 478 315],13,5,14782,3.980075390414647,20.0,20.0
11714,2,3714,[222 241 344 413 290],13,1,14783,3.9792732166890983,0.0,20.0
11715,2,3715,[272 303 211 478 315],13,5,14788,3.9795479009687837,20.0,20.0
11716,2,3716,[272 303 211 478 315],13,5,14793,3.979822437449556,20.0,20.0
11717,2,3717,[272 303 211 478 315],537,5,14798,3.9800968262506724,20.0,20.0
11718,2,3718,[272 303 211 478 315],13,5,14803,3.980371067491261,20.0,20.0
11719,2,3719,[272 303 211 478 315],537,5,14808,3.9806451612903224,20.0,20.0
11720,2,3720,[272 303 211 478 315],13,5,14813,3.9809191077667294,20.0,20.0
11721,2,3721,[211 431 291 321 208],234,1,14814,3.9801182160128965,0.0,20.0
11722,2,3722,[211 268 507 508 276],6,2,14816,3.9795863550899813,0.0,40.0
11723,2,3723,[215 326 392 212 211],64,2,14818,3.9790547798066593,0.0,20.0
11724,2,3724,[272 303 478 315 211],537,5,14823,3.9793288590604026,20.0,20.0
11725,2,3725,[216 300 231 280 452],13,1,14824,3.9785292538915726,0.0,20.0
11726,2,3726,[272 303 478 315 211],537,5,14829,3.9788033270727126,20.0,20.0
11727,2,3727,[272 303 478 315 211],13,5,14834,3.9790772532188843,20.0,20.0
11728,2,3728,[272 303 478 315 211],537,5,14839,3.9793510324483776,20.0,20.0
11729,2,3729,[272 303 478 315 211],13,5,14844,3.9796246648793567,20.0,20.0
11730,2,3730,[272 303 478 315 211],13,5,14849,3.979898150629858,20.0,20.0
11731,2,3731,[272 303 478 315 211],537,5,14854,3.980171489817792,20.0,20.0
11732,2,3732,[272 303 478 315 211],13,5,14859,3.9804446825609427,20.0,20.0
11733,2,3733,[272 303 478 315 211],13,5,14864,3.9807177289769684,20.0,20.0
11734,2,3734,[272 303 478 315 211],537,5,14869,3.9809906291834003,20.0,20.0
11735,2,3735,[272 303 478 315 211],13,5,14874,3.9812633832976445,20.0,20.0
11736,2,3736,[272 303 478 315 211],13,5,14879,3.9815359914369814,20.0,20.0
11737,2,3737,[217 481 227 272 301],13,2,14881,3.9810058855002675,0.0,0.0
11738,2,3738,[272 303 478 315 211],537,5,14886,3.981278416688954,20.0,20.0
11739,2,3739,[276 221 485 507 300],90,4,14890,3.981283422459893,0.0,40.0
11740,2,3740,[272 303 478 315 211],537,5,14895,3.9815557337610263,20.0,20.0
11741,2,3741,[272 303 478 315 211],537,5,14900,3.981827899518974,20.0,20.0
11742,2,3742,[272 303 478 315 211],537,5,14905,3.9820999198503872,20.0,20.0
11743,2,3743,[272 303 478 315 211],13,5,14910,3.9823717948717947,20.0,20.0
11744,2,3744,[378 268 303 212 272],537,3,14913,3.9821094793057408,0.0,0.0
11745,2,3745,[208 509 212 297 216],840,4,14917,3.9821142552055524,20.0,0.0
11746,2,3746,[272 303 478 315 211],537,5,14922,3.9823859087269815,20.0,20.0
11747,2,3747,[272 303 478 315 211],537,5,14927,3.982657417289221,20.0,20.0
11748,2,3748,[429 213 275 206 208],406,1,14928,3.981861829821286,0.0,20.0
11749,2,3749,[429 202 315 218 509],271,4,14932,3.981866666666667,20.0,0.0
11750,2,3750,[272 303 478 315 211],537,5,14937,3.982138096507598,20.0,20.0
11751,2,3751,[272 303 478 315 211],13,5,14942,3.982409381663113,20.0,20.0
11752,2,3752,[272 303 478 315 211],537,5,14947,3.9826805222488675,20.0,20.0
11753,2,3753,[272 303 478 315 211],13,5,14952,3.982951518380394,20.0,20.0
11754,2,3754,[272 303 478 315 211],537,5,14957,3.9832223701731024,20.0,20.0
11755,2,3755,[272 303 478 315 211],537,5,14962,3.983493077742279,20.0,20.0
11756,2,3756,[272 303 478 315 211],537,5,14967,3.9837636412030877,20.0,20.0
11757,2,3757,[272 303 478 315 211],13,5,14972,3.9840340606705693,20.0,20.0
11758,2,3758,[272 303 478 315 211],13,5,14977,3.9843043362596435,20.0,20.0
11759,2,3759,[429 239 227 221 276],334,3,14980,3.984042553191489,0.0,20.0
11760,2,3760,[272 303 478 315 211],537,5,14985,3.9843126827971282,20.0,20.0
11761,2,3761,[272 303 478 315 211],13,5,14990,3.984582668793195,20.0,20.0
11762,2,3762,[272 303 478 315 211],537,5,14995,3.9848525112941804,20.0,20.0
11763,2,3763,[272 303 478 315 211],13,5,15000,3.9851222104144526,20.0,20.0
11764,2,3764,[272 303 478 315 211],537,5,15005,3.9853917662682603,20.0,20.0
11765,2,3765,[216 283 481 202 300],409,2,15007,3.984864577801381,0.0,20.0
11766,2,3766,[272 303 478 315 211],13,5,15012,3.9851340589328377,20.0,20.0
11767,2,3767,[219 321 431 239 217],13,1,15013,3.9843418259023355,0.0,0.0
11768,2,3768,[272 303 478 315 211],537,5,15018,3.9846113027328203,20.0,20.0
11769,2,3769,[272 303 478 315 211],13,5,15023,3.9848806366047747,20.0,20.0
11770,2,3770,[384 290 507 231 219],648,2,15025,3.9843542826836384,0.0,0.0
11771,2,3771,[272 303 478 315 211],13,5,15030,3.9846235418875926,20.0,20.0
11772,2,3772,[452 226 367 583 507],7,4,15034,3.9846276172806787,0.0,0.0
11773,2,3773,[272 303 478 315 211],13,5,15039,3.9848966613672494,20.0,20.0
11774,2,3774,[212 213 509 478 215],406,1,15040,3.9841059602649005,0.0,0.0
11775,2,3775,[272 303 478 315 211],537,5,15045,3.984375,20.0,20.0
11776,2,3776,[485 217 316 478 299],13,2,15047,3.983849616097432,20.0,0.0
11777,2,3777,[272 303 478 315 211],13,5,15052,3.984118581259926,20.0,20.0
11778,2,3778,[272 303 478 315 211],13,5,15057,3.9843874040751524,20.0,20.0
11779,2,3779,[293 241 255 208 201],308,5,15062,3.9846560846560846,0.0,0.0
11780,2,3780,[272 303 478 315 211],13,5,15067,3.9849246231155777,20.0,20.0
11781,2,3781,[272 303 478 315 211],537,5,15072,3.985193019566367,20.0,20.0
11782,2,3782,[215 230 239 276 365],378,2,15074,3.98466825270949,0.0,20.0
11783,2,3783,[272 303 478 315 211],537,5,15079,3.984936575052854,20.0,20.0
11784,2,3784,[276 239 583 241 215],308,3,15082,3.984676354029062,0.0,20.0
11785,2,3785,[272 303 478 315 211],13,5,15087,3.984944532488114,20.0,20.0
11786,2,3786,[272 303 478 315 211],537,5,15092,3.985212569316081,20.0,20.0
11787,2,3787,[272 303 478 315 211],13,5,15097,3.985480464625132,20.0,20.0
11788,2,3788,[272 303 478 315 211],537,5,15102,3.985748218527316,20.0,20.0
11789,2,3789,[272 303 478 315 211],537,5,15107,3.986015831134565,20.0,20.0
11790,2,3790,[272 303 478 315 211],13,5,15112,3.9862833025586917,20.0,20.0
11791,2,3791,[202 283 284 321 241],234,0,15112,3.9852320675105486,0.0,0.0
11792,2,3792,[284 219 276 295 298],308,3,15115,3.984972317426839,0.0,20.0
11793,2,3793,[272 303 478 315 211],13,5,15120,3.985239852398524,20.0,20.0
11794,2,3794,[272 303 478 315 211],537,5,15125,3.9855072463768115,20.0,20.0
11795,2,3795,[272 303 478 315 211],13,5,15130,3.9857744994731297,20.0,20.0
11796,2,3796,[206 216 239 223 230],650,3,15133,3.9855148801685543,20.0,0.0
11797,2,3797,[272 303 478 315 211],13,5,15138,3.985781990521327,20.0,20.0
11798,2,3798,[216 413 485 218 300],843,0,15138,3.984732824427481,0.0,20.0
11799,2,3799,[272 303 478 315 211],537,5,15143,3.985,20.0,20.0
11800,2,3800,[275 301 300 290 259],537,1,15144,3.984214680347277,0.0,40.0
11801,2,3801,[272 303 478 315 211],13,5,15149,3.9844818516570224,20.0,20.0
11802,2,3802,[255 213 509 508 331],894,3,15152,3.984222981856429,0.0,0.0
11803,2,3803,[209 219 295 208 218],387,1,15153,3.9834384858044163,0.0,0.0
11804,2,3804,[272 303 478 315 211],537,5,15158,3.983705650459921,20.0,20.0
11805,2,3805,[272 303 478 315 211],13,5,15163,3.9839726747241198,20.0,20.0
11806,2,3806,[272 303 478 315 211],13,5,15168,3.984239558707644,20.0,20.0
11807,2,3807,[272 303 478 315 211],13,5,15173,3.9845063025210083,20.0,20.0
11808,2,3808,[272 303 478 315 211],537,5,15178,3.9847729062746127,20.0,20.0
11809,2,3809,[272 303 478 315 211],13,5,15183,3.98503937007874,20.0,20.0
11810,2,3810,[301 218 272 246 209],334,2,15185,3.984518499081606,0.0,0.0
11811,2,3811,[272 303 478 315 211],13,5,15190,3.984784889821616,20.0,20.0
11812,2,3812,[272 303 478 315 211],13,5,15195,3.985051140833989,20.0,20.0
11813,2,3813,[272 303 478 315 211],537,5,15200,3.9853172522286315,20.0,20.0
11814,2,3814,[272 303 478 315 211],13,5,15205,3.9855832241153344,20.0,20.0
11815,2,3815,[272 303 478 315 211],13,5,15210,3.9858490566037736,20.0,20.0
11816,2,3816,[272 303 478 315 211],13,5,15215,3.9861147498035105,20.0,20.0
11817,2,3817,[272 303 478 315 211],537,5,15220,3.9863803038239918,20.0,20.0
11818,2,3818,[272 303 478 315 211],537,5,15225,3.986645718774548,20.0,20.0
11819,2,3819,[272 303 478 315 211],537,5,15230,3.986910994764398,20.0,20.0
11820,2,3820,[272 303 478 315 211],13,5,15235,3.9871761319026433,20.0,20.0
11821,2,3821,[293 264 250 315 268],894,3,15238,3.9869178440607014,20.0,0.0
11822,2,3822,[231 226 420 300 331],313,3,15241,3.986659691341878,0.0,20.0
11823,2,3823,[485 209 222 452 217],13,0,15241,3.9856171548117154,0.0,20.0
11824,2,3824,[272 303 478 315 211],537,5,15246,3.9858823529411764,20.0,20.0
11825,2,3825,[272 303 478 315 211],13,5,15251,3.9861474124411918,20.0,20.0
11826,2,3826,[272 303 478 315 211],537,5,15256,3.9864123334204336,20.0,20.0
11827,2,3827,[272 303 478 315 211],13,5,15261,3.9866771159874608,20.0,20.0
11828,2,3828,[272 303 478 315 211],13,5,15266,3.9869417602507182,20.0,20.0
11829,2,3829,[272 303 478 315 211],13,5,15271,3.987206266318538,20.0,20.0
11830,2,3830,[272 303 478 315 211],537,5,15276,3.9874706342991386,20.0,20.0
11831,2,3831,[394 331 344 275 272],13,1,15277,3.9866910229645094,0.0,20.0
11832,2,3832,[220 254 231 219 208],648,2,15279,3.986172710670493,0.0,0.0
11833,2,3833,[272 303 478 315 211],537,5,15284,3.986437141366719,20.0,20.0
11834,2,3834,[272 303 478 315 211],13,5,15289,3.986701434159061,20.0,20.0
11835,2,3835,[272 303 478 315 211],13,5,15294,3.9869655891553704,20.0,20.0
11836,2,3836,[272 303 478 315 211],537,5,15299,3.9872296064633828,20.0,20.0
11837,2,3837,[272 303 478 315 211],13,5,15304,3.9874934861907243,20.0,20.0
11838,2,3838,[272 303 478 315 211],13,5,15309,3.9877572284449077,20.0,20.0
11839,2,3839,[272 303 478 315 211],13,5,15314,3.988020833333333,20.0,20.0
11840,2,3840,[272 303 478 315 211],537,5,15319,3.988284300963291,20.0,20.0
11841,2,3841,[485 336 290 223 429],13,3,15322,3.9880270692347737,20.0,0.0
11842,2,3842,[272 303 478 315 211],13,5,15327,3.988290398126464,20.0,20.0
11843,2,3843,[272 303 478 315 211],537,5,15332,3.988553590010406,20.0,20.0
11844,2,3844,[272 303 478 315 211],537,5,15337,3.988816644993498,20.0,20.0
11845,2,3845,[485 299 300 336 241],13,0,15337,3.987779511180447,0.0,20.0
11846,2,3846,[272 303 478 315 211],537,5,15342,3.9880426306212633,20.0,20.0
11847,2,3847,[219 226 431 201 230],774,2,15344,3.9875259875259874,0.0,0.0
11848,2,3848,[275 222 251 209 331],883,2,15346,3.987009612886464,20.0,40.0
11849,2,3849,[222 392 378 218 213],311,5,15351,3.9872727272727273,0.0,20.0
11850,2,3850,[272 303 478 315 211],13,5,15356,3.9875357050116853,20.0,20.0
11851,2,3851,[272 303 478 315 211],537,5,15361,3.987798546209761,20.0,20.0
11852,2,3852,[272 303 478 315 211],13,5,15366,3.9880612509732676,20.0,20.0
11853,2,3853,[365 202 241 219 250],774,3,15369,3.9878048780487805,0.0,0.0
11854,2,3854,[272 303 478 315 211],537,5,15374,3.9880674448767834,20.0,20.0
11855,2,3855,[272 303 478 315 211],537,5,15379,3.988329875518672,20.0,20.0
11856,2,3856,[272 303 478 315 211],537,5,15384,3.9885921700803735,20.0,20.0
11857,2,3857,[272 303 478 315 211],13,5,15389,3.9888543286677036,20.0,20.0
11858,2,3858,[272 303 478 315 211],13,5,15394,3.9891163513863694,20.0,20.0
11859,2,3859,[478 276 509 215 239],194,0,15394,3.988082901554404,0.0,20.0
11860,2,3860,[336 223 276 201 272],13,3,15397,3.987826987826988,20.0,20.0
11861,2,3861,[272 303 315 211 478],13,5,15402,3.988089073019161,20.0,20.0
11862,2,3862,[272 303 315 211 478],537,5,15407,3.9883510225213565,20.0,20.0
11863,2,3863,[272 303 315 211 478],537,5,15412,3.9886128364389233,20.0,20.0
11864,2,3864,[272 303 315 211 478],537,5,15417,3.9888745148771023,20.0,20.0
11865,2,3865,[223 218 264 276 429],13,4,15421,3.988877392653906,20.0,20.0
11866,2,3866,[223 222 481 272 321],13,2,15423,3.9883630721489527,20.0,20.0
11867,2,3867,[272 303 315 211 478],13,5,15428,3.9886246122026887,20.0,20.0
11868,2,3868,[272 303 315 211 478],537,5,15433,3.9888860170586713,20.0,20.0
11869,2,3869,[272 303 315 211 478],13,5,15438,3.9891472868217055,20.0,20.0
11870,2,3870,[272 303 315 211 478],537,5,15443,3.9894084215964867,20.0,20.0
11871,2,3871,[209 507 219 378 215],234,3,15446,3.9891528925619837,0.0,0.0
11872,2,3872,[272 303 315 211 478],13,5,15451,3.9894138910405372,20.0,20.0
11873,2,3873,[272 303 315 211 478],13,5,15456,3.989674754775426,20.0,20.0
11874,2,3874,[272 303 315 211 478],13,5,15461,3.9899354838709677,20.0,20.0
11875,2,3875,[272 303 315 211 478],13,5,15466,3.9901960784313726,20.0,20.0
11876,2,3876,[208 392 259 215 211],308,3,15469,3.9899406757802423,0.0,20.0
11877,2,3877,[202 216 431 222 509],13,2,15471,3.989427539969056,0.0,20.0
11878,2,3878,[272 303 315 211 478],13,5,15476,3.9896880639340035,20.0,20.0
11879,2,3879,[384 508 227 478 264],13,3,15479,3.9894329896907217,0.0,0.0
11880,2,3880,[272 303 315 211 478],537,5,15484,3.989693377995362,20.0,20.0
11881,2,3881,[272 303 315 211 478],13,5,15489,3.989953632148377,20.0,20.0
11882,2,3882,[272 303 315 211 478],13,5,15494,3.9902137522534122,20.0,20.0
11883,2,3883,[272 303 315 211 478],537,5,15499,3.990473738414006,20.0,20.0
11884,2,3884,[272 303 315 211 478],537,5,15504,3.9907335907335906,20.0,20.0
11885,2,3885,[261 211 268 301 321],6,1,15505,3.989963973237262,0.0,20.0
11886,2,3886,[272 303 315 211 478],537,5,15510,3.990223822999743,20.0,20.0
11887,2,3887,[272 303 315 211 478],537,5,15515,3.99048353909465,20.0,20.0
11888,2,3888,[272 303 315 211 478],537,5,15520,3.9907431216250964,20.0,20.0
11889,2,3889,[272 303 315 211 478],537,5,15525,3.9910025706940875,20.0,20.0
11890,2,3890,[272 303 315 211 478],13,5,15530,3.9912618864045233,20.0,20.0
11891,2,3891,[230 254 239 291 392],308,2,15532,3.9907502569373072,0.0,0.0
11892,2,3892,[272 303 315 211 478],13,5,15537,3.9910095042383764,20.0,20.0
11893,2,3893,[272 303 315 211 478],537,5,15542,3.9912686183872625,20.0,20.0
11894,2,3894,[272 303 315 211 478],13,5,15547,3.9915275994865214,20.0,20.0
11895,2,3895,[300 215 284 268 201],537,1,15548,3.990759753593429,0.0,20.0
11896,2,3896,[272 303 315 211 478],13,5,15553,3.9910187323582242,20.0,20.0
11897,2,3897,[272 303 315 211 478],13,5,15558,3.991277578245254,20.0,20.0
11898,2,3898,[276 367 213 478 209],406,3,15561,3.9910233393177736,0.0,20.0
11899,2,3899,[272 303 315 211 478],13,5,15566,3.9912820512820515,20.0,20.0
11900,2,3900,[378 300 316 508 272],85,2,15568,3.9907715970264035,20.0,20.0
11901,2,3901,[272 303 315 211 478],537,5,15573,3.9910302409021017,20.0,20.0
11902,2,3902,[216 485 241 420 481],7,5,15578,3.991288752241865,0.0,0.0
11903,2,3903,[213 367 222 291 316],234,2,15580,3.99077868852459,20.0,20.0
11904,2,3904,[272 303 315 211 478],537,5,15585,3.9910371318822024,20.0,20.0
11905,2,3905,[272 303 315 211 478],13,5,15590,3.991295442908346,20.0,20.0
11906,2,3906,[272 303 315 211 478],13,5,15595,3.991553621704633,20.0,20.0
11907,2,3907,[272 303 315 211 478],537,5,15600,3.991811668372569,20.0,20.0
11908,2,3908,[284 299 217 276 301],145,3,15603,3.9915579432079817,0.0,20.0
11909,2,3909,[272 303 315 211 478],537,5,15608,3.9918158567774937,20.0,20.0
11910,2,3910,[218 230 215 201 216],59,5,15613,3.992073638455638,0.0,0.0
11911,2,3911,[291 284 211 299 300],537,1,15614,3.9913087934560325,0.0,40.0
11912,2,3912,[280 299 232 316 211],13,3,15617,3.9910554561717353,20.0,20.0
11913,2,3913,[272 303 315 211 478],13,5,15622,3.9913132345426674,20.0,20.0
11914,2,3914,[272 303 315 211 478],13,5,15627,3.9915708812260537,20.0,20.0
11915,2,3915,[272 303 315 211 478],13,5,15632,3.9918283963227785,20.0,20.0
11916,2,3916,[209 300 508 293 481],334,1,15633,3.9910645902476385,0.0,20.0
11917,2,3917,[272 303 315 211 478],13,5,15638,3.9913221031138337,20.0,20.0
11918,2,3918,[217 218 478 212 223],650,1,15639,3.990558816024496,20.0,0.0
11919,2,3919,[272 303 315 211 478],537,5,15644,3.990816326530612,20.0,20.0
11920,2,3920,[272 303 315 211 478],13,5,15649,3.9910737056873247,20.0,20.0
11921,2,3921,[272 303 315 211 478],537,5,15654,3.9913309535951047,20.0,20.0
11922,2,3922,[272 303 315 211 478],13,5,15659,3.9915880703543207,20.0,20.0
11923,2,3923,[429 215 226 509 303],537,2,15661,3.991080530071356,0.0,0.0
11924,2,3924,[272 303 315 211 478],13,5,15666,3.9913375796178343,20.0,20.0
11925,2,3925,[326 295 254 223 239],749,3,15669,3.9910850738665307,20.0,0.0
11926,2,3926,[272 303 315 211 478],13,5,15674,3.9913419913419914,20.0,20.0
11927,2,3927,[208 290 202 301 239],650,1,15675,3.990580448065173,0.0,0.0
11928,2,3928,[272 303 315 211 478],537,5,15680,3.990837363196742,20.0,20.0
11929,2,3929,[272 303 315 211 478],13,5,15685,3.991094147582697,20.0,20.0
11930,2,3930,[272 303 315 211 478],537,5,15690,3.9913508013228185,20.0,20.0
11931,2,3931,[272 303 315 211 478],537,5,15695,3.9916073245167856,20.0,20.0
11932,2,3932,[272 303 315 211 478],13,5,15700,3.991863717264175,20.0,20.0
11933,2,3933,[272 303 315 211 478],13,5,15705,3.9921199796644635,20.0,20.0
11934,2,3934,[272 303 315 211 478],13,5,15710,3.992376111817027,20.0,20.0
11935,2,3935,[272 303 315 211 478],13,5,15715,3.9926321138211383,20.0,20.0
11936,2,3936,[298 284 219 299 227],145,4,15719,3.9926339852679704,0.0,0.0
11937,2,3937,[272 303 315 211 478],537,5,15724,3.9928897917724733,20.0,20.0
11938,2,3938,[272 303 315 211 478],13,5,15729,3.993145468392993,20.0,20.0
11939,2,3939,[272 303 315 211 478],537,5,15734,3.9934010152284265,20.0,20.0
11940,2,3940,[272 303 315 211 478],13,5,15739,3.993656432377569,20.0,20.0
11941,2,3941,[272 303 315 211 478],13,5,15744,3.993911719939117,20.0,20.0
11942,2,3942,[321 251 300 293 295],486,2,15746,3.9934060360131878,20.0,20.0
11943,2,3943,[226 298 284 202 236],145,2,15748,3.9929006085192698,0.0,0.0
11944,2,3944,[272 303 315 211 478],537,5,15753,3.9931558935361218,20.0,20.0
11945,2,3945,[272 303 315 211 478],13,5,15758,3.99341104916371,20.0,20.0
11946,2,3946,[272 303 315 211 478],537,5,15763,3.99366607550038,20.0,20.0
11947,2,3947,[272 303 315 211 478],537,5,15768,3.9939209726443767,20.0,20.0
11948,2,3948,[272 303 315 211 478],537,5,15773,3.9941757406938465,20.0,20.0
11949,2,3949,[321 202 215 485 276],194,0,15773,3.993164556962025,0.0,20.0
11950,2,3950,[272 303 315 211 478],13,5,15778,3.9934193874968362,20.0,20.0
11951,2,3951,[272 303 315 211 478],13,5,15783,3.993674089068826,20.0,20.0
11952,2,3952,[272 303 315 211 478],13,5,15788,3.9939286617758665,20.0,20.0
11953,2,3953,[272 303 315 211 478],537,5,15793,3.994183105715731,20.0,20.0
11954,2,3954,[223 326 261 303 384],13,2,15795,3.9936788874841973,20.0,0.0
11955,2,3955,[272 303 315 211 478],13,5,15800,3.993933265925177,20.0,20.0
11956,2,3956,[272 303 315 211 478],537,5,15805,3.994187515794794,20.0,20.0
11957,2,3957,[272 303 315 211 478],537,5,15810,3.9944416371905,20.0,20.0
11958,2,3958,[230 212 316 315 350],13,3,15813,3.994190452134377,40.0,0.0
11959,2,3959,[240 300 293 246 298],294,4,15817,3.9941919191919193,0.0,20.0
11960,2,3960,[272 303 315 211 478],537,5,15822,3.9944458470083313,20.0,20.0
11961,2,3961,[290 283 298 284 236],894,1,15823,3.9936900555275114,0.0,0.0
11962,2,3962,[272 303 315 211 478],13,5,15828,3.9939439818319453,20.0,20.0
11963,2,3963,[272 303 315 211 478],13,5,15833,3.9941977800201816,20.0,20.0
11964,2,3964,[272 303 315 211 478],537,5,15838,3.994451450189155,20.0,20.0
11965,2,3965,[478 243 283 301 259],537,2,15840,3.993948562783661,0.0,0.0
11966,2,3966,[272 303 315 211 478],13,5,15845,3.9942021678850517,20.0,20.0
11967,2,3967,[272 303 315 211 478],13,5,15850,3.9944556451612905,20.0,20.0
11968,2,3968,[272 303 315 211 478],537,5,15855,3.994708994708995,20.0,20.0
11969,2,3969,[275 392 507 295 230],308,3,15858,3.9944584382871535,0.0,20.0
11970,2,3970,[272 303 315 211 478],537,5,15863,3.994711659531604,20.0,20.0
11971,2,3971,[232 316 378 208 212],85,2,15865,3.9942094662638468,20.0,0.0
11972,2,3972,[272 303 315 211 478],537,5,15870,3.9944626227032467,20.0,20.0
11973,2,3973,[272 303 315 211 478],537,5,15875,3.994715651736286,20.0,20.0
11974,2,3974,[272 303 315 211 478],537,5,15880,3.9949685534591195,20.0,20.0
11975,2,3975,[420 226 230 431 485],295,5,15885,3.995221327967807,0.0,0.0
11976,2,3976,[272 303 315 211 478],13,5,15890,3.99547397535831,20.0,20.0
11977,2,3977,[221 244 378 218 259],474,4,15894,3.995475113122172,0.0,0.0
11978,2,3978,[272 303 315 211 478],13,5,15899,3.995727569741141,20.0,20.0
11979,2,3979,[272 303 315 211 478],13,5,15904,3.9959798994974873,20.0,20.0
11980,2,3980,[212 509 221 295 315],894,4,15908,3.9959809093192664,20.0,0.0
11981,2,3981,[275 213 431 507 478],537,5,15913,3.9962330487192363,0.0,20.0
11982,2,3982,[509 316 261 394 208],13,3,15916,3.9959829274416268,20.0,0.0
11983,2,3983,[272 303 315 211 478],537,5,15921,3.996234939759036,20.0,20.0
11984,2,3984,[222 275 413 246 206],699,1,15922,3.995483061480552,0.0,40.0
11985,2,3985,[321 298 259 284 209],308,3,15925,3.9952333166081284,0.0,0.0
11986,2,3986,[303 326 276 508 226],13,3,15928,3.9949836970152997,0.0,20.0
11987,2,3987,[212 268 232 485 324],7,1,15929,3.994232698094283,0.0,0.0
11988,2,3988,[222 429 209 218 243],804,3,15932,3.9939834544998747,0.0,20.0
11989,2,3989,[272 303 315 211 478],13,5,15937,3.994235588972431,20.0,20.0
11990,2,3990,[272 303 315 211 478],537,5,15942,3.9944875970934604,20.0,20.0
11991,2,3991,[321 413 420 481 201],13,1,15943,3.9937374749498997,0.0,0.0
11992,2,3992,[218 272 478 219 216],650,3,15946,3.993488605058853,0.0,0.0
11993,2,3993,[431 208 211 226 259],194,2,15948,3.9929894842263396,0.0,20.0
11994,2,3994,[272 303 315 211 478],13,5,15953,3.9932415519399247,20.0,20.0
11995,2,3995,[301 350 331 299 326],13,0,15953,3.9922422422422423,0.0,0.0
11996,2,3996,[272 303 315 211 478],13,5,15958,3.9924943707780836,20.0,20.0
11997,2,3997,[315 212 321 509 227],13,4,15962,3.9924962481240622,20.0,0.0
11998,2,3998,[272 303 315 211 478],537,5,15967,3.992748187046762,20.0,20.0
11999,2,3999,[272 303 315 211 478],537,5,15972,3.993,20.0,20.0
